A	<i>character</i><br><ol><li>The first letter of the Alemannic German alphabet, written in the Latin script.</li></ol>
Aabig|Ööbig	<i>noun</i><br><ol><li>evening</li></ol>
Aafang|Aafäng	<i>noun</i><br><ol><li>beginning</li></ol>
Aalass|Aaläss	<i>noun</i><br><ol><li>impetus, cause</li><li>event</li></ol>
Aare|Äärme|Äärem	<i>noun</i><br><ol><li>(unit of measurement) are, 100 square metres</li><li>(Uri) Alternative form of Aarm</li></ol>
Aargou	<i>name</i><br><ol><li>Aargau (a canton of Switzerland)</li></ol>
Aarm|Aarme|Äärmli|Äärm	<i>noun</i><br><ol><li>arm</li></ol>
Aaschnitt	<i>noun</i><br><ol><li>(Switzerland) heel, crust (end-piece of a loaf of bread)</li></ol>
Abwart|Abwarti|Abwarte	<i>noun</i><br><ol><li>caretaker, janitor</li><li>supervision, maintenance</li></ol>
Aff|Äffli|Affe	<i>noun</i><br><ol><li>monkey, ape</li></ol>
Alemannisch	<i>name</i><br><ol><li>Alemannic (dialect group or language)</li></ol>
Allmeini	<i>noun</i><br><ol><li>(Uri) common land</li></ol>
Alphorn|Alphörner	<i>noun</i><br><ol><li>(music) alphorn</li></ol>
Altar	<i>noun</i><br><ol><li>(Uri) age, old age</li></ol>
Ameisse	<i>noun</i><br><ol><li>(Uri) ant</li></ol>
Ange	<i>noun</i><br><ol><li>(Uri) hinge, door hinge</li></ol>
Angscht	<i>noun</i><br><ol><li>fear</li></ol>
Angster	<i>noun</i><br><ol><li>(Uri) A small coin of undetermined value.</li></ol>
Anke	<i>noun</i><br><ol><li>butter</li></ol>
Ankebälleli	<i>noun</i><br><ol><li>globeflower (Trollius europaeus)</li></ol>
Arfe	<i>noun</i><br><ol><li>(Uri) Swiss mountain pine, Pinus mugo.</li></ol>
Armbruscht|Armbrüscht	<i>noun</i><br><ol><li>crossbow</li></ol>
Ascht|Äschtli|Äscht	<i>noun</i><br><ol><li>bough, branch</li></ol>
Atzing	<i>noun</i><br><ol><li>(Uri) greenfodder</li></ol>
Au	<i>noun</i><br><ol><li>(Uri) ewe</li></ol>
Aug|Äugli|Auge	<i>noun</i><br><ol><li>(anatomy) eye</li></ol>
Augbraame	<i>noun</i><br><ol><li>(Uri, anatomy) eyebrow</li></ol>
Augespiegel	<i>noun</i><br><ol><li>(Uri) glasses</li></ol>
Baaum	<i>noun</i><br><ol><li>(Uri) tree</li></ol>
Bachbummele	<i>noun</i><br><ol><li>(Breisgau) marsh marigold (Caltha palustris)</li></ol>
Bachrolle	<i>noun</i><br><ol><li>(Breisgau, Försteland) globeflower (Trollius europaeus)</li></ol>
Bade	<i>name</i><br><ol><li>Baden</li></ol>
Badi	<i>noun</i><br><ol><li>public baths, swimming pool</li><li>open-air swimming area at a lakeside etc.; lido</li></ol>
Balung	<i>noun</i><br><ol><li>(Uri) balloon</li></ol>
Barme	<i>noun</i><br><ol><li>(Uri) A trough for animal fodder.</li></ol>
Beck|Becke	<i>noun</i><br><ol><li>baker</li></ol>
Bei	<i>noun</i><br><ol><li>leg</li></ol>
Beiz|Beizli|Beize	<i>noun</i><br><ol><li>pub, bar</li><li>inn</li></ol>
Berri	<i>noun</i><br><ol><li>(Uri) berry</li></ol>
Bett|Better	<i>noun</i><br><ol><li>bed</li></ol>
Bettseicher	<i>noun</i><br><ol><li>(Baden-Württemberg) bedwetter</li><li>(Baden-Württemberg) dandelion</li></ol>
Bier	<i>noun</i><br><ol><li>beer</li></ol>
Bii	<i>noun</i><br><ol><li>(Uri) honey bee</li></ol>
Biig|Biige|Biigli|Biigi	<i>noun</i><br><ol><li>pile, stack</li><li>(regional) woodpile</li></ol>
Biire	<i>noun</i><br><ol><li>(Uri) pear</li></ol>
Biiswind	<i>noun</i><br><ol><li>north wind, Bise (a specific north wind)</li></ol>
Biisääß	<i>noun</i><br><ol><li>(Uri) A man who is established in his profession, e.g. a resident doctor or (full) professor.</li></ol>
Biiwacht	<i>noun</i><br><ol><li>reinforcements for a guard, city watch, etc.</li></ol>
Billere	<i>noun</i><br><ol><li>(Uri) gums (flesh around teeth)</li></ol>
Birbant	<i>noun</i><br><ol><li>(Uri) rascal, imp</li></ol>
Bitz	<i>noun</i><br><ol><li>(Uri) bite, bit</li></ol>
Blacke	<i>noun</i><br><ol><li>(Uri, plural only) monk's rhubarb, Rumex alpinus</li></ol>
Blag|Blagli	<i>noun</i><br><ol><li>(Uri, derogatory, slang) brat</li></ol>
Blatt|Bletter|Blettli	<i>noun</i><br><ol><li>(botany) leaf</li><li>(card games) card</li></ol>
Bleewi	<i>noun</i><br><ol><li>(Uri) blue wash, blue dye</li></ol>
Bludaz	<i>name</i><br><ol><li>Bludenz (a town in the state of Vorarlberg, Austria)</li><li>Bludenz (an administrative district in the state of Vorarlberg, Austria)</li><li>Bludenz (a municipality in the district of Bludenz in the state of Vorarlberg, Austria)</li></ol>
Blösch|Blöschli|Blösche	<i>noun</i><br><ol><li>(Name for) a cow with a white spot, especially on its forehead; or alternatively a cow of a single colour, variously black, grey, red or brown depending on the region.</li></ol>
Bodesee	<i>name</i><br><ol><li>Lake Constance</li></ol>
Bone	<i>noun</i><br><ol><li>(Uri) bean</li></ol>
Bor	<i>noun</i><br><ol><li>(Uri) the wild leek, Allium ampeloprasum, syn. Allium porrum</li></ol>
Breagaz	<i>name</i><br><ol><li>Bregenz (the capital of and third largest city in the state of Vorarlberg, Austria)</li><li>Bregenz (an administrative district in the state of Vorarlberg, Austria)</li><li>Bregenz (a municipality in the district of Bregenz in the state of Vorarlberg, Austria)</li></ol>
Breemi	<i>noun</i><br><ol><li>(Uri) A premium given to students at the beginning of the school year to aid in school fees.</li></ol>
Brendli	<i>noun</i><br><ol><li>(Uri, plural only) The black vanilla orchid, Gymnadenia nigra.</li></ol>
Bretschel	<i>noun</i><br><ol><li>(Uri) A strap (on a purse, backpack, etc.).</li></ol>
Brittli	<i>noun</i><br><ol><li>(Uri) board</li></ol>
Brugg|Brugge|Brüggli	<i>noun</i><br><ol><li>bridge</li></ol>
Bruk	<i>noun</i><br><ol><li>(Uri) Bushes, thickets, especially of alpenroses.</li></ol>
Brunne|Brünneli|Brünne	<i>noun</i><br><ol><li>spring (of river etc)</li><li>(figuratively) source</li><li>well</li></ol>
Brunscht	<i>name</i><br><ol><li>(Alsatian) Brunstatt, a commune in the Haut-Rhin département, Alsace, France, part of the southern suburbs of the city of Mulhouse.</li></ol>
Bruun	<i>noun</i><br><ol><li>brown</li></ol>
Bruuni	<i>noun</i><br><ol><li>(Uri) A Braunvieh, a type of cattle native to Switzerland.</li></ol>
Bruut|Brüüt|Brüütli	<i>noun</i><br><ol><li>bride</li></ol>
Brämme	<i>noun</i><br><ol><li>(Uri) horsefly</li></ol>
Brënte	<i>noun</i><br><ol><li>(Uri) A wooden milk bottle carrier worn on the back.</li></ol>
Brüechli	<i>noun</i><br><ol><li>(Uri) diaper</li></ol>
Brüeder|Brüederli|Brüedere	<i>noun</i><br><ol><li>brother</li></ol>
Brüggli	<i>noun</i><br><ol><li>steps (leading up to a building)</li></ol>
Brügi	<i>noun</i><br><ol><li>(Uri) hayloft</li></ol>
Brüüsch	<i>noun</i><br><ol><li>heather</li></ol>
Bucke	<i>noun</i><br><ol><li>(Uri, agriculture) slurry (liquid manure) container</li></ol>
Buderi	<i>noun</i><br><ol><li>(Uri, plural only) bilberry, whortleberry, Vaccinium myrtillus</li></ol>
Bueb|Büebli|Buebe|Buebli	<i>noun</i><br><ol><li>boy</li></ol>
Buech|Buechli|Bueche|Büechli|Büecher	<i>noun</i><br><ol><li>beech</li><li>book</li></ol>
Bullere	<i>noun</i><br><ol><li>(Uri) The knobbly parts of cheese.</li></ol>
Bunse	<i>noun</i><br><ol><li>(Uri) an overweight woman</li></ol>
Burdi	<i>noun</i><br><ol><li>(Uri) burden, load</li></ol>
Butëlle	<i>noun</i><br><ol><li>(Uri) bottle</li></ol>
Buu	<i>noun</i><br><ol><li>(Uri) fertilizer</li></ol>
Buuchlämpe	<i>noun</i><br><ol><li>(Uri) dewlap on cattle</li></ol>
Bäne|Bënne	<i>noun</i><br><ol><li>wheelbarrow</li></ol>
Bärn	<i>name</i><br><ol><li>Bern (the capital city of Switzerland; capital city of Bern canton)</li><li>Bern (a canton of Switzerland)</li></ol>
Bärr	<i>noun</i><br><ol><li>(Uri) bear</li></ol>
Bäärg|Bäärge|Bäärgli	<i>noun</i><br><ol><li>mountain, hill</li></ol>
Bërg	<i>noun</i><br><ol><li>(Uri) Alternative form of Bäärg (“mountain”)</li></ol>
Bëtti	<i>noun</i><br><ol><li>(Uri) rosary</li></ol>
Bëtzgi	<i>noun</i><br><ol><li>(Uri) core (central part of a fruit)</li></ol>
Bölle	<i>noun</i><br><ol><li>(Schwyz, Apenzell, Uri) onion</li></ol>
Böögg|Bööggli|Böögge	<i>noun</i><br><ol><li>booger, bogey</li><li>A traditional straw figure burnt publicly in Zurich to mark the end of winter.</li></ol>
Büdel	<i>noun</i><br><ol><li>(Uri) belly</li></ol>
Büel	<i>noun</i><br><ol><li>(Uri) hill</li></ol>
Büsi	<i>noun</i><br><ol><li>cat</li></ol>
Bütschgi	<i>noun</i><br><ol><li>(Zürich) apple core</li><li>(Zürich, colloquial) Adam's apple</li></ol>
Chaabiß	<i>noun</i><br><ol><li>(Uri) white cabbage</li></ol>
Chaasleb	<i>noun</i><br><ol><li>(Uri) rennet (enzyme used in cheesemaking)</li></ol>
Chachele	<i>noun</i><br><ol><li>(Uri) tile for walls and floors</li></ol>
Chalchoufe	<i>name</i><br><ol><li>(Carcoforo) Carcoforo (a village in Piedmont, Italy)</li></ol>
Challe	<i>noun</i><br><ol><li>(Uri) the clapper of a bell</li></ol>
Chalp|Chalpli|Chäpli	<i>noun</i><br><ol><li>(Uri) calf (baby cattle)</li></ol>
Charte	<i>noun</i><br><ol><li>(Uri) comb for carding wool</li></ol>
Chaschte|Chäschte|Chäschtli	<i>noun</i><br><ol><li>closet, cupboard</li><li>bodybuilder</li></ol>
Chats|Chatsli	<i>noun</i><br><ol><li>(Uri) cat (house cat)</li></ol>
Chatz|Chätzli|Chatze	<i>noun</i><br><ol><li>cat</li></ol>
Chatzesprung	<i>noun</i><br><ol><li>(idiomatic) around the corner, nearby</li></ol>
Cheer	<i>noun</i><br><ol><li>(Uri) A bend in a road.</li></ol>
Chestene	<i>noun</i><br><ol><li>(Uri) chestnut</li></ol>
Chett	<i>noun</i><br><ol><li>(Uri) the wooden water channel of a mill</li></ol>
Chilbi|Chilbine	<i>noun</i><br><ol><li>fair, festival, parish fair</li></ol>
Chilche|Chilchene|Chilcheli	<i>noun</i><br><ol><li>(Aargau, Basel, Bern, Fribourg, Glarus, Grisons, Nidwalden, St. Gallen, Tessin, Schwyz, Solothurn, Thurgau, Valais, Zurich (Weinland)) Alternative form of Chirche</li></ol>
Chile|Chileli|Chilene	<i>noun</i><br><ol><li>(Aargau, Basel, Bern, Fribourg, Lucerne, Schwyz, Unterwalden, Uri, Zug, St Gallen (Amden), Zürich) Alternative form of Chirche</li></ol>
Chilt	<i>noun</i><br><ol><li>(Uri) A nighttime visit with friends and family.</li></ol>
Chilwi	<i>noun</i><br><ol><li>(Appenzell, Unterwalden, Uri) Alternative form of Chilbi: parish fair</li></ol>
Chimmi	<i>noun</i><br><ol><li>(Uri, anatomy) chin</li></ol>
Chind|Chinder|Chindli|Chinde	<i>noun</i><br><ol><li>child</li><li>girl, maid</li></ol>
Chindsgi	<i>noun</i><br><ol><li>(colloquial) kindergarten</li></ol>
Chindsgibändel|Chindsgibändeli	<i>noun</i><br><ol><li>reflective strip (handed out by kindergardens and schools in Switzerland to be worn by children for road safety)</li></ol>
Chirche|Chirchene|Chirchli	<i>noun</i><br><ol><li>church</li></ol>
Chlack	<i>noun</i><br><ol><li>(Uri) fissure, crack</li></ol>
Chlegti	<i>noun</i><br><ol><li>(Uri) lawsuit</li></ol>
Chleid	<i>noun</i><br><ol><li>dress</li></ol>
Chlempi	<i>noun</i><br><ol><li>(Uri) clamp, clip</li></ol>
Chlepfe	<i>noun</i><br><ol><li>(Uri) chatterbox</li></ol>
Chlooschter	<i>noun</i><br><ol><li>monastery, abbey; nunnery</li></ol>
Chlupf	<i>noun</i><br><ol><li>(Uri) fright, terror, shock</li></ol>
Chnoche|Chnöche	<i>noun</i><br><ol><li>(anatomy) bone</li></ol>
Chnode	<i>noun</i><br><ol><li>ankle</li><li>joint</li></ol>
Chnopf|Chnöpfli|Chnöpf	<i>noun</i><br><ol><li>button</li></ol>
Chnopplich	<i>noun</i><br><ol><li>(Uri) garlic</li></ol>
Chnuuschti|Chnuuschtis	<i>noun</i><br><ol><li>(informal) a worker</li><li>(informal) an eccentric, difficult person</li></ol>
Chnëcht	<i>noun</i><br><ol><li>(Uri) farmhand</li><li>(Uri) servant</li></ol>
Chnüsel	<i>noun</i><br><ol><li>(Uri) cold (illness)</li></ol>
Chnüü	<i>noun</i><br><ol><li>(Zürich, St. Gallen) knee</li></ol>
Chnüüw	<i>noun</i><br><ol><li>(Uri, anatomy) knee</li></ol>
Choch	<i>noun</i><br><ol><li>(Uri) male cook</li></ol>
Choli	<i>noun</i><br><ol><li>(Uri, humorous) locomotive</li></ol>
Chopf|Chöpfli|Chöpf	<i>noun</i><br><ol><li>(anatomy) head</li></ol>
Chorn	<i>noun</i><br><ol><li>(Uri) corn, maize</li></ol>
Chornäli|Chornähre	<i>noun</i><br><ol><li>(Uri) ear (of corn)</li></ol>
Chrache	<i>noun</i><br><ol><li>(Uri, anatomy) throat</li></ol>
Chranket|Chrankete	<i>noun</i><br><ol><li>illness, disease</li></ol>
Chrapfe	<i>noun</i><br><ol><li>(Uri) A krapfen, a type of doughnut.</li></ol>
Chriesi|Chriäsi|Chriasi	<i>noun</i><br><ol><li>cherry (fruit)</li></ol>
Chriesibaum|Chriesibäum|Chriesibäumli	<i>noun</i><br><ol><li>cherry tree</li></ol>
Chriesiholz	<i>noun</i><br><ol><li>cherry tree wood</li></ol>
Chrisam	<i>noun</i><br><ol><li>(Uri) chrism</li></ol>
Chromme	<i>noun</i><br><ol><li>(Uri) A shed for small domesticated animals.</li></ol>
Chrone	<i>noun</i><br><ol><li>crown</li></ol>
Chrott|Chrotte|Chröttli	<i>noun</i><br><ol><li>toad</li></ol>
Chrotte	<i>noun</i><br><ol><li>(Uri) toad</li></ol>
Chrottepösche	<i>noun</i><br><ol><li>dandelion</li></ol>
Chruut|Chrüütli|Chrüüter	<i>noun</i><br><ol><li>herb</li><li>cabbage</li><li>(chiefly diminutive) medicinal herb</li></ol>
Chräps	<i>noun</i><br><ol><li>(Uri) crayfish</li></ol>
Chrëbs	<i>noun</i><br><ol><li>(Uri) spindle (of a spinning wheel)</li></ol>
Chrüüz|Chrüüzli	<i>noun</i><br><ol><li>cross</li></ol>
Chuchi|Chucheli|Chücheli|Chuchene	<i>noun</i><br><ol><li>kitchen</li></ol>
Chuchichäschtli	<i>noun</i><br><ol><li>kitchen cupboard</li></ol>
Chue|Chueli|Chüe|Chuä|Chüeli	<i>noun</i><br><ol><li>cow</li></ol>
Chueche|Chüeche|Chüechli	<i>noun</i><br><ol><li>cake</li></ol>
Chupple|Chüpple	<i>noun</i><br><ol><li>(architecture) dome</li></ol>
Chur	<i>name</i><br><ol><li>Chur (a town, the capital of Graubünden canton, Switzerland).</li></ol>
Chuuderwältsch	<i>noun</i><br><ol><li>(colloquial) gibberish, double Dutch</li><li>jargon, lingo; pidgin</li></ol>
Chämlete	<i>name</i><br><ol><li>(Uri) Chämleten/Kemmleten (a village in Hospental, Uri canton, Switzerland)</li></ol>
Chätschgummi|Chätschgummis	<i>noun</i><br><ol><li>chewing gum</li></ol>
Chääfer	<i>noun</i><br><ol><li>(Uri) beetle (insect)</li></ol>
Chääs	<i>noun</i><br><ol><li>cheese</li></ol>
Chääsbrëche	<i>noun</i><br><ol><li>(Uri) A mixer used for separating curds and whey in cheesemaking.</li></ol>
Chääschüechli	<i>noun</i><br><ol><li>(traditional Swiss) quiche</li></ol>
Chääsmässer	<i>noun</i><br><ol><li>cheese knife</li></ol>
Chële	<i>noun</i><br><ol><li>(Uri) A cleft or groove in the ground.</li></ol>
Chöchene	<i>noun</i><br><ol><li>(Uri) a female cook</li></ol>
Chöltsch	<i>noun</i><br><ol><li>(Uri) colorful cotton or linen</li></ol>
Chüeni	<i>noun</i><br><ol><li>(Uri) cattleman</li></ol>
Chünel	<i>noun</i><br><ol><li>Synonym of Chüngel</li></ol>
Chüng	<i>noun</i><br><ol><li>(Uri, card games) king</li></ol>
Chüngel|Chüngeli	<i>noun</i><br><ol><li>rabbit</li></ol>
Chüssi	<i>noun</i><br><ol><li>cushion, pillow</li></ol>
Derri|Derrene|Deeri|Derreli	<i>noun</i><br><ol><li>(rare, Highest Alemannic) contrivance or place to dry fruits, wood etc.</li><li>(rare, Highest Alemannic) amount of something that is dried in one go</li></ol>
Didena	<i>name</i><br><ol><li>(Alsatian) Didenheim, a commune in the Haut-Rhin département, Alsace, France.</li></ol>
Droogehändler	<i>noun</i><br><ol><li>drug dealer</li></ol>
Dütschland|Düütschland|Tüütschland	<i>name</i><br><ol><li>Germany</li></ol>
Ee	<i>noun</i><br><ol><li>marriage</li></ol>
Efangeli	<i>noun</i><br><ol><li>(Uri) the Gospel (first section of the New Testament)</li></ol>
Egli	<i>noun</i><br><ol><li>European perch</li></ol>
Eichhore	<i>noun</i><br><ol><li>(Uri) squirrel</li></ol>
Eischeme	<i>name</i><br><ol><li>(Issime) Issime (a village in Aosta Valley, Italy)</li></ol>
Eisten	<i>name</i><br><ol><li>(Uri) Eisten (a village in Valais canton, Switzerland).</li></ol>
Elifant	<i>noun</i><br><ol><li>(Uri) elephant</li></ol>
Elsassisch	<i>noun</i><br><ol><li>(Alsatian) Alsatian (dialect)</li></ol>
Endi|End	<i>noun</i><br><ol><li>(Uri) end, finish</li></ol>
Engsti	<i>noun</i><br><ol><li>(Uri, plural only) fear, anxiety</li></ol>
Eschtrych	<i>name</i><br><ol><li>Austria</li></ol>
Esel	<i>noun</i><br><ol><li>(Uri) ass, donkey</li></ol>
Ess	<i>noun</i><br><ol><li>(Uri) chimney-hood over a stove</li></ol>
Faane|Fääne	<i>noun</i><br><ol><li>(Uri) flag</li></ol>
Fachele	<i>noun</i><br><ol><li>(Uri) torch</li></ol>
Fachsen	<i>noun</i><br><ol><li>(Uri, plural only) short, bristly grass</li></ol>
Famiili	<i>noun</i><br><ol><li>(Uri) family</li></ol>
Fare|Pfare	<i>noun</i><br><ol><li>(Uri, Christianity) pastor</li></ol>
Fasnacht|Faßnacht	<i>noun</i><br><ol><li>carnival (festival held just before the beginning of Lent)</li></ol>
Fass|Fässer|Fässli|Faß	<i>noun</i><br><ol><li>barrel, keg, cask</li></ol>
Fasung	<i>noun</i><br><ol><li>(Uri) manner, type, fashion</li></ol>
Fatter	<i>noun</i><br><ol><li>(Uri) father</li></ol>
Feire	<i>noun</i><br><ol><li>(Uri, derogatory) a licentious woman</li></ol>
Feisterramme|Fënsterramme	<i>noun</i><br><ol><li>(Uri) window frame</li></ol>
Felli	<i>noun</i><br><ol><li>(Uri) A steep and dangerous drop-off often found in mountainous areas.</li></ol>
Fiiraabig	<i>noun</i><br><ol><li>hometime, knocking-off time (UK); off-hours</li></ol>
Fiire	<i>noun</i><br><ol><li>(Uri) firn (a type of old snow which has gone through multiple thaw and refreeze cycles)</li></ol>
Flo	<i>noun</i><br><ol><li>(Uri) flea</li></ol>
Floor	<i>noun</i><br><ol><li>garden flower</li><li>bloom, blooming</li><li>gauze, crape; veil</li></ol>
Flueh	<i>noun</i><br><ol><li>(Uri) scarp, rock face</li></ol>
Fluume	<i>noun</i><br><ol><li>(Uri) plum</li></ol>
Fläsche	<i>noun</i><br><ol><li>(Uri) bottle, flask</li></ol>
Flüüge	<i>noun</i><br><ol><li>(Uri) fly (insect)</li></ol>
Fogel	<i>noun</i><br><ol><li>(Uri) bird</li></ol>
Folle	<i>noun</i><br><ol><li>(Uri) milk funnel</li></ol>
Frau	<i>noun</i><br><ol><li>woman</li><li>wife</li></ol>
Fremdi	<i>noun</i><br><ol><li>stranger; foreigner, alien</li></ol>
Frialp	<i>name</i><br><ol><li>(Uri, archaic) Realp (a village in Uri canton, Switzerland).</li></ol>
Frucht|Frücht	<i>noun</i><br><ol><li>(central and northeastern Switzerland) grain, cereal</li></ol>
Fràui	<i>noun</i><br><ol><li>(Alsatian) woman</li></ol>
Früelig	<i>noun</i><br><ol><li>spring (season)</li></ol>
Fründ|Fründe	<i>noun</i><br><ol><li>friend</li></ol>
Fuchs|Füchs|Füchsli	<i>noun</i><br><ol><li>fox</li></ol>
Fuess|Füess	<i>noun</i><br><ol><li>foot</li></ol>
Fugs	<i>noun</i><br><ol><li>(Uri) fox</li></ol>
Fummel	<i>noun</i><br><ol><li>(Uri) A shoemaking tool that is used to smooth the edges of the sole of a shoe.</li></ol>
Furgge	<i>noun</i><br><ol><li>(Uri) pitchfork, hayfork</li></ol>
Fäischter|Fäischterli	<i>noun</i><br><ol><li>window</li></ol>
Fänschter	<i>noun</i><br><ol><li>window</li></ol>
Färli	<i>noun</i><br><ol><li>(Uri) piglet</li></ol>
Färrich	<i>noun</i><br><ol><li>(Uri) A hurdle (temporary fence) to enclose cattle.</li></ol>
Fäscht|Fäschtli	<i>noun</i><br><ol><li>celebration, party, festival</li></ol>
Fättere	<i>noun</i><br><ol><li>(Uri) colander</li></ol>
Fëcke	<i>noun</i><br><ol><li>(Uri, anatomy) wing</li></ol>
Fëgfüür	<i>noun</i><br><ol><li>(Uri, Christianity) Purgatory</li></ol>
Fërsich	<i>noun</i><br><ol><li>(Uri) peach</li></ol>
Fëst	<i>noun</i><br><ol><li>(Uri) celebration, party, festival</li></ol>
Föllni	<i>noun</i><br><ol><li>(Uri) A cattle disease.</li></ol>
Föön	<i>noun</i><br><ol><li>(Uri) foehn (warm dry wind blowing down from the northern side of the Alps)</li></ol>
Füli	<i>noun</i><br><ol><li>(Uri) foal (young horse)</li></ol>
Fürschüübe	<i>noun</i><br><ol><li>(Uri) apron</li></ol>
Füür|Füürer	<i>noun</i><br><ol><li>fire</li></ol>
Gaarte|Gäärte	<i>noun</i><br><ol><li>(Sense, Uri) garden</li></ol>
Gaas|Gësens|Gëes|Gases	<i>noun</i><br><ol><li>(Bern) goose</li></ol>
Gable	<i>noun</i><br><ol><li>(Uri) fork, prong</li><li>(Uri) a rack for carrying small loads</li></ol>
Gajung	<i>noun</i><br><ol><li>(Uri) A mean or vile person.</li></ol>
Galge	<i>noun</i><br><ol><li>gallows</li><li>The part of a bell from which the clapper hangs.</li></ol>
Gand	<i>noun</i><br><ol><li>(Uri) scree (loose stony debris on a slope)</li></ol>
Gants	<i>noun</i><br><ol><li>(Uri) goose</li></ol>
Garte|Gärtli|Gärte	<i>noun</i><br><ol><li>garden</li></ol>
Gaufflete	<i>noun</i><br><ol><li>(Uri) handful</li></ol>
Gauzi	<i>noun</i><br><ol><li>(Uri) a dog that yaps; a yapper</li></ol>
Gebse	<i>noun</i><br><ol><li>(Uri) milk tub</li></ol>
Gedäächtnis	<i>noun</i><br><ol><li>(Uri) memory</li><li>(Uri, Christianity) remembrance</li></ol>
Geerste	<i>noun</i><br><ol><li>(Uri) barley</li></ol>
Geete	<i>noun</i><br><ol><li>(Uri, plural only) gaiters, spats</li></ol>
Gefell	<i>noun</i><br><ol><li>(Uri) steep hill</li></ol>
Gehuuri	<i>noun</i><br><ol><li>ghost</li><li>scarecrow</li><li>(figuratively) unkempt woman</li></ol>
Gehüdel	<i>noun</i><br><ol><li>(Uri) intestines, guts, entrails</li></ol>
Geiss	<i>noun</i><br><ol><li>(Alsatian, Uri) goat</li><li>(Uri) she-goat</li></ol>
Geissbock	<i>noun</i><br><ol><li>(Uri) he-goat</li></ol>
Geleich	<i>noun</i><br><ol><li>(Uri, anatomy) joint</li></ol>
Gelotz	<i>noun</i><br><ol><li>(Uri) A small observation window.</li></ol>
Gelungg	<i>noun</i><br><ol><li>(Uri) shallow, shoal</li></ol>
Gelëck	<i>noun</i><br><ol><li>(Uri) A mixture of salt, bran, oats, etc. used as cattle fodder.</li></ol>
Gelëff	<i>noun</i><br><ol><li>(Uri, anatomy) maw; mouth of an animal</li></ol>
Gemschi	<i>noun</i><br><ol><li>(Uri) chamois (Rupicara rupicara)</li></ol>
Gerigel	<i>noun</i><br><ol><li>(Uri) frame</li><li>(Uri) skeleton</li><li>(Uri, plural only) bones</li></ol>
Geröll	<i>noun</i><br><ol><li>(Uri) horse bells</li></ol>
Geschirr	<i>noun</i><br><ol><li>dishware</li><li>yoke</li></ol>
Geschwiie	<i>noun</i><br><ol><li>(Uri) sister-in-law</li></ol>
Geschäft	<i>noun</i><br><ol><li>(Uri) shop, store</li><li>(Uri) business</li></ol>
Gesetz	<i>noun</i><br><ol><li>(Uri) law</li></ol>
Gespur	<i>noun</i><br><ol><li>(Uri) track, trail</li></ol>
Gewëtt	<i>noun</i><br><ol><li>(Uri) log wall</li></ol>
Gewëtti	<i>noun</i><br><ol><li>(Uri) timberwork</li></ol>
Geääder	<i>noun</i><br><ol><li>(Uri) the sinewy parts of meat</li></ol>
Gfüül	<i>noun</i><br><ol><li>feeling</li></ol>
Ghüder	<i>noun</i><br><ol><li>(Bern) trash</li></ol>
Gibel	<i>noun</i><br><ol><li>gable; crest (of a roof)</li><li>pediment</li><li>(slang) head</li></ol>
Giir	<i>noun</i><br><ol><li>(Uri) vulture</li></ol>
Glas|Glesli|Gleser	<i>noun</i><br><ol><li>glass (material)</li><li>glass (drinking vessel)</li><li>pane of glass</li></ol>
Glogg|Glöggli|Glogge	<i>noun</i><br><ol><li>bell</li></ol>
Glüüt	<i>noun</i><br><ol><li>peal, chimes, ringing (of bells)</li></ol>
Gof|Gofä|Göfli|Gofa|Gofe	<i>noun</i><br><ol><li>(informal) an unruly child</li></ol>
Goof|Gööfli|Gööf|Goofe	<i>noun</i><br><ol><li>(informal) child</li><li>(Uri) girl</li></ol>
Gooli	<i>noun</i><br><ol><li>goalie</li></ol>
Goon	<i>noun</i><br><ol><li>(Uri) A wooden ladle for milk</li></ol>
Graas|Gras|Gräsli|Grääser|Grääsli|Gräser	<i>noun</i><br><ol><li>grass (plant)</li><li>(informal) weed, marijuana</li></ol>
Grasdeeri	<i>noun</i><br><ol><li>(Bern, rare) grass drying machine</li></ol>
Grebel	<i>noun</i><br><ol><li>(Uri) a hoe, especially one for digging up crystals</li></ol>
Greschòney Drifaltigkeit	<i>name</i><br><ol><li>(Gressoney) Gressoney-La-Trinité (a town in Aosta Valley, Italy)</li></ol>
Greschòney zer Chilchu	<i>name</i><br><ol><li>(Gressoney) Gressoney-Saint-Jean (a town in Aosta Valley, Italy)</li></ol>
Griggele	<i>noun</i><br><ol><li>(Uri, anatomy) perineum</li></ol>
Griggi	<i>noun</i><br><ol><li>(Uri) A person who is limping.</li></ol>
Grippi	<i>noun</i><br><ol><li>(Uri) influenza, illness</li></ol>
Grueß|Grüeß	<i>noun</i><br><ol><li>greeting</li></ol>
Grumbeer	<i>noun</i><br><ol><li>(Alsatian) potato</li></ol>
Grübli	<i>noun</i><br><ol><li>(Uri) lingonberry, cowberry, Vaccinium vitis-idaea</li></ol>
Grüübi	<i>noun</i><br><ol><li>(Uri) crackling (crispy rind of roast pork)</li></ol>
Grüüsch	<i>noun</i><br><ol><li>sound, noise</li></ol>
Gschwellti	<i>noun</i><br><ol><li>(plural only) jacket potatoes</li></ol>
Gspaane|Gspäändli	<i>noun</i><br><ol><li>companion</li></ol>
Gspuusi|Gschpuusi	<i>noun</i><br><ol><li>bride; sweetheart</li></ol>
Gstabëlle	<i>noun</i><br><ol><li>(Uri) chair</li></ol>
Guege	<i>noun</i><br><ol><li>(Uri) fiddle, violin</li></ol>
Guggehuur|Guggehüürli	<i>noun</i><br><ol><li>attic room (especially in a tower)</li></ol>
Guggere	<i>noun</i><br><ol><li>(Uri) roof hatch</li></ol>
Guli|Gulene	<i>noun</i><br><ol><li>rooster, cock</li></ol>
Gumel|Gumeli	<i>noun</i><br><ol><li>(Schwyz) potato</li></ol>
Gummle	<i>noun</i><br><ol><li>(Uri) potato</li></ol>
Gunte	<i>noun</i><br><ol><li>(Uri) A deep area in a river.</li></ol>
Gurre	<i>noun</i><br><ol><li>(Uri) A gulp, especially of alcohol.</li></ol>
Gursche	<i>noun</i><br><ol><li>(Uri) Gurten (a mountain in the Jura Mountains, Switzerland)</li></ol>
Guseler	<i>noun</i><br><ol><li>(Uri) A needle used to clean a tabacco pipe.</li></ol>
Gust	<i>noun</i><br><ol><li>(Uri) taste, flavour</li></ol>
Gusti	<i>noun</i><br><ol><li>(Uri) A two-year-old calf (baby cattle)</li></ol>
Guttere	<i>noun</i><br><ol><li>(Uri) bottle</li></ol>
Guutsche	<i>noun</i><br><ol><li>(Uri) A small bed; a cradle.</li></ol>
Gwitter	<i>noun</i><br><ol><li>weather</li><li>storm, thunderstorm</li></ol>
Gämere	<i>noun</i><br><ol><li>(Uri) white hellebore (Veratrum album)</li></ol>
Gänterli	<i>noun</i><br><ol><li>(Uri) cabinet, cupboard</li></ol>
Gärmere	<i>noun</i><br><ol><li>(Uri) Alternative form of Gämere (“white hellebore”)</li></ol>
Gäud|Gälder|Gäuder|Gäut	<i>noun</i><br><ol><li>(Bern) money</li></ol>
Güggel	<i>noun</i><br><ol><li>cock, rooster</li></ol>
Gülle	<i>noun</i><br><ol><li>shallow pond</li><li>puddle, especially of slurry (liquid manure)</li></ol>
Güsel	<i>noun</i><br><ol><li>(Zürich, Uri) garbage</li></ol>
Gütsch	<i>noun</i><br><ol><li>(Uri, archaic) hill</li></ol>
Haag|Hääg	<i>noun</i><br><ol><li>fence</li></ol>
Haane	<i>noun</i><br><ol><li>(Uri) cock, rooster (male chicken)</li></ol>
Haase	<i>noun</i><br><ol><li>(Uri) hare</li></ol>
Hag	<i>noun</i><br><ol><li>(Uri) fence</li></ol>
Halsbëtzgi	<i>noun</i><br><ol><li>(Uri, anatomy) Adam's apple</li></ol>
Hamf	<i>noun</i><br><ol><li>(Uri) hemp</li></ol>
Hamme	<i>noun</i><br><ol><li>(Uri) the hook on the wide end of a scythe blade</li></ol>
Haselmuus|Haselmüüsli|Haselmüüs	<i>noun</i><br><ol><li>dormouse</li></ol>
Haupt|Häuptli	<i>noun</i><br><ol><li>(Uri, anatomy, of livestock) head</li></ol>
Hebi	<i>noun</i><br><ol><li>(Uri) yeast</li></ol>
Heeli	<i>noun</i><br><ol><li>(Uri) cave</li></ol>
Heer	<i>noun</i><br><ol><li>(Uri, Christianity) pastor</li></ol>
Heidëchsli|Heidenëchsli	<i>noun</i><br><ol><li>(Uri) lizard</li></ol>
Hell	<i>noun</i><br><ol><li>(Uri) hell</li></ol>
Hengscht	<i>noun</i><br><ol><li>stallion</li></ol>
Henne	<i>noun</i><br><ol><li>(Uri) hen (female chicken)</li></ol>
Herbrig	<i>noun</i><br><ol><li>(Uri) hostel</li></ol>
Herpscht	<i>noun</i><br><ol><li>(Uri) autumn</li></ol>
Heugumper	<i>noun</i><br><ol><li>grasshopper</li></ol>
Heuw	<i>noun</i><br><ol><li>(Uri) hay</li></ol>
Heuwstöffel	<i>noun</i><br><ol><li>(Uri) grasshopper</li></ol>
Hiene	<i>noun</i><br><ol><li>(Uri) handle (of a container)</li></ol>
Hinige	<i>name</i><br><ol><li>(Alsatian) Huningue (a town in Alsace, France)</li></ol>
Hitzgi	<i>noun</i><br><ol><li>(central and eastern Switzerland) hiccup</li></ol>
Hocker	<i>noun</i><br><ol><li>(Uri) A small stool.</li></ol>
Hoger|Höger|Högerli	<i>noun</i><br><ol><li>hump, hunch</li><li>hill, hillock, knoll</li></ol>
Hosebalke	<i>noun</i><br><ol><li>(Uri) an old-fashioned, four-cornered fly (strip that hides the opening of trousers)</li></ol>
Hubel	<i>noun</i><br><ol><li>(Uri) hill</li></ol>
Hudel	<i>noun</i><br><ol><li>(Uri, mildly derogatory) rags (tattered clothing)</li></ol>
Hue|Hüendli	<i>noun</i><br><ol><li>(Uri) chicken (animal)</li></ol>
Hueste	<i>noun</i><br><ol><li>(Uri) cough</li></ol>
Huet|Hüet|Hüetli	<i>noun</i><br><ol><li>hat</li></ol>
Hufe	<i>noun</i><br><ol><li>(Uri) pile, heap</li></ol>
Hund	<i>noun</i><br><ol><li>(Uri) dog</li></ol>
Hus	<i>noun</i><br><ol><li>house</li></ol>
Hutzeli	<i>noun</i><br><ol><li>(Uri) updo</li></ol>
Huu	<i>noun</i><br><ol><li>(Uri) owl, especially the Eurasian eagle owl</li></ol>
Huube|Hüübli	<i>noun</i><br><ol><li>hood, bonnet (of a car)</li><li>spire</li><li>bonnet, headdress</li></ol>
Huus|Hüüser|Hüüsli	<i>noun</i><br><ol><li>house</li></ol>
Huusfrau|Huusfraue	<i>noun</i><br><ol><li>housewife</li></ol>
Hächle	<i>noun</i><br><ol><li>(Uri) hackle, hatchel (tool for threshing flax)</li></ol>
Häiwee	<i>noun</i><br><ol><li>homesickness</li></ol>
Hälemli	<i>noun</i><br><ol><li>(Uri) weasel</li></ol>
Hälftere	<i>noun</i><br><ol><li>(Uri) halter</li></ol>
Häppere	<i>noun</i><br><ol><li>(Fribourg) potato</li></ol>
Häppöri	<i>noun</i><br><ol><li>(Fribourg) strawberry</li></ol>
Härdöpfel	<i>noun</i><br><ol><li>(Switzerland) potato</li></ol>
Härdöpfelstock|Härdöpfelstöck	<i>noun</i><br><ol><li>(chiefly in the singular) mashed potatoes</li></ol>
Härre	<i>noun</i><br><ol><li>(Uri, anatomy, plural only) hair (the long hair on a person's head)</li></ol>
Härz|Härza|Härzli|Härzä|Härze	<i>noun</i><br><ol><li>(countable, anatomy) heart (anatomy)</li><li>(uncountable, figuratively) heart (one's feelings and emotions)</li></ol>
Hääli	<i>noun</i><br><ol><li>(Uri) trammel (hook for pots)</li></ol>
Häärdepfel	<i>noun</i><br><ol><li>(Uri) potato</li></ol>
Hërt	<i>noun</i><br><ol><li>(Uri) humus</li></ol>
Höchi|Höchene	<i>noun</i><br><ol><li>Synonym of Hööchi</li></ol>
Hörpfel	<i>noun</i><br><ol><li>(regional) Synonym of Härdöpfel.</li></ol>
Hööchi|Hööchene	<i>noun</i><br><ol><li>(countable) height</li><li>(uncountable, figuratively) mountains</li></ol>
Hüs	<i>noun</i><br><ol><li>(Alsatian) house</li></ol>
Iberlinge	<i>name</i><br><ol><li>Überlingen</li></ol>
Iichaufslade|Iichaufsläde|Iichaufslädeli	<i>noun</i><br><ol><li>store, shop</li></ol>
Iis	<i>noun</i><br><ol><li>ice</li></ol>
Im Land	<i>name</i><br><ol><li>(Italian Walser) Alagna Valesesia, a village in Piedmont, Italy.</li></ol>
Ise|Iseli	<i>noun</i><br><ol><li>(uncountable) iron</li><li>(countable) piece of iron</li></ol>
Jass|Jässli	<i>noun</i><br><ol><li>(card games) jass</li></ol>
Joggene	<i>noun</i><br><ol><li>(Uri)blue-spiked rampion (Phyteuma betonicifolium)</li></ol>
Johr|regionally|Johre	<i>noun</i><br><ol><li>year</li></ol>
Järb	<i>noun</i><br><ol><li>(Uri) the aging of cheese</li></ol>
Jåhr	<i>noun</i><br><ol><li>(Voralberg) year</li></ol>
Jëst	<i>noun</i><br><ol><li>(Uri) Early cheese blowing, a gas defect that causes pockets of gas in young cheese.</li></ol>
Jüppi	<i>noun</i><br><ol><li>(Uri) A sleeveless dress.</li><li>(Uri, plural only) The alpenrose, Rhododendron ferrugineum</li></ol>
Kaafe	<i>noun</i><br><ol><li>(Uri) coffee</li></ol>
Kanepe	<i>noun</i><br><ol><li>(Uri) sofa</li></ol>
Kansel	<i>noun</i><br><ol><li>(Uri) pulpit (raised platform in a church)</li></ol>
Kantrum	<i>noun</i><br><ol><li>(Uri) chest of drawers</li></ol>
Kapore	<i>noun</i><br><ol><li>(Uri) down payment, deposit</li></ol>
Kartatsche|Kartatschen	<i>noun</i><br><ol><li>(Uri) A winter shoe with a wooden sole.</li></ol>
Karäschi	<i>noun</i><br><ol><li>(Uri) courage</li></ol>
Katzala	<i>noun</i><br><ol><li>(Alsatian) little cat</li></ol>
Kawall	<i>noun</i><br><ol><li>(Uri) horse</li></ol>
Kerette	<i>noun</i><br><ol><li>(Uri) wheelbarrow</li></ol>
Kermille	<i>noun</i><br><ol><li>(Uri) camomile (plant)</li></ol>
Krämle	<i>noun</i><br><ol><li>(Vorarlberg) A homecoming gift (a gift brought back when returning from a trip).</li><li>(Vorarlberg) A hostess gift (a gift given by a visitor during a social visit).</li></ol>
Kunte	<i>noun</i><br><ol><li>(Uri) bill, invoice</li></ol>
Kàmpelj	<i>name</i><br><ol><li>(Rimella and Campello Monti) Campello Monti</li></ol>
Kàtz	<i>noun</i><br><ol><li>(Alsatian) Alternative form of Chatz</li></ol>
Käs	<i>noun</i><br><ol><li>cheese</li></ol>
Künig	<i>noun</i><br><ol><li>(Uri, dated) king</li></ol>
Lade|Lädeli|Läde	<i>noun</i><br><ol><li>store, shop</li></ol>
Lafete	<i>noun</i><br><ol><li>(Uri) part of a tool that holds or carries something</li></ol>
Laggääder	<i>noun</i><br><ol><li>(Uri) diarrhea</li></ol>
Land|Länder	<i>noun</i><br><ol><li>land</li><li>country</li></ol>
Langssi	<i>noun</i><br><ol><li>(Uri, Oberwallis) spring (season)</li></ol>
Lantärne	<i>noun</i><br><ol><li>(Uri) lantern</li></ol>
Laube	<i>noun</i><br><ol><li>(Uri) covered corridor or balcony</li></ol>
Laui	<i>noun</i><br><ol><li>(Uri) avalanche</li></ol>
Laxierer	<i>noun</i><br><ol><li>(Uri) diarrhea</li></ol>
Leew	<i>noun</i><br><ol><li>(Uri) lion</li></ol>
Leffel	<i>noun</i><br><ol><li>(Alsatian) a spoon</li></ol>
Leiker	<i>noun</i><br><ol><li>(Uri) ram (male sheep)</li></ol>
Liachtaschta	<i>name</i><br><ol><li>Liechtenstein</li></ol>
Lid	<i>noun</i><br><ol><li>(Uri, anatomy) The hindquarters of a slaughter animal.</li></ol>
Liib|Liibli|Liiber	<i>noun</i><br><ol><li>body</li><li>womb, uterus (of horses, cows)</li></ol>
Liibli	<i>noun</i><br><ol><li>vest (UK), undershirt (US)</li><li>jersey, T-shirt</li></ol>
Liire	<i>noun</i><br><ol><li>(Uri) butter churn</li></ol>
Liisblii	<i>noun</i><br><ol><li>(Uri) pencil</li></ol>
Linge	<i>noun</i><br><ol><li>(Uri) line, row</li></ol>
Loos	<i>noun</i><br><ol><li>(Uri) sow (adult female pig)</li></ol>
Lugi	<i>noun</i><br><ol><li>(Uri) lie (falsity)</li></ol>
Lunzi|Graubünden|Lünzeli|Lunzeli	<i>name</i><br><ol><li>Used as a general name for a person in various children's rhymes.</li></ol>
Luss	<i>noun</i><br><ol><li>(Uri) A piece of farmland acquired through a lottery.</li></ol>
Lutsch	<i>noun</i><br><ol><li>(Uri) soft, very young cheese</li></ol>
Luxus	<i>noun</i><br><ol><li>(Uri) luxury</li></ol>
Làuich	<i>noun</i><br><ol><li>(Alsatian) leek</li></ol>
Läbe	<i>noun</i><br><ol><li>life</li></ol>
Läffel	<i>noun</i><br><ol><li>(Alsatian) Alternative form of Leffel</li></ol>
Lätsch	<i>noun</i><br><ol><li>lace (of a shoe, etc.)</li><li>string</li></ol>
Läufer	<i>noun</i><br><ol><li>(Uri) moveable casement</li></ol>
Läägel	<i>noun</i><br><ol><li>(Uri) small barrel</li></ol>
Läärche	<i>noun</i><br><ol><li>(Uri) larch (coniferous tree)</li></ol>
Lëcki	<i>noun</i><br><ol><li>(Uri) A mixture of salt and bran.</li></ol>
Lëfzge	<i>noun</i><br><ol><li>(Uri, anatomy) lip</li></ol>
Löffel|Löffeli	<i>noun</i><br><ol><li>spoon</li></ol>
Lööl	<i>noun</i><br><ol><li>fool, simpleton</li></ol>
Lööli	<i>noun</i><br><ol><li>(Uri) Alternative form of Lööl</li></ol>
Lütt|Lüttli	<i>noun</i><br><ol><li>(plural only) Alternative form of Lüüt</li></ol>
Lüüchzgi	<i>noun</i><br><ol><li>Synonym of Chindsgibändel</li></ol>
Lüüt|Lüütli	<i>noun</i><br><ol><li>(plural only) people</li></ol>
Lüüte	<i>noun</i><br><ol><li>(plural only) Alternative form of Lüüt</li></ol>
Maa|Mändli|Manne|Mane|Maali	<i>noun</i><br><ol><li>man</li><li>husband</li></ol>
Maan	<i>noun</i><br><ol><li>(Uri) moon</li></ol>
Maase|Maasse	<i>noun</i><br><ol><li>(Uri) spot, fleck</li></ol>
Maitli	<i>noun</i><br><ol><li>girl</li></ol>
Manestre	<i>noun</i><br><ol><li>(Uri) A vegetable soup.</li></ol>
Mann	<i>noun</i><br><ol><li>(Uri) man</li></ol>
Masche	<i>noun</i><br><ol><li>mesh</li><li>stitch</li></ol>
Materi	<i>noun</i><br><ol><li>(Uri) soil, humus</li></ol>
Meer	<i>noun</i><br><ol><li>sea</li></ol>
Meerze	<i>noun</i><br><ol><li>March</li></ol>
Meisse	<i>noun</i><br><ol><li>(Uri) A cow that is pregnant for the first time at two years old.</li></ol>
Meitli	<i>noun</i><br><ol><li>(Uri) girl</li></ol>
Mensrind	<i>noun</i><br><ol><li>(Uri) A one- to two-year-old calf.</li></ol>
Mettel|Merttel	<i>noun</i><br><ol><li>(Uri) earthworm</li></ol>
Mies	<i>noun</i><br><ol><li>(Uri) moss</li></ol>
Migi	<i>noun</i><br><ol><li>(colloquial) Migros</li></ol>
Miigge	<i>noun</i><br><ol><li>(Uri) roll, bun</li></ol>
Militäär	<i>noun</i><br><ol><li>(Uri) military</li></ol>
Milme	<i>noun</i><br><ol><li>(Uri) mite (arachnid)</li></ol>
Mistguege	<i>noun</i><br><ol><li>(Uri) dung beetle</li></ol>
Moli|Morli	<i>noun</i><br><ol><li>(Uri) newt</li></ol>
Moloch	<i>noun</i><br><ol><li>(biblical) Moloch (deity)</li><li>something big; monstrosity, monster</li></ol>
Mond	<i>noun</i><br><ol><li>moon</li></ol>
Morge	<i>noun</i><br><ol><li>morning</li></ol>
Mues|Müesli	<i>noun</i><br><ol><li>mush, paste, pulp</li></ol>
Mueter|Müetere	<i>noun</i><br><ol><li>mother</li></ol>
Mueterspraach	<i>noun</i><br><ol><li>mother tongue, native language</li></ol>
Mueterwuet	<i>noun</i><br><ol><li>(Uri) nymphomania</li></ol>
Mugge	<i>noun</i><br><ol><li>(Uri) mosquito (Culicidae)</li><li>(Basel) fly</li></ol>
Muggedätscher	<i>noun</i><br><ol><li>(Basel) flyswatter</li></ol>
Mungge	<i>noun</i><br><ol><li>(Uri) marmot</li></ol>
Murmete	<i>noun</i><br><ol><li>(Uri) marmot</li></ol>
Mutschli	<i>noun</i><br><ol><li>(Uri) A Weggli, a type of Swiss bread, especially a sweet-flavored one.</li></ol>
Mutte	<i>noun</i><br><ol><li>(Uri) wooden milk crate</li></ol>
Muul|Müüler|Müüli	<i>noun</i><br><ol><li>mouth</li><li>(Uri) maw (mouth of an animal)</li></ol>
Muuni	<i>noun</i><br><ol><li>(Uri) breeding bull</li></ol>
Muur|Muure	<i>noun</i><br><ol><li>wall (especially when stone or otherwise solid and exterior)</li></ol>
Muus|Müüs|Müüsli	<i>noun</i><br><ol><li>mouse</li></ol>
Màmsel	<i>noun</i><br><ol><li>(Alsatian) Miss</li></ol>
Mànn	<i>noun</i><br><ol><li>(Alsatian) man</li></ol>
Märcht	<i>noun</i><br><ol><li>(Uri) market</li></ol>
Märe	<i>noun</i><br><ol><li>(Uri) mare (adult female horse)</li></ol>
Mäser	<i>noun</i><br><ol><li>(Uri) woodgrain</li></ol>
Määntig	<i>noun</i><br><ol><li>(Uri) Monday</li></ol>
Määri	<i>noun</i><br><ol><li>(Uri) fairy tale</li></ol>
Määrli	<i>noun</i><br><ol><li>fairy tale (folk tale)</li><li>(informal) fairy tale (unbelievable story)</li></ol>
Mël	<i>noun</i><br><ol><li>(Uri) flour, meal (ground cereal)</li></ol>
Mëlchtere	<i>noun</i><br><ol><li>(Uri) milking pail</li></ol>
Müe	<i>noun</i><br><ol><li>trouble, effort</li></ol>
Müesli	<i>noun</i><br><ol><li>muesli</li></ol>
Müli	<i>noun</i><br><ol><li>(Uri) mill</li></ol>
Müsele	<i>noun</i><br><ol><li>(Uri) A cord of firewood.</li></ol>
Müss	<i>noun</i><br><ol><li>(Uri) mouse</li></ol>
Naachpuur	<i>noun</i><br><ol><li>(Uri) neighbour</li></ol>
Naame	<i>noun</i><br><ol><li>(Uri) name</li></ol>
Nachtüüle	<i>noun</i><br><ol><li>(Uri) long-eared owl</li></ol>
Nami	<i>noun</i><br><ol><li>(colloquial) Alternative form of Nomi / clipping of Namitag.</li></ol>
Narr	<i>noun</i><br><ol><li>(Uri) fool</li></ol>
Nase|Näsi|Näsli	<i>noun</i><br><ol><li>(northeast and southwest Switzerland) nose</li></ol>
Nazi|Nazis	<i>noun</i><br><ol><li>Nazi</li></ol>
Neidorf	<i>name</i><br><ol><li>(Alsatian) Village-Neuf (a village in Alsace, France)</li></ol>
Nidel	<i>noun</i><br><ol><li>cream</li></ol>
Niidleblääjer	<i>noun</i><br><ol><li>(Uri) butter churn</li></ol>
Nochbär|Nochbärs	<i>noun</i><br><ol><li>neighbour</li></ol>
Noll	<i>noun</i><br><ol><li>(Uri, derogatory) An unintelligent man; a (male) dimwit or fool.</li></ol>
Nomi	<i>noun</i><br><ol><li>(colloquial) Clipping of Nomitag.</li></ol>
Nomitag|Nomitägli|Namitag|Nomitäg|Namitäg|Namitägli	<i>noun</i><br><ol><li>afternoon</li></ol>
Nuss	<i>noun</i><br><ol><li>(Uri) nut (hard-shelled seed)</li></ol>
Nägeli	<i>noun</i><br><ol><li>carnation</li></ol>
Näll	<i>noun</i><br><ol><li>(card games) The nine of trumps in a game of jass.</li></ol>
Nässi	<i>noun</i><br><ol><li>(Uri) wetness</li></ol>
Näächi	<i>noun</i><br><ol><li>(Uri) area, vicinity</li></ol>
Näätsch	<i>noun</i><br><ol><li>(Uri) Stiff, bristly grass.</li></ol>
Nüere	<i>noun</i><br><ol><li>(Uri) cesspool (underground pit for sewage)</li></ol>
Nüt	<i>noun</i><br><ol><li>nothing</li></ol>
Obertili	<i>noun</i><br><ol><li>(Uri) attic</li></ol>
Ochs|Ochse	<i>noun</i><br><ol><li>ox; bullock</li></ol>
Oor	<i>noun</i><br><ol><li>(Uri, anatomy) ear</li></ol>
Oorewirger	<i>noun</i><br><ol><li>(Uri) earwig</li></ol>
Oorgele|Öörgeli	<i>noun</i><br><ol><li>(music) organ</li></ol>
Oschpidall	<i>name</i><br><ol><li>(Uri) Hospental (a town in Uri canton, Switzerland)</li></ol>
Oschta	<i>noun</i><br><ol><li>east</li></ol>
Pajass	<i>noun</i><br><ol><li>fool, buffoon; idiot</li></ol>
Palangge	<i>noun</i><br><ol><li>(Uri) A large piece of wood; a board.</li></ol>
Palänser	<i>noun</i><br><ol><li>(Uri) pig, swine</li></ol>
Parniise	<i>noun</i><br><ol><li>(Uri) partridge</li></ol>
Pfane|Pfändli	<i>noun</i><br><ol><li>frying pan</li></ol>
Pfeister|Pfenster|Feister|Pfäischter	<i>noun</i><br><ol><li>(Uri) window</li></ol>
Pfiffi	<i>noun</i><br><ol><li>(Uri, of chickens) The hardening of the tip of the tongue, a symptom of pip.</li></ol>
Pfister	<i>noun</i><br><ol><li>(Uri, obsolete) baker</li></ol>
Pfulme	<i>noun</i><br><ol><li>(Uri) pillow</li></ol>
Pfussi	<i>noun</i><br><ol><li>(Uri) A fat guy.</li><li>(Uri) toddler</li></ol>
Pfärd	<i>noun</i><br><ol><li>horse, esp. a beautiful riding horse</li></ol>
Phack|Phäck|Phäckli	<i>noun</i><br><ol><li>parcel, package</li><li>pack, rabble (of animals)</li><li>(derogatory) rabble, mob, vermin, rascals (of people)</li></ol>
Pinggel	<i>noun</i><br><ol><li>(Uri) bundle</li></ol>
Plangge	<i>noun</i><br><ol><li>(Uri) plain (expanse of level land)</li></ol>
Pless	<i>noun</i><br><ol><li>(Uri) A cow with a white spot on its forehead.</li></ol>
Pomatt	<i>name</i><br><ol><li>(Formazza) Formazza (a village in Piedmont, Italy)</li></ol>
Porgge	<i>noun</i><br><ol><li>(Uri) pig (animal)</li></ol>
Potschämber	<i>noun</i><br><ol><li>(Uri) chamber pot</li></ol>
Prattig	<i>noun</i><br><ol><li>(Uri) calendar</li></ol>
Prueff|Prüeff	<i>noun</i><br><ol><li>job, profession</li></ol>
Pschäid	<i>noun</i><br><ol><li>information, notification</li><li>answer, response</li></ol>
Pulverhorn|Pulverhörner	<i>noun</i><br><ol><li>powder horn</li></ol>
Pumper	<i>noun</i><br><ol><li>(Uri) bag, sack</li></ol>
Pungg	<i>noun</i><br><ol><li>(Uri) push, impact, thrust</li></ol>
Purggli	<i>noun</i><br><ol><li>(Uri) piglet</li></ol>
Putsch|Pütschli|Pütsch|Putsch	<i>noun</i><br><ol><li>grove, copse</li><li>hit, blow, stroke</li><li>putsch, revolt</li></ol>
Puur|Puure|Püürli	<i>noun</i><br><ol><li>farmer</li><li>peasant, boor</li><li>(card games) Jack; specifically, the Jack of trumps in the game of jass</li></ol>
Pärisou	<i>noun</i><br><ol><li>(Fribourg) umbrella (for rain)</li></ol>
Püntner	<i>noun</i><br><ol><li>(Uri) a person from or living in Grisons</li></ol>
Raffle	<i>noun</i><br><ol><li>(Uri) A wooden rattle that is rung as a substitute for churchbells during Holy Week. In Roman Catholicism, bells are traditionally not rung from after the singing of Gloria in excelsis Deo on Maundy Thursday until Easter Sunday.</li></ol>
Rapp	<i>noun</i><br><ol><li>(Uri) raven</li></ol>
Ratze	<i>noun</i><br><ol><li>(Uri) people, clan, race</li></ol>
Raub	<i>noun</i><br><ol><li>(Uri) harvest yield</li></ol>
Red	<i>noun</i><br><ol><li>(Uri) speech</li></ol>
Reister	<i>noun</i><br><ol><li>(Uri) poker, firestick</li></ol>
Remmalju	<i>name</i><br><ol><li>(Rimella and Campello Monti) Rimella</li></ol>
Rigi	<i>noun</i><br><ol><li>(Uri, geology) stratification in mountains</li></ol>
Rind	<i>noun</i><br><ol><li>(Uri) calf (baby cattle)</li></ol>
Ringge	<i>noun</i><br><ol><li>(Uri) buckle, clasp</li></ol>
Rischi	<i>noun</i><br><ol><li>(Uri) An opening in a haybarn through which hay is thrown.</li></ol>
Rone	<i>noun</i><br><ol><li>(Uri) treestump</li></ol>
Roor|Röörli	<i>noun</i><br><ol><li>reed</li><li>pipe</li></ol>
Roos|Röösli|Roose	<i>noun</i><br><ol><li>rose</li></ol>
Roosejooli	<i>noun</i><br><ol><li>(Uri) rose liquor</li></ol>
Ross	<i>noun</i><br><ol><li>(Uri) horse</li></ol>
Ruew	<i>noun</i><br><ol><li>(Uri) peace, quiet, calm</li></ol>
Rufi	<i>noun</i><br><ol><li>(Uri) landslide</li></ol>
Rugge|Rügge	<i>noun</i><br><ol><li>back (part of the body)</li></ol>
Rupf	<i>noun</i><br><ol><li>(Uri) infatuation</li></ol>
Ruus	<i>noun</i><br><ol><li>soot</li></ol>
Rächnig|Rächnige	<i>noun</i><br><ol><li>bill (UK), check (US)</li></ol>
Rägeschirm	<i>noun</i><br><ol><li>(Switzerland) umbrella (strictly for rain)</li></ol>
Rääbe|Rääbli	<i>noun</i><br><ol><li>turnip</li></ol>
Rääbeliechtli	<i>noun</i><br><ol><li>neep lantern</li></ol>
Räägemoli	<i>noun</i><br><ol><li>(Uri) Alpine salamander (Salamandra atra)</li></ol>
Räätrich	<i>noun</i><br><ol><li>(Uri) radish (plant of the Raphanus genus)</li></ol>
Rëcht	<i>noun</i><br><ol><li>(Uri) right, privilege</li></ol>
Rüebli	<i>noun</i><br><ol><li>carrot</li></ol>
Rüeppe	<i>noun</i><br><ol><li>(Uri, anatomy) The end of a tail.</li></ol>
Rüüti	<i>name</i><br><ol><li>(Uri) A field in Urseren, Switzerland.</li></ol>
Samichlaus|Samichloisli|Samichlois	<i>name</i><br><ol><li>Saint Nicholas; Father Christmas (UK), Santa Claus</li><li>Saint Nicholas Day (6th December)</li></ol>
Schaa	<i>name</i><br><ol><li>Schaan (the largest municipality in Liechtenstein)</li></ol>
Schaf	<i>noun</i><br><ol><li>(Uri, rare) sheep</li></ol>
Schafhurd	<i>noun</i><br><ol><li>(Uri) A shed for sheep.</li></ol>
Schalle	<i>noun</i><br><ol><li>(Uri) cowbell</li></ol>
Scheenguege	<i>noun</i><br><ol><li>(Uri) ladybug, ladybird</li></ol>
Scheese	<i>noun</i><br><ol><li>(Uri) chaise (a horse-drawn carriage for one or two people)</li></ol>
Schiibli	<i>noun</i><br><ol><li>bull's eye windowpane</li><li>window</li><li>lens</li></ol>
Schiie	<i>noun</i><br><ol><li>(Uri) batten, slat</li></ol>
Schild	<i>noun</i><br><ol><li>(Uri) A triangle-shaped snow deposition formed as a result of a small avalanche.</li></ol>
Schinbein	<i>noun</i><br><ol><li>(Uri, anatomy) shinbone</li></ol>
Schine	<i>noun</i><br><ol><li>(Uri) splinter</li></ol>
Schkalfing	<i>noun</i><br><ol><li>(Uri) The part of stockings that covers the toes.</li></ol>
Schkarnutz	<i>noun</i><br><ol><li>(Uri) paper bag</li></ol>
Schloss|Schlösser|Schloß	<i>noun</i><br><ol><li>castle</li><li>lock</li></ol>
Schluecht	<i>noun</i><br><ol><li>(Uri) canyon, gorge</li></ol>
Schluenze	<i>noun</i><br><ol><li>An untidy woman.</li><li>(derogatory, by extension) slut, whore</li></ol>
Schluuch	<i>noun</i><br><ol><li>(Uri) tube, hose</li></ol>
Schmeeli	<i>noun</i><br><ol><li>(Uri) narrowness</li></ol>
Schmid	<i>noun</i><br><ol><li>(Uri) smith</li></ol>
Schmiisse	<i>noun</i><br><ol><li>(Uri) A track for sleds.</li></ol>
Schmër	<i>noun</i><br><ol><li>(Uri) fat</li></ol>
Schnee|Schneeli|Schneewli	<i>noun</i><br><ol><li>snow</li></ol>
Schnuer	<i>noun</i><br><ol><li>(Uri) daughter-in-law (son's wife)</li></ol>
Schnurre	<i>noun</i><br><ol><li>(Uri, anatomy) snout</li></ol>
Schnägg|Schnäggli|Schnägge	<i>noun</i><br><ol><li>snail, slug</li><li>(cooking) snail, escargot</li><li>(colloquial, Zürich) five-franc coin</li></ol>
Schoggi|Schoggis	<i>noun</i><br><ol><li>chocolate</li></ol>
Schooff	<i>noun</i><br><ol><li>(Uri) sheep</li></ol>
Schoon	<i>noun</i><br><ol><li>(Uri) brightening, especially of the sky</li></ol>
Schopf|Schöpfli|Schöpf	<i>noun</i><br><ol><li>shed, outhouse</li></ol>
Schrunde	<i>noun</i><br><ol><li>(Uri) scratch, scrape</li></ol>
Schtube|Schtubene	<i>noun</i><br><ol><li>living room</li></ol>
Schtund|Schtunde|Schtündli	<i>noun</i><br><ol><li>hour</li></ol>
Schtäge	<i>noun</i><br><ol><li>(flight of) stairs</li></ol>
Schwaab|Schwaabe|Schwööbli	<i>noun</i><br><ol><li>Swabian (person)</li><li>(derogatory) German (person)</li></ol>
Schwalme	<i>noun</i><br><ol><li>(Uri) swallow (bird)</li></ol>
Schwarbe	<i>noun</i><br><ol><li>(Uri) A swath or windrow of hay.</li></ol>
Schwartlig	<i>noun</i><br><ol><li>(Uri) slab</li></ol>
Schweig	<i>name</i><br><ol><li>(Uri) traditional alpine dairy</li></ol>
Schwibele	<i>noun</i><br><ol><li>(Uri) wooden beam</li></ol>
Schwiiz	<i>name</i><br><ol><li>Switzerland</li></ol>
Schwiizertüütsch	<i>name</i><br><ol><li>Swiss German (language)</li></ol>
Schwumm|Schwümm|Schwümmli	<i>noun</i><br><ol><li>an act of swimming</li><li>swimming style</li><li>(regional) mushroom</li></ol>
Schwëcherfatter	<i>noun</i><br><ol><li>(Uri) father-in-law</li></ol>
Schwöschter|Schwöschtere|Schwöschterli	<i>noun</i><br><ol><li>sister</li><li>nurse</li></ol>
Schëre	<i>noun</i><br><ol><li>(Uri) mole (mammal of the Talpidae family)</li></ol>
Schümli Pflümli	<i>noun</i><br><ol><li>A hot drink made of sweetened coffee, plum schnapps and whipped cream</li></ol>
Se	<i>noun</i><br><ol><li>(Uri) Alpine herdsman and dairyman</li></ol>
See|Seeli|Seee	<i>noun</i><br><ol><li>lake</li><li>(Uri) Alternative form of Se</li></ol>
Seel	<i>noun</i><br><ol><li>(Uri) soul</li></ol>
Seigel	<i>noun</i><br><ol><li>(Uri) rung of a ladder</li></ol>
Seike	<i>noun</i><br><ol><li>she-goat</li><li>(derogatory) A difficult woman; a bitch.</li></ol>
Sekreet	<i>noun</i><br><ol><li>(Uri) restroom, toilet</li></ol>
Sente	<i>noun</i><br><ol><li>(Uri) A group of cows that live in the same barn.</li></ol>
Si|sin|en|es|öise|mier|du|mi|mir|Ire|ois|öi|eure|im|er|min|eu|eus|ir|Si|dir|der|üüch|euse|di|mer|üse|ier|mich|diin|ene|siin|dich|din|si|'s|ine|Ene|i|öie|öis|dier|in|miin|ich|Ine|oise|üs|ire	<i>pron</i><br><ol><li>(polite) you (singular and plural)</li></ol>
Siite	<i>noun</i><br><ol><li>side</li><li>page</li></ol>
Sirte	<i>noun</i><br><ol><li>(Uri) milk used for cheesemaking</li></ol>
Sock|Socke|Socka|Söckli|Sockä	<i>noun</i><br><ol><li>sock</li></ol>
Sood	<i>noun</i><br><ol><li>(Uri) small pond, pool</li></ol>
Sou|Söi|Söili	<i>noun</i><br><ol><li>pig</li></ol>
Spatz|Spätzli|Spatze	<i>noun</i><br><ol><li>sparrow</li></ol>
Spiine	<i>noun</i><br><ol><li>(Uri) faucet, spigot</li></ol>
Spinnhoppegewëb	<i>noun</i><br><ol><li>(Uri) spiderweb</li></ol>
Spätzli	<i>noun</i><br><ol><li>darling, sweetheart</li><li>spätzli</li></ol>
Spään	<i>noun</i><br><ol><li>(Uri) woodchip; wood shaving</li></ol>
Staal	<i>noun</i><br><ol><li>(Uri) steel</li></ol>
Stafel	<i>name</i><br><ol><li>(Uri) The name of several fields in the Urseren area of Switzerland.</li></ol>
Stalatz	<i>noun</i><br><ol><li>(Uri) livelihood (financial means)</li></ol>
Steei	<i>noun</i><br><ol><li>(Uri) stone, rock</li></ol>
Stich|Stuch	<i>noun</i><br><ol><li>(Uri) stab, sting, prick</li></ol>
Stichel	<i>noun</i><br><ol><li>(Uri) pole, stake</li></ol>
Stier	<i>noun</i><br><ol><li>(Uri) male cattle</li></ol>
Stigli	<i>noun</i><br><ol><li>(Uri) stutterer</li></ol>
Stili	<i>noun</i><br><ol><li>silence, calm, hush, stillness</li></ol>
Straale	<i>noun</i><br><ol><li>(Uri, plural only) crystals</li></ol>
Strabatz	<i>noun</i><br><ol><li>(Uri) strain, exertion</li></ol>
Streuwi	<i>noun</i><br><ol><li>(Uri) litter (bedding for animals)</li></ol>
Striche	<i>noun</i><br><ol><li>(Uri) the teat of a cow</li></ol>
Stud	<i>noun</i><br><ol><li>(Uri) post, pole</li></ol>
Stueffe	<i>noun</i><br><ol><li>stage, level, rank</li><li>step, stair</li></ol>
Stund	<i>noun</i><br><ol><li>(Alsatian) hour</li></ol>
Stüpfer	<i>noun</i><br><ol><li>(Uri) thorn</li></ol>
Summer	<i>noun</i><br><ol><li>(Uri) summer</li></ol>
Summervogel|Summervögel	<i>noun</i><br><ol><li>(central and northern Switzerland) butterfly</li></ol>
Suppechlack	<i>noun</i><br><ol><li>(Uri, humorous) mouth</li></ol>
Suu	<i>noun</i><br><ol><li>(Uri) pig</li></ol>
Sëdel	<i>noun</i><br><ol><li>(Uri) chicken perch</li></ol>
Sëgisse	<i>noun</i><br><ol><li>(Uri) scythe</li></ol>
Sücke	<i>noun</i><br><ol><li>(Uri) puddle</li></ol>
Süülti	<i>noun</i><br><ol><li>(Uri) A small post.</li></ol>
Süüwfigler	<i>noun</i><br><ol><li>(Uri) pigsty</li></ol>
Taache	<i>noun</i><br><ol><li>(Uri) wick (porous cord that draws up liquid fuel for burning)</li></ol>
Taafele	<i>noun</i><br><ol><li>(Uri) portrait (painting of a person)</li></ol>
Tachtraupf	<i>noun</i><br><ol><li>(Uri) eaves</li></ol>
Tag|Täg|Tags	<i>noun</i><br><ol><li>day</li></ol>
Tagwen	<i>noun</i><br><ol><li>(Uri) compulsory labor, corvee</li></ol>
Tall	<i>noun</i><br><ol><li>(Uri) valley</li></ol>
Tanne	<i>noun</i><br><ol><li>(Uri) fir (conifer of the genus Abies)</li></ol>
Tanse	<i>noun</i><br><ol><li>(Uri) dance</li></ol>
Tatse	<i>noun</i><br><ol><li>(Uri) cup, mug</li></ol>
Tenn	<i>noun</i><br><ol><li>(Uri) threshing floor</li></ol>
Teste	<i>noun</i><br><ol><li>(Uri, anatomy) head</li></ol>
Thee|Tee|Theeli|Teeli	<i>noun</i><br><ol><li>tea</li></ol>
Theek|Theeke|Theekli	<i>noun</i><br><ol><li>schoolbag</li></ol>
Thönder	<i>noun</i><br><ol><li>big firework, big firecracker</li><li>(informal, by extension) a particularly big specimen of any kind (used more often for living or formerly living things)</li></ol>
Tiire	<i>noun</i><br><ol><li>(Uri) door</li></ol>
Tilbaum	<i>noun</i><br><ol><li>(Uri) rafter (sloped beam)</li></ol>
Tilischanz	<i>noun</i><br><ol><li>(Uri) mail truck</li></ol>
Tinder	<i>noun</i><br><ol><li>(Uri)</li></ol>
Tole	<i>noun</i><br><ol><li>(Uri) A small window on the wall of a haybarn.</li></ol>
Torn	<i>noun</i><br><ol><li>thorn</li><li>(figuratively) door hinge</li></ol>
Totz	<i>noun</i><br><ol><li>(Uri) A block or piece of wood.</li></ol>
Trinklere	<i>noun</i><br><ol><li>(Uri) cowbell</li></ol>
Triste	<i>noun</i><br><ol><li>(Uri) A haybarn.</li></ol>
Truel	<i>noun</i><br><ol><li>(Uri) curdled milk</li></ol>
Tröchni	<i>noun</i><br><ol><li>dryness</li><li>distant, aloof person</li></ol>
Trüegle	<i>noun</i><br><ol><li>(Uri) A small piece of wood with a hole drilled through, through which a hay rope is pulled.</li></ol>
Tschaagge	<i>noun</i><br><ol><li>(anatomy) hoof</li><li>(slang) foot</li></ol>
Tschidele	<i>noun</i><br><ol><li>(Uri, anatomy) skull</li></ol>
Tschifere	<i>noun</i><br><ol><li>(Uri, plural only, humorous) coins</li></ol>
Tscholi	<i>noun</i><br><ol><li>(Uri, derogatory) idiot, dummkopf</li></ol>
Tscholle	<i>noun</i><br><ol><li>(Uri) floe</li></ol>
Tschoope|Tschööpe	<i>noun</i><br><ol><li>(Valais, Unterwalden, Schwyz, Zug, Glarus, Graubünden, Zürich) jacket, coat</li><li>(Uri) dress (item of clothing worn by a woman)</li></ol>
Tschuggi	<i>noun</i><br><ol><li>(Uri) tuft</li></ol>
Tschumpel	<i>noun</i><br><ol><li>(vulgar) an asinine person, especially one that is easily exploited</li><li>(informal, by extension) a person in a position where they have to submit to exploitation, e.g. an intern</li></ol>
Tschuppe	<i>noun</i><br><ol><li>(Uri) pile, heap</li></ol>
Tschuuder	<i>noun</i><br><ol><li>(Uri) shudder, shiver</li></ol>
Tschägg	<i>noun</i><br><ol><li>(Uri) A speckled cow.</li></ol>
Tubel|Tübeli|Tuble	<i>noun</i><br><ol><li>(dated) stubborn behavior</li><li>(vulgar) idiot</li></ol>
Tuchel	<i>noun</i><br><ol><li>(Uri) large water pipe</li></ol>
Tuele	<i>noun</i><br><ol><li>(Uri) depression, indentation</li></ol>
Tulipaane	<i>noun</i><br><ol><li>tulip</li><li>fire lily, Lilium bulbiferum</li></ol>
Tunsch	<i>noun</i><br><ol><li>(Uri) The change in atmospheric pressure created by a powder avalanche.</li></ol>
Turner	<i>noun</i><br><ol><li>(Uri) A device used to turn cheese vats.</li></ol>
Tuub|Tuube|Tüübli	<i>noun</i><br><ol><li>pigeon, dove</li></ol>
Tuure	<i>noun</i><br><ol><li>(Uri) tower</li></ol><br><i>name</i><br><ol><li>(Uri, colloquial) Hospental Castle, a castle in Hospental, Switzerland.</li></ol>
Twër	<i>noun</i><br><ol><li>(Uri) westerly wind</li></ol>
Täsche	<i>noun</i><br><ol><li>(Uri) bag</li></ol>
Tätsch	<i>noun</i><br><ol><li>bang, explosion</li><li>clap, slap</li><li>(Uri) pavement</li></ol>
Täubi	<i>noun</i><br><ol><li>(Uri) anger</li></ol>
Türgge	<i>noun</i><br><ol><li>maize</li><li>cornflour, cornmeal</li><li>polenta</li></ol>
Tüüfel	<i>noun</i><br><ol><li>devil</li><li>(Christianity) The Devil; Satan</li></ol>
Tüüfi	<i>noun</i><br><ol><li>(Uri) depth</li></ol>
Tüür|Tüüre|Tüürli	<i>noun</i><br><ol><li>door</li></ol>
Uechs	<i>noun</i><br><ol><li>(Uri, anatomy) armpit</li></ol>
Underhaltig|Underhaltige	<i>noun</i><br><ol><li>conversation</li></ol>
Underschlacht	<i>noun</i><br><ol><li>(Uri) partition in a stable or barn</li></ol>
Urgroßvaters	<i>noun</i><br><ol><li>(obsolete) great-grandfather's</li></ol>
Urscheletall	<i>name</i><br><ol><li>(Uri) The Urseren, a valley in Uri, Switzerland</li></ol>
Vadoz	<i>name</i><br><ol><li>Vaduz (a town and municipality, the capital city of Liechtenstein)</li></ol>
Vakanz	<i>noun</i><br><ol><li>(Uri) holiday, vacation</li></ol>
Vatter|Vättere|Vatters	<i>noun</i><br><ol><li>father</li></ol>
Vee	<i>noun</i><br><ol><li>cattle</li></ol>
Vogel|Vögel|Vögeli	<i>noun</i><br><ol><li>bird</li></ol>
Vëh	<i>noun</i><br><ol><li>(Uri) cattle</li></ol>
Vësper	<i>noun</i><br><ol><li>(Uri, Christianity) Vespers (an afternoon Mass or service)</li></ol>
Waaffe	<i>noun</i><br><ol><li>(Uri) tool</li></ol>
Wagge	<i>noun</i><br><ol><li>(Uri) cow (female cattle)</li></ol>
Wald|Wälder|Wäldli	<i>noun</i><br><ol><li>woods, forest</li></ol>
Wasser	<i>noun</i><br><ol><li>(Basel, Alsatian) water</li></ol>
Wassermoli	<i>noun</i><br><ol><li>(Uri) Alpine salamander, Salamandra atra</li></ol>
Weisel	<i>noun</i><br><ol><li>(Uri, anatomy) esophagus, especially of animals</li></ol>
Weli	<i>noun</i><br><ol><li>(Uri) choice, option</li></ol>
Welo|Welööli	<i>noun</i><br><ol><li>bicycle</li></ol>
Weri	<i>noun</i><br><ol><li>(Uri) defense, resistance</li></ol>
Wespi	<i>noun</i><br><ol><li>(Uri) wasp</li></ol>
Wii	<i>noun</i><br><ol><li>wine</li></ol>
Wiis|Wiise	<i>noun</i><br><ol><li>way, manner</li><li>meadow</li></ol>
Worb|Wirbel	<i>noun</i><br><ol><li>(Uri) the handle of a scythe</li></ol>
Wulche|Wülchli	<i>noun</i><br><ol><li>cloud</li></ol>
Wunsch|Wünschli	<i>noun</i><br><ol><li>wish</li></ol>
Wält|Wälte|Wältli	<i>noun</i><br><ol><li>world</li></ol>
Wäntele	<i>noun</i><br><ol><li>(Uri) bedbug</li></ol>
Wüüre|Würme|Würem	<i>noun</i><br><ol><li>(Uri) worm</li></ol>
Xämpeli	<i>noun</i><br><ol><li>(Uri) brief story, anecdote</li></ol>
Zaa	<i>noun</i><br><ol><li>tooth</li></ol>
Zaugge	<i>noun</i><br><ol><li>(Uri) spout of a container</li></ol>
Zeewe	<i>noun</i><br><ol><li>(Uri, anatomy) toe</li></ol>
Zeine	<i>noun</i><br><ol><li>(Uri) basket</li></ol>
Zigaare	<i>noun</i><br><ol><li>(Uri) cigar</li></ol>
Ziil	<i>noun</i><br><ol><li>goal, target, destination</li></ol>
Ziischtig|Zischtig	<i>noun</i><br><ol><li>Tuesday</li></ol>
Ziisse	<i>noun</i><br><ol><li>(Uri) the stream of milk produced by the udder</li></ol>
Ziit|Ziitli|Ziite	<i>noun</i><br><ol><li>time</li></ol>
Zine	<i>noun</i><br><ol><li>roof terrace</li></ol>
Zit|Zite|Zitli	<i>noun</i><br><ol><li>time</li></ol>
Zotter	<i>noun</i><br><ol><li>(Uri) thug, rogue</li></ol>
Zuebueb	<i>noun</i><br><ol><li>(Uri) A dairyman's assistant.</li></ol>
Zutz	<i>noun</i><br><ol><li>(mildly derogatory) a toothless old person</li><li>(mildly derogatory) the youngest child in a family</li></ol>
Zweier	<i>noun</i><br><ol><li>(Uri) twin</li></ol>
Zwächele	<i>noun</i><br><ol><li>(Uri) towel</li></ol>
Zäiche|Zäieli	<i>noun</i><br><ol><li>sign, character, symbol; feature</li></ol>
Zältli	<i>noun</i><br><ol><li>(Zürich) sweet, candy</li></ol>
Zänni	<i>noun</i><br><ol><li>(Uri) squaller, loudmouth, ranter</li></ol>
Zëche	<i>noun</i><br><ol><li>tick</li><li>louse</li></ol>
Züri	<i>name</i><br><ol><li>Zurich (a city in Switzerland)</li><li>Zurich (a canton of Switzerland)</li></ol>
Züripieter	<i>noun</i><br><ol><li>Zuricher (someone from the canton of Zurich)</li></ol>
aaber	<i>adj</i><br><ol><li>snow-free, snowless</li></ol>
aabere	<i>verb</i><br><ol><li>(Uri, of snow) to thaw</li></ol>
aabüüte|büütet aa|aapotte	<i>verb</i><br><ol><li>to offer</li></ol>
aachoo|chunt aa	<i>verb</i><br><ol><li>to arrive</li></ol>
aagaa|aaggange|gaat aa	<i>verb</i><br><ol><li>(intransitive) to start</li><li>(transitive) to concern, to have to do with</li></ol>
aaluege|lueget aa|aaglueget	<i>verb</i><br><ol><li>to look at, observe</li></ol>
aamälde|aaggmäldet|aamäldet	<i>verb</i><br><ol><li>to announce, declare</li><li>to register</li></ol>
aapasse|aapassti|aapasst	<i>verb</i><br><ol><li>(reflexive) to adapt, adjust</li><li>(reflexive) to conform, to fit in</li></ol>
aaschtändig|aaschtändiger|aaschtändigscht	<i>adj</i><br><ol><li>decent, proper, respectable</li></ol>
aaträffe|aatroffe|träfft aa	<i>verb</i><br><ol><li>to find</li></ol>
aatue|aataa|aatuet	<i>verb</i><br><ol><li>to do (something for/to someone)</li></ol>
aatäigge|aatäigget|täigget aa	<i>verb</i><br><ol><li>to make into a dough; to dough</li><li>to launch, get underway; to do, undertake</li></ol>
aaööde|aaöödet|aagöödet	<i>verb</i><br><ol><li>to bore</li></ol>
abe	<i>adv</i><br><ol><li>down, downwards</li></ol>
abebringe|abepraacht|bringt abe	<i>verb</i><br><ol><li>(transitive) to bring (something) down, to take down, carry down</li></ol>
abfahre|fahrt ab|abgfahre	<i>verb</i><br><ol><li>to leave, to drive</li></ol>
abnää|nint ab|abgnaa	<i>verb</i><br><ol><li>(transitive) to take off</li><li>to thin, diminish</li><li>to believe</li><li>to administer (an oath)</li></ol>
acht	<i>num</i><br><ol><li>eight</li></ol>
ain|eis|ais|ai	<i>num</i><br><ol><li>one</li></ol>
aju	<i>noun</i><br><ol><li>(Carcoforo) mother</li></ol>
alee	<i>intj</i><br><ol><li>come on, let's go</li></ol>
allei	<i>adv</i><br><ol><li>alone</li></ol>
allpott	<i>adv</i><br><ol><li>often, all the time</li></ol>
alls	<i>pron</i><br><ol><li>(Carcoforo) everything, all</li></ol>
alltz	<i>pron</i><br><ol><li>(Formazza) everything, all</li></ol>
allwääg	<i>adv</i><br><ol><li>in any case</li><li>presumably</li><li>anytime; constantly</li></ol>
allz	<i>pron</i><br><ol><li>(Issime) everything, all</li></ol>
altu	<i>adj</i><br><ol><li>(Formazza) old</li></ol>
alz	<i>pron</i><br><ol><li>(Gressoney) everything, all</li></ol>
alzit	<i>adv</i><br><ol><li>(Rimella and Campello Monti) always</li></ol>
amigs	<i>adv</i><br><ol><li>every time, each time, regularly</li><li>(regional) earlier, in the past</li><li>(regional) always</li></ol>
appe	<i>adv</i><br><ol><li>(Uri) from here</li></ol>
areise	<i>verb</i><br><ol><li>(Uri) to prepare, equip</li></ol>
arig	<i>adj</i><br><ol><li>(Uri) clever, deft</li></ol>
artuffula	<i>noun</i><br><ol><li>(Carcoforo) potato</li></ol>
asse	<i>verb</i><br><ol><li>(Carcoforo) to eat</li></ol>
assu	<i>verb</i><br><ol><li>(Rimella and Campello Monti) to eat</li></ol>
astütze	<i>verb</i><br><ol><li>(Uri) to bring a drinking glass to one's mouth</li></ol>
attu	<i>noun</i><br><ol><li>(Issime, Carcoforo, Formazza) father, dad</li></ol>
attò	<i>noun</i><br><ol><li>(Gressoney) father</li></ol>
au	<i>adv</i><br><ol><li>also, too</li></ol>
azünte	<i>verb</i><br><ol><li>to light</li><li>to ignite, set on fire</li></ol>
baum	<i>noun</i><br><ol><li>(Issime, Carcoforo) tree</li></ol>
beibe	<i>verb</i><br><ol><li>(Uri) to ruminate (chew cud)</li></ol>
beite	<i>verb</i><br><ol><li>(Uri) to wait</li></ol>
bem	<i>noun</i><br><ol><li>(Rimella and Campello Monti) tree</li></ol>
benkle	<i>verb</i><br><ol><li>(Uri) to play pinochle</li></ol>
bercha	<i>verb</i><br><ol><li>(Uri) Aphetic form of ubercha</li></ol>
biigewiis	<i>adv</i><br><ol><li>en masse, lots of, in heaps</li></ol>
biise	<i>verb</i><br><ol><li>(Uri, of livestock) To run around wildly.</li></ol>
bisch du ghüroote	<i>phrase</i><br><ol><li>(familiar or informal) are you married?</li></ol>
bisch du gläubig	<i>phrase</i><br><ol><li>(familiar) are you religious?</li></ol>
bisch du religiös	<i>phrase</i><br><ol><li>(familiar) are you religious?</li></ol>
bisch du single	<i>phrase</i><br><ol><li>(familiar) Synonym of bisch single?</li></ol>
bisch single	<i>phrase</i><br><ol><li>(familiar) are you single?</li></ol>
blaaw	<i>adj</i><br><ol><li>(Uri) blue</li></ol>
bleewe	<i>verb</i><br><ol><li>(Uri) to dye blue</li></ol>
bliibe|bliibti|plibe|bliibt	<i>verb</i><br><ol><li>to stay, remain</li></ol>
bloos	<i>adj</i><br><ol><li>naked, bare</li></ol><br><i>adv</i><br><ol><li>merely, only</li></ol>
bloß	<i>adv</i><br><ol><li>merely, just, only</li></ol>
blöösse	<i>verb</i><br><ol><li>(literary, transitive) to bare, to lay bare</li></ol>
blüeje	<i>verb</i><br><ol><li>to bloom, blossom</li></ol>
bopju	<i>verb</i><br><ol><li>(Carcoforo) to play</li></ol>
briegge|priegget|briegget	<i>verb</i><br><ol><li>to grimace</li><li>to cry (especially quietly)</li></ol>
bringe|bringt|praacht	<i>verb</i><br><ol><li>to bring</li></ol>
briöder	<i>noun</i><br><ol><li>(Rimella and Campello Monti) brother</li></ol>
brot	<i>noun</i><br><ol><li>(Formazza) bread</li></ol>
broud	<i>noun</i><br><ol><li>(Carcoforo) bread</li></ol>
bruat	<i>noun</i><br><ol><li>(Issime) bread</li></ol>
bruder	<i>noun</i><br><ol><li>(Issime) brother</li></ol>
brueder	<i>noun</i><br><ol><li>(Gressoney) brother</li></ol>
bruuche|pruucht|bruucht	<i>verb</i><br><ol><li>to use</li><li>to use up</li><li>to need</li></ol>
bruun|bruunschte|bruuner	<i>adj</i><br><ol><li>brown</li></ol>
bròt	<i>noun</i><br><ol><li>(Gressoney) bread</li></ol>
bröder	<i>noun</i><br><ol><li>(Formazza) brother</li></ol>
bröt	<i>noun</i><br><ol><li>(Rimella and Campello Monti) bread</li></ol>
bröötle|pröötlet|bröötlet	<i>verb</i><br><ol><li>to roast, bake</li></ol>
brüele|brüelet|prüelet	<i>verb</i><br><ol><li>to roar, to shout</li><li>to bawl, cry</li></ol>
brünstele	<i>verb</i><br><ol><li>(Uri) to undergo necrosis</li></ol>
brütsch	<i>adj</i><br><ol><li>(Uri) healthy, hearty, happy</li></ol>
bueb	<i>noun</i><br><ol><li>(Gressoney) son</li></ol>
buschur	<i>intj</i><br><ol><li>(Alsatian) hello, good day</li></ol>
buue|puue	<i>verb</i><br><ol><li>(Uri) to build</li></ol>
bäcke|päcket|bäcket|bëcke	<i>verb</i><br><ol><li>to chop</li><li>to cough (especially with a dry or fitful cough); to hack</li></ol>
bés z'néschta	<i>intj</i><br><ol><li>(Gressoney) goodbye, see you later, until next time</li></ol>
bërsche	<i>verb</i><br><ol><li>(Uri) to gasp, moan</li></ol>
bìn	<i>verb</i><br><ol><li>(Alsatian) am (first person singular)</li></ol>
bìsch	<i>verb</i><br><ol><li>(Alsatian) are (second person singular)</li></ol>
böim	<i>noun</i><br><ol><li>(Formazza) tree</li></ol>
cha|chëmte|chëmi|chiem|chëme|chiemesch|chëmet|chunsch|chuume|chëmtesch|chëmesch|chëmt|chëmtet|chemmesch|chemm|chemme|chu|chëmti|chieme|chemmet|chiemi|chunt|chëm|chemmi	<i>verb</i><br><ol><li>(Uri) to come</li></ol>
chalt	<i>adj</i><br><ol><li>(Formazza, Uri) cold</li></ol>
charre	<i>verb</i><br><ol><li>(Uri) to breath with difficulty, wheeze</li></ol>
chatza	<i>noun</i><br><ol><li>(Carcoforo, Formazza) cat</li></ol>
chatzu	<i>noun</i><br><ol><li>(Issime) cat</li></ol>
chatzò	<i>noun</i><br><ol><li>(Gressoney) cat</li></ol>
cheemen	<i>verb</i><br><ol><li>(Issime) to come</li></ol>
cheisch	<i>noun</i><br><ol><li>(Carcoforo) cheese</li></ol>
cheme	<i>verb</i><br><ol><li>(Carcoforo) to come</li></ol>
chesch	<i>noun</i><br><ol><li>(Gressoney) cheese</li></ol>
chiesch	<i>noun</i><br><ol><li>(Issime) cheese</li></ol>
chifle	<i>verb</i><br><ol><li>(Uri) to scold</li></ol>
chiibe	<i>verb</i><br><ol><li>(Uri) to scold, chide</li></ol>
chiide	<i>verb</i><br><ol><li>(Uri) to sprout, germinate (especially regarding potatoes)</li></ol>
chiise	<i>verb</i><br><ol><li>(informal, Zürich, St. Gallen) to vomit</li></ol>
chlaage|gchlagt|chlaagt	<i>verb</i><br><ol><li>to mourn, lament</li><li>to moan, whine, complain</li></ol>
chlii|chliini|chly|chlei|chliiner|chliine|chli|chliins|chliinscht	<i>adj</i><br><ol><li>small, little</li></ol>
chlupfig	<i>adj</i><br><ol><li>(Uri) fearful, afraid</li></ol>
chluttere	<i>verb</i><br><ol><li>(Uri, onomatopoeia) to clink, clatter</li></ol>
chlättere|chlättert|klätteret|chlätteret|gchlätteret	<i>verb</i><br><ol><li>to climb</li></ol>
chnautsche	<i>verb</i><br><ol><li>(Uri) to bite, crunch, chew loudly</li></ol>
chneiste	<i>verb</i><br><ol><li>(Uri) to spray</li></ol>
chnuuschte	<i>verb</i><br><ol><li>(informal) to work hard</li></ol>
cho|chëmte|chëmi|chiem|chëme|chiemesch|chëmet|chunsch|chuume|chëmtesch|chëmesch|chëmt|chëmtet|chemmesch|chemm|chemme|chu|chëmti|chieme|chemmet|chiemi|chunt|chëm|chemmi	<i>verb</i><br><ol><li>(Formazza, Realp (Uri)) to come</li></ol>
choalt	<i>adj</i><br><ol><li>(Gressoney, Issime) cold</li></ol>
cholt	<i>adj</i><br><ol><li>(Carcoforo) cold</li></ol>
chomu	<i>verb</i><br><ol><li>(Rimella and Campello Monti) to come</li></ol>
choo|cheem|chunt	<i>verb</i><br><ol><li>to come</li></ol>
chrud	<i>noun</i><br><ol><li>(Carcoforo) grass</li></ol>
chrääe|chräät|gchrääet	<i>verb</i><br><ol><li>to crow</li></ol>
chrësme	<i>verb</i><br><ol><li>(Uri) to creep, crawl</li></ol>
chrüt	<i>noun</i><br><ol><li>(Rimella and Campello Monti) grass</li></ol>
chuele	<i>verb</i><br><ol><li>(Uri, intransitive) to become cool</li></ol>
chuute	<i>verb</i><br><ol><li>(Uri) to wheeze, pant</li></ol>
chàzzà	<i>noun</i><br><ol><li>(Rimella and Campello Monti) cat</li></ol>
chätsche	<i>verb</i><br><ol><li>to chew (in particular loudly or with little success (as on a chewing gum))</li></ol>
chääs	<i>noun</i><br><ol><li>(Formazza) cheese</li></ol>
chéeme	<i>verb</i><br><ol><li>(Gressoney) to come</li></ol>
chélte	<i>adj</i><br><ol><li>(Rimella and Campello Monti) cold</li></ol>
chìŝch	<i>noun</i><br><ol><li>(Rimella and Campello Monti) cheese</li></ol>
chöne|chëmte|chëmi|chiem|chëme|chiemesch|chönti|chëmet|chunsch|chuume|chëmtesch|cha|chëmesch|chëmt|chëmtet|chemmesch|chemm|chemme|chu|chëmti|chieme|chemmet|chöi|chiemi|chunt|chëm|chemmi	<i>verb</i><br><ol><li>(modal) can; to be able</li></ol>
chönne|chëmte|chëmi|chönn|chasch|chiem|chëme|chiemesch|chëmet|chunsch|chönnesch|chuume|chönnet|chëmtesch|cha|chëmesch|chëmt|chëmtet|chemmesch|chönnti|chat|chemm|chönntesch|chemme|chönnt|chu|chëmti|chieme|chemmet|chann|chönnte|chiemi|chunt|chönntet|chëm|chemmi|chönni	<i>verb</i><br><ol><li>(Uri) Alternative form of chöne</li></ol>
chüüwe	<i>verb</i><br><ol><li>(Uri) to chew</li></ol>
d|s|des|de (before a consonant)|ds|die|em|de (before a consonant, including h)|dr|de|d'|'s|den|at the beginning of a sentence or verse: S'|der|das|dem	<i>article</i><br><ol><li>(definite) the</li></ol>
d'r|des|de (before a consonant)|ds|d'- (as in d'Chinder)|de (before a consonant, including h)|dr|d'm|d'|de|'s|den|at the beginning of a sentence or verse: S'|die|das|dem|der|d's	<i>article</i><br><ol><li>(definite) the</li></ol>
dangge|danggt	<i>verb</i><br><ol><li>to thank</li></ol><br><i>intj</i><br><ol><li>thank you</li></ol>
dankche	<i>intj</i><br><ol><li>(Carcoforo) thank you</li></ol>
dasis	<i>abbrev</i><br><ol><li>Contraction of dass + i + es.</li></ol>
daß	<i>conj</i><br><ol><li>that</li></ol>
de|des|de (before a consonant)|de (before a consonant, including h)|d'|den|'s|at the beginning of a sentence or verse: S'|die|das|dem|der	<i>article</i><br><ol><li>(definite) the</li></ol>
de Lombatzi mache	<i>verb</i><br><ol><li>(Uri, idiomatic) to chatter loudly, especially in school</li></ol>
deet	<i>adv</i><br><ol><li>there</li></ol>
delekat	<i>adj</i><br><ol><li>(Uri) delicate, delicious</li></ol>
der|des|de (before a consonant)|de (before a consonant, including h)|d'|de|'s|den|at the beginning of a sentence or verse: S'|die|das|dem	<i>article</i><br><ol><li>(definite) the</li></ol>
diin|diner|dine|diim|dini|diis	<i>det</i><br><ol><li>your (singular)</li></ol>
dine	<i>adv</i><br><ol><li>inside</li></ol>
dobe	<i>adv</i><br><ol><li>above, aloft, up, upstairs</li></ol>
dontschtag	<i>noun</i><br><ol><li>(Formazza) Thursday</li></ol>
druus	<i>adv</i><br><ol><li>out of it, out of that/them</li><li>hence, from it, from that/them</li></ol>
drüü|drü	<i>num</i><br><ol><li>(Zürich) three</li><li>(Aargau, Appenzell) three</li></ol>
du|sin|en|es|öise|mier|du|mi|mir|Ire|ois|öi|eure|im|er|min|eu|eus|ir|Si|dir|der|üüch|euse|di|mer|üse|ier|mich|diin|ene|siin|dich|din|si|'s|ine|Ene|i|öie|öis|dier|in|miin|ich|Ine|oise|üs|ire	<i>pron</i><br><ol><li>thou, you</li></ol>
e|style="text-align:left|enere|e|en|es|ene|eme|emene|e (before a consonant)|es (before a consonant)	<i>article</i><br><ol><li>(indefinite) a/an</li></ol>
ebe	<i>adj</i><br><ol><li>flat, horizontal</li><li>smooth</li><li>utter, downright</li><li>appropriate</li></ol><br><i>adv</i><br><ol><li>totally, completely</li><li>properly, suitably</li></ol>
eerig	<i>adj</i><br><ol><li>(Uri) Made of iron or bronze.</li></ol>
effél	<i>noun</i><br><ol><li>(Gressoney) apple</li></ol>
eintlef|einlef	<i>num</i><br><ol><li>(Uri) eleven</li></ol>
eju	<i>noun</i><br><ol><li>(Issime) mother</li></ol>
ejò	<i>noun</i><br><ol><li>(Gressoney) mother</li></ol>
eläi	<i>adv</i><br><ol><li>alone</li></ol>
emaal	<i>adv</i><br><ol><li>once</li></ol>
en|style="text-align:left|e|enere|en|es|ene|eme|emene|e (before a consonant)|es (before a consonant)	<i>article</i><br><ol><li>(indefinite) a, an</li></ol>
en Guete	<i>intj</i><br><ol><li>bon appétit</li></ol>
entleene	<i>verb</i><br><ol><li>(Uri) to borrow</li></ol>
epfel	<i>noun</i><br><ol><li>(Formazza) apple</li></ol>
epfil	<i>noun</i><br><ol><li>(Carcoforo) apple</li></ol>
epper	<i>pron</i><br><ol><li>(Uri) someone, somebody</li></ol>
er|sin|en|es|öise|mier|du|mi|mir|Ire|ois|öi|eure|im|er|min|eu|eus|ir|Si|dir|der|üüch|euse|di|mer|üse|ier|mich|diin|ene|siin|dich|din|si|'s|ine|Ene|i|öie|öis|dier|in|miin|ich|Ine|oise|üs|ire	<i>pron</i><br><ol><li>(personal) he; it</li></ol>
erbe	<i>verb</i><br><ol><li>(Uri) to inherit</li></ol>
erbroche	<i>adj</i><br><ol><li>(Uri) afflicted with a hernia</li></ol>
ernüüsse	<i>verb</i><br><ol><li>(Uri) to sneeze</li></ol>
es|enere|sin|en|es|öise|mier|du|mi|eme|mir|Ire|ois|öi|eure|im|er|min|eu|eus|ire|Si|dir|ir|der|üüch|euse|di|mer|üse|es (before a consonant)|ier|mich|diin|ene|siin|dich|din|si|'s|ine|Ene|i|öie|öis|dier|in|style="text-align:left|e|miin|ich|Ine|oise|emene|üs|e (before a consonant)	<i>pron</i><br><ol><li>(personal) it</li></ol>
essen	<i>verb</i><br><ol><li>(Issime) to eat</li></ol>
etze	<i>verb</i><br><ol><li>(Uri) to graze (eat grass from a pasture)</li></ol>
faa|fëë|fat|fängi|gfange|fäng|fänge|fät|fätti|fieng|fiengi|fach|fätte|fäänt|faahe|fättesch|fänget|fängesch|fëëet|fiengesch|fängt|fienge|fëëesch|fienget|fëëe|fättet|faasch	<i>verb</i><br><ol><li>(Uri) to catch</li></ol>
faare|gfaare|faart	<i>verb</i><br><ol><li>to go</li><li>to drive; to ride</li></ol>
fater	<i>noun</i><br><ol><li>(Carcoforo) father</li></ol>
fellig	<i>adv</i><br><ol><li>(Uri) very, totally</li></ol>
fergälts Got	<i>intj</i><br><ol><li>(Formazza) thank you</li></ol>
flie	<i>verb</i><br><ol><li>(Uri) to flee</li></ol>
flüenig	<i>adj</i><br><ol><li>(Uri) rugged, jagged</li></ol>
foif	<i>num</i><br><ol><li>five</li></ol>
folge|gfolget|folget	<i>verb</i><br><ol><li>to obey, to be obedient</li></ol>
freuwe	<i>verb</i><br><ol><li>(Uri) to be happy</li></ol>
fritog	<i>noun</i><br><ol><li>(Carcoforo) Friday</li></ol>
frittag	<i>noun</i><br><ol><li>(Gressoney, Formazza) Friday</li></ol>
frontog	<i>noun</i><br><ol><li>(Carcoforo) Thursday</li></ol>
frou	<i>noun</i><br><ol><li>woman</li><li>wife</li></ol>
frääge	<i>verb</i><br><ol><li>(Uri) to ask</li></ol>
fròntag	<i>noun</i><br><ol><li>(Gressoney) Thursday</li></ol>
fröschene	<i>verb</i><br><ol><li>(Uri) to hoop a barrel</li></ol>
früe|früescht|früener	<i>adv</i><br><ol><li>early</li></ol>
fuks	<i>noun</i><br><ol><li>(Formazza) fox</li></ol>
fuksch	<i>noun</i><br><ol><li>(Carcoforo) fox</li></ol>
fääle|fäälti|fäält|gfäält	<i>verb</i><br><ol><li>to lack</li><li>to be the matter, to be wrong</li></ol>
fénef	<i>num</i><br><ol><li>(Alsatian) five</li></ol>
féri	<i>adv</i><br><ol><li>(Formazza) always</li></ol>
fëchte	<i>verb</i><br><ol><li>(Uri) to beg</li></ol>
fëret	<i>adv</i><br><ol><li>(Uri) last year</li></ol>
fòcks	<i>noun</i><br><ol><li>(Gressoney) fox</li></ol>
fümmala	<i>noun</i><br><ol><li>woman</li><li>wife</li></ol>
fürchte	<i>verb</i><br><ol><li>(Uri) to fear</li></ol>
fürig	<i>adj</i><br><ol><li>(Uri) peculiar, strange</li></ol>
g'mai	<i>noun</i><br><ol><li>(Carcoforo) municipality</li></ol>
gaa|gienget|gëëet|gëëesch|ggange|gëëe|gaasch|gäti|giengi|gäänt|gaat|gëënt|gëë|gange|gängi|gäng|gätet|gënt|gängesch|giengesch|gienge|gieng|gäte|gang|gät|gänt|gätesch	<i>verb</i><br><ol><li>to go</li></ol>
galt	<i>adj</i><br><ol><li>(Uri, of cows) Not milch.</li></ol>
ganz	<i>pron</i><br><ol><li>(Gressoney) all, everything</li></ol>
ganza	<i>adv</i><br><ol><li>(Carcoforo) always</li></ol>
gaume	<i>verb</i><br><ol><li>(Uri) to guard, watch, herd</li></ol>
gautsche	<i>verb</i><br><ol><li>(Uri) to ripple, burble, splash</li></ol>
gebüesmet	<i>adj</i><br><ol><li>(Uri, especially of livestock) afflicted with a hernia</li></ol>
gege	<i>prep</i><br><ol><li>against</li></ol><br><i>adv</i><br><ol><li>towards, at around, at about (temporally)</li></ol>
geheimsch	<i>adj</i><br><ol><li>(Uri) friendly</li></ol>
geheiwig	<i>adj</i><br><ol><li>(Uri, of weather) gloomy, hazy</li></ol>
gehirme	<i>verb</i><br><ol><li>(Uri) to rest, relax, especially after carrying a load or burden.</li></ol>
gehöörig	<i>adj</i><br><ol><li>(Uri) proper</li></ol>
gelengge	<i>verb</i><br><ol><li>(Uri) to obtain, acquire</li></ol>
geng	<i>adv</i><br><ol><li>(Gressoney) always</li></ol>
geriénts	<i>adj</i><br><ol><li>(Rimella and Campello Monti) green</li></ol>
gerëch	<i>adj</i><br><ol><li>(Uri) ready</li></ol>
gerëche	<i>verb</i><br><ol><li>(Uri) to make ready</li><li>(Uri) to repair</li></ol>
gerüerig	<i>adj</i><br><ol><li>(Uri) active, lively</li></ol>
geschende	<i>verb</i><br><ol><li>(Uri, transitive) to damage, harm</li></ol>
geschëhe	<i>verb</i><br><ol><li>(Uri) to occur, happen</li></ol>
gespriggelet	<i>adj</i><br><ol><li>(Uri) speckled</li></ol>
gespüre	<i>verb</i><br><ol><li>(Uri) to track, trace, sleuth</li></ol>
gestorig	<i>adj</i><br><ol><li>(Uri) lightly blanketed in snow</li></ol>
gesturm|gesture	<i>adj</i><br><ol><li>(Uri) disoriented, drowsy</li></ol>
gestuudig	<i>adj</i><br><ol><li>(Uri) overgrown with undergrowth</li></ol>
gfroura	<i>noun</i><br><ol><li>(Carcoforo) ice cream</li></ol>
ghaa	<i>verb</i><br><ol><li>had</li></ol>
gheie|gheit|gheiti	<i>verb</i><br><ol><li>to fall</li><li>to become</li></ol>
ghööre|ghöört	<i>verb</i><br><ol><li>to hear</li></ol>
giéte nàcht	<i>intj</i><br><ol><li>(Rimella and Campello Monti) good evening</li></ol>
giöte tàg	<i>intj</i><br><ol><li>(Rimella and Campello Monti) good day, hello, good afternoon</li></ol>
glateliere	<i>verb</i><br><ol><li>(Uri) to congratulate</li></ol>
glenze	<i>verb</i><br><ol><li>(Uri) to shine, gleam, sparkle</li></ol>
gli|glii|gly	<i>adv</i><br><ol><li>soon</li></ol>
gliich|glich	<i>adj</i><br><ol><li>identical (being the same entity)</li><li>equal (being different entities that are equivalent in all (relevant) regards)</li><li>(colloquial, predicative) unimportant (to the speaker)</li></ol><br><i>adv</i><br><ol><li>equally</li><li>still; nevertheless; notwithstanding</li><li>(regional, rare) Alternative form of gli: soon</li></ol>
gliichfalls	<i>adv</i><br><ol><li>likewise</li></ol>
glunzle	<i>verb</i><br><ol><li>(Uri) to blink, squint</li></ol>
glänze|glänzt|gglänzt	<i>verb</i><br><ol><li>to glisten, gleam, sparkle</li></ol>
gnueg	<i>adv</i><br><ol><li>enough</li></ol>
go|ggange|goo|goh|gieng|goht	<i>particle</i><br><ol><li>to (particle follows after verbs (such as go, come); placed before infinitive)</li></ol><br><i>prep</i><br><ol><li>(dated) to, towards (indicating a direction; nowaday often replaced by uf, nach)</li><li>to (used a verb preposition; in combination with verbs and often reduplicated. See particle for more)</li></ol><br><i>verb</i><br><ol><li>(used as an auxiliary time verb for perfect (tense) sentences; placed after verb sii (“being”) and causing an omission of participle gange (“went”))</li><li>to go, to walk, step (movement/motion indicating starting point, direction, aim and purpose)</li><li>to go away, walk away , step away</li><li>to enter; to step in(side), walk in(side), step in(side) (+ inne (“in(side)”) (ine (“id”)); a room, house, building)</li><li>to be in motion, to work</li><li>to flow (indicating flow direction of a river, stream, creek)</li></ol>
goots Ine besser	<i>phrase</i><br><ol><li>(polite) are you feeling better?</li></ol>
goots Ine guet	<i>phrase</i><br><ol><li>(polite) are you OK?</li></ol>
goots dr besser	<i>phrase</i><br><ol><li>(familiar) are you feeling better?</li></ol>
goots dr guet	<i>phrase</i><br><ol><li>(familiar) are you OK?</li></ol>
graase|graast|graasä	<i>verb</i><br><ol><li>to graze</li></ol>
graaw	<i>adj</i><br><ol><li>(Uri) gray</li></ol>
grad	<i>adv</i><br><ol><li>now, at the moment</li><li>exactly</li></ol>
gras	<i>noun</i><br><ol><li>(Gressoney, Formazza) grass</li></ol>
grien	<i>adj</i><br><ol><li>(Gressoney, Carcoforo) green</li></ol>
griine	<i>verb</i><br><ol><li>(Uri) to cry (especially of children)</li></ol>
gros	<i>noun</i><br><ol><li>(Carcoforo) grass</li></ol>
groß	<i>adj</i><br><ol><li>great</li></ol>
gruupe	<i>verb</i><br><ol><li>(Uri) to crouch, crouch down</li></ol>
gruuse	<i>verb</i><br><ol><li>(Uri) to be afraid</li></ol>
gruusig|gruusigschte|am gruusigschte|gruusiger|grusigschte|am grusigschte|grusiger|grusig	<i>adj</i><br><ol><li>gross, disgusting</li></ol><br><i>adv</i><br><ol><li>(slang) Intensifier.</li></ol>
gruuss	<i>adj</i><br><ol><li>(Uri) very large</li></ol>
grääwele	<i>verb</i><br><ol><li>(Uri, intransitive) to mold</li></ol>
gréén	<i>adj</i><br><ol><li>(Formazza) green</li></ol>
grüen	<i>adj</i><br><ol><li>(Uri) green</li></ol>
grüesse|ggrüesst|grüessti|grüesst	<i>verb</i><br><ol><li>to greet</li></ol>
grüezi	<i>intj</i><br><ol><li>hello</li></ol>
grün	<i>adj</i><br><ol><li>(Issime) green</li></ol>
gsee|gseet|gseht|gseh|g’see|g’seet	<i>verb</i><br><ol><li>to see</li></ol>
gsë|gsëtet|gsët|gsächt|gsächi|gsächesch|gsächte|gsäche|gsächet|gsëtesch|gsëti|gsëte|gsësch|gsäch|gsächtet|gsënt|gsächti	<i>verb</i><br><ol><li>(Uri) to see</li></ol>
guet|gueti|guets|besser|guete|bescht	<i>adj</i><br><ol><li>good</li></ol>
guetemorge	<i>intj</i><br><ol><li>(Gressoney) good morning</li></ol>
guetenoabe	<i>intj</i><br><ol><li>(Gressoney) good evening</li></ol>
guetnacht	<i>intj</i><br><ol><li>(Gressoney) good night</li></ol>
guggse	<i>verb</i><br><ol><li>(Uri, of snowstorms) to rage (storm violently)</li></ol>
gumpe	<i>verb</i><br><ol><li>to leap, jump</li></ol>
guot nacht	<i>intj</i><br><ol><li>(Carcoforo) good night</li></ol>
guoten oband	<i>intj</i><br><ol><li>(Carcoforo) good evening</li></ol>
guoten tog	<i>intj</i><br><ol><li>(Carcoforo) good day, hello, good afternoon</li></ol>
gut nacht	<i>intj</i><br><ol><li>(Issime) good night</li></ol>
guten oabe	<i>intj</i><br><ol><li>(Issime) good evening</li></ol>
guten tag	<i>intj</i><br><ol><li>(Issime) good day, hello, good afternoon</li></ol>
gwüss	<i>adj</i><br><ol><li>certain</li></ol><br><i>adv</i><br><ol><li>certainly, surely</li></ol>
gäh	<i>verb</i><br><ol><li>to give</li></ol>
gääbig	<i>adj</i><br><ol><li>(Uri) pleasant, enjoyable</li></ol>
génh	<i>adv</i><br><ol><li>(Issime) always</li></ol>
gë|git|gëbe|gëb|gënt|gisch|giibe|gëbt|ggë|gëbtesch|gëbtet|gëbte|gib|gëbti|gëbesch|gëbi|gëbet	<i>verb</i><br><ol><li>(Uri) to give</li></ol>
göt nacht	<i>intj</i><br><ol><li>(Formazza) good night</li></ol>
götacho	<i>intj</i><br><ol><li>(Formazza) welcome</li></ol>
göti nacht	<i>intj</i><br><ol><li>(Formazza) Alternative form of göt nacht</li></ol>
götä abä	<i>intj</i><br><ol><li>(Formazza) good evening</li></ol>
götä tag	<i>intj</i><br><ol><li>(Formazza) good day, hello, good afternoon</li></ol>
güxle	<i>verb</i><br><ol><li>(informal) to look, to peek</li></ol>
h.x.	<i>phrase</i><br><ol><li>(humorous, informal, uncommon, mathematics, student language) Initialism of hesch/häsch gseh/xe(!/?) (“you saw! / did you see?”): Humorous Swiss-German version of Q.E.D.</li></ol>
haa|hät|ghaa	<i>verb</i><br><ol><li>to have</li></ol>
haar	<i>noun</i><br><ol><li>(Formazza, anatomy) hair (the long hair on a person's head)</li></ol>
haim	<i>noun</i><br><ol><li>(Carcoforo) home</li></ol>
hale	<i>verb</i><br><ol><li>(Uri) to be steep</li></ol>
halt	<i>adv</i><br><ol><li>so, just, simply</li></ol>
handle	<i>verb</i><br><ol><li>(Uri) to stroke the teats of a dairy cow until they fill with milk</li></ol>
har	<i>adv</i><br><ol><li>(Uri) hither, here (to this place)</li></ol>
harpscht	<i>noun</i><br><ol><li>(Rimella and Campello Monti) autumn</li></ol>
harr	<i>adv</i><br><ol><li>(Uri) to here, hither</li></ol>
heen	<i>verb</i><br><ol><li>(Issime) to have</li></ol>
hei	<i>noun</i><br><ol><li>(Formazza) home</li></ol>
heilig	<i>adj</i><br><ol><li>(Uri) holy</li></ol>
heim	<i>noun</i><br><ol><li>(Gressoney) home</li></ol>
helte	<i>verb</i><br><ol><li>(Uri) to tilt, lean</li></ol>
hemmu	<i>noun</i><br><ol><li>(Rimella and Campello Monti) home</li></ol>
herbscht	<i>noun</i><br><ol><li>(Gressoney, Carcoforo, Formazza) autumn</li></ol>
hert	<i>adj</i><br><ol><li>(Uri) hard</li></ol>
hiiraate	<i>verb</i><br><ol><li>(Uri) to marry</li></ol>
hit	<i>adv</i><br><ol><li>(Alsatian) today</li></ol>
hoar	<i>noun</i><br><ol><li>(Gressoney, anatomy) hair (the long hair on a person's head)</li></ol>
hochtitsch	<i>noun</i><br><ol><li>(Formazza) Standard German</li></ol>
hocke|hocket|ghocket	<i>verb</i><br><ol><li>(of an animal) to sit, crouch, perch</li><li>(informal, of a person) to sit</li><li>(slang) to stay</li><li>(slang) to be in prison</li></ol>
hoh	<i>verb</i><br><ol><li>(Carcoforo) to have</li></ol>
hol	<i>adj</i><br><ol><li>(Uri) hollow</li></ol>
hooch|hööcher|hööchschte	<i>adj</i><br><ol><li>high</li></ol>
hoor	<i>noun</i><br><ol><li>(Carcoforo, anatomy) hair (the long hair on a person's head)</li></ol>
hous	<i>noun</i><br><ol><li>(Issime) home</li></ol>
housunh	<i>noun</i><br><ol><li>(Issime) house</li></ol>
hun	<i>noun</i><br><ol><li>(Formazza) dog</li></ol>
hund	<i>noun</i><br><ol><li>(Carcoforo, Rimella and Campello Monti) dog</li></ol>
hunn	<i>noun</i><br><ol><li>(Issime) dog</li></ol>
hurteg	<i>intj</i><br><ol><li>hello, hi</li><li>goodbye, bye</li></ol>
hus	<i>noun</i><br><ol><li>(Gressoney) house</li></ol>
husch	<i>noun</i><br><ol><li>(Carcoforo) house</li></ol>
huuenliicht	<i>adj</i><br><ol><li>(Uri) very light (not heavy)</li></ol>
huupe|huupt|ghuupt	<i>verb</i><br><ol><li>to honk, toot (a horn etc.)</li><li>to shout, call through one's cupped hands</li></ol>
hàre	<i>noun</i><br><ol><li>(Rimella and Campello Monti, anatomy, plural only) hair (the long hair on a person's head)</li></ol>
hä|ghä|hätte|heigi|hättesch|heigesch|het|heint|heige|hättet|hät|häb|heig|hätti|hesch|heiget	<i>verb</i><br><ol><li>(Gressoney, Formazza, Uri) to have</li></ol>
häbä	<i>verb</i><br><ol><li>(Formazza) to have</li></ol>
häi	<i>adv</i><br><ol><li>home (homewards)</li></ol>
hälme	<i>verb</i><br><ol><li>(Uri, of animals) to eat blades of grass (grass that has been cut and put in a trough)</li></ol>
hän Sii morn scho öppis vor	<i>phrase</i><br><ol><li>(polite) are you doing anything tomorrow?</li></ol>
häpfäl	<i>noun</i><br><ol><li>(Formazza) potato</li></ol>
häsch du morn scho öppis vor	<i>phrase</i><br><ol><li>(familiar) are you doing anything tomorrow?</li></ol>
hääggle	<i>verb</i><br><ol><li>(Uri) To play hopscotch.</li></ol>
hääl	<i>adj</i><br><ol><li>(Uri) slippery</li></ol>
hè	<i>verb</i><br><ol><li>(Rimella and Campello Monti) to have</li></ol>
héerfél	<i>noun</i><br><ol><li>(Gressoney) potato</li></ol>
hérbscht	<i>noun</i><br><ol><li>(Issime) autumn</li></ol>
hòchtitsch	<i>noun</i><br><ol><li>(Gressoney) Standard German</li></ol>
hònn	<i>noun</i><br><ol><li>(Gressoney) dog</li></ol>
hübscheli	<i>adv</i><br><ol><li>softly, gently, carefully</li></ol>
hürschele	<i>verb</i><br><ol><li>(Uri) to neigh, whinny</li></ol>
hüs	<i>noun</i><br><ol><li>(Formazza) house</li></ol>
hüt	<i>adv</i><br><ol><li>(Switzerland) today</li></ol>
hüüd	<i>adv</i><br><ol><li>(Uri, prevocalic) Alternative form of hüt (“today”)</li></ol>
hüüsch	<i>noun</i><br><ol><li>(Rimella and Campello Monti) house</li></ol>
hüüwle	<i>verb</i><br><ol><li>(Uri) to howl</li></ol>
i	<i>pron</i><br><ol><li>I (first-person singular pronoun)</li></ol>
ich|sin|en|es|öise|mier|du|mi|mir|Ire|ois|öi|eure|im|er|min|eu|eus|ir|Si|dir|der|üüch|euse|di|mer|üse|ier|mich|diin|ene|siin|dich|din|si|'s|ine|Ene|i|öie|öis|dier|in|miin|ich|Ine|oise|üs|ire	<i>pron</i><br><ol><li>I</li></ol>
ig	<i>pron</i><br><ol><li>(Bern) Alternative form of ich</li></ol>
iigsee|gseet ii	<i>verb</i><br><ol><li>to see, understand, comprehend</li></ol>
iilöse|löset ii|iiglöst	<i>verb</i><br><ol><li>to redeem (for money); to cash (a cheque)</li></ol>
iinfääsche|iinfäärsche	<i>verb</i><br><ol><li>(Uri) to swaddle a baby</li></ol>
ir|sin|en|es|öise|mier|du|mi|mir|Ire|ois|öi|eure|im|er|min|eu|eus|ir|Si|dir|der|üüch|euse|di|mer|üse|ier|mich|diin|ene|siin|dich|din|si|'s|ine|Ene|i|öie|öis|dier|in|miin|ich|Ine|oise|üs|ire	<i>pron</i><br><ol><li>you (plural)</li></ol>
isch	<i>noun</i><br><ol><li>(Gressoney, Rimella and Campello Monti, Formazza) ice</li></ol>
isch alles ok	<i>phrase</i><br><ol><li>are you OK?; is everything OK?</li></ol>
italienésch	<i>noun</i><br><ol><li>(Gressoney) Italian (language)</li></ol>
ja|jaa|jä	<i>adv</i><br><ol><li>(Uri) yes</li></ol>
jage	<i>verb</i><br><ol><li>to hunt</li><li>(of goats) to be in heat</li></ol>
jangse	<i>verb</i><br><ol><li>(Uri) to hurry, rush, hustle</li></ol>
jegisch	<i>adj</i><br><ol><li>(Uri) in heat</li></ol>
joole	<i>verb</i><br><ol><li>(Uri) to yodel</li></ol>
jung	<i>adj</i><br><ol><li>(Carcoforo) young</li></ol>
jungle	<i>verb</i><br><ol><li>(Uri) to give birth to a male</li></ol>
jungu	<i>adj</i><br><ol><li>(Formazza) young</li></ol>
jungà	<i>adj</i><br><ol><li>(Rimella and Campello Monti) young</li></ol>
junhs	<i>adj</i><br><ol><li>(Issime) young</li></ol>
juuze	<i>verb</i><br><ol><li>(Uri) to cheer, whoop</li></ol>
jäble	<i>verb</i><br><ol><li>(Uri, of small children) to screech, scream, cry</li></ol>
jäukig	<i>adj</i><br><ol><li>(Uri, of goats) in heat</li></ol>
jòng	<i>adj</i><br><ol><li>(Gressoney) young</li></ol>
kalaze	<i>verb</i><br><ol><li>(Uri) to eat breakfast</li></ol>
kale	<i>verb</i><br><ol><li>(Uri) to congeal, curdle</li></ol>
kenne	<i>verb</i><br><ol><li>(Uri) to know, be acquainted with, ken</li></ol>
kän|käm|känere|käs|kä|käni	<i>pron</i><br><ol><li>no</li></ol>
laa|längi|lies|gla|lättet|liessi|liesset|liessesch|lätte|glaa|lëëe|liess|läänt|laat|lättti|liesse|lëë|lëëet|lättesch|läng|lëëesch|lach|lät|laasch|längesch|lätti	<i>verb</i><br><ol><li>to leave</li><li>to break</li></ol>
lache|glacht|lacht	<i>verb</i><br><ol><li>to laugh</li></ol>
lade|glade|ladet	<i>noun</i><br><ol><li>to load</li></ol>
laffe	<i>verb</i><br><ol><li>(Uri, colloquial, informal) to drink quickly, gulp down, glug</li></ol>
lamm	<i>adj</i><br><ol><li>(Uri) lame; hobbling, limping</li></ol>
landlig	<i>adj</i><br><ol><li>(Alsatian) rural</li></ol>
lang|lange|langi|langs|lenger|lengscht	<i>adj</i><br><ol><li>long</li><li>tall, high</li></ol>
langsé	<i>noun</i><br><ol><li>(Formazza) spring (season)</li></ol>
laufe	<i>verb</i><br><ol><li>(Uri) to run, go</li></ol>
lauffe|gloffe|laufft	<i>verb</i><br><ol><li>to run, go</li></ol>
leernen	<i>verb</i><br><ol><li>(Issime) to learn</li></ol>
leew	<i>adj</i><br><ol><li>(Uri) lukewarm</li></ol>
leire	<i>verb</i><br><ol><li>(Carcoforo) to learn</li></ol>
lerä	<i>verb</i><br><ol><li>(Formazza) to learn</li></ol>
letscht|letschts|letschte|letschti	<i>adj</i><br><ol><li>last; final</li><li>latest</li></ol>
liachtaschtänerisch	<i>adj</i><br><ol><li>of or from Liechtenstein</li></ol>
lieb|liebi|liebscht|liebe|liebs|lieber	<i>adj</i><br><ol><li>dear</li></ol>
ligge|leeg|liit|ggläge	<i>verb</i><br><ol><li>to lie (be in horizontal position)</li><li>to lie, be (in a place)</li></ol>
liiber	<i>adj</i><br><ol><li>(Uri) free</li></ol>
liide|glitte|liidet	<i>verb</i><br><ol><li>to bear, suffer</li></ol>
liire	<i>verb</i><br><ol><li>(chiefly Bern) to prattle, talk nonsense</li></ol>
liisli	<i>adv</i><br><ol><li>quietly, softly</li></ol>
lindmëlch	<i>adj</i><br><ol><li>(Uri) easy to milk</li></ol>
lispe	<i>verb</i><br><ol><li>(Uri) to lisp</li></ol>
lokha	<i>noun</i><br><ol><li>(Issime, anatomy) hair</li></ol>
lose|gloset|loset	<i>verb</i><br><ol><li>to hear, listen</li></ol>
lotze	<i>verb</i><br><ol><li>(Uri) to waylay</li></ol>
ludele	<i>verb</i><br><ol><li>(Uri, of the fat of overweight people and animals) to shake, tremble</li></ol>
luege|glueget|lueget	<i>verb</i><br><ol><li>to look (at something), watch</li><li>to look after, care (for)</li></ol>
lugg	<i>adj</i><br><ol><li>(Uri) loose, relaxed</li></ol>
lupfe|lupft|glupft	<i>verb</i><br><ol><li>Synonym of lüpfe</li></ol>
läck Bobby|läck Bobi|läck Bobbi	<i>intj</i><br><ol><li>good Lord (expression of astonishment)</li></ol>
läse|list|gläse	<i>verb</i><br><ol><li>to read</li></ol>
lére	<i>verb</i><br><ol><li>(Gressoney) to learn</li></ol>
lérne	<i>verb</i><br><ol><li>(Rimella and Campello Monti) to learn</li></ol>
lërne	<i>verb</i><br><ol><li>(Uri) to learn</li></ol>
lëëbe	<i>verb</i><br><ol><li>(Uri) to live</li></ol>
lösch	<i>adj</i><br><ol><li>loose</li><li>mild (of temperature etc.)</li></ol>
lüpfe|lüpft|glüpft	<i>verb</i><br><ol><li>to lift, raise</li></ol>
lüüffig	<i>adj</i><br><ol><li>(Uri, of sheep) in heat</li></ol>
lüüte|glüütet|lüütet	<i>verb</i><br><ol><li>to ring</li></ol>
ma	<i>noun</i><br><ol><li>man</li><li>husband</li></ol>
mache	<i>verb</i><br><ol><li>to do</li><li>to make</li></ol>
mamma	<i>noun</i><br><ol><li>(Gressoney) mom, mama</li></ol>
mange	<i>verb</i><br><ol><li>(Uri, auxiliary) should</li><li>(Uri) to be in need of something</li></ol>
mannlig	<i>adj</i><br><ol><li>(Alsatian) male, masculine</li></ol>
manä	<i>noun</i><br><ol><li>(Formazza) moon</li></ol>
manòd	<i>noun</i><br><ol><li>(Gressoney) moon</li></ol>
massehaft	<i>adj</i><br><ol><li>lots of</li></ol>
massewiis	<i>adv</i><br><ol><li>en masse, lots of, in heaps</li></ol>
maugle|mauggele	<i>verb</i><br><ol><li>(Uri) to dawn</li></ol>
meer	<i>adv</i><br><ol><li>(Uri) more</li></ol>
meere	<i>verb</i><br><ol><li>(Uri) to vote by raising one's hands</li></ol>
mega	<i>adv</i><br><ol><li>(colloquial) very</li></ol>
meini	<i>noun</i><br><ol><li>(Carcoforo) moon</li></ol>
meintog	<i>noun</i><br><ol><li>(Carcoforo) Monday</li></ol>
meljch	<i>noun</i><br><ol><li>(Rimella and Campello Monti) milk</li></ol>
meng	<i>det</i><br><ol><li>(Uri) many a, some</li></ol>
menne	<i>verb</i><br><ol><li>(Uri) to drive a vehicle drawn by draught cattle</li></ol>
merci	<i>intj</i><br><ol><li>thank you</li></ol>
merde	<i>intj</i><br><ol><li>(Uri, vulgar) shit!, crap!</li></ol>
messi	<i>intj</i><br><ol><li>thank you</li></ol>
mettwucchu	<i>noun</i><br><ol><li>(Rimella and Campello Monti) Wednesday</li></ol>
metzge|gmetzget|metzget	<i>verb</i><br><ol><li>to slaughter</li></ol>
miantag	<i>noun</i><br><ol><li>(Issime) Monday</li></ol>
miin|miner|mini|miim|miis|mine	<i>det</i><br><ol><li>my; mine</li></ol>
miinetwäge	<i>adv</i><br><ol><li>for my sake, because of me</li><li>as far as I'm concerned; if you like, fair enough</li></ol>
milch	<i>noun</i><br><ol><li>(Issime, Carcoforo) milk</li></ol>
mingerréd	<i>noun</i><br><ol><li>(Issime) Italian (language)</li></ol>
mir|sin|en|es|öise|mier|du|mi|mir|Ire|ois|öi|eure|im|er|min|eu|eus|ir|Si|dir|der|üüch|euse|di|mer|üse|ier|mich|diin|ene|siin|dich|din|si|'s|ine|Ene|i|öie|öis|dier|in|miin|ich|Ine|oise|üs|ire	<i>pron</i><br><ol><li>(personal) we</li></ol>
mitenand	<i>adv</i><br><ol><li>together</li></ol>
mittuchu	<i>noun</i><br><ol><li>(Issime) Wednesday</li></ol>
mittwuchu	<i>noun</i><br><ol><li>(Carcoforo) Wednesday</li></ol>
mo	<i>noun</i><br><ol><li>man</li><li>husband</li></ol>
moanu	<i>noun</i><br><ol><li>(Issime) moon</li></ol>
moorn	<i>adv</i><br><ol><li>(Aargau, Basel, Lucerne, Solothurn, Zürich) tomorrow</li></ol>
morn	<i>adv</i><br><ol><li>tomorrow</li></ol>
muater	<i>noun</i><br><ol><li>(Carcoforo) mother</li></ol>
muele	<i>verb</i><br><ol><li>(Uri) to speak incomprehensibly, babble</li></ol>
murw	<i>adj</i><br><ol><li>(Uri) friable, tender, mushy</li></ol>
mutsch	<i>adj</i><br><ol><li>(Uri) hornless</li></ol>
mutz	<i>adj</i><br><ol><li>short</li><li>brief, quick</li></ol>
mà	<i>noun</i><br><ol><li>man</li><li>husband</li></ol>
mànund	<i>noun</i><br><ol><li>(Rimella and Campello Monti) moon</li></ol>
mängist|mängisch	<i>adv</i><br><ol><li>(Freiamt, Basel-Landschaft, Bern, Engelberg) sometimes</li></ol>
mäntag	<i>noun</i><br><ol><li>(Formazza) Monday</li></ol>
mäschere	<i>verb</i><br><ol><li>(Uri) to squeeze, crush</li></ol>
määr	<i>adj</i><br><ol><li>lovely, precious, pleasant</li><li>Used to indicate a preference.</li></ol>
mélch	<i>noun</i><br><ol><li>(Gressoney) milk</li></ol>
mélläch	<i>noun</i><br><ol><li>(Formazza) milk</li></ol>
méntag	<i>noun</i><br><ol><li>(Gressoney) Monday</li></ol>
méttwucha	<i>noun</i><br><ol><li>(Formazza) Wednesday</li></ol>
méttwòchò	<i>noun</i><br><ol><li>(Gressoney) Wednesday</li></ol>
mëlch	<i>adj</i><br><ol><li>(of cows) milch, milkable</li><li>(of animal fodder) Containing nutrients that help promote milk production in cows.</li></ol>
mìntàg	<i>noun</i><br><ol><li>(Rimella and Campello Monti) Monday</li></ol>
möge|meg|mechti|mecht|mechte|mechtesch|mögesch|megsch|magsch|möget|mechtet|mag	<i>verb</i><br><ol><li>(auxiliary) may</li><li>(auxiliary) can</li></ol>
möter	<i>noun</i><br><ol><li>(Formazza) mother</li></ol>
müese|müest|mues	<i>verb</i><br><ol><li>(auxiliary) must, should</li></ol>
müesse|müest|müessti|müesste|muess|müesstet|muesch|müessi|müesch|müesstesch|müent|müesst|müess	<i>verb</i><br><ol><li>(Uri) Alternative form of müese</li></ol>
müglich	<i>adj</i><br><ol><li>(Uri) possible</li></ol>
müüslistile	<i>adj</i><br><ol><li>quiet as a mouse</li></ol>
naach	<i>adj</i><br><ol><li>(Uri) near</li></ol>
namä	<i>noun</i><br><ol><li>(Formazza) name</li></ol>
natüürlich|natüürlichi|natüürliche|natüürlichs	<i>adj</i><br><ol><li>natural</li></ol><br><i>adv</i><br><ol><li>naturally</li></ol>
naure	<i>verb</i><br><ol><li>(Uri) to doze off</li></ol>
neiwer	<i>pron</i><br><ol><li>(Uri) somebody</li></ol>
neiwis	<i>pron</i><br><ol><li>(Uri) something</li></ol>
nett|nettischt|netts|nette|netti|netter	<i>adj</i><br><ol><li>nice</li><li>sweet</li></ol>
nie	<i>adv</i><br><ol><li>never</li></ol>
nin	<i>num</i><br><ol><li>(Alsatian) nine</li></ol>
nine	<i>num</i><br><ol><li>(Alsatian) nine</li></ol>
no|nu	<i>adv</i><br><ol><li>still, yet</li><li>eventually (at an unknown time in the future)</li><li>(only) just; barely (by a small margin)</li><li>(with comparative) even</li></ol>
noame	<i>noun</i><br><ol><li>(Gressoney, Issime) name</li></ol>
nomu	<i>noun</i><br><ol><li>(Carcoforo) name</li></ol>
nooch	<i>adj</i><br><ol><li>(Uri) Alternative form of naach</li></ol>
normaalerwiis	<i>adv</i><br><ol><li>normally, usually</li></ol>
nosch gŝchei wer nisch	<i>intj</i><br><ol><li>(Carcoforo) goodbye, see you later</li></ol>
nu	<i>adv</i><br><ol><li>only</li><li>now</li></ol>
nume	<i>adv</i><br><ol><li>(childish) Alternative form of nu</li></ol>
nàmund	<i>noun</i><br><ol><li>(Rimella and Campello Monti) name</li></ol>
nächti	<i>adv</i><br><ol><li>(Uri) last night</li></ol>
nägle	<i>verb</i><br><ol><li>(intransitive) to get frostbite on one's fingertips</li></ol>
näime	<i>adv</i><br><ol><li>somewhere, someplace (chiefly US)</li><li>somehow</li><li>A question particle.</li></ol>
näimehäär	<i>adv</i><br><ol><li>from somewhere (or other)</li></ol>
näimis	<i>pron</i><br><ol><li>(archaic) something; anything</li></ol>
nää|nimt|nääm|gnaa	<i>verb</i><br><ol><li>to take</li></ol>
në|nëmmesch|nimm|nëmm|nimsch|gna|nëmmet|nëmmi|nëmme|nëëmt|nëëmti|nimt|gnu|nëmmtet|niime|nëmmtesch|gno|nëmmte	<i>verb</i><br><ol><li>(Uri) Alternative form of nää (“to take”)</li></ol>
nëfle	<i>verb</i><br><ol><li>(Uri) to fume</li></ol>
nöd	<i>adv</i><br><ol><li>not</li></ol>
nöi|nöii|nöie|nöier|nöischt|nöis	<i>adj</i><br><ol><li>new</li></ol>
nüefer	<i>adj</i><br><ol><li>(Uri) chipper, in good health</li></ol>
nüme	<i>adv</i><br><ol><li>no longer, not anymore</li></ol>
nüün	<i>num</i><br><ol><li>nine</li></ol>
nüünzg	<i>num</i><br><ol><li>ninety</li></ol>
nüüt	<i>pron</i><br><ol><li>nothing, not any, not anything</li></ol>
nüüw	<i>adj</i><br><ol><li>(Uri) new</li></ol>
nüüwe	<i>verb</i><br><ol><li>(Uri, intransitive) to become a new moon</li></ol>
oalt	<i>adj</i><br><ol><li>(Gressoney) old</li></ol>
oalts	<i>adj</i><br><ol><li>(Issime) old</li></ol>
ocht	<i>num</i><br><ol><li>(Alsatian) eight</li></ol>
offe	<i>adj</i><br><ol><li>open</li></ol>
olt	<i>adj</i><br><ol><li>(Carcoforo) old</li></ol>
ooni	<i>prep</i><br><ol><li>without</li></ol>
oustaga	<i>noun</i><br><ol><li>(Issime) spring (season)</li></ol>
panduure	<i>verb</i><br><ol><li>(Uri) To play Pandur, a Swiss card game.</li></ol>
pappa	<i>noun</i><br><ol><li>(Gressoney) dad, daddy, papa</li></ol>
passiere|passiert	<i>verb</i><br><ol><li>to happen</li></ol>
pfife	<i>verb</i><br><ol><li>(Uri) to whistle</li></ol>
pflääge|pflägt|pfläägt	<i>verb</i><br><ol><li>(St. Gallen Oberland, Zürich Oberland) to look after; to care for; to maintain</li></ol>
pfuuse	<i>verb</i><br><ol><li>(Uri, humorous) to sleep</li></ol>
pfëcke	<i>verb</i><br><ol><li>(Uri) to calibrate</li></ol>
piie piie	<i>intj</i><br><ol><li>(Uri) A chicken's mating call.</li></ol>
plutt	<i>adj</i><br><ol><li>(Uri) naked</li></ol>
pole	<i>verb</i><br><ol><li>(Uri) to make noise, clatter, rumble</li></ol>
pour	<i>noun</i><br><ol><li>(Issime) farmer</li></ol>
presch	<i>adj</i><br><ol><li>(Uri, of the udders of a cow) bursting with milk</li></ol>
pum	<i>noun</i><br><ol><li>(Rimella and Campello Monti) apple</li></ol>
pungge	<i>verb</i><br><ol><li>(Uri) to knock, tap</li></ol>
pur	<i>noun</i><br><ol><li>(Gressoney, Carcoforo) farmer</li></ol>
päge	<i>verb</i><br><ol><li>(Uri) to pay</li></ol>
pärle	<i>verb</i><br><ol><li>(Uri) to babble; to speak unintelligibly, in gibberish</li></ol>
pür	<i>noun</i><br><ol><li>(Formazza) farmer</li></ol>
ran	<i>adj</i><br><ol><li>(Uri) lanky, slender</li></ol>
rauche|raucht|ggraucht	<i>verb</i><br><ol><li>to smoke</li></ol>
rede|redt|gredt	<i>verb</i><br><ol><li>to speak, talk</li></ol>
regu	<i>noun</i><br><ol><li>(Carcoforo) rain</li></ol>
reiere	<i>verb</i><br><ol><li>(informal, Zürich) to vomit</li></ol>
reike	<i>verb</i><br><ol><li>(Uri, transitive) to get</li></ol>
relle	<i>verb</i><br><ol><li>(Uri) to tease</li></ol>
resch	<i>adj</i><br><ol><li>merry, cheery</li><li>bright, clever</li></ol>
rigle|riglet|griglet	<i>verb</i><br><ol><li>to bolt (a door etc.)</li></ol>
riibe|gribe|riibt	<i>verb</i><br><ol><li>to rub</li></ol>
roddun	<i>verb</i><br><ol><li>(Issime) to play</li></ol>
rode|rodt|grodt	<i>verb</i><br><ol><li>(transitive, reflexive) to move, stir</li></ol>
rodò	<i>verb</i><br><ol><li>(Gressoney) to play</li></ol>
rot	<i>adj</i><br><ol><li>(Formazza) red</li></ol>
rout	<i>adj</i><br><ol><li>(Carcoforo) red</li></ol>
ruat	<i>adj</i><br><ol><li>(Issime) red</li></ol>
ruewe	<i>verb</i><br><ol><li>(Uri) to rest, relax</li></ol>
rutschge	<i>verb</i><br><ol><li>(Uri) to creak</li></ol>
ruusche|gruuschet|ruuschet	<i>verb</i><br><ol><li>to rustle, murmur, whisper</li></ol>
ruusse	<i>verb</i><br><ol><li>to snore</li><li>to grunt</li></ol>
räge	<i>noun</i><br><ol><li>(Gressoney) rain</li></ol>
rägä	<i>noun</i><br><ol><li>(Formazza) rain</li></ol>
rätsche	<i>verb</i><br><ol><li>(Uri) to chatter</li></ol>
rääss	<i>adj</i><br><ol><li>(Uri, of meat, cheese) rotting</li></ol>
ròt	<i>adj</i><br><ol><li>(Gressoney) red</li></ol>
röts	<i>adj</i><br><ol><li>(Rimella and Campello Monti) red</li></ol>
rüere	<i>verb</i><br><ol><li>to move, stir</li><li>to throw</li></ol>
rüewig	<i>adj</i><br><ol><li>(Uri) calm, quiet, peaceful</li></ol>
rüüdig	<i>adj</i><br><ol><li>(obsolete) mangy</li></ol><br><i>adv</i><br><ol><li>(Lucerne, Sense) very, really, super</li></ol>
rüüwe	<i>verb</i><br><ol><li>(Uri) to regret</li></ol>
s|des|de (before a consonant)|ds|die|em|de (before a consonant, including h)|dr|de|d'|'s|den|at the beginning of a sentence or verse: S'|der|das|dem|d	<i>article</i><br><ol><li>(definite) the</li></ol>
sait	<i>verb</i><br><ol><li>inflected form; says</li></ol>
samstag	<i>noun</i><br><ol><li>(Gressoney, Issime, Formazza) Saturday</li></ol>
sanft	<i>adj</i><br><ol><li>(Uri) easy, especially of a physical task</li></ol>
schade|schadt|gschadt|schadti	<i>verb</i><br><ol><li>To harm, hurt, damage.</li></ol>
schaffe	<i>verb</i><br><ol><li>to manage, to cope with; to (be able to) make, do; to finalize, complete something</li><li>to work, labor</li></ol>
scharpf	<i>adj</i><br><ol><li>(Uri) sharp</li></ol>
schatmig	<i>adj</i><br><ol><li>(Uri) shady, shadowy</li></ol>
scheide	<i>verb</i><br><ol><li>(transitive) to divorce (a married couple)</li><li>(of milk) to curdle</li></ol>
schelle	<i>verb</i><br><ol><li>(Uri) to peel, skin, shell</li></ol>
schiebe|gschobe|schiebt|schiebti	<i>verb</i><br><ol><li>to push</li></ol>
schier	<i>adv</i><br><ol><li>almost, nearly</li></ol>
schieße	<i>verb</i><br><ol><li>(Uri) to shoot</li></ol>
schiöl	<i>noun</i><br><ol><li>(Rimella and Campello Monti) school</li></ol>
schlaa|schläättesch|schlëëe|schlienge|schläänt|schliegi|schlänge|schläättet|schlëëesch|schlängesch|schlieng|schläätti|schlach|schlëë|schlëëet|schläät|schlaasch|schliengi|schlänget|schliengesch|schliegesch|schlieg|schläng|schlängi|schlieget|schliege|gschlaage|schlaat|schläätte	<i>verb</i><br><ol><li>(Uri) to beat, hit</li></ol>
schlaaffe|schlaft|gschlaaffe|schlafe|gschlafe|schlieff|schlaafft	<i>verb</i><br><ol><li>to sleep</li></ol>
schlaafä	<i>verb</i><br><ol><li>(Formazza) to sleep</li></ol>
schleipfe	<i>verb</i><br><ol><li>(Uri) to pull, drag</li></ol>
schloafe	<i>verb</i><br><ol><li>(Gressoney) to sleep</li></ol>
schloafen	<i>verb</i><br><ol><li>(Issime) to sleep</li></ol>
schlofe	<i>verb</i><br><ol><li>(Badisch, Carcoforo) to sleep</li></ol>
schlucke|schluckti|gschluckt|schluckt	<i>verb</i><br><ol><li>to swallow</li></ol>
schlàfu	<i>verb</i><br><ol><li>(Rimella and Campello Monti) to sleep</li></ol>
schlàwol	<i>intj</i><br><ol><li>(Rimella and Campello Monti) good night</li></ol>
schlësem	<i>adj</i><br><ol><li>(Uri, of snowflakes) rounded; having undergone rounding</li></ol>
schlësme	<i>verb</i><br><ol><li>(Uri, of snowflakes) To undergo rounding, a process that occurs under high snow temperatures and weak temperature gradients, in which the sharp edges of a snowflake are rounded, forming round grains or "rounds", thus minimizing surface area of the snowflakes and strengthening the snowpack.</li></ol>
schlüüfe	<i>verb</i><br><ol><li>(Uri, intransitive) to hatch</li></ol>
schmaal	<i>adj</i><br><ol><li>(Uri) narrow</li></ol>
schmid	<i>noun</i><br><ol><li>(Issime, Carcoforo) smith</li></ol>
schmirre	<i>verb</i><br><ol><li>(Uri) to smear</li></ol>
schméd	<i>noun</i><br><ol><li>(Gressoney) smith</li></ol>
schmét	<i>noun</i><br><ol><li>(Formazza) smith</li></ol>
schmìd	<i>noun</i><br><ol><li>(Rimella and Campello Monti) smith</li></ol>
schnaagge	<i>verb</i><br><ol><li>(Uri) to creep, crawl</li></ol>
schnee	<i>noun</i><br><ol><li>(Formazza) snow</li></ol>
schnei	<i>noun</i><br><ol><li>(Carcoforo) snow</li></ol>
schnia	<i>noun</i><br><ol><li>(Issime) snow</li></ol>
schné	<i>noun</i><br><ol><li>(Gressoney) snow</li></ol>
schnëtze	<i>verb</i><br><ol><li>(Uri, of wood) to carve</li></ol>
schnìj	<i>noun</i><br><ol><li>(Rimella and Campello Monti) snow</li></ol>
schore	<i>verb</i><br><ol><li>(Uri) to shovel, sweep</li></ol>
schpile|schpilti|gschpilt|schpilt	<i>verb</i><br><ol><li>to play</li></ol>
schpélju	<i>verb</i><br><ol><li>(Carcoforo) to play</li></ol>
schpélu	<i>verb</i><br><ol><li>(Formazza) to play</li></ol>
schpìlju	<i>verb</i><br><ol><li>(Rimella and Campello Monti) to play</li></ol>
schreg	<i>noun</i><br><ol><li>(Uri) slanted, oblique</li></ol>
schriibe|gschribe|schriibt|schriibti	<i>verb</i><br><ol><li>to write</li></ol>
schriie	<i>verb</i><br><ol><li>(Uri) to shout, scream</li></ol>
schriisse	<i>verb</i><br><ol><li>(Uri) to rupture, tear, rip</li></ol>
schroote	<i>verb</i><br><ol><li>(Uri, transitive) to cut, cut up (especially hay)</li></ol>
schuel	<i>noun</i><br><ol><li>(Gressoney) school</li></ol>
schul	<i>noun</i><br><ol><li>(Issime) school</li></ol>
schuol	<i>noun</i><br><ol><li>(Carcoforo) school</li></ol>
schweigge	<i>verb</i><br><ol><li>(Uri) to keep quiet</li></ol>
schwele|gschwelt|gschwule|schwelt	<i>verb</i><br><ol><li>to cook through; to cook well</li><li>to swell (up); to bulge</li></ol>
schwere	<i>verb</i><br><ol><li>(Uri) to swear, vow</li></ol>
schweschter	<i>noun</i><br><ol><li>(Formazza) sister</li></ol>
schwiine	<i>verb</i><br><ol><li>(Uri) to decrease, dwindle</li></ol>
schwiizerisch	<i>adj</i><br><ol><li>Swiss</li></ol>
schägget	<i>adj</i><br><ol><li>(Uri) speckled</li></ol>
schäme|gschämt|schämt	<i>verb</i><br><ol><li>(reflexive) to be ashamed</li></ol>
schööl	<i>noun</i><br><ol><li>(Formazza) school</li></ol>
schüüch|schüüchscht|schüücher	<i>adj</i><br><ol><li>shy</li></ol><br><i>adv</i><br><ol><li>shyly</li></ol>
schüüche	<i>verb</i><br><ol><li>to shy away</li><li>(reflexive) to dread, be afraid of</li></ol>
seelene	<i>verb</i><br><ol><li>(Uri) To play a children's game in which one throws sticks into three holes, representing Heaven, Hell and Purgatory.</li></ol>
seen	<i>verb</i><br><ol><li>(Issime) to say</li></ol>
seer|sehr	<i>adv</i><br><ol><li>very</li></ol>
si|sin|en|es|öise|mier|du|mi|mir|Ire|ois|sines|öi|eure|im|er|si'm & sim|min|eu|eus|sine|ir|Si|dir|der|üüch|sini|euse|di|mer|üse|ier|siner|mich|diin|ene|siin|dich|din|'s|ine|si|Ene|i|öie|öis|dier|in|miin|ich|sines & si's|Ine|oise|üs|ire	<i>pron</i><br><ol><li>she</li><li>it (for referents of the feminine grammatical gender)</li><li>they</li></ol><br><i>det</i><br><ol><li>his</li></ol><br><i>verb</i><br><ol><li>(Gressoney) to be</li></ol>
sibe|siebë	<i>num</i><br><ol><li>seven</li></ol>
sii|wäre|wäret|bi|weer|wär|wër|gsi|siige|sig|wäresch|siigesch|bisch|gsii|siiget|sind|biss|isch|bin	<i>verb</i><br><ol><li>to be</li></ol>
siin|siner|sine|siim|siis|sini	<i>det</i><br><ol><li>his; her, hers</li></ol>
sind Sii ghüroote	<i>phrase</i><br><ol><li>(polite) are you married?</li></ol>
sind Sii gläubig	<i>phrase</i><br><ol><li>(polite) are you religious?</li></ol>
sind Sii religiös	<i>phrase</i><br><ol><li>(polite) are you religious?</li></ol>
sind Sii single	<i>phrase</i><br><ol><li>(polite) are you single?</li></ol>
singe|gsunge|singt	<i>verb</i><br><ol><li>to sing</li></ol>
single	<i>adj</i><br><ol><li>single (not in a relationship)</li></ol>
sinh	<i>verb</i><br><ol><li>(Issime) to be</li></ol>
solle|sottet|sollesch|sollsch|sotti|solli|sott|soll|sottesch|sotte|sollet|sollt	<i>verb</i><br><ol><li>(Uri, auxiliary) should</li></ol>
spaat|speeter	<i>adj</i><br><ol><li>(Uri) late</li></ol>
spaltig	<i>adj</i><br><ol><li>(Uri) easy to split</li></ol>
spelig	<i>adj</i><br><ol><li>(Uri) easy to split, divide</li></ol>
sper	<i>adj</i><br><ol><li>(Uri) stiff, rigid</li></ol>
spere	<i>verb</i><br><ol><li>(Uri) to block, to bar</li></ol>
spiiwe	<i>verb</i><br><ol><li>(Uri) to spit</li></ol>
spillun	<i>verb</i><br><ol><li>(Carcoforo) to play</li></ol>
sprengge	<i>verb</i><br><ol><li>(Uri) to burst, blow up</li></ol>
springe|springt|gsprunge	<i>verb</i><br><ol><li>to run</li><li>to jump, leap</li><li>to burst</li></ol>
spräite|gspräitet|spräitet	<i>verb</i><br><ol><li>to spread, spread out</li></ol>
späuze	<i>verb</i><br><ol><li>(Uri) to spit</li></ol>
spélò	<i>verb</i><br><ol><li>(Gressoney) to play</li></ol>
staa|stängi|stiendet|stäätet|stëëesch|stiende|stääte|stäänt|stäät|stäng|stänge|gstande|stann|stiendi|stääti|stiendesch|stand|stiend|stängesch|stäättesch|staat|stëë|staasch|gstanne	<i>verb</i><br><ol><li>to stand</li><li>to be (in a place)</li></ol>
steerbe|stirbt|gstorbe	<i>verb</i><br><ol><li>to die</li></ol>
stigle	<i>verb</i><br><ol><li>(Uri) to stutter</li></ol>
stotzig	<i>adj</i><br><ol><li>(Uri) steep</li></ol>
streuwe	<i>noun</i><br><ol><li>(Uri) to spread, scatter</li></ol>
struensle	<i>verb</i><br><ol><li>(Uri) To milk poorly or clumsily, so that the stream splits.</li></ol>
struuse	<i>verb</i><br><ol><li>(Uri) To sink down into snow.</li></ol>
stuune|stuunet|gstuunet	<i>verb</i><br><ol><li>to stare into space while lost in thought; to brood to oneself</li><li>to be amazed; to wonder</li></ol>
stüüdle	<i>verb</i><br><ol><li>(Uri) to plant perennials</li></ol>
su	<i>noun</i><br><ol><li>(Issime, Formazza) son</li></ol>
sueche|gsuecht|suecht	<i>verb</i><br><ol><li>to seek, search</li></ol>
summer	<i>noun</i><br><ol><li>(Issime, Formazza) summer</li></ol>
sunna	<i>noun</i><br><ol><li>(Formazza) sun, the Sun</li></ol>
sunnatag	<i>noun</i><br><ol><li>(Issime) Sunday</li></ol>
sunntag	<i>noun</i><br><ol><li>(Formazza) Sunday</li></ol>
sunnu	<i>noun</i><br><ol><li>(Issime) sun, the Sun</li></ol>
sus|suscht|susch	<i>adv</i><br><ol><li>otherwise</li></ol>
suufe	<i>verb</i><br><ol><li>(Uri) to drink</li></ol>
suuge	<i>verb</i><br><ol><li>(Uri) to suck</li></ol>
sächs	<i>num</i><br><ol><li>six</li></ol>
säge|gsäit|säit	<i>verb</i><br><ol><li>to say, speak</li></ol>
sägä	<i>verb</i><br><ol><li>(Formazza) to say</li></ol>
säugge	<i>verb</i><br><ol><li>to lactate</li><li>to suckle</li></ol>
séege	<i>verb</i><br><ol><li>(Gressoney) to say</li></ol>
sòmmer	<i>noun</i><br><ol><li>(Gressoney) summer</li></ol>
sònntag	<i>noun</i><br><ol><li>(Gressoney) Sunday</li></ol>
sònnò	<i>noun</i><br><ol><li>(Gressoney) sun, the Sun</li></ol>
sölle|sött	<i>verb</i><br><ol><li>(auxiliary) should; to be obligated (to do something); ought; shall</li></ol>
sötti	<i>verb</i><br><ol><li>should</li></ol>
süeche	<i>verb</i><br><ol><li>(Uri) Alternative form of sueche</li></ol>
süeß	<i>adj</i><br><ol><li>(also Uri) sweet</li></ol>
süfä	<i>verb</i><br><ol><li>(Formazza) to drink</li></ol>
süüberli	<i>adv</i><br><ol><li>softly, gently, carefully</li></ol>
süüwle	<i>verb</i><br><ol><li>(Uri) To play a children's game in which one tries to push a round stone into a hole with a pole.</li></ol>
tachter	<i>noun</i><br><ol><li>(Rimella and Campello Monti) daughter</li></ol>
tank	<i>intj</i><br><ol><li>(Gressoney) thank you</li></ol>
taub	<i>adj</i><br><ol><li>(Uri) angry</li></ol>
techter	<i>noun</i><br><ol><li>(Gressoney, Carcoforo, Formazza) daughter</li></ol>
tenke	<i>verb</i><br><ol><li>(Uri) to think</li></ol>
timmer	<i>adj</i><br><ol><li>(Uri) dim, dark</li></ol>
titsch	<i>noun</i><br><ol><li>(Gressoney, Formazza) German (language)</li></ol>
tittschu	<i>noun</i><br><ol><li>(Rimella and Campello Monti) German (language)</li></ol>
titzsch	<i>noun</i><br><ol><li>(Carcoforo) German (language)</li></ol>
tobe|tobet	<i>verb</i><br><ol><li>to rage, rave, rampage (of a child, a person)</li><li>to bluster, rampage (of a wind, the weather)</li></ol>
tole	<i>verb</i><br><ol><li>to tolerate</li><li>to endure</li></ol>
trenhu	<i>verb</i><br><ol><li>(Rimella and Campello Monti) to drink</li></ol>
treuwe	<i>verb</i><br><ol><li>(Uri) to threaten</li></ol>
trifflu	<i>noun</i><br><ol><li>(Rimella and Campello Monti) potato</li></ol>
triibe|tribe|triibt	<i>verb</i><br><ol><li>to drive, urge, push</li></ol>
trinche	<i>verb</i><br><ol><li>(Carcoforo) to drink</li></ol>
tringhien	<i>verb</i><br><ol><li>(Issime) to drink</li></ol>
trinke|trinkt|trunke	<i>verb</i><br><ol><li>(transitive) to drink</li></ol>
troole	<i>verb</i><br><ol><li>(Uri) to rumble</li></ol>
trénge	<i>verb</i><br><ol><li>(Gressoney) to drink</li></ol>
trööle	<i>verb</i><br><ol><li>(Uri) to roll, writhe</li></ol>
trüffulu	<i>noun</i><br><ol><li>(Issime) potato</li></ol>
trüüw	<i>adj</i><br><ol><li>(Uri) loyal, true</li></ol>
tschau	<i>intj</i><br><ol><li>(Formazza) hi, hello, ciao</li></ol>
tschavò	<i>intj</i><br><ol><li>(Gressoney) hi, hello, ciao</li></ol>
tschischtag	<i>noun</i><br><ol><li>(Gressoney) Tuesday</li></ol>
tschuugge	<i>verb</i><br><ol><li>(Uri) to tousle, ruffle.</li></ol>
tschäferig	<i>adj</i><br><ol><li>(Uri) made of slate</li></ol>
tschättere	<i>verb</i><br><ol><li>to thunder</li><li>(by extension) to be noisy</li></ol>
tue|tuet|taa|tät|tüent|tätti|tuesch|tätte|tättesch|tüegi|täät|tu|tüege|tüegesch|tüeg	<i>verb</i><br><ol><li>to do</li></ol>
tätsche	<i>verb</i><br><ol><li>(Uri) to knock</li></ol>
täubele	<i>verb</i><br><ol><li>to complain loudly, to moan (especially incessant wailing by children)</li></ol>
töchter	<i>noun</i><br><ol><li>(Issime) daughter</li></ol>
töitsch	<i>noun</i><br><ol><li>(Issime) German (language)</li></ol>
törfe|törfesch|törftet|tarf|tarfsch|törfet|törfti|törft|törfte|törftesch|törfi|törf	<i>verb</i><br><ol><li>(Uri, auxiliary) to be allowed; may</li></ol>
tötzle	<i>verb</i><br><ol><li>(Uri) To play children's game in which one throws blocks of wood (or stones) at a target, similar to cornhole.</li></ol>
tööde|töödt	<i>verb</i><br><ol><li>to kill</li></ol>
tünn|tünnscht|tüner|tünne|tünns|tünni	<i>adj</i><br><ol><li>thin</li></ol>
tüüf	<i>adj</i><br><ol><li>(Uri) deep</li></ol>
tüür|tüüri|tüürscht|tüürs|tüürer|tüüre	<i>adj</i><br><ol><li>dear; expensive</li></ol>
tüütsch|tüütsche|tüütschs|tüütschi	<i>adj</i><br><ol><li>German</li></ol>
u	<i>conj</i><br><ol><li>(Bern) and</li></ol>
ubercha	<i>verb</i><br><ol><li>(Uri) to overcome, overwhelm</li></ol>
ubermaale	<i>verb</i><br><ol><li>(Uri) to milk only once daily, or only occasionally</li></ol>
ubersare	<i>verb</i><br><ol><li>(Uri, intransitive) to flood</li></ol>
ufe	<i>adv</i><br><ol><li>up, upwards</li></ol>
ufeluege|ufeglueget|lueget ufe	<i>verb</i><br><ol><li>to look up to/at</li></ol>
umenand	<i>adv</i><br><ol><li>around</li></ol>
umenläutsche	<i>verb</i><br><ol><li>(Uri) to wander around idly</li></ol>
umespringe|springt ume|umegsprunge	<i>verb</i><br><ol><li>to run around</li></ol>
umestaa|umegstande|staat ume	<i>verb</i><br><ol><li>to stand around</li></ol>
ummerittä	<i>verb</i><br><ol><li>(Formazza) to play</li></ol>
ummewappele	<i>verb</i><br><ol><li>(Uri) to stagger, wobble</li></ol>
unz widergsien	<i>intj</i><br><ol><li>(Issime) goodbye</li></ol>
urig	<i>adj</i><br><ol><li>wild, tempestuous, raging (of the weather)</li><li>uncouth, irascible (of people)</li></ol>
use	<i>adv</i><br><ol><li>out</li></ol>
usechoo|chunt use|usecheem	<i>verb</i><br><ol><li>to come out, appear</li></ol>
ustag	<i>noun</i><br><ol><li>(Gressoney) spring (season)</li></ol>
ustog	<i>noun</i><br><ol><li>(Carcoforo) spring (season)</li></ol>
uu|u	<i>adv</i><br><ol><li>very</li></ol>
uufluege|luegt uuf|uufgluegt	<i>verb</i><br><ol><li>to look up, glance up</li></ol>
uufschriibe|uufschriibt|uufgschribe	<i>verb</i><br><ol><li>to write down</li></ol>
uuftue|tuet uuf|uuftaa	<i>verb</i><br><ol><li>to open</li><li>(of the weather) to clear up, brighten up</li></ol>
uusgsee|gseet uus	<i>verb</i><br><ol><li>to look, seem</li></ol>
uushalte|haltet uus|uusghalte	<i>verb</i><br><ol><li>to bear, stand, endure</li></ol>
uusriibe|uusgribe|riibt uus	<i>verb</i><br><ol><li>to rub out, rub off, rub away</li><li>to rub (the eyes)</li></ol>
uusstrecke|uusgestreckt|streckt uus	<i>verb</i><br><ol><li>(transitive) to extend</li><li>(reflexive) to stretch out (oneself)</li></ol>
verbrëche	<i>verb</i><br><ol><li>(Uri, transitive) to break</li></ol>
vercheert	<i>adj</i><br><ol><li>inverted, inside out, upside down</li><li>(figuratively) wrong, amiss</li></ol>
verchünde	<i>verb</i><br><ol><li>(Uri) to pronounce something from a pulpit, often a betrothal</li></ol>
vergunstig	<i>adj</i><br><ol><li>(Uri) envious, jealous</li></ol>
verhege	<i>verb</i><br><ol><li>(Uri) to muddle, mess up</li></ol>
verherge	<i>verb</i><br><ol><li>(Uri, transitive) to mess up, disorder</li></ol>
verlaa|verlaat	<i>verb</i><br><ol><li>to leave</li></ol>
verlëchne	<i>verb</i><br><ol><li>(Uri, of wooden containers) To leak as a result of the wood being dehydrated, therefore being unable to reseal and hold the liquid inside.</li></ol>
verrigle	<i>verb</i><br><ol><li>to bolt, bar (a door)</li><li>to lock up</li></ol>
verrode|verrodt	<i>verb</i><br><ol><li>to move, stir</li></ol>
versprütze|versprützt	<i>verb</i><br><ol><li>to burst, break, split</li></ol>
vertschüeppe	<i>verb</i><br><ol><li>(Uri) to cover in small shingles</li></ol>
vertwelle	<i>verb</i><br><ol><li>(Uri, reflexive) to kill time</li></ol>
verware	<i>verb</i><br><ol><li>(Uri) to perform the Anointing of the Sick</li></ol>
verwësme	<i>verb</i><br><ol><li>(Uri) to rot, decay</li></ol>
verzele|verzelt	<i>verb</i><br><ol><li>to tell, narrate, report</li></ol>
verzenke	<i>verb</i><br><ol><li>(Uri) to irritate, bother</li></ol>
verzierige	<i>verb</i><br><ol><li>(Uri) to decorate, garnish</li></ol>
vier	<i>num</i><br><ol><li>four</li></ol>
vole|völlscht|völler	<i>adj</i><br><ol><li>full</li></ol>
vrattrus Got	<i>intj</i><br><ol><li>(Rimella and Campello Monti) thank you</li></ol>
vrittàg	<i>noun</i><br><ol><li>(Rimella and Campello Monti) Friday</li></ol>
vruantag	<i>noun</i><br><ol><li>(Issime) Thursday</li></ol>
vréitag	<i>noun</i><br><ol><li>(Issime) Friday</li></ol>
vröntàg	<i>noun</i><br><ol><li>(Rimella and Campello Monti) Thursday</li></ol>
vucks	<i>noun</i><br><ol><li>(Issime) fox</li></ol>
vàtter	<i>noun</i><br><ol><li>(Rimella and Campello Monti) father</li></ol>
waas|waa	<i>pron</i><br><ol><li>what</li></ol>
wailsch	<i>noun</i><br><ol><li>(Carcoforo) Italian (language)</li></ol>
walts	<i>noun</i><br><ol><li>(Rimella and Campello Monti) Italian (language)</li></ol>
warm	<i>adj</i><br><ol><li>(Formazza) warm</li></ol>
warr	<i>adv</i><br><ol><li>(Uri) whither, where (to which place)</li></ol>
wasser	<i>noun</i><br><ol><li>(Gressoney, Issime, Carcoforo, Formazza) water</li></ol>
watta	<i>noun</i><br><ol><li>(Carcoforo) sister</li></ol>
watter	<i>noun</i><br><ol><li>(Rimella and Campello Monti) rain</li></ol>
wattà	<i>noun</i><br><ol><li>(Rimella and Campello Monti) sister</li></ol>
weder	<i>conj</i><br><ol><li>(Uri) neither</li></ol><br><i>intj</i><br><ol><li>(Uri) Indicates that one is resuming what they were previously saying after being interrupted: "anyways", "back to what I was saying"</li></ol>
weidu	<i>noun</i><br><ol><li>(Issime) grass</li></ol>
weigge	<i>verb</i><br><ol><li>(Uri, reflexive) to move, stir</li></ol>
welle|wettesch|wette|will|wellesch|wett|wetti|well|wellt|wettet|welli|weint|wit	<i>verb</i><br><ol><li>(Uri) to want</li></ol>
wend	<i>noun</i><br><ol><li>(Rimella and Campello Monti) wind</li></ol>
wenter	<i>noun</i><br><ol><li>(Rimella and Campello Monti) winter</li></ol>
wetta	<i>noun</i><br><ol><li>(Issime) sister</li></ol>
wetter	<i>noun</i><br><ol><li>(Issime) rain</li></ol>
wi	<i>noun</i><br><ol><li>(Gressoney, Carcoforo, Rimella and Campello Monti) wine</li></ol>
wib	<i>noun</i><br><ol><li>woman</li><li>wife</li></ol>
widleich	<i>adj</i><br><ol><li>supple, lithe, willowy</li></ol>
wii	<i>noun</i><br><ol><li>(Formazza) wine</li></ol>
wiiss|wiisser|wiissischt	<i>adj</i><br><ol><li>white</li></ol>
wind	<i>noun</i><br><ol><li>(Carcoforo) wind</li></ol>
wingsle	<i>verb</i><br><ol><li>(Uri) to wriggle, fidget</li></ol>
winn	<i>noun</i><br><ol><li>(Issime) wind</li></ol>
winter	<i>noun</i><br><ol><li>(Issime, Carcoforo) winter</li></ol>
winterlüem	<i>adj</i><br><ol><li>(Uri) Only feeling slightly chilly, as a result of being pampered by staying in a warm stable.</li></ol>
wiss	<i>adj</i><br><ol><li>(Gressoney, Carcoforo, Rimella and Campello Monti, Formazza) white</li></ol>
woare	<i>adj</i><br><ol><li>(Gressoney) warm</li></ol>
woarm	<i>adj</i><br><ol><li>(Issime) warm</li></ol>
wol chomne|wol chomu	<i>intj</i><br><ol><li>(Rimella and Campello Monti) welcome</li></ol>
wol vergelzgott	<i>intj</i><br><ol><li>(Issime) thank you</li></ol>
wolf	<i>noun</i><br><ol><li>(Carcoforo, Formazza, Gressoney, Issime, Rimella and Campello Monti) wolf</li></ol>
wolgcheemen	<i>intj</i><br><ol><li>(Issime) welcome</li></ol>
woni	<i>abbrev</i><br><ol><li>Contraction of wo + i.</li></ol>
worbe	<i>verb</i><br><ol><li>(Uri) to turn hay</li></ol>
wore	<i>adj</i><br><ol><li>(Carcoforo) warm</li></ol>
wort	<i>noun</i><br><ol><li>(Formazza) word</li></ol>
woul chemne|woul cheme	<i>intj</i><br><ol><li>(Carcoforo) welcome</li></ol>
wourd	<i>noun</i><br><ol><li>(Carcoforo) word</li></ol>
wuart	<i>noun</i><br><ol><li>(Issime) word</li></ol>
wàsser	<i>noun</i><br><ol><li>(Rimella and Campello Monti) water</li></ol>
wälsch	<i>adj</i><br><ol><li>pertaining to the Romance-speaking areas and population of Switzerland</li><li>Italian</li></ol>
wältsch	<i>noun</i><br><ol><li>(Formazza) Italian (language)</li></ol>
wäsche	<i>verb</i><br><ol><li>(Uri) to wash</li></ol>
wätté	<i>noun</i><br><ol><li>(Gressoney) sister</li></ol>
wéin	<i>noun</i><br><ol><li>(Issime) wine</li></ol>
wéiss	<i>adj</i><br><ol><li>(Issime) white</li></ol>
wéllkòmm	<i>intj</i><br><ol><li>(Gressoney) welcome</li></ol>
wénn	<i>noun</i><br><ol><li>(Gressoney, Formazza) wind</li></ol>
wénter	<i>noun</i><br><ol><li>(Gressoney, Formazza) winter</li></ol>
wér kseenisch de	<i>intj</i><br><ol><li>(Formazza) goodbye</li></ol>
wérme	<i>adj</i><br><ol><li>(Rimella and Campello Monti) warm</li></ol>
wër	<i>pron</i><br><ol><li>(Uri, interrogative) who</li></ol>
wërde	<i>verb</i><br><ol><li>(Uri, auxiliary) will</li></ol>
wòrt	<i>noun</i><br><ol><li>(Gressoney) word</li></ol>
wört	<i>noun</i><br><ol><li>(Rimella and Campello Monti) word</li></ol>
wüsse|wüssesch|wüssti|wüsstet|wüsst|wüsstesch|wüsste|wüssi|wüss|wäiss|weiss|gwüss|weisch	<i>verb</i><br><ol><li>to know, be aware of</li></ol>
z	<i>article</i><br><ol><li>Synonym of s: the</li></ol>
zale|zalt|zalti	<i>verb</i><br><ol><li>to pay</li></ol>
zam	<i>adj</i><br><ol><li>tame, gentle</li><li>(of weather) mild</li></ol>
zeerscht	<i>adv</i><br><ol><li>first; at first</li></ol>
zette	<i>verb</i><br><ol><li>(Uri) to split a haybale, and distribute its hay</li></ol>
zischtag	<i>noun</i><br><ol><li>(Formazza) Tuesday</li></ol>
zischtog	<i>noun</i><br><ol><li>(Carcoforo) Tuesday</li></ol>
zischtàg	<i>noun</i><br><ol><li>(Rimella and Campello Monti) Tuesday</li></ol>
zree	<i>adj</i><br><ol><li>(Uri) stiff, rigid, especially when a symptom of fatigue</li></ol>
zuelose|loset zue|zuegloset	<i>verb</i><br><ol><li>to listen</li></ol>
zwei|zwëi	<i>num</i><br><ol><li>two</li></ol>
zwengge	<i>verb</i><br><ol><li>(Uri) to force</li></ol>
zwenzig	<i>num</i><br><ol><li>(Uri) twenty</li></ol>
zwingle	<i>verb</i><br><ol><li>(Uri, transitive) To force a child to stop crying.</li></ol>
zwänzg	<i>num</i><br><ol><li>twenty</li></ol>
zäme	<i>adv</i><br><ol><li>together</li></ol>
zää|zäh	<i>num</i><br><ol><li>ten</li></ol>
zääme	<i>adv</i><br><ol><li>(Uri) Alternative form of zäme</li></ol>
zéischtag	<i>noun</i><br><ol><li>(Issime) Tuesday</li></ol>
Äberi	<i>noun</i><br><ol><li>(Uri) a snow-free place</li></ol>
Äigeschaft|Äigeschafte	<i>noun</i><br><ol><li>quality, attribute</li></ol>
Ängländer	<i>noun</i><br><ol><li>Englishman</li><li>monkey wrench, adjustable spanner</li><li>English bicycle</li></ol>
Äni	<i>noun</i><br><ol><li>(Uri, informal) grandfather</li></ol>
Ärzt	<i>noun</i><br><ol><li>(Uri) ore</li></ol>
Äsche	<i>noun</i><br><ol><li>(Uri) ash, ashes</li></ol>
Ätti	<i>noun</i><br><ol><li>father, dad</li><li>grandfather</li><li>forefather</li></ol>
Äämberri	<i>noun</i><br><ol><li>(Uri) raspberry</li></ol>
Ërdbebme	<i>noun</i><br><ol><li>(Uri) earthquake</li></ol>
Ëërde	<i>noun</i><br><ol><li>earth, soil, ground</li><li>Earth (planet)</li></ol>
Öpfel	<i>noun</i><br><ol><li>(Kurzenberg (Appenzell), Bern, Grisons, Lucerne, St. Gallen, Schwyz, Solothurn, Zürich) apple</li></ol>
Üf der Matt	<i>name</i><br><ol><li>(Uri) Andermatt (a village in Uri canton, Switzerland).</li></ol>
àju	<i>noun</i><br><ol><li>(Rimella and Campello Monti) mother</li></ol>
àlts	<i>pron</i><br><ol><li>(Rimella and Campello Monti) everything, all</li></ol>
àltà	<i>adj</i><br><ol><li>(Rimella and Campello Monti) old</li></ol>
àttu	<i>noun</i><br><ol><li>(Rimella and Campello Monti) father, dad</li></ol>
ässe|isst|ggässe	<i>verb</i><br><ol><li>to eat</li></ol>
ässä	<i>verb</i><br><ol><li>(Formazza) to eat</li></ol>
äxgüsi	<i>intj</i><br><ol><li>excuse me</li></ol>
ääne	<i>adv</i><br><ol><li>(Uri) over there</li></ol>
èèrnscht	<i>adj</i><br><ol><li>serious</li></ol>
éisch	<i>noun</i><br><ol><li>(Issime) ice</li></ol>
ëben	<i>adj</i><br><ol><li>(Uri) even, flat, smooth</li></ol><br><i>adv</i><br><ol><li>(Uri) so, just</li></ol>
ìsch	<i>verb</i><br><ol><li>(Alsatian) is (third person singular)</li></ol>
öise|öisers|öisem|öiseri|öiserem|öisne|öisi|öisere|öises	<i>det</i><br><ol><li>our</li></ol>
öpfil	<i>noun</i><br><ol><li>(Issime) apple</li></ol>
öppe	<i>adv</i><br><ol><li>about, approximately</li><li>finally</li><li>at times, occasionally, on occasion</li></ol>
öpper|öpperem|öper	<i>pron</i><br><ol><li>someone, somebody</li></ol>
öppis|öpis|öppisem	<i>pron</i><br><ol><li>something; anything</li></ol>
übercho|chunt über|überchemti|überchunt|überchoo|chemti über	<i>verb</i><br><ol><li>to receive, to get</li></ol>
üstàg	<i>noun</i><br><ol><li>(Rimella and Campello Monti) spring (season)</li></ol>
ŝchamschtog	<i>noun</i><br><ol><li>(Carcoforo) Saturday</li></ol>
ŝchegi	<i>verb</i><br><ol><li>(Carcoforo) to say</li></ol>
ŝchi	<i>verb</i><br><ol><li>(Carcoforo, Rimella and Campello Monti) to be</li></ol>
ŝchu	<i>noun</i><br><ol><li>(Carcoforo, Rimella and Campello Monti) son</li></ol>
ŝchumer	<i>noun</i><br><ol><li>(Rimella and Campello Monti) summer</li></ol>
ŝchummer	<i>noun</i><br><ol><li>(Carcoforo) summer</li></ol>
ŝchunna	<i>noun</i><br><ol><li>(Carcoforo) sun, the Sun</li></ol>
ŝchunnutog	<i>noun</i><br><ol><li>(Carcoforo) Sunday</li></ol>
ŝchunnà	<i>noun</i><br><ol><li>(Rimella and Campello Monti) sun, the Sun</li></ol>
ŝchuntàg	<i>noun</i><br><ol><li>(Rimella and Campello Monti) Sunday</li></ol>
ŝchàmstàg	<i>noun</i><br><ol><li>(Rimella and Campello Monti) Saturday</li></ol>
ŝchége	<i>verb</i><br><ol><li>(Rimella and Campello Monti) say</li></ol>
