a	<i>verb</i><br><ol><li>(transitive, Mpakwithi) to pull</li></ol>
ad̪iki	<i>noun</i><br><ol><li>(Mpakwithi) moon</li></ol><br><i>adj</i><br><ol><li>(Mpakwithi) yellow</li></ol>
ad̪iti	<i>noun</i><br><ol><li>(Mpakwithi) wrinkle</li></ol>
anu	<i>noun</i><br><ol><li>(Mpakwithi) hip</li></ol>
arana	<i>noun</i><br><ol><li>(Mpakwithi) toenail</li><li>(Mpakwithi) fingernail</li></ol>
awn̪ilad̪i	<i>noun</i><br><ol><li>(Mpakwithi) oldest sister</li></ol>
awn̪ipwa	<i>noun</i><br><ol><li>(Mpakwithi) middle sister</li></ol>
ay	<i>noun</i><br><ol><li>(Mpakwithi) vegetable</li></ol>
aŋa	<i>verb</i><br><ol><li>(intransitive, Mpakwithi) to go</li><li>(intransitive, Mpakwithi) to come</li></ol>
aŋukwin̪i	<i>noun</i><br><ol><li>(Mpakwithi) maternal uncle</li></ol>
aŋurud̪i	<i>noun</i><br><ol><li>(Mpakwithi) my grandchild</li></ol>
aŋut̪a	<i>noun</i><br><ol><li>(Mpakwithi) daughter</li></ol>
aɽu	<i>verb</i><br><ol><li>(intransitive, Mpakwithi) to bark</li></ol>
aᶁima	<i>verb</i><br><ol><li>(intransitive, Mpakwithi) to suffer</li></ol>
ba	<i>noun</i><br><ol><li>(Mpakwithi) island</li></ol>
baanu	<i>noun</i><br><ol><li>(Mpakwithi) wild cucumber</li><li>(Mpakwithi) grape</li></ol>
bana	<i>verb</i><br><ol><li>(intransitive, Mpakwithi) to climb</li></ol>
barana	<i>noun</i><br><ol><li>(Mpakwithi) carpet snake</li></ol>
baw	<i>noun</i><br><ol><li>(Mpakwithi) tooth</li></ol>
bay	<i>noun</i><br><ol><li>(Mpakwithi) barracouta</li></ol>
baɣa	<i>noun</i><br><ol><li>(Mpakwithi) bag</li><li>(Mpakwithi) marsupial's pouch</li></ol>
baɽi	<i>noun</i><br><ol><li>(Mpakwithi) up</li></ol>
biini	<i>adj</i><br><ol><li>(Mpakwithi) short</li></ol>
buʔu	<i>noun</i><br><ol><li>(Mpakwithi) ghost</li></ol>
buʔu-ᶁe	<i>noun</i><br><ol><li>(Mpakwithi) clever man</li></ol>
bwa	<i>verb</i><br><ol><li>(transitive, Mpakwithi) to break</li></ol>
bwana	<i>noun</i><br><ol><li>(Mpakwithi) bream</li></ol>
bwaraka	<i>noun</i><br><ol><li>(Mpakwithi) Torres Strait pigeon</li></ol>
bwaʔa	<i>noun</i><br><ol><li>(Mpakwithi) meat</li><li>(Mpakwithi) flesh</li></ol>
bwii	<i>verb</i><br><ol><li>(transitive, Mpakwithi) to kill</li></ol>
bwiini	<i>noun</i><br><ol><li>(Mpakwithi) back</li></ol>
bwæni	<i>verb</i><br><ol><li>(intransitive, Mpakwithi) to break</li></ol>
büɣu	<i>noun</i><br><ol><li>(Mpakwithi) scorpion</li></ol>
bɽadʳa	<i>adj</i><br><ol><li>(Mpakwithi) long ago</li></ol>
bɽaŋa	<i>noun</i><br><ol><li>(Mpakwithi) husband</li></ol>
bɽeɲi	<i>noun</i><br><ol><li>(Mpakwithi) beach</li></ol>
bɽeʔeŋa	<i>verb</i><br><ol><li>(intransitive, Mpakwithi) to play</li></ol>
bɽi	<i>noun</i><br><ol><li>(Mpakwithi) mud</li><li>(Mpakwithi) red paint</li></ol>
bɽiŋi	<i>verb</i><br><ol><li>(intransitive, Mpakwithi) to be dirty</li></ol>
bɽiŋi-bɽiŋi	<i>verb</i><br><ol><li>(intransitive, Mpakwithi) to be noisy</li></ol>
bɽuyi	<i>noun</i><br><ol><li>(Mpakwithi) night</li></ol>
bɽuyi-bɽuyi	<i>noun</i><br><ol><li>(Mpakwithi) afternoon</li></ol>
dadi	<i>adj</i><br><ol><li>(Mpakwithi) fast</li></ol>
dimiᶁit̪i	<i>noun</i><br><ol><li>(Mpakwithi) water goanna</li></ol>
dupɽiɣu	<i>noun</i><br><ol><li>(Mpakwithi) old woman</li></ol>
duru	<i>noun</i><br><ol><li>(Mpakwithi) four-prong spear</li></ol>
duulu	<i>noun</i><br><ol><li>(Mpakwithi) garfish</li></ol>
duunu	<i>noun</i><br><ol><li>(Mpakwithi) small whiting (fish)</li></ol>
duwiði	<i>noun</i><br><ol><li>(Mpakwithi) name</li></ol>
duðu	<i>noun</i><br><ol><li>(Mpakwithi) word</li></ol>
dwakwabat̪i	<i>noun</i><br><ol><li>(Mpakwithi) salmon</li></ol>
dwaɣa	<i>noun</i><br><ol><li>(Mpakwithi) beach</li></ol>
dwiri	<i>noun</i><br><ol><li>(Mpakwithi) sugarbag bee</li></ol>
dʳa	<i>verb</i><br><ol><li>(transitive, Mpakwithi) to leave</li><li>(transitive, Mpakwithi) to put down</li></ol>
dʳadat̪a	<i>verb</i><br><ol><li>(intransitive, Mpakwithi) to live</li><li>(intransitive, Mpakwithi) to lie down</li></ol>
dʳat̪i	<i>noun</i><br><ol><li>(Mpakwithi) current</li><li>(Mpakwithi) tide</li></ol><br><i>verb</i><br><ol><li>(Mpakwithi) to lie down</li></ol>
dʳeebɽi	<i>noun</i><br><ol><li>(Mpakwithi) umbrella palm</li></ol>
dʳeegwati	<i>noun</i><br><ol><li>(Mpakwithi) trevally</li></ol>
dʳeemɽi	<i>noun</i><br><ol><li>(Mpakwithi) outrigger</li><li>(Mpakwithi) shirt</li></ol>
dʳeeni	<i>adj</i><br><ol><li>(Mpakwithi) different</li></ol>
dʳeet̪imɽi	<i>noun</i><br><ol><li>(Mpakwithi) shirt</li></ol>
dʳi	<i>noun</i><br><ol><li>(Mpakwithi) throat</li></ol>
dʳiiᶁiti	<i>adj</i><br><ol><li>(Mpakwithi) sweet</li></ol>
dʳwamɽa	<i>noun</i><br><ol><li>(Mpakwithi) woman</li></ol>
dʳwaŋa	<i>noun</i><br><ol><li>(Mpakwithi) wife</li></ol>
dʳwaʔara	<i>noun</i><br><ol><li>(Mpakwithi) today</li><li>(Mpakwithi) daytime</li></ol>
dʳwe	<i>noun</i><br><ol><li>(Mpakwithi) shell</li></ol>
dʳwili	<i>noun</i><br><ol><li>(Mpakwithi) brolga</li></ol>
dʳya	<i>noun</i><br><ol><li>(Mpakwithi) wing</li><li>(Mpakwithi) arm</li></ol>
d̪a	<i>noun</i><br><ol><li>(Mpakwithi) splinter</li><li>(Mpakwithi) wood chip</li></ol>
d̪aaƫamana	<i>noun</i><br><ol><li>(Mpakwithi) sap</li></ol>
d̪aɣu	<i>noun</i><br><ol><li>(Mpakwithi) testicles</li></ol>
d̪aʔa	<i>noun</i><br><ol><li>(Mpakwithi) grass</li></ol>
d̪eeni	<i>noun</i><br><ol><li>(Mpakwithi) wasp</li></ol>
d̪i	<i>noun</i><br><ol><li>(Mpakwithi) Smooth-bark tea tree (Melaleuca quinquenervia)</li></ol><br><i>verb</i><br><ol><li>(transitive, Mpakwithi) to suck</li></ol>
d̪it̪i	<i>noun</i><br><ol><li>(Mpakwithi) New Guinea sago</li></ol>
d̪uɽi	<i>noun</i><br><ol><li>(Mpakwithi) kingfisher</li></ol>
d̪wa	<i>noun</i><br><ol><li>(Mpakwithi) eye</li></ol><br><i>verb</i><br><ol><li>(transitive, Mpakwithi) to catch</li></ol>
d̪wa-pawa	<i>noun</i><br><ol><li>(Mpakwithi) eyeball</li></ol>
d̪wa-pay	<i>noun</i><br><ol><li>(Mpakwithi) eyebrow</li></ol>
d̪walad̪i	<i>noun</i><br><ol><li>(Mpakwithi) wild dog</li></ol>
d̪wimi	<i>noun</i><br><ol><li>(Mpakwithi) string</li></ol>
d̪wini	<i>noun</i><br><ol><li>(Mpakwithi) vine</li></ol>
d̪wiʔi	<i>noun</i><br><ol><li>(Mpakwithi) buttocks</li></ol>
d̪ææwat̪i	<i>adj</i><br><ol><li>(Mpakwithi) greedy</li></ol>
ga	<i>noun</i><br><ol><li>(Mpakwithi) mouth</li></ol><br><i>verb</i><br><ol><li>(transitive, Mpakwithi) to poke</li><li>(transitive, Mpakwithi) to peel</li></ol>
gamaraŋu	<i>noun</i><br><ol><li>(Mpakwithi) pannikin</li></ol>
gapɽa	<i>adj</i><br><ol><li>(Mpakwithi) bad</li></ol>
gatʳali	<i>adj</i><br><ol><li>(Mpakwithi) sour</li></ol>
gawri	<i>verb</i><br><ol><li>(transitive, Mpakwithi) to look for</li></ol>
gawðaɣi	<i>noun</i><br><ol><li>(Mpakwithi) crocodile</li></ol>
gaɽaka	<i>noun</i><br><ol><li>(Mpakwithi) star</li></ol>
gaʔaga	<i>noun</i><br><ol><li>(Mpakwithi) kookaburra</li></ol>
gaʔu	<i>noun</i><br><ol><li>(Mpakwithi) chin</li></ol>
gaʔu-ŋa	<i>noun</i><br><ol><li>(Mpakwithi) beard</li></ol>
geɽa	<i>verb</i><br><ol><li>(intransitive, Mpakwithi) to sit</li></ol>
geʔe	<i>det</i><br><ol><li>(Mpakwithi) no</li></ol>
geʔekeka	<i>verb</i><br><ol><li>(transitive, Mpakwithi) to tickle</li></ol>
geᶁiŋana	<i>noun</i><br><ol><li>(Mpakwithi) emu</li></ol>
goy	<i>noun</i><br><ol><li>(Mpakwithi) buck wallaby</li></ol>
gu	<i>noun</i><br><ol><li>(Mpakwithi) knee</li></ol>
guunu	<i>adj</i><br><ol><li>(Mpakwithi) heavy</li></ol>
guwana	<i>noun</i><br><ol><li>(Mpakwithi) curlew</li></ol>
gwapɽa	<i>verb</i><br><ol><li>(transitive, Mpakwithi) to eat</li><li>(transitive, Mpakwithi) to drink</li></ol>
gwat̪a	<i>noun</i><br><ol><li>(Mpakwithi) north</li></ol>
gweeni	<i>noun</i><br><ol><li>(Mpakwithi) lily</li></ol>
gwunu	<i>noun</i><br><ol><li>(Mpakwithi) ankle</li><li>(Mpakwithi) knuckle</li></ol>
gya	<i>noun</i><br><ol><li>(Mpakwithi) cat</li></ol>
gæ	<i>verb</i><br><ol><li>(transitive, Mpakwithi) to ask</li></ol>
gægi	<i>verb</i><br><ol><li>(intransitive, Mpakwithi) to shout</li></ol>
gæʔama	<i>verb</i><br><ol><li>(intransitive, Mpakwithi) to laugh</li></ol>
id̪i	<i>noun</i><br><ol><li>(Mpakwithi) lawyer cane</li></ol>
iɣi	<i>noun</i><br><ol><li>(Mpakwithi) termite mound</li><li>(Mpakwithi) snapper</li></ol>
iɣiti	<i>adj</i><br><ol><li>(Mpakwithi) brown</li></ol>
kad̪aka	<i>noun</i><br><ol><li>(Mpakwithi) oyster</li></ol>
kali	<i>noun</i><br><ol><li>(Mpakwithi) hole</li></ol>
kalipwa	<i>noun</i><br><ol><li>(Mpakwithi) gully</li></ol>
kan̪aŋa	<i>verb</i><br><ol><li>(transitive, Mpakwithi) to find</li></ol>
karagwa	<i>verb</i><br><ol><li>(intransitive, Mpakwithi) to crawl</li></ol>
karuku	<i>noun</i><br><ol><li>(Mpakwithi) beer</li></ol>
karupu	<i>noun</i><br><ol><li>(Mpakwithi) red kangaroo</li></ol>
katiʔi	<i>adv</i><br><ol><li>(Mpakwithi) perhaps</li><li>(Mpakwithi) soon</li></ol>
kat̪i	<i>adj</i><br><ol><li>(Mpakwithi) deep</li></ol>
kaw	<i>noun</i><br><ol><li>(Mpakwithi) lice</li></ol>
kayi-kayi	<i>adv</i><br><ol><li>(Mpakwithi) later on</li></ol>
kaɣu	<i>noun</i><br><ol><li>(Mpakwithi) skin</li></ol>
kaɣu rimi-rimi	<i>adj</i><br><ol><li>(Mpakwithi) jealous</li></ol>
kaɣu-weeɣe	<i>noun</i><br><ol><li>(Mpakwithi) muscle</li></ol>
kaɣu-βwat̪i	<i>noun</i><br><ol><li>(Mpakwithi) mixed-race</li></ol>
kaɣu-ᶁe	<i>noun</i><br><ol><li>(Mpakwithi) palm of hand</li></ol>
kaɣupaɽaƫi	<i>noun</i><br><ol><li>(Mpakwithi) coconut palm</li></ol>
kaɽa	<i>noun</i><br><ol><li>(Mpakwithi) down</li></ol>
kaᶁi	<i>noun</i><br><ol><li>(Mpakwithi) black ibis</li></ol>
kerimi	<i>adj</i><br><ol><li>(Mpakwithi) clean</li><li>(Mpakwithi) shiny</li></ol>
kili	<i>noun</i><br><ol><li>(Mpakwithi) king parrot</li></ol>
kiri-kiri	<i>noun</i><br><ol><li>(Mpakwithi) wood duck</li></ol>
kiɽi	<i>noun</i><br><ol><li>(Mpakwithi) knife</li></ol>
ku	<i>noun</i><br><ol><li>(Mpakwithi) tree</li><li>(Mpakwithi) wood</li><li>(Mpakwithi) stick</li></ol>
kuku	<i>noun</i><br><ol><li>(Mpakwithi) maternal grandfather</li><li>(Mpakwithi) paternal aunt</li></ol>
kukulææɣe	<i>noun</i><br><ol><li>(Mpakwithi) islander</li></ol>
kumala	<i>noun</i><br><ol><li>(Mpakwithi) sweet potato</li></ol>
kumuᶁini	<i>noun</i><br><ol><li>(Mpakwithi) woodpecker</li></ol>
kunu	<i>adv</i><br><ol><li>(Mpakwithi) now</li></ol>
kutʳaka	<i>noun</i><br><ol><li>(Mpakwithi) fighting stick</li></ol>
kuwati	<i>noun</i><br><ol><li>(Mpakwithi) grub</li></ol>
kwabi	<i>noun</i><br><ol><li>(Mpakwithi) quandong</li></ol>
kwad̪aʔa	<i>noun</i><br><ol><li>(Mpakwithi) crane</li></ol>
kwana	<i>noun</i><br><ol><li>(Mpakwithi) nape</li></ol>
kwe	<i>noun</i><br><ol><li>(Mpakwithi) foot</li></ol>
kwe-rãɣa	<i>noun</i><br><ol><li>(Mpakwithi) footprint</li></ol>
kweʔe	<i>noun</i><br><ol><li>(Mpakwithi) straight spear</li></ol>
kwii	<i>verb</i><br><ol><li>(transitive, Mpakwithi) to have</li><li>(transitive, Mpakwithi) to keep</li><li>(transitive, Mpakwithi) to look after</li></ol>
kwiiɣi	<i>noun</i><br><ol><li>(Mpakwithi) oldest sister</li></ol>
kwiniiɣi	<i>noun</i><br><ol><li>(Mpakwithi) cassowary</li></ol>
kwiniɣi	<i>noun</i><br><ol><li>(Mpakwithi) possum</li></ol>
kwiʔit̪i	<i>noun</i><br><ol><li>(Mpakwithi) long yam</li></ol>
kwumɽu	<i>noun</i><br><ol><li>(Mpakwithi) wrist</li></ol>
kyabara	<i>noun</i><br><ol><li>(Mpakwithi) alligator</li></ol>
köyɣi	<i>adj</i><br><ol><li>(Mpakwithi) left side</li></ol>
la	<i>noun</i><br><ol><li>(Mpakwithi) black snake</li></ol>
laagaʔa	<i>noun</i><br><ol><li>(Mpakwithi) death adder</li></ol>
ladi	<i>noun</i><br><ol><li>(Mpakwithi) marrow</li></ol>
lad̪i	<i>noun</i><br><ol><li>(Mpakwithi) girl</li></ol>
laga-laga	<i>noun</i><br><ol><li>(Mpakwithi) leg corroboree</li></ol>
lali	<i>noun</i><br><ol><li>(Mpakwithi) harpoon</li></ol>
lamalat̪i	<i>noun</i><br><ol><li>(Mpakwithi) stranger</li></ol>
lana	<i>noun</i><br><ol><li>(Mpakwithi) tongue</li></ol>
lanu	<i>noun</i><br><ol><li>(Mpakwithi) sea</li></ol>
lat̪imi	<i>adj</i><br><ol><li>(Mpakwithi) alive</li></ol>
lay	<i>verb</i><br><ol><li>(transitive, Mpakwithi) to carry</li></ol>
laðu	<i>noun</i><br><ol><li>(Mpakwithi) hawk</li></ol>
laɣa	<i>noun</i><br><ol><li>(Mpakwithi) lizard</li></ol>
laɣu	<i>noun</i><br><ol><li>(Mpakwithi) jaw</li><li>(Mpakwithi) cheek</li><li>(Mpakwithi) temple</li></ol>
laɣubɽeɽi	<i>noun</i><br><ol><li>(Mpakwithi) white cockatoo</li></ol>
luluma	<i>verb</i><br><ol><li>(intransitive, Mpakwithi) to swell up</li></ol>
luʔu	<i>noun</i><br><ol><li>(Mpakwithi) mangrove</li></ol>
lwaga	<i>noun</i><br><ol><li>(Mpakwithi) sickness</li></ol>
lwagati	<i>noun</i><br><ol><li>(Mpakwithi) kingfish</li></ol>
lwagat̪imɽi	<i>adj</i><br><ol><li>(Mpakwithi) sick</li></ol>
lwe	<i>noun</i><br><ol><li>(Mpakwithi) lake</li></ol>
lwiiɣi	<i>adj</i><br><ol><li>(Mpakwithi) angry</li></ol>
læ	<i>verb</i><br><ol><li>(intransitive, Mpakwithi) to walk around</li></ol>
læd̪i	<i>noun</i><br><ol><li>(Mpakwithi) grass tree</li></ol>
lææɣa	<i>noun</i><br><ol><li>(Mpakwithi) tree fork</li></ol>
ma	<i>noun</i><br><ol><li>(Mpakwithi) man</li></ol><br><i>verb</i><br><ol><li>(transitive, Mpakwithi) to hear</li><li>(transitive, Mpakwithi) to listen</li></ol>
malɣari	<i>noun</i><br><ol><li>(Mpakwithi) corroboree</li></ol>
mamalit̪i	<i>noun</i><br><ol><li>(Mpakwithi) message stick</li></ol>
marapi	<i>noun</i><br><ol><li>(Mpakwithi) bamboo</li></ol>
maru	<i>noun</i><br><ol><li>(Mpakwithi) queenfish</li></ol>
maruku	<i>noun</i><br><ol><li>(Mpakwithi) horse</li></ol>
mawkwiɣi	<i>noun</i><br><ol><li>(Mpakwithi) countryman</li></ol>
mayi	<i>noun</i><br><ol><li>(Mpakwithi) paternal grandfather</li></ol>
maɣa	<i>noun</i><br><ol><li>(Mpakwithi) small brown snake</li></ol>
maɣu	<i>noun</i><br><ol><li>(Mpakwithi) armpit</li></ol>
maɣunu	<i>noun</i><br><ol><li>(Mpakwithi) lips</li></ol>
maɣuʔiini	<i>noun</i><br><ol><li>(Mpakwithi) saltwater mullet</li></ol>
maʔat̪aŋa	<i>verb</i><br><ol><li>(transitive, Mpakwithi) to lift up</li></ol>
maʔæni	<i>noun</i><br><ol><li>(Mpakwithi) older brother</li><li>(Mpakwithi) paternal uncle</li></ol>
mid̪i	<i>noun</i><br><ol><li>(Mpakwithi) club</li><li>(Mpakwithi) spear thrower</li></ol>
mu	<i>noun</i><br><ol><li>(Mpakwithi) buttocks</li></ol>
murut̪i	<i>noun</i><br><ol><li>(Mpakwithi) fish</li></ol>
mutu-mutu	<i>noun</i><br><ol><li>(Mpakwithi) anthole</li></ol>
mut̪it̪i	<i>noun</i><br><ol><li>(Mpakwithi) white ibis</li></ol>
muwã	<i>noun</i><br><ol><li>(Mpakwithi) fin</li></ol>
muwĩ	<i>noun</i><br><ol><li>(Mpakwithi) fig tree</li></ol>
muʔut̪u	<i>noun</i><br><ol><li>(Mpakwithi) firestick</li></ol>
mwa	<i>noun</i><br><ol><li>(Mpakwithi) fire</li></ol>
mwa-rwiʔi	<i>noun</i><br><ol><li>(Mpakwithi) hot coals</li></ol>
mwi	<i>verb</i><br><ol><li>(intransitive, Mpakwithi) to dance</li></ol>
mwin̪i	<i>noun</i><br><ol><li>(Mpakwithi) sore</li></ol>
myüɣu	<i>noun</i><br><ol><li>(Mpakwithi) short yam</li></ol>
mæ	<i>verb</i><br><ol><li>(intransitive, Mpakwithi) to wake up</li><li>(intransitive, Mpakwithi) to get up</li></ol>
mɽit̪iki	<i>adj</i><br><ol><li>(Mpakwithi) many</li></ol>
mɽæɽaᶁi	<i>noun</i><br><ol><li>(Mpakwithi) land goanna</li></ol>
mɽæ̃ƫiri	<i>noun</i><br><ol><li>(Mpakwithi) black duck</li></ol>
nama	<i>noun</i><br><ol><li>(Mpakwithi) rough-bark tea tree</li></ol>
namaraŋu	<i>noun</i><br><ol><li>(Mpakwithi) frying-pan</li></ol>
napu	<i>verb</i><br><ol><li>(transitive, Mpakwithi) to swallow</li></ol>
natabani	<i>noun</i><br><ol><li>(Mpakwithi) sweat</li></ol>
natimi	<i>adj</i><br><ol><li>(Mpakwithi) tired</li></ol>
nat̪i	<i>noun</i><br><ol><li>(Mpakwithi) father</li></ol>
ni	<i>noun</i><br><ol><li>(Mpakwithi) place</li><li>(Mpakwithi) camp</li></ol>
niiɣi	<i>noun</i><br><ol><li>(Mpakwithi) boy</li></ol>
nubut̪i	<i>noun</i><br><ol><li>(Mpakwithi) navel</li></ol>
nuunu	<i>noun</i><br><ol><li>(Mpakwithi) wild potato</li></ol>
n̪a	<i>noun</i><br><ol><li>(Mpakwithi) fish</li></ol>
n̪agu	<i>noun</i><br><ol><li>(Mpakwithi) fern</li></ol>
n̪amweɣe	<i>noun</i><br><ol><li>(Mpakwithi) ironwood</li></ol>
n̪arama	<i>verb</i><br><ol><li>(intransitive, Mpakwithi) to stand</li></ol>
n̪ed̪i	<i>noun</i><br><ol><li>(Mpakwithi) small cabbage tree</li></ol>
n̪u	<i>adj</i><br><ol><li>(Mpakwithi) different</li></ol>
paana	<i>noun</i><br><ol><li>(Mpakwithi) riverbank</li><li>(Mpakwithi) level</li></ol>
paguru	<i>noun</i><br><ol><li>(Mpakwithi) yawn</li></ol>
palawara	<i>noun</i><br><ol><li>(Mpakwithi) flower</li></ol>
pana	<i>noun</i><br><ol><li>(Mpakwithi) friend</li></ol>
papaƫi	<i>noun</i><br><ol><li>(Mpakwithi) stone</li></ol>
patʳa	<i>noun</i><br><ol><li>(Mpakwithi) canoe</li></ol>
patʳa-dʳeemɽi	<i>noun</i><br><ol><li>(Mpakwithi) outrigger canoe</li></ol>
pat̪a	<i>verb</i><br><ol><li>(transitive, Mpakwithi) to fix</li><li>(transitive, Mpakwithi) to make</li></ol>
pawa	<i>noun</i><br><ol><li>(Mpakwithi) egg</li></ol>
pawƫi	<i>adj</i><br><ol><li>(Mpakwithi) blunt</li></ol>
pay	<i>noun</i><br><ol><li>(Mpakwithi) forehead</li><li>(Mpakwithi) face</li></ol>
pay ðuwi-ðuwi	<i>adj</i><br><ol><li>(Mpakwithi) ashamed</li></ol>
pay-ᶁa	<i>noun</i><br><ol><li>(Mpakwithi) hillside</li></ol>
paɽupaɽaƫi	<i>noun</i><br><ol><li>(Mpakwithi) cottonwood</li></ol>
paʔu	<i>noun</i><br><ol><li>(Mpakwithi) blue-tongue lizard</li></ol>
paᶁiki	<i>adv</i><br><ol><li>(Mpakwithi) recently</li></ol>
pemini	<i>noun</i><br><ol><li>(Mpakwithi) thunder</li></ol>
pimi	<i>num</i><br><ol><li>(Mpakwithi) one</li></ol>
pu	<i>verb</i><br><ol><li>(transitive, Mpakwithi) to do</li><li>(transitive, Mpakwithi) to throw</li></ol>
pulugin̪i	<i>noun</i><br><ol><li>(Mpakwithi) blanket</li></ol>
puluku	<i>noun</i><br><ol><li>(Mpakwithi) bullock</li></ol>
putʳu	<i>noun</i><br><ol><li>(Mpakwithi) sailboat</li></ol>
put̪uku	<i>adj</i><br><ol><li>(Mpakwithi) hard</li></ol>
puyimi	<i>noun</i><br><ol><li>(Mpakwithi) billycan</li></ol>
puði	<i>adj</i><br><ol><li>(Mpakwithi) small</li></ol>
puƫiki	<i>adj</i><br><ol><li>(Mpakwithi) many</li></ol>
puʔa	<i>noun</i><br><ol><li>(Mpakwithi) water</li></ol>
pwapu	<i>noun</i><br><ol><li>(Mpakwithi) lily</li></ol>
pwaʔakwit̪i	<i>noun</i><br><ol><li>(Mpakwithi) kangaroo rat</li></ol>
pwee	<i>verb</i><br><ol><li>(intransitive, Mpakwithi) to go in</li></ol>
pweeke	<i>noun</i><br><ol><li>(Mpakwithi) groper</li></ol>
pwi	<i>noun</i><br><ol><li>(Mpakwithi) bone</li><li>(Mpakwithi) seed</li></ol>
pæ	<i>verb</i><br><ol><li>(intransitive, Mpakwithi) to come out</li></ol>
pæʔa	<i>noun</i><br><ol><li>(Mpakwithi) elbow</li></ol>
pɽa	<i>verb</i><br><ol><li>(transitive, Mpakwithi) to rub</li><li>(transitive, Mpakwithi) to wash</li></ol>
pɽaŋa	<i>noun</i><br><ol><li>(Mpakwithi) morning</li></ol>
pɽeɽe	<i>verb</i><br><ol><li>(transitive, Mpakwithi) to pick up</li></ol>
pɽoʔa	<i>noun</i><br><ol><li>(Mpakwithi) frog</li><li>(Mpakwithi) tadpole</li></ol>
pɽulu	<i>noun</i><br><ol><li>(Mpakwithi) rainy season</li></ol>
pɽuʔu	<i>noun</i><br><ol><li>(Mpakwithi) maggot</li><li>(Mpakwithi) worm</li><li>(Mpakwithi) leech</li><li>(Mpakwithi) ghost</li></ol>
ra	<i>noun</i><br><ol><li>(Mpakwithi) stomach</li></ol><br><i>verb</i><br><ol><li>(transitive, Mpakwithi) to wash</li><li>(transitive, Mpakwithi) to rub</li></ol>
ragu	<i>noun</i><br><ol><li>(Mpakwithi) sandpaper tree</li><li>(Mpakwithi) prawn</li></ol>
rama	<i>adj</i><br><ol><li>(Mpakwithi) empty</li></ol>
rana	<i>noun</i><br><ol><li>(Mpakwithi) sky</li></ol>
ran̪a	<i>noun</i><br><ol><li>(Mpakwithi) river</li></ol>
ran̪apwa	<i>noun</i><br><ol><li>(Mpakwithi) creek</li></ol>
ran̪i	<i>noun</i><br><ol><li>(Mpakwithi) bailer shell</li></ol>
raw	<i>adj</i><br><ol><li>(Mpakwithi) black</li></ol>
raɣu	<i>adj</i><br><ol><li>(Mpakwithi) clear</li></ol>
ri	<i>noun</i><br><ol><li>(Mpakwithi) excrement</li></ol>
riyiga	<i>verb</i><br><ol><li>(transitive, Mpakwithi) to smash</li></ol>
riŋi	<i>verb</i><br><ol><li>(transitive, Mpakwithi) to hit</li><li>(transitive, Mpakwithi) to punch</li></ol>
roga	<i>adj</i><br><ol><li>(Mpakwithi) grey</li></ol>
rud̪i	<i>noun</i><br><ol><li>(Mpakwithi) grandson</li></ol>
rugu	<i>noun</i><br><ol><li>(Mpakwithi) bulrushes</li></ol>
rugunu	<i>noun</i><br><ol><li>(Mpakwithi) stingray</li></ol>
ruluku	<i>noun</i><br><ol><li>(Mpakwithi) taipan</li></ol>
rumu	<i>noun</i><br><ol><li>(Mpakwithi) fishnet</li></ol><br><i>verb</i><br><ol><li>(intransitive, Mpakwithi) to bend down</li></ol>
rumupɽana	<i>noun</i><br><ol><li>(Mpakwithi) kidney</li></ol>
ruri	<i>noun</i><br><ol><li>(Mpakwithi) maternal aunt</li><li>(Mpakwithi) child</li></ol>
ruɽi	<i>noun</i><br><ol><li>(Mpakwithi) maternal aunt</li><li>(Mpakwithi) child</li></ol>
rwa	<i>noun</i><br><ol><li>(Mpakwithi) white paint</li></ol>
rwagaƫi	<i>noun</i><br><ol><li>(Mpakwithi) fishing line</li></ol>
rwamat̪i	<i>noun</i><br><ol><li>(Mpakwithi) bamboo pipe</li></ol>
rwili	<i>noun</i><br><ol><li>(Mpakwithi) almond</li></ol>
rwiʔi	<i>noun</i><br><ol><li>(Mpakwithi) charcoal</li></ol>
rãɣa	<i>noun</i><br><ol><li>(Mpakwithi) shade</li></ol>
rẽɣe	<i>noun</i><br><ol><li>(Mpakwithi) whitefish</li></ol>
sæla	<i>noun</i><br><ol><li>(Mpakwithi) milkwood</li></ol>
tabwa	<i>noun</i><br><ol><li>(Mpakwithi) small bee</li></ol>
tapiƫi	<i>noun</i><br><ol><li>(Mpakwithi) wife's brother</li></ol>
tarama	<i>noun</i><br><ol><li>(Mpakwithi) drum</li></ol>
taβa	<i>noun</i><br><ol><li>(Mpakwithi) road</li></ol>
taβayama	<i>noun</i><br><ol><li>(Mpakwithi) wife's brother</li></ol>
tha	<i>verb</i><br><ol><li>(Mpakwithi) tie</li></ol>
tiini	<i>noun</i><br><ol><li>(Mpakwithi) swamp</li></ol>
tini	<i>noun</i><br><ol><li>(Mpakwithi) tin</li></ol>
tiri	<i>noun</i><br><ol><li>(Mpakwithi) tick</li></ol>
tiɣati	<i>adj</i><br><ol><li>(Mpakwithi) soft</li></ol>
tugumu	<i>noun</i><br><ol><li>(Mpakwithi) cliff</li></ol>
tuɽi	<i>noun</i><br><ol><li>(Mpakwithi) trochus shell</li></ol>
twala	<i>noun</i><br><ol><li>(Mpakwithi) plain</li></ol>
twiniŋa	<i>verb</i><br><ol><li>(transitive, Mpakwithi) to bash</li></ol>
tʳalawati	<i>adj</i><br><ol><li>(Mpakwithi) red</li></ol>
tʳay	<i>noun</i><br><ol><li>(Mpakwithi) penis</li></ol>
tʳaða	<i>noun</i><br><ol><li>(Mpakwithi) barramundi</li></ol>
tʳelimi	<i>noun</i><br><ol><li>(Mpakwithi) blood</li></ol>
tʳoka	<i>noun</i><br><ol><li>(Mpakwithi) head</li></ol>
tʳoka-tʳoka	<i>noun</i><br><ol><li>(Mpakwithi) end</li></ol>
tʳokanwi	<i>noun</i><br><ol><li>(Mpakwithi) lagoon</li></ol>
tʳu	<i>noun</i><br><ol><li>(Mpakwithi) urine</li></ol>
tʳya	<i>noun</i><br><ol><li>(Mpakwithi) ant</li><li>(Mpakwithi) shark</li></ol>
tʳææni	<i>noun</i><br><ol><li>(Mpakwithi) green turtle</li></ol>
t̪a	<i>verb</i><br><ol><li>(intransitive, Mpakwithi) to stand</li><li>(transitive, Mpakwithi) to bite</li><li>(transitive, Mpakwithi) to tie</li><li>(transitive, Mpakwithi) to burn</li><li>(transitive, Mpakwithi) to cook</li></ol>
t̪abwa	<i>noun</i><br><ol><li>(Mpakwithi) younger brother</li><li>(Mpakwithi) younger sister</li></ol>
t̪abæ	<i>verb</i><br><ol><li>(transitive, Mpakwithi) to chase</li></ol>
t̪alu	<i>noun</i><br><ol><li>(Mpakwithi) shoulder</li></ol>
t̪ama	<i>noun</i><br><ol><li>(Mpakwithi) thumb</li></ol>
t̪api	<i>noun</i><br><ol><li>(Mpakwithi) wing</li></ol>
t̪arana	<i>noun</i><br><ol><li>(Mpakwithi) spotted snake</li></ol>
t̪at̪a	<i>noun</i><br><ol><li>(Mpakwithi) fighting spear</li></ol>
t̪aɽaŋa	<i>adj</i><br><ol><li>(Mpakwithi) cold</li></ol>
t̪aɽiti	<i>adj</i><br><ol><li>(Mpakwithi) cold</li></ol>
t̪id̪ini	<i>noun</i><br><ol><li>(Mpakwithi) earwax</li></ol>
t̪iini	<i>noun</i><br><ol><li>(Mpakwithi) thigh</li><li>(Mpakwithi) spear</li></ol>
t̪ilini	<i>noun</i><br><ol><li>(Mpakwithi) saltwater turtle</li></ol>
t̪imɽit̪i	<i>noun</i><br><ol><li>(Mpakwithi) large grasshopper</li></ol>
t̪imɽiƫi	<i>noun</i><br><ol><li>(Mpakwithi) large grasshopper</li></ol>
t̪inipɽeɽe	<i>noun</i><br><ol><li>(Mpakwithi) lady apple</li></ol>
t̪inipɽi	<i>noun</i><br><ol><li>(Mpakwithi) large grasshopper</li></ol>
t̪iribwit̪i	<i>noun</i><br><ol><li>(Mpakwithi) porcupine</li></ol>
t̪it̪iri	<i>noun</i><br><ol><li>(Mpakwithi) willy wagtail</li></ol>
t̪iyiga	<i>verb</i><br><ol><li>(transitive, Mpakwithi) to smash</li></ol>
t̪u	<i>noun</i><br><ol><li>(Mpakwithi) west</li></ol>
t̪ud̪u	<i>noun</i><br><ol><li>(Mpakwithi) leaf</li></ol>
t̪umu	<i>noun</i><br><ol><li>(Mpakwithi) dead</li></ol>
t̪uʔu	<i>noun</i><br><ol><li>(Mpakwithi) leg</li></ol>
t̪wara	<i>noun</i><br><ol><li>(Mpakwithi) eagle</li></ol>
t̪æ	<i>verb</i><br><ol><li>(transitive, Mpakwithi) to push</li><li>(transitive, Mpakwithi) to send</li><li>(transitive, Mpakwithi) to move</li></ol>
t̪æβi	<i>adj</i><br><ol><li>(Mpakwithi) blue</li><li>(Mpakwithi) green</li></ol>
ubu	<i>noun</i><br><ol><li>(Mpakwithi) red gum tree</li></ol>
wa	<i>noun</i><br><ol><li>(Mpakwithi) grey hair</li></ol>
walapanu	<i>noun</i><br><ol><li>(Mpakwithi) hat</li><li>(Mpakwithi) dingy</li><li>(Mpakwithi) whaleboat</li></ol>
wat̪ayi	<i>noun</i><br><ol><li>(Mpakwithi) old man</li></ol>
wat̪i	<i>verb</i><br><ol><li>(intransitive, Mpakwithi) to dive</li></ol>
waɽa	<i>noun</i><br><ol><li>(Mpakwithi) flat tail stingray</li></ol>
waʔa	<i>noun</i><br><ol><li>(Mpakwithi) ear</li></ol>
we	<i>noun</i><br><ol><li>(Mpakwithi) owl</li></ol>
weeɣe	<i>adj</i><br><ol><li>(Mpakwithi) big</li><li>(Mpakwithi) fat</li></ol>
wimɽigeɽa	<i>verb</i><br><ol><li>(intransitive, Mpakwithi) to cry</li></ol>
winiga	<i>verb</i><br><ol><li>(transitive, Mpakwithi) to scratch</li></ol>
winimi	<i>noun</i><br><ol><li>(Mpakwithi) spotted stingray</li></ol>
wuŋat̪imɽi	<i>noun</i><br><ol><li>(Mpakwithi) tomorrow</li></ol>
wuƫi	<i>noun</i><br><ol><li>(Mpakwithi) house</li></ol>
wuɣulabi	<i>noun</i><br><ol><li>(Mpakwithi) frilled-neck lizard</li></ol>
ya	<i>verb</i><br><ol><li>(transitive, Mpakwithi) to give</li><li>(transitive, Mpakwithi) to bring</li></ol>
yara	<i>noun</i><br><ol><li>(Mpakwithi) seagull</li></ol>
yarat̪a	<i>noun</i><br><ol><li>(Mpakwithi) small parrot</li></ol>
yaɣara	<i>noun</i><br><ol><li>(Mpakwithi) centipede</li><li>(Mpakwithi) dragonfly</li></ol>
yeri	<i>noun</i><br><ol><li>(Mpakwithi) feather</li></ol>
yeti	<i>noun</i><br><ol><li>(Mpakwithi) bird</li></ol>
yeᶁi	<i>noun</i><br><ol><li>(Mpakwithi) wind</li></ol>
yibat̪i	<i>noun</i><br><ol><li>(Mpakwithi) turkey</li></ol>
yumu	<i>verb</i><br><ol><li>(transitive, Mpakwithi) to cook in ashes</li></ol>
yuᶁi	<i>noun</i><br><ol><li>(Mpakwithi) loggerhead turtle</li></ol>
ðadi	<i>verb</i><br><ol><li>(intransitive, Mpakwithi) to burn</li></ol>
ðawƫiki	<i>noun</i><br><ol><li>(Mpakwithi) white kangaroo</li></ol>
ðay	<i>noun</i><br><ol><li>(Mpakwithi) mother</li></ol>
ðaymɽi	<i>adj</i><br><ol><li>(Mpakwithi) hungry</li></ol>
ðitama	<i>verb</i><br><ol><li>(intransitive, Mpakwithi) to be afraid</li></ol>
ðu	<i>verb</i><br><ol><li>(transitive, Mpakwithi) to sew</li></ol>
ðurupu	<i>adj</i><br><ol><li>(Mpakwithi) small</li></ol>
ðutu	<i>verb</i><br><ol><li>(transitive, Mpakwithi) to follow</li></ol>
ðuʔu	<i>noun</i><br><ol><li>(Mpakwithi) yamstick</li></ol>
ðwata	<i>verb</i><br><ol><li>(intransitive, Mpakwithi) to flow</li></ol>
ðwimi	<i>verb</i><br><ol><li>(intransitive, Mpakwithi) to tell lies</li></ol>
ðwit̪i	<i>num</i><br><ol><li>(Mpakwithi) two</li></ol>
ðææɲa	<i>verb</i><br><ol><li>(transitive, Mpakwithi) to bury</li></ol>
ŋa	<i>noun</i><br><ol><li>(Mpakwithi) beard</li><li>(Mpakwithi) moustache</li></ol><br><i>verb</i><br><ol><li>(transitive, Mpakwithi) to dig</li></ol>
ŋaba	<i>noun</i><br><ol><li>(Mpakwithi) paddle</li></ol>
ŋu	<i>noun</i><br><ol><li>(Mpakwithi) clothes</li></ol>
ŋuubwa	<i>adj</i><br><ol><li>(Mpakwithi) hot</li></ol>
ŋuulu	<i>noun</i><br><ol><li>(Mpakwithi) mosquito</li></ol>
ŋwa	<i>noun</i><br><ol><li>(Mpakwithi) sun</li></ol>
ŋwaɽi	<i>noun</i><br><ol><li>(Mpakwithi) bandicoot</li></ol>
ŋwaʔat̪a	<i>noun</i><br><ol><li>(Mpakwithi) catfish</li></ol>
ŋwit̪a	<i>verb</i><br><ol><li>(Mpakwithi) to pour out</li><li>(Mpakwithi) to empty</li></ol>
ƫa	<i>noun</i><br><ol><li>(Mpakwithi) language</li><li>(Mpakwithi) speech</li><li>(Mpakwithi) song</li></ol><br><i>verb</i><br><ol><li>(transitive, Mpakwithi) to split</li></ol>
ƫakara	<i>noun</i><br><ol><li>(Mpakwithi) large whiting</li></ol>
ƫama	<i>verb</i><br><ol><li>(intransitive, Mpakwithi) to jump</li></ol>
ƫaɣa	<i>noun</i><br><ol><li>(Mpakwithi) tail</li></ol>
ƫaʔaga	<i>noun</i><br><ol><li>(Mpakwithi) longtail stingray</li></ol>
ƫaʔaƫeɽa	<i>verb</i><br><ol><li>(intransitive, Mpakwithi) to run</li></ol>
ƫeɽiyeɽi	<i>noun</i><br><ol><li>(Mpakwithi) burr</li></ol>
ƫii	<i>verb</i><br><ol><li>(transitive, Mpakwithi) to see</li><li>(transitive, Mpakwithi) to look at</li></ol>
ƫiti	<i>noun</i><br><ol><li>(Mpakwithi) fishhawk</li></ol>
ƫiᶁiri	<i>noun</i><br><ol><li>(Mpakwithi) joey</li><li>(Mpakwithi) doe wallaby</li></ol>
ƫumu	<i>num</i><br><ol><li>(Mpakwithi) three</li></ol>
ƫuɣuβu	<i>noun</i><br><ol><li>(Mpakwithi) tobacco</li><li>(Mpakwithi) cigarette</li></ol>
ƫwa	<i>verb</i><br><ol><li>(transitive, Mpakwithi) to tell</li></ol>
ƫwaka	<i>verb</i><br><ol><li>(transitive, Mpakwithi) to heap up</li></ol>
ƫwama	<i>noun</i><br><ol><li>(Mpakwithi) hill</li></ol>
ƫwana	<i>noun</i><br><ol><li>(Mpakwithi) wave</li></ol>
ƫwarama	<i>verb</i><br><ol><li>(intransitive, Mpakwithi) to float</li></ol>
ƫwaðaga	<i>verb</i><br><ol><li>(transitive, Mpakwithi) to wash</li></ol>
ƫweeɣe	<i>noun</i><br><ol><li>(Mpakwithi) flood</li></ol>
ƫwi	<i>verb</i><br><ol><li>(transitive, Mpakwithi) to say to</li></ol>
ƫwiƫiŋana	<i>noun</i><br><ol><li>(Mpakwithi) beeswax</li></ol>
ƫæɽa	<i>verb</i><br><ol><li>(transitive, Mpakwithi) to say to</li></ol>
ɣama	<i>noun</i><br><ol><li>(Mpakwithi) taro</li><li>(Mpakwithi) wild cucumber</li><li>(Mpakwithi) child</li></ol>
ɣay	<i>noun</i><br><ol><li>(Mpakwithi) rain</li></ol>
ɣaɣu	<i>noun</i><br><ol><li>(Mpakwithi) messmate tree</li></ol>
ɣaɽu	<i>noun</i><br><ol><li>(Mpakwithi) bloodwood</li></ol>
ɣeɽi	<i>noun</i><br><ol><li>(Mpakwithi) snake</li></ol>
ɣunu	<i>adj</i><br><ol><li>(Mpakwithi) distant</li></ol>
ɣurupiᶁi	<i>adj</i><br><ol><li>(Mpakwithi) tall</li></ol>
ɣwa	<i>noun</i><br><ol><li>(Mpakwithi) sand</li></ol>
ɣwa-pay	<i>noun</i><br><ol><li>(Mpakwithi) sandhill</li></ol>
ɣwagat̪a	<i>verb</i><br><ol><li>(Mpakwithi) to swim</li></ol>
ɣwini	<i>noun</i><br><ol><li>(Mpakwithi) coughing</li><li>(Mpakwithi) breathing</li></ol>
ɣyaŋa	<i>noun</i><br><ol><li>(Mpakwithi) axe</li></ol>
ɣyu	<i>verb</i><br><ol><li>(transitive, Mpakwithi) to spear</li></ol>
ɣyüdi	<i>noun</i><br><ol><li>(Mpakwithi) scrub</li><li>(Mpakwithi) dry forest</li></ol>
ɲu	<i>verb</i><br><ol><li>(transitive, Mpakwithi) to kick</li></ol>
ɽaad̪eɣe	<i>noun</i><br><ol><li>(Mpakwithi) jabiru</li></ol>
ɽama	<i>adv</i><br><ol><li>(Mpakwithi) recently</li></ol>
ɽeɽi	<i>noun</i><br><ol><li>(Mpakwithi) crow</li></ol>
ɽi	<i>noun</i><br><ol><li>(Mpakwithi) nose</li></ol>
ɽi put̪uku	<i>adj</i><br><ol><li>(Mpakwithi) jealous</li></ol>
ɽid̪i	<i>noun</i><br><ol><li>(Mpakwithi) freshwater turtle</li></ol>
ɽiði	<i>noun</i><br><ol><li>(Mpakwithi) mucus</li></ol>
ɽiɽi	<i>noun</i><br><ol><li>(Mpakwithi) oak</li></ol>
ɽæᶁiŋana	<i>noun</i><br><ol><li>(Mpakwithi) honey</li><li>(Mpakwithi) grease</li></ol>
ʃiʔi	<i>noun</i><br><ol><li>(Mpakwithi) green snake</li></ol>
ʃiβiri	<i>noun</i><br><ol><li>(Mpakwithi) culture hero</li></ol>
ʒeni	<i>verb</i><br><ol><li>(intransitive, Mpakwithi) to vomit</li></ol>
ʒi	<i>verb</i><br><ol><li>(transitive, Mpakwithi) to blow</li></ol>
ʒoɣa	<i>noun</i><br><ol><li>(Mpakwithi) fly</li></ol>
ʒuʔu	<i>noun</i><br><ol><li>(Mpakwithi) lily</li></ol>
ʔa	<i>noun</i><br><ol><li>(Mpakwithi) hand</li></ol><br><i>verb</i><br><ol><li>(transitive, Mpakwithi) to cover</li></ol>
ʔi	<i>verb</i><br><ol><li>(transitive, Mpakwithi) to wake</li></ol>
ʔunuwana	<i>noun</i><br><ol><li>(Mpakwithi) blister</li></ol>
ʔwa	<i>noun</i><br><ol><li>(Mpakwithi) tame dog</li></ol>
ʔwapwa	<i>noun</i><br><ol><li>(Mpakwithi) pup</li></ol>
ʔweʔe	<i>verb</i><br><ol><li>(transitive, Mpakwithi) to cut</li><li>(transitive, Mpakwithi) to chop</li></ol>
ʔwiini	<i>noun</i><br><ol><li>(Mpakwithi) chest</li><li>(Mpakwithi) rib</li></ol>
ʔya	<i>noun</i><br><ol><li>(Mpakwithi) hair</li></ol>
ʔya-d̪wa-pay	<i>noun</i><br><ol><li>(Mpakwithi) eyelashes</li></ol>
ʔyaana	<i>noun</i><br><ol><li>(Mpakwithi) twigs</li></ol>
ʔyuɽu	<i>noun</i><br><ol><li>(Mpakwithi) white gum tree</li></ol>
βa	<i>adv</i><br><ol><li>(Mpakwithi) again</li></ol>
βama	<i>adv</i><br><ol><li>(Mpakwithi) again</li></ol>
βati	<i>noun</i><br><ol><li>(Mpakwithi) right side</li></ol>
βat̪a	<i>noun</i><br><ol><li>(Mpakwithi) south</li></ol>
βaw	<i>intj</i><br><ol><li>(Mpakwithi) goodbye</li></ol>
βaði	<i>noun</i><br><ol><li>(Mpakwithi) intestines</li></ol>
βaɽaka	<i>noun</i><br><ol><li>(Mpakwithi) long time ago</li></ol>
βiini	<i>verb</i><br><ol><li>(intransitive, Mpakwithi) to go down</li></ol>
βwaᶁi	<i>noun</i><br><ol><li>(Mpakwithi) milkwood</li></ol>
βwe	<i>noun</i><br><ol><li>(Mpakwithi) brains</li></ol>
βweeni	<i>noun</i><br><ol><li>(Mpakwithi) dream</li></ol>
βwi	<i>verb</i><br><ol><li>(intransitive, Mpakwithi) to die</li></ol>
βüyi	<i>noun</i><br><ol><li>(Mpakwithi) dust</li><li>(Mpakwithi) ashes</li><li>(Mpakwithi) fog</li><li>(Mpakwithi) cloud</li></ol>
βüɽu	<i>noun</i><br><ol><li>(Mpakwithi) smoke</li></ol>
βɽeʔe-βɽeʔe	<i>adj</i><br><ol><li>(Mpakwithi) slippery</li></ol>
βɽiʔi	<i>noun</i><br><ol><li>(Mpakwithi) vagina</li></ol>
ᶁa	<i>noun</i><br><ol><li>(Mpakwithi) ground</li></ol><br><i>verb</i><br><ol><li>(transitive, Mpakwithi) to make</li></ol>
ᶁaatini	<i>noun</i><br><ol><li>(Mpakwithi) reef</li></ol>
ᶁe	<i>adj</i><br><ol><li>(Mpakwithi) good</li></ol>
ᶁii	<i>noun</i><br><ol><li>(Mpakwithi) to fall</li><li>(Mpakwithi) to light a fire</li></ol>
ᶁuʔu	<i>noun</i><br><ol><li>(Mpakwithi) breast</li><li>(Mpakwithi) lump</li><li>(Mpakwithi) milk</li></ol>
