Abkhasia	<i>name</i><br><ol><li>Abkhazia (a country in Europe)</li></ol>
Albania	<i>name</i><br><ol><li>Albania (a country in Europe)</li></ol>
Alemanya	<i>name</i><br><ol><li>Germany</li></ol>
Andorra	<i>name</i><br><ol><li>Andorra (a country in Europe)</li></ol>
Archentina	<i>name</i><br><ol><li>Argentina (a country in South America)</li></ol>
Armenia	<i>name</i><br><ol><li>Armenia (a country in Europe and Asia)</li></ol>
Asturias	<i>name</i><br><ol><li>Asturias (an autonomous community and province of Spain)</li></ol>
Austria	<i>name</i><br><ol><li>Austria (a country in Europe)</li></ol>
Azerbaichán	<i>name</i><br><ol><li>Azerbaijan (a country in Europe and Asia)</li></ol>
Belarrusia	<i>name</i><br><ol><li>Belarus (a country in Europe)</li></ol>
Belchica	<i>name</i><br><ol><li>Belgium (a country in Europe)</li></ol>
Benás	<i>name</i><br><ol><li>Benasque (a city in Huesca, Spain)</li></ol>
Cantabria	<i>name</i><br><ol><li>Cantabria (an autonomous community and province of Spain)</li></ol>
Chapón	<i>name</i><br><ol><li>Japan</li></ol>
Chenova	<i>name</i><br><ol><li>Genoa (the capital city of Liguria, Italy)</li><li>Genoa (a metropolitan city of Liguria, Italy)</li></ol>
Chesús	<i>name</i><br><ol><li>Jesus</li></ol>
Cuba	<i>name</i><br><ol><li>Cuba (an island and country in the Caribbean)</li></ol>
Dinamarca	<i>name</i><br><ol><li>Denmark</li></ol>
Espanya	<i>name</i><br><ol><li>Spain (a country in Europe)</li></ol>
Estonia	<i>name</i><br><ol><li>Estonia (a country in Europe)</li></ol>
Franzia	<i>name</i><br><ol><li>France</li></ol>
Grans Lacos	<i>name</i><br><ol><li>Great Lakes</li></ol>
Gronlandia	<i>name</i><br><ol><li>Greenland</li></ol>
Hongría	<i>name</i><br><ol><li>Hungary</li></ol>
Lanamesán	<i>name</i><br><ol><li>Lannemezan (a town in the Hautes-Pyrénées department, France)</li></ol>
Londres	<i>name</i><br><ol><li>London (the capital city of the United Kingdom; capital city of England)</li></ol>
Malaisia	<i>name</i><br><ol><li>Malaysia</li></ol>
Murcia	<i>name</i><br><ol><li>Murcia (an autonomous community and province in southeast Spain)</li><li>Murcia (the capital city of Murcia, Spain)</li></ol>
Navarra	<i>name</i><br><ol><li>Navarre (an autonomous community and province of Spain)</li></ol>
Oviedo	<i>name</i><br><ol><li>Oviedo (the capital city of Asturias, Spain)</li></ol>
Rumanía	<i>name</i><br><ol><li>Romania</li></ol>
Segorb	<i>name</i><br><ol><li>Segorbe</li></ol>
Serbia y Montenegro	<i>name</i><br><ol><li>Serbia and Montenegro</li><li>Used other than figuratively or idiomatically: see Serbia, y, Montenegro.</li></ol>
UE	<i>name</i><br><ol><li>Initialism of Unión Europea. (European Union)</li></ol>
Unión Europea	<i>name</i><br><ol><li>European Union</li></ol>
a	<i>article</i><br><ol><li>the</li></ol>
ababol	<i>noun</i><br><ol><li>a flower of the red poppy (Papaver rhoeas)</li><li>an absentminded person</li><li>simpleton</li></ol>
abadexo	<i>noun</i><br><ol><li>codfish</li></ol>
abaratar|abaratada|abaratés|abaratarán|abaratases|abarataré|abarataremos|abaratarían|abaratabe|abaratarías|abarate|abaratoron|abaratarez|abarataríaz|abaratato|abaratasenos|abaratasez|abarató|abaratasen|abarata|abaratata|abaratamos|abaratase|abarataus|abaratatas|abaratarás|abaratará|abarataban|abarato|abaratatos|abaratabanos|abarates|abaratadas|abaratabas|abaratemos|abaraté|abarataría|abaratas|abarataba|abaratez|abaratón|abaratabaz|abaratan|abarataríanos|abaratando|abaratau|abaraten|abarataz	<i>verb</i><br><ol><li>to cheapen</li></ol>
abarca	<i>noun</i><br><ol><li>sandal</li></ol>
abarcar|abarcas|abarcaría|abarcarían|abarquemos|abarcaré|abarcatos|abarcarez|abarcase|abarcases|abarcasenos|abarcoron|abarcaz|abarque|abarcarías|abarcabas|abarcaríaz|abarca|abarcadas|abarcabanos|abarcarás|abarcasen|abarcasez|abarcó|abarcamos|abarquen|abarcato|abarco|abarqués|abarcau|abarcaremos|abarcaus|abarcata|abarqué|abarques|abarcón|abarcabaz|abarcarán|abarquez|abarcan|abarcará|abarcando|abarcada|abarcabe|abarcaban|abarcatas|abarcaba|abarcaríanos	<i>verb</i><br><ol><li>to dodge</li></ol>
abarnizar|abarnizarían|abarnizase|abarnizón|abarnicé|abarnizando|abarnizabas|abarnizabanos|abarnizoron|abarnizasez|abarnizatos|abarnizaus|abarnizada|abarnizaremos|abarnizaría|abarnicemos|abarnizatas|abarnizaríaz|abarnizau|abarnices|abarnizaba|abarnizarías|abarnizabe|abarnizo|abarnizan|abarnicés|abarnizasen|abarnizas|abarnizata|abarnizaríanos|abarnicen|abarnizases|abarnizasenos|abarnizaban|abarnizato|abarnizó|abarnizaz|abarnizabaz|abarnicez|abarnizaré|abarnizará|abarnizarán|abarnice|abarniza|abarnizarez|abarnizarás|abarnizamos|abarnizadas	<i>verb</i><br><ol><li>to varnish</li></ol>
abella|abelleta|abellas	<i>noun</i><br><ol><li>bee</li></ol>
abentar	<i>verb</i><br><ol><li>(transitive) to throw</li></ol>
aber|ayan|has|han|abioron|abiés|abito|abiemos|esez|abiez|abrían|abió|ebanos|abrías|ayamos|abríanos|ez|abríaz|abrá|abrán|abitos|abremos|abitas|abié|esenos|ebas|eses|ese|abrás|abrez|abida|abión|eban|abendo|abidas|abita|abiu|ebaz|abría|ha|he|eba|abius|aigaz|aigas|aiga|aya|aigamos|aigan|abré|ayaz|emos|ayas|esen	<i>verb</i><br><ol><li>to have</li></ol>
abet	<i>noun</i><br><ol><li>fir-tree</li></ol>
abetullo	<i>noun</i><br><ol><li>the birch, a tree in the genus Betula</li></ol>
abiento	<i>noun</i><br><ol><li>December</li></ol>
abril	<i>noun</i><br><ol><li>April</li></ol>
absolver	<i>verb</i><br><ol><li>(transitive) to absolve</li></ol>
abstracto|abstractos|abstracta|abstractas	<i>adj</i><br><ol><li>abstract</li></ol>
acaballar	<i>verb</i><br><ol><li>(transitive) to superimpose</li></ol>
accentuar	<i>verb</i><br><ol><li>to accent (to mark with written accents)</li></ol>
achiperres	<i>noun</i><br><ol><li>tools and equipment used for a particular activity</li></ol>
achuda	<i>noun</i><br><ol><li>help</li></ol>
achudar	<i>verb</i><br><ol><li>to help</li></ol>
acobaltar	<i>verb</i><br><ol><li>(transitive) to exalt</li></ol>
acobardir	<i>verb</i><br><ol><li>(transitive) to frighten</li></ol>
acochillar	<i>verb</i><br><ol><li>(transitive) to cut</li></ol>
acompañar	<i>verb</i><br><ol><li>(transitive) to accompany</li></ol>
aconseguir	<i>verb</i><br><ol><li>(transitive) to succeed in</li></ol>
acordión|acordions	<i>noun</i><br><ol><li>accordion</li></ol>
adaguar|adaguases|adaguen|adaguatas|adaguaríanos|adaguas|adaguoron|adaguabas|adaguez|adaguada|adaguarían|adaguaré|adaguaríaz|adaguasenos|adaguón|adaguabe|adaguó|adaguadas|adaguase|adaguan|adaguando|adagués|adaguarías|adaguarás|adaguasez|adaguaba|adaguasen|adaguata|adaguarán|adaguará|adague|adaguamos|adaguarez|adaguo|adaguatos|adaguaría|adagué|adaguabaz|adaguaz|adaguau|adaguabanos|adaguaban|adagua|adaguemos|adagues|adaguaremos|adaguato|adaguaus	<i>verb</i><br><ol><li>(Cheso, transitive) to give water to cattle</li></ol>
adchectivo	<i>noun</i><br><ol><li>adjective</li></ol>
adiar	<i>verb</i><br><ol><li>(transitive) to put off, postpone</li></ol>
adibir	<i>verb</i><br><ol><li>(transitive) to add (more)</li><li>(transitive) to add to, improve</li></ol>
adiós	<i>intj</i><br><ol><li>goodbye</li></ol>
adomar	<i>verb</i><br><ol><li>(transitive) to tame</li></ol>
adormir	<i>verb</i><br><ol><li>(transitive) to make fall asleep</li><li>(reflexive) to fall asleep</li></ol>
adubir|adubitos|adubiríanos|aduben|adubindo|adubirás|adubió|adubito|adubiremos|adubirez|aduba|adubida|adubioron|aduban|adubibaz|adubiz|adubes|adubibanos|adubise|adubamos|adubiba|adubirán|adubises|adubión|adubisen|adubo|adubirían|adubidas|adube|adubitas|adubiban|adubisez|adubiés|adubiré|adubiría|adubisenos|adubibe|adubirías|adubas|adubiríaz|adubibas|adubiez|adubirá|adubimos|adubita|adubius|adubaz|adubié|adubiu|adubiemos	<i>verb</i><br><ol><li>to cope</li></ol>
aduyar|aduyata|aduyadas|aduyaríaz|aduyó|aduyamos|aduyan|aduyada|aduyabe|aduyasenos|aduyando|aduyen|aduyas|aduyará|aduyarán|aduyemos|aduyarías|aduyaba|aduyés|aduyez|aduyón|aduyarás|aduyaría|aduyatos|aduyaus|aduyabaz|aduyabanos|aduye|aduyabas|aduyes|aduyasen|aduyaz|aduya|aduyaremos|aduyase|aduyatas|aduyo|aduyau|aduyato|aduyaban|aduyaríanos|aduyarían|aduyaré|aduyé|aduyases|aduyoron|aduyarez|aduyasez	<i>verb</i><br><ol><li>to help</li></ol>
agora	<i>adv</i><br><ol><li>now</li></ol>
agosto	<i>noun</i><br><ol><li>August</li></ol>
agro	<i>adj</i><br><ol><li>sour</li></ol>
agulla|agullas	<i>noun</i><br><ol><li>needle</li></ol>
ahier	<i>noun</i><br><ol><li>yesterday</li></ol>
aladro|aladros	<i>noun</i><br><ol><li>(Belsetán, Ribagorçan, Chistabín, Cheso) plough</li></ol>
alatre|alatres	<i>noun</i><br><ol><li>(Belsetán) plough</li></ol>
alavez	<i>adv</i><br><ol><li>then,</li><li>so, hence</li></ol>
albaca	<i>noun</i><br><ol><li>basil</li></ol>
alberchena|alberchenas	<i>noun</i><br><ol><li>eggplant</li></ol>
albero|alberos	<i>noun</i><br><ol><li>esophagus, trachea</li></ol>
alcol	<i>noun</i><br><ol><li>alcohol</li></ol>
alegría	<i>noun</i><br><ol><li>joy</li></ol>
algorismo|algorismos	<i>noun</i><br><ol><li>algorithm</li></ol>
allo	<i>noun</i><br><ol><li>garlic</li></ol>
altaria	<i>noun</i><br><ol><li>altitude</li></ol>
amallatar	<i>verb</i><br><ol><li>(of cattle) to rest in the shade when it is too hot</li><li>(by extension) to have a siesta</li></ol>
amillorar|amilloró|amillores|amillorarez|amilloradas|amilloras|amilloraba|amillorau|amilloraus|amillora|amilloraremos|amillorez|amilloraríanos|amillorasen|amillororon|amillorarían|amillorato|amillorabe|amillorasez|amilloratos|amilloratas|amillorases|amilloro|amilloramos|amilloraré|amilloren|amillorabaz|amillorón|amillorase|amilloraríaz|amilloran|amillorés|amillore|amillorada|amillorata|amillorabanos|amilloraz|amillorarías|amilloraban|amillorará|amilloraría|amillorasenos|amilloré|amillorarás|amilloremos|amillorarán|amillorando|amillorabas	<i>verb</i><br><ol><li>to improve</li></ol>
anatomía	<i>noun</i><br><ol><li>anatomy</li></ol>
anca	<i>noun</i><br><ol><li>hip</li></ol>
anglo|anglos	<i>noun</i><br><ol><li>angle</li></ol>
anglés	<i>noun</i><br><ol><li>English (language)</li></ol>
aniello|aniellos	<i>noun</i><br><ol><li>ring (jewellery)</li><li>ring (round thing)</li></ol>
antigo|antiga|antigos|antigas	<i>adj</i><br><ol><li>old, ancient</li></ol>
anyo	<i>noun</i><br><ol><li>year</li></ol>
aquel|aquellas|aquels|aquellos|aquella	<i>det</i><br><ol><li>that</li></ol>
aragonés|aragonesa|aragoneses|aragonesas	<i>adj</i><br><ol><li>Aragonese (from Aragon)</li></ol><br><i>noun</i><br><ol><li>Aragonese (someone from Aragon)</li></ol>
araina|arainas	<i>noun</i><br><ol><li>spider</li></ol>
arambre|arambres	<i>noun</i><br><ol><li>wire</li></ol>
arbuzo|arbuzos	<i>noun</i><br><ol><li>bush, shrub</li></ol>
arena|arenas	<i>noun</i><br><ol><li>sand</li></ol>
arma|armas	<i>noun</i><br><ol><li>weapon</li></ol>
articlo|articlos	<i>noun</i><br><ol><li>(grammar) article</li></ol>
artificial|artificials	<i>adj</i><br><ol><li>artificial</li></ol>
as	<i>article</i><br><ol><li>the</li></ol>
asar	<i>verb</i><br><ol><li>(transitive) to roast</li></ol>
ascuitar|ascuites|ascuitaba|ascuitaríanos|ascuite|ascuitaban|ascuitasez|ascuitatos|ascuitada|ascuitarez|ascuitarían|ascuitamos|ascuitarías|ascuitan|ascuitaré|ascuitabanos|ascuité|ascuitato|ascuitasenos|ascuiten|ascuitasen|ascuita|ascuitaus|ascuitarás|ascuitaría|ascuités|ascuitaremos|ascuitando|ascuitoron|ascuitadas|ascuitatas|ascuitabaz|ascuitón|ascuitata|ascuito|ascuitaríaz|ascuitas|ascuitabas|ascuitases|ascuitau|ascuitez|ascuitabe|ascuitaz|ascuitará|ascuitemos|ascuitarán|ascuitase|ascuitó	<i>verb</i><br><ol><li>to listen</li></ol>
aspro|aspra|aspras|aspros	<i>adj</i><br><ol><li>rough</li></ol>
asturiano	<i>noun</i><br><ol><li>Asturian (language)</li></ol>
atenzión|atenzions	<i>noun</i><br><ol><li>attention</li></ol>
aterrar	<i>verb</i><br><ol><li>(intransitive) to land</li></ol>
ateísmo	<i>noun</i><br><ol><li>atheism</li></ol>
aturar	<i>verb</i><br><ol><li>(transitive) to stop; to stop with (to cause something to stop moving or progressing)</li></ol>
au|aus	<i>noun</i><br><ol><li>bird</li></ol>
auco|aucos	<i>noun</i><br><ol><li>goose</li></ol>
augua	<i>noun</i><br><ol><li>water</li></ol>
auguanieu	<i>noun</i><br><ol><li>sleet</li></ol>
autor	<i>noun</i><br><ol><li>author</li></ol>
axedrez	<i>noun</i><br><ol><li>chess</li></ol>
azanoria|azanorias	<i>noun</i><br><ol><li>carrot</li></ol>
azeite	<i>noun</i><br><ol><li>oil</li></ol>
azeto|azetos|azetas|azeta	<i>adj</i><br><ol><li>sour, acidic</li></ol><br><i>noun</i><br><ol><li>acid</li></ol>
azul	<i>adj</i><br><ol><li>blue</li></ol>
año|años	<i>noun</i><br><ol><li>year</li></ol>
babero|baberos	<i>noun</i><br><ol><li>bib</li></ol>
baca|bacas	<i>noun</i><br><ol><li>cow</li></ol>
bailar	<i>verb</i><br><ol><li>to dance</li></ol>
baile|bailes	<i>noun</i><br><ol><li>bail</li><li>dance</li></ol>
bailía	<i>noun</i><br><ol><li>bailiwick</li></ol>
balanza|balanzas	<i>noun</i><br><ol><li>balance (measuring device)</li></ol>
ballena|ballenas	<i>noun</i><br><ol><li>whale</li></ol>
bandera|banderas	<i>noun</i><br><ol><li>flag</li></ol>
baranna|barannas	<i>noun</i><br><ol><li>(Belsetán) railing</li></ol>
barba|barbas	<i>noun</i><br><ol><li>beard</li></ol>
barca	<i>noun</i><br><ol><li>boat</li></ol>
barzal	<i>noun</i><br><ol><li>bramble</li></ol>
basuera	<i>noun</i><br><ol><li>trash</li></ol>
batalla|batallas	<i>noun</i><br><ol><li>battle</li></ol>
baxar|baxaba|baxemos|baxaz|baxaus|baxés|baxato|baxabas|baxó|baxa|baxez|baxasen|baxé|baxarez|baxases|baxasenos|baxaré|baxaremos|baxase|baxen|baxas|baxatos|baxada|baxarás|baxarían|baxoron|baxe|baxes|baxón|baxadas|baxarán|baxaríanos|baxaríaz|baxando|baxaría|baxabaz|baxasez|baxabe|baxau|baxaban|baxan|baxarías|baxata|baxabanos|baxatas|baxo|baxamos|baxará	<i>verb</i><br><ol><li>to go down</li></ol>
bañar	<i>verb</i><br><ol><li>(transitive) to bathe</li></ol>
baño|baños	<i>noun</i><br><ol><li>bathroom</li></ol>
beber|beberían|bebiemos|beberíaz|bebesenos|bebebe|bebebas|bebeses|bebié|bebius|bebebaz|bebebanos|bebiés|bebita|bebión|beberíanos|bebesez|bebese|beban|bebesen|bebeban|beberán|bebemos|beberás|bebitos|beberé|beben|beberías|beberá|bebioron|bebitas|bebaz|bebió|bebas|bebida|beberemos|bebe|beberez|bebito|bebes|beba|bebendo|bebidas|bebez|bebamos|bebiez|bebo|bebería|bebeba|bebiu	<i>verb</i><br><ol><li>to drink</li></ol>
bebida|bebidas	<i>noun</i><br><ol><li>drink</li></ol>
bebita|bebitas	<i>noun</i><br><ol><li>drink, beverage</li></ol>
bel	<i>adj</i><br><ol><li>strange (in certain expressions)</li></ol><br><i>det</i><br><ol><li>any, anyone</li></ol>
bel-la	<i>adj</i><br><ol><li>(Belsetán) Alternative form of bela</li></ol>
bel-lota|bel-lotas	<i>noun</i><br><ol><li>(Belsetán) acorn</li></ol>
bela	<i>adj</i><br><ol><li>strange (in certain expressions)</li></ol><br><i>det</i><br><ol><li>any, anyone</li></ol>
belozidá	<i>noun</i><br><ol><li>speed</li></ol>
bena|benas	<i>noun</i><br><ol><li>vein</li></ol>
bender	<i>verb</i><br><ol><li>(transitive) to sell</li></ol>
bendicir	<i>verb</i><br><ol><li>to bless</li></ol>
benir	<i>verb</i><br><ol><li>(intransitive) to come</li></ol>
berano|beranos	<i>noun</i><br><ol><li>summer</li></ol>
berbo|berbos	<i>noun</i><br><ol><li>verb</li></ol>
berdura	<i>noun</i><br><ol><li>vegetable</li></ol>
berdá	<i>noun</i><br><ol><li>truth</li></ol>
bereno|berenos	<i>noun</i><br><ol><li>poison</li></ol>
bersión|bersions	<i>noun</i><br><ol><li>version</li></ol>
besitar|besitasen|besitada|besitarez|besitatas|besite|besitemos|besitaban|besitaz|besitau|besitaba|besitoron|besitará|besitasenos|besitato|besitaría|besitabas|besitaremos|besitabanos|besitez|besitasez|besitases|besiten|besité|besitó|besitabaz|besitaré|besitando|besitarían|besitamos|besitabe|besito|besités|besitarías|besitas|besitan|besitatos|besita|besitata|besitadas|besitaríaz|besites|besitaus|besitaríanos|besitón|besitase|besitarás|besitarán	<i>verb</i><br><ol><li>to visit</li></ol>
beso|besos	<i>noun</i><br><ol><li>kiss</li></ol>
bestia|bestias	<i>noun</i><br><ol><li>beast</li></ol>
bestir	<i>verb</i><br><ol><li>(transitive, reflexive) to dress</li></ol>
bestito|bestitos	<i>noun</i><br><ol><li>dress</li></ol>
beyer	<i>verb</i><br><ol><li>to see</li></ol>
bez|bezes	<i>noun</i><br><ol><li>a time</li><li>occasion</li></ol>
bezicleta tot terrén	<i>noun</i><br><ol><li>all-terrain bicycle, off-road bicycle</li></ol>
bezino|bezinos	<i>noun</i><br><ol><li>neighbor</li></ol>
biachar	<i>verb</i><br><ol><li>(intransitive) to travel</li></ol>
bibir	<i>verb</i><br><ol><li>to live</li></ol>
biblioteca|bibliotecas	<i>noun</i><br><ol><li>library</li></ol>
bida|bidas	<i>noun</i><br><ol><li>life</li></ol>
biento	<i>noun</i><br><ol><li>wind</li></ol>
biernes	<i>noun</i><br><ol><li>Friday</li></ol>
biolinero|biolineros	<i>noun</i><br><ol><li>violinist</li></ol>
blanco|blanca|blancas|blancos	<i>adj</i><br><ol><li>white</li></ol>
blango	<i>adj</i><br><ol><li>white</li></ol>
boca	<i>noun</i><br><ol><li>(anatomy) mouth</li></ol>
boda|bodas	<i>noun</i><br><ol><li>wedding</li></ol>
boira	<i>noun</i><br><ol><li>cloud</li></ol>
bolumen|bolúmens	<i>noun</i><br><ol><li>volume</li></ol>
bomber|bombers	<i>noun</i><br><ol><li>firefighter (person whose job is to put out fires)</li></ol>
bombero|bomberos	<i>noun</i><br><ol><li>firefighter</li></ol>
borina	<i>noun</i><br><ol><li>merrymaking; party (joyful celebration)</li></ol>
borrador|borradors	<i>noun</i><br><ol><li>eraser</li></ol>
borrar	<i>verb</i><br><ol><li>(transitive) to erase</li></ol>
bos	<i>pron</i><br><ol><li>you (second-person plural direct pronoun)</li><li>(to) you (second-person plural indirect pronoun)</li></ol>
bosque|bosques	<i>noun</i><br><ol><li>forest</li></ol>
bota|botas	<i>noun</i><br><ol><li>boot</li></ol>
botella|botellas	<i>noun</i><br><ol><li>bottle</li></ol>
bozina|bozinas	<i>noun</i><br><ol><li>horn</li></ol>
brazo	<i>noun</i><br><ol><li>arm</li></ol>
brenna|brennas	<i>noun</i><br><ol><li>(Belsetán) afternoon snack</li></ol>
bresca	<i>noun</i><br><ol><li>honeycomb</li></ol>
bulcar	<i>verb</i><br><ol><li>to overturn</li></ol>
busatras	<i>pron</i><br><ol><li>you, ye (second-person plural feminine pronoun)</li></ol>
busatros	<i>pron</i><br><ol><li>you, ye (second-person plural masculine pronoun)</li></ol>
caballo	<i>noun</i><br><ol><li>horse</li></ol>
cabeza	<i>noun</i><br><ol><li>(anatomy) head</li></ol>
cadena|cadenas	<i>noun</i><br><ol><li>chain</li></ol>
caixico|caixicos	<i>noun</i><br><ol><li>oak</li></ol>
caixo	<i>noun</i><br><ol><li>cheek</li></ol>
calor	<i>noun</i><br><ol><li>heat</li></ol>
camino	<i>noun</i><br><ol><li>way; path; road</li></ol>
camisa|camisas	<i>noun</i><br><ol><li>shirt</li></ol>
camiseta|camisetas	<i>noun</i><br><ol><li>T-shirt</li></ol>
campana|campanas	<i>noun</i><br><ol><li>bell</li></ol>
campión	<i>noun</i><br><ol><li>champion</li></ol>
can|cans	<i>noun</i><br><ol><li>dog</li></ol>
candreixo	<i>noun</i><br><ol><li>crab</li></ol>
candrexo|candrexos	<i>noun</i><br><ol><li>crab</li></ol>
cantar|cantaus|cantase|cantaré|cantamos|cantarían|cantabaz|cantando|cantaz|cantabas|cantabanos|canté|cantaba|cantau|cantata|cantemos|cantaremos|cantatas|cantas|cantan|cantaríanos|cantatos|cantato|cantases|canto|cantaríaz|cantaban|cantadas|cante|cantó|cantarán|cantada|cantarez|cantarías|cantés|canta|cantes|cantez|cantaría|cantabe|cantoron|cantará|cantasen|canten|cantasez|cantarás|cantasenos|cantón	<i>verb</i><br><ol><li>to sing</li></ol>
capanna|capannas	<i>noun</i><br><ol><li>(Belsetán) cabin, hut</li></ol>
capeza|capezas	<i>noun</i><br><ol><li>head</li></ol>
cara|caras	<i>noun</i><br><ol><li>(anatomy) face</li></ol>
carbón	<i>noun</i><br><ol><li>coal</li></ol>
carne|carnes	<i>noun</i><br><ol><li>meat</li><li>flesh</li></ol>
caro|caras|caros|cara	<i>adj</i><br><ol><li>expensive</li></ol>
casa|cases	<i>noun</i><br><ol><li>house</li></ol>
casalizo|casalizos	<i>noun</i><br><ol><li>a farm animal that is unable to undergo transhumance to the lowlands</li></ol>
castellán	<i>noun</i><br><ol><li>Spanish (language)</li></ol>
castiello|castiellos	<i>noun</i><br><ol><li>castle</li></ol>
catodico|catodicos|catodica|catodiques	<i>adj</i><br><ol><li>cathode (in compounds)</li></ol>
catodo	<i>noun</i><br><ol><li>cathode</li></ol>
cayer	<i>verb</i><br><ol><li>to fall</li></ol>
celebro	<i>noun</i><br><ol><li>brain</li></ol>
cella	<i>noun</i><br><ol><li>eyebrow</li></ol>
chacer	<i>verb</i><br><ol><li>to lie (down)</li></ol>
chaponés|chaponeses|chaponesas|chaponesa	<i>adj</i><br><ol><li>Japanese</li></ol><br><i>noun</i><br><ol><li>a Japanese person</li><li>the Japanese language</li></ol>
chardín	<i>noun</i><br><ol><li>garden</li></ol>
charrador|charradors	<i>noun</i><br><ol><li>speaker (one who speaks)</li></ol>
chelo	<i>noun</i><br><ol><li>ice</li></ol>
chema|chemas	<i>noun</i><br><ol><li>bud</li></ol>
chenullo	<i>noun</i><br><ol><li>knee</li></ol>
cheografía	<i>noun</i><br><ol><li>geography</li></ol>
chicolate	<i>noun</i><br><ol><li>chocolate</li></ol>
chicotén|chicotens	<i>noun</i><br><ol><li>(music) a type of psaltery used in the Pyrenees</li></ol>
chilar|chilau|chilarías|chilaban|chilasen|chilé|chilada|chilés|chilez|chilase|chilabaz|chilen|chiles|chilaba|chilatos|chilatas|chiloron|chilarás|chilasenos|chiladas|chilabas|chilabanos|chilará|chilarán|chilan|chilasez|chilo|chilaré|chilamos|chilón|chilaremos|chiló|chilemos|chilarez|chilases|chilas|chilaríanos|chilata|chilarían|chilato|chilabe|chila|chilaus|chilaría|chilando|chile|chilaz|chilaríaz	<i>verb</i><br><ol><li>to scream</li></ol>
chin	<i>noun</i><br><ol><li>dog</li></ol>
chincha|chinchas	<i>noun</i><br><ol><li>bedbug</li></ol>
chincharana|chincharanas	<i>noun</i><br><ol><li>any small bird which stops flapping its wings at regular intervals, or hops on the ground</li></ol>
chinero	<i>noun</i><br><ol><li>January</li></ol>
chiquet|chiquetos|chiquetas|chiqueta	<i>adj</i><br><ol><li>small</li></ol>
chirafa|chirafas	<i>noun</i><br><ol><li>giraffe</li></ol>
chirmán|chirmans	<i>noun</i><br><ol><li>brother</li></ol>
chitano|chitanas|chitanos|chitana	<i>adj</i><br><ol><li>gypsy</li></ol><br><i>noun</i><br><ol><li>a gypsy</li></ol>
chodigo|chodiga|chodigos|chodigas	<i>adj</i><br><ol><li>Jewish</li></ol><br><i>noun</i><br><ol><li>a Jewish person</li></ol>
choliba|cholibas	<i>noun</i><br><ol><li>(eastern Aragón) common barn owl (Tyto alba)</li></ol>
chordiga	<i>noun</i><br><ol><li>nettle</li></ol>
choven|choben|chovena|chovens|chovenas	<i>adj</i><br><ol><li>young</li></ol><br><i>noun</i><br><ol><li>young man</li><li>son-in-law</li></ol>
chudgar	<i>verb</i><br><ol><li>to judge</li></ol>
chuego|chuegos	<i>noun</i><br><ol><li>play, game</li></ol>
chueves|chuebes	<i>noun</i><br><ol><li>Thursday</li></ol>
chuez	<i>noun</i><br><ol><li>judge</li></ol>
chugar|chugasez|chugas|chugando|chugan|chugabas|chugué|chugoron|chugasenos|chugarás|chugasen|chugue|chugues|chugabanos|chugaus|chugato|chugaz|chugaríanos|chugó|chugatos|chugaban|chugarez|chugón|chugués|chugarías|chugaríaz|chugase|chugata|chuga|chugaba|chuguemos|chugatas|chugaré|chugabaz|chugau|chugaremos|chugases|chugarán|chuguen|chuguez|chugada|chugarían|chugabe|chugamos|chugo|chugaría|chugará|chugadas	<i>verb</i><br><ol><li>to play</li></ol>
chulio	<i>noun</i><br><ol><li>July</li></ol>
chunio	<i>noun</i><br><ol><li>June</li></ol>
chupar	<i>verb</i><br><ol><li>(transitive, intransitive) to suck</li></ol>
chustizia	<i>noun</i><br><ol><li>justice</li></ol>
chusto|chustos|chustas|chusta	<i>adj</i><br><ol><li>just, fair</li></ol>
cinc	<i>num</i><br><ol><li>five</li></ol>
cincha	<i>noun</i><br><ol><li>belt</li></ol>
ciudat	<i>noun</i><br><ol><li>city</li></ol>
clamar|clamará|clamaba|clamasenos|clamabanos|clamo|clamé|clamas|clamando|clamasen|clamatos|clamaríaz|clamarían|clame|clamaríanos|clamés|clamemos|clamaría|clamases|clamón|clamó|clamarán|claman|clamarez|clames|clamadas|clamase|clamaus|clamamos|clamabas|clamez|clamaz|clamaré|clamarás|clamata|clamato|clamabe|clamoron|clamasez|clamau|clamarías|clamabaz|clamen|clamada|clamatas|clama|clamaban|clamaremos	<i>verb</i><br><ol><li>to call</li></ol>
clar|claras|clara|clars	<i>adj</i><br><ol><li>clear</li></ol>
claredá	<i>noun</i><br><ol><li>clarity</li></ol>
claro|claras|clara|claros	<i>adj</i><br><ol><li>clear</li></ol>
clau	<i>noun</i><br><ol><li>key</li></ol>
cochín	<i>noun</i><br><ol><li>pig</li></ol>
cocodrilo|cocodrilos	<i>noun</i><br><ol><li>crocodile</li></ol>
coda|codas	<i>noun</i><br><ol><li>tail</li></ol>
codete|codetes	<i>noun</i><br><ol><li>firework</li><li>rocket</li></ol>
colezión	<i>noun</i><br><ol><li>collection</li></ol>
color	<i>noun</i><br><ol><li>color</li></ol>
cometa|cometas	<i>noun</i><br><ol><li>comet</li></ol>
cometas	<i>noun</i><br><ol><li>quotation marks (symbols used to denote a quotation in writing: “”, "", «», ‘’ or )</li></ol>
comunicar	<i>verb</i><br><ol><li>(transitive) to communicate</li></ol>
con	<i>prep</i><br><ol><li>with</li></ol>
conchugación|conchugacions	<i>noun</i><br><ol><li>(grammar) conjugation</li></ol>
condizión|condizions	<i>noun</i><br><ol><li>condition</li></ol>
confitanza	<i>noun</i><br><ol><li>confidence</li></ol>
coniello|coniellos	<i>noun</i><br><ol><li>rabbit</li></ol>
conquistar	<i>verb</i><br><ol><li>(transitive) to conquer</li></ol>
consonán|consonans	<i>noun</i><br><ol><li>consonant</li></ol>
conte|contes|contesas|contesa	<i>noun</i><br><ol><li>count (nobility); countess in the feminine sense.</li></ol>
contesa	<i>noun</i><br><ol><li>countess</li></ol>
contestazión	<i>noun</i><br><ol><li>response, contestation</li></ol>
continente	<i>noun</i><br><ol><li>continent</li></ol>
contrebuyir	<i>verb</i><br><ol><li>to contribute</li></ol>
corazón|corazons	<i>noun</i><br><ol><li>(anatomy) heart</li></ol>
corbillo|corbillos	<i>noun</i><br><ol><li>basket</li></ol>
corniera	<i>noun</i><br><ol><li>whortleberry</li></ol>
corona|coronas	<i>noun</i><br><ol><li>crown</li></ol>
correr	<i>verb</i><br><ol><li>to run</li></ol>
corruca|corrucas	<i>noun</i><br><ol><li>wrinkle</li></ol>
cortina|cortinas	<i>noun</i><br><ol><li>curtain</li></ol>
cosa|cosas	<i>noun</i><br><ol><li>thing (that which exists as a separate entity)</li></ol><br><i>pron</i><br><ol><li>nothing (not any thing)</li></ol>
costumbre|costumbres	<i>noun</i><br><ol><li>custom</li></ol>
cotorniz	<i>noun</i><br><ol><li>quail</li></ol>
craba	<i>noun</i><br><ol><li>goat</li></ol>
crebar|crebemos|creboron|crebaré|crebasenos|crebabas|crebata|crebaz|crebatos|creban|crebaría|crebe|crebada|crebes|crebau|crebés|crebó|crebasen|crebatas|crebaríaz|crebamos|crebará|crebarías|crebarez|creben|crebabe|crebato|crebabanos|crebarían|crebaríanos|crebón|crebé|crebo|crebando|crebaba|crebaban|crebez|crebase|crebaus|crebasez|crebarás|creba|crebabaz|crebaremos|crebarán|crebases|crebas|crebadas	<i>verb</i><br><ol><li>to break</li></ol>
creixer	<i>verb</i><br><ol><li>to grow</li></ol>
cremar|cremón|cremaremos|cremas|cremabanos|cremarán|cremaríaz|cremaz|cremaría|cremada|cremasenos|cremaban|cremasen|cremará|cremés|cremaus|cremaba|cremadas|cremes|cremato|cremamos|cremaré|crema|cremé|creme|cremase|cremases|cremarás|cremarías|crematos|cremau|cremarez|cremarían|cremoron|cremasez|crematas|cremabaz|cremando|cremez|cremen|cremabe|cremo|cremó|crememos|cremaríanos|cremabas|cremata|creman	<i>verb</i><br><ol><li>to burn</li></ol>
crexer	<i>verb</i><br><ol><li>(intransitive) to grow</li></ol>
creyar	<i>verb</i><br><ol><li>to create</li></ol>
creyer	<i>verb</i><br><ol><li>to believe</li></ol>
cristiano|cristianas|cristiana|cristianos	<i>adj</i><br><ol><li>christian</li></ol><br><i>noun</i><br><ol><li>a christian</li></ol>
cruz|cruzes	<i>noun</i><br><ol><li>cross</li></ol>
cual|cuala|cuales|cuals|cualas	<i>pron</i><br><ol><li>which? (masculine singular)</li></ol>
cubo|cubos	<i>noun</i><br><ol><li>cube</li></ol>
cuello|cuellos	<i>noun</i><br><ol><li>neck</li></ol>
cuerbo|cuerbos	<i>noun</i><br><ol><li>crow</li></ol>
cuerno|cuernos	<i>noun</i><br><ol><li>horn</li></ol>
cuero|cueros	<i>noun</i><br><ol><li>leather</li></ol>
cuerpo|cuerpos	<i>noun</i><br><ol><li>body</li></ol>
cuitiello	<i>noun</i><br><ol><li>knife</li></ol>
cuixa	<i>noun</i><br><ol><li>(anatomy) thigh</li></ol>
cullebra|cullebras	<i>noun</i><br><ol><li>snake</li></ol>
cullebra diamán	<i>noun</i><br><ol><li>(Aragonese folklore) a large snake that carries a diamond on its head, which it uses to hypnotise its prey</li></ol>
culo|culos	<i>noun</i><br><ol><li>ass</li></ol>
culpa|culpas	<i>noun</i><br><ol><li>blame, fault</li></ol>
cultura|culturas	<i>noun</i><br><ol><li>culture</li></ol>
curbă|curbas	<i>noun</i><br><ol><li>curve</li></ol>
cusir	<i>verb</i><br><ol><li>(transitive) to sew, stitch</li></ol>
cutiello|cutiellos	<i>noun</i><br><ol><li>knife</li></ol>
cuán	<i>adv</i><br><ol><li>when</li></ol>
dalla	<i>noun</i><br><ol><li>scythe</li></ol>
dar	<i>verb</i><br><ol><li>give</li></ol>
debantar|debantaus|debantasenos|debantasez|debantatas|debantas|debantamos|debantabanos|debantabas|debantasen|debantez|debantabe|debanto|debante|debantarían|debantabaz|debantaban|debantau|debantaba|debantoron|debantará|debantarás|debantaríaz|debantase|debantata|debantaríanos|debantan|debantemos|debantases|debantarán|debanten|debanta|debantadas|debantes|debantó|debantando|debantaré|debantón|debantés|debantaz|debantatos|debantarías|debantarez|debantaría|debantato|debanté|debantaremos|debantada	<i>verb</i><br><ol><li>to raise</li></ol>
debuxar|debuxatas|debuxe|debuxaz|debuxaremos|debuxarían|debuxases|debuxé|debuxemos|debuxas|debuxase|debuxabaz|debuxo|debuxasenos|debuxasez|debuxando|debuxará|debuxó|debuxarán|debuxaba|debuxabas|debuxez|debuxata|debuxasen|debuxabe|debuxada|debuxarez|debuxaus|debuxan|debuxarías|debuxaríaz|debuxés|debuxaban|debuxaríanos|debuxa|debuxen|debuxato|debuxamos|debuxaré|debuxón|debuxoron|debuxes|debuxatos|debuxau|debuxabanos|debuxaría|debuxadas|debuxarás	<i>verb</i><br><ol><li>to draw</li></ol>
debuxo|debuxos	<i>noun</i><br><ol><li>a drawing</li></ol>
democrazia|democrazias	<i>noun</i><br><ol><li>democracy</li></ol>
densidat	<i>noun</i><br><ol><li>density</li></ol>
deseyo|deseyos	<i>noun</i><br><ol><li>wish, desire</li></ol>
deteutor	<i>noun</i><br><ol><li>detector</li></ol>
deu	<i>num</i><br><ol><li>ten</li></ol>
deuñ	<i>noun</i><br><ol><li>God</li></ol>
dezaga	<i>prep</i><br><ol><li>after, behind</li></ol>
dezenio|dezenios	<i>noun</i><br><ol><li>decade</li></ol>
diamán|diamans	<i>noun</i><br><ol><li>diamond</li></ol>
diaple|diaples	<i>noun</i><br><ol><li>devil</li></ol>
dibisión|dibisions	<i>noun</i><br><ol><li>distribution, apportionment</li><li>(mathematics) the process of dividing a number by another</li><li>disunion, disaccord</li><li>a group of people or things</li></ol>
dibuixar	<i>verb</i><br><ol><li>to draw (a picture)</li></ol>
dichital|dichitals	<i>adj</i><br><ol><li>digital</li></ol>
dido|didos	<i>noun</i><br><ol><li>finger</li><li>toe</li></ol>
dien|diens	<i>noun</i><br><ol><li>tooth</li></ol>
dient	<i>noun</i><br><ol><li>tooth</li></ol>
diez	<i>num</i><br><ol><li>ten</li></ol>
diners	<i>noun</i><br><ol><li>money</li></ol>
dir	<i>verb</i><br><ol><li>to say</li></ol>
discutar	<i>verb</i><br><ol><li>(transitive, intransitive) to discuss</li></ol>
distrayer	<i>verb</i><br><ol><li>(transitive) to distract</li><li>(reflexive) to entertain oneself</li></ol>
diya	<i>noun</i><br><ol><li>day</li></ol>
dizionario|dizionarios	<i>noun</i><br><ol><li>dictionary</li></ol>
doce	<i>num</i><br><ol><li>twelve</li></ol>
doler	<i>verb</i><br><ol><li>(transitive) to hurt</li></ol>
domingo	<i>noun</i><br><ol><li>Sunday</li></ol>
dos	<i>num</i><br><ol><li>two</li></ol>
dotrina|dotrinas	<i>noun</i><br><ol><li>doctrine</li></ol>
dotze	<i>num</i><br><ol><li>twelve</li></ol>
doze	<i>num</i><br><ol><li>twelve</li></ol>
dubda	<i>noun</i><br><ol><li>doubt</li></ol>
ducena	<i>noun</i><br><ol><li>dozen</li></ol>
dueño|dueños	<i>noun</i><br><ol><li>owner</li></ol>
dulce	<i>adj</i><br><ol><li>sweet</li></ol>
duro	<i>adj</i><br><ol><li>hard</li></ol>
eixemplo|eixemplos	<i>noun</i><br><ol><li>example</li></ol>
el	<i>pron</i><br><ol><li>him (direct object)</li></ol>
ella	<i>pron</i><br><ol><li>she</li></ol>
ellas	<i>pron</i><br><ol><li>they (third-person plural feminine pronoun)</li></ol>
ellos	<i>pron</i><br><ol><li>they (third-person plural masculine pronoun)</li></ol>
els	<i>pron</i><br><ol><li>they (third-person plural masculine pronoun)</li></ol>
endurar	<i>verb</i><br><ol><li>(transitive) to endure</li></ol>
enemigo|enemigos	<i>noun</i><br><ol><li>enemy</li></ol>
enfortir	<i>verb</i><br><ol><li>(transitive, reflexive) to strengthen, reinforce</li></ol>
enguerau|engueraus|engueradas|enguerada	<i>adj</i><br><ol><li>involved in a multitude of projects that were started, but never finished</li></ol>
entender	<i>verb</i><br><ol><li>(transitive) to understand</li></ol>
epistemolochía	<i>noun</i><br><ol><li>epistemology</li></ol>
equipo|equipos	<i>noun</i><br><ol><li>team</li></ol>
eredar	<i>verb</i><br><ol><li>(transitive) to inherit</li></ol>
erenzio|erenzios	<i>noun</i><br><ol><li>inheritance</li></ol>
es	<i>pron</i><br><ol><li>them (masculine direct object)</li></ol>
escalera|escaleras	<i>noun</i><br><ol><li>ladder</li><li>staircase</li></ol>
escarabaxo	<i>noun</i><br><ol><li>beetle</li></ol>
escoba|escobas	<i>noun</i><br><ol><li>broom</li></ol>
escobar	<i>verb</i><br><ol><li>(transitive) to sweep</li></ol>
escorchar|escorchaus|escorchatos|escorcho|escorcha|escorchés|escorches|escorcharez|escorchasez|escorchaba|escorchata|escorchabanos|escorchadas|escorchasenos|escorchen|escorchará|escorchatas|escorchaz|escorchasen|escorchada|escorche|escorchan|escorcharía|escorchemos|escorchabas|escorchón|escorcharé|escorchoron|escorché|escorcharían|escorchaban|escorchabaz|escorchase|escorchau|escorchando|escorchato|escorchó|escorchabe|escorcharíanos|escorchas|escorcharemos|escorcharías|escorchamos|escorchez|escorcharás|escorcharán|escorcharíaz|escorchases	<i>verb</i><br><ol><li>to skin</li></ol>
escroto	<i>noun</i><br><ol><li>scrotum</li></ol>
espanyol	<i>noun</i><br><ol><li>Spanish (language)</li></ol>
esponnal	<i>noun</i><br><ol><li>(Belsetán) slope, bank</li></ol>
espuenna|espuennas	<i>noun</i><br><ol><li>(Belsetán) terrace</li></ol>
esquirgüelo|esquirgüelos	<i>noun</i><br><ol><li>squirrel</li></ol>
estadísticas	<i>noun</i><br><ol><li>statistics (study)</li></ol>
estamaco	<i>noun</i><br><ol><li>(anatomy) stomach</li></ol>
estar	<i>verb</i><br><ol><li>to be</li></ol>
estato	<i>noun</i><br><ol><li>state</li></ol>
este|estos|esta|estas	<i>det</i><br><ol><li>this</li></ol>
estiu	<i>noun</i><br><ol><li>summer</li></ol>
etimolochía|etimolochías	<i>noun</i><br><ol><li>etymology</li></ol>
faba	<i>noun</i><br><ol><li>bean</li></ol>
fablar|fablaríanos|fablez|fabló|fablarían|fabla|fablaba|fablaré|fablatas|fablen|fablasenos|fablaus|fablasen|fablarán|fablaban|fablé|fablase|fablato|fablata|fablatos|fablemos|fablabanos|fablaz|fablau|fablarías|fablarás|fables|fablón|fablabe|fabladas|fablo|fablas|fablarez|fablaremos|fablasez|fablaríaz|fabloron|fablamos|fablabas|fablés|fablará|fablada|fablabaz|fablando|fable|fablan|fablaría|fablases	<i>verb</i><br><ol><li>to speak</li></ol>
falcada|falcadas	<i>noun</i><br><ol><li>the amount of cereal stalks to be scythed that a person can hold with one hand</li></ol>
falordia|falordias	<i>noun</i><br><ol><li>tale; story</li><li>a tall tale or rumour</li></ol>
falz	<i>noun</i><br><ol><li>sickle</li></ol>
fambre	<i>noun</i><br><ol><li>hunger</li></ol>
febrero	<i>noun</i><br><ol><li>February</li></ol>
fer|farías|fará|fesen|feremos|faziemos|fayan|feríanos|feban|feríaz|fas|ferías|ferían|faré|faremos|farán|febanos|faya|feita|feba|faziez|fayaz|feitas|fendo|feses|fazié|fesenos|foi|fese|ferez|febas|fería|fan|ferán|ferá|fa|fazió|febe|farás|faríanos|fesez|feré|faziés|faiga|feito|fazión|ferás|febaz|faigas|fayamos|fayas|faría|faigaz|faigamos|feitos|fazioron|farían|fez|femos|faríaz|fé|faigan	<i>verb</i><br><ol><li>to do</li></ol>
fierro	<i>noun</i><br><ol><li>iron</li></ol>
figado	<i>noun</i><br><ol><li>liver</li></ol>
figo	<i>noun</i><br><ol><li>fig</li></ol>
filla	<i>noun</i><br><ol><li>daughter</li></ol>
fillo	<i>noun</i><br><ol><li>Son.</li></ol>
filosofía	<i>noun</i><br><ol><li>philosophy</li></ol>
finestra	<i>noun</i><br><ol><li>window</li></ol>
flama	<i>noun</i><br><ol><li>flame</li></ol>
flor|flors	<i>noun</i><br><ol><li>flower</li></ol>
floronco	<i>noun</i><br><ol><li>tumour, boil</li></ol>
foratar|foratemos|foratará|foratón|forates|forató|foratas|foraten|foratoron|foratatas|forataríanos|foratabaz|foratarez|foratarás|foratato|foratau|foratatos|forata|foratada|foratasen|foraté|foratabe|foratasenos|forataría|foratarían|foratez|foratarán|foratasez|foratadas|foratabanos|forato|foratases|foratase|forataba|foratamos|forataz|forataban|forataré|forate|forataríaz|foratarías|foratés|foratata|foratando|forataremos|foratabas|forataus|foratan	<i>verb</i><br><ol><li>to hole, to drill a holle</li></ol>
forato	<i>noun</i><br><ol><li>hole</li></ol>
fornica	<i>noun</i><br><ol><li>(Belsetán, Panticuto, Val de Vio) ant</li></ol>
frabica	<i>noun</i><br><ol><li>factory</li></ol>
franxe	<i>noun</i><br><ol><li>ditch, trench</li></ol>
franzés|franzeses|franzesa|franzesas	<i>noun</i><br><ol><li>French person</li><li>French (language)</li></ol><br><i>adj</i><br><ol><li>French (of, from or relating to France)</li></ol>
freqüencia	<i>noun</i><br><ol><li>frequency</li></ol>
fruita	<i>noun</i><br><ol><li>fruit</li></ol>
fruito	<i>noun</i><br><ol><li>fruit</li></ol>
fuego	<i>noun</i><br><ol><li>fire</li></ol>
fungo	<i>noun</i><br><ol><li>mushroom</li></ol>
furtaire	<i>noun</i><br><ol><li>thief</li></ol>
garra	<i>noun</i><br><ol><li>leg</li></ol><br><i>det</i><br><ol><li>no, not any (usually with no or other negative particle)</li></ol><br><i>pron</i><br><ol><li>none, not one (usually with no or other negative particle)</li></ol>
gos|goses	<i>noun</i><br><ol><li>dog</li></ol>
gran	<i>adj</i><br><ol><li>big</li></ol>
gronlandés	<i>noun</i><br><ol><li>Greenlandic (language)</li></ol>
guerra civil|guerras civils	<i>noun</i><br><ol><li>civil war</li></ol>
género	<i>noun</i><br><ol><li>(grammar) gender</li></ol>
güe	<i>adv</i><br><ol><li>today</li></ol>
güeito	<i>num</i><br><ol><li>eight</li></ol>
güello|güellos	<i>noun</i><br><ol><li>(anatomy) eye</li></ol>
güembro	<i>noun</i><br><ol><li>shoulder</li></ol>
güeso	<i>noun</i><br><ol><li>bone</li></ol>
haber	<i>verb</i><br><ol><li>have; there be</li></ol>
habitar|habitabe|habitabas|habitaría|habitamos|habitasen|habitata|habitato|habitadas|habitarían|habitarás|habitarán|habitaríaz|habito|habité|habitando|habite|habitases|habiten|habitase|habitasez|habitaus|habitatas|habitabaz|habitasenos|habitada|habitaré|habitaz|habitón|habitabanos|habita|habitas|habites|habitau|habitaban|habitarez|habitó|habitaríanos|habitaba|habitez|habitarías|habités|habitemos|habitoron|habitará|habitan|habitatos|habitaremos	<i>verb</i><br><ol><li>to dwell</li></ol>
hache	<i>noun</i><br><ol><li>The name of the Latin-script letter H.</li></ol>
hereu	<i>noun</i><br><ol><li>heir</li></ol>
hibierno	<i>noun</i><br><ol><li>winter</li></ol>
hielmo|hielmos	<i>noun</i><br><ol><li>(heraldry) helmet</li></ol>
hierba	<i>noun</i><br><ol><li>grass</li></ol>
hombre	<i>noun</i><br><ol><li>(anthropology) man</li><li>husband</li></ol>
hue	<i>adv</i><br><ol><li>today</li></ol>
huesped	<i>noun</i><br><ol><li>guest</li></ol>
ibón|ibons	<i>noun</i><br><ol><li>tarn; a small mountain lake (especially one in the Aragonese Pyrenees)</li></ol>
igual	<i>adj</i><br><ol><li>equal</li></ol>
ilesia	<i>noun</i><br><ol><li>church</li></ol>
información|informacions	<i>noun</i><br><ol><li>information</li></ol>
inmigración|inmigracions	<i>noun</i><br><ol><li>immigration</li></ol>
inspiración|inspiracions	<i>noun</i><br><ol><li>inspiration</li></ol>
intelichencia	<i>noun</i><br><ol><li>intelligence</li></ol>
intelichencia artificial	<i>noun</i><br><ol><li>artificial intelligence</li></ol>
ir	<i>verb</i><br><ol><li>to go</li></ol>
ironía	<i>noun</i><br><ol><li>irony</li></ol>
iste|istas|ista|istos	<i>det</i><br><ol><li>this</li></ol>
ixe|ixa|ixas|ixos	<i>det</i><br><ol><li>that</li></ol>
la	<i>pron</i><br><ol><li>her (direct object)</li></ol>
laco	<i>noun</i><br><ol><li>lake</li></ol>
las	<i>pron</i><br><ol><li>them (feminine direct object)</li></ol>
latín	<i>noun</i><br><ol><li>Latin (language)</li></ol>
le	<i>pron</i><br><ol><li>(to) him (indirect object)</li></ol>
leit	<i>noun</i><br><ol><li>milk</li></ol>
leito	<i>noun</i><br><ol><li>bed</li></ol>
les	<i>pron</i><br><ol><li>them (indirect object)</li></ol>
li	<i>pron</i><br><ol><li>him (indirect object)</li></ol>
liberalismo	<i>noun</i><br><ol><li>liberalism</li></ol>
lis	<i>pron</i><br><ol><li>(to) them (indirect object)</li></ol>
lixero	<i>adj</i><br><ol><li>light (not heavy)</li></ol>
lo	<i>pron</i><br><ol><li>him (direct object)</li></ol>
logar|logase|logaban|logatos|logabaz|logaremos|logoron|logó|loge|logaz|logarez|logaría|logez|logabas|logata|logamos|logemos|logaré|logases|logarás|logasen|logatas|logada|logadas|logaba|logará|logaríanos|logaríaz|logabanos|logabe|logasenos|logé|logo|logaus|logau|logato|logés|logarían|logarías|logasez|logarán|loges|loga|logón|logen|logando|logan|logas	<i>verb</i><br><ol><li>to rent</li></ol>
loro|loros	<i>noun</i><br><ol><li>parrot</li></ol>
los	<i>pron</i><br><ol><li>them (masculine direct object)</li></ol>
lotería|loterías	<i>noun</i><br><ol><li>lottery</li></ol>
luenga|luengas	<i>noun</i><br><ol><li>tongue</li><li>language</li></ol>
luengo|luengos|luengas|luenga	<i>adj</i><br><ol><li>long</li></ol>
luita	<i>noun</i><br><ol><li>fight</li></ol>
luitar	<i>verb</i><br><ol><li>(intransitive) to fight</li></ol>
lumero|lumeros	<i>noun</i><br><ol><li>number</li></ol>
luna|lunas	<i>noun</i><br><ol><li>moon</li></ol>
lunes	<i>noun</i><br><ol><li>Monday</li></ol>
lunetas	<i>noun</i><br><ol><li>eye-glasses</li></ol>
lupo|lupos	<i>noun</i><br><ol><li>wolf</li></ol>
lurte|lurtes	<i>noun</i><br><ol><li>avalanche</li></ol>
luz	<i>noun</i><br><ol><li>light</li></ol>
mai	<i>noun</i><br><ol><li>mother</li></ol>
maitín	<i>noun</i><br><ol><li>morning</li></ol>
malacatón|malacatons	<i>noun</i><br><ol><li>peach</li></ol>
malla	<i>noun</i><br><ol><li>angioma</li><li>little spot, stain</li><li>mesh</li></ol>
mallata|mallatas	<i>noun</i><br><ol><li>a cabin in the wilderness used by herdsmen during transhumance</li></ol>
man	<i>noun</i><br><ol><li>hand</li></ol>
manteca|mantecas	<i>noun</i><br><ol><li>butter</li></ol>
manzana|manzanas	<i>noun</i><br><ol><li>apple</li></ol>
manzanera|manzaneras	<i>noun</i><br><ol><li>apple-tree</li></ol>
mapa|mapas	<i>noun</i><br><ol><li>map</li></ol>
maquina|maquinas	<i>noun</i><br><ol><li>machine</li></ol>
mar|mars	<i>noun</i><br><ol><li>sea</li></ol>
margalida|margalidas	<i>noun</i><br><ol><li>daisy</li></ol>
marinero|marineras|marineros|marinera	<i>adj</i><br><ol><li>marine</li></ol><br><i>noun</i><br><ol><li>sailor</li></ol>
mariscal|mariscals	<i>noun</i><br><ol><li>veterinarian</li></ol>
marito|maritos	<i>noun</i><br><ol><li>husband</li></ol>
martes	<i>noun</i><br><ol><li>Tuesday</li></ol>
martiello|martiellos	<i>noun</i><br><ol><li>hammer</li></ol>
marzo	<i>noun</i><br><ol><li>March</li></ol>
masclo|masclos	<i>noun</i><br><ol><li>male</li></ol>
matar	<i>verb</i><br><ol><li>(transitive) to kill</li></ol>
matrimonio|matrimonios	<i>noun</i><br><ol><li>marriage</li></ol>
matur|maturs|matura|maturas	<i>adj</i><br><ol><li>(Belsetán, Chistabín, Sobrepuerto) ripe, mature</li></ol>
maular	<i>verb</i><br><ol><li>(intransitive) to meow</li></ol>
mayestro|mayestros	<i>noun</i><br><ol><li>teacher, professor</li></ol>
mayo	<i>noun</i><br><ol><li>May</li></ol>
me	<i>pron</i><br><ol><li>me (first-person singular direct pronoun)</li><li>(to) me (first-person singular indirect pronoun)</li></ol>
medieval	<i>adj</i><br><ol><li>medieval</li></ol>
memoria|memorias	<i>noun</i><br><ol><li>memory</li></ol>
mentira|mentiras	<i>noun</i><br><ol><li>lie</li></ol>
mes|meses	<i>noun</i><br><ol><li>month</li></ol>
mesa|mesas	<i>noun</i><br><ol><li>table</li></ol>
mesacha	<i>noun</i><br><ol><li>girl</li></ol>
mesura|mesuras	<i>noun</i><br><ol><li>measurement</li></ol>
mesurar	<i>verb</i><br><ol><li>(transitive) to measure</li></ol>
metal|metals	<i>noun</i><br><ol><li>metal</li></ol>
meter	<i>verb</i><br><ol><li>to put</li></ol>
metro	<i>noun</i><br><ol><li>metre</li></ol>
mezclar	<i>verb</i><br><ol><li>(transitive) to mix</li></ol>
midir	<i>verb</i><br><ol><li>(transitive) to measure</li></ol>
miedo|miedos	<i>noun</i><br><ol><li>fear</li></ol>
miel	<i>noun</i><br><ol><li>honey</li></ol>
mierda|mierdas	<i>noun</i><br><ol><li>(vulgar) shit</li></ol>
mil	<i>num</i><br><ol><li>thousand</li></ol>
minchar|minchas|minchaban|mincharían|minchabe|minchada|mincharemos|minches|minchatos|minchases|minchabas|minchez|mincharías|mincharás|mincharíaz|mincharía|minchasez|minchemos|minchón|minchau|minchata|minchato|minchan|minchó|minche|minchará|mincharez|minchabaz|minché|minchabanos|mincho|minchaus|minchando|minchoron|mincha|minchen|minchaba|minchatas|mincharán|minchés|mincharé|minchasen|minchaz|minchase|mincharíanos|minchamos|minchadas|minchasenos	<i>verb</i><br><ol><li>to eat</li></ol>
mirallo	<i>noun</i><br><ol><li>(Belsetán, Cheso) mirror</li></ol>
mirandés	<i>noun</i><br><ol><li>Mirandese (language)</li></ol>
mirar|miratas|mirando|mirata|miraus|mirón|miraban|mirasenos|miraremos|miraz|mirarían|mirez|mirasen|miraría|mirada|miradas|miraba|miraríanos|mires|miremos|mirase|miraríaz|miré|mirabe|mirau|mirabaz|mirabas|miras|mirabanos|miro|mirarás|mirarez|mirases|miraré|mirarías|mira|mirasez|mirato|miró|mire|miren|miratos|mirarán|mirará|miramos|miran|miroron|mirés	<i>verb</i><br><ol><li>(transitive) to watch</li></ol>
mixín|mixins	<i>noun</i><br><ol><li>cat</li></ol>
miércols	<i>noun</i><br><ol><li>Wednesday</li></ol>
mober	<i>verb</i><br><ol><li>(transitive, reflexive) to move</li></ol>
mobimiento|mobimientos	<i>noun</i><br><ol><li>movement</li></ol>
molteplicar	<i>verb</i><br><ol><li>(transitive) to multiply</li></ol>
molteplicazión|molteplicazions	<i>noun</i><br><ol><li>multiplication</li></ol>
moncho|monchos	<i>noun</i><br><ol><li>monk</li></ol>
moneda|monedas	<i>noun</i><br><ol><li>coin</li></ol>
monesterio	<i>noun</i><br><ol><li>monastery</li></ol>
mono|monos	<i>noun</i><br><ol><li>monkey</li></ol>
morato|moratos|moratas|morata	<i>adj</i><br><ol><li>purple</li></ol>
morder	<i>verb</i><br><ol><li>(transitive, reflexive) To bite.</li></ol>
mos	<i>pron</i><br><ol><li>us (first-person plural direct pronoun)</li><li>(to) us (first-person plural indirect pronoun)</li></ol>
mosal	<i>noun</i><br><ol><li>an enclosure for milking cattle</li></ol>
mosaquiar	<i>verb</i><br><ol><li>to bite</li></ol>
mosca|moscas	<i>noun</i><br><ol><li>fly (insect)</li></ol>
mosico|mosicos	<i>noun</i><br><ol><li>musician</li></ol>
mostrar|mostrabaz|mostrando|mostrau|mostratos|mostrarían|mostrarez|mostrabe|mostro|mostrés|mostraré|mostraus|mostrasez|mostramos|mostran|mostraremos|mostren|mostra|mostró|mostrabanos|mostrabas|mostrada|mostrarás|mostres|mostraban|mostré|mostraría|mostrasen|mostrarías|mostroron|mostrez|mostrase|mostrato|mostraríaz|mostraríanos|mostratas|mostraz|mostrón|mostradas|mostrará|mostras|mostremos|mostraba|mostre|mostrata|mostrases|mostrasenos|mostrarán	<i>verb</i><br><ol><li>to show</li></ol>
motibo|motibos	<i>noun</i><br><ol><li>motive</li></ol>
mover	<i>verb</i><br><ol><li>to move</li></ol>
muchila|muchilas	<i>noun</i><br><ol><li>backpack</li></ol>
muderno|muderna|mudernas|mudernos	<i>adj</i><br><ol><li>modern</li></ol>
mudo	<i>adj</i><br><ol><li>dumb, mute</li></ol>
mueble|muebles	<i>noun</i><br><ol><li>a piece of furniture</li></ol>
muerte|muertes	<i>noun</i><br><ol><li>death</li></ol>
muller|mullers	<i>noun</i><br><ol><li>woman</li><li>wife</li></ol>
mundo	<i>noun</i><br><ol><li>world</li></ol>
museyo|museyos	<i>noun</i><br><ol><li>museum</li></ol>
muyir|muyiz|muyiríaz|muyía|muyirá|muigas|muyitos|muigo|muyíos|muyibas|muyirez|muiga|muyiría|muyez|muyito|muyisenos|muyiríanos|muyirán|muyías|muyibe|muyemos|muyiban|muyisez|muyem|muyes|muyimos|muyibanos|muyoron|muyirían|muigam|muye|muyíu|muyirías|muigamos|muyisen|muigan|muyiremos|muyé|muyés|muyise|muyen|muyiba|muyirás|muyiré|muyibaz|muigaz|muyita|muyitas|muyises|muyindo	<i>verb</i><br><ol><li>to milk</li></ol>
nadar|nades|nadasen|nadé|nadau|nade|nadó|nadasez|nadando|nademos|nadaré|nadaba|nadoron|nadarías|nadaremos|nadasenos|nadarez|nadón|nadase|nadabanos|nadaban|nadabe|nadaus|nadés|nadaz|nadaríaz|nadan|nadarían|nadases|nadabas|nadez|nadarán|nadato|nada|nadas|nadatos|nadatas|nadata|nadamos|nado|naden|nadabaz|nadará|nadaría|nadarás|nadada|nadaríanos|nadadas	<i>verb</i><br><ol><li>to swim</li></ol>
naixer	<i>verb</i><br><ol><li>be born</li></ol>
narancha|naranchas	<i>noun</i><br><ol><li>orange (color)</li><li>orange (fruit)</li></ol>
nariz	<i>noun</i><br><ol><li>nose</li></ol>
naso	<i>noun</i><br><ol><li>nose</li></ol>
nau|naus	<i>noun</i><br><ol><li>ship</li></ol>
naxer	<i>verb</i><br><ol><li>(intransitive) to be born</li></ol>
nazión|nazions	<i>noun</i><br><ol><li>nation</li></ol>
nebar|nebabe|nebaus|nebau|nebo|nebaré|nebes|nebez|nebemos|nebarez|nebatos|nebará|nebamos|nebaba|nebón|nebarías|nebata|nebasen|nebato|nebadas|nebaremos|neboron|nebatas|nebé|neben|nebas|nebase|nebasenos|nebaríanos|neban|nebaz|nebés|nebaría|nebabanos|nebada|nebó|nebases|nebaban|nebando|nebarían|nebabas|nebaríaz|nebasez|neba|nebe|nebarán|nebarás|nebabaz	<i>verb</i><br><ol><li>to snow</li></ol>
negar	<i>verb</i><br><ol><li>(transitive) to deny</li></ol>
negro|negros|negras|negra	<i>adj</i><br><ol><li>black (color)</li></ol>
nevar	<i>verb</i><br><ol><li>to snow</li></ol>
nezesitar	<i>verb</i><br><ol><li>(transitive) to need</li></ol>
nieda|niedas	<i>noun</i><br><ol><li>haystack, hayrick</li></ol>
niedo|niedos	<i>noun</i><br><ol><li>nest</li></ol>
nieu	<i>noun</i><br><ol><li>snow</li></ol>
ninno	<i>noun</i><br><ol><li>(Belsetán) male toddler</li></ol>
nobiembre	<i>noun</i><br><ol><li>November</li></ol>
nombre|nombres	<i>noun</i><br><ol><li>name</li></ol>
nome	<i>noun</i><br><ol><li>name</li></ol>
norte	<i>noun</i><br><ol><li>north</li></ol>
nos	<i>pron</i><br><ol><li>us (first-person plural direct pronoun)</li><li>(to) us (first-person plural indirect pronoun)</li></ol>
nou	<i>num</i><br><ol><li>nine</li></ol>
nuei	<i>noun</i><br><ol><li>night</li></ol>
nueit	<i>noun</i><br><ol><li>night</li></ol>
nueu	<i>num</i><br><ol><li>nine</li></ol>
nusatras	<i>pron</i><br><ol><li>we (first-person plural feminine pronoun)</li></ol>
nusatros	<i>pron</i><br><ol><li>we (first-person plural masculine pronoun)</li></ol>
número	<i>noun</i><br><ol><li>number, digit, numeral</li><li>(grammar) number</li></ol>
o|singulars	<i>article</i><br><ol><li>the</li></ol>
obchecto	<i>noun</i><br><ol><li>object</li></ol>
octubre	<i>noun</i><br><ol><li>October</li></ol>
ocupar	<i>verb</i><br><ol><li>(transitive) to occupy</li></ol>
ofierta|ofiertas	<i>noun</i><br><ol><li>offer</li></ol>
ofizina|ofizinas	<i>noun</i><br><ol><li>office</li></ol>
ofrexer	<i>verb</i><br><ol><li>(transitive) to offer</li></ol>
olandés	<i>noun</i><br><ol><li>Dutch (language)</li></ol>
oliba|olibas	<i>noun</i><br><ol><li>olive</li></ol>
olio	<i>noun</i><br><ol><li>oil</li></ol>
olla|ollas	<i>noun</i><br><ol><li>pot</li></ol>
ombre|ombres	<i>noun</i><br><ol><li>man</li><li>a 17th-century Spanish card game (c. 1650-1660), usually played by three persons with a pack of 40 cards.</li><li>the lone player in this game undertaking to win the pool against two defenders.</li></ol>
once	<i>num</i><br><ol><li>eleven</li></ol>
onso	<i>noun</i><br><ol><li>bear</li></ol>
onze	<i>num</i><br><ol><li>eleven</li></ol>
operazión|operazions	<i>noun</i><br><ol><li>operation</li></ol>
ora|oras	<i>noun</i><br><ol><li>hour</li></ol>
ordio	<i>noun</i><br><ol><li>barley</li></ol>
orella	<i>noun</i><br><ol><li>(anatomy) ear</li></ol>
oro	<i>noun</i><br><ol><li>gold</li></ol>
os	<i>article</i><br><ol><li>the</li></ol>
otubre	<i>noun</i><br><ol><li>October</li></ol>
pachina|pachinas	<i>noun</i><br><ol><li>page</li></ol>
pagar	<i>verb</i><br><ol><li>(transitive) to pay</li></ol>
pai	<i>noun</i><br><ol><li>father</li></ol>
palazio|palazios	<i>noun</i><br><ol><li>palace</li></ol>
pan	<i>noun</i><br><ol><li>bread</li></ol>
pancha	<i>noun</i><br><ol><li>(anatomy) abdomen</li></ol>
papel|papels	<i>noun</i><br><ol><li>paper</li></ol>
paret|parez	<i>noun</i><br><ol><li>wall</li></ol>
parexer	<i>verb</i><br><ol><li>(intransitive) to seem</li></ol>
parlar|parlabas|parlaz|parlas|parlemos|parladas|parle|parlón|parlabaz|parlaríaz|parlando|parlato|parló|parlaré|parlarás|parlaría|parlase|parlabe|parlé|parloron|parles|parlabanos|parlarían|parlasen|parlaban|parlarez|parlo|parlarías|parla|parlez|parlaríanos|parlatas|parlada|parlarán|parlan|parlata|parlases|parlamos|parlará|parlasez|parlaba|parlés|parlen|parlaremos|parlatos|parlaus|parlasenos|parlau	<i>verb</i><br><ol><li>to speak</li></ol>
parpago|parpagos	<i>noun</i><br><ol><li>eyelid</li></ol>
pas	<i>adv</i><br><ol><li>emphasises a negation; (not) at all; (not) ever</li></ol>
paxaro	<i>noun</i><br><ol><li>bird</li></ol>
paz	<i>noun</i><br><ol><li>peace</li></ol>
pedagochía	<i>noun</i><br><ol><li>pedagogy</li></ol>
pedaleta|pedaletas	<i>noun</i><br><ol><li>a short sock</li></ol>
pegullo|pegullos	<i>noun</i><br><ol><li>flock; herd (of animals)</li></ol>
peito|peitos	<i>noun</i><br><ol><li>(anatomy) chest</li></ol>
peix	<i>noun</i><br><ol><li>fish</li></ol>
pelello	<i>noun</i><br><ol><li>skin</li></ol>
pene	<i>noun</i><br><ol><li>(anatomy) penis</li></ol>
penna|pennas	<i>noun</i><br><ol><li>(Belsetán) large natural rock or stone</li></ol>
pescau	<i>noun</i><br><ol><li>fish</li></ol>
pex|pexes	<i>noun</i><br><ol><li>fish</li></ol>
piedra|piedras	<i>noun</i><br><ol><li>stone</li></ol>
piel|piels	<i>noun</i><br><ol><li>skin</li></ol>
piet|pietz	<i>noun</i><br><ol><li>(anatomy) foot</li></ol>
pintaire|pintaires	<i>noun</i><br><ol><li>painter</li></ol>
pintar	<i>verb</i><br><ol><li>(transitive) to paint</li></ol>
plata|platas	<i>noun</i><br><ol><li>silver</li></ol>
playa|playas	<i>noun</i><br><ol><li>beach</li></ol>
pleber	<i>verb</i><br><ol><li>to rain</li></ol>
plebia	<i>noun</i><br><ol><li>rain water</li></ol>
plegar|plegatos|plegando|plege|plegarían|plegasen|plegau|plegó|plegan|plegés|plegé|plegabe|plegón|plegaríanos|plega|plegarán|plegasenos|plego|plegamos|plegaremos|plegen|plegaríaz|plegaré|plegaba|plegaz|plegarás|plegarías|plegada|plegarez|plegato|plegará|plegasez|plegadas|plegemos|plegaban|pleges|plegatas|plegaría|plegabas|plegata|plegases|plegabanos|plegase|plegabaz|plegoron|plegez|plegas|plegaus	<i>verb</i><br><ol><li>to arrive</li></ol>
plen|plenas|plena|plens	<i>adj</i><br><ol><li>(Belsetán) full</li></ol>
pleonasmo	<i>noun</i><br><ol><li>pleonasm</li></ol>
plorar|ploremos|plorabe|ploratas|ploraz|ploraríanos|plorabaz|ploren|ploraremos|plororon|plorato|plorata|ploradas|ploras|plorez|ploraríaz|ploramos|plorase|plorarías|plorarez|plorasez|plorarían|plorau|ploratos|ploré|plorases|plorarás|ploraría|plorada|ploraré|plora|plorarán|ploraba|ploran|ploraban|plorará|plore|ploraus|plorando|ploro|plorabas|plores|plorés|plorasen|plorabanos|plorasenos|plorón|ploró	<i>verb</i><br><ol><li>to cry</li></ol>
pluma|plumas	<i>noun</i><br><ol><li>feather</li></ol>
poder|puesto	<i>verb</i><br><ol><li>to be able to, can</li></ol>
poesía	<i>noun</i><br><ol><li>poetry</li></ol>
polmón|polmons	<i>noun</i><br><ol><li>lung</li></ol>
polpa|polpas	<i>noun</i><br><ol><li>pulp</li></ol>
polpo|polpos	<i>noun</i><br><ol><li>octopus</li></ol>
pornografía	<i>noun</i><br><ol><li>pornography</li></ol>
porro|porros	<i>noun</i><br><ol><li>leek</li></ol>
portafuellas	<i>noun</i><br><ol><li>(computing) clipboard</li></ol>
prau	<i>noun</i><br><ol><li>meadow</li></ol>
prauticar	<i>verb</i><br><ol><li>(transitive) to practice</li></ol>
prebar|prebón|prebau|prebaríaz|prebo|prebaríanos|prebaré|prebes|prebas|prebarían|prebabaz|preben|prebada|prebaz|prebemos|prebamos|prebata|prebases|prebaba|prebase|prebadas|prebó|prebará|prebaremos|prebando|prebasenos|preba|prebe|prebarás|prebés|prebatos|prebaría|prebasen|prebaban|preban|prebarán|prebaus|prebato|prebasez|prebé|prebabe|prebez|prebarías|prebatas|preboron|prebarez|prebabas|prebabanos	<i>verb</i><br><ol><li>to try</li></ol>
preguntar	<i>verb</i><br><ol><li>(transitive) to ask</li></ol>
prenzipe|prenzipes	<i>noun</i><br><ol><li>price</li></ol>
prenzipio|prenzipios	<i>noun</i><br><ol><li>beginning</li></ol>
presona|presonas	<i>noun</i><br><ol><li>person</li></ol>
prexinar|prexinen|prexinaus|prexinatas|prexinó|prexinasen|prexinamos|prexinadas|prexine|prexinasenos|prexinando|prexinaríanos|prexinases|prexinasez|prexinarez|prexinas|prexinan|prexinará|prexinase|prexinabe|prexinatos|prexinemos|prexinarás|prexinaríaz|prexinaré|prexinabanos|prexinaría|prexiné|prexinabaz|prexinaban|prexina|prexinón|prexino|prexinés|prexinabas|prexinoron|prexines|prexinarán|prexinaremos|prexinaz|prexinaba|prexinarías|prexinarían|prexinez|prexinato|prexinau|prexinata|prexinada	<i>verb</i><br><ol><li>to imagine</li></ol>
prinzesa|prinzesas	<i>noun</i><br><ol><li>princess</li></ol>
probenzal	<i>noun</i><br><ol><li>Provençal</li></ol>
probinzia|probinzias	<i>noun</i><br><ol><li>province</li></ol>
problema	<i>noun</i><br><ol><li>problem</li></ol>
pueyo|pueyos	<i>noun</i><br><ol><li>hill</li></ol>
pui	<i>noun</i><br><ol><li>hill</li></ol>
puyar|puyé|puyato|puyaus|puyabaz|puyamos|puyo|puyará|puyabe|puyada|puyadas|puyabanos|puyaremos|puyaría|puye|puyarían|puyen|puyes|puyaríaz|puyas|puyaban|puyasez|puyoron|puyaz|puyases|puyau|puyasen|puyaríanos|puya|puyés|puyemos|puyarías|puyabas|puyez|puyarez|puyón|puyando|puyaba|puyaré|puyarán|puyó|puyata|puyase|puyatas|puyarás|puyasenos|puyatos|puyan	<i>verb</i><br><ol><li>to rise</li></ol>
qualque|cualque	<i>det</i><br><ol><li>(Belsetán, Chistabín) any, some</li></ol>
quan	<i>pron</i><br><ol><li>when</li></ol>
quanto	<i>pron</i><br><ol><li>how many</li></ol>
quatre	<i>num</i><br><ol><li>four</li></ol>
querer	<i>verb</i><br><ol><li>to want</li></ol>
qui	<i>pron</i><br><ol><li>(interrogative) who? whom?</li></ol>
radiz|radizes	<i>noun</i><br><ol><li>root</li></ol>
rastiello|rastiellos	<i>noun</i><br><ol><li>rake</li></ol>
rayo|rayos	<i>noun</i><br><ol><li>ray</li></ol>
rayo catodico	<i>noun</i><br><ol><li>cathode ray</li></ol>
razón|razons	<i>noun</i><br><ol><li>reason</li></ol>
rechirar|rechiren|rechirarían|rechirabe|rechirada|rechiraban|rechiré|rechirando|rechiró|rechirata|rechiraré|rechiroron|rechirarías|rechiraremos|rechiras|rechiro|rechiraz|rechiran|rechirabas|rechiraríaz|rechirasen|rechirez|rechirabaz|rechiraba|rechirasez|rechirarás|rechire|rechirase|rechiraría|rechiraríanos|rechirés|rechirará|rechirau|rechira|rechiremos|rechiratas|rechirón|rechirarez|rechirases|rechires|rechirasenos|rechirabanos|rechirarán|rechirato|rechiradas|rechiramos|rechiratos|rechiraus	<i>verb</i><br><ol><li>to search</li></ol>
rechión|rechions	<i>noun</i><br><ol><li>region</li></ol>
reclamo	<i>noun</i><br><ol><li>complaint</li></ol>
reconoxer	<i>verb</i><br><ol><li>(transitive) to recognize</li></ol>
redondo|redondos|redondas|redonda	<i>adj</i><br><ol><li>round</li></ol>
regar	<i>verb</i><br><ol><li>(transitive) to irrigate</li></ol>
rei	<i>noun</i><br><ol><li>king</li></ol>
relampago	<i>noun</i><br><ol><li>lightning</li></ol>
relazión	<i>noun</i><br><ol><li>relation</li></ol>
relichión|relichions	<i>noun</i><br><ol><li>religion</li></ol>
reloch	<i>noun</i><br><ol><li>clock</li></ol>
renera	<i>noun</i><br><ol><li>lower back</li></ol>
representar	<i>verb</i><br><ol><li>(transitive) to represent</li></ol>
republica|republicas	<i>noun</i><br><ol><li>republic</li></ol>
responder	<i>verb</i><br><ol><li>(transitive) to respond</li></ol>
rete	<i>noun</i><br><ol><li>net</li></ol>
rezibir	<i>verb</i><br><ol><li>(transitive) to receive</li></ol>
rico|rica|ricas|ricos	<i>adj</i><br><ol><li>rich</li></ol>
rinyón|rinyons	<i>noun</i><br><ol><li>kidney</li></ol>
riñón|riñons	<i>noun</i><br><ol><li>kidney</li></ol>
robre|robres	<i>noun</i><br><ol><li>oak</li></ol>
rocanroll	<i>noun</i><br><ol><li>(music) rock and roll</li></ol>
ropa|ropas	<i>noun</i><br><ol><li>clothes</li></ol>
rosa|rosas	<i>noun</i><br><ol><li>rose (flower)</li></ol>
royo	<i>adj</i><br><ol><li>red</li></ol>
río|ríos	<i>noun</i><br><ol><li>river</li></ol>
sabado	<i>noun</i><br><ol><li>Saturday</li></ol>
sabón	<i>noun</i><br><ol><li>soap</li></ol>
sal	<i>noun</i><br><ol><li>salt</li></ol>
salida|salidas	<i>noun</i><br><ol><li>exit</li></ol>
salinero|salineros	<i>noun</i><br><ol><li>salt-shaker</li></ol>
saludar	<i>verb</i><br><ol><li>(transitive) to salute</li></ol>
salú	<i>noun</i><br><ol><li>health</li></ol>
sangonera|sangoneras	<i>noun</i><br><ol><li>leech</li></ol>
sangre	<i>noun</i><br><ol><li>blood</li></ol>
santmigalada	<i>noun</i><br><ol><li>autumn (season of the year)</li></ol>
saper	<i>verb</i><br><ol><li>to know</li></ol>
sapia|sapias	<i>noun</i><br><ol><li>sap</li><li>taste</li></ol>
seda	<i>noun</i><br><ol><li>silk</li></ol>
seis	<i>num</i><br><ol><li>six</li></ol>
selba|selbas	<i>noun</i><br><ol><li>forest</li></ol>
semaforo|semaforos	<i>noun</i><br><ol><li>traffic light</li></ol>
semana|semanas	<i>noun</i><br><ol><li>week</li></ol>
sembrar	<i>verb</i><br><ol><li>(transitive) to sow</li></ol>
seminifero|seminiferos|seminifers	<i>adj</i><br><ol><li>seminiferous</li></ol>
senra	<i>noun</i><br><ol><li>ashes</li></ol>
serbir	<i>verb</i><br><ol><li>(intransitive) to serve</li></ol>
set	<i>noun</i><br><ol><li>thirst</li></ol>
sete	<i>noun</i><br><ol><li>thirst</li></ol>
setiembre	<i>noun</i><br><ol><li>September</li></ol>
sicolochía	<i>noun</i><br><ol><li>psychology</li></ol>
sieglo|sieglos	<i>noun</i><br><ol><li>century</li></ol>
sierra|sierras	<i>noun</i><br><ol><li>mountain-range</li></ol>
sies	<i>num</i><br><ol><li>six</li></ol>
siet|siete	<i>num</i><br><ol><li>seven</li></ol>
silenzio	<i>noun</i><br><ol><li>silence</li></ol>
simient	<i>noun</i><br><ol><li>seed</li></ol>
simién	<i>noun</i><br><ol><li>seed</li></ol>
sobretot	<i>adv</i><br><ol><li>above all</li></ol>
sodio	<i>noun</i><br><ol><li>sodium</li></ol>
sustantibo	<i>noun</i><br><ol><li>noun</li></ol>
tabierna|tabiernas	<i>noun</i><br><ol><li>tavern</li></ol>
tall	<i>pron</i><br><ol><li>such</li></ol>
tamién	<i>adv</i><br><ol><li>also; too</li></ol>
tartuga|tartugas	<i>noun</i><br><ol><li>turtle</li></ol>
te	<i>pron</i><br><ol><li>you, thee (second-person singular direct pronoun)</li><li>(to) you, (to) thee (second-person singular indirect pronoun)</li></ol>
teito|teitos	<i>noun</i><br><ol><li>roof</li></ol>
teixidor	<i>noun</i><br><ol><li>weaver</li></ol>
teixir	<i>verb</i><br><ol><li>to weave</li></ol>
telebisión	<i>noun</i><br><ol><li>television</li></ol>
templar|templaus|temples|templamos|templón|templaría|templarían|templasen|templaríaz|templata|templaba|temploron|templés|templau|templabas|templemos|templarás|templas|templases|templen|templatas|templaz|templó|templando|templasez|templará|templase|templarez|templan|templa|templaremos|templaré|templabe|templabanos|templez|templarías|templato|templasenos|templo|templada|templabaz|templé|templarán|templadas|templaban|temple|templatos|templaríanos	<i>verb</i><br><ol><li>to temper</li><li>to reduce</li><li>to warm up</li><li>to tune</li></ol>
templato|templatas|templatos|templata	<i>adj</i><br><ol><li>tepid, warm, mild</li><li>very fast</li></ol>
tener	<i>verb</i><br><ol><li>to have, hold</li></ol>
testiclo|testiclos	<i>noun</i><br><ol><li>testicle</li></ol>
texir	<i>verb</i><br><ol><li>(transitive) to knit, weave</li></ol>
tiburón|tiburons	<i>noun</i><br><ol><li>shark</li></ol>
tiempo|tiempos	<i>noun</i><br><ol><li>time</li></ol>
tierra|tierras	<i>noun</i><br><ol><li>earth</li></ol>
tocar	<i>verb</i><br><ol><li>(transitive) to touch</li></ol>
tocino|tocinos|tocins|tozino	<i>noun</i><br><ol><li>pig</li><li>lard</li></ol>
torraza	<i>noun</i><br><ol><li>tower</li></ol>
torre|torres	<i>noun</i><br><ol><li>tower</li></ol>
tos	<i>pron</i><br><ol><li>you (second-person plural direct pronoun)</li><li>(to) you (second-person plural indirect pronoun)</li></ol>
tot	<i>adj</i><br><ol><li>all</li></ol>
traduzir	<i>verb</i><br><ol><li>to translate</li></ol>
tranquilidá	<i>noun</i><br><ol><li>calmness, tranquility</li></ol>
trasportar	<i>verb</i><br><ol><li>(transitive) to transport</li></ol>
tratar	<i>verb</i><br><ol><li>(transitive) to try</li></ol>
trayer	<i>verb</i><br><ol><li>(transitive) to bring</li></ol>
treball	<i>noun</i><br><ol><li>work</li></ol>
treballador|treballadors	<i>noun</i><br><ol><li>worker</li></ol>
treballar	<i>verb</i><br><ol><li>(intransitive) to work</li></ol>
treballo|treballos	<i>noun</i><br><ol><li>work</li></ol>
tren|trens	<i>noun</i><br><ol><li>train</li></ol>
trepuzar	<i>verb</i><br><ol><li>(intransitive) to trip, stumble</li><li>(reflexive) to bump into, stumble upon, encounter (by chance)</li></ol>
tres	<i>num</i><br><ol><li>three</li></ol>
tresoro|tresoros	<i>noun</i><br><ol><li>treasure</li></ol>
trigo	<i>noun</i><br><ol><li>wheat</li></ol>
tristor	<i>noun</i><br><ol><li>sadness</li></ol>
trobar|trobatas|trobarez|trobabe|trobaban|troboron|trobaremos|trobemos|trobaré|trobasenos|trobaríaz|trobasen|trobez|trobaz|trobó|trobabanos|trobata|trobaría|troben|trobando|trobé|trobabas|trobes|trobaba|trobabaz|trobo|trobarías|trobaríanos|trobará|trobadas|trobarás|trobarían|trobau|trobarán|trobasez|trobato|trobón|trobase|trobases|troban|trobe|trobaus|trobas|trobatos|trobada|trobés|troba|trobamos	<i>verb</i><br><ol><li>to find</li></ol>
troz	<i>noun</i><br><ol><li>piece, portion</li></ol>
truco|trucos	<i>noun</i><br><ol><li>blow (act of striking or hitting)</li></ol>
truen	<i>noun</i><br><ol><li>thunder</li></ol>
truita|truitas	<i>noun</i><br><ol><li>trout</li></ol>
tubo|tubos	<i>noun</i><br><ol><li>tube</li></ol>
tubo catodico	<i>noun</i><br><ol><li>cathode tube</li></ol>
tusir	<i>verb</i><br><ol><li>(intransitive) to cough</li></ol>
tú	<i>pron</i><br><ol><li>you, thou (second-person singular pronoun)</li></ol>
u	<i>conj</i><br><ol><li>or</li></ol>
ubrir	<i>verb</i><br><ol><li>to open</li></ol>
udito	<i>noun</i><br><ol><li>hearing (sense)</li></ol>
uego	<i>noun</i><br><ol><li>egg</li></ol>
ueit	<i>num</i><br><ol><li>eight</li></ol>
ueito	<i>num</i><br><ol><li>eight</li></ol>
uello	<i>noun</i><br><ol><li>(anatomy) eye</li></ol>
ueste	<i>noun</i><br><ol><li>west</li></ol>
uga|ugas	<i>noun</i><br><ol><li>grape</li></ol>
ulor	<i>noun</i><br><ol><li>smell</li></ol>
un	<i>num</i><br><ol><li>one</li></ol>
ungla|unglas	<i>noun</i><br><ol><li>nail (on fingers or toes)</li></ol>
unibersidá|unibersidaz	<i>noun</i><br><ol><li>university</li></ol>
uno	<i>num</i><br><ol><li>one</li></ol>
urbano|urbana|urbanos|urbanas	<i>adj</i><br><ol><li>urban</li></ol>
urchén	<i>adj</i><br><ol><li>urgent</li></ol>
usar	<i>verb</i><br><ol><li>(transitive) to use</li></ol>
vabor	<i>noun</i><br><ol><li>steam</li></ol>
vaca	<i>noun</i><br><ol><li>cow</li></ol>
vachina|vachinas	<i>noun</i><br><ol><li>vagina</li></ol>
vachinal|vachinals	<i>adj</i><br><ol><li>vaginal</li></ol>
vada|vadas	<i>noun</i><br><ol><li>strike (work stoppage)</li></ol>
vada cheneral|vadas chenerals	<i>noun</i><br><ol><li>general strike</li></ol>
val	<i>noun</i><br><ol><li>valley</li></ol>
variedat|variedatz	<i>noun</i><br><ol><li>variety</li></ol>
vaxiella|vaxiellas	<i>noun</i><br><ol><li>dishes, dishware</li></ol>
vegada	<i>noun</i><br><ol><li>time, occasion</li></ol>
verbal|verbals	<i>adj</i><br><ol><li>(grammar) verbal (relating to verbs)</li></ol>
verdat|verdatz	<i>noun</i><br><ol><li>truth</li></ol>
verde|verda|verdes|verdas|verds|berde	<i>adj</i><br><ol><li>green</li></ol>
verenoso|verenosos|verenosas|verenosa	<i>adj</i><br><ol><li>(Cheso, Belsetán, Chistabín) poisonous</li></ol>
veyer	<i>verb</i><br><ol><li>to see</li></ol>
viache	<i>noun</i><br><ol><li>journey, trip, voyage</li></ol>
viello	<i>adj</i><br><ol><li>old</li></ol>
vielluz	<i>noun</i><br><ol><li>old age</li></ol>
viernes	<i>noun</i><br><ol><li>Friday</li></ol>
virchen	<i>noun</i><br><ol><li>virgin</li></ol>
vivir	<i>verb</i><br><ol><li>to live</li></ol>
volandrina	<i>noun</i><br><ol><li>bird (bird)</li></ol>
volar|volemos|volabaz|volarían|volarez|volando|volarías|voloron|volaba|volaría|volabas|volés|volaríanos|volada|volasez|volo|volaríaz|volabe|volen|voles|volarán|volatos|voladas|vole|volabanos|volasen|volará|volau|volaré|volarás|volase|volato|volaremos|vola|volasenos|volata|volaz|volaban|volamos|volé|volas|volan|voló|volases|volón|volez|volaus|volatas	<i>verb</i><br><ol><li>to fly</li></ol>
voler	<i>verb</i><br><ol><li>to want</li></ol>
voz	<i>noun</i><br><ol><li>voice</li></ol>
vuedo	<i>adj</i><br><ol><li>empty</li></ol>
vueitre	<i>noun</i><br><ol><li>vulture</li></ol>
xadrez	<i>noun</i><br><ol><li>chess</li></ol>
xordo	<i>adj</i><br><ol><li>deaf</li></ol>
y	<i>conj</i><br><ol><li>and</li></ol>
yayo|yayos	<i>noun</i><br><ol><li>grandpa</li></ol>
yegua|yeguas	<i>noun</i><br><ol><li>mare</li></ol>
yerba	<i>noun</i><br><ol><li>grass</li></ol>
yeugua	<i>noun</i><br><ol><li>mare</li></ol>
yo	<i>pron</i><br><ol><li>I (first-person singular pronoun)</li></ol>
zago	<i>noun</i><br><ol><li>intestine</li></ol>
zapato|zapatos	<i>noun</i><br><ol><li>shoe</li></ol>
zapo	<i>noun</i><br><ol><li>toad</li></ol>
zarpa	<i>noun</i><br><ol><li>claw</li></ol>
zarrar|zarraz|zarratos|zarrabaz|zarrarán|zarras|zarraus|zarraría|zarrarás|zarrez|zarran|zarre|zarrando|zarrase|zarraré|zarraríanos|zarrasen|zarrés|zarroron|zarramos|zarrata|zarré|zarrarías|zarres|zarra|zarrasez|zarrau|zarrarez|zarrada|zarratas|zarrabas|zarradas|zarrases|zarrabanos|zarrasenos|zarrabe|zarraremos|zarrón|zarrará|zarren|zarraba|zarró|zarro|zarraríaz|zarrarían|zarremos|zarraban|zarrato	<i>verb</i><br><ol><li>to close</li></ol>
zelebrar	<i>verb</i><br><ol><li>(transitive) to celebrate</li></ol>
zelebro|zelebros	<i>noun</i><br><ol><li>brain</li></ol>
zella	<i>noun</i><br><ol><li>(anatomy) eyebrow</li></ol>
zenisa|zenisas	<i>noun</i><br><ol><li>ash</li></ol>
zenzia|zenzias	<i>noun</i><br><ol><li>science</li></ol>
zepillar	<i>verb</i><br><ol><li>(transitive) to brush</li></ol>
zepillo|zepillos	<i>noun</i><br><ol><li>brush</li></ol>
zernillón|zernillons	<i>noun</i><br><ol><li>the ridge of a roof</li></ol>
zibada|zibadas	<i>noun</i><br><ol><li>barley</li></ol>
zicala|zicalas	<i>noun</i><br><ol><li>cicada</li></ol>
ziego|ziegas|ziega|ziegos	<i>adj</i><br><ol><li>blind</li></ol><br><i>noun</i><br><ol><li>a blind person</li></ol>
ziel|ziels	<i>noun</i><br><ol><li>sky</li></ol>
zimenterio|zimenterios	<i>noun</i><br><ol><li>grave</li></ol>
zinco	<i>num</i><br><ol><li>five</li></ol>
zirco|zircos	<i>noun</i><br><ol><li>circus</li></ol>
ziresa|ziresas	<i>noun</i><br><ol><li>cherry</li></ol>
ziresera|zireseras	<i>noun</i><br><ol><li>cherry-tree</li></ol>
zirgüellera|zirgüelleras	<i>noun</i><br><ol><li>plum-tree</li></ol>
zirgüello|zirgüellos	<i>noun</i><br><ol><li>plum</li></ol>
ziudat	<i>noun</i><br><ol><li>city, town</li></ol>
ziudá|ziudaz	<i>noun</i><br><ol><li>city</li></ol>
zorz	<i>noun</i><br><ol><li>(regional) mouse, murine</li></ol>
zrujano|zrujanos	<i>noun</i><br><ol><li>surgeon</li></ol>
zucre	<i>noun</i><br><ol><li>sugar</li></ol>
zucrería|zucrerías	<i>noun</i><br><ol><li>pastry-shop</li></ol>
ánchel|ánchels	<i>noun</i><br><ol><li>angel</li></ol>
él	<i>pron</i><br><ol><li>he (third-person singular masculine pronoun)</li></ol>
