׃	<i>punct</i><br><ol><li>Used to signify the end of a passage, such as a verse from Scripture.</li></ol>
אב|ʾāḇ|אָב	<i>name</i><br><ol><li>August</li></ol>
אבא|אַבְנַיָּא|אבנא|אַבְנָא|אֲבוּ|ʾabbā|אֲבָהָתָא|אַבָּא|אִמָּא|ʾaḇnā|אבא	<i>noun</i><br><ol><li>father, ancestor, progenitor</li><li>teacher</li><li>chief, leader</li><li>author, originator</li><li>thicket, woods, grove</li><li>produce, fruit, vegetable</li></ol>
אבאבית	<i>noun</i><br><ol><li>swelling, heaviness</li><li>disorder of the stomach, vomiting (spasms)</li></ol>
אבאשותא	<i>noun</i><br><ol><li>offense, displeasure</li></ol>
אבב|aḇaḇ|אֲבַב	<i>verb</i><br><ol><li>(intransitive) to grow, to ripen</li></ol>
אבגניסטטי|אֶבְגְּנִיסְטָטֵי'	<i>noun</i><br><ol><li>most noble</li></ol>
אבד|avad|אֲבַד	<i>verb</i><br><ol><li>be lost, disappear</li><li>to perish, die</li><li>destroy</li><li>destroy.</li><li>(intransitive), be lost, go to ruin.</li></ol>
אבדא	<i>noun</i><br><ol><li>disappearance</li><li>destruction, ruin</li></ol>
אבדלתא	<i>noun</i><br><ol><li>distinguishing, separation</li><li>Havdalah, a formula of prayer for the exit of the Sabbath or holy days</li></ol>
אבדנא	<i>noun</i><br><ol><li>ruin, destruction</li><li>perdition</li><li>loss</li></ol>
אבה|אָבָה|אָבֵי	<i>verb</i><br><ol><li>to be willing</li></ol>
אבהתא|אמהתא|אֲבוּ|ʾabbā|אֲבָהָתָא|אַבָּא|אִמָּא|אבא	<i>noun</i><br><ol><li>fathers</li></ol>
אבוב|אַבּוּב|אַבּוּבָא	<i>noun</i><br><ol><li>reed, flute</li><li>pipe, tube</li></ol>
אבובא|אבובתא	<i>noun</i><br><ol><li>reed, flute</li><li>pipe, tube</li><li>channel, canal</li></ol>
אבולא|ʾibbûlā|אִבּוּלֵי|אִבּוּלָא	<i>noun</i><br><ol><li>wagon-gate, city gateway</li><li>a fortified place where people like judges sit</li></ol>
אבולאי|ʾibbûlāʾê|אִבּוּלָאֵי	<i>noun</i><br><ol><li>city-gate guards, police</li></ol>
אבורגנא|אַבּוּרְגְּנָא|אַבְּרוּגְנֵי|אַבְּרוּגְנָא|pl.: אַבּוּרְגְּנֵי	<i>noun</i><br><ol><li>bed-cover, ticking (involucrum)</li></ol>
אבזרא|אַבְזָרָא|אֲבִזְרֵי|ʾaḇizrā|אֲבִיזְרֵי|אבזרי|אֲבִיזְרָא|אֲבִזְרֵי'|אֲבִזְרָא|ʾaḇzārā	<i>noun</i><br><ol><li>instrument, appurtenance</li><li>anything used for seasoning; spices, etc.</li></ol>
אבזרי|אֲבִזְרֵי'|אֲבִיזְרֵי	<i>noun</i><br><ol><li>requisites; appurtenances</li></ol>
אבטא	<i>noun</i><br><ol><li>belly; whence</li><li>leather wine-bag</li></ol>
אבטומטוס	<i>adj</i><br><ol><li>self-moving, self-growing, spontaneous</li></ol>
אבטוניות	<i>noun</i><br><ol><li>Cities enjoying their own laws; jurisdictions.</li></ol>
אבטיונא	<i>noun</i><br><ol><li>Commissary, quartermaster in the Roman army.</li></ol>
אבטיחא|אבטיחיא	<i>noun</i><br><ol><li>watermelon</li></ol>
אביבא|אביב	<i>noun</i><br><ol><li>early stage of ripening, especially of grains</li><li>season of beginning barley-crop</li><li>also, the offering of the first fruits (בכורים) (on Passover)</li></ol>
אבידא	<i>adj</i><br><ol><li>lost</li><li>perished, destroyed</li></ol>
אבידתא|אבידא	<i>adj</i><br><ol><li>lost</li><li>perished, destroyed</li></ol>
אבל	<i>verb</i><br><ol><li>to mourn, to lament</li></ol>
אבלא	<i>noun</i><br><ol><li>grief, sadness, sorrow</li><li>mourning, lamentation</li></ol>
אבנא|אַבְנַיָּא|אַבְנָא|ʾaḇnā	<i>noun</i><br><ol><li>rock, stone (material)</li></ol>
אבקא	<i>noun</i><br><ol><li>dust</li></ol>
אברא|אברא	<i>noun</i><br><ol><li>lead</li><li>feather</li></ol>
אברהם	<i>name</i><br><ol><li>(biblical) Abraham</li></ol>
אגוגא	<i>noun</i><br><ol><li>watercourse (aqueduct, canal, waterfall, etc.)</li><li>cleft, fissure</li></ol>
אגונא	<i>noun</i><br><ol><li>assembly, crowd</li><li>contest, competition</li><li>trial, test</li><li>struggle</li></ol>
אגטרגטא|אַגְטְרַגְטָא|agt'ragta|אַגְטְרַגְטַיָּיא	<i>noun</i><br><ol><li>cataract, cascade</li></ol>
אגנא	<i>noun</i><br><ol><li>basin, crater</li><li>jug, pitcher</li><li>bowl</li><li>(anatomy) pelvis</li></ol>
אגרא|אגרא	<i>noun</i><br><ol><li>roof, rooftop</li><li>pay, wage, hire</li><li>fee, fare</li><li>reward</li></ol>
אגרתא	<i>noun</i><br><ol><li>letter, epistle</li></ol>
אדהכי והכי	<i>adv</i><br><ol><li>meanwhile</li></ol>
אדכר|אַדְכֵּר	<i>verb</i><br><ol><li>to remind</li></ol>
אדם|adám	<i>name</i><br><ol><li>(biblical) Adam.</li></ol>
אדמתא|אַדְמְתָא|אֲדָמַת|אַדְמָת|אֲדָמָה|אַדְמָתָא|אַדְמָן	<i>noun</i><br><ol><li>earth, soil, dust</li></ol>
אדנא|אדנהתא|אדנתא	<i>noun</i><br><ol><li>(anatomy) ear</li></ol>
אדר|ɑdɑr	<i>name</i><br><ol><li>March: the month of March.</li></ol>
אדרבא|ʾaddərabbā|אַדְּרַבָּא	<i>adv</i><br><ol><li>(Jewish Babylonian Aramaic) on the contrary</li></ol>
אהרון	<i>name</i><br><ol><li>(biblical) Aaron.</li></ol>
או	<i>conj</i><br><ol><li>or, either</li></ol><br><i>intj</i><br><ol><li>woe, alas, O</li></ol>
אוגיניס|אֶוְגִּינֵיס|אֶוְגִּינֵס|אֶבְגִּינוֹס|אֶװְגִּינוֹס	<i>adj</i><br><ol><li>of noble descent</li></ol>
אווזא	<i>noun</i><br><ol><li>(Jewish Babylonian Aramaic, Mandaic) goose</li></ol>
אוחדנא	<i>noun</i><br><ol><li>possession</li><li>dominion, province</li></ol>
אוכלא	<i>noun</i><br><ol><li>food</li></ol>
אוכמא	<i>adj</i><br><ol><li>black</li></ol>
אוכמתא|אוכמא	<i>adj</i><br><ol><li>black</li></ol>
אולי	<i>name</i><br><ol><li>Ulai</li></ol>
אולצנא	<i>noun</i><br><ol><li>calamity</li><li>suffering, oppression</li></ol>
אומתא|אמותא|אומותא|ʾumməṯā	<i>noun</i><br><ol><li>nation, people</li></ol>
אונגליון|אונגליא	<i>noun</i><br><ol><li>gospel</li></ol>
אוצרא	<i>noun</i><br><ol><li>treasury, storehouse</li><li>barn, granary</li></ol>
אוקינוס|אוקינו	<i>noun</i><br><ol><li>ocean</li></ol>
אורגנון|אורגנא	<i>noun</i><br><ol><li>instrument, tool</li><li>vessel</li><li>(anatomy) organ</li></ol>
אורדעא	<i>noun</i><br><ol><li>frog</li></ol>
אורהי	<i>name</i><br><ol><li>Edessa</li></ol>
אורחא|אורחתא	<i>noun</i><br><ol><li>road, way, path</li></ol>
אוריא|אורותא	<i>noun</i><br><ol><li>stall (compartment in stable)</li><li>crib, manger, cradle</li></ol>
אוריתא|ʾōrayṯā|אוֹרַיְתָא	<i>name</i><br><ol><li>Torah</li></ol>
אורכא	<i>noun</i><br><ol><li>length</li></ol>
אורשלם|’ūrišlem	<i>name</i><br><ol><li>Jerusalem</li></ol>
אזדרע|izdəraʿ|izdaraʿ|אִזְדַּרַע|אִזְדְּרַע	<i>verb</i><br><ol><li>to be sown, seeded</li></ol>
אזל|אֲזַל|ʾăzal|יֵאזֵל	<i>verb</i><br><ol><li>to go, depart</li></ol>
אזרע|ʾazraʿ|אַזְרַע	<i>verb</i><br><ol><li>to emit semen, to ejaculate</li></ol>
אחא|אַחַיָּא|אֲחָא|ʾăḥā	<i>noun</i><br><ol><li>brother</li></ol>
אחד	<i>verb</i><br><ol><li>to hold, take, seize</li><li>to shut, close</li></ol>
אחר	<i>verb</i><br><ol><li>to be late, to delay</li></ol>
אחריא	<i>adj</i><br><ol><li>last, final</li></ol>
אחריתא|אחריא	<i>adj</i><br><ol><li>last, final</li></ol>
אחרנא	<i>adj</i><br><ol><li>other, another</li></ol>
אחרתא|אחרנא|אחרניתא	<i>adj</i><br><ol><li>other, another</li></ol>
אידא|אינא|ʾīḏā|אידיא|אילין	<i>pron</i><br><ol><li>which</li></ol>
איהו|איהי|אינהו|ʾīhū|אינהי	<i>pron</i><br><ol><li>(Jewish Babylonian Aramaic) he</li></ol>
איהי	<i>pron</i><br><ol><li>she</li></ol>
איך	<i>conj</i><br><ol><li>like, as, similar to</li></ol>
איכא|אִיכָּא|ʾīkkā	<i>adv</i><br><ol><li>where</li></ol><br><i>conj</i><br><ol><li>where</li></ol><br><i>particle</i><br><ol><li>(Jewish Palestinian Aramaic, Jewish Babylonian Aramaic) there is, there are</li></ol>
איכנא	<i>pron</i><br><ol><li>how, as, similar to</li><li>for example</li></ol>
איל	<i>name</i><br><ol><li>God, the single god of monotheism.</li></ol>
אילא|אַיְלָא|אַיְלֵא|ʾaylā|אַיְלְתָא	<i>noun</i><br><ol><li>stag, hart (male deer)</li></ol>
אילול	<i>name</i><br><ol><li>September</li></ol>
אילין|אידא|אינא	<i>pron</i><br><ol><li>which</li></ol>
אילנא|אִילָנָא|אִילָנַיָּא|ʾīlānā|אִילָנֵי|אִילַן|אִילָנִין	<i>noun</i><br><ol><li>tree</li></ol>
אילתא|אַיְלָא|ʾayəlṯā|אַיְלְתֵא|אַיְלְתָא	<i>noun</i><br><ol><li>hind (female deer)</li></ol>
אין|אֵין|ʾēn	<i>adv</i><br><ol><li>yes</li></ol>
אינא|אידא|אילין	<i>pron</i><br><ol><li>which</li></ol>
אינהו	<i>pron</i><br><ol><li>they</li></ol>
אינון	<i>pron</i><br><ol><li>they</li></ol>
איקרא	<i>noun</i><br><ol><li>honour/honor, glory</li></ol>
איר	<i>name</i><br><ol><li>May</li></ol>
אירג	<i>name</i><br><ol><li>Iraq, the southern end of Mesopotamia</li></ol>
אית|אִית|ʾīṯ	<i>prep</i><br><ol><li>there is, there are</li><li>(with ל־ (lə-)) to have</li></ol>
איתותא	<i>noun</i><br><ol><li>essence, substance</li></ol>
איתתא|נְשַיָּא|ʾittǝṯā|נְשַיָא|אִיתְּתָא|אִתַּת|אִתָּא|נְשִין|נְשֵי	<i>noun</i><br><ol><li>woman</li><li>wife</li></ol>
אכדנא	<i>noun</i><br><ol><li>viper</li></ol>
אכחדא	<i>adv</i><br><ol><li>together</li></ol>
אכילא	<i>adj</i><br><ol><li>eaten, consumed</li></ol>
אכילתא|אכילא	<i>adj</i><br><ol><li>eaten, consumed</li></ol>
אכל	<i>verb</i><br><ol><li>to eat, to consume</li></ol>
אכלוס|אכלו	<i>noun</i><br><ol><li>crowd, multitude, mob</li><li>people, populace</li></ol>
אכסניא|אכסניתא	<i>adj</i><br><ol><li>strange, unusual</li></ol><br><i>noun</i><br><ol><li>stranger, foreigner</li><li>guest, visitor, lodger</li><li>exile, banishment</li><li>hospitality, lodging</li></ol>
אכסניתא|אכסניא	<i>adj</i><br><ol><li>strange, unusual</li></ol><br><i>noun</i><br><ol><li>stranger, foreigner</li><li>guest, visitor, lodger</li></ol>
אכר	<i>verb</i><br><ol><li>to plow, to dig</li><li>to cultivate</li></ol>
אכרא|אִכָּרֵא|ʾikkārā|אִכָּרָא	<i>noun</i><br><ol><li>farmer, tiller</li></ol>
אלא|ʾellā|אֶלָּא	<i>conj</i><br><ol><li>but</li></ol>
אלהא|ʾĕlāha|אֱלָהָא|אֱלָהַיָּא	<i>noun</i><br><ol><li>god, deity</li><li>God</li></ol>
אלול|elul	<i>noun</i><br><ol><li>August or September</li><li>Elul</li></ol>
אלין	<i>adj</i><br><ol><li>these</li><li>those</li></ol><br><i>verb</i><br><ol><li>accommodate</li><li>lodge</li></ol>
אלעא|el‘ā	<i>noun</i><br><ol><li>(anatomy) rib</li></ol>
אלפא|אלפיא	<i>noun</i><br><ol><li>ship, boat, galley</li><li>Greek letter Α</li></ol><br><i>num</i><br><ol><li>thousand</li></ol>
אלץ	<i>verb</i><br><ol><li>to oppress, to force</li><li>to constrain, to compress</li></ol>
אמא|אמהתא|אֲבוּ|ʾabbā|אֲבָהָתָא|אַבָּא|אִמָּא|אבא	<i>noun</i><br><ol><li>mother</li></ol>
אמורא|אֲמוֹרָא|אמוראים|amora	<i>noun</i><br><ol><li>speaker</li><li>(historical, Judaism) One of the Amoraim, sages of the Gemara.</li></ol>
אמין|ʾamīyn|אַמִין|אמינין	<i>adv</i><br><ol><li>amen, truly</li></ol><br><i>intj</i><br><ol><li>amen, so be it</li></ol><br><i>noun</i><br><ol><li>amen</li></ol><br><i>adj</i><br><ol><li>constant</li><li>reliable, dependable</li><li>trustworthy, believable</li><li>authentic, credible</li><li>eternal</li></ol>
אמינא	<i>adj</i><br><ol><li>constant</li><li>reliable, dependable</li><li>trustworthy, believable</li><li>authentic, credible</li><li>eternal</li></ol>
אמינתא|אמינא	<i>adj</i><br><ol><li>constant</li><li>reliable, dependable</li><li>trustworthy, believable</li><li>authentic, credible</li><li>eternal</li></ol>
אמירא	<i>noun</i><br><ol><li>commander</li><li>prince, emir</li></ol>
אמר|אֲמַר|ʾamar	<i>verb</i><br><ol><li>to say, to pronounce</li><li>to command</li></ol>
אמרא	<i>noun</i><br><ol><li>lamb</li></ol><br><i>name</i><br><ol><li>(astrology) Aries</li></ol>
אמרכלא|אֲמַרְכְּלָא|ʾămarkəlā	<i>noun</i><br><ol><li>(Judeo-Aramaic) administrator of finances</li></ol>
אמתלא	<i>noun</i><br><ol><li>excuse</li></ol>
אן	<i>conj</i><br><ol><li>if</li></ol>
אנא|אֲנָן|אֲנָא|ʾănā|אֲנַחְנָא	<i>pron</i><br><ol><li>I</li></ol>
אנחנא|אֲנָא|ʾănáḥnā|אֲנַחְנָא	<i>pron</i><br><ol><li>we</li></ol>
אנכא	<i>noun</i><br><ol><li>tin</li><li>lead</li></ol>
אנן|ʾănān|אֲנָן|אֲנָא	<i>pron</i><br><ol><li>we</li></ol>
אנשא|אֵינָשׁ|אֵינָשָׁא|אֵינָשִׁין|אֵינָשֵׁי|אֵינָשַׁיָּא|אֱינָשׁ	<i>noun</i><br><ol><li>human, man</li></ol>
אנשיא	<i>adj</i><br><ol><li>human</li></ol>
אנשיתא|אנשיא	<i>adj</i><br><ol><li>human</li></ol>
אנת|ʾattā|אַנְתּוּן|אַנְתְּ|ʾantā|אַתֵּין|אַתּוּן|את|אַנְתִּי|ʾant|אַתִּי|אַתְּ|אתה|ʾatt|אַנְתֵּין|אנתה|אַתָּה|אַנְתָּה	<i>pron</i><br><ol><li>you, thou</li></ol>
אנתתא|אִנְתְּתָא|נְשַׁיָּא|גַּבְרָא|ʾintəṯā	<i>noun</i><br><ol><li>woman</li><li>wife</li></ol>
אסא|אָסָא|אֲסׇא|ʾāsā|ʾăsā	<i>name</i><br><ol><li>(biblical) Asa</li></ol><br><i>verb</i><br><ol><li>to heal, to cure</li><li>to restore, to repair</li></ol><br><i>noun</i><br><ol><li>myrtle</li></ol>
אסורא	<i>noun</i><br><ol><li>bond, chain, fetter</li><li>bondage, imprisonment</li><li>obligation</li><li>oath</li></ol>
אסטוא	<i>noun</i><br><ol><li>portico</li></ol>
אסטומכא	<i>noun</i><br><ol><li>(anatomy) stomach</li></ol>
אסטרטיוטא	<i>noun</i><br><ol><li>soldier</li></ol>
אסיא|אָסְוָותׇא|אָסִיתָּא|אָסְיָא|אָסְוָתׇא|ʾasiyā|ʾāsyā	<i>noun</i><br><ol><li>physician, medical doctor</li></ol><br><i>name</i><br><ol><li>Asia</li><li>Asia Minor</li></ol>
אסיתא|אָסְיׇתָּא|אָסִיתָּא|ʾāsītā|אָסְיָא	<i>noun</i><br><ol><li>physician, midwife</li></ol>
אסכולא	<i>noun</i><br><ol><li>school</li><li>knowledge, teaching</li></ol>
אסכימא	<i>noun</i><br><ol><li>form, figure, shape</li><li>appearance</li><li>attire, dress, garb</li><li>manner, character</li></ol>
אסכמא	<i>noun</i><br><ol><li>form, figure, shape</li><li>appearance</li><li>attire, dress, garb</li><li>manner, character</li></ol>
אספוגא	<i>noun</i><br><ol><li>sponge</li></ol>
אספקלריא|אִסְפַּקְלַרְיוֹת|ispaqlarya|אִסְפַּקְלַרְיָא|אִסְפַּקְלַרְיָאוֹת	<i>noun</i><br><ol><li>speculum; lens; mirror</li><li>glass</li><li>windowpane</li><li>(Jewish mysticism) prophetic vision</li></ol>
אסר	<i>verb</i><br><ol><li>to bind, to tie</li><li>to join</li></ol>
אעא|אָעִין|אָעָא|אָעַיָּא|אָע|אָעֵי|ʾāʿā	<i>noun</i><br><ol><li>wood</li><li>piece of wood, log</li></ol>
אף|af	<i>adv</i><br><ol><li>and, also, as well, too, truly, indeed, yea, with</li></ol>
אפא	<i>noun</i><br><ol><li>face, countenance</li><li>(anatomy) nostrils</li></ol>
אפדנא|אַפַּדְנֵי|אַפַּדְנָא	<i>noun</i><br><ol><li>palace, citadel</li></ol>
אפיסקופא	<i>noun</i><br><ol><li>bishop</li></ol>
אצבעא|ʾeṣbəʿā|אֶצְבְּעָתָא|אֶצְבְּעָא	<i>noun</i><br><ol><li>finger</li></ol>
אצר	<i>verb</i><br><ol><li>to store, to stockpile</li></ol>
ארביסר	<i>num</i><br><ol><li>fourteen</li></ol>
ארבע	<i>num</i><br><ol><li>four (4)</li></ol>
ארבעא|ʾarbəʿā	<i>num</i><br><ol><li>four (4)</li></ol>
ארבעין	<i>num</i><br><ol><li>forty (40)</li></ol>
ארבעמאא	<i>num</i><br><ol><li>four hundred</li></ol>
ארבעסר	<i>num</i><br><ol><li>fourteen (14)</li></ol>
ארבעסרא	<i>num</i><br><ol><li>fourteen (14)</li></ol>
ארדכלא	<i>noun</i><br><ol><li>architect</li></ol>
ארזא	<i>noun</i><br><ol><li>cedar</li><li>pine</li></ol>
ארזפתא	<i>noun</i><br><ol><li>hammer, mallet</li></ol>
ארח	<i>verb</i><br><ol><li>to leave, to depart</li></ol>
אריא|arya|אריותא	<i>noun</i><br><ol><li>lion</li></ol><br><i>name</i><br><ol><li>(astrology) Leo</li></ol>
אריותא|arya|אריותא|אריא	<i>noun</i><br><ol><li>lioness (female lion)</li><li>lions, lionesses</li></ol>
אריכא|אריכין	<i>adj</i><br><ol><li>long</li></ol>
אריכתא|אריכין|אריכא	<i>adj</i><br><ol><li>long</li></ol>
אריסא|ʾărīšā|ʾărīsā|אֲרִיסַיָּא|אֲרִישַׁיָּא|אֲרִיסָא|ארישא|אֲרִישָׁא	<i>noun</i><br><ol><li>tenant farmer</li></ol>
ארך|ʾeréḥ	<i>verb</i><br><ol><li>to be long, to lengthen</li><li>to be tall</li></ol>
ארם|aram	<i>name</i><br><ol><li>(biblical) Aram</li><li>Aramaea/Aramea, Syria</li></ol>
ארמיא|אֲרַמָּיָא|ʾărammāyā|ʾārāmāyā|אָרָמָיָא	<i>noun</i><br><ol><li>Aramean</li><li>gentile</li></ol>
ארנבא	<i>noun</i><br><ol><li>rabbit</li></ol>
ארנון	<i>name</i><br><ol><li>Arnon river</li></ol>
ארעא|אַרְעָתָא|אַרְעָן|ʾarʿā|אַרַע|אַרְעָא|אַרְעָת	<i>noun</i><br><ol><li>land, soil, earth</li><li>land, ground</li><li>land, country</li></ol>
ארש	<i>verb</i><br><ol><li>to hammer, to beat</li></ol>
אשד	<i>verb</i><br><ol><li>to pour</li></ol>
אשור|ˀăšūr|אֲשׁוּר	<i>noun</i><br><ol><li>Assyria</li><li>Ashur</li></ol>
אשכתא	<i>noun</i><br><ol><li>(anatomy) testicle</li></ol>
אשתא|ʼešāṯāʼ|אשתותא|אשיתא	<i>noun</i><br><ol><li>fever, fire</li><li>bottom, foundation</li><li>(anatomy) buttock</li></ol>
אשתי|šəṯā|אִשְׁתִּי|שְׁתָא|שתא|ʾištī	<i>verb</i><br><ol><li>to drink</li></ol>
אשתריף|אִשְׂתָּרֵיף	<i>verb</i><br><ol><li>(intransitive) burn, be burned</li></ol>
אתא|אֲתָא|ʾaṯā|ʾāṯā|אתותא	<i>noun</i><br><ol><li>sign, banner, flag</li></ol><br><i>verb</i><br><ol><li>to come, to arrive</li><li>to bring</li></ol>
אתמלי	<i>adv</i><br><ol><li>yesterday</li></ol>
אתנא|חֲמָרָא|ʾăṯānā|אַתָּנָא|אֲתָנָא|ʾattānā	<i>noun</i><br><ol><li>female donkey, ass</li></ol>
אתרא|אתרותא|אַתְרָא	<i>noun</i><br><ol><li>country</li><li>region, province</li><li>place</li></ol>
ב|beth	<i>character</i><br><ol><li>The second letter of the Aramaic alphabet.</li><li>The numeral 2 in Aramaic numbering.</li></ol>
ב־	<i>prep</i><br><ol><li>in</li><li>at</li><li>with</li></ol>
בארא|בֵּארָא|bērā|bəʾērā|בְּאֵרָא	<i>noun</i><br><ol><li>well, pit</li></ol>
באש	<i>verb</i><br><ol><li>to do evil</li></ol>
בבא|bāḇā|בָּבַיָּא|בָּבָא	<i>noun</i><br><ol><li>gate, door, entrance</li><li>section, clause</li><li>chapter</li></ol>
בבל|bāḇel	<i>name</i><br><ol><li>Babylon</li></ol>
בבתא	<i>noun</i><br><ol><li>(anatomy) pupil (of the eye)</li></ol>
בדל	<i>verb</i><br><ol><li>to distinguish, to separate</li></ol>
בדר	<i>verb</i><br><ol><li>to scatter, to disperse</li></ol>
בהמות	<i>noun</i><br><ol><li>behemoth</li></ol>
בוצלא|בּוּצְלַיָּא|בּוּצְלָא	<i>noun</i><br><ol><li>onion</li></ol>
בזא|בזא	<i>noun</i><br><ol><li>(anatomy) nipple, teat</li><li>hawk, falcon</li></ol>
בזז	<i>verb</i><br><ol><li>to plunder, to despoil</li></ol>
בטל|bəṭal|baṭṭēl|בְּטַל|בַּטֵּל	<i>verb</i><br><ol><li>(intransitive) to cease</li><li>(intransitive) to be invalid</li><li>(transitive) to make cease, stop, cancel</li></ol>
בטלתא	<i>noun</i><br><ol><li>idleness, vanity</li></ol>
בטן	<i>verb</i><br><ol><li>to conceive, to bear children</li></ol>
בטנא	<i>noun</i><br><ol><li>pregnancy, conception</li></ol>
ביא	<i>verb</i><br><ol><li>to comfort, to console</li></ol>
בינת	<i>prep</i><br><ol><li>between, among</li></ol>
ביעתא|ביעא	<i>noun</i><br><ol><li>egg</li></ol>
בישא	<i>adj</i><br><ol><li>wrong, evil</li></ol>
בישתא|בישא	<i>noun</i><br><ol><li>evil, wickedness</li></ol><br><i>adj</i><br><ol><li>wrong, evil</li></ol>
בית|bēṯ|בֵּית	<i>name</i><br><ol><li>beth, the second letter of the Aramaic alphabet.</li></ol>
בית אסירא|בתי אסירא	<i>noun</i><br><ol><li>prison</li></ol>
בית ארכא|בתי ארכא	<i>noun</i><br><ol><li>archive, library</li></ol>
ביתא|בַּי|בַּיְתָא|bayṯā|בֵּית|בָּתַּיָּא	<i>noun</i><br><ol><li>house, home</li></ol>
בכא	<i>verb</i><br><ol><li>to weep, to mourn</li></ol>
בכת	<i>verb</i><br><ol><li>to weave, to spin</li></ol>
בלא	<i>verb</i><br><ol><li>to be worn out, to grow old</li></ol>
בלוטא	<i>noun</i><br><ol><li>acorn</li><li>oak</li></ol>
בליא	<i>adj</i><br><ol><li>worn out, old</li></ol>
בליעא	<i>adj</i><br><ol><li>swallowed</li></ol>
בליעתא|בליעא	<i>adj</i><br><ol><li>swallowed</li></ol>
בליתא|בליא	<i>adj</i><br><ol><li>worn out, old</li></ol>
בלל	<i>verb</i><br><ol><li>to confuse, to confound</li><li>to mix</li></ol>
בלע|bəlaˁ|בְּלַע	<i>verb</i><br><ol><li>to swallow</li></ol>
בלעא	<i>noun</i><br><ol><li>swallowing</li><li>(phonology) assimilation</li></ol>
בנא	<i>verb</i><br><ol><li>to build, to construct, to erect</li><li>to found</li></ol>
בניא|בנתא|בְּרַת|בְּנֵי|בְּנָתָא|b'rā|בְּנַיָּא|bratā|בַּר|ברתא|בניא|בְּנִין|בַּרְתָּא|bartā|בְּרָא|בְּרַתָּא|בְּנָת|בְּנָן|ברא	<i>noun</i><br><ol><li>builder, founder</li><li>sons</li></ol>
בנתא|בְּרַת|בְּנָתָא|bratā|בניא|ברתא|בַּרְתָּא|bartā|בְּרָא|בְּרַתָּא|בְּנָת|בְּנָן	<i>noun</i><br><ol><li>daughters</li></ol>
בסימא	<i>adj</i><br><ol><li>pleasant</li></ol>
בסימותא	<i>noun</i><br><ol><li>pleasantness</li></ol>
בסימתא|בסימא	<i>adj</i><br><ol><li>pleasant</li></ol>
בסם	<i>verb</i><br><ol><li>to be sweet, to be pleasing</li><li>to rejoice, to be joyful</li></ol>
בסמא|בסמונא|בסמנא|בסמא	<i>noun</i><br><ol><li>pleasure, delight, luxury</li><li>feast, banquet</li><li>incense</li><li>perfume, fragrance</li><li>ointment, unguent</li><li>perfumer</li></ol>
בסרא|בִּסְרָא|bisrā	<i>noun</i><br><ol><li>flesh</li><li>human</li></ol>
בעא	<i>verb</i><br><ol><li>to ask, to beg</li><li>to need, to require</li><li>to inquire, to question</li><li>to seek</li></ol>
בעט	<i>verb</i><br><ol><li>to kick</li></ol>
בעירא	<i>noun</i><br><ol><li>domesticated animals, beasts of burden</li></ol>
בעלא|baʿlā	<i>noun</i><br><ol><li>lord, master</li><li>head of household</li><li>husband</li></ol>
בעלדבבא	<i>noun</i><br><ol><li>enemy</li></ol>
בער	<i>verb</i><br><ol><li>(intransitive) burn</li></ol>
בצא	<i>verb</i><br><ol><li>to search, to examine</li></ol>
בצירא	<i>adj</i><br><ol><li>less</li></ol>
בצירתא|בצירא	<i>adj</i><br><ol><li>less</li></ol>
בצלא|בָּצְלַיָּא|בָּצְלָא	<i>noun</i><br><ol><li>onion</li></ol>
בצר	<i>verb</i><br><ol><li>to decrease, to diminish, to lessen</li><li>to lack, to be inferior</li></ol>
בקא|bqā|bāqā|בְּקָא|בָּקֵּא|בָּקָּא	<i>noun</i><br><ol><li>gnat</li></ol><br><i>verb</i><br><ol><li>to examine, to consider, to investigate</li></ol>
בקר	<i>verb</i><br><ol><li>to bore</li><li>to seek</li><li>to ask, to inquire</li></ol>
בקרא|בקרא	<i>noun</i><br><ol><li>drove, herd of animals</li><li>herdsman, cowherd</li></ol>
בר|bar|בַּר	<i>prep</i><br><ol><li>outside, except</li></ol>
בר אווזא	<i>noun</i><br><ol><li>(Jewish Babylonian Aramaic) duck</li></ol>
ברא|בְּנֵי|b'rā|בַּר|בְּנַיָּא|בְּנִין|בַּרְתָּא|בְּרָא	<i>noun</i><br><ol><li>son, child</li></ol><br><i>verb</i><br><ol><li>to create</li></ol>
ברדא|barḏā|בַּרְדָא	<i>noun</i><br><ol><li>hail</li></ol>
ברונא|בנונא|bərōnā	<i>noun</i><br><ol><li>little son</li></ol>
ברותא|בְּרֹותָא|bərōṯā|בְּרֹותֵא|בְּרָתֵא|ברתא|בְּרָתָא|bərāṯā	<i>noun</i><br><ol><li>cypress, juniper</li></ol>
בריך|Absolute|בְּרִיכִין|בְּרִיכָן|Determined|בְּרִיךְ|בְּרִיכָא|בְּרִיכַיָּא|בְּרִיכְתָּא|בְּרִיכָתָא|bərīḵ	<i>adj</i><br><ol><li>blessed</li></ol>
בריכא	<i>adj</i><br><ol><li>blessed</li></ol>
בריכתא|בריכא	<i>adj</i><br><ol><li>blessed</li></ol>
בריתא	<i>noun</i><br><ol><li>street, road</li></ol>
ברך|bəraḵ|בְּרַךְ|bārēḵ|בָּרֵךְ	<i>verb</i><br><ol><li>to kneel, to bow</li><li>to bless</li></ol>
ברכא|בִּרְכֵּי|בִּרְכָּא|בֶּרֶךְ|birkā|בִּרְכַּיָּא|בִּרְכִּין	<i>noun</i><br><ol><li>knee</li></ol>
ברכתא|בִּרְכָתָא|birkəṯā|בִּרְכְּתָא	<i>noun</i><br><ol><li>blessing</li></ol>
ברם	<i>conj</i><br><ol><li>but, however, nevertheless</li></ol>
ברק	<i>verb</i><br><ol><li>to gleam, to flash</li></ol>
ברקא|בַּרְקֵי|בַּרְקִין|בַּרְקָא|barqā|בְּרַק|בַּרְקַיָּא	<i>noun</i><br><ol><li>lightning</li></ol>
ברתא|בְּרַת|בְּרָתֵא|בְּנָתָא|bratā|בַּרְתָּא|bartā|בְּרָא|bərāṯā|בְּרַתָּא|בְּנָת|בְּרָתָא|בְּנָן	<i>noun</i><br><ol><li>daughter</li></ol>
בשילא	<i>adj</i><br><ol><li>cooked</li></ol>
בשילתא|בשילא	<i>adj</i><br><ol><li>cooked</li></ol>
בשל	<i>verb</i><br><ol><li>To cook.</li></ol>
בתולא|bəṯūltā|בְּתוּלָא|בְּתוּלְתָּא|בתולתא|בְּתוּלָתָא	<i>noun</i><br><ol><li>virgin</li></ol><br><i>name</i><br><ol><li>(astrology) Virgo</li></ol>
בתולותא	<i>noun</i><br><ol><li>virginity</li></ol>
בתולתא|bəṯūltā|בְּתוּלְתָּא|בְּתוּלָתָא|בְּתוּלָא	<i>noun</i><br><ol><li>virgin</li></ol>
בתל	<i>verb</i><br><ol><li>to ravish, to violate</li><li>to deflower</li></ol>
בתר	<i>conj</i><br><ol><li>after</li><li>post-</li></ol>
בתרכן	<i>adv</i><br><ol><li>afterwards, following</li></ol>
גבא|Gava	<i>verb</i><br><ol><li>to gather, to collect</li><li>to choose, to select, to elect</li></ol>
גביא	<i>noun</i><br><ol><li>exactor, tax collector</li></ol>
גבינא	<i>noun</i><br><ol><li>(anatomy) eyebrow</li></ol>
גברא|אִנְתְּתָא|גֻּבְרַיָּא|ʾintəṯā|נְשַׁיָּא|גּוּבְרַיָּא|גַּבְרָא|גֻּבְרִין|גְּבַר|גֻּבְרֵי|אנתתא|gaḇrā	<i>noun</i><br><ol><li>man, husband</li></ol>
גברותא	<i>noun</i><br><ol><li>power, force, vigour</li><li>prodigy</li></ol>
גבתא|גובנא	<i>noun</i><br><ol><li>cheese</li></ol>
גדיא|גְּדַיָּא|גַּדְיָא|גדיתא|gaḏyā	<i>noun</i><br><ol><li>kid (young goat)</li></ol><br><i>name</i><br><ol><li>Capricorn</li></ol>
גדל	<i>verb</i><br><ol><li>to twist</li><li>to weave</li></ol>
גדם	<i>verb</i><br><ol><li>to cut off</li><li>to abbreviate</li></ol>
גדף	<i>verb</i><br><ol><li>to blaspheme</li></ol>
גהנא	<i>noun</i><br><ol><li>hell</li></ol><br><i>name</i><br><ol><li>Gehenna, Hell</li></ol>
גו|gō|gaw	<i>prep</i><br><ol><li>in, inside, within</li></ol>
גוא	<i>noun</i><br><ol><li>(anatomy) belly, innards, viscera</li><li>community, congregation</li></ol>
גודא	<i>noun</i><br><ol><li>company, rank, choir</li></ol>
גוזא	<i>noun</i><br><ol><li>walnut</li><li>walnut tree</li></ol>
גוחכא	<i>noun</i><br><ol><li>laughter</li></ol>
גולתא|גולא	<i>noun</i><br><ol><li>cloak, cover</li></ol>
גופיה	<i>noun</i><br><ol><li>itself, himself</li></ol>
גושמא	<i>noun</i><br><ol><li>(anatomy) body</li></ol>
גזא|גזתא|גזא	<i>noun</i><br><ol><li>treasure, treasury</li><li>mowing, shearing</li><li>mower, shearer</li><li>wool, fleeces</li></ol><br><i>name</i><br><ol><li>Gaza</li></ol>
גזורתא	<i>noun</i><br><ol><li>circumcision</li></ol>
גזר	<i>verb</i><br><ol><li>to cut</li><li>to circumcise</li></ol>
גזרא|גזריא	<i>noun</i><br><ol><li>surgery</li><li>law, decree</li><li>piece</li><li>log, club</li><li>slit, incision</li><li>flock</li></ol>
גזתא|גזא	<i>noun</i><br><ol><li>wool, fleece</li></ol>
גחיכא	<i>adj</i><br><ol><li>laughable, ridiculous</li></ol>
גחיכתא|גחיכא	<i>adj</i><br><ol><li>laughable, ridiculous</li></ol>
גחך	<i>verb</i><br><ol><li>to laugh</li></ol>
גידא|גִּידָא|גִּידִין|גִּיד|גִּידַיָּא|גִּידֵי	<i>noun</i><br><ol><li>(anatomy) nerve, tendon, sinew</li></ol>
גיהנם|gīhinnām|גִּיהִנָּם	<i>name</i><br><ol><li>(Judaism) Gehinnom</li></ol>
גימטריא	<i>noun</i><br><ol><li>accounts</li><li>the use of letters for their numerical value; homiletic interpretation based on the numerical value of letters</li><li>learned writing, cifer</li></ol>
גינתא|גִּינְתָא|גִּינָּתָא|gīnəṯā	<i>noun</i><br><ol><li>garden</li></ol>
גיס	<i>noun</i><br><ol><li>to rob, to plunder</li></ol>
גיסא|גיסא	<i>noun</i><br><ol><li>foray, raid</li><li>robber, bandit, pirate</li></ol>
גיר	<i>conj</i><br><ol><li>for, since</li></ol>
גלד	<i>verb</i><br><ol><li>to freeze</li></ol>
גלדא	<i>noun</i><br><ol><li>(anatomy) skin, hide</li></ol>
גלותא|gālūṯā|גָּלוּתָא	<i>noun</i><br><ol><li>exile</li><li>captivity</li></ol>
גלידא|גְּלִידָא	<i>noun</i><br><ol><li>ice</li></ol>
גלל	<i>verb</i><br><ol><li>to roll</li><li>to surge, to swell</li></ol>
גמורתא|גומרא|gmurtā	<i>noun</i><br><ol><li>coal</li></ol>
גמלא|gamlā’|גְּמַל|גַּמְלִין|גַּמְלָא|גַּמְלַיָּא|גמלא|גַּמְלֵי	<i>noun</i><br><ol><li>camel</li><li>cameleer</li></ol>
גמרא|גְּמָרָא|g'mará	<i>noun</i><br><ol><li>perfection</li><li>completion, consummation</li><li>tradition</li><li>instruction, study</li><li>Gemara</li></ol>
גנב	<i>verb</i><br><ol><li>to steal</li></ol>
גנבא|גנבתא	<i>noun</i><br><ol><li>thief</li></ol>
גנברא	<i>noun</i><br><ol><li>hero, champion</li><li>giant</li></ol>
גנבתא|גנבא	<i>noun</i><br><ol><li>thief</li></ol>
גניסא|גניסן|גניסאתא	<i>noun</i><br><ol><li>family, gentry</li></ol>
גנן	<i>verb</i><br><ol><li>to dwell, to inhabit</li></ol>
גנסא|גנסנא	<i>noun</i><br><ol><li>genus, kind, type</li><li>gender, sex</li><li>(grammar) gender</li></ol>
גנתא|גנא	<i>noun</i><br><ol><li>garden</li></ol>
גרב|g-r-b|gəreḇ|gārəḇ|גְּרַב|גְּרָב|גָּרְב|גְּרֶב|gəraḇ|גּרַב	<i>verb</i><br><ol><li>to seize, to rob, to despoil</li></ol><br><i>noun</i><br><ol><li>absolute state of גַּרְבָא (garəḇā, “leprosy”)</li><li>absolute state of גרבא (g-r-bā, “plunderer, spoliator”)</li><li>absolute state of גְּרָבָא (gər؜ābā, “bottle”)</li><li>absolute state of גַּרְבָּא (garbā, “bottle”)</li></ol><br><i>adj</i><br><ol><li>absolute state of גַּרְבָא (garəḇā, “leprous”)</li></ol><br><i>name</i><br><ol><li>Gareb (a hill in Israel, near Jerusalem, whither the leprous were been banished, as it seems)</li></ol>
גרבא|state גְּרַב|state גרב|state גְּרָב|garbā|garəḇā|גרבא|גְּרָבָא|גַּרְבָּא|גְּרָבֵא|גַּרְבֵּא|גַּרְבֵא|state גְּרֶב|g-r-bā|גַּרְבָא	<i>noun</i><br><ol><li>leprosy</li><li>plunderer, spoliator</li><li>jar, bottle</li></ol><br><i>adj</i><br><ol><li>leprous</li></ol>
גריצתא|גריצא	<i>noun</i><br><ol><li>cake, loaf</li></ol>
גרם חצא|גרמי חצא	<i>noun</i><br><ol><li>(anatomy) backbone, spine</li></ol>
גרמא|garmā’	<i>noun</i><br><ol><li>(anatomy) bone</li></ol>
גרע	<i>verb</i><br><ol><li>to shear, to shave</li></ol>
גרש	<i>verb</i><br><ol><li>to pull, to drag</li></ol>
גשר	<i>verb</i><br><ol><li>to bridge (over)</li><li>to build a bridge</li></ol>
גשרא	<i>noun</i><br><ol><li>bridge</li></ol>
ד־|דְּ־	<i>prep</i><br><ol><li>of</li></ol><br><i>conj</i><br><ol><li>that</li></ol><br><i>pron</i><br><ol><li>who, which, that, what</li></ol>
דא|dā|דָּא	<i>pron</i><br><ol><li>this</li></ol>
דאבתא|דאבא	<i>noun</i><br><ol><li>wolf</li></ol>
דבא|dubbā|דֻּבָּא|דִּבָּא|dibbā	<i>noun</i><br><ol><li>bear</li></ol>
דבבא	<i>noun</i><br><ol><li>fly</li></ol>
דבורתא|דבוריתא	<i>noun</i><br><ol><li>bee</li><li>wasp, hornet</li></ol>
דבח	<i>verb</i><br><ol><li>to slaughter, to sacrifice</li></ol>
דבחא	<i>noun</i><br><ol><li>sacrifice</li></ol>
דבק	<i>verb</i><br><ol><li>to cleave, to adhere</li></ol>
דבר	<i>verb</i><br><ol><li>to lead</li></ol>
דברא	<i>noun</i><br><ol><li>country, countryside</li></ol>
דבשא|dibšā	<i>noun</i><br><ol><li>honey</li></ol>
דגל|dḡal|דְּגַל|יְדַגֵּיל	<i>verb</i><br><ol><li>to lie, to deceive</li></ol>
דגש	<i>verb</i><br><ol><li>to pierce, to stab</li></ol>
דדא|דדתא	<i>noun</i><br><ol><li>uncle</li><li>cousin</li></ol>
דדתא|דדא	<i>noun</i><br><ol><li>aunt</li><li>cousin</li></ol>
דהב	<i>verb</i><br><ol><li>to gild</li></ol>
דהבא|dahăḇā|dahāḇā|דַהָבַיָּא|דַּהֲבָא|דַּהָבָא	<i>noun</i><br><ol><li>gold</li><li>goldsmith</li></ol>
דוגמא|dūḡmāʾ|דּוּגְמָאוֹת|דּוּגְמוֹת|דּוּגְמָא	<i>noun</i><br><ol><li>example, illustration; sample</li><li>simile</li><li>a show, exhibition; also metaphorically, a farce</li><li>one's appearance</li></ol>
דוחנא	<i>noun</i><br><ol><li>millet</li></ol>
דויד	<i>name</i><br><ol><li>(biblical) David</li></ol>
דוכא|דוכיתא|דוכתא|דוכותא	<i>noun</i><br><ol><li>place</li></ol>
דוכרנא	<i>noun</i><br><ol><li>remembrance, commemoration</li><li>memorial</li></ol>
דוכתא|דוכיתא|דוכא|דוכותא	<i>noun</i><br><ol><li>place</li></ol>
דולא	<i>noun</i><br><ol><li>bucket</li></ol><br><i>name</i><br><ol><li>(astrology) Aquarius</li></ol>
דונבא|דונבתא|דונביתא	<i>noun</i><br><ol><li>tail, end</li></ol>
דונבתא|דונבא|דונביתא	<i>noun</i><br><ol><li>tail, end</li><li>final or last thing</li></ol>
דחילא	<i>adj</i><br><ol><li>terrible, frightening</li><li>timid</li></ol>
דחילתא|דחילא	<i>adj</i><br><ol><li>terrible, frightening</li><li>timid</li></ol>
דחל	<i>verb</i><br><ol><li>to fear</li></ol>
דחלתא	<i>noun</i><br><ol><li>fear, dread</li></ol>
דחק	<i>verb</i><br><ol><li>to reject, to expel</li></ol>
דחשא	<i>noun</i><br><ol><li>attendant</li><li>guard, officer</li></ol>
די|דִּי|dī	<i>conj</i><br><ol><li>that</li></ol>
די לא	<i>prep</i><br><ol><li>without</li></ol>
דיבא|dēḇā|דֵּיבָא	<i>noun</i><br><ol><li>wolf</li></ol>
דיותא|דְּיוּתָא|dyūṯā|dyōṯā	<i>noun</i><br><ol><li>ink</li></ol>
דיל־	<i>particle</i><br><ol><li>of, belonging to</li></ol>
דין	<i>adv</i><br><ol><li>yet</li></ol><br><i>conj</i><br><ol><li>yet, but, however</li></ol>
דינא|דינא	<i>noun</i><br><ol><li>judgement, sentence</li><li>lawsuit</li><li>judge</li></ol>
דירא|דירתא|דירא	<i>noun</i><br><ol><li>dwelling, habitation</li><li>monastery</li><li>dweller, inhabitant</li></ol>
דכא	<i>verb</i><br><ol><li>to cleanse, to purify</li></ol>
דכיא	<i>adj</i><br><ol><li>clear, clean, pure</li></ol>
דכיתא|דכיא	<i>adj</i><br><ol><li>clear, clean, pure</li></ol>
דכר	<i>verb</i><br><ol><li>to remember, to recall, to remind</li></ol>
דכרא|דִּכְרֵי|דכרייא|דִּכְרָא|diḵraʾ|נקבתא|דכר|דִּכְרַיָּא|דִּכְרִין|דיכרא|דְּכַר	<i>noun</i><br><ol><li>male</li><li>penis</li></ol><br><i>adj</i><br><ol><li>male, masculine</li></ol>
דליק|דְּלֵיק	<i>verb</i><br><ol><li>to burn</li></ol>
דלקא	<i>noun</i><br><ol><li>flame, fire, torch</li><li>brightness, blaze</li></ol>
דלתא|דַּלְתָתֵי|דַּלְתָא|dalṯā	<i>noun</i><br><ol><li>door</li></ol>
דמא|dmā’	<i>noun</i><br><ol><li>blood</li></ol><br><i>verb</i><br><ol><li>to liken, to compare, to resemble</li></ol>
דמיא	<i>noun</i><br><ol><li>price, value</li></ol>
דמיכא	<i>adj</i><br><ol><li>asleep</li></ol>
דמיכתא|דמיכא	<i>adj</i><br><ol><li>asleep</li></ol>
דמך	<i>verb</i><br><ol><li>to sleep</li></ol>
דמכא	<i>noun</i><br><ol><li>sleeping</li></ol>
דמן	<i>pron</i><br><ol><li>whose</li></ol>
דמע	<i>verb</i><br><ol><li>to weep, to tear</li></ol>
דמעתא|דמעא	<i>noun</i><br><ol><li>tear (drop of water)</li></ol>
דמר	<i>verb</i><br><ol><li>to amaze, to wonder</li></ol>
דנח	<i>verb</i><br><ol><li>to shine</li><li>to dawn, to rise</li></ol>
דנחא	<i>noun</i><br><ol><li>sunrise, dawn</li></ol>
דער	<i>verb</i><br><ol><li>to prick</li><li>to blind</li></ol>
דעת	<i>verb</i><br><ol><li>to sweat</li></ol>
דפא|dappā|דַּפִּין|דַּפָּא|דַּף|דַּפֵּי|דַּפַּיָּא	<i>noun</i><br><ol><li>page</li><li>board, tablet</li></ol>
דקוקא	<i>noun</i><br><ol><li>pestle</li></ol>
דקלא|דִּקְלָא|דִּקְלִין|דקל|דִּקְלֵי|דִּקְלַיָּא|diqlā	<i>noun</i><br><ol><li>palm tree</li></ol>
דקלת	<i>name</i><br><ol><li>Tigris</li></ol>
דקנא|דִּיקְנָא|diqnā|dîqnā|דִּקְנַיָּא|דִּקְנָא	<i>noun</i><br><ol><li>beard</li><li>(anatomy) chin</li></ol>
דקק	<i>verb</i><br><ol><li>to inspect, to moderate, to observe</li><li>to crush, to break into pieces</li></ol>
דקקא	<i>noun</i><br><ol><li>crushing</li></ol>
דרא|דָּרַיָּא|דָּרָא|dārā	<i>noun</i><br><ol><li>age, generation</li><li>row, rank</li></ol>
דרגא	<i>noun</i><br><ol><li>stairway, step</li><li>order, rank</li></ol>
דרדרא	<i>noun</i><br><ol><li>thistle, thorn</li></ol>
דרמסוק	<i>name</i><br><ol><li>Damascus</li></ol>
דרעא|דְּרָעַיָּא|דְּרָעָא|דְּרוֹעַיָּא|דַּרְעָא|darʿā|דְּרַע|dərāʿā	<i>noun</i><br><ol><li>(anatomy) upper arm</li><li>seed, sperm, semen</li><li>offspring</li><li>produce</li></ol>
דרציני|dārṣīnī	<i>noun</i><br><ol><li>cinnamon (particularly Cinnamomum verum)</li></ol>
דרש|dəraš|דְּרַשׁ	<i>verb</i><br><ol><li>to study</li><li>to argue, to dispute</li><li>to converse, to discuss</li><li>to exercise, to train</li></ol>
דרתא|דרא|דָּרַיָּא|דָּרָא|dārā	<i>noun</i><br><ol><li>atrium, court</li></ol>
דתאה|דִּתְאָה|diṯʾā	<i>noun</i><br><ol><li>grass, ground vegetation</li></ol>
ה־|הָ־	<i>det</i><br><ol><li>this</li></ol>
הא	<i>intj</i><br><ol><li>behold!</li></ol>
הבב	<i>verb</i><br><ol><li>to blossom, to bloom</li><li>to flourish</li></ol>
הדא|הנא|הלין	<i>pron</i><br><ol><li>this</li></ol>
הדם	<i>verb</i><br><ol><li>to dismember</li></ol>
הדמא	<i>noun</i><br><ol><li>(anatomy) limb, member</li></ol>
הה״ד|HH"D	<i>phrase</i><br><ol><li>Abbreviation of הָדָא הוּא דִּכְתִיב (hāḏā hū diḵṯīḇ): this is what is written.</li></ol>
הו|הנון	<i>pron</i><br><ol><li>he, it</li></ol>
הוא|hăwā|הֲוָה|הֲוָא|הוה|hū|הוּא|הִיא	<i>pron</i><br><ol><li>he, it</li><li>(copulative) (he/it) is</li></ol><br><i>det</i><br><ol><li>that (distal)</li></ol><br><i>verb</i><br><ol><li>to be, to exist</li></ol>
הוננא	<i>adj</i><br><ol><li>smart, prudent</li></ol>
הוננתא|הוננא	<i>adj</i><br><ol><li>smart, prudent</li></ol>
הי|הנין	<i>pron</i><br><ol><li>she, it</li></ol>
הידין	<i>adv</i><br><ol><li>then, afterwards</li><li>then, previously</li></ol>
היכלא|hēḵəlā|הֵיכְלָא|הֵיכְלֵא	<i>noun</i><br><ol><li>temple</li><li>palace</li></ol>
הימן	<i>verb</i><br><ol><li>to believe, to trust</li></ol>
הימנותא	<i>noun</i><br><ol><li>faith, belief</li><li>faithfulness, fidelity</li><li>trust, confidence</li><li>religion, doctrine, creed</li></ol>
הכנא	<i>adv</i><br><ol><li>thus, so</li></ol>
הלין|הנא|הדא	<i>pron</i><br><ol><li>these</li></ol>
הלך|הַלֵּךְ|הֲלֵךְ|יְהָךְ|hallēḵ|hălēḵ|יְהַלֵּךְ	<i>verb</i><br><ol><li>to go, proceed</li><li>to behave, act</li><li>to walk</li><li>to live in a certain manner, behave</li></ol>
הלכתא|hilkǝṯā|הִלְכְוָתָא|הִלְכָתָא|הִלְכְּתָא	<i>noun</i><br><ol><li>custom, usual practice</li><li>(Jewish law) legal decision, halacha</li></ol>
הלל	<i>verb</i><br><ol><li>to praise</li><li>to deride</li></ol>
הנא|הדא|הלין	<i>pron</i><br><ol><li>this</li></ol>
הנון|הו	<i>pron</i><br><ol><li>they</li></ol>
הנין|הי	<i>pron</i><br><ol><li>they</li></ol>
הפך	<i>verb</i><br><ol><li>to turn, to overturn</li></ol>
ה״מ|hey-mem	<i>noun</i><br><ol><li>Abbreviation of הני מילי (“these words”).</li></ol>
ו־	<i>conj</i><br><ol><li>and</li></ol>
וי	<i>intj</i><br><ol><li>woe!, alas!</li></ol>
ולא	<i>verb</i><br><ol><li>to fit, to befit</li><li>to be appropriate</li></ol>
ועדא	<i>noun</i><br><ol><li>appointment</li></ol>
ורדא	<i>noun</i><br><ol><li>rose, flower</li></ol>
זבא	<i>name</i><br><ol><li>Zab river</li></ol>
זבא עליא	<i>name</i><br><ol><li>Upper Zab river</li></ol>
זבא תחתיא	<i>name</i><br><ol><li>Lower Zab river</li></ol>
זבל	<i>verb</i><br><ol><li>to defecate</li></ol>
זבלא	<i>noun</i><br><ol><li>dung, manure</li></ol>
זבן	<i>verb</i><br><ol><li>to buy, to sell</li></ol>
זבנא|zaḇnā	<i>noun</i><br><ol><li>time</li><li>epoch, era, age</li><li>season</li><li>(grammar) tense</li></ol>
זגגא	<i>noun</i><br><ol><li>glassmaker</li></ol>
זגוגיתא|zgūgītā’	<i>noun</i><br><ol><li>glass (substance)</li></ol>
זד|זֵד|זֵדִים	<i>noun</i><br><ol><li>a wicked person</li></ol>
זדון|זֵדוֹן|זֵדוֹנִין	<i>noun</i><br><ol><li>a violent man</li></ol>
זדיקא	<i>adj</i><br><ol><li>righteous</li></ol>
זדיקתא|זדיקא	<i>adj</i><br><ol><li>righteous</li></ol>
זדק	<i>verb</i><br><ol><li>to be righteous</li></ol>
זוג	<i>verb</i><br><ol><li>to pair, to join, to marry</li></ol>
זוגא	<i>noun</i><br><ol><li>yoke, pair</li></ol>
זוזא|zūzā	<i>noun</i><br><ol><li>coin, money</li><li>drachma</li></ol>
זוע	<i>verb</i><br><ol><li>to shake, to stir</li><li>to confuse</li><li>to trouble</li></ol>
זועא|zawˁā	<i>noun</i><br><ol><li>earthquake, trembling</li><li>vibration</li><li>commotion, agitation</li><li>motion, movement</li><li>impulse</li><li>(phonetics) vowel</li></ol>
זינא|zaynā’	<i>noun</i><br><ol><li>weapon</li></ol>
זיתא|זֵית|זֵיתַיָּא|זֵיתֵי|zaytā|זֵיתָא|זֵיתִין	<i>noun</i><br><ol><li>olive</li><li>olive tree</li></ol>
זלם	<i>verb</i><br><ol><li>to distort, to pervert</li></ol>
זמם	<i>verb</i><br><ol><li>to sound, to buzz, to ring</li></ol>
זמנא|זִמְנָא|זִימְנֵא|zimnā	<i>noun</i><br><ol><li>time</li></ol>
זמר	<i>verb</i><br><ol><li>to sing</li></ol>
זמרא|זמרא|זמרתא	<i>noun</i><br><ol><li>singing, music</li><li>singer, musician</li></ol>
זמרתא|זמרא	<i>noun</i><br><ol><li>singer, musician</li></ol>
זנא|זניא	<i>noun</i><br><ol><li>type, kind</li><li>method, manner</li><li>species</li></ol><br><i>verb</i><br><ol><li>to fornicate, to commit adultery</li><li>to prostitute</li></ol>
זעורא|zəʿōrā	<i>adj</i><br><ol><li>small, little, insignificant</li></ol>
זעורתא|זעורא|זעוריתא|zəʿōrā	<i>adj</i><br><ol><li>small, little, insignificant</li></ol>
זעיק|זְעֵיק|zəʿēq	<i>verb</i><br><ol><li>to cry</li></ol>
זעף	<i>verb</i><br><ol><li>to be indignant</li></ol>
זעק|זְעַק|zəʿaq	<i>verb</i><br><ol><li>to cry</li></ol>
זקיפא	<i>adj</i><br><ol><li>erected, elevated</li><li>crucified</li></ol>
זקיפתא|זקיפא	<i>adj</i><br><ol><li>erected, elevated</li><li>crucified</li></ol>
זקן|זְקַן|zəqan	<i>verb</i><br><ol><li>(Jewish Babylonian Aramaic) to age</li></ol>
זקף|זְקַף|zəqaf	<i>verb</i><br><ol><li>to erect, to elevate, to raise</li><li>to stand straight</li></ol>
זקר	<i>verb</i><br><ol><li>to weave</li></ol>
זקתא	<i>noun</i><br><ol><li>goad, spur</li></ol>
זרועא	<i>noun</i><br><ol><li>sower</li></ol>
זרניכא	<i>noun</i><br><ol><li>orpiment</li></ol>
זרע|זְרַע|zəraʿ	<i>verb</i><br><ol><li>to sow, to seed, to plant</li></ol>
זרעא|זַרְעָא|זרעתא	<i>noun</i><br><ol><li>seed</li></ol>
זרתא|זרא	<i>noun</i><br><ol><li>span (of the hand)</li><li>fist, hand</li></ol>
חארא	<i>adj</i><br><ol><li>free, liberated</li></ol>
חארתא|חארא	<i>adj</i><br><ol><li>free, liberated</li></ol>
חבב|ḥaváv	<i>verb</i><br><ol><li>to love</li></ol>
חבושא|חֲבוּשָׁא|חבושיא|חָבוּשָׁא	<i>noun</i><br><ol><li>quince</li><li>prisoner</li><li>imprisonment</li></ol>
חביבא	<i>adj</i><br><ol><li>beloved, dear</li></ol>
חביבתא|חביבא	<i>adj</i><br><ol><li>beloved, dear</li></ol>
חבל|ḥăḇal|חֲבַל	<i>verb</i><br><ol><li>to damage, to injure, to destroy</li></ol>
חבלא|חבלתא|חבלא	<i>noun</i><br><ol><li>rope, cord</li><li>line, row, series</li><li>travail</li><li>injury, damage, corruption</li><li>destroyer</li></ol>
חבן	<i>verb</i><br><ol><li>to cease</li><li>to be lazy</li></ol>
חבננא	<i>adj</i><br><ol><li>lazy</li></ol>
חבננתא|חבננא	<i>adj</i><br><ol><li>lazy</li></ol>
חבק|ḥăḇaq|חַבֵּק|חֲבַק|ḥabbēq	<i>verb</i><br><ol><li>to embrace</li></ol>
חבר	<i>verb</i><br><ol><li>to associate with, to gather together</li></ol>
חברא|חַבְרָא|חַבְרַיָּיא|חֲבֶרְתָּא	<i>noun</i><br><ol><li>friend, companion</li></ol>
חברותא	<i>noun</i><br><ol><li>fellowship, companionship</li></ol>
חברתא|חַבְרָא|חברא|חַבְרַיָּיא|חֲבֶרְתָּא	<i>noun</i><br><ol><li>friend, companion</li></ol>
חבש	<i>verb</i><br><ol><li>to imprison, to confine</li><li>to include</li></ol>
חגירא	<i>adj</i><br><ol><li>lame</li></ol>
חגירתא|חגירא	<i>adj</i><br><ol><li>lame</li></ol>
חגר	<i>verb</i><br><ol><li>to limp</li><li>to hold back</li></ol>
חד|חדא|ḥad|ḥdāʾ	<i>num</i><br><ol><li>one (1)</li></ol>
חדותא	<i>noun</i><br><ol><li>joy, gladness</li></ol>
חדי	<i>verb</i><br><ol><li>to rejoice</li></ol>
חדיא|חדותא	<i>noun</i><br><ol><li>(anatomy) chest, breast</li></ol><br><i>adj</i><br><ol><li>joyous</li></ol>
חדיתא|חדיא	<i>adj</i><br><ol><li>joyous</li></ol>
חדסר	<i>num</i><br><ol><li>eleven</li></ol>
חדעסר	<i>num</i><br><ol><li>eleven (11)</li></ol>
חדעסרא	<i>num</i><br><ol><li>eleven (11)</li></ol>
חדקא|ḥiḏqāʾ|חִדְקָא|חִדְקַיָּא|חִידְקַיָּא	<i>noun</i><br><ol><li>thorn</li></ol>
חדר	<i>verb</i><br><ol><li>to wander</li><li>to beg</li></ol>
חדתא|חדתתא|חדתא	<i>adj</i><br><ol><li>new</li></ol>
חדתתא|חדתא	<i>adj</i><br><ol><li>new</li></ol>
חוא	<i>verb</i><br><ol><li>to show, to reveal</li></ol><br><i>name</i><br><ol><li>(biblical) Eve</li></ol>
חוב	<i>verb</i><br><ol><li>to owe, to be in debt</li></ol>
חובא|חובא	<i>noun</i><br><ol><li>love</li><li>debt</li></ol>
חוגתא|חוגיתא	<i>noun</i><br><ol><li>circle, orb</li><li>halo, corona</li><li>compass</li></ol>
חוחא	<i>noun</i><br><ol><li>thorn, thornbush</li></ol>
חוט	<i>verb</i><br><ol><li>to sew</li></ol>
חוטא|חוּטָא|Term?|ħūṭāˀ|חוּטִין|חוּטֵי|חוּטַיָּּא	<i>noun</i><br><ol><li>thread, string</li><li>seam</li></ol>
חוטמא	<i>noun</i><br><ol><li>any distinctive feature of the face</li><li>(anatomy) nose, nostril</li></ol>
חוטרא	<i>noun</i><br><ol><li>staff, rod</li></ol>
חומא	<i>noun</i><br><ol><li>heat</li></ol>
חוף	<i>verb</i><br><ol><li>to wash</li></ol>
חופא	<i>noun</i><br><ol><li>washing, cleansing</li></ol>
חור	<i>verb</i><br><ol><li>to look at, to watch, to stare</li><li>to be white, to be pale</li></ol>
חורא	<i>adj</i><br><ol><li>white</li></ol>
חורבא|חורבא	<i>noun</i><br><ol><li>stork, heron</li><li>wilderness, ruin</li></ol>
חורתא|חורא	<i>adj</i><br><ol><li>white</li></ol>
חושבא	<i>noun</i><br><ol><li>thought, idea</li></ol>
חזא|ḥaza	<i>verb</i><br><ol><li>to see</li></ol>
חזונא	<i>noun</i><br><ol><li>vision</li></ol>
חזיא|חזיא	<i>noun</i><br><ol><li>sight</li><li>observer, spectator</li></ol>
חזירא|ħzīrā’|חזירתא|ħzīrtā’	<i>noun</i><br><ol><li>pig, swine, hog</li></ol>
חזירן	<i>name</i><br><ol><li>June</li></ol>
חזירתא|ħzīrā’|ħzīrtā’|חזירא	<i>noun</i><br><ol><li>pig, swine, sow</li></ol>
חטא|חטתא	<i>noun</i><br><ol><li>wheat</li></ol><br><i>verb</i><br><ol><li>to sin</li></ol>
חטהא	<i>noun</i><br><ol><li>sin, fault</li></ol>
חטיא|חטיתא	<i>noun</i><br><ol><li>sinner</li></ol>
חטיתא|חטיא|חטיתא	<i>noun</i><br><ol><li>sin</li><li>sinner</li></ol>
חטף	<i>verb</i><br><ol><li>to seize</li></ol>
חטתא|חטא	<i>noun</i><br><ol><li>wheat</li></ol>
חיא|ħayē	<i>noun</i><br><ol><li>life, lives</li></ol><br><i>verb</i><br><ol><li>to live</li></ol>
חיורא|ḥeywara	<i>adj</i><br><ol><li>white</li></ol>
חיותא|חיותא	<i>noun</i><br><ol><li>life, living, vitality</li><li>wild animal, creature</li></ol>
חיט	<i>verb</i><br><ol><li>to sew</li></ol>
חייא|חַיִּין|חַיַּיָּא|ħayyayyā|חַיֵּי	<i>noun</i><br><ol><li>life</li></ol>
חיל	<i>verb</i><br><ol><li>to be strong, to strengthen</li></ol>
חילא|חֵילֵי|חֵילַיָּא|חֵילָא|חֵיל|חֵילִין	<i>noun</i><br><ol><li>strength, force, power</li></ol>
חכימא	<i>adj</i><br><ol><li>wise, cunning</li></ol>
חכימתא|חכימא	<i>adj</i><br><ol><li>wise, cunning</li></ol>
חכם	<i>verb</i><br><ol><li>to be wise</li></ol>
חכמתא	<i>noun</i><br><ol><li>wisdom, knowledge, science</li><li>counsel</li><li>art, skill</li></ol>
חלא|Nabataean|khālā|חלא|חלתא|ḥāltā	<i>noun</i><br><ol><li>vinegar</li><li>sand, gravel</li><li>maternal uncle</li><li>dust</li></ol>
חלב	<i>verb</i><br><ol><li>to milk</li></ol>
חלבא|ħalbā'	<i>noun</i><br><ol><li>milk</li></ol>
חלי	<i>verb</i><br><ol><li>to be sweet, to sweeten</li></ol>
חליא	<i>adj</i><br><ol><li>sweet, sweetened</li></ol>
חליותא	<i>noun</i><br><ol><li>sweetness</li></ol>
חלימא	<i>adj</i><br><ol><li>sound, whole, healthy</li><li>strong</li></ol>
חלימתא|חלימא	<i>adj</i><br><ol><li>sound, whole, healthy</li><li>strong</li></ol>
חליתא|חליא	<i>adj</i><br><ol><li>sweet, sweetened</li></ol>
חללא	<i>noun</i><br><ol><li>hole, cavity</li><li>cave, cavern, tunnel</li><li>mine</li><li>trench</li></ol>
חלם|ħălam	<i>verb</i><br><ol><li>To dream.</li><li>To heal, to cure.</li></ol>
חלמא|חֶלְמָא|חָלְמַיָּא|ḥelmā|חֶלְמַיָּא|ḥāləmā|חָלְמָא	<i>noun</i><br><ol><li>dream</li><li>dreamer</li><li>an interpreter of dreams</li></ol>
חלף	<i>verb</i><br><ol><li>to change, to alter</li></ol>
חלתא|Nabataean|ḥalləṯā|חַלְּתָא|khālā|חלא|ḥelləṯā|ḥāltā	<i>noun</i><br><ol><li>maternal aunt</li><li>ossuary</li><li>basket, bucket</li><li>a type of loaf or cake</li><li>the priest’s share of the dough, also called challa in English texts, and Teighebe in German ones</li></ol>
חמא|חמתא|חמהא	<i>noun</i><br><ol><li>father-in-law</li></ol><br><i>verb</i><br><ol><li>to brood</li><li>to protect</li></ol>
חמוצא	<i>adj</i><br><ol><li>sour, unripe</li></ol>
חמוצתא|חמוצא	<i>adj</i><br><ol><li>sour, unripe</li></ol>
חמורתא|חמורא	<i>noun</i><br><ol><li>wheel, bead</li><li>gem</li></ol>
חמימא	<i>adj</i><br><ol><li>hot</li></ol>
חמימתא|חמימא	<i>adj</i><br><ol><li>hot</li></ol>
חמיסר	<i>num</i><br><ol><li>fifteen</li></ol>
חמיעא	<i>noun</i><br><ol><li>leaven, yeast</li></ol><br><i>adj</i><br><ol><li>leavened</li></ol>
חמיעתא|חמיעא	<i>adj</i><br><ol><li>leavened</li></ol>
חמירא|חֲמִירָא|ḥămīrā|חֲמִירֵא	<i>noun</i><br><ol><li>leaven</li><li>leavened dough or bread</li></ol>
חמם	<i>verb</i><br><ol><li>to be hot</li></ol>
חמע	<i>verb</i><br><ol><li>to ferment, to leaven</li><li>to mix</li></ol>
חמץ	<i>verb</i><br><ol><li>To be sour.</li></ol>
חמרא|חַמְרָא|חֲמָרָא|ḥammārā|חַמָּרַיָּא|חַמָּרְתָא|חֲמָרַיָּא|חֲמָרֵי|חַמָּרָא|ḥămārā|ḥamrā	<i>noun</i><br><ol><li>wine</li><li>vintner</li><li>donkey, ass</li><li>donkey driver</li></ol>
חמרתא|חַמְרָא|חמרא|ḥamrā	<i>noun</i><br><ol><li>vintner</li><li>donkey driver</li></ol>
חמש	<i>num</i><br><ol><li>five (5)</li></ol>
חמשא|ḥamša	<i>num</i><br><ol><li>five (5)</li></ol>
חמשין	<i>num</i><br><ol><li>fifty (50)</li></ol>
חמשמאא	<i>num</i><br><ol><li>five hundred</li></ol>
חמשעסר	<i>num</i><br><ol><li>fifteen (15)</li></ol>
חמשעסרא	<i>num</i><br><ol><li>fifteen (15)</li></ol>
חמת	<i>verb</i><br><ol><li>to rage, to be angry</li></ol>
חמתא|חמא|חמתא|חמהא	<i>noun</i><br><ol><li>mother-in-law</li><li>heat, fever</li><li>anger, wrath, fury</li></ol>
חנוכתא	<i>noun</i><br><ol><li>inauguration</li><li>dedication</li></ol><br><i>name</i><br><ol><li>Hanukkah/Chanukah</li></ol>
חנותא|חָנוּתָא|חָנְוָאתָא|ḥānūṯā|חָנְוָתָא	<i>noun</i><br><ol><li>vaulted chamber, cell</li><li>wine tavern, pub</li><li>booth, shed</li><li>shop, store</li></ol>
חנכא	<i>noun</i><br><ol><li>(anatomy) palate</li></ol>
חנן	<i>verb</i><br><ol><li>to be merciful</li></ol><br><i>name</i><br><ol><li>(biblical) Annas</li></ol>
חנק	<i>verb</i><br><ol><li>to choke, to suffocate</li><li>to hang, to strangle</li><li>to drown</li></ol>
חנקא	<i>noun</i><br><ol><li>bond, band</li><li>suffocation</li></ol>
חס	<i>adv</i><br><ol><li>God forbid</li></ol>
חסינא	<i>adj</i><br><ol><li>strong, mighty</li><li>heavy</li><li>serious</li></ol>
חסינתא|חסינא	<i>adj</i><br><ol><li>strong, mighty</li><li>heavy</li><li>serious</li></ol>
חפט	<i>verb</i><br><ol><li>to incite</li><li>to be diligent, to be zealous</li></ol>
חצד	<i>verb</i><br><ol><li>to reap, to harvest</li></ol>
חצדא	<i>noun</i><br><ol><li>reaping, harvest</li></ol>
חצינא|חֲצִינֵא|ḥăṣṣīnā|חֲצִינָא	<i>noun</i><br><ol><li>axe</li></ol>
חציפותא	<i>noun</i><br><ol><li>persistence, importunity</li><li>obstinacy, pertinacity</li><li>audacity</li></ol>
חקלא|חקלנא|חַקְלָא|חַקְלִין|חַקְלֵי|ḥaqlā|חקלתא|חֲקַל|חַקְלַיָּא	<i>noun</i><br><ol><li>field</li></ol>
חרבא|חַרְבֵּא|חַרְבׇּא|ḥarbā	<i>noun</i><br><ol><li>sword, dagger</li><li>blade</li></ol>
חרדלא	<i>noun</i><br><ol><li>mustard</li></ol>
חרר	<i>verb</i><br><ol><li>to free, to liberate</li></ol>
חרשא|חרשא|חרשתא	<i>adj</i><br><ol><li>deaf, mute</li></ol><br><i>noun</i><br><ol><li>enchantment, incantation</li><li>magic, witchcraft</li><li>magician, sorcerer, wizard</li></ol>
חרשתא|חרשא	<i>adj</i><br><ol><li>deaf, mute</li></ol><br><i>noun</i><br><ol><li>magician, sorceress, witch</li></ol>
חרת	<i>verb</i><br><ol><li>to dig</li><li>to plough/plow, to till</li></ol>
חשב	<i>verb</i><br><ol><li>to think</li></ol>
חשיארש	<i>name</i><br><ol><li>Xerxes</li></ol>
חשך	<i>verb</i><br><ol><li>to darken</li></ol>
חשכא	<i>noun</i><br><ol><li>darkness</li><li>eclipse</li></ol>
חשכתא	<i>noun</i><br><ol><li>sunset, dusk</li></ol>
חשל	<i>verb</i><br><ol><li>to forge, to fabricate, to produce</li><li>to excite, to arouse</li></ol>
טב|טָבְתָא|טָב|טָבִי|טָבַיָּא|טָבַת|טָבִין|טָבָת|טָבָתָא|טָבָא|טָבָה|טָבָן|טָבֵי|ṭāḇ	<i>adj</i><br><ol><li>good</li></ol>
טבח|טְבַח|t'vaḥ|טַבַּח|tabbaḥ	<i>verb</i><br><ol><li>to slaughter an animal to be prepared for a meal</li></ol>
טבחא|טבחתא	<i>noun</i><br><ol><li>butcher, slaughterer</li><li>cook</li></ol>
טבחתא|טבחא	<i>noun</i><br><ol><li>butcher, slaughterer</li><li>cook</li></ol>
טביא|ṭaḇyā|טַבְיָא|טביתא|Ṭabīṯāʾ	<i>noun</i><br><ol><li>gazelle</li><li>roe, deer</li></ol>
טביתא|טַבְיָא|ṭaḇyā|טביא|Ṭabīṯāʾ	<i>noun</i><br><ol><li>gazelle</li><li>roe, doe</li></ol><br><i>name</i><br><ol><li>(biblical) Tabitha</li></ol>
טבע	<i>verb</i><br><ol><li>to sink, to drown</li><li>to stamp, to seal</li></ol>
טבתא	<i>adj</i><br><ol><li>feminine singular emphatic state of טָב</li><li>feminine plural emphatic state of טָב</li></ol>
טהרא	<i>noun</i><br><ol><li>noon, midday</li></ol>
טוב	<i>verb</i><br><ol><li>to do/to be good</li></ol>
טובא	<i>noun</i><br><ol><li>good, goodness</li><li>much, many, a lot</li></ol>
טובענא|tōvʿānā|טוֹבְעָנָא	<i>noun</i><br><ol><li>flood</li></ol>
טוסא|טַוְסִ|טַוסָא|ṭawsā|טַוְסִין|טַוָּוסִין	<i>noun</i><br><ol><li>peacock</li><li>flight</li></ol>
טופסא	<i>noun</i><br><ol><li>example</li><li>form, figure</li><li>type, kind</li><li>(grammar) term describing root of words, mood</li></ol>
טורא|טוּרָא|טוּרַיּאָ|ṭūrā|טוּרַיָּא|טוּרִין|טוּרֵי|טוּר	<i>noun</i><br><ol><li>mountain, hill</li></ol>
טחלא|ṭəḥālā|טְחָלֵא|טְחָלָא	<i>noun</i><br><ol><li>spleen, milt</li></ol>
טחן|טְחַן	<i>verb</i><br><ol><li>to grind, to pound</li></ol>
טיגריס|ṭīgrīs	<i>noun</i><br><ol><li>tiger</li></ol>
טינא	<i>noun</i><br><ol><li>mud, clay</li></ol>
טכס	<i>verb</i><br><ol><li>to order, to arrange</li></ol>
טלא	<i>noun</i><br><ol><li>dew</li></ol>
טלח|ṭəlaħ|טְלַח	<i>verb</i><br><ol><li>to halt</li></ol>
טלל	<i>verb</i><br><ol><li>to shade</li></ol>
טללא|ṭillālā	<i>noun</i><br><ol><li>shade</li><li>shadow</li></ol>
טלם	<i>verb</i><br><ol><li>to oppress</li><li>to cheat, to deceive</li><li>to reject, to refuse</li></ol>
טלניתא|ṭellānīṯā	<i>noun</i><br><ol><li>shadow</li></ol>
טלק	<i>verb</i><br><ol><li>to disappear, to vanish</li><li>to be finished</li></ol>
טננא	<i>noun</i><br><ol><li>zeal</li><li>jealousy, envy</li></ol>
טעא	<i>verb</i><br><ol><li>to wander</li><li>to err</li></ol>
טעם|ta'am|t'em	<i>noun</i><br><ol><li>decree</li></ol><br><i>verb</i><br><ol><li>to taste</li></ol>
טעמא	<i>noun</i><br><ol><li>taste (used esp. in the phrase מַאי טַעְמָא, ‘what is the reason?’)</li></ol>
טען	<i>verb</i><br><ol><li>to carry, to burden</li></ol>
טפי|טְפֵי|t'fey	<i>adv</i><br><ol><li>more</li></ol>
טפרא	<i>noun</i><br><ol><li>(anatomy) nail (on fingers and toes)</li><li>claw, talon</li></ol>
טרא	<i>verb</i><br><ol><li>to steer, to drive</li></ol>
טרף	<i>verb</i><br><ol><li>to strike, to knock</li><li>to tire, to wear out</li></ol>
טרפא|טרפנא	<i>noun</i><br><ol><li>leaf</li></ol>
טשא	<i>verb</i><br><ol><li>to hide</li></ol>
יבישא	<i>adj</i><br><ol><li>dry</li></ol>
יבישתא|יבישא	<i>adj</i><br><ol><li>dry</li></ol>
יבש	<i>verb</i><br><ol><li>to be dry</li></ol>
יבשא	<i>noun</i><br><ol><li>earth, dry land</li></ol>
יבשתא	<i>noun</i><br><ol><li>continent, dry land</li></ol>
יגרא	<i>noun</i><br><ol><li>heap, pile</li><li>barrier</li></ol>
ידא|yəḏā|יְדָא|אידיא|ʾīḏā|אידא|יְדַיָּא	<i>noun</i><br><ol><li>hand</li></ol><br><i>verb</i><br><ol><li>to admit, to confess</li></ol>
ידע|yeda'|יְדַע	<i>verb</i><br><ol><li>to know</li></ol>
יהב|yehab	<i>verb</i><br><ol><li>to give</li></ol>
יהוד	<i>name</i><br><ol><li>Judea</li></ol>
יהודא	<i>name</i><br><ol><li>(biblical) Judas</li></ol>
יהודיא|יְהוּדָיֵא|יהודיתא	<i>noun</i><br><ol><li>Jew</li></ol><br><i>adj</i><br><ol><li>Jewish</li></ol>
יהודיותא|yəhūḏāyūṯā|יְהוּדָיוּתָא	<i>name</i><br><ol><li>Judaism</li></ol>
יהודיתא|יְהוּדָיֵא|יהודיא	<i>noun</i><br><ol><li>Jew</li></ol><br><i>adj</i><br><ol><li>Jewish</li></ol>
יוחנן	<i>name</i><br><ol><li>(biblical) John</li></ol>
יוי	<i>noun</i><br><ol><li>(biblical) God</li></ol>
יומא|יוֹמָתָא|יוֹמִין|יוֹמַיָּא|יוֹמָא|יוֹם|יוֹמֵי|yōmā	<i>noun</i><br><ol><li>day</li><li>(in the plural) time</li><li>(uncountable) daytime, daylight</li></ol>
יומנא	<i>noun</i><br><ol><li>today</li></ol><br><i>adv</i><br><ol><li>today</li></ol>
יון	<i>name</i><br><ol><li>Greece</li></ol>
יונא	<i>noun</i><br><ol><li>dove (bird)</li></ol>
יוסף	<i>name</i><br><ol><li>Joseph (Biblical figure)</li></ol>
יורדנן	<i>name</i><br><ol><li>Jordan river</li></ol>
יזף	<i>verb</i><br><ol><li>to borrow, to lend</li></ol>
יחד	<i>verb</i><br><ol><li>to unite</li></ol>
יחט	<i>verb</i><br><ol><li>to miscarry, to abort</li></ol>
יחטא	<i>noun</i><br><ol><li>miscarriage, abortion</li></ol>
יחף	<i>verb</i><br><ol><li>to be barefoot</li></ol>
ילד	<i>verb</i><br><ol><li>to bear children</li><li>to be born</li></ol>
ילידותא	<i>noun</i><br><ol><li>birth</li><li>origin</li><li>genealogy, ancestry, descent</li></ol>
ילף|יְלַף|yəlap̄|yallēp̄|יַלֵּף	<i>verb</i><br><ol><li>to learn</li><li>to teach</li></ol>
ימא|ʾīmāmā|איממא|יְמָמָא|אִיְמָמָא|יממא|yəmāmā	<i>noun</i><br><ol><li>sea</li></ol><br><i>verb</i><br><ol><li>to swear, to vow</li></ol>
ימינא	<i>noun</i><br><ol><li>right (direction)</li></ol>
יממא|איממא|יְמָמָא|אִיְמָמָא|ʾīmāmā|yəmāmā	<i>noun</i><br><ol><li>daytime</li></ol>
ינק|יְנַק|yᵊnaq	<i>verb</i><br><ol><li>to suck</li></ol>
יסמין	<i>noun</i><br><ol><li>jasmine/jessamine</li></ol>
יעקוב	<i>name</i><br><ol><li>(biblical) Jacob</li></ol>
יציפא	<i>adj</i><br><ol><li>anxious</li><li>careful</li></ol>
יציפותא	<i>noun</i><br><ol><li>anxiety</li><li>care, attention</li></ol>
יציפתא|יציפא	<i>adj</i><br><ol><li>anxious</li><li>careful</li></ol>
יצף	<i>verb</i><br><ol><li>to be anxious</li><li>to take care</li></ol>
יקד	<i>verb</i><br><ol><li>to burn, to be burned</li></ol>
יקדא	<i>noun</i><br><ol><li>burning</li><li>burnt offering, sacrifice</li></ol>
יקדתא	<i>noun</i><br><ol><li>conflagration, flame</li></ol>
יקידא	<i>adj</i><br><ol><li>burned</li></ol>
יקידתא|יקידא	<i>adj</i><br><ol><li>burned</li></ol>
יקירא	<i>adj</i><br><ol><li>heavy</li><li>rare, precious</li></ol>
יקירותא	<i>noun</i><br><ol><li>weight, heaviness</li><li>dignity, honour/honor</li><li>seriousness</li></ol>
יקירתא|יקירא	<i>adj</i><br><ol><li>heavy</li><li>rare, precious</li></ol>
יקר	<i>verb</i><br><ol><li>to be heavy</li><li>to honor, to be honored</li><li>to be precious</li></ol>
יקרא	<i>noun</i><br><ol><li>weight (heavy mass)</li></ol>
ירורא	<i>noun</i><br><ol><li>jackal</li></ol>
ירושלם|yərūšəlem|יְרוּשְׁלֶם	<i>name</i><br><ol><li>(biblical) Jerusalem</li></ol>
ירחא	<i>noun</i><br><ol><li>month</li><li>new moon</li></ol>
ירק	<i>verb</i><br><ol><li>to be light coloured/colored, pale, green, yellow</li></ol>
ירקא	<i>noun</i><br><ol><li>vegetable</li></ol>
ירקון	<i>name</i><br><ol><li>Yarkon river</li></ol>
ירת	<i>verb</i><br><ol><li>to inherit</li></ol>
ירתא	<i>noun</i><br><ol><li>heir, inheritor</li></ol>
ירתותא	<i>noun</i><br><ol><li>inheritance</li><li>possession, property</li><li>lot, portion</li></ol>
ירתתא	<i>noun</i><br><ol><li>heritage</li></ol>
ישוע|יֵשׁוּע|Yēšūʿ	<i>name</i><br><ol><li>(biblical) Joshua, a Biblical character</li><li>(Christianity) Jesus, a Biblical character</li></ol>
ישוע משיחא|Yēšūʿ Mšīḥāʾ|יֵשׁוּע משִׁיחָא	<i>name</i><br><ol><li>(Christianity) Jesus Christ</li></ol>
ישט	<i>verb</i><br><ol><li>to extend, to stretch</li></ol>
ישפה	<i>noun</i><br><ol><li>jasper</li></ol>
ית|yit	<i>prep</i><br><ol><li>Used to introduce a direct object.</li><li>(with suffixes) self (e.g. myself, himself, etc.)</li></ol>
יתא	<i>noun</i><br><ol><li>existence, being</li><li>essence</li></ol>
יתב	<i>verb</i><br><ol><li>to sit</li><li>to dwell</li><li>to establish</li></ol>
יתירא	<i>adj</i><br><ol><li>more, extra</li></ol>
יתירתא|יתירא	<i>adj</i><br><ol><li>more, extra</li></ol>
יתר	<i>verb</i><br><ol><li>to add, to gain</li><li>to prefer</li><li>to remain</li></ol>
כאבא	<i>noun</i><br><ol><li>suffering, pain</li><li>disease</li></ol>
כבד	<i>verb</i><br><ol><li>to be angry</li></ol>
כבדא|כבדתא	<i>noun</i><br><ol><li>liver</li><li>gall, bile</li></ol>
כבר|kəḇar|כַּבֵּר|kabbēr|כְּבַר	<i>adv</i><br><ol><li>already, long since</li><li>perhaps</li></ol><br><i>verb</i><br><ol><li>to be much/many</li><li>to increase, multiply, make much/many</li></ol>
כבריתא|כִּבְּרִיתָא|kiḇrīṯā	<i>noun</i><br><ol><li>sulphur/sulfur, brimstone</li></ol>
כבשא|נקותא|נקיא	<i>noun</i><br><ol><li>ram (male sheep)</li></ol>
כד|kaḏ|כַּד	<i>conj</i><br><ol><li>when, as</li></ol>
כדי	<i>conj</i><br><ol><li>when</li></ol>
כהן	<i>verb</i><br><ol><li>to serve as a priest</li></ol>
כהנא|כַּהֲנַיָּא|kahǎnā|כַּהֲנָא	<i>noun</i><br><ol><li>(Judaism) cohen</li><li>priest</li></ol>
כהנותא	<i>noun</i><br><ol><li>priesthood</li></ol>
כובא	<i>noun</i><br><ol><li>thorn</li></ol>
כודנא|כודנתא	<i>noun</i><br><ol><li>mule</li></ol>
כודנתא|כודנא	<i>noun</i><br><ol><li>mule</li></ol>
כוכב	<i>verb</i><br><ol><li>to asterisk</li></ol>
כוכבא|כּוֹכָב|כּוֹכְבָא|כּוֹכְבִין|כּוֹכְבַיָּא|kawkbā’|כוכב|כּוֹכְבֵי	<i>noun</i><br><ol><li>star (celestial body)</li></ol>
כוכבונא	<i>noun</i><br><ol><li>little star</li><li>asterisk</li></ol>
כוליתא|כּוֹלְיַת|כּוֹלְיָת|כּוֹלְיָן|כּוֹלְיָתָא|כּוֹלִיתָא|כּוֹלְיָה	<i>noun</i><br><ol><li>kidney</li><li>testicle</li></ol>
כורהנא	<i>noun</i><br><ol><li>disease</li></ol>
כורסיא|kursəyā|כּוּרְסְיָא|כּוּרְסְוָתָא	<i>noun</i><br><ol><li>seat, chair</li><li>throne</li></ol>
כותא|כוא	<i>noun</i><br><ol><li>window</li></ol>
כי|kay	<i>conj</i><br><ol><li>because, for</li></ol>
כיסא|כִּיסֵי|כִּיסָא|כִּיס|כִּיסַיָּא|כִּיסִין	<i>noun</i><br><ol><li>bag, purse, pouch</li><li>pocket</li></ol>
כיפא|כיפיא|kēp̄ā|כֵּיפָא	<i>noun</i><br><ol><li>rock, stone</li></ol>
ככא	<i>noun</i><br><ol><li>(anatomy) tooth, molar</li></ol>
כל|kol	<i>particle</i><br><ol><li>all, every, whole</li></ol>
כלא	<i>verb</i><br><ol><li>to stop, to cease, to pause</li><li>to hinder, to restrain, to forbid</li></ol>
כלבא|כַּלְבַיָּא|כַּלְבֵּי|כַּלְבִּין|כַּלְבַּיָּא|כלבתא|כְּלֵב|כְּלַב|כַּלְבָּא	<i>noun</i><br><ol><li>dog</li></ol>
כלבתא|כַּלְבַיָּא|כַּלְבֵּי|כלבא|כַּלְבִּין|כַּלְבַּיָּא|כְּלֵב|כְּלַב|כַּלְבָּא	<i>noun</i><br><ol><li>dog, bitch</li></ol>
כליא	<i>adj</i><br><ol><li>stopped</li></ol>
כלילא	<i>noun</i><br><ol><li>crown</li><li>wreath</li></ol>
כליתא|כליא	<i>adj</i><br><ol><li>stopped</li></ol>
כלתא|kalləṯā|כַּלָּתָא|כַּלְּתָא	<i>noun</i><br><ol><li>bride</li><li>daughter-in-law</li><li>(Syriac, in the plural) order of angels</li></ol>
כמא	<i>pron</i><br><ol><li>how much, how many</li></ol>
כמונא|kammōnā|כַּמֹּונָֹא	<i>noun</i><br><ol><li>cumin</li></ol>
כן|kēn|כֵּן	<i>adv</i><br><ol><li>thus, so, next</li><li>then, afterwards, soon, shortly</li></ol>
כנון א	<i>name</i><br><ol><li>December</li></ol>
כנון אחרי	<i>name</i><br><ol><li>January</li></ol>
כנון ב	<i>name</i><br><ol><li>January</li></ol>
כנון קדים	<i>name</i><br><ol><li>December</li></ol>
כנון תרינא	<i>name</i><br><ol><li>January</li></ol>
כנישא	<i>adj</i><br><ol><li>gathered, collected</li></ol>
כנישתא|כנישא	<i>adj</i><br><ol><li>gathered, collected</li></ol>
כנפא|כנפתא|כנפא|knāpā|kenpā	<i>noun</i><br><ol><li>side, edge</li><li>wing</li><li>lap, bosom</li><li>service tree</li></ol>
כנש|כְּנַשׁ	<i>verb</i><br><ol><li>to gather</li></ol>
כנשא	<i>noun</i><br><ol><li>crowd, gathering, collection</li></ol>
כסא|kəsā|כסאות|כְּסָא	<i>noun</i><br><ol><li>cup</li><li>chair</li></ol><br><i>verb</i><br><ol><li>to cover, to conceal, to hide</li></ol>
כספא|כַּסְפָּא|kaspā|כְּסַף	<i>noun</i><br><ol><li>silver</li><li>money</li></ol>
כף|כַּף|kap̄	<i>noun</i><br><ol><li>absolute state of כַּפָּא (kappā, “palm”)</li></ol>
כפא|כַּפָּא|כַּף|kappā|כַּפֵּי|כַּפַּיָּא|כַּפִּין	<i>noun</i><br><ol><li>palm, hand</li><li>spoon, ladle</li><li>bundle, bunch, sheaf, handful</li></ol>
כפורא|כפורתא	<i>noun</i><br><ol><li>pagan, heathen</li><li>unbeliever, infidel</li><li>denier, apostate</li><li>camphor</li></ol>
כפורתא|כפורא	<i>noun</i><br><ol><li>pagan, heathen</li><li>unbeliever, infidel</li><li>denier, apostate</li></ol>
כפינא	<i>adj</i><br><ol><li>hungry</li></ol>
כפינתא|כפינא	<i>adj</i><br><ol><li>hungry</li></ol>
כפן|כְפַּן|câpēn	<i>verb</i><br><ol><li>to hunger</li></ol>
כפנא	<i>noun</i><br><ol><li>hunger, famine</li></ol>
כפר|kp̄ar|כְּפַר|יִכְפַּר|כְפַר	<i>verb</i><br><ol><li>to deny, to renounce</li><li>to wipe out, to efface</li></ol><br><i>noun</i><br><ol><li>absolute state of כַּפְרָא (kap̄rā, “village; tomb”)</li></ol>
כפרא|כְּפָרָא|כַּפְרָא|כַּפְרֵא|kp̄ārā|kap̄rā	<i>noun</i><br><ol><li>(Palestine) hamlet, village</li><li>(Nabataean) tomb, sepulcher</li><li>(Jewish Babylonian Aramaic) smearing</li></ol>
כפש	<i>verb</i><br><ol><li>to supplicate</li></ol>
כרא	<i>verb</i><br><ol><li>to be short</li><li>to be sad</li></ol>
כרה	<i>verb</i><br><ol><li>to weaken, to make sick</li></ol>
כרז	<i>verb</i><br><ol><li>to preach, to proclaim</li></ol>
כרטיסא	<i>noun</i><br><ol><li>paper, papyrus</li><li>document, deed</li><li>sheet</li></ol>
כריא	<i>adj</i><br><ol><li>short</li></ol>
כריהא	<i>adj</i><br><ol><li>weak, sick</li></ol>
כריהתא|כריהא	<i>adj</i><br><ol><li>weak, sick</li></ol>
כריסטינותא	<i>name</i><br><ol><li>Christianity</li></ol>
כריתא|כריא	<i>adj</i><br><ol><li>short</li></ol>
כרכא|karḵā|כְּרָכָא|כִּרְכָּא|כַּרְכָא|kərāḵā|kirkā	<i>noun</i><br><ol><li>walled city or town, fortress</li><li>enclosure</li><li>codex, volume, scroll</li><li>large mat</li></ol>
כרם|כָּּרַם|כְּרָם|krām|kāram	<i>verb</i><br><ol><li>to prune</li></ol><br><i>noun</i><br><ol><li>absolute state of כַּרְמָא (karmā)</li></ol>
כרמא|כַּרְמָא|karmā|כַּרְמַיָּא	<i>noun</i><br><ol><li>vineyard</li></ol>
כרסא|karsā|כרסתא	<i>noun</i><br><ol><li>(anatomy) belly, womb, uterus</li></ol>
כרעא|כרעא	<i>noun</i><br><ol><li>butter</li><li>breastmilk</li><li>(anatomy) shank, shin</li></ol>
כרתא|כרותא|כרתא	<i>noun</i><br><ol><li>(anatomy) thumb</li><li>bundle</li><li>burden, load</li><li>leek</li></ol>
כשט	<i>verb</i><br><ol><li>to shoot, to aim</li></ol>
כתב|kəṯaḇ|כְּתַב	<i>verb</i><br><ol><li>to write</li></ol>
כתבא	<i>noun</i><br><ol><li>writing, scripture, book</li></ol>
כתבונא	<i>noun</i><br><ol><li>booklet, pamphlet</li></ol>
כתבתא	<i>noun</i><br><ol><li>handwriting</li><li>autograph, signature</li></ol>
כתיבא	<i>adj</i><br><ol><li>written</li></ol>
כתיבתא|כתיבא	<i>adj</i><br><ol><li>written</li></ol>
כתנא	<i>noun</i><br><ol><li>linen, flax</li></ol>
כתפא|כתפתא	<i>noun</i><br><ol><li>(anatomy) shoulder</li></ol>
כתר	<i>verb</i><br><ol><li>to wait, to remain</li></ol>
ל־|ליה	<i>prep</i><br><ol><li>to, for</li><li>(Babylonian Talmudic) Forms the direct object.</li></ol>
לא|לָא|lā	<i>adv</i><br><ol><li>no, not</li></ol>
לבא|לבותא|libbā	<i>noun</i><br><ol><li>heart</li></ol>
לבונתא	<i>noun</i><br><ol><li>frankincense</li></ol>
לבושא	<i>noun</i><br><ol><li>clothing, garment</li></ol>
לביה|lbyh	<i>noun</i><br><ol><li>lioness</li></ol>
לבלבא|לַבְלְבִין|לַבְלְבָא	<i>noun</i><br><ol><li>bloom, blossom</li></ol>
לבנתא|lbenttā|לבנא	<i>noun</i><br><ol><li>brick, adobe</li></ol>
לבש|ləḇaš	<i>verb</i><br><ol><li>to clothe oneself, to wear clothing</li></ol>
לגיונא	<i>noun</i><br><ol><li>legion</li></ol>
לגינא|לְגִינָא|ləḡīnā	<i>noun</i><br><ol><li>amphora, pitcher</li><li>flask, bottle</li></ol>
להל	<i>adv</i><br><ol><li>beyond, thither</li></ol>
לוזא|lūzā	<i>noun</i><br><ol><li>almond</li><li>almond tree</li></ol>
לוחא	<i>noun</i><br><ol><li>board, tablet</li></ol>
לויתן	<i>noun</i><br><ol><li>leviathan</li></ol>
לוקא	<i>name</i><br><ol><li>(biblical) Luke</li></ol>
לוש|לוּשׁ|lōš	<i>verb</i><br><ol><li>to knead, to mix, to weld</li></ol>
לות	<i>prep</i><br><ol><li>to, toward</li><li>at, with</li></ol>
לחוד	<i>adv</i><br><ol><li>alone</li><li>only, solely, just</li></ol>
לחמא|לַחְמָא|laḥmā	<i>noun</i><br><ol><li>bread</li><li>food</li></ol>
לחש|l'ħāş|לְחַשׁ	<i>verb</i><br><ol><li>to whisper</li><li>charm</li></ol>
לחשא	<i>noun</i><br><ol><li>whisper, murmur</li></ol>
ליא	<i>name</i><br><ol><li>(biblical) Leah</li></ol>
ליכא|lēkkā|לֵיכָּא	<i>particle</i><br><ol><li>(Jewish Palestinian Aramaic, Jewish Babylonian Aramaic) there is not, there are not</li></ol>
לילא|לליא	<i>noun</i><br><ol><li>nights</li></ol>
ליליא|לֵילְיָא|lēləyā|לֵילָוָתָא	<i>noun</i><br><ol><li>night</li></ol>
לישא|layšā	<i>noun</i><br><ol><li>dough</li><li>kneading</li></ol>
לית|לֵית|lēṯ	<i>prep</i><br><ol><li>there is not, there are not</li><li>(with ל־ (lə-)) not to have</li></ol>
לכא	<i>adv</i><br><ol><li>here, hither</li></ol>
לכסיקון|לכסיקא	<i>noun</i><br><ol><li>lexicon, dictionary</li></ol>
למא	<i>conj</i><br><ol><li>why</li></ol>
לסטא|לִסְטָא|לִסְטֵא|lesṭā	<i>noun</i><br><ol><li>robber, bandit</li></ol>
לסטיא|לִסְטָיֵא|leṣtāyā|לִסְטָיָא	<i>noun</i><br><ol><li>robber, bandit</li></ol>
לעזא	<i>noun</i><br><ol><li>sound</li><li>speech, utterance, pronunciation</li><li>tongue, language, dialect</li></ol>
לעיסא	<i>adj</i><br><ol><li>chewed</li></ol>
לעיסתא|לעיסא	<i>adj</i><br><ol><li>chewed</li></ol>
לעס	<i>verb</i><br><ol><li>to chew, to dine</li></ol>
לעסא	<i>noun</i><br><ol><li>chewing</li></ol>
לקנא	<i>noun</i><br><ol><li>dish, platter</li><li>basin</li></ol>
לשן	<i>verb</i><br><ol><li>to pronounce, to sound</li></ol>
לשנא|liššānā|לשן	<i>noun</i><br><ol><li>(anatomy) tongue</li><li>language</li><li>pronunciation</li></ol>
מא|ma|maʾ|מה	<i>pron</i><br><ol><li>what</li></ol>
מאא|m’ā’	<i>num</i><br><ol><li>hundred</li></ol>
מאי|מַאי	<i>pron</i><br><ol><li>(Jewish Babylonian Aramaic) what, why</li></ol>
מאמרא	<i>noun</i><br><ol><li>speech, diction</li></ol>
מאנא	<i>noun</i><br><ol><li>vessel</li><li>instrument, tool, utensil</li><li>garment</li></ol>
מאתא|ma’tā’	<i>num</i><br><ol><li>hundred</li></ol>
מאתין	<i>num</i><br><ol><li>two hundred</li></ol>
מאתן	<i>num</i><br><ol><li>two hundred</li></ol>
מבועא	<i>noun</i><br><ol><li>fountain, spring</li></ol>
מגדלא	<i>noun</i><br><ol><li>tower</li></ol>
מגלתא|מגלא	<i>noun</i><br><ol><li>sickle</li><li>parchment, scroll</li></ol>
מדבחא|madbḥā	<i>noun</i><br><ol><li>altar</li></ol>
מדברא	<i>noun</i><br><ol><li>desert, wilderness</li></ol>
מדברנותא	<i>noun</i><br><ol><li>direction, steering</li><li>guidance, leadership</li><li>administration, government</li><li>authority</li><li>prudence</li></ol>
מדין	<i>conj</i><br><ol><li>therefore, then</li></ol>
מדינתא|מְדִינָתָא|מְדִינְתָּא|məḏīntā	<i>noun</i><br><ol><li>province</li><li>country</li><li>city</li></ol>
מדנחא	<i>noun</i><br><ol><li>east</li></ol>
מדע	<i>verb</i><br><ol><li>to know, to understand</li></ol>
מדעא	<i>noun</i><br><ol><li>knowledge, intelligence, intellect</li></ol>
מדרשא|מִדְרְשַׁיָּא|מִדְרְשָׁא|miḏrəšā	<i>noun</i><br><ol><li>Midrash</li></ol>
מהירא	<i>adj</i><br><ol><li>skilled</li></ol>
מהירתא|מהירא	<i>adj</i><br><ol><li>skilled</li></ol>
מהר	<i>verb</i><br><ol><li>to learn, to excel, to be practiced</li></ol>
מובלא	<i>noun</i><br><ol><li>burden, load</li><li>cargo</li><li>duty</li></ol>
מוהבתא	<i>noun</i><br><ol><li>gift, present</li><li>favour/favor</li></ol>
מוחא	<i>noun</i><br><ol><li>(anatomy) brain</li><li>(anatomy) marrow</li></ol>
מולדא	<i>noun</i><br><ol><li>birth, nativity</li><li>travail, childbirth, delivery</li><li>new moon</li></ol>
מומא	<i>noun</i><br><ol><li>defect</li><li>spot, blemish, mark</li></ol>
מון	<i>pron</i><br><ol><li>what</li></ol>
מורא	<i>noun</i><br><ol><li>myrrh</li></ol>
מושא	<i>name</i><br><ol><li>(biblical) Moses</li></ol>
מותא	<i>noun</i><br><ol><li>death</li></ol>
מותבא	<i>noun</i><br><ol><li>site, settlement, location</li><li>habitation</li><li>seat</li></ol>
מזתא|מזא	<i>noun</i><br><ol><li>(anatomy) single hair</li></ol>
מחא	<i>verb</i><br><ol><li>to hit, to strike</li></ol>
מחזיתא|מחזיא	<i>noun</i><br><ol><li>example</li><li>mirror</li></ol>
מחטא	<i>noun</i><br><ol><li>needle</li></ol>
מחר	<i>adv</i><br><ol><li>tomorrow</li></ol>
מחשבתא	<i>noun</i><br><ol><li>thought, idea</li><li>reasoning, intention, purpose</li></ol>
מטא	<i>verb</i><br><ol><li>to arrive, to reach</li></ol>
מטול|מִּטּוּל|miṭṭūl	<i>conj</i><br><ol><li>because</li></ol>
מטללא	<i>noun</i><br><ol><li>roof, shelter</li></ol>
מטלתא|מטלא	<i>noun</i><br><ol><li>booth, hut, tabernacle</li></ol>
מטר|miṭrā	<i>verb</i><br><ol><li>to rain</li></ol>
מטרא|מִטְרָא|מְטַר	<i>noun</i><br><ol><li>rain</li></ol>
מטרקא|mṭrqʾ	<i>noun</i><br><ol><li>(Jewish Babylonian Aramaic) goad, whip, device for driving livestock</li></ol>
מי	<i>adv</i><br><ol><li>Marks a yes/no question.</li></ol>
מיא|mayyā|מַיָּא	<i>noun</i><br><ol><li>water</li></ol>
מיהו	<i>adv</i><br><ol><li>however, but, nonetheless</li></ol>
מית|mīṯ|מִית	<i>verb</i><br><ol><li>to die</li></ol>
מיתא	<i>adj</i><br><ol><li>dead</li></ol>
מיתתא|מיתא	<i>adj</i><br><ol><li>dead</li></ol>
מכיכא	<i>adj</i><br><ol><li>gentle, humble</li></ol>
מכיכתא|מכיכא	<i>adj</i><br><ol><li>gentle, humble</li></ol>
מלא|מלתא	<i>noun</i><br><ol><li>words</li><li>things, matter</li><li>(grammar) verbs</li><li>(grammar) voices</li></ol><br><i>verb</i><br><ol><li>to fill, to be filled</li><li>to be complete</li></ol>
מלאכא|מַלְאָךְ|מַלְאֲכָא|malʾăḵā|מַלְאָכַיָּא|מַלְאָכֵי|מַלְאָכִין	<i>noun</i><br><ol><li>angel</li><li>messenger</li></ol>
מלח|melaḥ|מַלַח|מְלַח|מֶלַח|mālaḥ|mlaḥ|məlaḥ	<i>verb</i><br><ol><li>to salt</li><li>to steer, to guide, to sail</li></ol><br><i>noun</i><br><ol><li>absolute state of מִלְחָא (milḥā, “salt”)</li></ol>
מלחא|מִלְחָא|מִלְחֵא|milḥa|מַלָּחָא|מַלָּחֵא|mallāḥā	<i>noun</i><br><ol><li>salt</li><li>sailor</li></ol>
מליחא	<i>adj</i><br><ol><li>salty</li></ol>
מליחתא|מליחא	<i>adj</i><br><ol><li>salty</li></ol>
מלכא|מַלְכֵי|מֶלֶךְ|מַלְכַּיָּא|מַלְכָּא|מַלְכִין|מְלֵיךְ|malkā|מַלְכְתָא|מַלְכַיָּא	<i>noun</i><br><ol><li>king</li></ol>
מלכותא|מַלְכוּת|מַלְכְוָתָא|מַלְכוּ|malḵūṯā|מַלְכוּתָא	<i>noun</i><br><ol><li>kingship</li><li>reign, rule</li><li>kingdom</li><li>realm</li></ol>
מלכתא|malkā|מַלְכֵי|מַלכַּת|מַלְכָת|מַלְכַּיָּא|מֶלֶךְ|מַלְכְּתָא|מלכא|מַלְכָּא|מַלְכִין|מַלְכָתָא|מְלֵיךְ|מַלְכָן|מַלְכָּה|מַלְכְתָא|מַלְכַיָּא|malkəṯā	<i>noun</i><br><ol><li>queen (female monarch)</li></ol>
מלל	<i>verb</i><br><ol><li>to speak</li></ol>
מלפנא|מלפניתא	<i>noun</i><br><ol><li>teacher</li></ol>
מלפניתא|מלפנא	<i>noun</i><br><ol><li>teacher</li></ol>
מלפפון|מִלְפִּפּוֹנַיָא|milpipon	<i>noun</i><br><ol><li>muskmelon, melon</li></ol>
מלתא|מלא	<i>noun</i><br><ol><li>word</li><li>thing, matter</li><li>(grammar) verb</li><li>(grammar) voice</li></ol>
ממונא|מָמוֹנָא|māmōnā	<i>noun</i><br><ol><li>money</li><li>wealth, riches</li></ol>
ממללא	<i>noun</i><br><ol><li>speech, talk</li><li>discourse</li><li>eloquence</li></ol>
מן|מִן|מַן|man|min	<i>prep</i><br><ol><li>from</li></ol><br><i>conj</i><br><ol><li>since, after</li><li>because</li></ol><br><i>pron</i><br><ol><li>who (interrogative)</li></ol>
מנא|מָנַיָּא|mənā|mannā|מְנֵא|mānā|מָנָא|מַנָּא	<i>verb</i><br><ol><li>to count, to number</li></ol><br><i>noun</i><br><ol><li>(Jewish Palestinian Aramaic) mina, maund (a unit of weight)</li><li>(Jewish Palestinian Aramaic) manna</li></ol>
מנדע|mandaʿ|מַנְדַּע	<i>noun</i><br><ol><li>knowledge</li></ol>
מני|mannī|מַנִּי	<i>verb</i><br><ol><li>to appoint</li></ol>
מניא|manyā|מָנְיָא|מְנֵא	<i>noun</i><br><ol><li>mina</li></ol>
מנינא	<i>noun</i><br><ol><li>number</li><li>(grammar) number</li></ol>
מנרתא	<i>noun</i><br><ol><li>candlestick</li><li>lighthouse</li><li>minaret</li></ol>
מנתא|מְנָתָא|מְנָוָתָא|mənāṯā	<i>noun</i><br><ol><li>part, portion, deal, share</li></ol>
מסאתא	<i>noun</i><br><ol><li>balance, scales</li></ol><br><i>name</i><br><ol><li>(astrology) Libra</li></ol>
מסכן	<i>verb</i><br><ol><li>to be poor</li></ol>
מסכנא	<i>adj</i><br><ol><li>poor</li></ol>
מסכנותא	<i>noun</i><br><ol><li>poverty</li></ol>
מסכנתא|מסכנא	<i>adj</i><br><ol><li>poor</li></ol>
מסכתא|מַסֶּכְתָּא	<i>noun</i><br><ol><li>text</li><li>treatise</li><li>(Talmudic) tractate</li></ol>
מסנא	<i>noun</i><br><ol><li>shoe, sandal</li></ol>
מספרא	<i>noun</i><br><ol><li>scissors, shears</li></ol>
מעיא	<i>noun</i><br><ol><li>(anatomy) bowel, intestine</li></ol>
מעינא|מעינתא	<i>noun</i><br><ol><li>fountain, well</li><li>source</li></ol>
מעלא	<i>noun</i><br><ol><li>entrance</li><li>return</li><li>beginning, commencement</li></ol>
מעלתא	<i>noun</i><br><ol><li>entrance, entryway</li><li>inroad, incursion, invasion</li><li>introduction, preface</li><li>induction, inauguration</li><li>crop, produce</li></ol>
מערבא	<i>noun</i><br><ol><li>west</li></ol>
מפקתא	<i>noun</i><br><ol><li>departure, exodus</li><li>version, edition</li></ol>
מצא	<i>verb</i><br><ol><li>to be able</li></ol>
מציעא	<i>adj</i><br><ol><li>middle</li><li>mediocre, average</li></ol>
מציעתא|מציעא	<i>adj</i><br><ol><li>middle</li><li>mediocre, average</li></ol>
מצעתא	<i>noun</i><br><ol><li>midst, middle, centre/center</li></ol>
מצרין	<i>name</i><br><ol><li>Egypt</li></ol>
מקרי	
מרא|מרותא|mrā|מריא|מרתא|mārā	<i>noun</i><br><ol><li>lord, master, ruler</li><li>owner</li><li>pickaxe</li></ol><br><i>verb</i><br><ol><li>to imitate, to emulate</li></ol>
מרגניתא	<i>noun</i><br><ol><li>pearl, jewel, gem</li></ol>
מרומא	<i>noun</i><br><ol><li>height</li></ol>
מריא|מרותא|māryā|מרא|מרתא|mārā	<i>name</i><br><ol><li>Lord; the Christian concept of God and Jesus. Used to represent the Tetragrammaton.</li></ol><br><i>noun</i><br><ol><li>lords, masters, rulers</li><li>owners</li></ol>
מרים|maryám	<i>name</i><br><ol><li>Miriam, Mary (biblical figures)</li></ol>
מרירא	<i>adj</i><br><ol><li>bitter</li></ol>
מרירתא|מרירא	<i>adj</i><br><ol><li>bitter</li></ol>
מרע	<i>verb</i><br><ol><li>to be sick</li></ol>
מרעא	<i>noun</i><br><ol><li>sickness</li></ol><br><i>adj</i><br><ol><li>sick, ill</li></ol>
מרעיתא	<i>noun</i><br><ol><li>pasture, flock</li><li>diocese</li></ol>
מרעתא|מרעא	<i>adj</i><br><ol><li>sick, ill</li></ol>
מרקוס|Marqōs	<i>name</i><br><ol><li>(biblical) Mark</li></ol>
מררתא	<i>noun</i><br><ol><li>(anatomy) gall bladder</li></ol>
מרתא|מרותא|מרא|מריא|מרתא|mārā	<i>noun</i><br><ol><li>lady, mistress, ruler</li><li>owner</li><li>bitterness</li><li>gall, bile, humour/humor</li></ol><br><i>name</i><br><ol><li>(biblical) Martha</li></ol>
משבא	<i>noun</i><br><ol><li>breeze, wind</li><li>breath</li><li>bellows</li></ol>
משח|m'šaḥ|מְשַׁח	<i>verb</i><br><ol><li>to anoint</li><li>to measure</li></ol>
משחא|משחנא	<i>noun</i><br><ol><li>oil, ointment, salve</li></ol>
משיחא|M'šīḥāʾ|מְשִׁיחָא|משיחיא|m'šīḥāʾ|מְשִׁיחַיָּא	<i>noun</i><br><ol><li>Messiah</li></ol><br><i>adj</i><br><ol><li>anointed</li></ol>
משיחתא|m'šīḥāʾ|משיחיא|משיחא	<i>adj</i><br><ol><li>anointed</li><li>Messiah, Christ (attributive)</li></ol>
משליא|mašlyā	<i>noun</i><br><ol><li>fork</li></ol>
משמע|מַשְׁמָע|mashmá'	<i>noun</i><br><ol><li>The first simple meaning of a word or passage, as per its sound; the basic fundamental meaning without the consideration of other relations.</li></ol>
מתא|māṯā|מתתא|מתותא	<i>noun</i><br><ol><li>home</li><li>homeland, birthplace</li><li>village, town</li><li>region</li></ol>
מתי	<i>name</i><br><ol><li>(biblical) Matthew</li></ol>
מתל	<i>verb</i><br><ol><li>to compare</li></ol>
מתלא	<i>noun</i><br><ol><li>parable, proverb</li><li>tale, fable</li><li>myth</li></ol>
מתקולתא|מתקוליתא	<i>noun</i><br><ol><li>scale, weight, balance</li></ol>
נבא	<i>verb</i><br><ol><li>to prophesy</li></ol>
נביא|נְבִיתָא|נְבִיָּא|nəḇiyyā	<i>noun</i><br><ol><li>prophet</li></ol>
נביתא|נְבִיתָא|נְבִיָּא|נביא|nəḇiyyā	<i>noun</i><br><ol><li>prophetess</li></ol>
נגרא	<i>noun</i><br><ol><li>carpenter</li></ol>
נדוניא	<i>noun</i><br><ol><li>dowry</li></ol>
נהירא	<i>adj</i><br><ol><li>bright, clear</li></ol>
נהירתא|נהירא	<i>adj</i><br><ol><li>bright, clear</li></ol>
נהר	<i>verb</i><br><ol><li>to light, to shine</li></ol>
נהרא|נהרותא|nahrā’	<i>noun</i><br><ol><li>river</li></ol>
נוהרא|נוהרא	<i>noun</i><br><ol><li>light, brightness</li><li>enlightenment, illumination</li><li>commentary</li></ol>
נוח	<i>name</i><br><ol><li>(biblical) Noah</li></ol>
נונא|נוּנָא|nūne|nūnā	<i>noun</i><br><ol><li>fish</li></ol><br><i>name</i><br><ol><li>(astrology) Pisces</li></ol>
נוסא	<i>noun</i><br><ol><li>temple, shrine</li></ol>
נורא|נורותא|נורא|nūrā’	<i>noun</i><br><ol><li>fire</li><li>mirror</li></ol>
נושקתא	<i>noun</i><br><ol><li>kiss</li></ol>
נחירא	<i>noun</i><br><ol><li>(anatomy) nostril, nose</li></ol>
נחלא	<i>noun</i><br><ol><li>torrent</li><li>wadi, gully</li><li>gorge, valley</li></ol>
נחם|nᵊḥam|נְחַם	<i>verb</i><br><ol><li>to comfort</li><li>to raise (the dead)</li></ol>
נחש	<i>verb</i><br><ol><li>to divine</li></ol>
נחשא|נחשא	<i>noun</i><br><ol><li>copper</li><li>any alloy of copper (bronze, brass, etc.)</li><li>augury, divination</li><li>augur, diviner</li><li>brazier (brass worker)</li></ol>
נחת	<i>verb</i><br><ol><li>to descend</li></ol>
נטל|יִטּוֹל|נְטַל|nəṭal	<i>verb</i><br><ol><li>to raise, lift, take up</li><li>to set out, travel</li></ol>
נטר	<i>verb</i><br><ol><li>to guard, to protect</li></ol>
ניהו|נינהו|ניהי|נינהי|nīhū	<i>pron</i><br><ol><li>(Jewish Babylonian Aramaic, copulative) (he/it) is</li></ol>
ניחא	<i>noun</i><br><ol><li>quiet, calm, peacefulness</li><li>rest, ease, relief</li><li>pleasure, satisfaction</li></ol>
ניחתא	<i>noun</i><br><ol><li>leisure, rest, recreation</li></ol>
נילוס	<i>name</i><br><ol><li>Nile</li></ol>
נינוא	<i>name</i><br><ol><li>Nineveh</li></ol>
ניסן|nēsɑn	<i>name</i><br><ol><li>Nisan: the seventh month of the Jewish calendar (of thirty days), after Adar and before Iyar.</li></ol>
נישא	<i>noun</i><br><ol><li>sign, banner</li><li>aim, goal, objective</li></ol>
נכלא	<i>noun</i><br><ol><li>guile, deceit, treachery</li></ol>
נכף	<i>verb</i><br><ol><li>to be modest, to be bashful</li></ol>
נכרי	<i>verb</i><br><ol><li>to alienate, to estrange</li></ol>
נכת	<i>verb</i><br><ol><li>to bite, to sting</li></ol>
נמוסא|נמוסא	<i>noun</i><br><ol><li>law, ordinance</li><li>nome, prefecture</li></ol>
נמרא|נמרתא	<i>noun</i><br><ol><li>leopard</li></ol>
נמרתא|נמרא	<i>noun</i><br><ol><li>leopardess</li></ol>
ננעא	<i>noun</i><br><ol><li>Mentha (mint)</li></ol>
נסא	<i>verb</i><br><ol><li>to tempt</li><li>to attempt, to try, to experiment</li></ol>
נסב	<i>verb</i><br><ol><li>to take, to receive</li></ol>
נסיונא	<i>noun</i><br><ol><li>temptation, trial</li></ol>
נענע	<i>noun</i><br><ol><li>Mentha (mint)</li></ol>
נפח|nāp̄aḥ|נָפַח|nəp̄aḥ|נְפַח	<i>verb</i><br><ol><li>to blow, to exhale to breathe</li></ol>
נפטא	<i>noun</i><br><ol><li>naphtha, petroleum</li></ol>
נפל	<i>verb</i><br><ol><li>to fall, to collapse</li></ol>
נפק|nəpaq|נְפַק|יִפּוֹק	<i>verb</i><br><ol><li>to go out, to depart, to leave</li><li>to eject</li></ol>
נפשא|נפשתא	<i>noun</i><br><ol><li>soul, life, self</li></ol>
נצב	<i>verb</i><br><ol><li>to plant</li></ol>
נצרת	<i>name</i><br><ol><li>Nazareth (a city in northern Israel)</li></ol>
נקא	<i>verb</i><br><ol><li>to cleanse, to be pure</li></ol>
נקבתא|דִּכְרֵי|דִּכְרָא|דכרייא|diḵraʾ|דכר|דִּכְרַיָּא|דִּכְרִין|דיכרא|דְּכַר|דכרא	<i>noun</i><br><ol><li>female</li></ol><br><i>adj</i><br><ol><li>female, feminine</li></ol>
נקיא|נקותא|כבשא	<i>noun</i><br><ol><li>ewe (female sheep)</li></ol>
נקף	<i>verb</i><br><ol><li>to adhere, to attach</li></ol>
נקש	<i>verb</i><br><ol><li>to knock (on a door)</li></ol>
נרגא	<i>noun</i><br><ol><li>axe</li></ol>
נרקיס	<i>noun</i><br><ol><li>narcissus, daffodil</li></ol>
נשא	<i>verb</i><br><ol><li>to bear, to carry</li></ol>
נשק	<i>verb</i><br><ol><li>to kiss</li></ol>
נשקא	<i>noun</i><br><ol><li>kissing</li></ol>
נשרא|nišrā’	<i>noun</i><br><ol><li>eagle</li></ol>
סאמא|sēmā|סָאמָא	<i>noun</i><br><ol><li>silver</li></ol>
סבא|סָבָא|סָבַיָּא|סָבְתָא|sāḇā	<i>noun</i><br><ol><li>old man, grandfather</li></ol>
סבע	<i>verb</i><br><ol><li>to satisfy</li></ol>
סבר|סָבַר|sāḇar|סְבַר|sḇār|סְבָר|sḇar|סֽבַר	<i>verb</i><br><ol><li>to show a bright face towards, to be favourable towards</li><li>to hope, to expect, to look out for</li><li>to endure, to sustain, to bear</li><li>to consider, to regard, to look on; to have a notion to think, to understand</li><li>to perforate, to cut</li></ol><br><i>noun</i><br><ol><li>absolute state of סַבְרָא (saḇrā, “hope”)</li><li>absolute state of סִבְרָא (seḇrā, “consideration, regard; belief”)</li><li>absolute state of סְבָרָא (sḇārā, “perspicacity, discernment; countenance”)</li><li>absolute state of סָבְרָא (sāḇərā, “teacher, scholar”)</li></ol>
סברא|סִבְרָא|sāḇərā|state סְבָר|סַבְרָא|sḇārā|סְבָרָא|seḇrā|saḇrā|state סֽבַר|state סָבַר|סָבְרָא	<i>noun</i><br><ol><li>hope; trust, confidence</li><li>consideration, regard, belief, conjecture, supposition, opinion</li><li>perspicacity, discernment; countenance</li><li>fine teacher, scholar</li></ol>
סבתא|סָבָא|sāḇəṯā|סָבְתָא|סָבָתָא	<i>noun</i><br><ol><li>old woman, grandmother</li></ol>
סגא	<i>verb</i><br><ol><li>to increase, to multiply</li><li>to be great, to be numerous</li></ol>
סגד	<i>verb</i><br><ol><li>to worship</li><li>to bow down</li></ol>
סגיאא	<i>adj</i><br><ol><li>much, many, numerous</li></ol>
סגיאתא|סגיאא	<i>adj</i><br><ol><li>much, many, numerous</li></ol>
סדינא	<i>noun</i><br><ol><li>oak</li></ol>
סדנא|sadnā|sedānā|saddānā	<i>noun</i><br><ol><li>foundation</li></ol>
סדרא	<i>noun</i><br><ol><li>grade, rank</li><li>order, row</li><li>classroom</li></ol>
סהד	<i>verb</i><br><ol><li>to witness</li><li>to suffer martyrdom</li></ol>
סהדא|סהדתא	<i>noun</i><br><ol><li>martyr</li><li>witness</li></ol>
סהדותא	<i>noun</i><br><ol><li>testimony</li><li>martyrdom</li></ol>
סהדתא|סהדא	<i>noun</i><br><ol><li>martyr</li><li>witness</li></ol>
סהרא	<i>noun</i><br><ol><li>moon</li></ol>
סודרא	<i>noun</i><br><ol><li>cloth, towel, handkerchief</li></ol>
סוך	<i>verb</i><br><ol><li>to end, to finish</li></ol>
סוכא	<i>noun</i><br><ol><li>branch, bough, twig</li></ol>
סוכלא	<i>noun</i><br><ol><li>understanding, sense</li></ol>
סום	<i>verb</i><br><ol><li>to put, to place</li></ol>
סומק|סוּמַּק|summaq	<i>adj</i><br><ol><li>red</li></ol>
סוסיא|סוסתא|סוסיתא|סוסותא|sūsyā	<i>noun</i><br><ol><li>horse</li></ol>
סוסתא|סוסיתא|סוסיא|סוסותא|sūsyā	<i>noun</i><br><ol><li>horse, mare</li></ol>
סופא|sōp̄ā|סוֹפָא	<i>noun</i><br><ol><li>limit, end, edge</li></ol>
סוריא	<i>name</i><br><ol><li>Syria</li></ol>
סחא	<i>verb</i><br><ol><li>to swim</li><li>to wash, to bathe</li></ol>
סטנא|sāṭānā	<i>noun</i><br><ol><li>adversary</li><li>devil</li></ol><br><i>name</i><br><ol><li>Satan, the Devil</li></ol>
סיטרא אחרא|סִיטְרָא אַחְרָא	<i>noun</i><br><ol><li>"the other side"; the opposite of the holy side.</li><li>(Kabbalah) the forces of evil which underlie all of reality, born from imbalance in flows of holy plenty that is caused largely by the sins of humans.</li></ol>
סיפא|סַיְפָּא|סְיָיפִּין|סְיָפֵין|סַיְפֵּא|saypā|sēp̄ā|סֵיפָא	<i>noun</i><br><ol><li>end, distant region</li><li>sword, blade</li></ol>
סיפתא|סִיפְוָותָא|סִיפְתָּא|סִיפְתָתָא|sip̄tā	<i>noun</i><br><ol><li>lip</li><li>brim, edge, border, ledge</li><li>shore, bank</li></ol>
סכא|סכתא|סכא	<i>noun</i><br><ol><li>end, limit</li><li>sum</li><li>pins, pegs</li><li>nails, stakes</li><li>wedges</li><li>ploughshares/plowshares</li></ol><br><i>verb</i><br><ol><li>to wait, to expect</li></ol>
סכינא|סכינתא|סכיניתא	<i>noun</i><br><ol><li>knife, dagger</li></ol>
סכל	<i>verb</i><br><ol><li>to do wrong, to behave foolishly</li><li>to understand</li></ol>
סכלא|סכלתא	<i>noun</i><br><ol><li>fool</li><li>foolishness, stupidity</li></ol><br><i>adj</i><br><ol><li>foolish, stupid</li></ol>
סכלתא|סכלא	<i>noun</i><br><ol><li>fool</li></ol><br><i>adj</i><br><ol><li>foolish, stupid</li></ol>
סכתא|סכא	<i>noun</i><br><ol><li>pin, peg</li><li>nail, stake</li><li>wedge</li><li>ploughshare/plowshare</li></ol>
סלק	<i>verb</i><br><ol><li>to ascend, to go up</li></ol>
סמא|סממנא|סמנא	<i>noun</i><br><ol><li>drug, medicine</li><li>poison</li></ol>
סמי	<i>verb</i><br><ol><li>to be blind</li></ol>
סמלא	<i>noun</i><br><ol><li>left (direction)</li></ol>
סנא	<i>verb</i><br><ol><li>to hate</li></ol>
סני	<i>verb</i><br><ol><li>to hate</li></ol>
סניא	<i>noun</i><br><ol><li>bush, shrub, thorn</li></ol><br><i>adj</i><br><ol><li>hated, detestable</li></ol>
סניתא|סניא	<i>adj</i><br><ol><li>hated, detestable</li></ol>
סנק	<i>verb</i><br><ol><li>to lack, to need</li></ol>
ססא	<i>noun</i><br><ol><li>moth</li><li>maggot, worm</li><li>decay, rottenness</li></ol>
סערא|סערא	<i>noun</i><br><ol><li>(anatomy) hair</li><li>barley</li></ol>
ספד|סְפַד|səfad	<i>verb</i><br><ol><li>lament, mourn</li></ol>
ספדא|סָפְדַּיָּא|סָפְדָּא	<i>noun</i><br><ol><li>mourner</li></ol>
ספינתא|סְפִינֵא|סְפִינִתָּא|sǝp̄īntā|סְפִינָתָא	<i>noun</i><br><ol><li>ship</li></ol>
ספיקא	<i>adj</i><br><ol><li>empty</li></ol>
ספיקתא|ספיקא	<i>adj</i><br><ol><li>empty</li></ol>
ספנא	<i>noun</i><br><ol><li>captain of a ship</li><li>ship-builder</li></ol>
ספסרא|סַפְסָרָא|סַפְסֵרָא|sap̄sārā|sap̄sērā	<i>noun</i><br><ol><li>sword, blade</li><li>broker, agent</li><li>huckster</li><li>gabble</li><li>fable, fiction</li></ol>
ספק	<i>verb</i><br><ol><li>to be sufficient</li><li>to be empty, to be cleaned out</li></ol>
ספר	<i>verb</i><br><ol><li>to shave</li><li>to narrate</li></ol>
ספרא|səp̄ārā|sāp̄ərā|סָפַרְתָּא|סַפָּרְתָא|סַפָּרָא|sappārā|ספרי|סִפְרָא|סָפְרָא|sip̄rā	<i>noun</i><br><ol><li>scribe, writer</li><li>barber</li><li>book</li><li>document, scroll</li><li>shore, coast</li><li>riverbank</li></ol>
ספרתא|sāp̄artā|סָפַרְתָּא|סַפָּרְתָא|סַפָּרָא|סָפְרָתָא|סַפָּרָתָא|סָפְרָא|sappārəṯā	<i>noun</i><br><ol><li>scribe, writer</li><li>barber</li></ol>
סקא	<i>noun</i><br><ol><li>sackcloth</li><li>sack, bag</li></ol>
סרא	<i>name</i><br><ol><li>(biblical) Sarah/Sara</li></ol>
סרט	<i>verb</i><br><ol><li>to scratch</li><li>to draw (produce a picture)</li></ol>
סרטא|סרטא	<i>noun</i><br><ol><li>line</li><li>scratch, gash</li><li>letter, character, tittle</li><li>incision</li><li>writing</li></ol>
סרטנא	<i>noun</i><br><ol><li>crab</li><li>cancer (disease)</li></ol><br><i>name</i><br><ol><li>(astrology) Cancer</li></ol>
סריק|סָרֵיק|סְרִיקִין	<i>adj</i><br><ol><li>empty, void</li></ol>
סריקתא|סריקא	<i>adj</i><br><ol><li>empty, void</li></ol>
סרק	<i>verb</i><br><ol><li>to comb</li><li>to empty</li></ol>
סתוא	<i>noun</i><br><ol><li>winter</li><li>storm</li></ol>
עבד	<i>verb</i><br><ol><li>to do, to make</li><li>to serve, to slave</li></ol>
עבדא|עבדא	<i>noun</i><br><ol><li>servant, slave</li><li>labour/labor, work</li></ol>
עבדו|עֲבַדוּ	<i>verb</i><br><ol><li>they did</li></ol>
עבדותא	<i>noun</i><br><ol><li>servitude, slavery, bondage</li></ol>
עבט	<i>verb</i><br><ol><li>to be thick</li></ol>
עבידא	<i>adj</i><br><ol><li>done, made</li><li>served, slaved</li></ol>
עבידתא|עבידא	<i>adj</i><br><ol><li>done, made</li><li>served, slaved</li></ol>
עבר|ʿāḇar	<i>verb</i><br><ol><li>to pass over, to cross over</li></ol>
עגן	<i>verb</i><br><ol><li>to cast down</li></ol>
עד	<i>conj</i><br><ol><li>until</li><li>while</li></ol><br><i>prep</i><br><ol><li>until</li></ol>
עדה|עֵדָה	<i>noun</i><br><ol><li>a group or meeting (particularly for purposes of worship or judicial matters); congregation; assembly; prayer meeting</li></ol>
עדות|עֵדוּת	<i>noun</i><br><ol><li>testimony, report (of a witness)</li></ol>
עדמא	<i>conj</i><br><ol><li>until</li></ol>
עדן	<i>noun</i><br><ol><li>time, duration, year</li></ol>
עדנא	<i>noun</i><br><ol><li>moment</li><li>time, age</li></ol>
עדר	<i>verb</i><br><ol><li>to help, to aid</li></ol>
עדתא	<i>noun</i><br><ol><li>church, congregation</li><li>assembly</li></ol>
עהד	<i>verb</i><br><ol><li>to remember, to be mindful</li></ol>
עובא	<i>noun</i><br><ol><li>(anatomy) bosom, breast</li><li>lap</li></ol>
עוד	<i>adv</i><br><ol><li>certainly, indeed</li></ol><br><i>verb</i><br><ol><li>to accustom, to habituate</li></ol>
עוזא	<i>noun</i><br><ol><li>energy, fervour</li><li>strength, force</li><li>vehemence, violence</li></ol>
עוירא	<i>adj</i><br><ol><li>blind</li></ol>
עוירתא|עוירא	<i>adj</i><br><ol><li>blind</li></ol>
עול	<i>verb</i><br><ol><li>to harm, to wrong</li></ol>
עולא|עולא	<i>noun</i><br><ol><li>fetus, embryo</li><li>young child, infant</li><li>injustice</li></ol><br><i>adj</i><br><ol><li>unjust</li></ol>
עולתא|עולא	<i>adj</i><br><ol><li>unjust</li></ol>
עומק|עֹמֶק	<i>noun</i><br><ol><li>depth, profoundness</li></ol>
עומקא	<i>noun</i><br><ol><li>depth, deepness</li><li>foundation, the earth under a building</li></ol>
עוקברתא|עוקברא|עוקברתא	<i>noun</i><br><ol><li>mouse</li><li>(anatomy) muscle</li></ol>
עור	<i>verb</i><br><ol><li>to blind</li></ol>
עורבא	<i>noun</i><br><ol><li>crow, raven</li></ol>
עותרא	<i>noun</i><br><ol><li>wealth, opulence</li></ol>
עזא|תישא	<i>noun</i><br><ol><li>goat</li></ol>
עזז	<i>verb</i><br><ol><li>to be strong, mighty</li><li>to groan</li></ol>
עזיזא	<i>adj</i><br><ol><li>strong, powerful, vehement</li><li>intense</li></ol>
עזיזתא|עזיזא	<i>adj</i><br><ol><li>strong, powerful, vehement</li><li>intense</li></ol>
עזקתא|עִזְקְתָא|ʿizqəṯā|עִזְקָתָא	<i>noun</i><br><ol><li>ring</li></ol>
עטל	<i>verb</i><br><ol><li>to be difficult, to be stubborn</li></ol>
עטלא	<i>adj</i><br><ol><li>difficult, stubborn</li></ol>
עטלתא|עטלא	<i>adj</i><br><ol><li>difficult, stubborn</li></ol>
עטמא|עטמתא	<i>noun</i><br><ol><li>(anatomy) thigh, hip</li></ol>
עטרא	<i>noun</i><br><ol><li>vapour/vapor, fume</li></ol>
עיבא|עֵיבָא|ʕēḇā	<i>noun</i><br><ol><li>rain cloud</li></ol>
עינא|עין|עַיִן|ʿēnā|עינתא|עֵינָא	<i>noun</i><br><ol><li>eye; sight</li><li>(by extension) eye, hole, opening</li><li>fountain, spring</li></ol>
עינוג|עִינּוּג|ʿinnūḡ	<i>noun</i><br><ol><li>pleasure; sweetness</li></ol>
עיקא	<i>adj</i><br><ol><li>narrow</li></ol>
עיקתא|עיקא	<i>adj</i><br><ol><li>narrow</li></ol>
עכביתא|עַכָּבִיתֵי|עַכָּבִיתָא|עַכָּבִיתִין|עַכָּבִיתַיָּא|ʿakkāḇīṯā|עַכָּבִית	<i>noun</i><br><ol><li>spider</li></ol>
על	<i>prep</i><br><ol><li>on, upon</li><li>over</li><li>about, concerning</li></ol>
עלא	<i>verb</i><br><ol><li>to raise, to ascend</li></ol>
עליא	<i>adj</i><br><ol><li>upper</li><li>supreme, highest</li></ol>
עליתא|עליא	<i>noun</i><br><ol><li>An upper story, chamber, or room.</li><li>rising, elevation, promotion</li></ol><br><i>adj</i><br><ol><li>upper</li><li>supreme, highest</li></ol>
עלל	<i>verb</i><br><ol><li>to enter</li><li>to bring, to lead</li></ol>
עלמא|עָלַם|עָלְמָא|ʿāləmā|עָלְמַיָּא	<i>noun</i><br><ol><li>eternity, forever</li><li>world</li><li>nation, people</li></ol>
עלתא|עללתא|עלותא	<i>noun</i><br><ol><li>cause, reason, pretext</li><li>occasion</li><li>offering, sacrifice</li><li>altar</li></ol>
עם|ʿam|ʕim|עממין	<i>noun</i><br><ol><li>people, nation</li></ol><br><i>prep</i><br><ol><li>with</li></ol>
עמא|עַמָּא|ʿammā|עמתא|עמא|עַמְּמַיָא|עם|עַמְּמֵי|ʿam|עממתא|עַמְּמַיָּא|עַם|עַמְּמִין|עממין	<i>noun</i><br><ol><li>people, nation</li><li>folk</li><li>paternal uncle</li><li>great-grandfather</li><li>father's sister</li></ol>
עמד	<i>verb</i><br><ol><li>to sink</li><li>to baptize</li></ol>
עמודא	<i>noun</i><br><ol><li>pillar, column</li></ol>
עמט	<i>verb</i><br><ol><li>to darken, to obscure</li></ol>
עמיקא	<i>adj</i><br><ol><li>deep</li></ol>
עמיקתא|עמיקא	<i>adj</i><br><ol><li>deep</li></ol>
עמירא	<i>noun</i><br><ol><li>grass, hay, fodder</li></ol>
עממא|עַמָּא|ʿammā|עַמְּמַיָא|ʿam|עם|עַמְּמֵי|עַמְּמַיָּא|עמא|עַם|עַמְּמִין|עממין	<i>noun</i><br><ol><li>peoples, nations</li></ol>
עמץ	<i>verb</i><br><ol><li>to close/shut the eyes, to be blinded</li></ol>
עמק	<i>verb</i><br><ol><li>to be deep</li></ol>
עמקא|עִמְקַיָּא|עִמְקָא	<i>noun</i><br><ol><li>valley</li></ol>
עמר	<i>noun</i><br><ol><li>wool</li></ol><br><i>verb</i><br><ol><li>to dwell, to inhabit</li></ol>
עמתא|עַמָּא|ʿammā|עַמְּמַיָא|ʿam|עם|עַמְּמֵי|עַמְּמַיָּא|עממתא|עמא|עַם|עַמְּמִין|עממין	<i>noun</i><br><ol><li>paternal aunt</li></ol>
ענא|ʿānā|עָנָא	<i>noun</i><br><ol><li>(collective) flock of sheep and goats</li><li>(collective) sheep (as opposed to goats)</li></ol><br><i>verb</i><br><ol><li>to answer, to respond</li><li>to be busy, to be occupied</li></ol>
ענבתא|עִנְבַּיָּא|עִנְבְּתָא|ʿinbəṯā	<i>noun</i><br><ol><li>grape</li><li>berry</li></ol>
ענד	<i>verb</i><br><ol><li>to depart, to cease</li></ol>
עננא|ʕnānā|עֲנָנֵא|עֲנָנָא	<i>noun</i><br><ol><li>cloud</li></ol>
עסבא|עִסְבֵּי|עֵסֶב|עִסְבַּיָּא|עִסְבִּין|עִסְבָּא	<i>noun</i><br><ol><li>plant, herb, grass</li></ol>
עסק	<i>verb</i><br><ol><li>to be difficult, to be troublesome</li></ol>
עסקא	<i>adj</i><br><ol><li>difficult, troublesome, perverse</li></ol>
עסקתא|עסקא	<i>adj</i><br><ol><li>difficult, troublesome, perverse</li></ol>
עסר|ʿăsar	<i>num</i><br><ol><li>ten (10)</li></ol>
עסרא|ʿasrā	<i>num</i><br><ol><li>ten (10)</li></ol>
עסרין	<i>num</i><br><ol><li>twenty (20)</li></ol>
עפרא	<i>noun</i><br><ol><li>soil, dust</li></ol>
עצר	<i>verb</i><br><ol><li>to trample</li><li>to squeeze, to press</li></ol>
עקב	<i>verb</i><br><ol><li>to search, to investigate</li><li>to trip (literally "to hold by the heel")</li></ol>
עקבא|עקבתא	<i>noun</i><br><ol><li>footprint</li><li>(anatomy) heel</li></ol>
עקבתא|עקבא	<i>noun</i><br><ol><li>footprints</li><li>(anatomy) heels</li></ol>
עקיבא|עֲקִיבָא|ʿăqīḇā	<i>name</i><br><ol><li>Rabbi Akiva ben Joseph, a major figure in Jewish history, a tanna of the late first century and early second century who contributed to the Mishnah and Midrash Halakha</li></ol>
עקרא	<i>adj</i><br><ol><li>barren, sterile</li></ol><br><i>noun</i><br><ol><li>extractor</li><li>extirpation, eradication</li><li>tooth extraction</li><li>germination</li><li>root, stump, shoot (of a plant)</li><li>origin, stock</li><li>herb</li></ol>
עקרבא|‘eqarbā	<i>noun</i><br><ol><li>scorpion</li></ol><br><i>name</i><br><ol><li>(astrology) Scorpio</li></ol>
עקרתא|עקרא	<i>adj</i><br><ol><li>barren, sterile</li></ol>
ערא	<i>noun</i><br><ol><li>tamarix/tamarisk</li><li>intensity</li></ol><br><i>verb</i><br><ol><li>to contain, to hold</li><li>to comprehend</li><li>to seize</li></ol>
ערב	<i>verb</i><br><ol><li>to set, to go down</li><li>to pledge</li><li>to sift</li></ol>
ערבא|ערבתא|ערבא	<i>noun</i><br><ol><li>cup, measure</li><li>water wheel</li><li>sponsor, guarantor</li><li>godfather</li><li>security</li><li>sheep</li><li>sunset</li><li>willows (trees)</li></ol>
ערבתא|ˁarbtā|ערבתא|ערבא	<i>noun</i><br><ol><li>sponsor, guarantor</li><li>godmother</li><li>willow (tree)</li></ol>
ערובתא|ערובתתא|עֲרוּבְתָּא	<i>noun</i><br><ol><li>eve</li><li>day of preparation</li><li>Friday</li></ol>
ערסא|ערסתא	<i>noun</i><br><ol><li>bed</li></ol>
ערפלא|‘arpelā	<i>noun</i><br><ol><li>fog, mist</li><li>gloom, darkness</li></ol>
ערק|יִערוֹק|ʿăraq|עֲרַק	<i>verb</i><br><ol><li>to flee, to escape</li></ol>
עשינא	<i>adj</i><br><ol><li>strong, powerful</li></ol>
עשינתא|עשינא	<i>adj</i><br><ol><li>strong, powerful</li></ol>
עשן	<i>verb</i><br><ol><li>to overcome, to prevail</li></ol>
עשק	<i>verb</i><br><ol><li>to oppress</li><li>to accuse</li></ol>
עשרין	<i>num</i><br><ol><li>twenty</li></ol>
עתד	<i>verb</i><br><ol><li>to ready, to prepare</li></ol>
עתידא|עָתִידַת|עָתִידְתָא|עָתִיד|עָתִידִי|עָתִידָן|עָתִידָת|עָתִידַיָּא|עָתִידִין|עָתִידָא|עָתִידָה|עָתִידֵי|עָתִידָתָא	<i>adj</i><br><ol><li>ready, prepared</li></ol>
עתידתא|עָתִידַת|עתידא|עָתִידְתָא|עָתִיד|עָתִידִי|עָתִידָן|עָתִידָת|עָתִידַיָּא|עָתִידִין|עָתִידָא|עָתִידָה|עָתִידֵי|עָתִידָתָא	<i>adj</i><br><ol><li>ready, prepared</li></ol>
עתיק|ʿattīq|עַתִּיק	<i>adj</i><br><ol><li>old, ancient</li></ol>
עתיקא|עַתִּיקָא|ʿattīqā	<i>adj</i><br><ol><li>Emphatic state of of עַתִּיק (ʿattīq)</li></ol>
עתיקותא	<i>noun</i><br><ol><li>antiquity, oldness</li><li>old age</li></ol>
עתיקתא|עתיקא|עַתִּיקָא|ʿattīqā	<i>adj</i><br><ol><li>old, ancient</li></ol>
עתירא	<i>adj</i><br><ol><li>wealthy, rich</li></ol>
עתירותא	<i>noun</i><br><ol><li>wealth, opulence, richness</li></ol>
עתירתא|עתירא	<i>adj</i><br><ol><li>wealthy, rich</li></ol>
עתק	<i>verb</i><br><ol><li>to be old, to grow old</li></ol>
עתר	<i>verb</i><br><ol><li>to be wealthy, to be rich</li></ol>
פאתא|פָּוָותָא|pāṯā|פָּאתָא	<i>noun</i><br><ol><li>face, cheek</li><li>side, edge, corner</li></ol>
פגרא	<i>noun</i><br><ol><li>(anatomy) body, flesh</li><li>corpse, carcass</li></ol>
פדגוגא|פְּדָגוֹגִין|פְּדָגוֹגָא|פַּדְגּוּגְתָּא	<i>noun</i><br><ol><li>pedagogue, tutor, governor</li></ol>
פדנא	<i>noun</i><br><ol><li>plough/plow</li><li>yoke (of oxen)</li><li>field, acre</li></ol>
פולוס	<i>name</i><br><ol><li>(biblical) Paul</li></ol>
פומא	<i>noun</i><br><ol><li>(anatomy) mouth</li></ol>
פוריא|pūrayyā|פּוּרַיָּא	<i>name</i><br><ol><li>Purim</li></ol>
פטקא|peṭqā	<i>noun</i><br><ol><li>ticket</li><li>memorandum, letter</li></ol>
פילא|פִּילְתָא|pīlā|פִּילָא	<i>noun</i><br><ol><li>elephant</li></ol>
פילוסופא|pīlōsōp̄ā|פִּילוֹסוֹפָא	<i>noun</i><br><ol><li>philosopher</li></ol>
פילתא|פִּילְתָא|pīlā|פילא|פִּילָא	<i>noun</i><br><ol><li>elephant</li></ol>
פינכא	<i>noun</i><br><ol><li>dish, platter</li></ol>
פיס	<i>verb</i><br><ol><li>to persuade, to convince</li></ol>
פיסא	<i>noun</i><br><ol><li>persuasion, persuasiveness</li></ol>
פלג	<i>verb</i><br><ol><li>to divide, to part, to separate</li></ol>
פלגא|פלגא	<i>noun</i><br><ol><li>half, middle</li><li>division</li><li>drum, tambourine</li></ol>
פלח	<i>verb</i><br><ol><li>to work, to labour/labor</li></ol>
פלחא|פלחא|פלחתא|פלחותא	<i>noun</i><br><ol><li>servant, attendant</li><li>worshipper</li><li>artisan</li><li>soldier</li><li>worker</li><li>tiller, cultivator, farmer</li></ol>
פלחתא|פלחא|פלחתא|פלחותא	<i>noun</i><br><ol><li>servant, attendant</li><li>worshipper</li><li>artisan</li><li>soldier</li><li>worker</li><li>tiller, cultivator, farmer</li></ol>
פלט	<i>verb</i><br><ol><li>to eject, to escape</li></ol>
פלסף	<i>verb</i><br><ol><li>to philosophize</li></ol>
פלפלא	<i>noun</i><br><ol><li>pepper (fruit)</li></ol>
פנא	<i>verb</i><br><ol><li>to reply, to answer</li><li>to return, to give back</li></ol>
פנטקוסטא	<i>name</i><br><ol><li>Pentecost</li></ol>
פסוקא	<i>noun</i><br><ol><li>paragraph, verse</li><li>part, section</li><li>(typography) period, full stop</li></ol>
פסק	<i>verb</i><br><ol><li>to cut off, to break away</li></ol>
פעל	<i>verb</i><br><ol><li>to work</li></ol>
פעלא|פעלא|פעלתא	<i>noun</i><br><ol><li>work, labour/labor</li><li>worker, labourer/laborer</li></ol>
פעלתא|פעלא	<i>noun</i><br><ol><li>worker, labourer/laborer</li></ol>
פערא	<i>noun</i><br><ol><li>chasm, gap, cleft</li></ol>
פצא	<i>verb</i><br><ol><li>to save, to rescue</li></ol>
פקד|pqad	<i>verb</i><br><ol><li>to command</li></ol>
פקע|פַּקַּע|פְּקַע	<i>verb</i><br><ol><li>to split, to crack, to burst</li><li>to break</li></ol>
פקעא|פקעא	<i>noun</i><br><ol><li>frog</li><li>crack, rift, fissure</li><li>noise, crash</li><li>thunderbolt</li></ol>
פרדיסא|pardaysā|פַּרְדַּיְסָא|פַּרְדֵּיסָא|פַּרְדֵּס|pardēsā	<i>noun</i><br><ol><li>park, garden, orchard</li></ol>
פרזלא|parzəlā|פַּרְזְלָא	<i>noun</i><br><ol><li>iron</li></ol>
פרח|פְּרַח|pəraḥ	<i>verb</i><br><ol><li>to fly</li><li>to waste, to squander</li></ol>
פרחא|פִּרְחַיָּיא|פִּרְחָא|pirḥā|פרח|pəraḥ|פְּרַח	<i>noun</i><br><ol><li>flower</li></ol>
פרם	<i>verb</i><br><ol><li>to cut apart, to split</li></ol>
פרנס	<i>verb</i><br><ol><li>to provide, to supply</li></ol>
פרס|פָּרָס|פְּרַס|pārās|p’ras|pəras	<i>verb</i><br><ol><li>to divide</li><li>to spread</li></ol><br><i>name</i><br><ol><li>Persia, the Persians</li></ol>
פרסא|parsā|פְּרֵס|פַּרְסָא	<i>noun</i><br><ol><li>a half-unit, such as a half-shekel or half-mina</li></ol>
פרפר	<i>name</i><br><ol><li>Pharpar river</li></ol>
פרצופא	<i>noun</i><br><ol><li>aspect</li><li>face, countenance</li><li>person, individual</li><li>(grammar) person</li></ol>
פרק	<i>verb</i><br><ol><li>to unload, to dismantle</li><li>to deliver, to depart</li><li>to redeem</li></ol>
פרש	<i>verb</i><br><ol><li>to separate, cut off</li></ol>
פרת|פְּרָת|pəraṯ|pərāṯ|פְּרַת	<i>verb</i><br><ol><li>to burst, split</li></ol><br><i>name</i><br><ol><li>Euphrates</li></ol>
פש|פָּשׁ|pāš	<i>verb</i><br><ol><li>to stay, remain</li></ol>
פשיטא	<i>adj</i><br><ol><li>simple</li><li>upright</li></ol>
פשיטתא|פשיטא	<i>adj</i><br><ol><li>simple</li><li>upright</li></ol>
פשירא	<i>adj</i><br><ol><li>melted, dissolved</li></ol>
פשירתא|פשירא	<i>adj</i><br><ol><li>melted, dissolved</li></ol>
פשכא	<i>noun</i><br><ol><li>handbreadth</li><li>(anatomy) palm</li></ol>
פשל	<i>verb</i><br><ol><li>to twist</li></ol>
פשר	<i>verb</i><br><ol><li>to interpret, to explain</li><li>to melt, to dissolve</li></ol>
פשרא|pəšārā|pišrā|פְּשָׁרָא|פִּשְׁרָא	<i>noun</i><br><ol><li>interpretation, explanation</li><li>melting</li><li>digestion, rumination</li></ol>
פתגמא|פִּתְגָמָא|פִּתְגָמַיָּא|piṯḡāmā	<i>noun</i><br><ol><li>word</li><li>saying, phrase</li><li>verse, paragraph, text</li><li>matter, thing, affair</li></ol>
פתורא|פָּתוּרֵא|pāṯūrā|פָּתוּרָא	<i>noun</i><br><ol><li>table</li></ol>
פתח|פְּתַח|pəṯaḥ	<i>verb</i><br><ol><li>to open</li></ol>
פתחא	<i>noun</i><br><ol><li>opening, gate</li><li>(grammar) vowel equivalent to /æ/</li></ol>
פתיחא	<i>adj</i><br><ol><li>open</li></ol>
פתיחתא|פתיחא	<i>adj</i><br><ol><li>open</li></ol>
פתילא|פְּתִילָא|ptīlā	<i>adj</i><br><ol><li>twisted, spun</li></ol><br><i>noun</i><br><ol><li>twisted cord, string, wick</li></ol>
פתילתא|ptīlā|ptīltā|פְּתִילֽתָּא|פתילא|פְּתִילָא	<i>adj</i><br><ol><li>twisted, spun</li></ol><br><i>noun</i><br><ol><li>twisted cord, string, wick</li></ol>
פתכר	<i>noun</i><br><ol><li>statue, idol</li></ol>
פתל|pātal|פָּתַל	<i>verb</i><br><ol><li>to twist, to spin</li></ol>
פתלא	<i>noun</i><br><ol><li>twisting, spinning</li></ol>
צאתא	<i>noun</i><br><ol><li>filth, dirt</li></ol>
צבא	<i>verb</i><br><ol><li>to desire, to will, to wish</li></ol>
צבינא	<i>noun</i><br><ol><li>desire, will</li></ol>
צבע|צְבַע|ṣəbaʿ	<i>verb</i><br><ol><li>to dip</li><li>to moisten</li><li>to dye, to colour/color</li></ol>
צבעא|צבעא|צבעתא	<i>noun</i><br><ol><li>(anatomy) finger, toe, digit</li><li>dye, pigment</li><li>dyer</li></ol>
צדד	<i>verb</i><br><ol><li>to behold</li></ol>
צדיקא|ṣadīqāʾ|צַדִּיקַיָּא|צַדִּיקֵי|צַדִּיקִין|צַדִּיקָא|צַדִּיק	<i>noun</i><br><ol><li>a saintly or righteous person: tzadik.</li></ol>
צוד	<i>verb</i><br><ol><li>to hunt, to fish, to catch</li></ol>
צום	<i>verb</i><br><ol><li>to fast, to abstain</li></ol>
צומא	<i>noun</i><br><ol><li>fast</li></ol>
צורא|ṣawrā|צְוַר|צַוְרָא	<i>noun</i><br><ol><li>(anatomy) neck</li></ol>
צורתא	<i>noun</i><br><ol><li>picture, image, form</li></ol>
צות	<i>verb</i><br><ol><li>to hear, to listen</li><li>to obey</li></ol>
צחק|צְחַק	<i>verb</i><br><ol><li>laugh</li></ol>
ציד	<i>prep</i><br><ol><li>with</li><li>at, near</li></ol>
צידא|צידא	<i>noun</i><br><ol><li>hunting, fishing</li><li>hunter, fisherman</li></ol>
צירא|צירא	<i>noun</i><br><ol><li>painting, picture</li><li>An artist's tool (pen, pencil, stylus, brush, chisel, etc.)</li><li>painter, sculptor, artist</li></ol>
צלא	<i>verb</i><br><ol><li>to pray</li><li>to bend down (to pray)</li></ol>
צלב|tsaláv	<i>verb</i><br><ol><li>to crucify, to be crucified</li></ol>
צלותא	<i>noun</i><br><ol><li>prayer</li></ol>
צליבא	<i>noun</i><br><ol><li>crucifix, cross</li></ol>
צפח	<i>verb</i><br><ol><li>to surprise</li><li>to fall on</li></ol>
צפרא|צפרותא|צפרא	<i>noun</i><br><ol><li>morning</li><li>sparrow, finch</li></ol>
צפתא|צפא	<i>noun</i><br><ol><li>care</li><li>anxiety, worry</li><li>stone, setting (of a ring)</li><li>mat</li></ol>
צרא	<i>verb</i><br><ol><li>to split, to tear, to rip</li></ol>
צרח	<i>verb</i><br><ol><li>to shout, to exclaim</li></ol>
צרף	<i>verb</i><br><ol><li>to refine, to smelt</li></ol>
קבורא|קבורא	<i>noun</i><br><ol><li>sepulture/sepulchre/sepulcher, tomb</li><li>gravedigger, sexton</li></ol>
קבורתא	<i>noun</i><br><ol><li>burial, funeral</li></ol>
קבירא	<i>adj</i><br><ol><li>buried, interred</li></ol>
קבירתא|קבירא	<i>adj</i><br><ol><li>buried, interred</li></ol>
קבל	<i>verb</i><br><ol><li>to oppose</li><li>to allow, to accept, to receive</li></ol>
קבע	<i>verb</i><br><ol><li>to fix, to fasten</li></ol>
קבר|qavar	<i>verb</i><br><ol><li>to bury, to inter</li></ol>
קברא	<i>noun</i><br><ol><li>grave, tomb</li></ol>
קדיש|קַדִּישַׁת|קַדִּישׁ|קַדִּישָׁת|קַדִּישָׁן|קַדִּישְׁתָא|קַדִּישִׁי|qaddīš|קַדִּישִׁין|קַדִּישֵׁי|קַדִּישָׁה|קַדִּישַׁיָּא|קַדִּישָׁתָא|קַדִּישָׁא	<i>adj</i><br><ol><li>holy</li></ol>
קדלא	<i>noun</i><br><ol><li>(anatomy) neck, nape</li></ol>
קדם|qəḏam|qŏḏām|קֳדָם	<i>verb</i><br><ol><li>to precede, to come before</li></ol><br><i>prep</i><br><ol><li>before, in front of</li></ol>
קדמי|קָדָמַי	<i>prep</i><br><ol><li>before me: first-person singular suffix form of קדם</li></ol>
קדמיא	<i>adj</i><br><ol><li>first</li></ol>
קדמיתא|קדמיא	<i>adj</i><br><ol><li>first</li></ol>
קדש	<i>verb</i><br><ol><li>to sanctify, to be holy</li></ol>
קהוא	<i>noun</i><br><ol><li>coffee</li></ol>
קודשא	<i>noun</i><br><ol><li>holiness</li><li>consecration, dedication</li><li>oblation, Eucharist</li></ol>
קודשא בריך הוא|ḳuḏšā bərīḵ hū|קֻדְשָׁא בְּרִיךְ הוּא	<i>name</i><br><ol><li>(Judaism) the Holy One, blessed be He (a euphemism for God)</li></ol>
קומתא	<i>noun</i><br><ol><li>stature, stance</li></ol>
קופא	<i>noun</i><br><ol><li>monkey, ape</li><li>pole, bar</li></ol>
קופדא|קופדא	<i>noun</i><br><ol><li>porcupine, hedgehog</li><li>cutlet, chop (of meat)</li><li>long staff</li></ol>
קורבא	<i>noun</i><br><ol><li>nearness</li><li>offering, oblation</li><li>approach, access</li></ol>
קורבנא	<i>noun</i><br><ol><li>offering, oblation</li><li>sacrifice</li><li>Eucharist</li><li>gift</li></ol>
קטילא	<i>adj</i><br><ol><li>killed, murdered</li></ol>
קטילתא|קטילא	<i>adj</i><br><ol><li>killed, murdered</li></ol>
קטל|qəṭal	<i>verb</i><br><ol><li>to kill, to murder, to slaughter</li></ol>
קטלא	<i>noun</i><br><ol><li>kill, murder, slaughter</li></ol>
קטמא|קטמא	<i>noun</i><br><ol><li>ash, ashes</li><li>slice, section</li><li>slicing, lopping</li></ol>
קטע|qṭaʿ|יִקְטַע|קְטַע	<i>verb</i><br><ol><li>to cut</li></ol>
קיטא|qēṭā|קֵיטָא|קֵיטַיָּא	<i>noun</i><br><ol><li>summer</li></ol>
קיניא	<i>noun</i><br><ol><li>smith</li></ol>
קינתא|קיניתא	<i>noun</i><br><ol><li>melody</li><li>tone</li><li>chant, hymn</li><li>(music) metre/meter</li></ol>
קיסא	<i>noun</i><br><ol><li>wood</li><li>stick, stake</li></ol>
קיסונא	<i>noun</i><br><ol><li>stem, twig</li></ol>
קיתרא	<i>noun</i><br><ol><li>any stringed musical instrument (guitar, harp, lyre, etc.)</li></ol>
קלא	<i>noun</i><br><ol><li>voice</li><li>sound, noise</li></ol><br><i>verb</i><br><ol><li>to roast, to fry</li></ol>
קליא	<i>adj</i><br><ol><li>roasted, fried</li></ol>
קלידא	<i>noun</i><br><ol><li>key</li></ol>
קלילא	<i>adj</i><br><ol><li>lightweight</li></ol>
קלילתא|קלילא	<i>adj</i><br><ol><li>lightweight</li></ol>
קליתא|קליא	<i>adj</i><br><ol><li>roasted, fried</li></ol>
קלל	<i>verb</i><br><ol><li>to be lightweight</li><li>to lessen, to lighten</li></ol>
קלס	<i>verb</i><br><ol><li>to praise</li></ol>
קם|קָם|qām	<i>verb</i><br><ol><li>to rise, to stand</li></ol>
קמחא	<i>noun</i><br><ol><li>flour</li></ol>
קנא	<i>noun</i><br><ol><li>nest, rookery</li><li>hive</li><li>brood</li></ol><br><i>verb</i><br><ol><li>to get, to gain, to obtain</li><li>to possess</li></ol>
קנומא|qənōma	<i>noun</i><br><ol><li>person, self, individual</li><li>substance, figure, body</li><li>essence, being, emanation</li><li>(Christianity, theology) hypostasis, substantive reality,</li></ol>
קניא|state קְנֵי|קַנְיָא|qanyā|קְנַיָּא	<i>noun</i><br><ol><li>cane, reed</li><li>straw, stalk</li><li>measuring rod, yardstick</li><li>pen</li></ol>
קנינא	<i>noun</i><br><ol><li>possession, property</li><li>goods, substance</li></ol>
קעא	<i>verb</i><br><ol><li>to shout, to cry out</li></ol>
קפיסא	<i>adj</i><br><ol><li>contracted</li><li>stored, collected, brought together</li></ol>
קפיסתא|קפיסא	<i>adj</i><br><ol><li>contracted</li><li>stored, collected, brought together</li></ol>
קפס	<i>verb</i><br><ol><li>to contract (the muscles)</li><li>to store, to collect, to bring together</li></ol>
קפסא|קפסא	<i>noun</i><br><ol><li>basket</li><li>birdcage</li><li>contraction, convulsion, spasm</li><li>store, storehouse</li><li>(anatomy) ham, hock; haunch</li></ol>
קצא	<i>verb</i><br><ol><li>to break</li></ol>
קצע|קָצַע|qṣaʿ|qāṣaʿ|קְצַע	<i>verb</i><br><ol><li>to cut, to trim</li></ol>
קרא|q'rā	<i>verb</i><br><ol><li>to call</li><li>to read</li></ol>
קרב	<i>verb</i><br><ol><li>to be near, to approach</li><li>to touch</li><li>to fight, to make war</li></ol>
קרבא	<i>noun</i><br><ol><li>war, battle, fighting</li></ol>
קרט	<i>verb</i><br><ol><li>to gnaw, to nibble, to bite</li></ol>
קריבא	<i>adj</i><br><ol><li>near, close</li></ol>
קריבתא|קריבא	<i>adj</i><br><ol><li>near, close</li></ol>
קרירא	<i>adj</i><br><ol><li>cold</li></ol>
קרירתא|קרירא	<i>adj</i><br><ol><li>cold</li></ol>
קרישא	<i>adj</i><br><ol><li>cold, frozen</li></ol>
קרישתא|קרישא	<i>adj</i><br><ol><li>cold, frozen</li></ol>
קריתא|קוריא|קריתא	<i>noun</i><br><ol><li>beam, plank</li><li>locust, infestation</li><li>calling, vocation</li><li>village, town, hamlet</li><li>field</li></ol>
קרנא|קרנתא	<i>noun</i><br><ol><li>horn (growth on heads of animals and musical instrument)</li><li>angle, corner</li></ol>
קרקפתא|קַרְקַפְיַתָא|qarqap̄tā|קַרְקְפַתָא|קַרְקַפְתָּא	<i>noun</i><br><ol><li>skull, head</li></ol>
קרר	<i>verb</i><br><ol><li>to be cold</li></ol>
קרש	<i>verb</i><br><ol><li>to chill, to freeze</li></ol>
קרתא|קִרוֵי|קִרוִין|qartā|קִריָה|קַרתָּא|קִרוַיָּא	<i>noun</i><br><ol><li>city</li><li>town</li></ol>
קשא	<i>verb</i><br><ol><li>to harden</li></ol>
קשיא	<i>adj</i><br><ol><li>rough, hard</li></ol>
קשישא|קשישתא	<i>noun</i><br><ol><li>elder, ancestor</li></ol><br><i>adj</i><br><ol><li>elder</li></ol>
קשישתא|קשישא	<i>noun</i><br><ol><li>elder, ancestor</li></ol><br><i>adj</i><br><ol><li>elder</li></ol>
קשיתא|קשיא	<i>adj</i><br><ol><li>rough, hard</li></ol>
קשתא|קשתתא|קשתא	<i>noun</i><br><ol><li>bow</li><li>rainbow</li><li>archer, bowman</li></ol>
ר־ח־ץ	<i>root</i><br><ol><li>Forming words relating to trust and security.</li></ol>
רבא|רורבא|רבתא|רונא	<i>noun</i><br><ol><li>leader</li></ol><br><i>adj</i><br><ol><li>great, master</li></ol>
רבה|rābaḥ|רַבָּה	<i>adj</i><br><ol><li>big, important</li><li>extensive, extended</li></ol>
רבותא	<i>noun</i><br><ol><li>myriad, ten thousand</li><li>greatness</li></ol>
רבי|רִבִּי|ribbī|רבנא	<i>noun</i><br><ol><li>rabbi, spiritual teacher</li><li>master</li></ol>
רבתא|רבא|רורבא|רונא	<i>noun</i><br><ol><li>leader</li></ol><br><i>adj</i><br><ol><li>great, master</li></ol>
רגג	<i>verb</i><br><ol><li>to desire, to lust</li></ol>
רגגא	<i>noun</i><br><ol><li>desire, desiring</li></ol>
רגז	<i>verb</i><br><ol><li>to be wroth, to be angry</li></ol><br><i>noun</i><br><ol><li>violent anger: rage</li></ol>
רגיגא	<i>adj</i><br><ol><li>desirable, lustful</li></ol>
רגיגתא|רגיגא	<i>adj</i><br><ol><li>desirable, lustful</li></ol>
רגלא|רגלא	<i>noun</i><br><ol><li>(anatomy) leg, foot</li><li>foot soldier</li></ol>
רגם|raw-gam' ragam	<i>verb</i><br><ol><li>to stone</li></ol>
רגתא	<i>noun</i><br><ol><li>desire, lust</li></ol>
רדיא	<i>noun</i><br><ol><li>flow, current</li><li>flux, fusion (of metal)</li><li>march, journey</li><li>running water</li></ol>
רהומא	<i>name</i><br><ol><li>Rome</li></ol>
רהט	<i>verb</i><br><ol><li>to run</li></ol>
רוא	<i>verb</i><br><ol><li>to be drunk</li></ol>
רוז	<i>verb</i><br><ol><li>to rejoice</li></ol>
רוחא|רוחנא|rūḥā|רוחתא|rwāḥā	<i>noun</i><br><ol><li>spirit, ghost</li><li>wind (movement of air)</li><li>breath</li><li>(grammar) vowel equivalent to /o/</li></ol>
רוחקא	<i>noun</i><br><ol><li>distance</li></ol>
רוככא	<i>noun</i><br><ol><li>softening</li><li>(phonetics) aspiration</li></ol>
רומא	<i>noun</i><br><ol><li>height, breadth, size</li></ol>
רומחא	<i>noun</i><br><ol><li>spear, lance</li></ol>
רומנא|רוּמָּנֵא|רוּמָּנָא|rummānā	<i>noun</i><br><ol><li>pomegranate (fruit and tree)</li></ol>
רוקא	<i>noun</i><br><ol><li>saliva, spittle</li></ol>
רזף	<i>verb</i><br><ol><li>to drip, to sprinkle</li></ol>
רחיא|רחותא|raḥyā	<i>noun</i><br><ol><li>mill, millstone</li></ol>
רחימא	<i>adj</i><br><ol><li>beloved</li></ol>
רחימתא|רחימא	<i>adj</i><br><ol><li>beloved</li></ol>
רחיקא	<i>adj</i><br><ol><li>distant, remote, far</li></ol>
רחיקתא|רחיקא	<i>adj</i><br><ol><li>distant, remote, far</li></ol>
רחם	<i>verb</i><br><ol><li>to love</li><li>to be merciful, to be compassionate</li></ol>
רחמא|רחמתא	<i>noun</i><br><ol><li>friend</li><li>mercy, compassion</li><li>(anatomy) intestines, bowels</li></ol>
רחמותא	<i>noun</i><br><ol><li>friendship</li><li>love, kindness</li></ol>
רחמנא	<i>adj</i><br><ol><li>merciful</li></ol>
רחמנותא	<i>noun</i><br><ol><li>mercy</li></ol>
רחמנתא|רחמנא	<i>adj</i><br><ol><li>merciful</li></ol>
רחמתא|רחמא|רחמתא	<i>noun</i><br><ol><li>friend</li><li>love, friendship</li><li>kindness</li></ol>
רחף	<i>verb</i><br><ol><li>to brood</li></ol>
רחק	<i>verb</i><br><ol><li>to go away, to be distant</li></ol>
רטב	<i>verb</i><br><ol><li>to moisten</li></ol>
רטיבא	<i>adj</i><br><ol><li>moist, humid</li></ol>
רטיבתא|רטיבא	<i>adj</i><br><ol><li>moist, humid</li></ol>
ריח	<i>verb</i><br><ol><li>to smell</li></ol>
ריחא|ריחנא	<i>noun</i><br><ol><li>smell, odour/odor</li><li>perfume</li></ol>
ריקא|רֵיקְתָּא|rēqā|רֵיקָא|transliteration needed|רֵיקֵא	<i>adj</i><br><ol><li>empty, void</li><li>vain</li><li>worthless</li></ol><br><i>noun</i><br><ol><li>a vain or worthless person</li></ol>
ריקתא|רֵיקְתָּא|rēqtā	<i>adj</i><br><ol><li>feminine singular emphatic state of רֵיקָא (rēqā)</li></ol>
רירא	<i>noun</i><br><ol><li>saliva, mucus</li></ol>
רישא|ראשא	<i>noun</i><br><ol><li>(anatomy) head</li><li>top, (figuratively) head</li></ol>
רכיכא	<i>adj</i><br><ol><li>soft</li></ol>
רכיכתא|רכיכא	<i>adj</i><br><ol><li>soft</li></ol>
רכך	<i>verb</i><br><ol><li>to soften</li></ol>
רככא	<i>noun</i><br><ol><li>softness, mildness</li></ol>
רכשא|רכשתא	<i>noun</i><br><ol><li>horse, horses</li></ol>
רכשתא|רכשא	<i>noun</i><br><ol><li>horse, horses, mare, mares</li></ol>
רמא|rāmā|רָמָא|rəmā|יִרְמֵי|רמיא|רְמָא	<i>adj</i><br><ol><li>high, tall</li></ol><br><i>noun</i><br><ol><li>height, hill, elevation</li></ol><br><i>verb</i><br><ol><li>to throw, to warp, to cast, to hurl</li><li>to put, to place</li></ol>
רמז	<i>verb</i><br><ol><li>to indicate</li><li>to beckon, to signal</li></ol>
רמכא|רמכא	<i>noun</i><br><ol><li>herd</li><li>herdsman</li></ol>
רמשא|רמשותא	<i>noun</i><br><ol><li>evening</li></ol>
רמתא|רָמָא|rāmā|רמיא|רמא	<i>noun</i><br><ol><li>hill, height, high place</li></ol><br><i>name</i><br><ol><li>Arimathaea</li><li>Ramah</li></ol><br><i>adj</i><br><ol><li>high, tall</li></ol>
רעא	<i>verb</i><br><ol><li>to feed, to graze</li><li>to reconcile</li><li>to think</li></ol>
רעד|r'ad|רְעַד	<i>verb</i><br><ol><li>to tremble</li></ol>
רעיא|רעותא|רעיא	<i>noun</i><br><ol><li>pasture, flock</li><li>shepherd</li></ol>
רעילא	<i>adj</i><br><ol><li>shaken, trembled</li></ol>
רעילתא|רעילא	<i>adj</i><br><ol><li>shaken, trembled</li></ol>
רעל	<i>verb</i><br><ol><li>to shake, to quiver</li></ol>
רעלא|רעלא|reˁlā	<i>noun</i><br><ol><li>shaking, trembling, oscillation</li><li>tremor, earthquake</li></ol>
רעם	<i>verb</i><br><ol><li>to thunder</li></ol>
רעמא	<i>noun</i><br><ol><li>thunder</li></ol>
רפא	<i>verb</i><br><ol><li>to loosen, to soften</li></ol>
רפיא	<i>adj</i><br><ol><li>loose, weak</li></ol>
רפיתא|רפיא	<i>adj</i><br><ol><li>loose, weak</li></ol>
רפף	<i>verb</i><br><ol><li>to wink</li></ol>
רפפא	<i>noun</i><br><ol><li>twitch, jerk</li><li>wink</li><li>instant, moment, second</li></ol>
רקד|rəqaḏ	<i>verb</i><br><ol><li>to dance</li><li>to mourn, to lament</li></ol>
רקדא|רקדא|רקדתא	<i>noun</i><br><ol><li>dance, dancing</li><li>dancer</li><li>mourning, lamentation</li></ol>
רקדתא|רקדא	<i>noun</i><br><ol><li>dancer</li></ol>
רקיעא	<i>noun</i><br><ol><li>firmament</li></ol>
רשא	<i>verb</i><br><ol><li>to blame, to accuse</li></ol>
רשיעא	<i>adj</i><br><ol><li>wicked, impious</li></ol>
רשיעתא|רשיעא	<i>adj</i><br><ol><li>wicked, impious</li></ol>
רשע	<i>verb</i><br><ol><li>to be wicked, to be evil.</li></ol>
רשעא	<i>noun</i><br><ol><li>wickedness, evil, impiety</li></ol>
רתיתא	<i>noun</i><br><ol><li>tremor, trembling</li><li>fear</li></ol>
רתת	<i>verb</i><br><ol><li>to tremble, to rattle</li></ol>
ר׳|r'	<i>noun</i><br><ol><li>R., Reb, Rebbe, Rabbi, Rav, Rabbeinu (title)</li></ol>
ש־כ־ח|sh-k-h	<i>root</i><br><ol><li>Forming words relating to finding.</li></ol>
שאול|šāʾūl|שָׁאוּל	<i>name</i><br><ol><li>(biblical) Saul</li></ol>
שאילא|šəʾīlā|שְׁאִילָא	<i>name</i><br><ol><li>(biblical) Silas</li></ol>
שאל	<i>verb</i><br><ol><li>to ask, to inquire</li><li>to lend, to borrow</li></ol>
שב	<i>num</i><br><ol><li>seven (7)</li></ol>
שבבא|שבבתא|šbābā’	<i>noun</i><br><ol><li>neighbour/neighbor</li></ol>
שבבותא	<i>noun</i><br><ol><li>neighbourhood/neighborhood</li><li>nearness, vicinity</li></ol>
שבבתא|שבבא|šbābā’	<i>noun</i><br><ol><li>neighbour/neighbor</li></ol>
שבועא|שבועתא	<i>noun</i><br><ol><li>week</li></ol>
שבח|šeb̲aḥ|šəb̲aḥ|שֶׁבַח|שְׁבַח	<i>verb</i><br><ol><li>improve, increase in value or quality; make a profit</li><li>praise, glorify</li></ol><br><i>noun</i><br><ol><li>improvement, gain</li></ol>
שבט|šəḇāṭ|שְׁבָט	<i>name</i><br><ol><li>Shevat</li><li>February</li></ol>
שבע	<i>num</i><br><ol><li>seven (7)</li></ol>
שבעא|šabhʿā	<i>num</i><br><ol><li>seven (7)</li></ol>
שבעין	<i>num</i><br><ol><li>seventy (70)</li></ol>
שבעמאא	<i>num</i><br><ol><li>seven hundred</li></ol>
שבעסר	<i>num</i><br><ol><li>seventeen (17)</li></ol>
שבעסרא	<i>num</i><br><ol><li>seventeen (17)</li></ol>
שבק|שַׁבֵּק|sh'vaq|shabbeq|שְׁבַק	<i>verb</i><br><ol><li>to leave, to depart</li><li>to abandon, to leave alone</li><li>to permit, to allow</li><li>divorce</li></ol>
שבת|שַׁבַּת|שְׁבַת|šəḇaṯ|šabbaṯ	<i>verb</i><br><ol><li>rest; observe the Sabbath</li></ol>
שבתא|šabbəṯā|שַׁבְּתָא|שַׁבַּת|שַׁבָּה|šabbattā|שבת|שַׁבַּתָּא|שבא|šabbaṯ	<i>noun</i><br><ol><li>Shabbat, Sabbath, Saturday</li><li>week</li></ol>
שגושיא	<i>noun</i><br><ol><li>disturbance, tumult, commotion</li><li>riot</li></ol>
שגני	<i>verb</i><br><ol><li>to change</li></ol>
שגש	<i>verb</i><br><ol><li>to disturb, to trouble</li></ol>
שדר	<i>verb</i><br><ol><li>to send</li></ol>
שוחדא	<i>noun</i><br><ol><li>bribe</li></ol>
שוחרא	<i>noun</i><br><ol><li>soot, coal</li><li>blackness</li></ol>
שולטנא	<i>noun</i><br><ol><li>power, authority, sway</li><li>rule, government, office</li><li>ruler, commander, prince, sultan</li></ol>
שונרא|שׁוּנְרָא|שונרי|shunra	<i>noun</i><br><ol><li>cat</li></ol>
שופא	<i>noun</i><br><ol><li>place, site</li><li>friction</li><li>polish</li><li>filling</li></ol>
שופיא	<i>noun</i><br><ol><li>grease, lubrication</li></ol>
שופנינא|שופנינתא	<i>noun</i><br><ol><li>turtle dove/turtledove</li></ol>
שופנינתא|שופנינא	<i>noun</i><br><ol><li>turtle dove/turtledove</li></ol>
שופרא	<i>noun</i><br><ol><li>beauty</li><li>fairness, grace, elegance</li></ol>
שוקא	<i>noun</i><br><ol><li>street</li><li>square, plaza, forum</li><li>market, bazaar</li><li>open space</li><li>quarter, district, borough</li></ol>
שור	<i>verb</i><br><ol><li>to jump, to leap</li></ol>
שורא|שורא	<i>noun</i><br><ol><li>wall, fortification, rampart</li><li>(anatomy) navel</li><li>pulley, axle</li></ol>
שוש	<i>verb</i><br><ol><li>to disturb, to disrupt, to confuse</li></ol>
שושא	<i>noun</i><br><ol><li>disorder</li><li>liquorice/licorice</li></ol>
שושנתא|שושנא	<i>noun</i><br><ol><li>lily</li></ol>
שושפא	<i>noun</i><br><ol><li>napkin, handkerchief, towel</li><li>veil, covering</li><li>vestment, robe</li></ol>
שותפותא	<i>noun</i><br><ol><li>participation, partnership, association</li></ol>
שחד	<i>verb</i><br><ol><li>to bribe</li></ol>
שחידא	<i>adj</i><br><ol><li>bribed</li></ol>
שחידתא|שחידא	<i>adj</i><br><ol><li>bribed</li></ol>
שחינא	<i>adj</i><br><ol><li>warm</li></ol>
שחינתא|שחינא	<i>adj</i><br><ol><li>warm</li></ol>
שחן	<i>verb</i><br><ol><li>to warm, to heat</li></ol>
שחנא	<i>noun</i><br><ol><li>heating, warmth</li></ol>
שחת	<i>verb</i><br><ol><li>to rust</li><li>Decay, to corrupt</li></ol>
שחתא|שחותא	<i>noun</i><br><ol><li>(anatomy) armpit</li></ol>
שטח	<i>verb</i><br><ol><li>to spread out</li></ol>
שטיפתא	<i>noun</i><br><ol><li>alabaster container</li></ol>
שיבסר	<i>num</i><br><ol><li>seventeen</li></ol>
שיול|שׁיוּל|Šyūl|šyūl	<i>noun</i><br><ol><li>Sheol, netherworld</li></ol><br><i>name</i><br><ol><li>Sheol</li></ol>
שיזב|šyzb	<i>verb</i><br><ol><li>to save</li></ol>
שישא|שִׁישָׁא|šīšā|שֵׁישָׁא|שישא|šēšā	<i>noun</i><br><ol><li>marble (rock)</li><li>bottle</li></ol>
שישלתא	<i>noun</i><br><ol><li>bond, chain, fetter</li><li>line, series</li></ol>
שית	<i>num</i><br><ol><li>six (6)</li></ol>
שיתא|šittā	<i>num</i><br><ol><li>six (6)</li></ol>
שיתסר	<i>num</i><br><ol><li>sixteen</li></ol>
שכח	<i>verb</i><br><ol><li>to find</li><li>to be capable</li></ol>
שכרא	<i>noun</i><br><ol><li>liquor, spirit</li><li>sugar</li></ol>
שלדא	<i>noun</i><br><ol><li>body, corpse, carcass</li><li>mummy</li></ol>
שלח	<i>verb</i><br><ol><li>to send</li><li>to strip, to take off clothing</li></ol>
שלחא	<i>noun</i><br><ol><li>swarm</li><li>hide, skin</li><li>riverbank</li><li>undressing</li></ol>
שלט|אֶשְׁלוֹט|תִּישְׁלְטוּן|שְׁלַטְנָא|שְׁלַטָן|שְׁלַטְתּוּן|2MS|תִּישְׁלְטִין|נִישְׁלוֹט|שַׁלְטוּ|3MP|2FP|2MP|נִישְׁלְטוּן|שְׁלַטָא|3FS|תִּישְׁלוֹט|2FS|לִישְׁלְטוּן|שְׁלַטְנַן|שְׁלַטַת|שְׁלַטוּ|1CP|שְׁלַטִינַן|שְׁלַטַן|1CS|לִישְׁלוֹט|שַׁלְטָא|3MS|3FP|שְׁלַטִית|שְׁלַטְתְּ|שְׁלַט	<i>verb</i><br><ol><li>to rule, to have power</li></ol>
שליחא	<i>noun</i><br><ol><li>messenger</li><li>missionary, apostle</li></ol><br><i>adj</i><br><ol><li>sent</li><li>naked</li></ol>
שליחותא	<i>noun</i><br><ol><li>mission, apostleship</li><li>nudity</li></ol>
שליחתא|שליחא	<i>adj</i><br><ol><li>sent</li><li>naked</li></ol>
שליטא	<i>adj</i><br><ol><li>ruling, powerful</li></ol>
שליטתא|שליטא	<i>adj</i><br><ol><li>ruling, powerful</li></ol>
שלימון	<i>name</i><br><ol><li>(biblical) Solomon</li></ol>
שלם	<i>verb</i><br><ol><li>to be whole, to be complete</li><li>to follow, to agree</li><li>to obey</li></ol>
שלמא|šlāmā|שְׁלָמָא|שְׁלָמֵי|שְׁלָמַיָּא|שְׁלָמִין|שְׁלָם	<i>intj</i><br><ol><li>A greeting; similar to hello.</li></ol><br><i>noun</i><br><ol><li>peace</li><li>perfection</li><li>wholeness</li><li>health</li><li>welfare, safety</li></ol>
שלף	<i>verb</i><br><ol><li>to peel, to tear off, to slip off</li></ol>
שלפוחתא	<i>noun</i><br><ol><li>(anatomy) bladder</li></ol>
שמא|שְׁמָא|שֻׁם|שׁוֹם|שֵׁם|šəmā|שְׁמָהָתָא	<i>noun</i><br><ol><li>name</li><li>appellation, title</li><li>(grammar) noun</li></ol>
שמט	<i>verb</i><br><ol><li>to draw out</li></ol>
שמי	<i>verb</i><br><ol><li>to name</li></ol>
שמיא|שְׁמֵי|šmayā’|שְׁמַיִן|שְׁמַיָּא	<i>noun</i><br><ol><li>sky</li><li>heaven</li></ol>
שמן	<i>verb</i><br><ol><li>to ripen, to mature</li><li>to be fat</li></ol>
שמע|šəmaʿ|שְׁמַע	<i>verb</i><br><ol><li>to hear</li></ol>
שמש	<i>verb</i><br><ol><li>to serve</li></ol>
שמשא|šemšā|שמשתא|שִׁמְשָׁא|שמשא	<i>noun</i><br><ol><li>sun</li><li>servant</li><li>minister, deacon</li></ol>
שמשנא	<i>adj</i><br><ol><li>solar</li></ol>
שמשנתא|שמשנא	<i>adj</i><br><ol><li>solar</li></ol>
שנא|שנתא|šinnā|שַׁנְתָּא|שניא	<i>noun</i><br><ol><li>(anatomy) tooth</li><li>fang, tusk</li><li>ivory</li></ol>
שניא|שנתא|שַׁנְתָּא	<i>noun</i><br><ol><li>years</li></ol>
שנתא|שניא|שנא|שַׁנְתָּא|שִׁנְתָּא|שנתא|שִׁנָּתָא|šinnā	<i>noun</i><br><ol><li>year</li><li>sleep</li><li>(anatomy) teeth</li><li>tusks, ivory</li></ol>
שעא|שעתא|šāʿəṯā	<i>noun</i><br><ol><li>hours</li></ol><br><i>verb</i><br><ol><li>to play</li><li>to narrate</li><li>to smooth, to plaster</li></ol>
שעותא	<i>noun</i><br><ol><li>wax</li></ol>
שעתא|שעא|šāʿəṯā	<i>noun</i><br><ol><li>hour</li></ol>
שפירא|Shpirā	<i>adj</i><br><ol><li>beautiful</li></ol>
שפירתא|שפירא|Shpirā	<i>adj</i><br><ol><li>beautiful</li></ol>
שפר	<i>verb</i><br><ol><li>to be beautiful</li></ol>
שקיפא	<i>noun</i><br><ol><li>precipice, cliff, crag</li></ol>
שקל	<i>verb</i><br><ol><li>to take, to remove</li></ol>
שרא	<i>verb</i><br><ol><li>to loosen</li><li>to start, to begin</li></ol>
שרבתא	<i>noun</i><br><ol><li>generation, genealogy</li><li>race, nation, tribe</li><li>order, rank</li></ol>
שרותא	<i>noun</i><br><ol><li>meal</li></ol>
שרירא	<i>adj</i><br><ol><li>true</li></ol>
שרירותא	<i>noun</i><br><ol><li>firmness</li><li>sureness, certainty</li><li>reality</li><li>fidelity, steadfastness</li></ol>
שרירתא|שרירא	<i>adj</i><br><ol><li>true</li></ol>
שרף|sraf|שְׂרַף	<i>verb</i><br><ol><li>(transitive) to burn</li></ol>
שרק	<i>verb</i><br><ol><li>to whistle</li></ol>
שרר	<i>verb</i><br><ol><li>to be true, to be sure</li></ol>
שרשא	<i>noun</i><br><ol><li>root</li><li>ground, base, foundation</li><li>beginning</li></ol>
שת	<i>num</i><br><ol><li>six (6)</li></ol>
שתא|šəṯā|שְׁתָא	<i>num</i><br><ol><li>six (6)</li></ol>
שתאסתא|שתאסא	<i>noun</i><br><ol><li>base, bottom</li><li>foundation (of a building)</li></ol>
שתין	<i>num</i><br><ol><li>sixty (60)</li></ol>
שתיקא	<i>adj</i><br><ol><li>silenced, mute</li></ol>
שתיקתא|שתיקא	<i>adj</i><br><ol><li>silenced, mute</li></ol>
שתמאא	<i>num</i><br><ol><li>six hundred</li></ol>
שתעסר	<i>num</i><br><ol><li>sixteen (16)</li></ol>
שתעסרא	<i>num</i><br><ol><li>sixteen (16)</li></ol>
שתק	<i>verb</i><br><ol><li>to silence</li></ol>
תאביל	<i>noun</i><br><ol><li>world, earth</li><li>universe</li></ol>
תאומא	<i>name</i><br><ol><li>(biblical) Thomas</li></ol>
תאמא|תאמתא	<i>noun</i><br><ol><li>twin, double</li><li>(astrology) Gemini</li></ol>
תאנתא|תאנא	<i>noun</i><br><ol><li>fig (fruit)</li><li>fig (tree)</li></ol>
תביל	<i>noun</i><br><ol><li>world, earth</li><li>universe</li></ol>
תגא|תָּגָא|taga	<i>noun</i><br><ol><li>crown, diadem, tiara</li></ol>
תגג	<i>verb</i><br><ol><li>to crown</li></ol>
תגר	<i>verb</i><br><ol><li>to trade</li></ol>
תגרא|תגרתא	<i>noun</i><br><ol><li>trader, merchant</li></ol>
תגרתא|תגרא	<i>noun</i><br><ol><li>trader, merchant</li></ol>
תדא|תדיא	<i>noun</i><br><ol><li>(anatomy) breast, pap</li></ol>
תהר	<i>verb</i><br><ol><li>to marvel, to wonder, to be amazed</li></ol>
תוב|tūḇ|תּוּב	<i>noun</i><br><ol><li>again</li><li>furthermore</li></ol>
תולעא	<i>noun</i><br><ol><li>worm, tapeworm/tape-worm</li></ol>
תומא	<i>noun</i><br><ol><li>garlic</li></ol>
תונא	<i>noun</i><br><ol><li>room, chamber</li></ol>
תור	<i>verb</i><br><ol><li>to amaze, to wonder</li></ol>
תורא|תּוֹרְתָּא|תּוֹרָא|tawwārā|tōrā|תּוֹרֵא|tawrā|תַּוָּרֵי|תַּוְורָא|תַּוְורֵא|תַּוָּרָא	<i>noun</i><br><ol><li>steer, bull, ox</li><li>ox-driver</li><li>cattle dealer</li><li>cord, band</li><li>row, line</li></ol><br><i>name</i><br><ol><li>(astrology) Taurus</li></ol>
תורגמא	<i>noun</i><br><ol><li>interpretation, translation</li></ol>
תורתא|תורא|tōrtā|תּוֹרְתָּא|תּוֹרָא|tōrā|tawrā|תּוֹרֵא|תַּוְורָא|תַּוְורֵא	<i>noun</i><br><ol><li>cow, heifer</li></ol>
תוש	<i>verb</i><br><ol><li>to err</li></ol>
תותא|twāṯā|תותא|tūṯā	<i>noun</i><br><ol><li>remorse, regret</li><li>mulberry</li></ol>
תחום|təḥūm|תְּחוּם	<i>noun</i><br><ol><li>absolute state of תְּחוּמָא (təḥūmā, “border, limit”)</li></ol>
תחומא|təḥūmā	<i>noun</i><br><ol><li>border, boundary, limit</li><li>regulation, penalty</li><li>definition</li></ol>
תחם	<i>verb</i><br><ol><li>to limit, to define, to border</li></ol>
תחתי	<i>verb</i><br><ol><li>to lower</li></ol>
תחתיא	<i>adj</i><br><ol><li>low</li></ol>
תחתיתא|תחתיא	<i>adj</i><br><ol><li>low</li></ol>
תטלילא	<i>noun</i><br><ol><li>rafter, roof</li></ol>
תימנא	<i>noun</i><br><ol><li>south</li></ol>
תישא|עזא	<i>noun</i><br><ol><li>goat</li></ol>
תלא|tlā|telā	<i>noun</i><br><ol><li>hill</li><li>tell, mound, pile</li><li>ruins</li></ol><br><i>verb</i><br><ol><li>to suspend, to hang</li></ol>
תלגא	<i>noun</i><br><ol><li>snow</li></ol>
תליא	<i>noun</i><br><ol><li>hanging, suspension</li></ol><br><i>adj</i><br><ol><li>hung</li></ol>
תלילא	<i>adj</i><br><ol><li>wet, humid</li></ol>
תלילתא|תלילא	<i>adj</i><br><ol><li>wet, humid</li></ol>
תליסר|təlēsar	<i>num</i><br><ol><li>thirteen</li></ol>
תליתא|תליא	<i>adj</i><br><ol><li>hung</li></ol>
תלל	<i>verb</i><br><ol><li>to wet</li></ol>
תלמידא|תלמידתא	<i>noun</i><br><ol><li>student, disciple</li></ol>
תלמידותא	<i>noun</i><br><ol><li>teaching, education</li><li>discipleship</li></ol>
תלמידתא|תלמידא	<i>noun</i><br><ol><li>student, disciple</li></ol>
תלתא|šlšh|ṯalāṯ|ṯalāṯah|šlš|tlātā’|tlāṯ|תלת|שלשה|שלש	<i>num</i><br><ol><li>three (3)</li></ol>
תלתין	<i>num</i><br><ol><li>thirty (30)</li></ol>
תלתמאא	<i>num</i><br><ol><li>three hundred</li></ol>
תלתעסר	<i>num</i><br><ol><li>thirteen (13)</li></ol>
תלתעסרא	<i>num</i><br><ol><li>thirteen (13)</li></ol>
תמה|təmah|תְּמַהּ	<i>verb</i><br><ol><li>to wonder at, be amazed</li></ol>
תמהא	<i>noun</i><br><ol><li>amazement, wonder, prodigy</li></ol>
תמוז|tamuz	<i>name</i><br><ol><li>July</li></ol>
תמימא	<i>adj</i><br><ol><li>meek, gentle</li></ol>
תמימתא|תמימא	<i>adj</i><br><ol><li>meek, gentle</li></ol>
תמן|תַּמָּן|tammān	<i>adv</i><br><ol><li>there, yonder</li></ol>
תמנא	<i>num</i><br><ol><li>eight (8)</li></ol>
תמנאין	<i>num</i><br><ol><li>eighty (80)</li></ol>
תמני	<i>num</i><br><ol><li>eight (8)</li></ol>
תמניא|təmānəyā	<i>num</i><br><ol><li>eight (8)</li></ol>
תמנין	<i>num</i><br><ol><li>eighty</li></ol>
תמניסר	<i>num</i><br><ol><li>eighteen</li></ol>
תמנמאא	<i>num</i><br><ol><li>eight hundred</li></ol>
תמנעסר	<i>num</i><br><ol><li>eighteen (18)</li></ol>
תמנעסרא	<i>num</i><br><ol><li>eighteen (18)</li></ol>
תמר	<i>verb</i><br><ol><li>to wink, to blink</li></ol>
תמרא|תמרא|təmārā|of təmārā תמריא|תמרתא|tamrā and the singulative תמרי|timrā|tamrē|tamrā	<i>noun</i><br><ol><li>eyelid</li><li>dates (fruit)</li><li>date palms</li></ol>
תמרתא|timrā|תמרא	<i>noun</i><br><ol><li>date (fruit)</li><li>date palm</li></ol>
תנא	<i>verb</i><br><ol><li>to repeat</li></ol>
תנורא|tannūrā|תַּנּוּרַא|תַּנּוּרֵא	<i>noun</i><br><ol><li>oven, furnace</li><li>cuirass, corselet, breastplate</li><li>helmet</li></ol>
תנינא|tannīnā|תִּנְיָנָא|תַּנִּינָא|תַּנִּינֵא|תִּנְיָנֵא|tinyānā	<i>noun</i><br><ol><li>dragon, monster</li></ol><br><i>adj</i><br><ol><li>second</li></ol>
תניניתא|tannīnā|תַּנִּינֵא|תנינא|תַּנִּינָא	<i>noun</i><br><ol><li>second</li></ol>
תנן	<i>verb</i><br><ol><li>to stiffen</li><li>to smoke, to smoulder, to fumigate</li></ol>
תננא	<i>noun</i><br><ol><li>smoke</li></ol>
תעלא|תעלתא	<i>noun</i><br><ol><li>fox</li></ol>
תעלתא|תעלא	<i>noun</i><br><ol><li>fox</li></ol>
תפוחא	<i>noun</i><br><ol><li>apple</li></ol>
תפיא|תפותא	<i>noun</i><br><ol><li>andiron, oven, stove</li><li>hearth</li></ol>
תקל	<i>verb</i><br><ol><li>to stumble</li><li>to weigh, to measure</li></ol>
תקלא|תְּקֵל|tiqlā|תִּקְלָא	<i>noun</i><br><ol><li>shekel/sheqel</li></ol>
תרא	<i>verb</i><br><ol><li>to soak</li></ol>
תרגומא|תַּרְגּוּמָא|תַּרְגּוּמַיָּא|targūmā	<i>noun</i><br><ol><li>translation</li><li>(Judaism, specifically) an Aramaic translation of the Bible; targum</li></ol>
תרגם|tirgem|תִּרְגֵּם	<i>verb</i><br><ol><li>proclaim, to deliver (aloud, a proclamation)</li><li>to interpret, to translate</li></ol>
תרודא	<i>noun</i><br><ol><li>spoon, spoonful</li></ol>
תרונוס|תְּרוֹנוֹס|t'ronos	<i>noun</i><br><ol><li>throne, chair</li></ol>
תרי	<i>num</i><br><ol><li>two (2)</li></ol>
תרין|תְּרֵין|trēn	<i>num</i><br><ol><li>two (2)</li></ol>
תריסר|tərēsar	<i>num</i><br><ol><li>twelve</li></ol>
תריצא	<i>adj</i><br><ol><li>correct</li></ol>
תריצותא	<i>noun</i><br><ol><li>correctness, uprightness</li></ol>
תריצתא|תריצא	<i>adj</i><br><ol><li>correct</li></ol>
תרמלא	<i>noun</i><br><ol><li>wallet</li><li>bag, haversack</li></ol>
תרנגולתא|תרנגלא	<i>noun</i><br><ol><li>hen</li></ol>
תרנגלא|תרנגולתא	<i>noun</i><br><ol><li>rooster, cock</li></ol>
תרסי	<i>verb</i><br><ol><li>to nourish, to feed</li><li>to support, to sustain</li><li>to repair, to restore</li></ol>
תרע|תְּרַע	<i>verb</i><br><ol><li>to open</li><li>to break</li></ol>
תרעא|tarrāʿā|תרעתא|תרעא|תָּרָעָא|tarʿā|תַּרְעֵי|תְּרַע|תַּרְעִין|תַּרְעָא|תַּרְעַיָּיא	<i>noun</i><br><ol><li>door, gate</li><li>entrance, opening</li><li>doorkeeper, porter</li></ol>
תרעסר|tərēʿsār	<i>num</i><br><ol><li>twelve (12)</li></ol>
תרעתא|תרעא|tarʿā|תַּרְעֵי|תְּרַע|תַּרְעִין|תַּרְעָא|תַּרְעַיָּיא	<i>noun</i><br><ol><li>doorkeeper, porter</li></ol>
תרץ|teraṣ	<i>verb</i><br><ol><li>to be correct</li></ol>
תרתי	<i>num</i><br><ol><li>two (2)</li></ol>
תרתין|תַרְתֵּין|thartēin	<i>num</i><br><ol><li>two (2)</li></ol>
תרתעסרא	<i>num</i><br><ol><li>twelve (12)</li></ol>
תשבוחתא|תשבחתא	<i>noun</i><br><ol><li>glory, praise, splendor</li></ol>
תשמשתא	<i>noun</i><br><ol><li>service, ministration</li><li>rite, worship</li><li>attendance</li><li>office</li></ol>
תשע	<i>num</i><br><ol><li>nine (9)</li></ol>
תשעא|tišʿa	<i>num</i><br><ol><li>nine (9)</li></ol>
תשעין	<i>num</i><br><ol><li>ninety (90)</li></ol>
תשעמאא	<i>num</i><br><ol><li>nine hundred</li></ol>
תשעסר	<i>num</i><br><ol><li>nineteen (19)</li></ol>
תשעסרא	<i>num</i><br><ol><li>nineteen (19)</li></ol>
תשרין א	<i>name</i><br><ol><li>October</li></ol>
תשרין אחרי	<i>name</i><br><ol><li>November</li></ol>
תשרין ב	<i>name</i><br><ol><li>November</li></ol>
תשרין קדים	<i>name</i><br><ol><li>October</li></ol>
תשרין תרינא	<i>name</i><br><ol><li>November</li></ol>
תשריתא	<i>noun</i><br><ol><li>autumn</li></ol>
ܐܘܗܐܝܘ	<i>name</i><br><ol><li>Ohio</li></ol>
ܐܘܪܫܠܡ|’ūrišlem	<i>name</i><br><ol><li>Jerusalem</li></ol>
ܕܟ ܐܝܘܬ؟|dekh iwet|iwat	<i>phrase</i><br><ol><li>How are you?</li></ol>
ܝܫܘܥ ܡܫܝܚܐ|ܝܶܫܽܘܥ ܡܫܺܝܚܳܐ	<i>name</i><br><ol><li>(Christianity) Jesus Christ</li></ol>
ܟܢܘܢ ܐ	<i>noun</i><br><ol><li>December</li></ol>
ܟܢܘܢ ܒ	<i>noun</i><br><ol><li>January</li></ol>
ܡܫܝܚܐ|m'šīḥāʾ|ܡܫܺܝܚܳܐ	<i>noun</i><br><ol><li>(Christianity) Messiah, Christ</li><li>(Abrahamic religions) anointed one, messiah</li></ol>
𐡀	<i>character</i><br><ol><li>Aleph, the first letter of the Aramaic alphabet.</li></ol>
𐡀𐡅𐡓𐡔𐡋𐡌|ʾūrišlem|ʾwršlm	<i>name</i><br><ol><li>Jerusalem</li></ol>
𐡀𐡓𐡕𐡇𐡔𐡕𐡓𐡉|ʾrtḥštry	<i>name</i><br><ol><li>Ardakhshir, the name of several rulers of Persis</li></ol>
𐡁|b	<i>character</i><br><ol><li>Beth, the second letter of the Aramaic alphabet.</li></ol>
𐡁𐡁𐡀|bāḇāʾ	<i>noun</i><br><ol><li>gate, gateway</li><li>court</li></ol>
𐡁𐡂𐡃𐡕|bgdt	<i>name</i><br><ol><li>Baydad, the name of a frataraka of Persis</li></ol>
𐡁𐡉𐡍|bēn	<i>prep</i><br><ol><li>between</li><li>among</li></ol>
𐡂𐡁𐡓𐡀|gbrʾ	<i>noun</i><br><ol><li>(Old Aramaic, Imperial Aramaic) man, husband</li></ol>
𐡃𐡀𐡓𐡉𐡅|dʾryw	<i>name</i><br><ol><li>Darew, the name of several kings of Persis</li></ol>
𐡄𐡌𐡓𐡊𐡓𐡀|hmrkrʾ	<i>noun</i><br><ol><li>(Imperial Aramaic) accountant</li></ol>
𐡅𐡄𐡅𐡁𐡓𐡆|whwbrz	<i>name</i><br><ol><li>Vahbarz, the name of a frataraka of Persis</li></ol>
𐡅𐡇𐡅𐡇𐡔𐡕𐡓|wḥwḥštr	<i>name</i><br><ol><li>Wahsir, the name of a king of Persis</li></ol>
𐡅𐡕𐡐𐡓𐡃𐡕|wtprdt	<i>name</i><br><ol><li>Vādfradād, the name of several fratarakas and kings of Persis</li></ol>
𐡆𐡌𐡍|zmn	<i>noun</i><br><ol><li>absolute state of 𐡆𐡌𐡍𐡀 (zmnʾ)</li></ol>
𐡆𐡌𐡍𐡀|zmnʾ|state 𐡆𐡌𐡍|𐡆𐡌𐡀𐡍	<i>noun</i><br><ol><li>time</li></ol>
𐡉𐡓𐡇|īraḥ|yraḥ	<i>noun</i><br><ol><li>month</li><li>moon</li></ol>
𐡌𐡂𐡅𐡔|mgwš	<i>noun</i><br><ol><li>Mazdean priest</li></ol>
𐡌𐡋𐡀𐡊|mlʾk	<i>name</i><br><ol><li>angel</li><li>messenger</li></ol>
𐡌𐡋𐡊𐡀|malkā	<i>noun</i><br><ol><li>king</li></ol>
𐡌𐡍𐡃𐡏|mandaʿ	<i>noun</i><br><ol><li>knowledge</li></ol>
𐡌𐡎𐡂𐡃𐡀|msgdʾ|masgəḏā	<i>noun</i><br><ol><li>place of worship</li></ol>
𐡍𐡌𐡅𐡐𐡕|nmwpt	<i>name</i><br><ol><li>Nambed, the name of a king of Persis</li></ol>
𐡍𐡐𐡀𐡕|npʾt	<i>name</i><br><ol><li>Napad, the name of a king of Persis</li></ol>
𐡐𐡊𐡅𐡓|pkwr	<i>name</i><br><ol><li>Pakor, the name of two kings of Persis</li></ol>
𐡕𐡋𐡕|talāṯ|talāṯā|𐡕𐡋𐡕𐡄	<i>num</i><br><ol><li>three</li></ol>
𐡕𐡋𐡕𐡄|talāṯ|𐡕𐡋𐡕|talāṯā	<i>num</i><br><ol><li>three</li></ol>
