Ala	<i>name</i><br><ol><li>God</li></ol>
Bamakɔ	<i>name</i><br><ol><li>Bamako (the capital of Mali)</li></ol>
Bamanan	<i>name</i><br><ol><li>Bambara people</li><li>a member of that people</li></ol>
Bamanankan	<i>name</i><br><ol><li>Bambara language</li></ol>
Farafinna	<i>name</i><br><ol><li>Africa</li></ol>
Fula	<i>name</i><br><ol><li>Fula (West African people)</li></ol>
Fulakan	<i>name</i><br><ol><li>Fula language</li></ol>
Fulani	<i>noun</i><br><ol><li>(derogatory) little Fula</li></ol>
Segu	<i>name</i><br><ol><li>A city in south-central Mali, lying 235 kilometres (146 mi) northeast of Bamako on the River Niger</li><li>A region in south-central Mali.</li></ol>
Tubabukan	<i>name</i><br><ol><li>French language</li></ol>
Zanga	<i>name</i><br><ol><li>a unisex given name</li></ol>
a	<i>article</i><br><ol><li>the (definite article).</li></ol><br><i>intj</i><br><ol><li>ah (expression of surprise)</li><li>eh (expression of reluctance)</li></ol><br><i>pron</i><br><ol><li>they, them (plural)</li><li>he, she, they (singular)</li></ol>
a dɔ la	<i>intj</i><br><ol><li>maybe</li></ol>
a dɔ ra	<i>intj</i><br><ol><li>maybe</li></ol>
a dɔ rɔ	<i>intj</i><br><ol><li>maybe</li></ol>
a'	<i>pron</i><br><ol><li>you</li></ol>
abada	<i>noun</i><br><ol><li>eternity</li></ol><br><i>adv</i><br><ol><li>always, forever</li></ol>
abarika	<i>intj</i><br><ol><li>thanks</li></ol>
abarka	<i>intj</i><br><ol><li>thanks</li></ol>
adamaden	<i>noun</i><br><ol><li>human</li></ol>
adamadenya	<i>noun</i><br><ol><li>humanity</li><li>good manners</li></ol>
aderenalini	<i>noun</i><br><ol><li>adrenaline</li></ol>
adɛrɛsi	<i>noun</i><br><ol><li>address</li></ol>
alalandi	<i>noun</i><br><ol><li>a person who loves God</li></ol>
alamisa	<i>noun</i><br><ol><li>Tuesday</li></ol>
ale	<i>pron</i><br><ol><li>him</li></ol>
alijɛnɛ	<i>noun</i><br><ol><li>(Islam) paradise</li></ol>
alikuranɛ	<i>noun</i><br><ol><li>Quran (the)</li></ol>
alikɔli	<i>noun</i><br><ol><li>(Medical) alcool</li></ol>
alimɛti	<i>noun</i><br><ol><li>matchstick</li></ol>
amiina	<i>adv</i><br><ol><li>amen</li></ol>
an	<i>pron</i><br><ol><li>we</li></ol>
anw	<i>pron</i><br><ol><li>(emphatic) we, us, our</li></ol>
aw	<i>det</i><br><ol><li>your (plural)</li></ol><br><i>pron</i><br><ol><li>you (plural)</li></ol>
ayi	<i>adv</i><br><ol><li>no</li></ol>
ayiwa	<i>adv</i><br><ol><li>Okay; well.</li></ol>
ba|bà|bá	<i>noun</i><br><ol><li>mother</li><li>goat</li><li>river, stream, lake</li></ol><br><i>num</i><br><ol><li>one thousand</li></ol>
baana	<i>adj</i><br><ol><li>rich, wealthy</li></ol><br><i>noun</i><br><ol><li>the middle finger</li></ol>
baara	<i>noun</i><br><ol><li>work</li></ol>
baarakalan	<i>noun</i><br><ol><li>learning to work</li></ol>
babili	<i>noun</i><br><ol><li>bridge (over a river)</li></ol>
babɛlɛ	<i>noun</i><br><ol><li>river gravel</li></ol>
bacɛncɛn	<i>noun</i><br><ol><li>river sand</li></ol>
badaa	<i>adv</i><br><ol><li>forever</li></ol>
bafaarɔ	<i>noun</i><br><ol><li>manatee</li></ol>
bagan	<i>noun</i><br><ol><li>animal, beast</li><li>livestock</li></ol>
bagangɛnna	<i>noun</i><br><ol><li>shepherd</li></ol>
baganmara	<i>noun</i><br><ol><li>livestock farming</li></ol>
bajalan	<i>noun</i><br><ol><li>canal</li></ol>
bakuruba	<i>noun</i><br><ol><li>group</li></ol>
bakurubasanni	<i>noun</i><br><ol><li>subscription</li></ol>
balansan	<i>noun</i><br><ol><li>Faidherbia albida</li></ol>
baliku	<i>noun</i><br><ol><li>adult</li></ol>
balima	<i>noun</i><br><ol><li>sibling, brother, sister</li></ol>
balimakɛ	<i>noun</i><br><ol><li>brother</li></ol>
balimamuso	<i>noun</i><br><ol><li>sister</li></ol>
bama	<i>noun</i><br><ol><li>crocodile</li></ol>
ban	<i>verb</i><br><ol><li>to finish</li></ol>
bana	<i>noun</i><br><ol><li>disease</li><li>outside of the village</li></ol><br><i>verb</i><br><ol><li>sicken (to become sick)</li></ol>
banakisɛ|banakisɛw	<i>noun</i><br><ol><li>a disease, microbe, virus</li></ol>
banan	<i>noun</i><br><ol><li>kapok tree (Ceiba pentandra)</li></ol>
bananku	<i>noun</i><br><ol><li>cassava, manioc</li></ol>
banayɛlɛmata	<i>noun</i><br><ol><li>contagious disease, epidemic</li></ol>
bange	<i>noun</i><br><ol><li>birth, birthing</li></ol><br><i>verb</i><br><ol><li>to give birth, engender</li><li>to be born</li><li>to appear</li><li>to provoke, cause</li></ol>
banji	<i>noun</i><br><ol><li>palm wine</li></ol>
baradaa	<i>noun</i><br><ol><li>kettle, teapot</li></ol>
baranda	<i>noun</i><br><ol><li>plantain</li></ol>
barika	<i>noun</i><br><ol><li>strength</li></ol>
base	<i>noun</i><br><ol><li>a bush taxi, a common type of public transit</li></ol>
bawo	<i>conj</i><br><ol><li>because of</li></ol>
bawɔlɔ	<i>noun</i><br><ol><li>Egyptian goose (Alopochen aegyptiaca)</li></ol>
bere	<i>noun</i><br><ol><li>a stick</li></ol>
bi	<i>noun</i><br><ol><li>today</li></ol>
bilali	<i>noun</i><br><ol><li>mat</li></ol>
binkannikɛla	<i>noun</i><br><ol><li>bandit, robber</li></ol>
bintu	<i>noun</i><br><ol><li>savannah</li></ol>
biɲɛ	<i>noun</i><br><ol><li>horn</li><li>(anatomy) liver</li></ol>
biɲɛkisɛ	<i>noun</i><br><ol><li>arrow</li></ol>
bolo	<i>noun</i><br><ol><li>(anatomy) arm, hand</li></ol>
boloci	<i>noun</i><br><ol><li>vaccination</li></ol><br><i>verb</i><br><ol><li>(transitive) to vaccinate</li></ol>
bolofɛn	<i>noun</i><br><ol><li>possessions</li></ol>
bolokala	<i>noun</i><br><ol><li>(Anatomy) arm</li></ol>
bolokoli	<i>noun</i><br><ol><li>circumcision</li></ol>
bolokolon	<i>adj</i><br><ol><li>poor, destitute, needful</li></ol>
bolokurun	<i>noun</i><br><ol><li>(anatomy) fist</li></ol>
bolokɔni	<i>noun</i><br><ol><li>(anatomy) finger</li></ol>
bonya	<i>verb</i><br><ol><li>to grow</li></ol>
bubaakisɛ	<i>noun</i><br><ol><li>termite</li></ol>
bugu	<i>noun</i><br><ol><li>hut, shelter with straw roof</li></ol>
bulon	<i>noun</i><br><ol><li>hut</li></ol>
buru	<i>noun</i><br><ol><li>(music) horn</li></ol>
buruju	<i>noun</i><br><ol><li>genealogy, lineage</li></ol>
buyaki	<i>noun</i><br><ol><li>guava</li></ol>
bàanan	<i>noun</i><br><ol><li>Vachellia nilotica</li></ol>
bàsi	<i>noun</i><br><ol><li>couscous</li></ol>
bádingɛ	<i>noun</i><br><ol><li>riverbed</li></ol>
bín	<i>noun</i><br><ol><li>grass, weed</li></ol>
bírinka	<i>noun</i><br><ol><li>cloud</li></ol>
bɔ	<i>verb</i><br><ol><li>(intransitive) to go out, come from</li><li>(transitive) to bring out</li><li>to remove, take off, take away, subtract</li></ol>
bɔgɔ	<i>noun</i><br><ol><li>soil, mud, clay</li></ol>
bɔgɔlanfini	<i>noun</i><br><ol><li>mudcloth</li></ol>
bɔlɔn	<i>noun</i><br><ol><li>road, street</li></ol>
bɔ̀nɛ	<i>noun</i><br><ol><li>adversity, misfortune</li><li>spendings</li><li>the fruit of labor</li></ol>
bɛ	<i>verb</i><br><ol><li>(Predicate of existence) there is, it is</li><li>Forms the present tense, positive of verbs</li></ol>
bɛna	<i>verb</i><br><ol><li>predicate, future tense</li></ol>
bɛnba	<i>noun</i><br><ol><li>ancestor</li></ol>
bɛnɛ	<i>noun</i><br><ol><li>sesame</li></ol>
bɛɛ	<i>adj</i><br><ol><li>all, every</li></ol>
ci|cí|cì	<i>noun</i><br><ol><li>thatch, especially of the species Diheteropogon grandiflorus</li><li>commission, errand</li><li>message, order</li><li>mission, task, assignment</li><li>work, labor (especially agricultural)</li><li>usefulness, utility</li><li>line, stroke</li><li>tattoo</li></ol><br><i>verb</i><br><ol><li>to send, charge with a mission</li><li>to hit</li><li>to break</li><li>to destroy</li><li>to split, divide, cut</li><li>to burst, explode with a loud noise</li><li>to trace, tattoo</li></ol>
cibɔ|cíbɔ	<i>noun</i><br><ol><li>communal work in the fields</li></ol>
ciden|cíden	<i>noun</i><br><ol><li>envoy</li><li>(Christianity) apostle</li><li>communal worker (agriculture)</li></ol>
cikɛla|cíkɛla	<i>noun</i><br><ol><li>farmer</li></ol>
cogo|cógo	<i>noun</i><br><ol><li>manner, way</li><li>means, solution</li><li>conduct, attitude</li><li>appearance, form</li></ol>
cáman	<i>adj</i><br><ol><li>numerous, abundant, frequent</li></ol>
cáya	<i>noun</i><br><ol><li>a large number</li><li>quantity</li><li>increase, multiplication</li></ol><br><i>verb</i><br><ol><li>to multiply</li><li>to intensify, exaggerate</li><li>to pass (in number, in quantity)</li></ol>
cɔnkɔ	<i>verb</i><br><ol><li>to press</li></ol>
cɛ	<i>noun</i><br><ol><li>man</li><li>husband</li></ol>
cɛmancɛrɔbana	<i>noun</i><br><ol><li>middle finger</li></ol>
cɛncɛn	<i>noun</i><br><ol><li>sand</li></ol>
cɛrɔ	<i>noun</i><br><ol><li>small basket</li></ol>
cɛ́mà	<i>postp</i><br><ol><li>amid, among</li></ol>
da	<i>noun</i><br><ol><li>(anatomy) mouth, orifice</li><li>door, doorway</li><li>plant that is source of kenaf fiber (Hibiscus cannabinus)</li><li>roselle (Hibiscus sabdariffa)</li></ol>
dabamuso	<i>noun</i><br><ol><li>hoe</li></ol>
dabɔlɔ	<i>noun</i><br><ol><li>beak</li></ol>
dafa	<i>verb</i><br><ol><li>to fulfill, complete, finish</li></ol>
dafalen	<i>noun</i><br><ol><li>vow</li></ol>
dafiɲɛ	<i>noun</i><br><ol><li>breath</li></ol>
dafuruku	<i>noun</i><br><ol><li>(anatomy) cheek</li></ol>
dafɛn	<i>noun</i><br><ol><li>creature, created thing</li></ol>
dajɛ	<i>noun</i><br><ol><li>antelope</li></ol>
dakumu	<i>noun</i><br><ol><li>roselle, Hibiscus sabdariffa</li></ol>
dakun	<i>noun</i><br><ol><li>chapter, theme</li></ol>
dalasi	<i>noun</i><br><ol><li>moustache</li></ol>
dama	<i>noun</i><br><ol><li>number, quantity</li><li>limit</li></ol><br><i>adv</i><br><ol><li>only</li></ol>
damadɔ	<i>adj</i><br><ol><li>some, many, a certain number of</li></ol>
daminɛ	<i>noun</i><br><ol><li>start, beginning</li></ol><br><i>verb</i><br><ol><li>to start, begin</li></ol>
dan	<i>verb</i><br><ol><li>to count</li><li>to sow</li><li>to pass beyond</li></ol>
danbe	<i>noun</i><br><ol><li>dignity, honor</li></ol>
dancɛ	<i>noun</i><br><ol><li>border</li></ol>
danfara	<i>noun</i><br><ol><li>difference</li></ol>
danga	<i>noun</i><br><ol><li>a curse</li></ol><br><i>verb</i><br><ol><li>(transitive) to curse</li></ol>
dankana	<i>noun</i><br><ol><li>a headscarf</li></ol>
dayɛlɛ	<i>verb</i><br><ol><li>to open</li></ol>
de	<i>particle</i><br><ol><li>emphatic particle (placed directly after the word it modifies)</li></ol>
dee	<i>noun</i><br><ol><li>child</li></ol>
dege	<i>verb</i><br><ol><li>(transitive) to learn</li><li>to teach</li></ol>
degeden	<i>noun</i><br><ol><li>student</li></ol>
den	<i>noun</i><br><ol><li>child</li><li>fruit</li></ol><br><i>verb</i><br><ol><li>to bear fruit</li></ol>
denbaya	<i>noun</i><br><ol><li>family</li></ol><br><i>verb</i><br><ol><li>to have a family</li></ol>
denbo	<i>noun</i><br><ol><li>(vulgar) good-for-nothing</li></ol>
denkɛ	<i>noun</i><br><ol><li>son</li></ol>
denmuso	<i>noun</i><br><ol><li>daughter</li></ol>
denso	<i>noun</i><br><ol><li>womb, uterus</li></ol>
depitebulon	<i>noun</i><br><ol><li>parliament</li></ol>
di	<i>verb</i><br><ol><li>to give</li></ol>
dibi	<i>noun</i><br><ol><li>darkness</li><li>grill, barbecue</li></ol>
dimi	<i>noun</i><br><ol><li>anger</li><li>pain, suffering, hurt</li></ol><br><i>verb</i><br><ol><li>(Intransitive) to be angry</li></ol>
dimɔgɔ	<i>noun</i><br><ol><li>fly (insect)</li></ol>
dingɛ	<i>noun</i><br><ol><li>hole</li></ol>
disi	<i>noun</i><br><ol><li>chest</li></ol>
diya	<i>adj</i><br><ol><li>pleasant, nice</li></ol><br><i>verb</i><br><ol><li>(Transitive) to make pleasing</li><li>to make succeed</li></ol>
diɲɛ	<i>noun</i><br><ol><li>world, universe</li></ol>
do	<i>noun</i><br><ol><li>group</li></ol>
dolen	<i>noun</i><br><ol><li>fishhook</li></ol>
dolokulu	<i>noun</i><br><ol><li>constellation</li></ol>
don	<i>noun</i><br><ol><li>day</li></ol><br><i>verb</i><br><ol><li>(intransitive) to enter</li><li>(transitive) to put (something into something)</li><li>to put on, wear (of clothing)</li></ol><br><i>adj</i><br><ol><li>marks the predicate</li></ol>
du	<i>noun</i><br><ol><li>household</li></ol>
dugu	<i>noun</i><br><ol><li>town, village</li><li>land</li><li>ground, soil</li></ol>
duguba	<i>noun</i><br><ol><li>town</li></ol>
dugujɛ	<i>noun</i><br><ol><li>dawn</li><li>next morning</li></ol>
dugutigi	<i>noun</i><br><ol><li>village chief</li></ol>
duminiba	<i>noun</i><br><ol><li>feast</li></ol>
dumuni|dúmuni	<i>noun</i><br><ol><li>eating</li><li>food, meal</li></ol>
dun	<i>verb</i><br><ol><li>to eat</li></ol>
dunan	<i>noun</i><br><ol><li>stranger, visitor, foreigner</li></ol>
dunun	<i>noun</i><br><ol><li>drum</li></ol>
dá-ji	<i>noun</i><br><ol><li>saliva</li></ol>
dáyɛlɛlan	<i>noun</i><br><ol><li>bottle opener</li><li>key</li><li>door knocker</li></ol>
dège	<i>verb</i><br><ol><li>to teach</li><li>to learn</li></ol>
dònso	<i>noun</i><br><ol><li>hunter</li></ol>
dóolen	<i>noun</i><br><ol><li>fishhook</li></ol>
dúuru	<i>num</i><br><ol><li>five</li></ol>
dɔn	<i>verb</i><br><ol><li>to know</li></ol>
dɔnko	<i>noun</i><br><ol><li>culture, knowledge</li></ol>
dɔnni	<i>noun</i><br><ol><li>knowledge</li><li>science</li></ol>
dɔrɔn	<i>adv</i><br><ol><li>only</li></ol>
dɔɔnin	<i>adv</i><br><ol><li>a little</li></ol>
dɔ̀lɔ	<i>noun</i><br><ol><li>a type of beer made from grains</li></ol>
dɔ̀nkɔri	<i>noun</i><br><ol><li>Acacia verek</li><li>Acacia senegalensis</li><li>Acacia macrostachya</li></ol>
dɔ́gɔkun	<i>noun</i><br><ol><li>week</li></ol>
dɔ́nni	<i>noun</i><br><ol><li>science, knowledge</li></ol>
dɛ	<i>adv</i><br><ol><li>certainly</li></ol>
dɛn	<i>noun</i><br><ol><li>A type of fly (insect).</li><li>Specifically tsetse fly (Glossina palpalis).</li></ol>
dɛnɛ	<i>noun</i><br><ol><li>wall</li></ol>
dɛ̀bɛn	<i>noun</i><br><ol><li>mat</li></ol>
dɛ̀mɛ	<i>verb</i><br><ol><li>to help</li></ol><br><i>noun</i><br><ol><li>aid, assistance, help</li></ol>
dɛ̀ɲɛ	<i>noun</i><br><ol><li>brass, yellow copper</li></ol>
dɛ́bɛ	<i>noun</i><br><ol><li>womb</li></ol>
fakɛ	<i>noun</i><br><ol><li>father, uncle</li></ol>
falenfɛnw	<i>noun</i><br><ol><li>flora, vegetation</li></ol>
fali	<i>noun</i><br><ol><li>donkey, ass</li></ol>
fan	<i>noun</i><br><ol><li>egg</li><li>direction, side</li></ol>
fana	<i>noun</i><br><ol><li>meal</li></ol><br><i>adv</i><br><ol><li>also, too</li></ol>
fanga	<i>noun</i><br><ol><li>power, force</li><li>authority</li></ol>
farafin	<i>noun</i><br><ol><li>black person</li></ol>
farajɛ	<i>noun</i><br><ol><li>white person</li></ol>
farama	<i>adj</i><br><ol><li>stony, rocky</li></ol>
faso	<i>noun</i><br><ol><li>state, homeland</li></ol>
filɛ	<i>verb</i><br><ol><li>(transitive) to look, see</li></ol>
filɛli	<i>noun</i><br><ol><li>(religion) divination</li><li>observation</li></ol>
fin	<i>adj</i><br><ol><li>black</li></ol><br><i>verb</i><br><ol><li>(transitive) to darken, blacken</li></ol>
firifiri	<i>noun</i><br><ol><li>struggle</li></ol>
fiɲɛ	<i>noun</i><br><ol><li>wind, air</li></ol>
fogonfogon	<i>noun</i><br><ol><li>lung</li></ol>
folon	<i>noun</i><br><ol><li>ravine</li></ol>
foro|fòrò	<i>noun</i><br><ol><li>field</li><li>penis</li></ol>
foroko	<i>noun</i><br><ol><li>bag, container</li></ol>
foyi	<i>adv</i><br><ol><li>nothing</li></ol>
fura|fúra	<i>noun</i><br><ol><li>leaf</li><li>page, leaf of paper</li></ol>
furakɛla	<i>noun</i><br><ol><li>physician, doctor</li></ol>
furalan	<i>noun</i><br><ol><li>broom</li></ol>
furancɛ	<i>noun</i><br><ol><li>interval between two things, gap</li></ol>
furu	<i>noun</i><br><ol><li>marriage</li></ol>
furufɛn	<i>noun</i><br><ol><li>dowry</li></ol>
furunafolo	<i>noun</i><br><ol><li>dowry, bride price</li></ol>
fàgali	<i>noun</i><br><ol><li>murder</li></ol>
fàri	<i>noun</i><br><ol><li>body</li><li>appearance</li></ol>
fára	<i>noun</i><br><ol><li>stone, rock</li></ol>
fìla	<i>num</i><br><ol><li>two</li></ol>
fòrobafanga	<i>noun</i><br><ol><li>democracy</li></ol>
fòrokiya	<i>noun</i><br><ol><li>boubou</li></ol>
fɔli	<i>noun</i><br><ol><li>music</li></ol>
fɔ́	<i>verb</i><br><ol><li>to say</li><li>to play (a percussion instrument)</li><li>to speak (a language)</li><li>to miss, fail (to see a person)</li><li>to follow (one another)</li><li>to contradict</li></ol><br><i>noun</i><br><ol><li>speaking, talking</li><li>spoken word</li><li>playing (of a musical instrument)</li></ol>
fɔ́lɔ	<i>adj</i><br><ol><li>first</li></ol>
fɛ	<i>postp</i><br><ol><li>with</li><li>by</li><li>expresses wishes, desires</li></ol>
fɛn	<i>noun</i><br><ol><li>thing</li></ol>
gala	<i>noun</i><br><ol><li>dye</li></ol>
gan	<i>verb</i><br><ol><li>to jump</li><li>(transitive) to heat up</li></ol><br><i>adj</i><br><ol><li>hot</li></ol>
gasi	<i>noun</i><br><ol><li>wrong, offense</li></ol>
gato	<i>noun</i><br><ol><li>cake</li></ol>
geji	<i>noun</i><br><ol><li>sea</li></ol>
gele	<i>noun</i><br><ol><li>African mesquite, Prosopis africana</li></ol>
gèsedala	<i>noun</i><br><ol><li>weaver</li></ol>
gɔmɛ	<i>noun</i><br><ol><li>A small drum.</li></ol>
gɔngɔrɔ	<i>noun</i><br><ol><li>pebble, stone</li></ol>
gɔsi	<i>verb</i><br><ol><li>(transitive) to beat, to thresh</li></ol>
gɛlɛ	<i>noun</i><br><ol><li>a platform in the center of a village</li><li>watchtower, lookout (in fields)</li><li>tusk, horn</li><li>canon</li></ol>
gɛlɛn	<i>adj</i><br><ol><li>hard, firm</li><li>difficult</li><li>expensive</li></ol>
gɛn	<i>verb</i><br><ol><li>(transitive) to chase</li><li>to herd</li></ol>
gɛnna	<i>noun</i><br><ol><li>shepherd</li></ol>
habada	<i>adv</i><br><ol><li>(in a negative phrase) never</li><li>(in a positive phrase) forever, always</li></ol>
hadamaden	<i>noun</i><br><ol><li>human</li></ol>
hakili	<i>noun</i><br><ol><li>mind</li><li>intelligence</li><li>memory</li><li>opinion, idea</li><li>wiseness, reflection</li></ol>
hakilila	<i>noun</i><br><ol><li>opinion, thought, impression</li></ol>
hakilinan	<i>noun</i><br><ol><li>opinion, point of view</li></ol>
hakɛ	<i>noun</i><br><ol><li>measure, level</li><li>average</li><li>quantity</li><li>price, salary</li><li>moment</li><li>right</li></ol>
háwusakala	<i>noun</i><br><ol><li>sugarcane</li></ol>
hɔrɔnya	<i>noun</i><br><ol><li>freedom, liberty, independence</li></ol>
hɛrɛ	<i>noun</i><br><ol><li>peace</li></ol>
i	<i>pron</i><br><ol><li>thou, you (singular)</li></ol>
i bɛ angilekan men wa	<i>phrase</i><br><ol><li>do you speak English?</li></ol>
izini	<i>noun</i><br><ol><li>factory</li></ol>
jaabi	<i>verb</i><br><ol><li>to answer</li></ol><br><i>noun</i><br><ol><li>answer, response</li></ol>
jago	<i>noun</i><br><ol><li>commerce, trade</li></ol>
jakuma	<i>noun</i><br><ol><li>cat (domesticated animal)</li></ol>
jala	<i>noun</i><br><ol><li>African mahogany (Khaya senegalensis)</li></ol>
jalamugu	<i>noun</i><br><ol><li>turban</li></ol>
jan	<i>noun</i><br><ol><li>trap (device to catch animals)</li></ol>
jankaro	<i>noun</i><br><ol><li>disease</li></ol>
jele	<i>noun</i><br><ol><li>ax</li></ol>
jeli|jeliw	<i>noun</i><br><ol><li>A member of the hereditary caste of griots among the Mandé peoples, whose social roles include transmitting their people's oral traditions and playing traditional music (jeliya).</li></ol>
jeliya	<i>noun</i><br><ol><li>(literally) The state or quality of being a jeli.</li><li>The essential traditions, practices and art of the jeliw.</li><li>The traditional music of the jeliw.</li></ol>
jenbe	<i>noun</i><br><ol><li>(music) drum made with hollow wood and animal skin, djembe</li></ol>
ji	<i>noun</i><br><ol><li>water</li></ol>
jigiɲɛ	<i>noun</i><br><ol><li>granary</li></ol>
jiidiya	<i>noun</i><br><ol><li>growth</li></ol>
jikankurun	<i>noun</i><br><ol><li>canoe, boat</li></ol>
jikuru	<i>noun</i><br><ol><li>wave</li><li>ice</li></ol>
jiri|yiri	<i>noun</i><br><ol><li>tree</li></ol>
jiwalankata	<i>noun</i><br><ol><li>flood</li></ol>
joginda	<i>noun</i><br><ol><li>wound</li></ol>
jukɔrɔ|jùkɔ́rɔ	<i>postp</i><br><ol><li>under, below</li></ol>
julaya	<i>noun</i><br><ol><li>trade</li></ol>
jumɛn|jùmɛn	<i>adj</i><br><ol><li>which</li></ol>
jàbere	<i>noun</i><br><ol><li>taro</li></ol>
jàlaki	<i>noun</i><br><ol><li>fault, responsibility</li></ol>
jàra	<i>noun</i><br><ol><li>lion</li></ol>
jòli	<i>adv</i><br><ol><li>how much?</li></ol><br><i>noun</i><br><ol><li>blood</li></ol>
jùrudonna	<i>noun</i><br><ol><li>lender</li></ol>
jùrumantigi	<i>noun</i><br><ol><li>debtor</li></ol>
jùrumu	<i>noun</i><br><ol><li>sin</li></ol>
jɔn	<i>pron</i><br><ol><li>who?</li></ol>
jɔyɔrɔ	<i>noun</i><br><ol><li>position, role, function</li></ol>
jɔ̀nya	<i>noun</i><br><ol><li>slavery</li></ol>
jɛgɛ|jɛ́gɛ	<i>noun</i><br><ol><li>fish</li></ol>
jɛnɛ	<i>noun</i><br><ol><li>spindle</li></ol>
jɛ̀	<i>verb</i><br><ol><li>to assemble, unite, congregate</li></ol><br><i>noun</i><br><ol><li>assembly, union</li><li>association</li><li>alliance, convention</li><li>associate</li><li>mating</li></ol>
jɛ́	<i>verb</i><br><ol><li>to whiten, bleach, wash</li><li>to prove innocent, clear</li><li>to be sure, clear</li></ol><br><i>adj</i><br><ol><li>white, hoary</li><li>clean, pure</li><li>transparent, clear</li><li>clear, evident, comprehensible</li><li>open, empty</li></ol><br><i>noun</i><br><ol><li>a plain, an open space</li></ol>
ka	<i>particle</i><br><ol><li>possessive marker</li><li>particle linking subject and predicative adjective</li></ol>
kabako	<i>noun</i><br><ol><li>wonder, miracle</li></ol>
kafo	<i>noun</i><br><ol><li>canton, region</li></ol>
kalan	<i>noun</i><br><ol><li>study</li><li>reading</li></ol><br><i>verb</i><br><ol><li>to study</li><li>to read</li><li>to be warm</li></ol>
kalanni	<i>noun</i><br><ol><li>reading</li></ol>
kalansen	<i>noun</i><br><ol><li>lesson</li></ol>
kalata	<i>noun</i><br><ol><li>election</li></ol>
kalili	<i>noun</i><br><ol><li>oath</li></ol>
kalo	<i>noun</i><br><ol><li>moon</li><li>month</li><li>menses</li></ol>
kamafura|kàmàfura	<i>noun</i><br><ol><li>wing</li></ol>
kamakun	<i>noun</i><br><ol><li>shoulder</li></ol>
kan	<i>noun</i><br><ol><li>(anatomy) neck</li></ol>
kanntanya	<i>noun</i><br><ol><li>infidelity, unfaithfulness</li></ol>
kanuya	<i>noun</i><br><ol><li>love</li></ol>
kanɲɛ	<i>noun</i><br><ol><li>sound</li><li>syllable</li></ol>
karamɔgɔ	<i>noun</i><br><ol><li>teacher, professor</li><li>marabout</li><li>(Christianity) pastor</li></ol>
kari	<i>noun</i><br><ol><li>Sunday</li></ol><br><i>verb</i><br><ol><li>(transitive) to break</li><li>to pick, harvest (a crop)</li></ol>
kasabi	<i>noun</i><br><ol><li>total</li></ol>
kasara	<i>noun</i><br><ol><li>accident (vehicles)</li></ol>
kelen|kélen	<i>num</i><br><ol><li>one</li></ol>
keninge	<i>noun</i><br><ol><li>a type of sorghum Sorghum bicolor (syn. Sorghum gambicum)</li></ol>
kibaru	<i>noun</i><br><ol><li>news</li></ol>
kiritigɛla|kíritigɛla	<i>noun</i><br><ol><li>judge</li></ol>
ko	<i>verb</i><br><ol><li>to say</li><li>to wash</li></ol>
kojugu	<i>adv</i><br><ol><li>too much</li></ol>
kolo	<i>noun</i><br><ol><li>(anatomy) bone</li></ol>
ku	<i>noun</i><br><ol><li>tail</li><li>yam</li></ol>
kulu	<i>noun</i><br><ol><li>hill, mountain, cliff</li></ol>
kuluba	<i>noun</i><br><ol><li>mountain</li></ol>
kulunin	<i>noun</i><br><ol><li>hill</li></ol>
kuma	<i>verb</i><br><ol><li>(intransitive) to speak</li></ol><br><i>noun</i><br><ol><li>word, that which is spoken</li></ol>
kunbere	<i>noun</i><br><ol><li>knee</li></ol>
kundama	<i>noun</i><br><ol><li>size, height</li></ol>
kundigi	<i>noun</i><br><ol><li>braid</li></ol>
kundigila	<i>noun</i><br><ol><li>a person who plaits/braids hair</li></ol>
kungo	<i>noun</i><br><ol><li>countryside, brush</li></ol>
kungolɛ	<i>noun</i><br><ol><li>wild boar</li></ol>
kungowulu	<i>noun</i><br><ol><li>jackal, fox</li></ol>
kunko	<i>noun</i><br><ol><li>problem, affair</li></ol>
kunkolo	<i>noun</i><br><ol><li>(anatomy) head</li></ol>
kunnafoni	<i>noun</i><br><ol><li>news, information</li></ol><br><i>verb</i><br><ol><li>(Transitive) to inform, give information to</li></ol>
kunnafonisɛbɛn	<i>noun</i><br><ol><li>newspaper</li></ol>
kunsi	<i>noun</i><br><ol><li>hair</li></ol>
kuntaala	<i>noun</i><br><ol><li>period, length of time</li></ol>
kuntigi	<i>noun</i><br><ol><li>boss, chief, director</li></ol>
kuntilenna	<i>noun</i><br><ol><li>direction</li><li>significance, sense</li><li>objective, goal</li></ol>
kunun	<i>noun</i><br><ol><li>yesterday</li></ol><br><i>verb</i><br><ol><li>to wake up</li><li>to swallow</li></ol>
kura	<i>adj</i><br><ol><li>new</li></ol>
kurun|kúrun	<i>noun</i><br><ol><li>stool</li><li>canoe, small boat</li><li>means of transport</li></ol>
kàkɔrɔ	<i>adv</i><br><ol><li>previously, formerly, in the past</li><li>already</li></ol>
kàrama	<i>noun</i><br><ol><li>respect, regard</li></ol>
kàso	<i>noun</i><br><ol><li>prison</li></ol>
kàsɔrɔ	<i>conj</i><br><ol><li>despite, even though</li><li>in effect</li></ol>
kàta	<i>noun</i><br><ol><li>potash</li></ol>
kàtilaka	<i>noun</i><br><ol><li>Eupodotis senegalensis</li><li>Eupodotis melanogaster</li></ol>
kàtuguni	<i>conj</i><br><ol><li>because</li></ol>
kába	<i>noun</i><br><ol><li>stone, rock</li></ol>
kálo	<i>noun</i><br><ol><li>month</li></ol>
kènde	<i>noun</i><br><ol><li>sorghum</li></ol>
kòlon	<i>noun</i><br><ol><li>cowry (formerly used as money)</li><li>divination using cowry shells</li><li>mortar (tool for grinding)</li></ol>
kòlonkala	<i>noun</i><br><ol><li>pestle</li></ol>
kólon	<i>adj</i><br><ol><li>used, worn</li><li>useless</li><li>bad, violent</li><li>empty</li><li>naked</li></ol>
kósɔ̀n	<i>postp</i><br><ol><li>due to, because of, for</li></ol>
kóya	<i>noun</i><br><ol><li>Manilkara</li></ol>
kùntigi	<i>noun</i><br><ol><li>chief, leader, superior</li></ol>
kɔli	<i>noun</i><br><ol><li>misery</li></ol>
kɔlɔ	<i>noun</i><br><ol><li>A kind of nut (esp. shea nut).</li></ol>
kɔlɛ	<i>noun</i><br><ol><li>race (contest)</li></ol>
kɔnɔ|kɔ́nɔ	<i>noun</i><br><ol><li>stomach</li></ol><br><i>postp</i><br><ol><li>inside</li><li>during, for (an amount of time)</li></ol>
kɔra	<i>noun</i><br><ol><li>kora, traditional 21 stringed harp played by griots</li></ol>
kɔrɔ	<i>noun</i><br><ol><li>meaning</li></ol><br><i>postp</i><br><ol><li>under</li></ol>
kɔrɔmuso	<i>noun</i><br><ol><li>older sister</li></ol>
kɔɔri	<i>noun</i><br><ol><li>cotton, Gossypium hirsutum</li></ol>
kɔ̀gɔji	<i>noun</i><br><ol><li>sea, ocean</li></ol>
kɔ̀gɔjida	<i>noun</i><br><ol><li>coast, shore</li></ol>
kɔ̀nɔ	<i>noun</i><br><ol><li>bird</li></ol>
kɔ̀nɔntɔn	<i>num</i><br><ol><li>nine</li></ol>
kɔ̀rɔ	<i>noun</i><br><ol><li>older brother</li></ol>
kɔ́kàn	<i>postp</i><br><ol><li>from outside</li><li>from the other side of, from across</li></ol>
kɔ́ra	<i>noun</i><br><ol><li>kora, harp-lute</li></ol>
kɔ́rɔn	<i>noun</i><br><ol><li>east</li></ol>
kɛ	<i>verb</i><br><ol><li>(Transitive) to do</li><li>to put</li><li>(Intransitive) to happen</li><li>to spend (time)</li><li>to become</li></ol>
kɛlɛ	<i>noun</i><br><ol><li>quarrel</li><li>fight, combat, battle, war</li></ol><br><i>verb</i><br><ol><li>to combat, fight, battle</li></ol>
kɛlɛbolo	<i>noun</i><br><ol><li>army</li></ol>
kɛn	<i>noun</i><br><ol><li>fat</li></ol>
kɛnɛ	<i>noun</i><br><ol><li>light</li></ol>
kɛnɛba	<i>noun</i><br><ol><li>a plain</li></ol>
kɛnɛma	<i>adv</i><br><ol><li>outside, outdoors</li></ol>
kɛnɛya	<i>noun</i><br><ol><li>health</li></ol><br><i>verb</i><br><ol><li>(transitive) to heal</li></ol>
kɛnɛyali	<i>noun</i><br><ol><li>healing</li></ol>
kɛrɛ	<i>noun</i><br><ol><li>side</li></ol>
kɛɲɛ	<i>verb</i><br><ol><li>(transitive) to prevent</li><li>to compare</li><li>(intransitive) to fail</li></ol>
la	<i>postp</i><br><ol><li>postposition marking location</li></ol>
laada	<i>noun</i><br><ol><li>custom, tradition</li><li>menstruation, period</li></ol>
laadi	<i>verb</i><br><ol><li>(transitive) to advise, counsel</li></ol>
laadilikan	<i>noun</i><br><ol><li>advice</li></ol>
labalo	<i>verb</i><br><ol><li>(transitive) to feed</li></ol>
labɛnni	<i>noun</i><br><ol><li>preparation</li></ol>
ladamu	<i>verb</i><br><ol><li>raise to child</li></ol>
lajɛ	<i>verb</i><br><ol><li>(Transitive) to look at, watch</li><li>to try</li></ol>
lajɛba	<i>noun</i><br><ol><li>meeting</li></ol>
lajɛli	<i>noun</i><br><ol><li>meeting</li></ol>
lamini	<i>noun</i><br><ol><li>environs, surrounding area</li><li>frame</li></ol><br><i>verb</i><br><ol><li>(transitive) to surround</li></ol>
lankolon	<i>adj</i><br><ol><li>empty</li><li>naked</li></ol>
lasigiden	<i>noun</i><br><ol><li>representative</li><li>ambassador</li></ol>
lasɔmi	<i>verb</i><br><ol><li>(transitive) to warn</li></ol>
lábi	<i>verb</i><br><ol><li>to replace, substitute, relieve, take over for</li></ol>
lábilali	<i>noun</i><br><ol><li>permission</li><li>leave, authorization to leave</li><li>acquittal</li></ol>
lábìla	<i>verb</i><br><ol><li>to let go, give leave, send on paid leave</li><li>to permit, liberate</li></ol>
lábìn	<i>verb</i><br><ol><li>to cause to fall, turn over, overturn</li></ol>
lábònya	<i>verb</i><br><ol><li>to enlarge, make big</li><li>to exaggerate</li><li>to honor</li></ol>
lábɔ	<i>verb</i><br><ol><li>to make come out</li><li>to clean out</li><li>to invade, infiltrate, penetrate</li><li>to suite, agree, be convenient for, suffice</li><li>to aide, replace</li><li>to be tired</li></ol>
lábɛ̀n	<i>verb</i><br><ol><li>to prepare</li><li>to repair</li><li>to get dressed</li></ol>
lácɛ̀ɲɛ	<i>verb</i><br><ol><li>to embellish, make more beautiful</li></ol>
ládumuni	<i>verb</i><br><ol><li>(transitive, causative) to feed, give food</li></ol>
ládège	<i>verb</i><br><ol><li>to imitate, copy</li></ol>
lájɛ	<i>verb</i><br><ol><li>to look, examine</li><li>to try</li></ol>
lárawe	<i>verb</i><br><ol><li>to search, feel, grope</li><li>to undress</li><li>to examine (of a doctor)</li><li>to reprimand</li></ol>
lásà	<i>verb</i><br><ol><li>to cause to die</li><li>to extinguish</li><li>to prevent, hinder</li></ol>
ma	<i>noun</i><br><ol><li>sea cow</li></ol><br><i>verb</i><br><ol><li>(verbal auxiliary) marks an action which is not accomplished</li></ol>
maana	<i>noun</i><br><ol><li>story, explanation</li></ol>
mabɛn	<i>noun</i><br><ol><li>arrangement</li><li>grammar</li></ol>
mago	<i>noun</i><br><ol><li>need</li></ol>
majamu	<i>verb</i><br><ol><li>(transitive) to praise</li></ol>
makari	<i>noun</i><br><ol><li>mercy</li></ol>
makɔnɔ	<i>verb</i><br><ol><li>(transitive) to wait for</li></ol>
manje	<i>noun</i><br><ol><li>papaya</li></ol>
mansa	<i>noun</i><br><ol><li>parent, ancestor</li></ol>
mara	<i>noun</i><br><ol><li>guard</li><li>region, province</li><li>(administrative division) circle</li><li>savings, reserves</li><li>kingdom</li></ol><br><i>verb</i><br><ol><li>(transitive) to guard, keep, take care of</li><li>to manage, govern</li><li>to keep, raise (poultry)</li></ol>
marali	<i>noun</i><br><ol><li>protection</li><li>colonisation</li></ol>
marifa	<i>noun</i><br><ol><li>gun</li></ol>
masa	<i>noun</i><br><ol><li>king</li></ol>
masaden	<i>noun</i><br><ol><li>prince</li></ol>
masaku	<i>noun</i><br><ol><li>sweet potato</li></ol>
masaya	<i>noun</i><br><ol><li>kingdom</li></ol>
mburu	<i>noun</i><br><ol><li>bread</li></ol>
minisiriɲɛmɔgɔ	<i>noun</i><br><ol><li>prime minister</li></ol>
minkɛ	<i>conj</i><br><ol><li>when</li></ol>
misali	<i>noun</i><br><ol><li>example</li></ol>
misi	<i>noun</i><br><ol><li>cow</li></ol>
misidaba	<i>noun</i><br><ol><li>ox-plow</li></ol>
mpan	<i>noun</i><br><ol><li>sword</li></ol>
munna	<i>adv</i><br><ol><li>why?</li></ol>
muso	<i>noun</i><br><ol><li>woman</li><li>wife</li></ol>
màli	<i>noun</i><br><ol><li>hippopotamus</li></ol>
màra	<i>noun</i><br><ol><li>region, province, kingdom</li></ol>
màsa	<i>noun</i><br><ol><li>king, chief</li></ol>
mìn	<i>verb</i><br><ol><li>to drink, absorb</li><li>to suck, nurse</li><li>to smoke</li><li>to kiss</li><li>to quench one's thirst</li><li>to be courageous</li></ol>
mùgan	<i>num</i><br><ol><li>twenty</li></ol>
mɔgɔ|mɔgɔw|mɔ̀gɔ	<i>noun</i><br><ol><li>person, man</li><li>someone</li></ol>
mɔgɔkɔrɔba	<i>noun</i><br><ol><li>adult</li></ol>
mɛn	<i>verb</i><br><ol><li>to hear</li><li>to understand</li></ol>
n	<i>pron</i><br><ol><li>I</li></ol>
na|nana	<i>noun</i><br><ol><li>stew</li></ol><br><i>particle</i><br><ol><li>auxiliary marker for future tense</li></ol>
nafolo|nafolow	<i>noun</i><br><ol><li>riches, wealth, treasure</li></ol>
naji	<i>noun</i><br><ol><li>sauce, soup</li></ol>
nakɔ	<i>noun</i><br><ol><li>garden, plot of land for growing vegetables</li></ol>
namasa	<i>noun</i><br><ol><li>banana</li></ol>
nanbara	<i>noun</i><br><ol><li>dishonesty, injustice</li></ol>
nbuuru	<i>noun</i><br><ol><li>bread</li></ol>
nbuurufunun	<i>noun</i><br><ol><li>yeast</li></ol>
ncɔgɔn	<i>noun</i><br><ol><li>yam</li></ol>
ndoro	<i>noun</i><br><ol><li>dough, paste</li></ol>
nfirinfirin	<i>noun</i><br><ol><li>butterfly</li></ol>
ngɔn	<i>noun</i><br><ol><li>baboon</li></ol>
ngɔni	<i>noun</i><br><ol><li>ngoni, a traditional lute played by griots</li></ol>
ngɔnɔ	<i>noun</i><br><ol><li>dew</li></ol>
ni	<i>noun</i><br><ol><li>soul, life, spirit</li></ol><br><i>conj</i><br><ol><li>if</li><li>when</li></ol>
ninnu	<i>adj</i><br><ol><li>these</li></ol>
nka	<i>conj</i><br><ol><li>but</li></ol>
nkolonnin	<i>noun</i><br><ol><li>antelope</li></ol>
nkɔli	<i>noun</i><br><ol><li>(anatomy) The hind leg of a grasshopper.</li></ol>
nkɔsɔn	<i>noun</i><br><ol><li>scorpion</li></ol>
nkɔyɔ	<i>noun</i><br><ol><li>bitter tomato, african eggplant, Solanum aethiopicum</li></ol>
nkɛɛrɛn	<i>noun</i><br><ol><li>cricket</li></ol>
npan	<i>noun</i><br><ol><li>sword</li></ol>
npogotigi|npògotigi	<i>noun</i><br><ol><li>young girl, virgin</li></ol>
npògo	<i>noun</i><br><ol><li>female underwear, a garment which covers the pudendum muliebre</li></ol>
nsana	<i>noun</i><br><ol><li>proverb</li></ol>
nsaransaranin	<i>noun</i><br><ol><li>small fish</li></ol>
nsiranɛgɛ|nsìranɛgɛ	<i>noun</i><br><ol><li>bronze</li></ol>
nsáajɛ	<i>noun</i><br><ol><li>Vachellia seyal (gum arabic tree, shittim wood, thirty thorn, whistling tree)</li></ol>
nsɛrɛ	<i>noun</i><br><ol><li>watermelon</li></ol>
ntilen	<i>noun</i><br><ol><li>giraffe</li></ol>
ntomi	<i>noun</i><br><ol><li>(botany) tamarind (Tamarindus indica)</li></ol>
ntori	<i>noun</i><br><ol><li>frog, toad</li></ol>
ntura	<i>noun</i><br><ol><li>bull</li></ol>
ntɔn	<i>noun</i><br><ol><li>cricket</li></ol>
nugu	<i>noun</i><br><ol><li>(anatomy) intestine</li></ol>
numu	<i>noun</i><br><ol><li>blacksmith</li></ol>
nun|nún	<i>noun</i><br><ol><li>(anatomy) nose</li></ol>
nya	<i>noun</i><br><ol><li>(anatomy) eye</li></ol>
nàfa	<i>noun</i><br><ol><li>usefulness, importance</li></ol><br><i>verb</i><br><ol><li>(transitive) to be useful to</li></ol>
nàra	<i>noun</i><br><ol><li>sandy earth</li></ol>
nàsira	<i>noun</i><br><ol><li>means, way</li><li>path by which one comes</li></ol>
náamu	<i>noun</i><br><ol><li>turban of an Imam</li><li>rule, custom</li></ol>
náani	<i>num</i><br><ol><li>four</li></ol>
nákɔ	<i>noun</i><br><ol><li>garden</li></ol>
núnwo	<i>noun</i><br><ol><li>(Anatomy) nostril</li></ol>
nɔnɔ	<i>noun</i><br><ol><li>milk</li></ol>
nɔɔrɔ	<i>noun</i><br><ol><li>glory</li></ol>
nɔ́nɔ	<i>noun</i><br><ol><li>milk</li></ol>
nɛgɛ	<i>noun</i><br><ol><li>iron, metal</li></ol>
nɛgɛdaga	<i>noun</i><br><ol><li>iron cooking pot</li></ol>
nɛgɛso	<i>noun</i><br><ol><li>bicycle</li></ol>
nɛn	<i>noun</i><br><ol><li>tongue</li></ol>
nɛrɛ	<i>noun</i><br><ol><li>African locust bean (Parkia biglobosa)</li></ol>
nɛ́gɛn	<i>verb</i><br><ol><li>to delude, lure, flatter</li><li>to fool, trick</li></ol><br><i>noun</i><br><ol><li>flattery, deceit</li></ol>
nɛ́gɛnɛgɛ	<i>verb</i><br><ol><li>to taste</li></ol>
olu	<i>pron</i><br><ol><li>(emphatic) they, them</li></ol>
pan	<i>verb</i><br><ol><li>to fly</li><li>to jump</li></ol>
peresidan	<i>noun</i><br><ol><li>president</li></ol>
sabali	<i>noun</i><br><ol><li>patience</li><li>calm</li></ol>
sagasi	<i>noun</i><br><ol><li>wool</li></ol>
sama|sàmá	<i>noun</i><br><ol><li>gift</li><li>elephant</li></ol><br><i>verb</i><br><ol><li>to bring a gift (after a voyage)</li><li>to pull</li></ol>
samiya	<i>noun</i><br><ol><li>rainy season</li></ol>
sanfɛ|sánfɛ̀	<i>postp</i><br><ol><li>above, on</li></ol>
sanga|sánga	<i>noun</i><br><ol><li>mourning</li><li>time, moment</li><li>minute</li><li>success</li></ol>
sanji	<i>noun</i><br><ol><li>rain</li></ol>
sankolo	<i>noun</i><br><ol><li>sky</li></ol>
sanni	<i>noun</i><br><ol><li>shopping</li></ol>
sanpɛrɛn	<i>noun</i><br><ol><li>lightening</li></ol>
sara	<i>noun</i><br><ol><li>charm (object with magic powers)</li></ol>
saraka	<i>noun</i><br><ol><li>alms</li><li>sacrifice</li><li>remedy</li></ol>
sariya	<i>noun</i><br><ol><li>law, rule, ruling</li></ol>
saya	<i>noun</i><br><ol><li>death</li></ol>
saɲɔ|sàɲɔ	<i>noun</i><br><ol><li>pearl millet, Pennisetum glaucum</li></ol>
sebaaya	<i>noun</i><br><ol><li>power, means</li></ol>
sebe|sèbé	<i>noun</i><br><ol><li>African fan palm, Borassus aethiopum</li></ol>
seere	<i>noun</i><br><ol><li>witness</li></ol>
seko|sekoart	<i>noun</i><br><ol><li>as much as possible, the maximum</li></ol>
seleke	<i>noun</i><br><ol><li>angle</li><li>corner</li></ol>
senfɛ	<i>postp</i><br><ol><li>during, in the course of, while</li></ol>
senuma	<i>adj</i><br><ol><li>holy, sacred</li></ol>
shinye	<i>noun</i><br><ol><li>time</li></ol>
sigida	<i>noun</i><br><ol><li>district</li></ol>
sigiyɔrɔ	<i>noun</i><br><ol><li>residence, domicile</li></ol>
sini	<i>noun</i><br><ol><li>tomorrow</li><li>the future</li></ol>
sinin	<i>noun</i><br><ol><li>tomorrow</li></ol>
sira	<i>noun</i><br><ol><li>baobab</li></ol>
situlu	<i>noun</i><br><ol><li>shea butter</li></ol>
siya	<i>noun</i><br><ol><li>tribe, race, ethnic group</li></ol>
so	<i>noun</i><br><ol><li>horse</li><li>house, home</li></ol>
sogoba	<i>noun</i><br><ol><li>elephant</li></ol>
soso	<i>noun</i><br><ol><li>mosquito</li></ol>
sugandi	<i>verb</i><br><ol><li>(Transitive) to choose</li><li>to elect</li></ol>
sugandili	<i>noun</i><br><ol><li>election</li></ol>
sun	<i>noun</i><br><ol><li>trunk (of tree)</li><li>fasting (during the month of Ramadan)</li><li>to fast</li></ol>
suruku	<i>noun</i><br><ol><li>hyena</li></ol>
sàba	<i>num</i><br><ol><li>three</li></ol>
sàban	<i>noun</i><br><ol><li>Saba senegalensis</li></ol>
sába	<i>noun</i><br><ol><li>side (of people or animals)</li><li>flank</li></ol>
sábanan	<i>adj</i><br><ol><li>third</li></ol>
sán	<i>noun</i><br><ol><li>sky, heaven, above</li><li>rain</li><li>thunder, lightning</li></ol>
sánfin	<i>noun</i><br><ol><li>raincloud</li></ol>
sánfiɲɛ	<i>noun</i><br><ol><li>storm</li></ol>
sánfɛfɛn	<i>noun</i><br><ol><li>bird</li><li>anything in the air, on high, above</li></ol>
sánfɛla	<i>noun</i><br><ol><li>top</li></ol>
sèɡin	<i>num</i><br><ol><li>eight</li></ol>
sìgida	<i>noun</i><br><ol><li>locality, village</li><li>housing</li><li>situation of a place</li><li>group, category</li><li>part of a discourse, chapter of a book</li></ol>
sìgidolo	<i>noun</i><br><ol><li>Venus, the morning star</li></ol>
síran	<i>noun</i><br><ol><li>fear</li></ol><br><i>verb</i><br><ol><li>to fear, have fear, be scared of</li></ol>
sògo	<i>noun</i><br><ol><li>meat</li><li>game</li><li>flesh, body</li></ol>
sòku	<i>noun</i><br><ol><li>a bowed string instrument, similar to a violin</li></ol>
sòkɛ	<i>noun</i><br><ol><li>stallion</li></ol>
sójɔla	<i>noun</i><br><ol><li>mason, housebuilder</li></ol>
sùman	<i>noun</i><br><ol><li>harvest, subsistence crops</li><li>food, meal</li></ol>
sùmangosi	<i>noun</i><br><ol><li>threshing</li></ol>
sɔgɔma|sɔ̀gɔmà	<i>noun</i><br><ol><li>morning</li></ol>
sɔgɔsɔgɔ	<i>noun</i><br><ol><li>cough</li></ol>
sɔrɔdasi	<i>noun</i><br><ol><li>soldier</li></ol>
sɔsɔli	<i>noun</i><br><ol><li>argument, debate</li></ol>
sɔ̀mɔ	<i>noun</i><br><ol><li>cashew tree, Anacardium occidentale</li></ol>
sɔ̀ngɔ	<i>noun</i><br><ol><li>price, value</li></ol>
sɛ	<i>noun</i><br><ol><li>chicken, hen</li></ol>
sɛfan	<i>noun</i><br><ol><li>egg</li></ol>
sɛnɛ	<i>noun</i><br><ol><li>agriculture, farming</li></ol>
sɛsi	<i>noun</i><br><ol><li>chair</li></ol>
sɛ́bɛn	<i>verb</i><br><ol><li>(transitive) to write</li></ol><br><i>noun</i><br><ol><li>document, letter, paper</li><li>amulette</li></ol>
tiga|tìgá	<i>noun</i><br><ol><li>peanut</li></ol>
tigɛ	<i>verb</i><br><ol><li>(transitive) to break, cut</li><li>to harvest</li><li>to cross</li></ol>
tile|tìlé	<i>noun</i><br><ol><li>sun</li><li>day, daytime, the heat of the day</li><li>epoch, era</li></ol>
tilema	<i>noun</i><br><ol><li>dry season</li></ol>
to	<i>noun</i><br><ol><li>stiff porridge</li></ol>
tu	<i>noun</i><br><ol><li>forest; thicket</li></ol><br><i>verb</i><br><ol><li>to spit (out)</li></ol>
tufin	<i>noun</i><br><ol><li>Acacia ataxacantha (now Senegalia ataxacantha, flame thorn)</li><li>Acacia pennata (now Senegalia pennata subsp. pennata)</li></ol>
tun	<i>adv</i><br><ol><li>again</li></ol>
turu	<i>verb</i><br><ol><li>(transitive) to plant</li><li>to replant, transplant</li></ol>
tàafe	<i>noun</i><br><ol><li>loincloth</li></ol>
tàasi	<i>verb</i><br><ol><li>to reflect upon, consider</li></ol>
tàfo	<i>noun</i><br><ol><li>a type of charm, amulet, talisman, gri-gri</li></ol>
tàga	<i>noun</i><br><ol><li>molar</li></ol>
táa	<i>verb</i><br><ol><li>to go, leave</li><li>to carry off</li></ol><br><i>noun</i><br><ol><li>departure</li></ol>
táabaa	<i>noun</i><br><ol><li>one who goes, leaves</li><li>the deceased</li></ol>
táafan	<i>noun</i><br><ol><li>direction</li><li>sense</li></ol>
táala	<i>noun</i><br><ol><li>one who leaves</li></ol>
táalan	<i>noun</i><br><ol><li>that which makes (something) go, that which comes with</li><li>necessity</li><li>habit, tendency</li><li>condition</li></ol>
táaran	<i>noun</i><br><ol><li>gutter</li></ol>
tìɲɛ	<i>noun</i><br><ol><li>truth</li><li>reason</li></ol>
tùn	<i>verb</i><br><ol><li>Forms the imperfect tense</li><li>Forms the past perfect tense</li></ol>
túlo	<i>noun</i><br><ol><li>ear</li></ol>
tɔn	<i>noun</i><br><ol><li>nape (back part of the neck)</li></ol>
tɔ̀gɔ̀tɔ̀gɔ̀nin	<i>noun</i><br><ol><li>dysentery</li></ol>
tɛ	<i>verb</i><br><ol><li>there is not, it is not</li><li>not, (is) not</li></ol>
tɛmɛ	<i>noun</i><br><ol><li>sieve, screen</li><li>zebu bull</li><li>an oversight, omission, something forgotten</li></ol><br><i>verb</i><br><ol><li>to pass</li><li>to surpass, exceed</li></ol>
u	<i>pron</i><br><ol><li>they</li></ol>
wa	<i>particle</i><br><ol><li>final interrogative particle on a yes/no question</li></ol>
walima	<i>conj</i><br><ol><li>or</li></ol>
waraba	<i>noun</i><br><ol><li>lion</li></ol>
warijɛ	<i>noun</i><br><ol><li>silver</li></ol>
wele	<i>verb</i><br><ol><li>to call</li><li>to invite</li></ol>
woro	<i>noun</i><br><ol><li>thigh</li></ol>
wotoro	<i>noun</i><br><ol><li>cart, carriage</li></ol>
wula	<i>noun</i><br><ol><li>afternoon, between 2pm and sunset</li></ol>
wulu|wùlu	<i>noun</i><br><ol><li>dog</li></ol>
wòro	<i>noun</i><br><ol><li>kola nut</li></ol>
wólo	<i>noun</i><br><ol><li>procreation</li><li>family</li></ol><br><i>verb</i><br><ol><li>to give birth, deliver, engender</li><li>to form into an ear (of millet)</li><li>to be born</li><li>(transitive) to bring to the world (a child)</li><li>(transitive) to deliver (a child)</li></ol>
wólonwula	<i>num</i><br><ol><li>seven</li></ol>
wólonwulanan	<i>adj</i><br><ol><li>seventh</li></ol>
wɔlɔ	<i>noun</i><br><ol><li>partridge</li></ol>
wɔlɔsɔ|wɔ̀lɔsɔ	<i>noun</i><br><ol><li>sickle</li></ol>
wɔsiji	<i>noun</i><br><ol><li>sweat</li></ol>
wɔ́ɔrɔ	<i>num</i><br><ol><li>six</li></ol>
wɛrɛ	<i>adj</i><br><ol><li>another, different</li></ol><br><i>noun</i><br><ol><li>cow enclosure</li></ol>
yaani	<i>conj</i><br><ol><li>before</li></ol>
yaasa	<i>conj</i><br><ol><li>so that, in order that</li></ol>
yan	<i>adv</i><br><ol><li>here</li></ol>
ye	<i>postp</i><br><ol><li>at, towards</li><li>for</li><li>with</li></ol><br><i>verb</i><br><ol><li>(verbal auxiliary for transitive verbs) marks an action which is accomplished</li><li>(transitive) to see</li></ol>
yen	<i>adv</i><br><ol><li>there</li></ol>
yàfa	<i>noun</i><br><ol><li>forgiveness</li><li>amnesty</li></ol><br><i>verb</i><br><ol><li>(transitive) to forgive</li><li>(intransitive) to forgive</li></ol>
yànfan	<i>noun</i><br><ol><li>this side</li></ol>
yóya	<i>noun</i><br><ol><li>war</li></ol>
yɔrɔ	<i>noun</i><br><ol><li>place</li></ol>
yɛlɛma	<i>verb</i><br><ol><li>(transitive) to change, transform, turn</li></ol>
yɛlɛnyɛlɛnnan	<i>noun</i><br><ol><li>ladder, stairs, staircase</li></ol>
yɛrɛ	<i>adj</i><br><ol><li>self, one's self, own</li></ol>
àlikaama	<i>noun</i><br><ol><li>wheat</li></ol>
àlisilamɛ	<i>noun</i><br><ol><li>Muslim</li></ol>
ŋana	<i>adj</i><br><ol><li>tough</li></ol>
ŋaniya	<i>noun</i><br><ol><li>resolution, decision, intention</li></ol>
ŋɔmɔ	<i>noun</i><br><ol><li>bark (exterior covering of a tree)</li></ol>
ɲaami	<i>verb</i><br><ol><li>(Transitive) to mix, confuse, trouble</li></ol>
ɲaamɛ	<i>noun</i><br><ol><li>camel, dromedary</li></ol>
ɲin	<i>noun</i><br><ol><li>tooth</li></ol>
ɲùman	<i>noun</i><br><ol><li>good</li><li>beautiful, handsome</li><li>useful</li><li>a good deed</li></ol>
ɲɔ	<i>noun</i><br><ol><li>millet, sorghum</li></ol>
ɲɔgɔmɛ	<i>noun</i><br><ol><li>camel</li></ol>
ɲɔgɔn|ɲɔ̀gɔn|ɲɔ́gɔn	<i>pron</i><br><ol><li>(reflexive) one another</li></ol><br><i>noun</i><br><ol><li>the same, like, equal</li><li>approximation, estimate</li><li>associate, partner</li></ol>
ɲɛ|ɲɛ́	<i>noun</i><br><ol><li>eye</li><li>sight</li><li>color</li></ol><br><i>postp</i><br><ol><li>before, ahead of</li></ol><br><i>verb</i><br><ol><li>(intransitive) to be good</li></ol>
ɲɛda	<i>noun</i><br><ol><li>face</li></ol>
ɲɛmɔgɔ	<i>noun</i><br><ol><li>leader, boss</li></ol>
ɲɛ́-ji	<i>noun</i><br><ol><li>tears</li></ol>
