Aablik|Aabliks-je|Aablikke	<i>noun</i><br><ol><li>(Kirchröadsj) view, sight, look</li></ol>
Aabouw|Aabui|Aabuisje	<i>noun</i><br><ol><li>(Kirchröadsj) extension, annex</li></ol>
Aad|Ate|Aatsje	<i>noun</i><br><ol><li>(Kirchröadsj) nature, character, disposition</li><li>(Kirchröadsj) behavior</li><li>(Kirchröadsj) way, method</li><li>(Kirchröadsj, biology, taxonomy) species</li></ol>
Aadenke|Aadenker|Aadinker|Aadenkesje	<i>noun</i><br><ol><li>(Kirchröadsj) memory; remembrance (especially of a deceased person)</li><li>(Kirchröadsj) memento; souvenir; keepsake (something of emotional value kept as a reminder)</li></ol>
Aaf|Aafe|Ääfche	<i>noun</i><br><ol><li>(western Moselle Franconian, few dialects of Ripuarian, Limburgan Ripuarian) ape; monkey</li></ol>
Aap|Aape|Ääpche	<i>noun</i><br><ol><li>(Ripuarian) ape; monkey</li></ol>
Ab|Abte|Abche	<i>noun</i><br><ol><li>(westernmost Ripuarian) An abbot, monastic superior of an abbey</li></ol>
Abbauhammer|Abbauhammere|Abbauhämmerche|Abbauhämmercher	<i>noun</i><br><ol><li>(Mining) (most of Ripuarian) A pneumatic hammer</li></ol>
Ablas|Ables|Ables-je	<i>noun</i><br><ol><li>(Kirchröadsj, Roman Catholicism) indulgence, reduction of expected punishment in purgatory</li></ol>
Abriekoeës|Abriekoeëze|Abriekues-je	<i>noun</i><br><ol><li>(Kirchröadsj) apricot</li></ol>
Absjied|Absjiede|Absjiedsje	<i>noun</i><br><ol><li>(Kirchröadsj) parting, farewell</li></ol>
Aff	<i>noun</i><br><ol><li>(eastern Moselle Franconian, also Moselle Franconian / Hunsrückisch) ape; monkey</li></ol>
Appel|Äppelche|Äppel	<i>noun</i><br><ol><li>(most dialects) apple</li></ol>
Appelkoeës|Appelkues-je|Appelkues-jes|Appelkoeëze|Appelkoeës-jes	<i>noun</i><br><ol><li>(Kirchröadsj) Alternative form of Abriekoeës</li></ol>
Appelkuus|Appelküüsjer|Appelküüscher|Appelkuuse|Appelküüsje|Appelküüsche	<i>noun</i><br><ol><li>(dialectal) Alternative form of Apriekuus</li></ol>
Appeltaat|Appeltäätche|Appeltaate	<i>noun</i><br><ol><li>(Ripuarian, some dialects of Moselle Franconian) apple pie</li></ol>
Au	<i>noun</i><br><ol><li>(southern Moselle Franconian) eye</li></ol>
Auch	<i>noun</i><br><ol><li>(Kölsch) eye</li></ol>
Baam	<i>noun</i><br><ol><li>(southern Moselle Franconian) tree</li></ol>
Bal|Bals|Belsje|Bale|Beëlsje|Bel	<i>noun</i><br><ol><li>(Kirchröadsj, informal) testicle, nut</li><li>(Kirchröadsj, sports) pass, shot</li><li>(Kirchröadsj, chiefly in the negative) anything</li><li>(Kirchröadsj) A bale of hay or straw.</li><li>(Kirchröadsj) A closed bag or package of wares.</li></ol>
Ball|Balle|Bäll|Bal|Bals|Balls|Bällche|Beëlsje|Bel	<i>noun</i><br><ol><li>(most dialects) ball (round or roundish object, most commonly used in games)</li><li>(most dialects, dance) ball (social gathering for dancing), prom (US)</li></ol>
Been|Beenche	<i>noun</i><br><ol><li>(Ripuarian, western Moselle Franconian) leg</li></ol>
Beer|Beere|Beer	<i>noun</i><br><ol><li>(Moselle Franconian) berry (kind of fruit)</li><li>(Moselle Franconian) bear (animal)</li><li>(parts of western Moselle Franconian) beer</li></ol>
Bei|Beiche|Beie	<i>noun</i><br><ol><li>(most dialects) bee (insect)</li></ol>
Beidel	<i>noun</i><br><ol><li>(Moselle Franconian) pouch; bag; purse; wallet</li></ol>
Berch|Berjelche	<i>noun</i><br><ol><li>(Ripuarian, eastern Moselle Franconian) mountain</li></ol>
Berlin	<i>name</i><br><ol><li>Berlin</li></ol>
Bier|Biere	<i>noun</i><br><ol><li>(many dialects) beer (drink)</li><li>(most dialects) a male uncastrated pig; a boar</li></ol>
Bild|Biller|Bildche|Bilder	<i>noun</i><br><ol><li>(most dialects) image; picture; painting; photo</li></ol>
Bir|Birre	<i>noun</i><br><ol><li>pear (fruit)</li></ol>
Birk|Birke	<i>noun</i><br><ol><li>(most dialects) birch (tree)</li></ol>
Blatt|Bläder|Blader|Blättche	<i>noun</i><br><ol><li>(Ripuarian) leaf</li></ol>
Blot	<i>noun</i><br><ol><li>(Ripuarian, northern Moselle Franconian) blood</li></ol>
Blotwoosch|Blotwööschje|Blotwöösch	<i>noun</i><br><ol><li>(Kölsch) blood sausage</li></ol>
Blotwursch|Blotwürschje|Blotwürsch	<i>noun</i><br><ol><li>(most dialects of Ripuarian) blood sausage</li></ol>
Booch|Bööchelche|Booche|Beechelche|Beecher|Bööcher	<i>noun</i><br><ol><li>(Ripuarian, northern Moselle Franconian) book</li><li>(Ripuarian, northern Moselle Franconian) beech (tree)</li></ol>
Boom|Böömche|Bääm|Beemche|Bäämche|Bööm|Beem	<i>noun</i><br><ol><li>(most dialects) tree</li></ol>
Botz|Botze|Bötzje	<i>noun</i><br><ol><li>(Ripuarian) pair of trousers</li></ol>
Breme	<i>name</i><br><ol><li>(Kölsch) Bremen (the capital city of the state of Bremen, Germany)</li><li>(Kölsch) Bremen (a state of Germany)</li></ol>
Brock|Brögge|Bröck|Bröggelche	<i>noun</i><br><ol><li>(most of Ripuarian) bride (woman on or with regard to her wedding day)</li></ol>
Broder|Breder|Bröder|Brederche|Bröderche	<i>noun</i><br><ol><li>(Ripuarian, northern Moselle Franconian) brother</li></ol>
Bross|Bröss|Brössje	<i>noun</i><br><ol><li>(Ripuarian) chest</li><li>(Ripuarian) breast</li></ol>
Brot	<i>noun</i><br><ol><li>(southern Moselle Franconian) bread</li><li>(same region) loaf of bread</li></ol>
Brut|Brude|Brütche	<i>noun</i><br><ol><li>(Ripuarian, northern Moselle Franconian) bread</li><li>(same regions) loaf of bread</li></ol>
Brutt|Brie	<i>noun</i><br><ol><li>(Siegerland Moselle Franconian) bride</li></ol>
Bruut|Brüüt|Brüü	<i>noun</i><br><ol><li>(westernmost and northernmost Ripuarian) bride</li></ol>
Bröck|Brögge|Bröggelche	<i>noun</i><br><ol><li>(Ripuarian) bridge</li></ol>
Buch|Büchelche|Büch|Biechelche|Biecher	<i>noun</i><br><ol><li>(Ripuarian) belly; abdomen; stomach</li><li>(southern Moselle Franconian) book</li></ol>
Bunn|Bünnche|Bunne	<i>noun</i><br><ol><li>(Ripuarian) bean (kind of pulse)</li></ol>
Bunnezupp|Bunnezuppe|Bunnezüppche	<i>noun</i><br><ol><li>a thick soup made from beans</li></ol>
Butz|Bützje|Bütz	<i>noun</i><br><ol><li>(chiefly Ripuarian) kiss</li></ol>
Böggel|Böggele|Böggelche	<i>noun</i><br><ol><li>(most dialects of Ripuarian) pouch; bag; purse; wallet</li><li>(same dialects) scrotum</li><li>(same dialects) derogatory term for a man</li></ol>
Bösch|Bösche|Böschelche|Böscher|Böschje	<i>noun</i><br><ol><li>(Ripuarian) forest</li></ol>
Bühel|Bühelche|Bühele	<i>noun</i><br><ol><li>(westernmost Ripuarian) pouch; bag; purse; wallet</li><li>(same dialects) scrotum</li><li>(same dialects) derogatory term for a man</li></ol>
Chress|Chreste	<i>noun</i><br><ol><li>Christian (believer in Christianity)</li></ol>
Chressfess|Chressfeste	<i>noun</i><br><ol><li>Christmas</li></ol>
Daach|Dooch|Dääch|Däächer	<i>noun</i><br><ol><li>(most dialects) day</li><li>(most dialects) roof</li></ol>
Dau|Daue	<i>noun</i><br><ol><li>(most dialects) dew</li><li>(Ripuarian) push</li></ol>
Dauf|Daifche|Dauwe	<i>noun</i><br><ol><li>(Moselle Franconian) dove, pigeon</li></ol>
Deev|Deeve	<i>noun</i><br><ol><li>(Ripuarian) thief</li></ol>
Deiwel	<i>noun</i><br><ol><li>(Moselle Franconian / Hunsrückisch) devil</li></ol>
Densdaach|Densdääch	<i>noun</i><br><ol><li>(most dialects) Tuesday</li></ol>
Desch|Deschelche|Desche|Deschje	<i>noun</i><br><ol><li>(most dialects) table, desk</li></ol>
Dingsdaach|Dingsdääch	<i>noun</i><br><ol><li>(Kölsch, dated) Tuesday</li></ol>
Doch|Döchelche|Döcher	<i>noun</i><br><ol><li>(chiefly Ripuarian) cloth; paper towel</li></ol>
Doef|Duufje|Doeve	<i>noun</i><br><ol><li>(Kirchröadsj) A dove, pigeon, bird of the family Columbidae.</li><li>(Kirchröadsj) A female dove or pigeon.</li><li>(Kirchröadsj, astronomy) The constellation Columba</li></ol>
Donnersdaach|Donnersdääch	<i>noun</i><br><ol><li>(most dialects) Thursday</li></ol>
Droom|Drööm|Drääm|Dröömche|Dreem|Dreemche|Dräämche	<i>noun</i><br><ol><li>(most dialects) dream</li></ol>
Duch|Diecher|Diechelche	<i>noun</i><br><ol><li>(most dialects of Moselle Franconian) cloth</li></ol>
Dumme|Dümmche	<i>verb</i><br><ol><li>(most of Ripuarian) thumb</li></ol>
Dursch	<i>noun</i><br><ol><li>(Ripuarian) thirst</li></ol>
Duuv|Duuve|Düüvje	<i>noun</i><br><ol><li>(Ripuarian) dove; pigeon</li></ol>
Dörp|Dörpche|Dörper	<i>noun</i><br><ol><li>(most dialects of Ripuarian) village</li></ol>
Dösseldorp	<i>name</i><br><ol><li>(Kölsch) Düsseldorf (the capital city of North Rhine-Westphalia, Germany)</li></ol>
Dür|Dürre|Düre|Dürche	<i>noun</i><br><ol><li>(Ripuarian) door</li></ol>
Dütsch	<i>noun</i><br><ol><li>(Kölsch) German</li></ol>
Dütschland	<i>name</i><br><ol><li>(Ripuarian (in Aachen and Köln)) Germany</li></ol>
Düüvel|Düüvelche|Düvele|Düüvele|Düvelche|Düvel	<i>noun</i><br><ol><li>(Ripuarian) devil</li></ol>
Eech|Eeche	<i>noun</i><br><ol><li>(Ripuarian, western Moselle Franconian) oak (tree)</li></ol>
Eis	<i>noun</i><br><ol><li>(Moselle Franconian) ice</li><li>(Moselle Franconian) ice cream</li></ol>
Eng|Engche|Enger	<i>noun</i><br><ol><li>(Ripuarian) Alternative form of Enk</li></ol>
Enk|Enkche|Enger	<i>noun</i><br><ol><li>(most dialects of Ripuarian) end</li></ol>
Essel|Esselche|Essele	<i>noun</i><br><ol><li>(Ripuarian) donkey; ass</li></ol>
Eëts|Eëtse|Eëts-je	<i>noun</i><br><ol><li>(Kirchröadsj) pea</li></ol>
Faddem|Fäddemche|Fäddem	<i>noun</i><br><ol><li>(most of Ripuarian) thread</li></ol>
Famillich|Famillije	<i>noun</i><br><ol><li>(most dialects) family</li></ol>
Fauer|Fouer	<i>noun</i><br><ol><li>(some dialects of Moselle Franconian) fire</li></ol>
Faß|Faßer|Fäßche|Fäßje|Fäßer	<i>noun</i><br><ol><li>(most dialects) barrel, vat, keg, especially for liquids</li></ol>
Feier	<i>noun</i><br><ol><li>(most of Moselle Franconian) fire</li></ol>
Ferke|Ferkelche	<i>noun</i><br><ol><li>(Ripuarian) pig</li></ol>
Fesch|Feschelche|Feschje	<i>noun</i><br><ol><li>(most dialects) fish</li></ol>
Fetz|Fetze|Fetzje	<i>noun</i><br><ol><li>(Ripuarian) a young boy, especially a naughty one (but always in a mild tone)</li></ol>
Fillem|Filme|Fillemche	<i>noun</i><br><ol><li>(most dialects) film</li></ol>
Finster|Finsterche|Finstere	<i>noun</i><br><ol><li>(most of Ripuarian, parts of Moselle Franconian) window</li></ol>
Fleech|Fleeje	<i>noun</i><br><ol><li>(Ripuarian, northern Moselle Franconian) fly (insect)</li></ol>
Fleesch	<i>noun</i><br><ol><li>(Ripuarian, western Moselle Franconian) meat; flesh</li></ol>
Fläsch|Fläsche|Fläschje|Fläschelche	<i>noun</i><br><ol><li>(most dialects) bottle</li></ol>
Flönz|Flönze	<i>noun</i><br><ol><li>(Ripuarian) blood sausage</li></ol>
Fonz|Fonze|Fönzje	<i>noun</i><br><ol><li>(chiefly Ripuarian, vulgar) pussy; vulva</li></ol>
Fott|Föttche|Fotte|Fött	<i>noun</i><br><ol><li>(Ripuarian) posterior; buttocks</li></ol>
Foß|Feeß|Feeßche|Fößje|Föß	<i>noun</i><br><ol><li>(Ripuarian, northern Moselle Franconian) foot (lower part of the leg)</li></ol>
Fraa|Frääche|Fraache|Frahe	<i>noun</i><br><ol><li>(most of Moselle Franconian) woman, wife</li></ol>
Frankreich|Frankreichs	<i>name</i><br><ol><li>(Kölsch) France</li></ol>
Frankrich	<i>name</i><br><ol><li>(Ripuarian (in Aachen and Düren)) France</li></ol>
Freidaach|Freidääch	<i>noun</i><br><ol><li>(Moselle Franconian) Friday</li></ol>
Freud	<i>noun</i><br><ol><li>joy, happiness</li></ol>
Friedaach|Friedääch	<i>noun</i><br><ol><li>(Ripuarian) Friday</li></ol>
Froo|Frääche|Frohe	<i>noun</i><br><ol><li>(southern Moselle Franconian) question</li><li>(few dialects of Moselle Franconian) woman, wife</li></ol>
Frooch|Froge|Frööch	<i>noun</i><br><ol><li>(most dialects) question</li><li>(Ripuarian, uncountable) grain; corn</li><li>(Ripuarian, countable) fruit (sweet edible part of a plant)</li></ol>
Frönd|Frönde|Frönn|Fröndche	<i>noun</i><br><ol><li>(many dialects of Ripuarian) friend</li></ol>
Frösch|Fröschelche	<i>noun</i><br><ol><li>(Ripuarian) frog</li></ol>
Fuss|Fissje|Fusse|Fiss|Füssje|Füss	<i>noun</i><br><ol><li>(Ripuarian, dated in northern Moselle Franconian) fox</li><li>(same dialects) red-haired person, redhead</li></ol>
Fuß	<i>noun</i><br><ol><li>(southern Moselle Franconian) foot (lower part of the leg)</li></ol>
Färv|Färve	<i>noun</i><br><ol><li>(central and western Ripuarian) colour; paint</li></ol>
Fääsch|Fääschte	<i>noun</i><br><ol><li>(Ripuarian) heel (back of the foot or shoe)</li></ol>
Füür|Füürche	<i>noun</i><br><ol><li>(Ripuarian) fire</li></ol>
Griecheland	<i>name</i><br><ol><li>(Kölsch) Greece</li></ol>
Halve Hahn	<i>noun</i><br><ol><li>(chiefly Kölsch) a cheese sandwich, cut in half</li></ol>
Hamburg	<i>name</i><br><ol><li>(Kölsch) Hamburg</li></ol>
Hand|Hänn|Häng|Händche	<i>noun</i><br><ol><li>(many dialects) hand</li></ol>
Hank|Häng|Hängche	<i>noun</i><br><ol><li>(Ripuarian, now chiefly western dialects) hand</li></ol>
Has|Häsje|Häsche|Hase	<i>noun</i><br><ol><li>(Ripuarian, eastern Moselle Franconian) hare</li><li>(same areas, loosely) rabbit</li><li>(same areas) a fearful person, coward</li><li>(Ripuarian) a piece of pork or beef from the loin; tenderloin</li></ol>
Hatz|Hatze|Hätzje|Hatzer	<i>noun</i><br><ol><li>(westernmost Ripuarian) heart</li></ol>
Haus|Haiser|Hous|Heische|Heiser|Haische	<i>noun</i><br><ol><li>(Moselle Franconian) house</li></ol>
Hemb|Hembche|Hemder	<i>noun</i><br><ol><li>(Ripuarian) shirt</li></ol>
Himb|Himmer|Himbche|Himber	<i>noun</i><br><ol><li>(many dialects of Moselle Franconian) shirt</li></ol>
Himmel|Himmele	<i>noun</i><br><ol><li>(most dialects) sky</li><li>(most dialects) heaven</li></ol>
Hock|Höck	<i>noun</i><br><ol><li>(central and eastern Ripuarian) skin</li></ol>
Hohn|Hohnder|Hehnche|Höhner|Hehner|Höhnche	<i>noun</i><br><ol><li>(Ripuarian, northern Moselle Franconian) chicken; hen</li></ol>
Hond|Hendche|Henn|Hönn|Honn|Höndche	<i>noun</i><br><ol><li>(Moselle Franconian, southern Ripuarian) dog; hound</li></ol>
Hongerlegger	<i>noun</i><br><ol><li>(Ripuarian) starveling</li><li>(Ripuarian, offensive) weakling, wimp, loser; somewhat like the contemporary German Opfer</li></ol>
Honk|Höng|Hong|Hönkche	<i>noun</i><br><ol><li>(most dialects of Ripuarian) dog; hound</li></ol>
Hoor|Häärche|Höörche	<i>noun</i><br><ol><li>(most dialects) hair</li></ol>
Hot|Hötche|Heet|Höt|Heetche	<i>noun</i><br><ol><li>(Ripuarian, northern Moselle Franconian) hat</li></ol>
Hunnig	<i>noun</i><br><ol><li>(most dialects) honey</li></ol>
Huus|Hüüser|Hüüsje	<i>noun</i><br><ol><li>(Ripuarian) house</li></ol>
Huusfrau|Huusfraue	<i>noun</i><br><ol><li>(Ripuarian) housewife</li></ol>
Härjott	<i>name</i><br><ol><li>(Ripuarian) God; the Lord</li></ol>
Hätz|Hätzje|Hätzche|Hätze|Hätzer	<i>noun</i><br><ol><li>(most dialects) heart</li></ol>
Ies|Iesje	<i>noun</i><br><ol><li>(Ripuarian) ice</li><li>(Ripuarian) ice cream</li></ol>
Illech	<i>noun</i><br><ol><li>(Moselle Franconian) onion (Allium cepa)</li></ol>
Italie	<i>name</i><br><ol><li>(Kölsch) Italy</li></ol>
Jaade|Jääde|Jäätche	<i>noun</i><br><ol><li>(Ripuarian) garden</li></ol>
Jaas|Jase|Jääsche|Jeës-je|Jaze|Jääs	<i>noun</i><br><ol><li>(western Ripuarian) lane, alley (small street)</li><li>(western Ripuarian) gas (matter in a physical state between liquid and plasma)</li><li>(western Ripuarian) liquefied petroleum gas</li><li>(westernmost Ripuarian) gauze, mesh, wire gauze</li></ol>
Jadeng|Jadenge	<i>noun</i><br><ol><li>(Ripuarian) curtain, especially a window curtain</li></ol>
Januar	<i>noun</i><br><ol><li>(Kölsch) January</li></ol>
Jass|Jässje|Jasse|Jässjer	<i>noun</i><br><ol><li>(Ripuarian) lane, alley (small street)</li></ol>
Jeld	<i>noun</i><br><ol><li>(Ripuarian) money</li></ol>
Jitta|Jittas	<i>noun</i><br><ol><li>(Ripuarian) guitar</li></ol>
Jlas|Jläser|Jläsje	<i>noun</i><br><ol><li>(Ripuarian) glass</li></ol>
Jodesdaach	<i>noun</i><br><ol><li>(parts of western Ripuarian, archaic) Wednesday</li></ol>
Johr|Johre|Jöhrche|Jährche	<i>noun</i><br><ol><li>(most dialects, including Ripuarian) year</li></ol>
Jold	<i>noun</i><br><ol><li>(Ripuarian) gold</li></ol>
Jong|Jöngelche|Jonge|Jengelche	<i>noun</i><br><ol><li>boy, lad</li><li>son</li><li>bachelor, unmarried man of any age</li></ol>
Jood	<i>noun</i><br><ol><li>(westernmost Ripuarian) gold</li></ol>
Jott|Jödder	<i>noun</i><br><ol><li>(Ripuarian) god</li></ol><br><i>name</i><br><ol><li>(Ripuarian) God</li></ol>
Jrav|Jräver|Jrävje|Jraver	<i>noun</i><br><ol><li>(Ripuarian) grave; tomb</li></ol>
Jääsch	<i>noun</i><br><ol><li>(Ripuarian) barley</li></ol>
Jåhr	<i>noun</i><br><ol><li>(Moselle Franconian) year</li></ol>
Jüdd|Jüddche|Jüdde	<i>noun</i><br><ol><li>(Ripuarian) Jew</li></ol>
Kaat|Kaate|Käätche	<i>noun</i><br><ol><li>(most dialects) card</li><li>(most dialects) map</li></ol>
Kallef|Källefche|Kälwer|Kalwer	<i>noun</i><br><ol><li>(Moselle Franconian) calf (young bovine animal)</li></ol>
Kallev|Källevje|Kalver|Kälver	<i>noun</i><br><ol><li>(Ripuarian) calf (young bovine animal)</li></ol>
Kanada	<i>name</i><br><ol><li>(Kölsch) Canada</li></ol>
Kappes|Kappesse	<i>noun</i><br><ol><li>(Ripuarian) cabbage (Brassica oleracea)</li><li>(Ripuarian, figuratively) nonsense</li></ol>
Kend|Kendche|Kenner|Kender	<i>noun</i><br><ol><li>(most of Moselle Franconian, parts of Ripuarian) child</li></ol>
Kerl	<i>noun</i><br><ol><li>(Moselle Franconian / Hunsrückisch) fellow, guy, chap, bloke, man</li></ol>
Kies	<i>noun</i><br><ol><li>(Ripuarian, western Moselle Franconian) cheese</li></ol>
Kirch|Kirchelche|Kirche	<i>noun</i><br><ol><li>(most dialects) church</li></ol>
Klock|Kläckelche|Klöckche|Klöckelche|Klocke|Kläckche	<i>noun</i><br><ol><li>(Ripuarian, parts of Moselle Franconian) bell</li><li>(westernmost Ripuarian) clock</li></ol>
Klompe|Klömpche|Klempche	<i>noun</i><br><ol><li>(most dialects) ball, lump, clot (solidified piece of a soft material)</li><li>(Ripuarian, northern Moselle Franconian) clog, shoe of wood or with a wooden sole</li><li>(chiefly Ripuarian, diminutive) lump of sugar, piece of hard candy</li></ol>
Klotz|Klätzer|Klötzer|Klätzche|Klätz|Klötz|Klötzje	<i>noun</i><br><ol><li>(most dialects) block, log, chunk (piece of a hard material)</li><li>(most dialects) ball in ninepins</li><li>(most dialects) ball, lump, clot (solidified piece of a soft material)</li><li>(most dialects) testicle</li></ol>
Knee|Kneen	<i>noun</i><br><ol><li>(Ripuarian, northern Moselle Franconian) knee</li></ol>
Kneng|Knengche	<i>noun</i><br><ol><li>(most of Ripuarian) rabbit</li></ol>
Knodde|Knöttche	<i>noun</i><br><ol><li>(chiefly Ripuarian) knot</li></ol>
Knuddel|Kniddelche|Knüddelche|Knuddele	<i>noun</i><br><ol><li>(most dialects) clump</li></ol>
Knudel|Knüdelche|Knidelche|Knudele	<i>noun</i><br><ol><li>(many dialects) dumpling</li></ol>
Knöddel|Knöddelche|Knöddele	<i>noun</i><br><ol><li>(Ripuarian) knot</li><li>(Ripuarian) clump</li></ol>
Koh|Köhche|Köh|Kehche|Keh	<i>noun</i><br><ol><li>(Ripuarian, northern Moselle Franconian) cow (female bovine animal)</li></ol>
Kommelejun|Kommelejune	<i>noun</i><br><ol><li>Holy Communion</li><li>First Communion</li></ol>
Koon|Köönche|Kööner	<i>noun</i><br><ol><li>(Ripuarian, uncountable) rye</li><li>(Ripuarian, countable) grain; seed; particle; small object</li></ol>
Korv|Körv|Körvje	<i>noun</i><br><ol><li>(most dialects) basket</li></ol>
Kreech	<i>noun</i><br><ol><li>(Ripuarian, northern Moselle Franconian) war</li></ol>
Kriech	<i>noun</i><br><ol><li>(southern Moselle Franconian) war</li></ol>
Krock|Kröckche	<i>noun</i><br><ol><li>(Ripuarian) herb, useful plant</li><li>(Ripuarian) any small leafy or grass-like plant</li><li>(Ripuarian) thick syrup, particularly from sugarbeets</li></ol>
Krout	<i>noun</i><br><ol><li>(Moselle Franconian) herb, useful plant</li></ol>
Kruck	<i>noun</i><br><ol><li>(Kölsch) herb, useful plant</li><li>(Kölsch) any small leafy or grass-like plant</li><li>(Kölsch) thick syrup, particularly from sugarbeets</li></ol>
Kruckedill|Kruckedillche|Kruckedille	<i>noun</i><br><ol><li>crocodile</li></ol>
Krütz|Krützje|Krützer	<i>noun</i><br><ol><li>(Ripuarian) cross</li></ol>
Kuh	<i>noun</i><br><ol><li>(southern Moselle Franconian) cow (female bovine animal)</li></ol>
Kääz|Kääzje|Kääze	<i>noun</i><br><ol><li>(Ripuarian) candle</li><li>(Ripuarian, slightly vulgar) boner, hard-on</li><li>(Ripuarian, perhaps archaic) icicle</li></ol>
Köbes|Köbesse	<i>noun</i><br><ol><li>A nickname for Jakob</li><li>A waiter, especially the head waiter, in a traditional pub.</li></ol>
Köch|Köche	<i>noun</i><br><ol><li>(Ripuarian) kitchen</li><li>(Ripuarian) cuisine</li></ol>
Kölle	<i>name</i><br><ol><li>(Ripuarian) Cologne (the largest city in North Rhine-Westphalia, in northwestern Germany)</li></ol>
Kölsch	<i>noun</i><br><ol><li>(most dialects) Kölsch lect</li><li>(most dialects) Kölsch beer</li></ol>
Künnijin|Künnijinne	<i>noun</i><br><ol><li>(some dialects, including Kölsch) queen</li></ol>
Künning|Künninge	<i>noun</i><br><ol><li>(some dialects, including Kölsch Ripuarian) king, King (ruler of a kingdom)</li><li>(some dialects, including Kölsch Ripuarian) king (chess piece)</li><li>(some dialects, including Kölsch Ripuarian) king (card)</li></ol>
Lahs|Lähs	<i>noun</i><br><ol><li>(Ripuarian, northern Moselle Franconian, dated) salmon (fish)</li></ol>
Ledder|Leddere|Ledderche	<i>noun</i><br><ol><li>(most of Ripuarian) leather</li><li>(most of western Ripuarian) ladder</li></ol>
Leech|Leechje|Leechter	<i>noun</i><br><ol><li>(central and eastern Ripuarian, Kölsch) light</li></ol>
Leed|Leedche|Leedere|Leeder|Leederche	<i>noun</i><br><ol><li>(Ripuarian, northern Moselle Franconian) song</li><li>(Ripuarian, western Moselle Franconian) sorrow; grief; agony</li></ol>
Leeder|Leedere|Leederche	<i>noun</i><br><ol><li>(central and eastern Ripuarian, western Moselle Franconian) ladder</li></ol>
Leich	<i>noun</i><br><ol><li>(Moselle Franconian) corpse (dead human body)</li></ol>
Lein	<i>noun</i><br><ol><li>(Moselle Franconian) rope of minor to medium thickness; cord</li></ol>
Leng|Lenge|Lengche	<i>noun</i><br><ol><li>(Ripuarian) rope of minor to medium thickness; cord</li></ol>
Levver|Levvere	<i>noun</i><br><ol><li>(Ripuarian) liver</li></ol>
Lich|Liche	<i>noun</i><br><ol><li>(most dialects of Ripuarian) corpse (dead human body)</li><li>(the same dialects, dated) funeral</li></ol>
Lied	<i>noun</i><br><ol><li>(southern Moselle Franconian) song</li></ol>
Liev|Lievje|Liever	<i>noun</i><br><ol><li>(Ripuarian) body</li></ol>
Ling	<i>noun</i><br><ol><li>(Kölsch) rope of minor to medium thickness; cord</li></ol>
Loff	<i>noun</i><br><ol><li>(Ripuarian) air (gas)</li><li>(Ripuarian, some dialects) air (the apparently open space above the ground of the earth)</li></ol>
Läffel|Läffele|Läffelche	<i>noun</i><br><ol><li>(most dialects, but dated in parts of Ripuarian) spoon</li></ol>
Löck|Löckcher	<i>noun</i><br><ol><li>(most dialects of Ripuarian) people; persons; folk</li></ol>
Maat|Määt	<i>noun</i><br><ol><li>(most dialects) market</li></ol>
Mau|Mäuche|Maue	<i>noun</i><br><ol><li>(chiefly Ripuarian) sleeve</li></ol>
Meck|Megge|Meggelche	<i>noun</i><br><ol><li>(all of Moselle Franconian) a thin-bodied flying insect, particularly a mosquito, also a crane fly, gnat, or midge</li><li>(southern Moselle Franconian) a fly</li></ol>
Menutt|Menutte	<i>noun</i><br><ol><li>(most dialects) minute</li></ol>
Mettwoch	<i>noun</i><br><ol><li>(most dialects) Wednesday</li></ol>
Metz|Metzer|Metzje	<i>noun</i><br><ol><li>(Ripuarian, some dialects of Moselle Franconian) knife</li></ol>
Modder|Moddere|Möddersje	<i>noun</i><br><ol><li>(Limburgan Ripuarian) mother</li><li>(Kirchröadsj) bolt</li></ol>
Modderjoddes	<i>name</i><br><ol><li>(Kölsch, Christianity) Mother of God</li></ol>
Monakko	<i>name</i><br><ol><li>(Kölsch) Monaco</li></ol>
Mond|Monde	<i>noun</i><br><ol><li>(most dialects) moon</li><li>(most dialects) month</li></ol>
Mondaach|Mondääch	<i>noun</i><br><ol><li>(most dialects) Monday</li></ol>
Motter|Mötterche|Mötter|Metterche|Metter	<i>noun</i><br><ol><li>mother</li></ol>
Mouer	<i>noun</i><br><ol><li>(Moselle Franconian) wall</li></ol>
Muhr|Murre|Muhre|Mührche	<i>noun</i><br><ol><li>(Ripuarian, northern Moselle Franconian) carrot</li></ol>
Muul|Muule|Müüler|Müülche	<i>noun</i><br><ol><li>(Ripuarian) mouth of a person</li><li>(Ripuarian) mouth of an animal; snout; muzzle</li><li>(western Ripuarian) slipper</li></ol>
Muur|Muure|Müürche	<i>noun</i><br><ol><li>(Ripuarian) wall</li></ol>
Muus|Müüsje|Müüs	<i>noun</i><br><ol><li>(Ripuarian) mouse</li></ol>
Märch	<i>noun</i><br><ol><li>(Ripuarian) marrow</li></ol>
Möck|Möggelche|Mögge	<i>noun</i><br><ol><li>(Ripuarian) a thin-bodied flying insect, particularly a mosquito, also a crane fly, gnat, or midge</li></ol>
Möhn|Möhne	<i>noun</i><br><ol><li>(Ripuarian) an older woman; not implying decrepitness, but having a mildly contemptuous tone</li></ol>
Mösch|Mösche|Möschelche	<i>noun</i><br><ol><li>(Ripuarian) sparrow (small bird)</li></ol>
Naach|Näächte|Naachte|Nääch	<i>noun</i><br><ol><li>(central and eastern Ripuarian) night</li></ol>
Naiht|Naihte	<i>noun</i><br><ol><li>(Ripuarian in Belgium) night</li></ol>
Nas|Näsche|Nase|Näsje	<i>noun</i><br><ol><li>(Ripuarian, eastern Moselle Franconian) nose</li></ol>
Nohber|Nohbere	<i>noun</i><br><ol><li>(most dialects) neighbour</li></ol>
Nool|Noole|Nohl|Nähl|Nääl|Nol	<i>noun</i><br><ol><li>(most dialects) needle</li><li>(Moselle Franconian) nail</li></ol>
Nääl|Nähl	<i>noun</i><br><ol><li>(eastern and central Ripuarian) nail</li></ol>
Oche	<i>name</i><br><ol><li>(western Ripuarian) Aachen (city)</li></ol>
Odem	<i>noun</i><br><ol><li>breath</li></ol>
Oder|Äderche|Öderche|Odere	<i>noun</i><br><ol><li>(most dialects) blood vessel, vein</li></ol>
Ohs|Ohße|Ähsche|Öhsje	<i>noun</i><br><ol><li>(Ripuarian, northern Moselle Franconian) ox (castrated male bovine animal)</li><li>(Ripuarian, northern Moselle Franconian) bull (any male bovine animal)</li></ol>
Ollich	<i>noun</i><br><ol><li>(central and eastern Ripuarian, parts of Moselle Franconian) oil</li></ol>
Ooch|Ooge|Ööjelche	<i>noun</i><br><ol><li>(most of Ripuarian, northern Moselle Franconian) eye</li></ol>
Ooche	<i>name</i><br><ol><li>(Moselle Franconian, central and eastern Ripuarian) Aachen (city)</li></ol>
Ovve|Övve	<i>noun</i><br><ol><li>(Ripuarian) oven</li></ol>
Pand|Pändche|Pänder|Pänner	<i>noun</i><br><ol><li>(many dialects) pledge; security; deposit; pawn</li></ol>
Pank|Panger|Pängche|Pänger	<i>noun</i><br><ol><li>(Ripuarian, now chiefly western dialects) pledge; security; deposit; pawn</li><li>(Ripuarian, dated) delimited area or surface (chiefly of land, hence: parcel)</li></ol>
Pann|Pännche|Panne	<i>noun</i><br><ol><li>(most dialects) frying pan</li></ol>
Paraplü	<i>noun</i><br><ol><li>(Aachen) umbrella</li></ol>
Pastuur|Pastier|Pastüür	<i>noun</i><br><ol><li>(most dialects) pastor (clergyman who serves a parish)</li></ol>
Peif|Peife|Peifche	<i>noun</i><br><ol><li>(Moselle Franconian) stovepipe</li><li>(Moselle Franconian) pipe (smoking implement)</li><li>(Moselle Franconian) flute</li></ol>
Peng	<i>noun</i><br><ol><li>(Ripuarian) pain</li></ol>
Pief|Piefje|Piefe	<i>noun</i><br><ol><li>(Ripuarian) stovepipe</li><li>(Ripuarian) pipe (smoking implement)</li></ol>
Plan|Pläne|Plänche	<i>noun</i><br><ol><li>plan (way of procedure)</li><li>map (schematic maps of streets, subways, etc., often detailed)</li><li>(Limburgan Ripuarian, film) shot</li></ol>
Platt	<i>noun</i><br><ol><li>(Ripuarian) dialect</li></ol>
Plooch|Ploge|Plee|Plööch|Pleech	<i>noun</i><br><ol><li>(Ripuarian, northern Moselle Franconian) plough, plow</li><li>(Ripuarian) an epidemic of any disease, not necessarily dangerous</li><li>(Ripuarian) a nuisance, something strenuous</li></ol>
Pooschdaach	<i>noun</i><br><ol><li>(Ripuarian) Easter Sunday</li></ol>
Poosche	<i>noun</i><br><ol><li>(obsolete outside of compounds) Easter</li></ol>
Pooz|Pöözje|Pooze	<i>noun</i><br><ol><li>gate</li></ol>
Prumm|Prumme|Prümmche	<i>noun</i><br><ol><li>(Ripuarian) plum; usually restricted to the round, firm sorts; sometimes including longer, softer sorts</li><li>(Ripuarian, mildly vulgar) pussy; vulva</li></ol>
Pääd|Päädche	<i>noun</i><br><ol><li>(chiefly Ripuarian) horse</li></ol>
Päärd	<i>noun</i><br><ol><li>(Siegerland Moselle Franconian) horse</li></ol>
Pöll|Pöllche|Pölle	<i>noun</i><br><ol><li>(western and central Ripuarian) pullet; young hen</li><li>(the same dialects, mildly vulgar) young, usually attractive girl; chick</li></ol>
Rauh	<i>noun</i><br><ol><li>(Ripuarian) stillness, calm, rest, ease, tranquility, silence (absence of stress, movement, and/or sound)</li></ol>
Rend|Render|Renner|Rendche	<i>noun</i><br><ol><li>(most of Moselle Franconian, parts of Ripuarian) cow; bull; (head of) cattle</li></ol>
Rhing	<i>name</i><br><ol><li>(some of Ripuarian, including Kölsch) Rhine (European river)</li></ol>
Rus|Ruse|Rüsje|Riesche	<i>noun</i><br><ol><li>(most dialects) rose</li></ol>
Räjeboge	<i>noun</i><br><ol><li>(Ripuarian) rainbow</li></ol>
Rään	<i>noun</i><br><ol><li>(most dialects) rain</li></ol>
Rögge|Röggelcher|Röggelche	<i>noun</i><br><ol><li>(Ripuarian) back; rear of the body</li></ol>
Röggelche|Röggelcher	<i>noun</i><br><ol><li>(Ripuarian) rye roll</li></ol>
Sallem|Salme	<i>noun</i><br><ol><li>(chiefly along Rhine and Moselle) salmon (fish)</li></ol>
Same	<i>noun</i><br><ol><li>seed</li></ol>
Samsdaach|Sambsdääch|Sambsdaach|Samsdääch	<i>noun</i><br><ol><li>(most dialects) Saturday</li></ol>
Sau|Seiche|Säuche|Sei|Säu	<i>noun</i><br><ol><li>(Ripuarian, western Moselle Franconian) sow; female pig</li><li>(eastern Moselle Franconian) pig (male or female)</li></ol>
Schatte	<i>noun</i><br><ol><li>(many dialects) shadow; shade</li></ol>
Scheif|Scheiwe|Scheifche	<i>noun</i><br><ol><li>(Moselle Franconian) disc, slice, pane (flat piece or surface)</li></ol>
Schiev|Schieve|Schievje	<i>noun</i><br><ol><li>(Ripuarian) disc, slice, pane (flat piece or surface)</li></ol>
Schlang	<i>noun</i><br><ol><li>(Moselle Franconian / Hunsrückisch) snake</li></ol>
Schlot|Schlote	<i>noun</i><br><ol><li>(many dialects) salad; lettuce</li></ol>
Schnie	<i>noun</i><br><ol><li>(most dialects) snow</li></ol>
Schnüss|Schnüsse|Schnüssje	<i>noun</i><br><ol><li>(Ripuarian) face, mouth</li></ol>
Schof|Schäfche|Schöfche	<i>noun</i><br><ol><li>sheep</li></ol>
Schohn|Schöhnche	<i>noun</i><br><ol><li>(Ripuarian) shoe</li></ol>
Scholder|Scholdere	<i>noun</i><br><ol><li>(many dialects of Ripuarian) shoulder</li></ol>
Schull|Schulle	<i>noun</i><br><ol><li>(most dialects) school</li></ol>
Schwein|Schweine|Schweinche	<i>noun</i><br><ol><li>(western Moselle Franconian) pig; swine (animal)</li><li>(all dialects) swine (mean person)</li></ol>
Schwester|Schwestere|Schwesterche	<i>noun</i><br><ol><li>sister</li><li>nun</li><li>nurse</li></ol>
Seck|Segge	<i>noun</i><br><ol><li>(most dialects of Ripuarian) side</li><li>(most dialects of Ripuarian) page</li></ol>
Seel|Seeler|Seelche	<i>noun</i><br><ol><li>(Ripuarian, western Moselle Franconian) rope of medium to maximal thickness</li></ol>
Senn|Senne|Senn	<i>noun</i><br><ol><li>(most dialects) sense</li><li>(most dialects) mind</li><li>(Moselle Franconian) sin</li></ol>
Sie|Sijje	<i>noun</i><br><ol><li>(westernmost Ripuarian) side</li><li>(westernmost Ripuarian) page</li></ol>
Siel|Siele|Sielche	<i>noun</i><br><ol><li>(most dialects) soul</li></ol>
Sock|Socke|Söckche|Seckche|Söck	<i>noun</i><br><ol><li>(most dialects) sock</li></ol>
Sonn|Sennche|Sönn|Sönnche|Sonne|Senn	<i>noun</i><br><ol><li>(most dialects) sun</li><li>(most dialects) son</li></ol>
Sonndaach|Sonndääch	<i>noun</i><br><ol><li>(most dialects) Sunday</li></ol>
Spidol|Spidäler|Spidälche|Spidöler|Spidölche	<i>noun</i><br><ol><li>(most dialects) hospital</li></ol>
Sproch|Sproche|Spröch|Sprechelche|Spröchelche|Sprech	<i>noun</i><br><ol><li>saying</li></ol>
Sprooch|Sprooche|Sproch|Sproche	<i>noun</i><br><ol><li>(most dialects) language</li></ol>
Steen|Steenche	<i>noun</i><br><ol><li>(Ripuarian, western Moselle Franconian) stone</li></ol>
Stock|Stöck|Stäckelche|Stäck|Stöckelche|Stöcker	<i>noun</i><br><ol><li>(most dialects) stick; staff</li><li>(most dialects) floor; storey; level</li></ol>
Stromp|Stremp|Strömp|Strömpche|Strempche	<i>noun</i><br><ol><li>(most dialects) stocking</li></ol>
Stroß|Strößje|Stroße|Sträßche	<i>noun</i><br><ol><li>street; road</li></ol>
Stuvv|Stuvve|Stüvvje	<i>noun</i><br><ol><li>(Ripuarian) living room, sitting room</li></ol>
Stätz|Stätzje|Stätze	<i>noun</i><br><ol><li>(some of Ripuarian, including Kölsch) tail (of an animal)</li></ol>
Stään|Stääne|Stään|Stäänche	<i>noun</i><br><ol><li>(most of Ripuarian) star</li><li>(eastern Moselle Franconian, except Westerwald) stone</li></ol>
Stöck|Stöckelche|Stöcker	<i>noun</i><br><ol><li>(Ripuarian, plural Stöcker) piece</li><li>(Ripuarian, plural Stöck or Stöcker) general counter word, usually not translated in English</li></ol>
Trottwa	<i>noun</i><br><ol><li>(many dialects, including Aachen) sidewalk</li></ol>
Uhr|Uhre|Ührche	<i>noun</i><br><ol><li>(Ripuarian, northern Moselle Franconian) ear</li><li>(Ripuarian) watch; clock</li><li>(Ripuarian) o'clock</li></ol>
Ullieg|Ullieje|Ulliegs-je	<i>noun</i><br><ol><li>(Kirchröadsj) onion (Allium cepa)</li><li>(Kirchröadsj, derogatory) an idiot</li></ol>
Uustere	<i>noun</i><br><ol><li>Easter</li></ol>
Vadder|Veddersje|Vedder|Vaddere	<i>noun</i><br><ol><li>(Limburgan Ripuarian) father</li></ol>
Vatter|Vätterche|Vätter	<i>noun</i><br><ol><li>father</li></ol>
Vinster|Vinstersje|Vinstere	<i>noun</i><br><ol><li>(Kirchröadsj Ripuarian) window</li><li>(Kirchröadsj Ripuarian, computing) window</li></ol>
Vuggel|Vüjjelche|Vijjelche|Vüjjel|Vijjel	<i>noun</i><br><ol><li>(Ripuarian, many dialects of Moselle Franconian) bird</li></ol>
Vääsch|Vääschje|Vääsche|Vääschte	<i>noun</i><br><ol><li>(most of Ripuarian) verse</li></ol>
Wand|Wändche|Wäng|Wänn	<i>noun</i><br><ol><li>(many dialects) wall</li></ol>
Wasser|Wässerche	<i>noun</i><br><ol><li>(many dialects) water</li></ol>
Wedder|Wedderche	<i>noun</i><br><ol><li>(most of Ripuarian) weather</li></ol>
Wedderfrösch	<i>noun</i><br><ol><li>(Ripuarian) a frog kept in a jar with a small ladder, used to predict the weather; see German Wetterfrosch for more</li></ol>
Weech|Weechje|Weechelche|Weechter|Weeje|Weejelche	<i>noun</i><br><ol><li>(Ripuarian) a child, especially a girl, daughter</li><li>(Ripuarian, northern Moselle Franconian) cradle</li></ol>
Weiher|Weiherche|Weihere	<i>noun</i><br><ol><li>(most dialects) pond</li></ol>
Weiht|Weihter|Weihtche	<i>noun</i><br><ol><li>(northernmost Ripuarian) girl (female child, adolescent, young woman)</li></ol>
Weng|Wengche	<i>noun</i><br><ol><li>(Ripuarian) wine</li></ol>
Wenter|Wentere	<i>noun</i><br><ol><li>(most of Moselle Franconian, parts of Ripuarian) winter</li></ol>
Wiev|Wiever|Wievje	<i>noun</i><br><ol><li>(Ripuarian, derogatory) woman</li></ol>
Wittfrau|Wittfraue|Wittmann	<i>noun</i><br><ol><li>(Ripuarian, few dialects of Moselle Franconian) widow</li></ol>
Woch|Wöchelche|Woche	<i>noun</i><br><ol><li>(most dialects) week</li></ol>
Woeësj|Wuesj|Woeësjte|Wuesj-je	<i>noun</i><br><ol><li>(Kirchröadsj) sausage</li><li>(Kirchröadsj, vulgar slang) penis</li></ol>
Woo|Wohe|Woh|Wähelche	<i>noun</i><br><ol><li>(southern and eastern Moselle Franconian) scales (instrument for measuring)</li></ol>
Wooch|Wooge	<i>noun</i><br><ol><li>(Ripuarian, north-western Moselle Franconian) scales (instrument for measuring)</li></ol>
Woot|Wööt|Wööder|Wöötche	<i>noun</i><br><ol><li>(many dialects of Ripuarian) word</li></ol>
Wursch|Würschje|Würsch	<i>noun</i><br><ol><li>(most of Ripuarian) sausage</li></ol>
Wääch|Wää|Wäje	<i>noun</i><br><ol><li>(most dialects) way; path; distance</li></ol>
Zahn|Zäng|Zähnche	<i>noun</i><br><ol><li>(some dialects of Ripuarian) tooth</li></ol>
Zamsdieg|Zamsdiegs-je|Zamsdieje	<i>noun</i><br><ol><li>(Kirchröadsj) Saturday</li></ol>
Zand|Zäng|Zändche|Zänn	<i>noun</i><br><ol><li>(many dialects) tooth</li></ol>
Zank|Zänkche|Zäng	<i>noun</i><br><ol><li>(Ripuarian, now chiefly western dialects) tooth</li></ol>
Zeck|Zecke|Zegge	<i>noun</i><br><ol><li>(most dialects of Ripuarian) time</li><li>(most dialects) tick (insect)</li></ol>
Zieh|Ziehe|Ziehche	<i>noun</i><br><ol><li>(most dialects) toe (digit on the foot)</li></ol>
Ziet|Ziede|Zijje	<i>noun</i><br><ol><li>(westernmost and northernmost Ripuarian) time</li></ol>
Zoam|Zöam|Zöamsje	<i>noun</i><br><ol><li>(Limburgan Ripuarian) seed, grain</li><li>(Limburgan Ripuarian, uncommon) sperm, semen</li></ol>
Zong|Zengelche|Zonge|Zöngelche	<i>noun</i><br><ol><li>(most dialects) tongue</li></ol>
Zoot|Zoote|Zöötche	<i>noun</i><br><ol><li>(chiefly Ripuarian) kind; sort</li><li>(in particular) a certain kind of people, of characters</li></ol>
Zupp|Züppche|Zuppe	<i>noun</i><br><ol><li>soup</li></ol>
aabakke|bakt aa|aajebakke|bakket aa|bók aa|aabakkend|aabakkens	<i>verb</i><br><ol><li>(Kirchröadsj, intransitive) to burn to the pan.</li><li>(Kirchröadsj, ergative) to cook evenly.</li></ol>
aabeie|aajeboane|aabeiend|aabeiens|beiet aa|boan aa|beit aa	<i>verb</i><br><ol><li>(Kirchröadsj, ditransitive) to offer, to provide.</li><li>(Kirchröadsj, reflexive) to offer oneself, to volunteer, (in sexual contexts) to solicit.</li></ol>
aabelange|aabelangens|belanget aa|belangt aa|aabelangd|aabelangend	<i>verb</i><br><ol><li>(Kirchröadsj, transitive) to concern, to affect.</li></ol>
aabeveële|beveëlt aa|aabevoale|bevool aa|beveëlet aa|aabeveëlend|aabeveëlens	<i>verb</i><br><ol><li>(Kirchröadsj, transitive) to recommend</li><li>(Kirchröadsj, transitive) to advocate</li><li>(Kirchröadsj, intransitive, reflexive) to recommend oneself</li></ol>
aabeëne|aajebeënd|beënt aa|beënet aa|aabeënens|aabeënend	<i>verb</i><br><ol><li>(Kirchröadsj, transitive) to worship</li><li>(Kirchröadsj, transitive, figuratively) to adore</li></ol>
aabiese|biest aa|bieset aa|aajebèse|aabiesend|bees aa|aabiesens	<i>verb</i><br><ol><li>(Kirchröadsj, transitive) to take the first bite of food</li><li>(Kirchröadsj, intransitive, of fish) to bite, to take the bait</li></ol>
aabinge|bong aa|aabingens|aajebónge|bingt aa|aabingend	<i>verb</i><br><ol><li>(Kirchröadsj, intransitive) to make contact, to reach out</li><li>(Kirchröadsj, transitive) to affix (something) to something else, to bind</li></ol>
aabletsje|bletsjt aa|bletsjet aa|aabletsjens|aabletsjend|aajebletsjd	<i>verb</i><br><ol><li>(Kirchröadsj, transitive) to bark at</li><li>(Kirchröadsj, transitive) to shout at (in an unsympathetic manner)</li></ol>
aablieve|blieft aa|aablievens|bloof aa|aajeblóve|blievet aa|bleef aa|aablievend|aajeblève|bliet aa	<i>verb</i><br><ol><li>(Kirchröadsj, intransitive) to remain in office</li><li>(Kirchröadsj, intransitive) to keep a (romantic) relationship going</li></ol>
aabloaze|aabloazens|bloast aa|aabloazend|aajebloaze|bloazet aa|bloos aa	<i>verb</i><br><ol><li>(Kirchröadsj, transitive) to kindle by means of breath or wind</li><li>(Kirchröadsj, intransitive, music) to play the first note with a wind instrument</li></ol>
aaboare|aajeboard|aaboarens|boart aa|aaboarend|boaret aa	<i>verb</i><br><ol><li>(Kirchröadsj, transitive) to tap into a resource (mostly said of coal)</li></ol>
aabraad	<i>adv</i><br><ol><li>(Kirchröadsj) relevant</li></ol>
aaböake|aaböakend|aajeböakd|böaket aa|böakt aa|aaböakens	<i>verb</i><br><ol><li>(Kirchröadsj, intransitive) to loudly rant against someone</li></ol>
aach	<i>num</i><br><ol><li>(Ripuarian) eight</li></ol>
aan	<i>prep</i><br><ol><li>(most dialects) on; at</li><li>(most dialects) to</li></ol>
absjäulieg|absjäuliejer|absjäuliegste	<i>adj</i><br><ol><li>(Kirchröadsj) abominable, hideous</li><li>(Kirchröadsj) abhorrent, detestable</li></ol><br><i>adv</i><br><ol><li>(Kirchröadsj) hideously, beastly, abominably, detestably</li></ol>
ach	<i>num</i><br><ol><li>(Limburgan Ripuarian) eight (numerical value represented by the Arabic numeral 8; or describing a set with eight elements)</li></ol>
allt	<i>adv</i><br><ol><li>(Ripuarian, northern Moselle Franconian) already</li></ol>
alt|aalste|aaler|älder|aale|äälste|aal|ältste|ääler	<i>adj</i><br><ol><li>(most dialects) old</li></ol>
am Eng	<i>adv</i><br><ol><li>(most dialects of Ripuarian) in the end; finally</li></ol>
ander|andere	<i>adj</i><br><ol><li>(some dialects of Ripuarian) other</li><li>(some dialects of Ripuarian) different</li></ol>
aod|äudstes|heë is aod|inne äudste|gès äudste|heë is 't äudste|ge auwer|d'n aode|dèr auwer|d'm auwere|jetter aode|ge äudste|eens äudste|inne auwere|'t aode|aoder|zie is auwer|g'n äudste|zie is aod|'t auwere|'t Aods|dès aode|eens aode|ing aode|äudste|gès aode|zie is 't äudste|g'm auwere|jet auwer|zie zunt auwer|äudstem|dèr äudste|g'r auwer|de auwer|jet aode|inger aode|jetter auwer|ing äudste|g'r auwere|ge aode|innen auwere|inne aode|heë is auwer|d'n auwere|auwer|g'n auwere|g'r äudste|aodes|auweren|gès auwere|jet äudste|zie zunt aod|auwerem|d'r auwer|gèr äudste|d'r äudste|d'm äudste|'t is aod|aoden|d'n auwer|innen aode|'t äudste|innes äudste|de aode|auwere|ing auwer|dès auwere|de äudste|innem äudste|innes auwere|innem auwere|äudsten|dès äudste|eens auwere|g'n auwer|ee auwere|auwerer|d'r auwere|inger äudste|dèr aode|aode|g'm aode|ee aode|'t is auwer|jetter äudste|auweres|inger auwer|'t is 't äudste|ge auwere|zie zunt 't äudste|g'm äudste|g'r aode|g'n aode|ee äudste|äudster|d'm aode|gèr auwer|innen äudste|aodem|gèr aode|innem aode|innes aode|d'r aode|d'n äudste	<i>adj</i><br><ol><li>(Kirchröadsj) old</li></ol>
auw|äudstes|inne äudste|gès äudste|heë is 't äudste|ge auwer|dèr auwer|d'm auwere|g'n auwe|ge äudste|eens äudste|inne auwere|innen auwe|zie is auwer|g'n äudste|'t auwere|g'r auwe|äudste|zie is 't äudste|'t is auw|g'm auwere|jet auwer|zie zunt auwer|äudstem|heë is auw|dèr äudste|g'r auwer|dèr auwe|de auwer|jetter auwer|ing äudste|g'r auwere|zie zunt auw|innen auwere|heë is auwer|d'n auwere|auwer|auwe|g'n auwere|g'r äudste|g'm auwe|auweren|gès auwere|inger auwe|jet äudste|gèr auwe|auwem|auwerem|d'r auwer|gèr äudste|d'r äudste|ge auwe|d'm äudste|gès auwe|d'r auwe|inne auwe|auwes|d'n auwer|'t äudste|ee auwe|innes äudste|de auwe|auwere|ing auwer|dès auwere|'t auwe|'t Auws|de äudste|innem äudste|innes auwere|innem auwere|äudsten|dès äudste|eens auwere|jet auwe|auwen|g'n auwer|ee auwere|auwerer|d'r auwere|inger äudste|d'n auwe|dès auwe|eens auwe|innes auwe|'t is auwer|jetter äudste|auweres|inger auwer|'t is 't äudste|ge auwere|zie zunt 't äudste|g'm äudste|ee äudste|äudster|ing auwe|gèr auwer|innen äudste|jetter auwe|d'm auwe|innem auwe|d'n äudste|zie is auw	<i>adj</i><br><ol><li>(Kirchröadsj) old</li></ol>
baal	<i>adv</i><br><ol><li>(most dialects) soon</li><li>(most dialects) almost</li></ol>
bedde|bett|jebedde|jebett	<i>verb</i><br><ol><li>(Ripuarian, transitive or intransitive, with öm) to ask for something; to beg</li><li>(Ripuarian, intransitive or transitive) to pray</li></ol>
beede|geboade|bütt|beet|gebode|bot|jebodde|bott	<i>verb</i><br><ol><li>(Ripuarian, northern Moselle Franconian) to offer</li></ol>
beeje|büch|geboge|jeboge|beecht|boch	<i>verb</i><br><ol><li>(Ripuarian, northern Moselle Franconian, transitive) to bend</li><li>(same regions, reflexive) to be bent</li></ol>
bei	<i>prep</i><br><ol><li>(most dialects) at; with; by; near; (close) to</li></ol>
benge|jebonge|tense bong|bengk	<i>verb</i><br><ol><li>(most of Ripuarian) to bind</li></ol>
better|et betterste|betterer|bettere	<i>adj</i><br><ol><li>(most dialects) bitter</li></ol>
blend|blenne|blende|blenner|blenn|et blendste|blender	<i>adj</i><br><ol><li>(Moselle Franconian, some dialects of Ripuarian) blind; unable to see</li></ol>
blieve|bliev|bliet|blevv|blevve|jeblevve	<i>verb</i><br><ol><li>(Ripuarian) to stay; to remain</li></ol>
blond|blond|blonner|blonn|blonne|et blondste|blonder|blonde	<i>adj</i><br><ol><li>(Eifel) blind; unable to see</li><li>blond; fair</li></ol>
bloo|et blooste|bloher|blohe|bloh|et blohste	<i>adj</i><br><ol><li>(many dialects) blue</li></ol>
bläck|bläcker|et bläckste|bläcke	<i>adj</i><br><ol><li>(chiefly Ripuarian) bare; naked; uncovered; said of body parts, not of people</li></ol>
breet|breede|breeder|et breetste	<i>adj</i><br><ol><li>(Ripuarian, Eifel) broad; wide</li></ol>
brenge|brengk|jebraht|braach|brengt|braht|gebraacht|jebraach|braacht	<i>verb</i><br><ol><li>(most dialects) to bring; to take something somewhere</li></ol>
brenne	<i>verb</i><br><ol><li>to burn</li></ol>
brille	<i>verb</i><br><ol><li>(Moselle Franconian / Hunsrückisch) to cry</li></ol>
brong|bronger|bronge|et brongste	<i>adj</i><br><ol><li>(most dialects of Ripuarian) brown</li></ol>
bruche|bruch|broht|brooch|jebruch	<i>verb</i><br><ol><li>(Ripuarian) to need</li><li>(Ripuarian, interrogative or negated) to need, have to</li></ol>
brääche|gebroch|brech|brooch|jebroche|brecht	<i>verb</i><br><ol><li>(Ripuarian, northern Moselle Franconian) to break</li></ol>
böcke|böck|jeböck|jebock	<i>verb</i><br><ol><li>(Ripuarian, reflexive) to bend down, to stoop</li></ol>
dausend	<i>num</i><br><ol><li>(many dialects) a thousand</li></ol>
de|dat|dä (some Ripuarian dialects; full)|ət|dę̄|den|full|dem|der (some Ripuarian dialects; reduced)|mf dęǹə|dä|der|dęꝛ|dę|die (most dialects; full)|die|dęs|där (Moselle Franconian; full)|des|dę̄ꝛ|n (fan) dęǹə|dē|de (few dialects; reduced)|de (some dialects, also some Ripuarian dialects; reduced)|dęm|dę̄ (dęǹə)|et|dä (Ripuarian; full)	<i>article</i><br><ol><li>(most dialects) feminine nominative and accusative</li><li>(most dialects) plural nominative and accusative</li><li>(many dialects) plural dative</li><li>(some dialects) masculine nominative</li><li>(some dialects) masculine accusative</li><li>(few dialects) feminine dative</li></ol>
deef|deefe|deefer|et deefste	<i>adj</i><br><ol><li>(Ripuarian, northern Moselle Franconian) deep</li></ol>
deep|et deepste|deepe	<i>adj</i><br><ol><li>(Ripuarian, archaic in many dialects) deep</li></ol>
deister|deistere|et deisterste|deisterer	<i>adj</i><br><ol><li>(Moselle Franconian) dark (without light)</li></ol>
denke|tense daach|denkt|denk|gedaacht|jedaach|daacht	<i>verb</i><br><ol><li>(most dialects) to think</li></ol>
di|dinge|deng|denge|ding	<i>det</i><br><ol><li>(Ripuarian) your (second-person singular possessive)</li></ol>
do	<i>adv</i><br><ol><li>here; there; in this or that place</li><li>(Ripuarian, northern Moselle Franconian) then; back then (at a certain time in the past)</li></ol><br><i>pron</i><br><ol><li>(few dialects, including Kölsch) thou; you (singular)</li></ol>
donn|dät|deit|jedonn|jedon|deet	<i>verb</i><br><ol><li>(many dialects of Ripuarian, including Kölsch) to do</li><li>(same dialects) Used in the preterite with a following infinitive to form the paraphrastic preterite.</li><li>(same dialects) Used in the subjunctive with a following infinitive to form the conditional tense.</li></ol>
doov|doover|doove|et doovste	<i>adj</i><br><ol><li>(Ripuarian) deaf</li></ol>
draan|dreit|gedraan|drooch|gedrage|drät	<i>adv</i><br><ol><li>(most dialects) prominal adverb of an, aan: on it, at it</li></ol><br><i>verb</i><br><ol><li>(few dialects of Moselle Franconian) to carry, bear, wear</li></ol>
drage|drooch|jedrage|drät	<i>verb</i><br><ol><li>(most of Ripuarian) to carry, bear, wear</li></ol>
drei	<i>num</i><br><ol><li>(most dialects) three</li></ol>
drenke|gedronk|jedronke|drenk|gedronke|drenkt|dronk	<i>verb</i><br><ol><li>(most dialects) to drink</li></ol>
driehe|drieht|jedrieht	<i>verb</i><br><ol><li>(central and western Ripuarian) to turn, spin, twist</li></ol>
drieve|jedrevve|driev|drevv	<i>verb</i><br><ol><li>(Ripuarian, transitive) to drive; to push; to chase (cause to go somewhere or to do something)</li><li>(Ripuarian, intransitive) to float</li></ol>
drieße|drieß|jedresse	<i>verb</i><br><ol><li>(Ripuarian, mildly vulgar) to shit; to defecate</li></ol>
droon|drooch|gedroon|gedrage|dreet|drät|druuch	<i>verb</i><br><ol><li>(most of Moselle Franconian, parts of southern Ripuarian) to carry, bear, wear</li></ol>
drööme|droomp|dröömp|jedroomp|jedröömp	<i>verb</i><br><ol><li>(most of Ripuarian) to dream</li></ol>
drüch|drüjje|et drüchste|drüjjer|drühe|drüh|drüher	<i>adj</i><br><ol><li>(Ripuarian) dry</li></ol>
dut|duhe|dude|duh	<i>adj</i><br><ol><li>(Ripuarian, northern Moselle Franconian) dead; not alive</li></ol>
dä|full	<i>article</i><br><ol><li>(Ripuarian) masculine nominative and accusative</li><li>(Ripuarian) feminine dative</li><li>(some dialects of Ripuarian) plural dative</li></ol><br><i>pron</i><br><ol><li>(Ripuarian) this (one), that (one)</li></ol>
dän|full	<i>article</i><br><ol><li>(many dialects) plural dative</li><li>(Moselle Franconian) masculine accusative</li><li>(western Moselle Franconian) masculine nominative</li></ol>
där|full	<i>article</i><br><ol><li>(Moselle Franconian) feminine dative</li><li>(eastern Moselle Franconian) masculine nominative</li></ol>
däue|jedaut|däut|daut	<i>verb</i><br><ol><li>(Ripuarian) to push; to shove</li></ol>
döksch|dökscher|et dökschte|döksche	<i>adj</i><br><ol><li>(central and eastern Ripuarian, widely archaic) German; of Germany</li></ol>
dööfe|dööf|jedööf	<i>verb</i><br><ol><li>(most of Ripuarian) to baptise</li></ol>
dürve|darf|jedurf|durf	<i>verb</i><br><ol><li>(Ripuarian) may; to be allowed to</li></ol>
düster|düsterer|et düsterste|düstere	<i>adj</i><br><ol><li>(Ripuarian) dark (without light)</li></ol>
dütsch|dütsche|dütscher|et dütschte	<i>adj</i><br><ol><li>(Ripuarian) German; of Germany</li></ol>
düür|et düürste|düürtste|düürer|düüre|düürter	<i>adj</i><br><ol><li>(Ripuarian) expensive</li></ol>
eckesch	<i>adv</i><br><ol><li>(Ripuarian, dated) just; only</li></ol>
eeje|eejener|et eejenste|eejene	<i>adj</i><br><ol><li>(Ripuarian, western Moselle Franconian) own</li><li>(same regions) idiosyncratic; quirky</li></ol>
een	<i>num</i><br><ol><li>(Ripuarian, western Moselle Franconian) one</li></ol>
eich	<i>pron</i><br><ol><li>(Moselfränkisch/Hunsrückisch) I</li></ol>
ellef	<i>num</i><br><ol><li>eleven</li></ol>
em	<i>abbrev</i><br><ol><li>(most dialects) Contraction of en däm (“in the”).</li></ol><br><i>prep</i><br><ol><li>(Moselle Franconian) around</li></ol>
en	<i>prep</i><br><ol><li>(most dialects) in; into</li></ol><br><i>adv</i><br><ol><li>(most dialects) in</li></ol><br><i>conj</i><br><ol><li>(some western dialects) and</li></ol><br><i>article</i><br><ol><li>(most dialects) feminine nominative and accusative</li><li>(most dialects) neuter nominative and accusative, used before vowels and alternatively before h and dental consonants</li><li>(some dialects) masculine nominative, used before vowels and alternatively before h and dental consonants</li><li>(some dialects) masculine accusative, used before vowels and alternatively before h and dental consonants</li></ol><br><i>pron</i><br><ol><li>(most dialects) him; masculine accusative</li><li>(some dialects) he; masculine nominative</li><li>(most dialects) them; plural dative</li></ol>
en Ääz am Wandere hann|en Ääts am Wandere hann	<i>verb</i><br><ol><li>(Ripuarian, idiomatic) to be crazy, to have lost it</li></ol>
evvens	<i>adv</i><br><ol><li>(Ripuarian) just; simply; so</li><li>(Ripuarian) just; quickly; easily</li><li>(Ripuarian) just; a moment ago</li></ol>
eß	<i>verb</i><br><ol><li>(Kölsch) is</li></ol>
faale|gefaalt|jefaalt|gefaal|jefaale|gefaale|faalt	<i>verb</i><br><ol><li>(most dialects) to fold</li></ol>
fass|faste|faster|et miets fass	<i>adj</i><br><ol><li>(Ripuarian) firm</li></ol>
fenge|jefonge|fengk|fong	<i>verb</i><br><ol><li>(most of Ripuarian) to find</li></ol>
fleeje|jefloge|floch|flüch|fleecht|gefloge|flooch	<i>verb</i><br><ol><li>(Ripuarian, northern Moselle Franconian) to fly</li></ol>
flegg|flegge|et fleggste|flegger	<i>adj</i><br><ol><li>(Moselle Franconian) quick, fast</li></ol>
flögg|flögger|flögge|et flöggste	<i>adj</i><br><ol><li>(Ripuarian) quick, fast</li></ol>
freese|fror|frur|früüs|jefrore	<i>verb</i><br><ol><li>(Ripuarian, impersonal) to freeze (be below 0 degrees celsius)</li><li>(Ripuarian, of liquids) to freeze (become solid)</li><li>(Ripuarian, of living beings) to be/feel cold</li></ol>
freh	<i>adj</i><br><ol><li>(northern Moselle Franconian) early</li></ol>
fremb|fremde|fremder|et frembste	<i>adj</i><br><ol><li>(some dialects of Ripuarian, including Kölsch) strange; foreign</li></ol>
freue|jefreut|jefraut|fraut|freut	<i>verb</i><br><ol><li>(Ripuarian, reflexive) to be glad, happy</li></ol>
frieh	<i>adj</i><br><ol><li>(southern Moselle Franconian) early</li></ol>
froge|jefrooch|fruuch|frot|gefrot|frät|jefrot|fröt|frooch|frööch	<i>verb</i><br><ol><li>(most dialects) to ask; to pose a question</li></ol>
fröh|fröhtste|fröhe|fröher|fröhter|et fröhste	<i>adj</i><br><ol><li>(most dialects of Ripuarian) early</li></ol>
föhle|föhlt|fohlt|jefohlt	<i>verb</i><br><ol><li>(most of Ripuarian) to feel</li></ol>
fönnef|fönf	<i>num</i><br><ol><li>(Ripuarian) five</li></ol>
fööch|fööchte|fööchter|et fööchste	<i>adj</i><br><ol><li>(central and eastern Ripuarian) moist, humid</li></ol>
fünnef|fünf	<i>num</i><br><ol><li>(Kölsch) five</li></ol>
gehn	<i>verb</i><br><ol><li>(Moselle Franconian / Hunsrückisch) to go</li></ol>
gesond|gesenner|gesonne|gesonn|et gesendste	<i>adj</i><br><ol><li>(Moselle Franconian) healthy</li></ol>
giehn|gohn|gang|gäht|geng|gieng	<i>verb</i><br><ol><li>(Moselle Franconian) to go</li></ol>
gut|besser|gude|et beste	<i>adj</i><br><ol><li>(southern Moselle Franconian) good</li></ol>
haale|gehal|gehaal|gehale|heelt|jehaale|gehaale|hält|hale|jehale|hielt	<i>verb</i><br><ol><li>(most dialects) to hold</li></ol>
haat|hääder|haatste|et häätste|haader|haade	<i>adj</i><br><ol><li>(many dialects of Ripuarian) hard; not soft</li></ol>
hallev|halve	<i>adj</i><br><ol><li>(Ripuarian) half</li></ol>
han|weëd han|has|hait jehad|weëde jehad han|hai jehad|weëd jehad han|hauw|häut|hauw jehad|häue|jehad|jeuft han|häu|hat|weëds han|häuts|jeuf han|häuts jehad|has jehad|haits|häue jehad|hauwts jehad|häut jehad|hauwe jehad|hauwt jehad|hauwe|hauwts|haits jehad|häu jehad|hait|jeuve han|hauwt|hai|hant|haie|weëde han|han jehad|hant jehad|haie jehad|hat jehad|weëds jehad han|jeufs han	<i>verb</i><br><ol><li>(westernmost Ripuarian and Kölsch, auxiliary, with a past participle) to have (forms the perfect and past perfect tense)</li><li>(same dialects, transitive) to have; to own (to possess, have ownership of; to possess a certain characteristic)</li><li>(same dialects, transitive) to have; to hold (to contain within itself/oneself)</li><li>(same dialects, transitive) to have, get (to obtain, acquire)</li><li>(same dialects, transitive) to get (to receive)</li><li>(same dialects, transitive) to have (to be afflicted with, suffer from)</li><li>(same dialects, transitive, of units of measure) to contain, be composed of, equal</li><li>(same dialects, impersonal, with het or 't) there be, there is, there are</li><li>(same dialects, with 't and mit) to be occupied with, to like, to be into</li><li>(same dialects, with 't and uvver) to talk about</li></ol>
hann|hat|hatt|hät|jehatt|gehatt	<i>verb</i><br><ol><li>(most dialects) to have</li></ol>
haue|gehaue|jehaue|heel|heelt|häut|haut|hält|hait	<i>verb</i><br><ol><li>(Ripuarian, some dialects of Moselle Franconian) to hit, beat</li><li>(westernmost Ripuarian) to hold, keep</li></ol>
hee	<i>adv</i><br><ol><li>(Ripuarian, northern Moselle Franconian) here; in this place</li></ol>
heeß|heeßer|et heeßte|heeße	<i>adj</i><br><ol><li>(Ripuarian, Eifel) hot</li></ol>
heiße	<i>verb</i><br><ol><li>(Kölsch) to be called, hight</li></ol>
hellepe|hellep|hollep|jehollepe	<i>verb</i><br><ol><li>(Ripuarian, dated in some dialects) to help</li></ol>
henger	<i>prep</i><br><ol><li>(Ripuarian) behind</li></ol>
hierode|jehierot|hierot	<i>verb</i><br><ol><li>(Ripuarian, transitive or intransitive) to marry</li></ol>
hondert	<i>num</i><br><ol><li>(most dialects of Ripuarian) a hundred</li></ol>
huh|hieher|et hühste|hüchste|hiehtste|hühter|hüher|hühtste|huhe	<i>adj</i><br><ol><li>(Ripuarian, eastern Moselle Franconian) high; tall</li></ol>
hä	<i>pron</i><br><ol><li>(most dialects) he; nominative of the third-person singular masculine</li></ol>
höck	<i>adv</i><br><ol><li>(Ripuarian) today</li></ol>
höösch|höösche|hööscher|et hööschte	<i>adj</i><br><ol><li>(Ripuarian, chiefly predicative and adverbial) slow; careful; gentle; quiet</li></ol>
hüre|hürt|jehürt|hurt|jehoot|hoot|jehurt|jehööt|hööt	<i>verb</i><br><ol><li>(Ripuarian) to hear</li></ol>
ich|deer|vir [A]|inne|it|dat.|du|do|ühr|uns|mir|'t|mer (red.)|der (red.)|ver (red.)|ihr|[A] = acc.|se (red.)|os|hä|im|hönne [A] (or = nom.)|er|en (red.)|meer [C]|Dich|er (red.)|dir|höm [A]|ehr [C]|hön|sie|em (red.)|us|ehr|sei|het [A]|e (red.)|mich|Deer [C]|hör [A] (or = nom.)|höm [A] (or = nom.)|dich|[A] = dat.|üch|= nom.|Ehr [C]|in|Do [C]|[A] = nom.|ons [A]|de (red.)|= dat.|et|Üch	<i>pron</i><br><ol><li>(some dialects of Ripuarian, including Kölsch) I; nominative of the first-person singular personal pronoun</li></ol>
janz|janze	<i>adj</i><br><ol><li>(Ripuarian) all, whole</li></ol>
jedde Jeck es anders	<i>proverb</i><br><ol><li>All people are crazy, but in different ways. You may think someone crazy for one thing, but they might think you crazy for another.</li><li>to each his own</li></ol>
jeddem Dierche si Pläsierche	<i>proverb</i><br><ol><li>to each his own</li></ol>
jenooch	<i>det</i><br><ol><li>(most of Ripuarian) enough</li></ol><br><i>pron</i><br><ol><li>(most of Ripuarian) enough</li></ol><br><i>adv</i><br><ol><li>(most of Ripuarian) enough</li></ol>
jeschehn|jeschüch|jeschooch|jescheht	<i>verb</i><br><ol><li>(Ripuarian, dated in some dialects) to happen, occur</li></ol>
jesond|jesonn|jesonne|jesonde|jesönder|jesönner|et jesöndste	<i>adj</i><br><ol><li>(some dialects of Ripuarian) healthy</li></ol>
jesonk|jesönger|jesonge|jesong|et jesönkste	<i>adj</i><br><ol><li>(Ripuarian, now chiefly western dialects) healthy</li></ol>
jet	<i>pron</i><br><ol><li>(Ripuarian, northernmost Moselle Franconian) something; anything</li></ol>
jevve|jejevve|jejovve|jitt|jov	<i>verb</i><br><ol><li>(Ripuarian) to give</li></ol>
jlööve|jejloov|jlööv|jloov|jlöövte|jejlööv	<i>verb</i><br><ol><li>(most of Ripuarian) to believe</li></ol>
john|jeng|jeht|jejange	<i>verb</i><br><ol><li>(Ripuarian) to go</li></ol>
jonk|et jöngste|jengste|jönger|jong|jonge|jenger	<i>adj</i><br><ol><li>(many dialects) young</li></ol>
jonn|jing|jeiht|jejange	<i>verb</i><br><ol><li>(Kölsch) to go</li></ol>
jot|besser|et beste|jode	<i>adj</i><br><ol><li>(most of Ripuarian) good</li></ol>
jott|et beste|betzte|besser|jaue|jau|bester	<i>adj</i><br><ol><li>(westernmost Ripuarian) good</li></ol>
jries|jriese|et jrieste|jrieser	<i>adj</i><br><ol><li>(Ripuarian) grey; especially of hair, but also in a general sense</li></ol>
jruß|et jrüßte|jrüter|jrütste|jrüßer|jruße	<i>adj</i><br><ol><li>(Ripuarian) big; great; large</li></ol>
jrön|et jrönste|jröner|jröne	<i>adj</i><br><ol><li>(Ripuarian) green</li></ol>
jäl|jäle|et jälste|jäler	<i>adj</i><br><ol><li>(some dialects of Ripuarian) yellow</li></ol>
jään|et leevs|leever|et leevste	<i>adv</i><br><ol><li>(central and eastern Ripuarian) gladly, with pleasure (expresses English like to)</li></ol>
jäänhann|hät jään|jäänjehatt|hatt jään	<i>verb</i><br><ol><li>(central and eastern Ripuarian) to love</li></ol>
kalle|kallt|kallet|jekallt|kallend|jekald|kalt|kallens	<i>verb</i><br><ol><li>(chiefly Ripuarian, including Kirchröadsj) to speak; to talk; to chat</li><li>(Kirchröadsj, obsolete) to call</li><li>(Kirchröadsj, obsolete) to give a name to</li></ol>
kalt|kääler|kaal|kälder|et kaalste|kältste|kaaler|käälste|kaale	<i>adj</i><br><ol><li>(most dialects) cold</li></ol>
keen	<i>det</i><br><ol><li>(most of Ripuarian, western Moselle Franconian) no, not a, not any</li></ol>
kenne|gekannt|kennt|konnt|tense konnt|kann|gekonnt|jekannt|tense kannt	<i>verb</i><br><ol><li>(most dialects) to know; to be acquainted with</li><li>(Moselle Franconian) can; to be able to / of</li><li>(Moselle Franconian) to be possible</li></ol>
kicke|jekick|keck|kick|jekecke	<i>verb</i><br><ol><li>(Ripuarian) to look</li></ol>
klafe|jeklaf|klaf	<i>verb</i><br><ol><li>(Ripuarian) to chat, to talk among each other</li></ol>
kleen|kleener|et kleenste|kleene	<i>adj</i><br><ol><li>(Ripuarian, western Moselle Franconian) little; small</li></ol>
klevve|jekläv|kläv	<i>verb</i><br><ol><li>(Ripuarian, transitive or intransitive) to stick; to be sticky</li></ol>
kniepe|jekniep|kniep	<i>verb</i><br><ol><li>(Ripuarian) to blink, wink</li><li>(Ripuarian, rare) to squeeze, pinch</li></ol>
kodd|et koddste|kodde|kodder	<i>adj</i><br><ol><li>(Ripuarian, of living beings) mean, evil, wicked</li><li>(Ripuarian, of living beings) angry, furious</li><li>(Ripuarian, of limbs) sore, hurting</li><li>(Ripuarian, only of weather, times) bad, unfavourable</li><li>(Ripuarian, of money) false, counterfeit</li></ol>
komme|kennt|jekomme|kött|kom|gekomme	<i>verb</i><br><ol><li>to come</li></ol>
koofe|jekoof|kööf|koofte|kääft|gekooft|keeft|kooft	<i>verb</i><br><ol><li>(most dialects) to buy; to purchase</li></ol>
koot|kööter|koote|et köötste	<i>adj</i><br><ol><li>(Kölsch) short; not long</li></ol>
kriesche|jekresche|kresch|kriesch	<i>verb</i><br><ol><li>(Ripuarian) to cry, weep</li></ol>
krijje|jekrääch|jekrät|jekräje|krät|krääch|kritt|krich|kräje	<i>verb</i><br><ol><li>(Ripuarian) to get; to receive</li></ol>
kruffe|krüff|jekroffe|kroff	<i>verb</i><br><ol><li>(most dialects of Ripuarian) to creep, to crawl</li></ol>
kumme|kom|kütt|jekumme	<i>verb</i><br><ol><li>(some Ripuarian dialects, including Kölsch) to come</li></ol>
kunn|jekunn|kom|kütt	<i>verb</i><br><ol><li>(Ripuarian, archaic in most areas) to come</li></ol>
kurt|kürter|et kürzte|kürtste|kurte	<i>adj</i><br><ol><li>(Ripuarian, north-western Moselle Franconian) short; not long</li></ol>
kölsch|kölsche|kölscher|et kölschte	<i>adj</i><br><ol><li>(Ripuarian) of or pertaining to Cologne</li></ol>
könne|kann|jekonnt|konnt	<i>verb</i><br><ol><li>(Ripuarian) can; to be able to / of</li><li>(Ripuarian) to be possible</li></ol>
laache|laach|jelaach|laacht|gelaacht	<i>verb</i><br><ol><li>(most dialects) to laugh</li></ol>
laafe	<i>verb</i><br><ol><li>(southern Moselle Franconian) to run; to walk; to go (move on foot, either at a normal or at an increased speed)</li></ol>
lank|lang|et längste|länger|lange	<i>adj</i><br><ol><li>(most dialects) long</li></ol>
leck mich en der Täsch|leck mich en der Täsch!	<i>intj</i><br><ol><li>(Ripuarian, somewhat vulgar) damn!, wow!, fuck me! (expression of being surprised, impressed, dismayed)</li></ol>
leddig|et leddigste|leddijer|leddije	<i>adj</i><br><ol><li>empty; not full</li><li>vacant; empty; not occupied (e.g. a seat)</li><li>unmarried; single</li></ol>
leech|leechte|et leechste|leechter	<i>adj</i><br><ol><li>(central and eastern Ripuarian) light, not heavy</li><li>(same dialects) easy, not difficult</li></ol>
leev|leever|et leevste|leeve	<i>adj</i><br><ol><li>(Ripuarian) lovable; dear; darling; sweet; good-hearted</li></ol>
legge|jelegge|legg|jeledde|lett	<i>verb</i><br><ol><li>(most dialects of Ripuarian) to suffer</li></ol>
leie|leiet|leiend|jeloage|leit|jeleid|loog|leiens	<i>verb</i><br><ol><li>(Kirchröadsj, intransitive) to lie; to tell lies</li><li>(Kirchröadsj, transitive) to lead</li><li>(Kirchröadsj, transitive) to manage (an orginization)</li><li>(Kirchröadsj, transitive) to conduct (a liquid, electricity, etc.)</li><li>(Kirchröadsj, intransitive) to lead, to go, to follow a path to</li></ol>
leje|lüch|jeloge|looch|geloge|leeje|leecht	<i>verb</i><br><ol><li>(Ripuarian, northern Moselle Franconian) to lie; to tell lies</li></ol>
lesse|lisst|less|liss|gelesse|tense los|lesst|jelesse	<i>verb</i><br><ol><li>(Ripuarian, eastern Moselle Franconian) to read</li></ol>
levve|jeläv|läv	<i>verb</i><br><ol><li>(Ripuarian) to live</li></ol>
liehne|geliehnt|liehnt|jeliehnt	<i>verb</i><br><ol><li>(Ripuarian, northern Moselle Franconian) to lend; to loan</li><li>(same regions, usually with reflexive dative) to borrow</li></ol>
liehre|jeliehrt|leht|liehrt|jeleht	<i>verb</i><br><ol><li>(Ripuarian, northern Moselle Franconian) to learn</li><li>(same dialects) to teach</li></ol>
lijje|looch|jeläje|jelijje|jeledde|lett|lich|litt	<i>verb</i><br><ol><li>(Ripuarian) to lie (be in a horizontal position)</li><li>(westernmost Ripuarian) to suffer</li></ol>
loofe|jeloofe|lääft|lööf|geloof|leeft|leef|geloofe	<i>verb</i><br><ol><li>(Ripuarian, northern Moselle Franconian) to walk; to go; to run (move on foot, either at a normal or at an increased speed)</li></ol>
loope|leep|lööp|jeloope	<i>verb</i><br><ol><li>(northernmost Ripuarian) to walk; to go; to run (move on foot, either at a normal or an increased speed)</li></ol>
loße|leet|geloße|ließt|löt|leeß|geloß|jeloße|looß|lett	<i>verb</i><br><ol><li>(most dialects) to let</li><li>(most dialects) to make (someone do something)</li></ol>
luure|jeluurt|luurt|loot|jeloot	<i>verb</i><br><ol><li>(Ripuarian) to look (originally: look closely, but now also generally)</li></ol>
luustere|luustert|jeluustert	<i>verb</i><br><ol><li>(most dialects of Ripuarian) to listen (closely)</li></ol>
läje|geläächt|lääch|läächt|jelaach|lät|laach|lat|jelat	<i>verb</i><br><ol><li>(most dialects) to put; to lay; to make lie</li></ol>
maache|mooch|jemaht|gemaach|micht|gemaacht|maachens|jemaad|maach|maat|maachend|jemaach|mächt|muuch|maht|mäht|maachet	<i>verb</i><br><ol><li>(transitive) to make, form , produce, create (an object, arrangement, situation, etc.)</li><li>(transitive, of food, drinks, etc.) to make, prepare</li><li>(transitive, informal) to do</li><li>(transitive, with an adjective) to make (to cause to be)</li><li>(transitive, arithmetic) to make, be, equal (the result of a calculation)</li><li>(transitive, informal, colloquial) to make, earn (to earn, gain wages, profit, etc.)</li><li>(transitive, impersonal, colloquial) to matter (to be important)</li><li>(intransitive, informal, euphemistic) to do one's business, do number two or number one, go (to defecate or urinate)</li><li>(reflexive) to do (to fare or perform (well or poorly))</li><li>(with et, 't) to live</li></ol>
mahle|jemahle|mahlt|millt|gemahle|mohl|mählt	<i>verb</i><br><ol><li>(most dialects) to grind</li></ol>
mangzjere|mangzjeret|mangzjeert|mangzjerend|mangzjeerd|mangzjerens	<i>verb</i><br><ol><li>(Kirchröadsj Ripuarian, transitive) to eat</li><li>(Kirchröadsj Ripuarian, intransitive) to eat</li></ol>
mannich|manche|mannije	<i>det</i><br><ol><li>(many dialects, in the plural) some</li><li>(many dialects, in the singular) many a(n)</li></ol>
med|mede|et medste|meed|meder	<i>adj</i><br><ol><li>(northern Moselle Franconian) tired</li></ol>
met	<i>prep</i><br><ol><li>(most dialects) with</li></ol>
mi|minge|ming|meng|menge	<i>det</i><br><ol><li>(Ripuarian) my (first-person singular possessive)</li></ol>
mied	<i>adj</i><br><ol><li>(southern Moselle Franconian) tired</li></ol>
mole|jemolt|molt	<i>verb</i><br><ol><li>(most dialects) to paint, draw, depict</li></ol>
mugge|mooch|maach|jemooch|jemoht|moht	<i>verb</i><br><ol><li>(Ripuarian) to like</li><li>(Ripuarian) may; to be conceivable</li><li>(Ripuarian, obsolete in many dialects) may; to be allowed to</li></ol>
männich|männije	<i>det</i><br><ol><li>(Ripuarian, in the plural) some</li><li>(Ripuarian, in the singular) many a(n)</li></ol>
möd|möder|möde|et mödste	<i>adj</i><br><ol><li>(Ripuarian) tired</li></ol>
mösse|jemot|moss|mot|jemoss	<i>verb</i><br><ol><li>(Ripuarian, auxiliary) must; to have to; should</li></ol>
naachs	<i>adv</i><br><ol><li>(central and eastern Ripuarian) at night</li></ol>
naß|naße|naßer|et naßte	<i>adj</i><br><ol><li>(most dialects) wet</li></ol>
nei	<i>adj</i><br><ol><li>(Moselle Franconian) new</li></ol>
nemme|jenomme|nemmp|nohm	<i>verb</i><br><ol><li>(Ripuarian) to take</li></ol>
nemmieh	<i>adv</i><br><ol><li>(most dialects) no longer; not any more</li></ol>
net	<i>adv</i><br><ol><li>(most dialects) not</li></ol>
neu|neue|et neuste|neuer	<i>adj</i><br><ol><li>(Ripuarian) new</li></ol>
nevve	<i>prep</i><br><ol><li>(Ripuarian) next to</li></ol>
nix|nieks	<i>pron</i><br><ol><li>nothing</li></ol>
noh|nöhste|nöchste|nöhtste|noher|nohe|nächste|nöher|nöhter|et nohste	<i>adj</i><br><ol><li>near; close</li></ol>
nöng	<i>num</i><br><ol><li>(most dialects of Ripuarian) nine</li></ol>
nööme|nöömp|jenöömp|jenoomp|noomp	<i>verb</i><br><ol><li>(Ripuarian, chiefly western dialects) to call (someone something)</li></ol>
nühs|nüüs|nuus	<i>pron</i><br><ol><li>(Ripuarian, dated in some dialects) nothing</li></ol>
nüüx|nuuks	<i>pron</i><br><ol><li>(westernmost Ripuarian) nothing</li></ol>
off|et öffste|öfter	<i>adv</i><br><ol><li>(Ripuarian) often</li></ol>
ohne|case	<i>prep</i><br><ol><li>(most dialects) without</li></ol>
om	<i>abbrev</i><br><ol><li>(most dialects) Contraction of op/of däm (“on the”).</li><li>(parts of Eifel) Contraction of on däm (“in the”).</li></ol>
on	<i>conj</i><br><ol><li>and</li></ol>
onger	<i>prep</i><br><ol><li>(Ripuarian) under; beneath</li></ol>
oot|auer|au|äutste|älder|aue|et ootste|ältste|äuer	<i>adj</i><br><ol><li>(westernmost Ripuarian) old</li></ol>
op	<i>prep</i><br><ol><li>(Ripuarian, north-western Moselle Franconian) on; upon</li></ol>
ov|off	<i>conj</i><br><ol><li>(most dialects) if; whether</li><li>(Ripuarian) or</li></ol>
piefe|jepeffe|pief	<i>verb</i><br><ol><li>(Ripuarian) to smoke a pipe</li><li>(Ripuarian) to wheeze (breathe loudly and with trouble)</li><li>(Ripuarian) to sulk, be grumpy</li><li>(Ripuarian, only in expressions) to whistle or play a wind instrument (but this sense is usual in Moselle Franconian)</li></ol>
piel	<i>adv</i><br><ol><li>(Ripuarian) straight up; steeply</li></ol>
regge|jeregge|rett|reck|jeredde	<i>verb</i><br><ol><li>(most dialects of Ripuarian) to ride</li></ol>
riere|ree|gerere|ritt	<i>verb</i><br><ol><li>(Siegerland Moselle Franconian) to ride</li></ol>
rieve|revv|jerevve|riev	<i>verb</i><br><ol><li>(Ripuarian) to rub</li><li>(Ripuarian) to grate</li></ol>
rijje|rett|jerijje|ritt|jeredde	<i>verb</i><br><ol><li>(westernmost Ripuarian) to ride</li></ol>
roeëd|'t roeëdste|roeëder|Roeëdes	<i>adj</i><br><ol><li>(Kirchröadsj) red (colour)</li><li>(Kirchröadsj, politics) red; pertaining to Marxism in the widest sense; social democratic; socialist; communist</li><li>(Kirchröadsj, possibly mildly offensive) red-haired</li><li>(Kirchröadsj, historical, possibly offensive) redskin; Native American; Indian</li></ol>
rofe|röf|reef|gerofe|jerofe|reft	<i>verb</i><br><ol><li>(Ripuarian, northern Moselle Franconian) to call; to shout</li></ol>
rooche|roocht|rooch|geroocht|jerooch	<i>verb</i><br><ol><li>(most of Ripuarian, northern Moselle Franconian) to smoke</li></ol>
ruche|roch|rüch|jeroche	<i>verb</i><br><ol><li>(Ripuarian, transitive or intransitive) to smell</li></ol>
rut|ruder|ruh|et rutste|rude|ruher|ruhe	<i>adj</i><br><ol><li>(Ripuarian, northern Moselle Franconian) red</li></ol>
rähts	<i>adv</i><br><ol><li>(Ripuarian, parts of western Moselle Franconian) right (not left)</li></ol>
rähtseröm	<i>adv</i><br><ol><li>(Ripuarian) to the right, turning right</li></ol>
räne|ränt|rääne|jeränt|geränt|jeräänt|geräänt|räänt	<i>verb</i><br><ol><li>(most dialects) to rain</li></ol>
räuhig|räuhije|et räuhigste|räuhijer	<i>adj</i><br><ol><li>(Ripuarian) still, calm, easy, tranquil, silent (without stress, movement, and/or sound)</li></ol><br><i>adv</i><br><ol><li>(Ripuarian) just, freely, easily (without too much reluctance, caution, or fear); often expresses English may as well</li></ol>
rääch|räächter|räächte|et räächste	<i>adj</i><br><ol><li>(central and eastern Ripuarian) right (not left)</li><li>(central and western Ripuarian) right (as it should be)</li></ol>
rösig|rösijer|et rösigste|rösije	<i>adj</i><br><ol><li>(Ripuarian) angry, enraged</li><li>(Ripuarian) in heat, randy, horny</li></ol>
rüh|et rühste|rühe|rüher	<i>adj</i><br><ol><li>(Ripuarian) raw, uncooked</li></ol>
sage|jesat|jesät|sat|sät	<i>verb</i><br><ol><li>(Ripuarian) to say; to tell</li></ol>
scheeße|geschoss|geschosse|schüüß|schoss|jeschosse|scheeßt|schüss	<i>verb</i><br><ol><li>(Ripuarian, northern Moselle Franconian) to shoot</li></ol>
schenge|jeschengk|schengk|jeschonge|schong|jeschenge	<i>verb</i><br><ol><li>(most of Ripuarian) to shine</li><li>(same dialects) to seem, appear</li></ol>
schieße	<i>verb</i><br><ol><li>(southern Moselle Franconian) to shoot</li></ol>
schlage|schlooch|schlät|jeschlage	<i>verb</i><br><ol><li>(Ripuarian, as a variant) to hit; to beat; to defeat</li></ol>
schlofe|jeschlofe|schlief|schläft|schleef|schlöf|geschlof	<i>verb</i><br><ol><li>(most dialects) to sleep</li></ol>
schloon|jeschloon|geschloon|schlooch|schleet|schlon|geschlan|jeschlage|schleit|geschlaan|jeschlon|geschlon	<i>verb</i><br><ol><li>(most dialects) to hit; to beat; to defeat</li></ol>
schlääch|et schläächste|schläächte|schläächter	<i>adj</i><br><ol><li>(Ripuarian) bad; not good</li></ol>
schnegge|schnett|jeschnegge|schnegg|jeschnedde	<i>verb</i><br><ol><li>(most dialects of Ripuarian) to cut</li></ol>
schniere|schnitt|geschnere|schnee	<i>verb</i><br><ol><li>(Siegerland Moselle Franconian) to cut</li></ol>
schrieve|jeschrevve|schrevv|schriev	<i>verb</i><br><ol><li>(Ripuarian) to write</li></ol>
schun	<i>adv</i><br><ol><li>(most dialects) already</li></ol>
schunn	<i>adv</i><br><ol><li>(Moselle Franconian / Hunsrückisch) already</li></ol>
schwaade|schwade|schwaat|schwad|jeschwad|jeschwaat	<i>verb</i><br><ol><li>(chiefly Ripuarian) to speak, talk</li><li>(Ripuarian, now rare) to eat a lot</li><li>(Ripuarian, now rare) to slap</li></ol>
schwatz|schwatze|schwatzer|et schwatzte	<i>adj</i><br><ol><li>(most dialects) black</li></ol>
schwevve|schwäv|jeschwäv	<i>verb</i><br><ol><li>(most of Ripuarian) to hover, soar, float, drift</li></ol>
schwijje|schwech|jeschwijje|schwicht|schweech|jeschweeje|schwich	<i>verb</i><br><ol><li>(Ripuarian, Siegerland Moselle Franconian) to be silent, to say nothing</li></ol>
schwär	<i>adj</i><br><ol><li>heavy</li></ol>
schänge|schängk|jeschangk|jeschand	<i>verb</i><br><ol><li>(most dialects of Ripuarian) to scold; to rebuke; to rail; to complain</li></ol>
schärp|schärpe|et schärpste|schärper	<i>adj</i><br><ol><li>(central and western Ripuarian) sharp</li></ol>
schääl|schääle|schääler|et schäälste	<i>adj</i><br><ol><li>having a crooked or limited view: cross-eyed, one-eyed, or squinting</li><li>(figuratively) not right; false, crooked</li><li>(figuratively) referring to the other bank of the Rhine (now mostly the eastern one)</li></ol>
schödde|schott|schött|jeschott	<i>verb</i><br><ol><li>(Ripuarian) to pour</li><li>(Ripuarian) to shake</li></ol>
schön|et schönste|schöne|schöner	<i>adj</i><br><ol><li>(many dialects of Ripuarian) beautiful; pretty; nice</li></ol>
sechs	<i>num</i><br><ol><li>(most dialects) six</li></ol>
sehn|jesehn|seiht|süht|sooch|gesehn|sitt	<i>verb</i><br><ol><li>(Ripuarian, northern Moselle Franconian) to see</li></ol>
selde	<i>adv</i><br><ol><li>(Ripuarian) seldom; rarely</li></ol>
senn|jesenn|süht|es|sooch|jewäs|sitt|wor	<i>verb</i><br><ol><li>(Ripuarian) to be</li><li>(some dialects of Ripuarian) to see</li></ol>
setze|jesatz|setzt|jesäße|gesess|gesatz|satz|söß|gesat|soß|setz	<i>verb</i><br><ol><li>to sit</li><li>to set, to put</li></ol>
si|singe|sing|senge|seng	<i>det</i><br><ol><li>(Ripuarian) his, its (third-person masculine and neuter possessive)</li></ol>
sibbe	<i>num</i><br><ol><li>(most dialects of Ripuarian) seven</li></ol>
sjprèche|sjprèchens|sjprik|jesjpraoche|sjprooch|sjprèchend|sjprikt	<i>verb</i><br><ol><li>(Kirchröadsj, transitive) to speak (some language, the truth, etc.)</li><li>(Kirchröadsj, intransitive, [uvver (about) + accusative], [oes (from)]) to speak, to talk, to give a speech</li><li>(Kirchröadsj, transitive) to say, to speak (a word, phrase, sentence, prayer, etc.)</li><li>(Kirchröadsj, archaic, reflexive, of a word) to have a pronunciation; to be pronounced (some way)</li></ol>
solle|soll|gesollt|sall|jesollt|sollt	<i>verb</i><br><ol><li>(most dialects) shall; should; to be supposed to; expressing obligation or hearsay</li><li>(most dialects, dated) will; shall; used to form the future tense</li></ol>
spille|gespillt|jespillt|spillt	<i>verb</i><br><ol><li>(most dialects) to play</li></ol>
sprääche|sprooch|jesproche|sprech|sprecht|gesproche|sprich	<i>verb</i><br><ol><li>(chiefly Ripuarian) to speak</li></ol>
stelle|stallt|jestallt|gestallt|stellt	<i>verb</i><br><ol><li>(most dialects) to put; to place; to make stand</li></ol>
sterve|storv|sterv|stirv|jestorve	<i>verb</i><br><ol><li>(Ripuarian) to die</li></ol>
stiehn|gestanne|jestande|stäht|steiht|stuhn|stonn|stund	<i>verb</i><br><ol><li>(Moselle Franconian) to stand</li></ol>
stohn|jestande|jestange|steht|stond|stong	<i>verb</i><br><ol><li>(chiefly Ripuarian) to stand</li></ol>
stonn|steiht|stund|jestande	<i>verb</i><br><ol><li>(Kölsch) to stand</li></ol>
suffe|soff|jesoffe|süff	<i>verb</i><br><ol><li>(most dialects of Ripuarian, of animals) to drink</li><li>(the same dialects, of people) to drink excessively (usually alcohol)</li></ol>
suur|suure|suurer|et suurste	<i>adj</i><br><ol><li>(Ripuarian) sour</li></ol>
söke|jesok|sok|jesoht|soht|sök	<i>verb</i><br><ol><li>(Ripuarian) to search</li></ol>
söss	<i>adv</i><br><ol><li>(Ripuarian) otherwise; or else</li></ol>
söß|sößer|et sößte|söße	<i>adj</i><br><ol><li>(Ripuarian) sweet</li></ol>
trecke|jetrocke|trok|trick|treck	<i>verb</i><br><ol><li>(Ripuarian) to pull, draw</li><li>(Ripuarian) to go, march</li></ol>
tredde|jetrodde|trett|trot|tritt	<i>verb</i><br><ol><li>(Ripuarian) to kick</li></ol>
unn	<i>conj</i><br><ol><li>(Moselle Franconian / Hunsrückisch) and</li></ol>
verkamesöle|verkamesölt	<i>verb</i><br><ol><li>to beat up</li></ol>
verzälle|verzällt|verzallt	<i>verb</i><br><ol><li>(Ripuarian) to tell</li><li>(Ripuarian) to talk; to speak with each other</li></ol>
vier	<i>num</i><br><ol><li>(most dialects) four</li></ol>
vill|declension|mieste|mieschte|mieh|määste|et mietste|määschte	<i>adj</i><br><ol><li>much; many</li></ol>
vóchtsieg|vóchtsieje|vóchtsiegste	<i>adj</i><br><ol><li>(Kirchröadsj) humid</li><li>(Kirchröadsj) moist</li></ol>
vöhle|veule|vöhlt|veulens|jeveuld|vólt|vohlt|veult|veulend|veulet|jevohlt	<i>verb</i><br><ol><li>(westernmost Ripuarian) to feel</li></ol>
vür	<i>prep</i><br><ol><li>(Ripuarian) before; prior to</li><li>(Ripuarian) in front of</li></ol>
vürre|vür	<i>adv</i><br><ol><li>(Ripuarian) up front, at the front</li><li>(Ripuarian) over, ahead (at some place lying in front of one)</li></ol>
waade|waat|jewaat	<i>verb</i><br><ol><li>(Ripuarian) to wait</li></ol>
wade|jewaad|waad|wadens|wadet|wadend	<i>verb</i><br><ol><li>(Kirchröadsj, intransitive) to wait (for) [+ óp (accusative)]</li></ol>
wahr|wahre	<i>adj</i><br><ol><li>(most dialects) true, real, actual</li></ol>
wahße|jewase|wäßt|wohs|weëst|wießt|wiehst|wähst|woß|gewaß|woos|waast|waset|jewaße|gewahst|gewaßt|waße|wieß|wiehs|jewahße|wähs|wase|wasens|gewahs|wasend	<i>verb</i><br><ol><li>(most dialects) to grow; to become larger</li></ol>
weck|wegge|wegger|et weckste	<i>adj</i><br><ol><li>(some dialects of Ripuarian) far; wide; distant</li></ol>
weit|weide|et weitste|weider	<i>adj</i><br><ol><li>(Moselle Franconian) far; wide; distant</li></ol>
weld|welde|welle|et weldste|weller|well|welder	<i>adj</i><br><ol><li>(chiefly Ripuarian) wild</li></ol>
welle|wollt|wellt|well|gewollt|jewollt	<i>verb</i><br><ol><li>(most dialects) to want (to)</li></ol>
werm	<i>adv</i><br><ol><li>(western Ripuarian) again</li></ol>
werpe|werp|jeworpe|worp	<i>verb</i><br><ol><li>(Ripuarian, dated in some dialects) to throw; to cast</li></ol>
wesse|weiß|weeß|wääß|gewosst|wosst|tense woss|jewoss	<i>verb</i><br><ol><li>(most dialects) to know; to be aware (of a fact)</li></ol>
wick|et wickste|wigge|wigger	<i>adj</i><br><ol><li>(Kölsch) far; wide; distant</li></ol>
widder	<i>adv</i><br><ol><li>(eastern and central dialects) again; another time; once more</li></ol>
wies|zie zunt wieser|innes wiese|dès wiese|gès wiese|wieste|ing wieste|ing wiese|wieses|jet wieste|g'm wieste|eens wiesere|heë is 't wieste|inger wieser|zie zunt 't wieste|dèr wieser|dèr wieste|innen wiesere|'t is wies|gèr wiese|d'r wieste|dèr wiese|wieserer|wieser|d'r wieser|g'r wiesere|ing wieser|jetter wieste|wieseren|d'm wiese|ge wieste|gèr wieste|jet wieser|inne wiesere|heë is wieser|g'n wiesere|innem wiesere|de wiese|g'r wiese|g'm wiese|gèr wieser|wiesere|'t wiesere|ee wiesere|innem wiese|dès wiesere|g'n wiese|g'r wieste|d'n wiese|inger wieste|d'r wiesere|d'm wiesere|ge wieser|dès wieste|zie zunt wies|wiestem|d'm wieste|wiestes|g'r wieser|g'n wieste|wieseres|heë is wies|'t wiese|zie is wieser|'t is 't wieste|'t is wieser|jet wiese|wiesten|inger wiese|inne wieste|innes wieste|Wieses|de wieste|jetter wieser|d'n wiesere|innes wiesere|wiester|d'n wieser|g'n wieser|zie is 't wieste|ee wiese|d'n wieste|wiesen|g'm wiesere|ge wiesere|gès wieste|innem wieste|'t wieste|innen wieste|ee wieste|ge wiese|de wieser|innen wiese|wiese|zie is wies|eens wieste|wiesem|eens wiese|inne wiese|wieserem|d'r wiese|gès wiesere|jetter wiese	<i>adj</i><br><ol><li>(Kirchröadsj) white, reflecting most or all light</li><li>(Kirchröadsj) white, having a low amount of melanin in an organ, e.g. the skin</li><li>(Kirchröadsj, figuratively) legal</li></ol>
wiet|et wietste|wieder|wijjer|wiede|wie|wijje	<i>adj</i><br><ol><li>(westernmost and northernmost Ripuarian) far; wide; distant</li></ol>
wieß|et wießte|wießer|wieße	<i>adj</i><br><ol><li>(Ripuarian) white</li></ol>
winnieg|winniejer|'t winniegste	<i>det</i><br><ol><li>(Kirchröadsj) little, few, not much, not many</li></ol><br><i>pron</i><br><ol><li>(Kirchröadsj) little, not much, not a lot</li></ol><br><i>adj</i><br><ol><li>(Kirchröadsj) little, few (a small amount, a small number)</li></ol><br><i>adv</i><br><ol><li>(Kirchröadsj) little, not much</li><li>(Kirchröadsj) not often, rarely</li></ol>
winnig|et winnigste|winniger|declension|winnijer	<i>adj</i><br><ol><li>little; few</li></ol>
wohr|wohrer|wohre|et wohrste	<i>adj</i><br><ol><li>(most dialects) true, truthful</li></ol>
wä	<i>pron</i><br><ol><li>(Ripuarian) who, whom</li></ol>
wä de Musik bestellt, dä bestemmp, wat se spillt|wä de Musik bestellt|wat se spillt|dä bestemmp	<i>proverb</i><br><ol><li>(Ripuarian) who pays the piper calls the tune</li></ol>
wä de Musik bestellt, dä moss se och bezahle|wä de Musik bestellt|dä moss se och bezahle	<i>proverb</i><br><ol><li>(Ripuarian) in for a penny, in for a pound</li></ol>
wärm|wärmer|et wärmste|wärme	<i>adj</i><br><ol><li>(Ripuarian) warm; not cold</li></ol>
wääde|jewoode|wood|weed|wurde|jewurde|wird|wurd	<i>verb</i><br><ol><li>(Ripuarian) to become</li><li>(Ripuarian) to be; used with past participles to form the passive voice</li><li>(Ripuarian) will; shall; used with infinitives to form the future tense (which is rather rare, however)</li></ol>
zaubere|zaubert|gezaubert|jezaubert	<i>verb</i><br><ol><li>(intransitive) to perform magic</li></ol>
zehn	<i>num</i><br><ol><li>(Ripuarian, northern Moselle Franconian) ten</li></ol>
zieë|jeufs zieë|weëd jeweë zieë|bis jeweë|zalt jeweë zieë|weëd zieë|woar|jeuve zieë|wuurs jeweë|zint|weëds zieë|zieg|is|zal jeweë zieë|zint jeweë|woart|zalle jeweë zieë|wure|wure jeweë|wuur|zal zieë|zut|weëde zieë|zut jeweë|bin|woart jeweë|wuurs|is jeweë|zit jeweë|woar jeweë|jeweë|zals zieë|zalle zieë|bis|weëde jeweë zieë|zals jeweë zieë|woars jeweë|jeuft zieë|weëds jeweë zieë|wuurt jeweë|woare|zalt zieë|wuurt|woare jeweë|woars|jeuf zieë|bin jeweë|zunt|zit|zunt jeweë|wuur jeweë	<i>verb</i><br><ol><li>(Kirchröadsj, copulative, with a predicate adjective or predicate nominative) to be</li><li>(Kirchröadsj, with a dative object and certain adjectives) to feel, (to experience a condition)</li><li>(Kirchröadsj, auxiliary) forms the present perfect and past perfect tense of certain intransitive verbs</li><li>(Kirchröadsj, intransitive) to exist; there to be; to be alive</li><li>(Kirchröadsj, intransitive, colloquial) to have the next turn (in a game, in a queue, etc.)</li></ol>
zjwats|heë is zjwats|zjwatstes|de zjwatse|zie is zjwats|innen zjwatse|g'r zjwatste|d'n zjwatsere|ee zjwatse|inger zjwatse|gèr zjwatste|dès zjwatse|d'n zjwatste|de zjwatste|ee zjwatste|zjwatseres|zjwatsen|zjwatsem|zie zunt zjwats|zjwatses|Zjwatses|dès zjwatsere|dèr zjwatse|zie is 't zjwatste|g'n zjwatser|zjwatste|dèr zjwatser|ge zjwatste|innes zjwatste|ee zjwatsere|eens zjwatsere|zjwatstem|inne zjwatste|jetter zjwatser|ing zjwatser|'t zjwatsere|g'n zjwatste|zie is zjwatser|ge zjwatser|inne zjwatsere|innem zjwatsere|jetter zjwatste|inne zjwatse|ge zjwatse|jet zjwatse|d'm zjwatsere|zjwatseren|g'r zjwatsere|'t is zjwatser|d'r zjwatser|'t zjwatste|zjwatserem|ing zjwatste|dès zjwatste|g'm zjwatsere|d'n zjwatse|g'n zjwatsere|jet zjwatste|eens zjwatste|innen zjwatsere|ge zjwatsere|jetter zjwatse|g'm zjwatse|g'm zjwatste|'t is 't zjwatste|eens zjwatse|ing zjwatse|g'r zjwatse|'t is zjwats|d'r zjwatsere|zjwatsten|inger zjwatser|gès zjwatste|d'm zjwatse|zjwatsere|zie zunt 't zjwatste|innes zjwatsere|innem zjwatse|gès zjwatse|dèr zjwatste|g'r zjwatser|zie zunt zjwatser|innem zjwatste|heë is zjwatser|d'r zjwatse|de zjwatser|gès zjwatsere|innen zjwatste|zjwatserer|innes zjwatse|d'm zjwatste|zjwatster|d'r zjwatste|zjwatse|gèr zjwatse|heë is 't zjwatste|jet zjwatser|'t zjwatse|gèr zjwatser|d'n zjwatser|inger zjwatste|zjwatser|g'n zjwatse	<i>adj</i><br><ol><li>(Kirchröadsj) black, reflecting little or no light</li><li>(Kirchröadsj) black, having a high amount of melanin in an organ, e.g. the skin</li><li>(Kirchröadsj, figuratively) illegal</li><li>(Kirchröadsj, of coffee) without milk</li></ol>
zwei	<i>num</i><br><ol><li>(most dialects) two</li></ol>
zwällef|zwellef	<i>num</i><br><ol><li>twelve</li></ol>
zälle|zällt|zillt|jezallt|zallt	<i>verb</i><br><ol><li>(Ripuarian) to count</li></ol>
Ärm|Ärmche|Ärme	<i>noun</i><br><ol><li>(Ripuarian) arm</li><li>(Ripuarian) sleeve</li></ol>
Ääd	<i>noun</i><br><ol><li>(Ripuarian) earth</li></ol>
Ääpel|Ääpele	<i>noun</i><br><ol><li>(Ripuarian) potato</li></ol>
Ääpelschlot|Ääpelschlote	<i>noun</i><br><ol><li>(Ripuarian) potato salad</li></ol>
Ääz|Ääze|Ääts|Äätse|Ääzje|Äätsje	<i>noun</i><br><ol><li>(most dialects of Ripuarian) pea (kind of pulse)</li></ol>
Öllich|Öllisch	<i>noun</i><br><ol><li>(most of Ripuarian) onion (Allium cepa)</li></ol>
ärch|ärje|et mieste|et ärchste|mietste|mieschte|mieh|ärjer	<i>adj</i><br><ol><li>(Ripuarian, chiefly of things, events) bad; tremendous</li></ol><br><i>adv</i><br><ol><li>(Ripuarian) badly; terribly</li><li>(Ripuarian) very; much; a lot</li></ol>
äße|iss|oß|gäß|esst|jäße|jejäße	<i>verb</i><br><ol><li>(Ripuarian, northern Moselle Franconian) to eat</li></ol>
ääch|äächter|et äächste|äächte	<i>adj</i><br><ol><li>(some dialects of Ripuarian) genuine, real, true</li></ol>
ödeme|jeödemp|ödemp	<i>verb</i><br><ol><li>(Ripuarian) to breathe</li></ol>
öm	<i>prep</i><br><ol><li>(Ripuarian) around</li></ol><br><i>abbrev</i><br><ol><li>(parts of Eifel) Contraction of ön däm (“in the”).</li></ol>
ühr|ühre|er|üch	<i>det</i><br><ol><li>(Ripuarian) your (second-person plural possessive)</li></ol><br><i>pron</i><br><ol><li>(much of Ripuarian) you, y'all (second-person plural pronoun)</li></ol>
üvver	<i>prep</i><br><ol><li>(Ripuarian) over; above</li></ol>
üvverläje|üvverlat|üvverlääch|üvverlät|üvverlaach	<i>verb</i><br><ol><li>(Ripuarian) to think, ponder, consider</li></ol>
