A|А|a|а	<i>character</i><br><ol><li>The first letter of the Chechen alphabet, written in the Latin script.</li></ol>
Q̇|къ|q̇|Къ	<i>character</i><br><ol><li>The twenty-ninth letter of the Chechen alphabet, written in the Latin script.</li></ol>
massanẋara-a proletaraš cẋa bart bejlaš	<i>phrase</i><br><ol><li>workers of the world, unite! (pre-1938 Latin spelling)</li></ol>
q̇|къ|Q̇|Къ	<i>character</i><br><ol><li>The twenty-ninth letter of the Chechen alphabet, written in the Latin script.</li></ol>
Ç̇|ç̇	<i>character</i><br><ol><li>The seventh letter of the Chechen alphabet, written in the Latin script.</li></ol>
ç̇	<i>character</i><br><ol><li>The seventh letter of the Chechen alphabet, written in the Latin script.</li></ol>
Ƶ|ž|ج|ж|Ж|ƶ	<i>character</i><br><ol><li>The fortieth letter of the Chechen alphabet, called ƶe and written in the Latin script.</li></ol>
ƶ|ž|ج|ж|Ж|Ƶ	<i>character</i><br><ol><li>The fortieth letter of the Chechen alphabet, called ƶe and written in the Latin script.</li></ol>
А|а|a	<i>character</i><br><ol><li>The first letter of the Chechen alphabet, written in the Cyrillic script.</li></ol>
Аллахӏ|Allah	<i>name</i><br><ol><li>(Islam) Allah</li></ol>
Б|б|b|B	<i>character</i><br><ol><li>The third letter of the Chechen alphabet, written in the Cyrillic script.</li></ol>
Братислава|Братисла́ва|Bratisláwa	<i>name</i><br><ol><li>Bratislava (the capital and largest city of Slovakia)</li></ol>
В|в|w|W	<i>character</i><br><ol><li>The fourth letter of the Chechen alphabet, written in the Cyrillic script.</li></ol>
Г|g|г	<i>character</i><br><ol><li>The fifth letter of the Chechen alphabet, written in the Cyrillic script.</li></ol>
Гезгмашан-бутт|Gezgmašan-butt	<i>noun</i><br><ol><li>September</li></ol>
Гӏадужу-бутт|Ġadužu-butt	<i>noun</i><br><ol><li>October</li></ol>
Гӏалгӏай|Ġalġaj	<i>name</i><br><ol><li>Ingush people</li></ol>
Гӏалгӏайчоь|Ġalġajčö	<i>name</i><br><ol><li>Ingushetia</li></ol>
Гӏуран-бутт|Ġuran-butt	<i>noun</i><br><ol><li>December</li></ol>
Дечкен-бутт|Dečken-butt	<i>noun</i><br><ol><li>January</li></ol>
Зазадоккху-бутт|Zazadoqːu-butt	<i>noun</i><br><ol><li>March</li></ol>
Ибраьхӏим|Ibrähim	<i>name</i><br><ol><li>(Islam) Abraham</li></ol>
Керста|Kersta	<i>noun</i><br><ol><li>Christian</li></ol>
Керста дин|Kersta din	<i>noun</i><br><ol><li>Christianity</li></ol>
Куба|Kuba	<i>name</i><br><ol><li>Cuba (an island and country in the Caribbean)</li></ol>
Лахьанан-бутт|Laḥanan-butt	<i>noun</i><br><ol><li>November</li></ol>
Мажарчоь|Mažarčö	<i>name</i><br><ol><li>Hungary</li></ol>
Мангалан-бутт|Mangalan-butt	<i>noun</i><br><ol><li>June</li></ol>
Марсхьокху-бутт|Marsḥoqu-butt	<i>noun</i><br><ol><li>August</li></ol>
Москох|Moskox	<i>name</i><br><ol><li>Moscow (a federal city, the capital of Russia)</li><li>Moscow (an oblast of Russia, surrounding the city of Moscow)</li></ol>
Нидерландаш|Niderlandaš	<i>name</i><br><ol><li>Netherlands</li></ol>
Нохчийчоь|Noχčīčö	<i>name</i><br><ol><li>Chechnya (a republic of the northern Caucasus of Russia; capital: Grozny)</li></ol>
Овгӏан|Owġan	<i>name</i><br><ol><li>Afghanistan (a country in Asia)</li></ol>
Огайо|Ogajo	<i>name</i><br><ol><li>Ohio (a state of the United States)</li><li>Ohio (a river in the central United States)</li></ol>
Оханан-бутт|Oχanan-butt	<i>noun</i><br><ol><li>April</li></ol>
Оьрсий|Örsī	<i>name</i><br><ol><li>Russia</li></ol>
Португали|Portugali	<i>name</i><br><ol><li>Portugal (a country in Europe)</li></ol>
Пхьармат|Pḥarmat	<i>noun</i><br><ol><li>(Vainakh mythology) Pkharmat</li></ol>
Росси|Rossi	<i>noun</i><br><ol><li>Russia</li></ol>
Руанда|Ruanda	<i>name</i><br><ol><li>Rwanda (a country in East Africa)</li></ol>
Соьлжа-Гӏала|Sölža-Ġala	<i>name</i><br><ol><li>Grozny (a city, the regional capital of Chechnya, Russia)</li></ol>
Стигалкъекъа-бутт|Stigalq̇eq̇a-butt	<i>noun</i><br><ol><li>May</li></ol>
Товбецан-бутт|Towbecan-butt	<i>noun</i><br><ol><li>July</li></ol>
Уганда	<i>name</i><br><ol><li>Uganda (a country in East Africa)</li></ol>
Хорвати|Χorwati	<i>name</i><br><ol><li>Croatia</li></ol>
Чиллан-бутт|Čillan-butt	<i>noun</i><br><ol><li>February</li></ol>
Эрмалойчоь|Ermalojčö	<i>noun</i><br><ol><li>Armenia (a country in Europe and Asia)</li></ol>
а|А|a	<i>character</i><br><ol><li>The first letter of the Chechen alphabet, written in the Cyrillic script.</li></ol><br><i>conj</i><br><ol><li>and</li></ol>
абаде|abade	<i>noun</i><br><ol><li>eternity without an end (as opposed to: eternity without a beginning)</li></ol>
абазо|abazo	<i>noun</i><br><ol><li>Person from Abaza, Abazian.</li></ol>
абазойн|abazojn	<i>adj</i><br><ol><li>Abazian (from Abaza).</li></ol>
абат|abat	<i>noun</i><br><ol><li>alphabet</li><li>abc-book</li><li>primer, book to learn a language</li></ol>
абатан|abatan	<i>adj</i><br><ol><li>pertaining to the alphabet</li><li>pertaining to a primer</li></ol>
авгол|awgol	<i>noun</i><br><ol><li>clay ball (used in child games)</li></ol>
авсал|awsal	<i>noun</i><br><ol><li>foot-and-mouth disease</li></ol>
авсалан|awsalan	<i>adj</i><br><ol><li>aphthous</li></ol>
авст|awst	<i>noun</i><br><ol><li>goat (one year old)</li></ol>
ага|aga	<i>noun</i><br><ol><li>crib</li></ol><br><i>verb</i><br><ol><li>to chisel</li></ol>
аганан|aganan	<i>adj</i><br><ol><li>pertaining to a crib</li></ol>
аганчӏу|aganč̣u	<i>noun</i><br><ol><li>rod (part of the cradle)</li></ol>
агар|agar	<i>noun</i><br><ol><li>chiseling</li></ol>
агӏаз|aġaz	<i>noun</i><br><ol><li>kind of small spider</li></ol>
агӏо|aġo	<i>noun</i><br><ol><li>side</li><li>page</li></ol>
агӏордаккха|aġordaqːa	<i>verb</i><br><ol><li>to turn over</li></ol>
адам|адамца|адаме|адамо|адамах|адамийн|адамал|adam|адамел|адаман|адамна|адамех|адамашка|адамаш|адамашна|адамаша|адамашца	<i>noun</i><br><ol><li>man</li><li>person</li></ol>
адамат|adamat|адаматаш	<i>noun</i><br><ol><li>tomato</li></ol>
аз|az	<i>noun</i><br><ol><li>voice</li></ol>
азан|azan	<i>noun</i><br><ol><li>(Islam) adhan (call to prayer)</li></ol>
айгӏар|ajġar	<i>noun</i><br><ol><li>stallion</li></ol>
ала|ala	<i>verb</i><br><ol><li>to say</li></ol>
алу|ālu	<i>noun</i><br><ol><li>flame</li></ol>
ананас|ананасаш|ананасах|ананасашца|ананасашна|ананасе|ананасца|ананасаша|ананасо|ананасийн|ананасна|ананасел|ананасашка|ананасал|ананасех|ananas|ананасан|ананасо̄	<i>noun</i><br><ol><li>pineapple</li></ol>
апельсин|апельсинашна|апельсинан|апельсинашца|апельсинех|апельсино̄|apel’sino|апельсинца|апельсинашка|апельсинна|апельсинал|апельсинаша|апельсинел|апельсино|apel’sin|апельсинаш|апельсине|апельсинийн|апельсинах	<i>noun</i><br><ol><li>orange (fruit)</li><li>orange tree</li></ol>
ара|ara	<i>adv</i><br><ol><li>out</li></ol>
аре|ārē	<i>noun</i><br><ol><li>field</li><li>plain</li></ol>
артист|артисташ|артистна|артистел|артистал|артистийн|артисто|артисташа|артисто̄|artist|артисташна|артисташца|артистца|артистах|артистех|артисташка|артистан|артисте	<i>noun</i><br><ol><li>actor, actress</li></ol>
астагӏа|astaġa	<i>adj</i><br><ol><li>lame</li></ol>
ах|ākh	<i>noun</i><br><ol><li>half</li></ol>
ахча	<i>noun</i><br><ol><li>money</li><li>coin</li></ol>
ахча дала|aχča dala	<i>verb</i><br><ol><li>to pay</li></ol>
ахьке|aḥke	<i>noun</i><br><ol><li>summer</li></ol>
аь|Аь|ä	<i>character</i><br><ol><li>The second letter of the Chechen alphabet, written in the Cyrillic script.</li></ol>
аьрзу|ärzu|аьрзунаш	<i>noun</i><br><ol><li>eagle</li><li>vulture</li></ol>
аьрру|ärru	<i>adj</i><br><ol><li>left</li></ol>
аьтта|ätta	<i>adj</i><br><ol><li>easy</li></ol>
аьтту|ättu	<i>adj</i><br><ol><li>right</li></ol>
б|B|Б|b	<i>character</i><br><ol><li>The third letter of the Chechen alphabet, written in the Cyrillic script.</li></ol>
бага|baga	<i>noun</i><br><ol><li>larch (Larix, tree)</li></ol>
бад|bad	<i>noun</i><br><ol><li>duck</li></ol>
бадарж|badarž|бадаржаш	<i>noun</i><br><ol><li>tomato</li></ol>
база|baza	<i>noun</i><br><ol><li>spruce (tree)</li></ol>
базар|bazar	<i>noun</i><br><ol><li>market</li></ol>
байракх|bajraq	<i>noun</i><br><ol><li>flag</li><li>banner</li></ol>
бамба|bamba	<i>noun</i><br><ol><li>cotton</li></ol>
банан|бананах|бана̄но̄|бананаша|бананех|банане|бананаш|бананца|бананашна|бананийн|бананан|бананашца|бананал|бананашка|бананел|бананна|банано|banan	<i>noun</i><br><ol><li>banana</li></ol>
баркал|barkal	<i>intj</i><br><ol><li>thank you</li></ol>
бархӏ|barh	<i>num</i><br><ol><li>eight</li></ol>
барч|barč	<i>noun</i><br><ol><li>seat of honor, place of honor for guests or elders (in a room, around the table, etc.)</li></ol>
баса|basa	<i>verb</i><br><ol><li>to paint</li></ol>
басар|basar	<i>noun</i><br><ol><li>painting (the action of applying paint)</li><li>dye, paint</li></ol>
баьхьа|bäḥa	<i>noun</i><br><ol><li>wooden spade</li></ol>
баьццара|bäccara	<i>adj</i><br><ol><li>green</li></ol>
баӏ|baʿ	<i>noun</i><br><ol><li>burdock</li><li>lamp burner</li></ol>
бежаӏу|bežaʿu	<i>noun</i><br><ol><li>herdsman</li></ol>
безам|бе̄замал|бе̄замаш|бе̄замо|бе̄замашна|бе̄заме|бе̄зам|biezam|бе̄замна|бе̄замах|бе̄замех|бе̄замел|бе̄замашца|бе̄замашка|бе̄замийн|бе̄замаша|бе̄замца|бе̄заман	<i>noun</i><br><ol><li>love</li></ol>
бекъа|beq̇a	<i>noun</i><br><ol><li>foal</li></ol>
бел|bel	<i>noun</i><br><ol><li>shovel, spade</li></ol>
белхало|белхало̄|belχalō|белхалой|белхало̄чо̄	<i>noun</i><br><ol><li>employee</li><li>worker</li></ol>
белш|belš	<i>noun</i><br><ol><li>shoulder</li></ol>
бен|ben	<i>noun</i><br><ol><li>nest</li></ol>
бепиг|баьпко|bepig|баьпкаш	<i>noun</i><br><ol><li>bread</li></ol>
бер|бе̄раш|ber|бе̄ро̄	<i>noun</i><br><ol><li>child</li></ol>
берхӏитта|berhitta	<i>num</i><br><ol><li>eighteen</li></ol>
бирдолаг|birdolag	<i>noun</i><br><ol><li>bat (animal)</li></ol>
бо|bō	<i>noun</i><br><ol><li>orphan</li></ol>
болат|bōlat	<i>noun</i><br><ol><li>steel</li></ol>
болх|белхаш|балхо̄|bolχ	<i>noun</i><br><ol><li>work</li></ol>
болхлург|болхлурш|болхлучо̄|bolχlurg	<i>noun</i><br><ol><li>employer</li></ol>
боргӏал|borġal	<i>noun</i><br><ol><li>cock</li></ol>
борз|берзлой|berzloj|барзо|borz	<i>noun</i><br><ol><li>wolf</li></ol>
борш|borš	<i>noun</i><br><ol><li>bull-calf</li></ol>
бос|bos	<i>noun</i><br><ol><li>color</li></ol>
бохь|boḥ	<i>noun</i><br><ol><li>top, peak, summit</li></ol>
боьха|böχa	<i>adj</i><br><ol><li>dirty</li></ol>
буд|bud	<i>noun</i><br><ol><li>vulva</li></ol>
букъ|buq̇	<i>noun</i><br><ol><li>back</li></ol>
бурам|buram	<i>noun</i><br><ol><li>ferry</li></ol>
бурч|burč	<i>noun</i><br><ol><li>pepper</li></ol>
бутт|butt	<i>noun</i><br><ol><li>moon</li><li>month</li></ol>
бух	<i>noun</i><br><ol><li>bottom</li></ol>
бухгалтер|buχgalter	<i>noun</i><br><ol><li>accountant</li></ol>
бухӏа|buha	<i>noun</i><br><ol><li>owl</li></ol>
буц|buc	<i>noun</i><br><ol><li>grass</li></ol>
буьйса|büjsa	<i>noun</i><br><ol><li>night</li></ol>
бӏар|bʿar	<i>noun</i><br><ol><li>nut</li></ol>
бӏаьрг|bʿärg|бӏаьргаш	<i>noun</i><br><ol><li>eye (organ of sight)</li></ol>
бӏаьрхи|bʿärχi	<i>noun</i><br><ol><li>tear</li></ol>
бӏаьсте|bʿäste	<i>noun</i><br><ol><li>spring</li></ol>
бӏе|bʿe	<i>num</i><br><ol><li>hundred</li></ol>
бӏогӏам|bʿoġam	<i>noun</i><br><ol><li>pole, post</li></ol>
в|w|В|W	<i>character</i><br><ol><li>The fourth letter of the Chechen alphabet, written in the Cyrillic script.</li></ol>
вай|waj	<i>pron</i><br><ol><li>first-person inclusive plural pronoun: we</li></ol>
валар|walar	<i>noun</i><br><ol><li>death</li></ol>
ваша|waša	<i>noun</i><br><ol><li>brother</li></ol>
веда|weda	<i>adj</i><br><ol><li>flat</li></ol>
верза|werza	<i>verb</i><br><ol><li>to turn</li></ol>
вижа|wiža	<i>verb</i><br><ol><li>to lie down</li></ol>
вир|wir	<i>noun</i><br><ol><li>donkey</li></ol>
во|wo	<i>adj</i><br><ol><li>bad</li></ol>
ворда|worda	<i>noun</i><br><ol><li>cart</li><li>carriage</li><li>wagon</li></ol>
ворхӏ|worh	<i>num</i><br><ol><li>seven</li></ol>
вота|wota	<i>noun</i><br><ol><li>drum</li></ol>
вуьрхӏитта|würhitta	<i>num</i><br><ol><li>seventeen</li></ol>
г|g|Г	<i>character</i><br><ol><li>The fifth letter of the Chechen alphabet, written in the Cyrillic script.</li></ol>
га|ga	<i>verb</i><br><ol><li>to see</li></ol>
газа|гāза|gāza	<i>noun</i><br><ol><li>goat</li></ol>
гата|gata	<i>noun</i><br><ol><li>towel</li></ol>
гезг|гезго|gezg|гезгаш	<i>noun</i><br><ol><li>spider</li></ol>
гезга|gezga	<i>noun</i><br><ol><li>spider</li></ol>
гена|gēna	<i>adv</i><br><ol><li>far</li></ol>
герз|gerz	<i>noun</i><br><ol><li>weapon</li></ol>
герзахо|gerzaχo	<i>noun</i><br><ol><li>A person skilled in the manufacturing of weaponry, typically firearms.</li><li>An armourer.</li></ol>
герма|germa	<i>noun</i><br><ol><li>wad (sealing material used in guns)</li></ol>
герми|germi	<i>noun</i><br><ol><li>(dialectal) floorcloth</li></ol>
гитара|гитаро|gitara|гитараш	<i>noun</i><br><ol><li>guitar</li></ol>
го|gō	<i>noun</i><br><ol><li>circle</li></ol>
говр|говрал|говрашка|говраш|говрийн|говраша|говрашца|говре|говрел|говрах|говран|говрана|говро|говраца|говрех|говрашна|gowr	<i>noun</i><br><ol><li>horse</li></ol>
гола|gōla	<i>noun</i><br><ol><li>knee</li><li>elbow</li></ol>
гома|gōma	<i>adj</i><br><ol><li>crooked</li></ol>
горга|gorga	<i>adj</i><br><ol><li>round</li></ol>
горгам|gorgam	<i>noun</i><br><ol><li>floorcloth</li><li>(dialectal) rag for cleaning the gun after lubrication</li></ol>
горгум|gorgum	<i>noun</i><br><ol><li>(dialectal) Alternative form of горгам (gorgam)</li></ol>
гота|gota	<i>noun</i><br><ol><li>plough</li></ol>
готта|gotta	<i>adj</i><br><ol><li>narrow</li></ol>
гражданийн тӏом|graždanīn ṭom	<i>noun</i><br><ol><li>civil war</li></ol>
грейпфрукт|grejpfrukt	<i>noun</i><br><ol><li>grapefruit</li></ol>
гу|gu	<i>noun</i><br><ol><li>hill</li></ol>
гуьйре|güjrē|гуьйре̄	<i>noun</i><br><ol><li>autumn</li></ol>
гӏ|ġ|Гӏ	<i>character</i><br><ol><li>The sixth letter of the Chechen alphabet, written in the Cyrillic script.</li></ol>
гӏа|ġa	<i>noun</i><br><ol><li>leaf</li></ol>
гӏаз|ġaz	<i>noun</i><br><ol><li>goose</li></ol>
гӏазот|ġazot	<i>noun</i><br><ol><li>holy war</li><li>jihad</li><li>crusade</li></ol>
гӏайба|ġajba	<i>noun</i><br><ol><li>pillow</li></ol>
гӏайре|ġajre	<i>noun</i><br><ol><li>island</li></ol>
гӏала|ġala	<i>noun</i><br><ol><li>castle</li><li>fort</li><li>town</li></ol>
гӏалакх|ġalaq	<i>noun</i><br><ol><li>sword</li></ol>
гӏалат|ġalat	<i>noun</i><br><ol><li>mistake</li><li>error</li></ol>
гӏама|ghāma	<i>noun</i><br><ol><li>heap</li></ol>
гӏант|ġant	<i>noun</i><br><ol><li>chair</li></ol>
гӏела|ġela	<i>noun</i><br><ol><li>red deer</li></ol>
гӏо|ġo	<i>noun</i><br><ol><li>help</li></ol>
гӏу|ghū	<i>noun</i><br><ol><li>a well</li></ol>
гӏум|ġum	<i>noun</i><br><ol><li>sand</li></ol>
д|Д|d	<i>character</i><br><ol><li>The seventh letter of the Chechen alphabet, written in the Cyrillic script.</li></ol>
да|дас|da|да̄|dā|дай	<i>noun</i><br><ol><li>father</li></ol><br><i>verb</i><br><ol><li>to do</li></ol>
даа|daa	<i>verb</i><br><ol><li>to eat</li></ol>
дага|dāga	<i>verb</i><br><ol><li>to burn (be burnt)</li></ol>
дада|dada	<i>verb</i><br><ol><li>to run</li><li>to flee</li></ol>
дай|daj	<i>adj</i><br><ol><li>light (of weight)</li><li>cheap</li></ol>
дала|dala	<i>verb</i><br><ol><li>to give</li><li>to die</li></ol>
далар|dalar	<i>noun</i><br><ol><li>death</li></ol>
дан|də	<i>verb</i><br><ol><li>to do</li><li>to make</li></ol>
даржа|darža	<i>verb</i><br><ol><li>to spread out, to extend</li></ol>
дарс|dars	<i>noun</i><br><ol><li>lesson</li></ol>
даха|daχa	<i>verb</i><br><ol><li>to live</li><li>to dwell</li></ol>
дахар|daχar	<i>noun</i><br><ol><li>life</li></ol>
дахка|daχka	<i>noun</i><br><ol><li>mouse</li></ol>
даш|daš	<i>noun</i><br><ol><li>copper</li></ol>
даша|dāša	<i>verb</i><br><ol><li>to shave</li></ol>
даьхний|däχnī	<i>noun</i><br><ol><li>cattle</li></ol>
даьӏахк|däʿaχk	<i>noun</i><br><ol><li>bone</li></ol>
де|de	<i>noun</i><br><ol><li>day</li></ol><br><i>verb</i><br><ol><li>to kill</li></ol>
дегӏ|deġ	<i>noun</i><br><ol><li>body</li></ol>
деза|deza	<i>adj</i><br><ol><li>heavy</li><li>expensive</li></ol><br><i>verb</i><br><ol><li>to like</li><li>to love</li></ol>
дезткъе итт|dezṭq̇e itt	<i>num</i><br><ol><li>ninety</li></ol>
дейтта|dejtta	<i>num</i><br><ol><li>fourteen</li></ol>
декхар|deqar	<i>noun</i><br><ol><li>debt</li></ol>
декъа|deq̇a	<i>adj</i><br><ol><li>dry</li></ol><br><i>verb</i><br><ol><li>to divide</li></ol>
декъаза|deq̇aza	<i>adj</i><br><ol><li>insignificant</li><li>unhappy, miserable</li></ol>
дела|dēla|dela	<i>noun</i><br><ol><li>god</li><li>a deity</li></ol><br><i>verb</i><br><ol><li>to laugh</li></ol>
делкъе|delq̇e	<i>noun</i><br><ol><li>noon</li></ol>
делла|della	<i>verb</i><br><ol><li>to die</li></ol>
делха|delχa	<i>verb</i><br><ol><li>to weep, to cry</li></ol>
дерзина|derzina	<i>adj</i><br><ol><li>naked</li></ol>
дерриг|derrig	<i>adj</i><br><ol><li>all, every</li><li>whole</li></ol>
деса|dēsa	<i>adj</i><br><ol><li>empty</li></ol>
деста|desta	<i>verb</i><br><ol><li>to swell</li></ol>
дети|deti	<i>noun</i><br><ol><li>silver</li></ol>
детта|dētta	<i>verb</i><br><ol><li>to milk</li></ol>
деха|dēχa|deχa	<i>adj</i><br><ol><li>long</li></ol><br><i>verb</i><br><ol><li>to ask</li></ol>
дечиг|dečig	<i>noun</i><br><ol><li>wood</li></ol>
деша|deša	<i>verb</i><br><ol><li>to read</li></ol>
деши|deši	<i>noun</i><br><ol><li>gold</li></ol>
диг|дагаро̄|dig|дагарш	<i>noun</i><br><ol><li>axe</li></ol>
дийнат|dīnat	<i>noun</i><br><ol><li>animal</li></ol>
дика|dika	<i>adj</i><br><ol><li>good</li></ol>
дила|dila	<i>verb</i><br><ol><li>to put</li></ol>
дин|din	<i>noun</i><br><ol><li>religion</li></ol>
дитт|ditt	<i>noun</i><br><ol><li>tree</li></ol>
диц да|dic da	<i>verb</i><br><ol><li>to forget</li></ol>
диъ|diʾ	<i>num</i><br><ol><li>four</li></ol>
дов|dow	<i>noun</i><br><ol><li>quarrel</li><li>dispute</li><li>strife</li><li>feud</li></ol>
довха|dowχa	<i>adj</i><br><ol><li>hot</li></ol>
дог|dog	<i>noun</i><br><ol><li>(anatomy) heart</li></ol>
догӏа|dōġa	<i>noun</i><br><ol><li>raining</li><li>key</li><li>lock, padlock</li></ol>
доза|dōza	<i>noun</i><br><ol><li>border</li></ol>
дозушцахилар|dozušcaχilar	<i>noun</i><br><ol><li>independence</li></ol>
доккха|doqːa	<i>adj</i><br><ol><li>big</li></ol>
дораха|dōrakha	<i>adj</i><br><ol><li>cheap</li></ol>
досбух|dosbuχ	<i>noun</i><br><ol><li>place for chopping wood</li></ol>
доттагӏ|доттагӏий|доттагӏчо|dottaġ	<i>noun</i><br><ol><li>friend</li></ol>
дохк|doχk	<i>noun</i><br><ol><li>fog</li></ol>
дохка|doχka	<i>adj</i><br><ol><li>foggy</li><li>misty</li></ol><br><i>verb</i><br><ol><li>to sell</li></ol>
доца|dōtsa	<i>adj</i><br><ol><li>short</li></ol>
дош|doš|дашо̄|дешнаш	<i>noun</i><br><ol><li>word</li><li>deed</li><li>matter</li></ol>
дошам|došam	<i>noun</i><br><ol><li>dictionary</li></ol>
доьзал|dözal	<i>noun</i><br><ol><li>family</li></ol>
доьзткъа|dözṭq̇a	<i>num</i><br><ol><li>eighty</li></ol>
доьхк|döχk	<i>noun</i><br><ol><li>belt</li></ol>
доӏахк|doʿaχk	<i>noun</i><br><ol><li>liver</li></ol>
дуга|duga	<i>noun</i><br><ol><li>rice</li><li>cereals, groats</li></ol>
дуза|duza	<i>verb</i><br><ol><li>to fill</li></ol>
дукха|duqa	<i>adj</i><br><ol><li>many</li></ol>
дуста|dusta	<i>verb</i><br><ol><li>to measure</li></ol>
дуткъа|duṭq̇a	<i>adj</i><br><ol><li>thin</li></ol>
дуьне|дуьне̄|dünē	<i>noun</i><br><ol><li>world</li><li>light</li></ol>
дуьра|düra	<i>adj</i><br><ol><li>salty</li></ol>
дӏакхосса|dʿaqossa|дIакхуссу|дIакхоьссина|дIакхоьссира	<i>verb</i><br><ol><li>to throw away</li></ol>
е|e|Е	<i>character</i><br><ol><li>The eighth letter of the Chechen alphabet, written in the Cyrillic script.</li></ol>
еара|еарш|еаро|eara	<i>noun</i><br><ol><li>Thursday</li></ol>
етт|jiatt	<i>noun</i><br><ol><li>cow</li></ol>
ехк	<i>noun</i><br><ol><li>comb</li><li>brush</li></ol>
еша|eša|йоьшу	<i>verb</i><br><ol><li>to read</li></ol>
ж|Ж|ž	<i>character</i><br><ol><li>The tenth letter of the Chechen alphabet, written in the Cyrillic script.</li></ol>
жагӏа|žagla	<i>noun</i><br><ol><li>gravel</li></ol>
жаӏар|žaʿar	<i>noun</i><br><ol><li>cross</li></ol>
жеро|жерой|žero	<i>noun</i><br><ol><li>widow</li><li>a female divorcee</li></ol>
жигара|žigara	<i>adj</i><br><ol><li>energetic</li><li>active</li><li>enterprising</li><li>full of initiative</li></ol>
жигархо|žigarχoj|žigarχo|жигархой	<i>noun</i><br><ol><li>activist</li></ol>
жим|žim|= жаннаш	<i>noun</i><br><ol><li>kidney</li></ol>
жима|žima	<i>adj</i><br><ol><li>small, little</li><li>young</li></ol>
жоп|žop	<i>noun</i><br><ol><li>answer</li></ol>
жоьжахати|žöžaχati	<i>noun</i><br><ol><li>hell</li></ol>
жӏара|žʿara	<i>noun</i><br><ol><li>cross</li></ol>
жӏаьла|жӏаьло̄|žʿäla|жӏаьлеш|жӏаьлин|žʿälin	<i>noun</i><br><ol><li>dog</li></ol>
жӏаьлин нускал|žʿälin nuskalš|жӏаьлин нускалш|žʿälin nuskəl	<i>noun</i><br><ol><li>mushroom</li></ol>
з|З|z	<i>character</i><br><ol><li>The eleventh letter of the Chechen alphabet, written in the Cyrillic script.</li></ol>
заза|zaza|зазанаш|зазано	<i>noun</i><br><ol><li>flower</li></ol>
зайтун|zajtun	<i>noun</i><br><ol><li>olive</li></ol>
зезаг|zezag	<i>noun</i><br><ol><li>flower</li></ol>
зингат|zingat	<i>noun</i><br><ol><li>ant</li></ol>
зуда|зудари|zuda	<i>noun</i><br><ol><li>woman</li></ol>
зӏе|zʿe	<i>noun</i><br><ol><li>chain</li></ol>
зӏок|zʿok	<i>noun</i><br><ol><li>beak</li></ol>
зӏуга|dzuga	<i>noun</i><br><ol><li>wasp</li></ol>
и|И|i	<i>character</i><br><ol><li>The twelfth letter of the Chechen alphabet, written in the Cyrillic script.</li></ol><br><i>conj</i><br><ol><li>and</li></ol>
иза|iza	<i>pron</i><br><ol><li>third-person singular pronoun: he, she, it</li></ol>
ий|Ий|ī	<i>character</i><br><ol><li>The thirteenth letter of the Chechen alphabet, written in the Cyrillic script.</li></ol>
имам|imam|има̄маш|има̄мо	<i>noun</i><br><ol><li>(Islam) imam</li></ol>
инжир|inžir	<i>noun</i><br><ol><li>fig</li></ol>
ира|ira	<i>adj</i><br><ol><li>sharp</li></ol>
исс|iss	<i>num</i><br><ol><li>nine</li></ol>
итт|itt	<i>num</i><br><ol><li>ten</li></ol>
иту|итуш|itu|итуно	<i>noun</i><br><ol><li>clothes iron</li></ol>
ишкол|iškol	<i>noun</i><br><ol><li>school</li></ol>
й|j|Й	<i>character</i><br><ol><li>The fourteenth letter of the Chechen alphabet, written in the Cyrillic script.</li></ol>
йаз дан|jaz dan	<i>verb</i><br><ol><li>to write</li></ol>
йаздар|jazdar	<i>noun</i><br><ol><li>writing</li></ol>
йаздархо|jazdarχo	<i>noun</i><br><ol><li>writer; someone who writes</li><li>author</li></ol>
йалта|jalta	<i>noun</i><br><ol><li>crop</li><li>harvest</li></ol>
йалх|jalχ	<i>num</i><br><ol><li>six</li></ol>
йий|jī	<i>noun</i><br><ol><li>beer</li></ol>
йист|yīst	<i>noun</i><br><ol><li>edge</li><li>shore, coast</li><li>end</li></ol>
йиша|йишас|йижарий|jiša	<i>noun</i><br><ol><li>sister</li></ol>
йозанча|йозанчо|jozanča|йозанчаш	<i>noun</i><br><ol><li>secretary</li></ol>
йол|jol	<i>noun</i><br><ol><li>hay</li></ol>
йохкар|joχkar	<i>noun</i><br><ol><li>sale</li></ol>
йохкархо|joχkarχo	<i>noun</i><br><ol><li>vendor</li><li>salesperson</li><li>retail employee</li><li>clerk</li></ol>
йоӏ|joʿ|йоӏри	<i>noun</i><br><ol><li>daughter</li><li>girl</li></ol>
йу|ju	<i>noun</i><br><ol><li>awl</li></ol>
йукъ|juq̇	<i>noun</i><br><ol><li>center</li></ol>
йукь|juk’	<i>noun</i><br><ol><li>center</li></ol>
йургӏа|jurġa	<i>noun</i><br><ol><li>blanket</li></ol>
йуьхь|jüḥ	<i>noun</i><br><ol><li>face</li></ol>
к|К	<i>character</i><br><ol><li>The fifteenth letter of the Chechen alphabet, written in the Cyrillic script.</li></ol>
ка|ka	<i>noun</i><br><ol><li>hand</li></ol>
кад|kad	<i>noun</i><br><ol><li>cup</li></ol>
картог|kartog|картогаш	<i>noun</i><br><ol><li>potato</li></ol>
картол|kartol|картолаш	<i>noun</i><br><ol><li>potato</li></ol>
кема|kema	<i>noun</i><br><ol><li>boat</li><li>airplane</li></ol>
кеманхо|kemanχo	<i>noun</i><br><ol><li>pilot</li><li>someone who flies an airplane</li><li>aviator</li></ol>
кемс|kems	<i>noun</i><br><ol><li>grape</li></ol>
керла|kerla	<i>adj</i><br><ol><li>new</li><li>fresh</li></ol>
керт|kert	<i>noun</i><br><ol><li>fence</li></ol>
кехат|keχat	<i>noun</i><br><ol><li>paper</li></ol>
кийча|kīča	<i>adj</i><br><ol><li>ready</li></ol>
килс|kils	<i>noun</i><br><ol><li>church</li></ol>
кино|kino|кинош	<i>noun</i><br><ol><li>movie</li></ol>
кинчка|kinčka|кинчкш	<i>noun</i><br><ol><li>book</li></ol>
киншка|kinška	<i>noun</i><br><ol><li>book</li></ol>
кир|кӏир|ḳir|kir	<i>noun</i><br><ol><li>lime, calcium oxide</li></ol>
киса|kisa	<i>noun</i><br><ol><li>pocket</li></ol>
китаб|kitab	<i>noun</i><br><ol><li>book</li></ol>
кк|kk|Кк	<i>character</i><br><ol><li>The sixteenth letter of the Chechen alphabet, written in the Cyrillic script.</li></ol>
ккх|qː|Ккх	<i>character</i><br><ol><li>The eighteenth letter of the Chechen alphabet, written in the Cyrillic script.</li></ol>
книга|kniga|книгаш	<i>noun</i><br><ol><li>book</li></ol>
книшка|kniška	<i>noun</i><br><ol><li>book</li></ol>
ког|kog	<i>noun</i><br><ol><li>foot</li><li>leg</li></ol>
кор|kor	<i>noun</i><br><ol><li>window</li><li>observational slit at the top of Vainakh towers</li><li>attic, loft</li></ol>
корматалла|kormatalla	<i>noun</i><br><ol><li>ability</li><li>profession</li><li>occupation</li></ol>
корсам|korsam	<i>noun</i><br><ol><li>moss</li></ol>
корта|коьрто|korta|кортош	<i>noun</i><br><ol><li>head</li></ol>
котам|kotam	<i>noun</i><br><ol><li>hen</li></ol>
кофе|kofe	<i>noun</i><br><ol><li>coffee</li></ol>
коч|koč	<i>noun</i><br><ol><li>dress, shirt</li></ol>
куз|kuz	<i>noun</i><br><ol><li>carpet, rug</li></ol>
кухни|kuχni	<i>noun</i><br><ol><li>kitchen</li><li>cooking shed</li></ol>
куьг|куьгаш|küg	<i>noun</i><br><ol><li>arm</li></ol>
куьзга|küzga	<i>noun</i><br><ol><li>mirror</li></ol>
куьйра|куьйранаш|küjra	<i>noun</i><br><ol><li>northern goshawk (Accipiter gentilis)</li></ol>
кх|q|Кх	<i>character</i><br><ol><li>The seventeenth letter of the Chechen alphabet, written in the Cyrillic script.</li></ol>
кхаара|qaara	<i>noun</i><br><ol><li>Wednesday</li></ol>
кхаллардоттург|qallardotturg	<i>noun</i><br><ol><li>baker</li></ol>
кхана|qāna	<i>adv</i><br><ol><li>tomorrow</li></ol>
кхаьл|qäl	<i>noun</i><br><ol><li>mare</li></ol>
кхерам|qeram	<i>noun</i><br><ol><li>danger</li></ol>
кхета|qēta	<i>verb</i><br><ol><li>to understand</li><li>to meet</li></ol>
кхойтта|qojtta	<i>num</i><br><ol><li>thirteen</li></ol>
кхокха|qoqa	<i>noun</i><br><ol><li>rock pigeon, dove</li></ol>
кхор|qor	<i>noun</i><br><ol><li>pear</li></ol>
кхосса|quossaⁿ|кхоьссира|кхуссу|кхоьссина	<i>verb</i><br><ol><li>to throw, fling, cast</li><li>to shoot (a gun)</li></ol>
кхоъ|qoʾ	<i>num</i><br><ol><li>three</li></ol>
кхузткъа|quzṭq̇a	<i>num</i><br><ol><li>sixty</li></ol>
кхузткъе итт|quzṭq̇e itt	<i>num</i><br><ol><li>seventy</li></ol>
къ|q̇|Q̇|Къ	<i>character</i><br><ol><li>The nineteenth letter of the Chechen alphabet, written in the Cyrillic script.</li></ol>
къайле|q̇ajle	<i>noun</i><br><ol><li>secret</li></ol>
къамел да|q̇amel da	<i>verb</i><br><ol><li>to speak</li><li>to talk</li></ol>
къахьо|q̇aḥō|къахьо̄	<i>noun</i><br><ol><li>bitterness (quality of being bitter in taste)</li><li>coffee</li></ol>
къаьхьа|q̇äḥa	<i>adj</i><br><ol><li>bitter</li></ol>
къегина|q̇egina	<i>adj</i><br><ol><li>bright</li></ol>
къемате|q̇emate	<i>adj</i><br><ol><li>terrible, horrible</li></ol>
къена|q̇ena	<i>adj</i><br><ol><li>old</li></ol>
къийг|q̇īg	<i>noun</i><br><ol><li>crow</li></ol>
къилбе|q̇ilbe	<i>noun</i><br><ol><li>south</li></ol>
къилбседе|q̇ilbsede	<i>noun</i><br><ol><li>north</li></ol>
къолам|q̇olam	<i>noun</i><br><ol><li>pencil</li></ol>
къона|q̇ona	<i>adj</i><br><ol><li>young</li></ol>
къу|q̇u	<i>noun</i><br><ol><li>thief</li></ol>
кӏ|ḳ|Кӏ	<i>character</i><br><ol><li>The twentieth letter of the Chechen alphabet, written in the Cyrillic script.</li></ol>
кӏа|ḳa	<i>noun</i><br><ol><li>wheat</li></ol>
кӏай|ḳaj	<i>adj</i><br><ol><li>white</li></ol>
кӏайн|ḳajn	<i>adj</i><br><ol><li>white</li></ol>
кӏант|ḳenti|кӏенти|ḳant	<i>noun</i><br><ol><li>boy</li><li>son</li></ol>
кӏеда|ḳeda	<i>adj</i><br><ol><li>soft</li></ol>
кӏел|ḳel	<i>adv</i><br><ol><li>under, beneath</li></ol>
кӏира|кӏиро̄|ḳira	<i>noun</i><br><ol><li>week</li></ol>
кӏиранде|ḳirande|кӏирандийно|кӏиранденош	<i>noun</i><br><ol><li>Sunday</li></ol>
кӏомсар|ḳomsar	<i>noun</i><br><ol><li>canine tooth</li></ol>
кӏора|ḳora	<i>noun</i><br><ol><li>noun</li></ol>
кӏорга|ḳorga	<i>adj</i><br><ol><li>deep</li></ol>
кӏордо|ḳordo	<i>adj</i><br><ol><li>annoying, bothersome</li></ol>
кӏорни|ḳorni	<i>noun</i><br><ol><li>chick, nestling</li><li>young of an animal</li></ol>
кӏур|ḳur	<i>noun</i><br><ol><li>smoke</li></ol>
л|Л|l	<i>character</i><br><ol><li>The twenty-first letter of the Chechen alphabet, written in the Cyrillic script.</li></ol>
лаамалла|laamalla	<i>noun</i><br><ol><li>independence</li></ol>
лаза|laza	<i>verb</i><br><ol><li>to hurt</li></ol>
лазар|lazar	<i>noun</i><br><ol><li>pain</li></ol>
лаилаха иллАллах|lailaχa illAllaχ	<i>phrase</i><br><ol><li>There is no deity but God (the shahada)</li></ol>
лай|laj	<i>noun</i><br><ol><li>slave</li></ol>
лам|лаьмнаш|lam	<i>noun</i><br><ol><li>mountain</li></ol>
лама|lama	<i>adv</i><br><ol><li>day after tomorrow</li></ol>
лами|lāmi	<i>noun</i><br><ol><li>ladder</li></ol>
лара|lāra	<i>verb</i><br><ol><li>to count</li></ol>
ларгант|largant	<i>noun</i><br><ol><li>barber</li></ol>
латта|latta	<i>noun</i><br><ol><li>earth</li><li>soil</li></ol><br><i>verb</i><br><ol><li>to stand</li></ol>
лаца|lātsa	<i>noun</i><br><ol><li>catch, seize</li><li>take</li></ol>
лаьхьа|läẋa	<i>noun</i><br><ol><li>snake</li></ol>
лезгинка|лезгинко|лезгинкаш|lezginka	<i>noun</i><br><ol><li>lezginka (dance)</li><li>a Lezgi (female)</li></ol>
лекха|leqa	<i>adj</i><br><ol><li>high</li></ol><br><i>verb</i><br><ol><li>to sing</li></ol>
лела|lēla|лēла	<i>verb</i><br><ol><li>to walk, to move, to go</li><li>to move in air, to fly</li></ol>
лерг|lerg	<i>noun</i><br><ol><li>(anatomy) ear</li></ol>
леха|lēkha	<i>verb</i><br><ol><li>to look for, to seek</li></ol>
леча|лечарчий|leča	<i>noun</i><br><ol><li>falcon</li><li>great spotted woodpecker, lesser spotted woodpecker</li></ol>
ло|lo	<i>noun</i><br><ol><li>snow</li></ol>
лом|lom	<i>noun</i><br><ol><li>lion</li></ol>
лор|lor|ло̄ьраш|ло̄ьро̄	<i>noun</i><br><ol><li>doctor</li></ol>
лорйиша|lorjiša	<i>noun</i><br><ol><li>nurse</li></ol>
лоха|loχa	<i>adj</i><br><ol><li>low</li></ol>
лоьмар|lömar	<i>noun</i><br><ol><li>number</li></ol>
лугӏат|лугӏаташ|luġat	<i>noun</i><br><ol><li>dictionary</li></ol>
м|М	<i>character</i><br><ol><li>The twenty-second letter of the Chechen alphabet, written in the Cyrillic script.</li></ol>
маж|maž	<i>noun</i><br><ol><li>beard</li></ol>
майра|majra	<i>adj</i><br><ol><li>brave</li></ol>
мала|молу|мелла|мелира|malaⁿ	<i>verb</i><br><ol><li>to drink</li></ol>
малар|malar	<i>noun</i><br><ol><li>drinking</li><li>a drink</li></ol>
малх|malχ	<i>noun</i><br><ol><li>sun</li></ol>
малхбале|malχbale	<i>noun</i><br><ol><li>east</li></ol><br><i>adj</i><br><ol><li>east</li></ol>
малхбузе|malχbuze	<i>noun</i><br><ol><li>west</li></ol>
мангал|mangal|мангалаш	<i>noun</i><br><ol><li>scythe</li></ol>
мар|mar	<i>noun</i><br><ol><li>husband</li></ol>
мара|mara|марош|меро̄	<i>noun</i><br><ol><li>nose</li></ol>
марзилник|marzilnik	<i>noun</i><br><ol><li>freezer</li></ol>
марс|mars	<i>noun</i><br><ol><li>sickle</li></ol>
марта|marta	<i>noun</i><br><ol><li>breakfast</li></ol>
марха|marχa	<i>noun</i><br><ol><li>cloud</li></ol>
маршо|maršo	<i>noun</i><br><ol><li>freedom</li><li>security</li></ol>
маса|masa	<i>pron</i><br><ol><li>how many</li></ol>
мах|māx	<i>noun</i><br><ol><li>aspen (tree)</li><li>price</li></ol>
маха|maaxa|ма̄ха	<i>noun</i><br><ol><li>needle</li></ol>
маца|maca	<i>pron</i><br><ol><li>when</li></ol>
мацалла|macalla	<i>noun</i><br><ol><li>hunger</li></ol>
мача|mača|маачаш	<i>noun</i><br><ol><li>a shoe</li></ol>
машар|mašar	<i>noun</i><br><ol><li>peace</li></ol>
машен|машенаш|mašen|mašenaš	<i>noun</i><br><ol><li>car</li></ol>
маьждиг|mäždig	<i>noun</i><br><ol><li>mosque</li></ol>
маьнга|mänga	<i>noun</i><br><ol><li>bed</li></ol>
маӏа|maʿa	<i>noun</i><br><ol><li>horn</li></ol>
меза|meza	<i>noun</i><br><ol><li>louse</li></ol>
мел|mel	<i>pron</i><br><ol><li>how much</li></ol>
мела|mela	<i>adj</i><br><ol><li>warm</li></ol>
менеджер|meneǯer	<i>noun</i><br><ol><li>manager</li></ol>
мерза|merza	<i>adj</i><br><ol><li>sweet</li></ol>
месаш|mesaš	<i>noun</i><br><ol><li>hair</li></ol>
меттанийн ӏилманча|mettanīn ʿilmanča	<i>noun</i><br><ol><li>linguist</li></ol>
меттиг|mettig	<i>noun</i><br><ol><li>place</li></ol>
меца|meca	<i>adj</i><br><ol><li>hungry</li></ol>
мила|mila	<i>pron</i><br><ol><li>who</li></ol>
милцо|milco	<i>noun</i><br><ol><li>policeman, police officer, police</li><li>someone in the military</li></ol>
минот|minot	<i>noun</i><br><ol><li>minute</li></ol>
мичара|mičara	<i>pron</i><br><ol><li>where</li></ol>
могуш|moguš	<i>adj</i><br><ol><li>healthy</li></ol>
можа|moža	<i>adj</i><br><ol><li>yellow</li></ol>
моз|moz	<i>noun</i><br><ol><li>honey</li></ol>
моза|moza	<i>noun</i><br><ol><li>a fly</li></ol>
мозгӏар|mozġar	<i>noun</i><br><ol><li>priest</li></ol>
морза|morza	<i>noun</i><br><ol><li>whey</li></ol>
морзах|morzaχ	<i>noun</i><br><ol><li>pliers</li><li>pincer</li></ol>
москал|moskalal|moskal|москалшка|moskalška|moskale|moskalo|москалийн|moskalšca|moskalca|москалал|москалшна|москало|москалах|москалш|moskalīn|москалшца|moskalša|москалан|москалша|moskalš|moskalšna|москале|москалех|moskalna|moskalel|москалца|moskalaχ|moskaleχ|moskalan|москало̄|москална|москалел	<i>noun</i><br><ol><li>turkey</li></ol>
мостагӏ|mostaġ|мостагӏо|мостагӏаш	<i>noun</i><br><ol><li>enemy</li></ol>
мотт|матто̄|mott|меттанаш	<i>noun</i><br><ol><li>language</li></ol>
мох	<i>noun</i><br><ol><li>wind</li></ol>
мохк|moχk	<i>noun</i><br><ol><li>country</li><li>land</li></ol>
моьлкъа|mölq̇a	<i>noun</i><br><ol><li>lizard</li></ol>
музыкант|muzykant	<i>noun</i><br><ol><li>musician</li></ol>
мукх|muq	<i>noun</i><br><ol><li>barley</li></ol>
муьста|müsta	<i>adj</i><br><ol><li>sour</li></ol>
мӏара|m'āra	<i>noun</i><br><ol><li>nail (on fingers)</li><li>claw</li><li>fork</li><li>hook</li></ol>
н|Н	<i>character</i><br><ol><li>The twenty-third letter of the Chechen alphabet, written in the Cyrillic script.</li></ol>
наб|nab	<i>noun</i><br><ol><li>sleep</li></ol>
наж|нежнаш|naž	<i>noun</i><br><ol><li>oak</li></ol>
накхармоза|naqarmoza	<i>noun</i><br><ol><li>bee (insect)</li></ol>
налог|nalog	<i>noun</i><br><ol><li>tax</li></ol>
налха|nalχa	<i>noun</i><br><ol><li>butter</li></ol>
нана|nana	<i>noun</i><br><ol><li>mother</li></ol>
нах	<i>noun</i><br><ol><li>people</li></ol>
наьрс|närs	<i>noun</i><br><ol><li>cucumber</li></ol>
нека|neka	<i>noun</i><br><ol><li>swim (swimming)</li></ol>
нека дан|neek da	<i>verb</i><br><ol><li>to swim</li></ol>
некъ|neq̇	<i>noun</i><br><ol><li>way</li><li>road</li></ol>
нехча|neχča	<i>noun</i><br><ol><li>cheese</li></ol>
неӏ|neʿ	<i>noun</i><br><ol><li>door</li></ol>
нийса|nīsa	<i>adj</i><br><ol><li>right (correct)</li><li>straight</li></ol>
нитт|nitt	<i>noun</i><br><ol><li>nettle</li></ol>
нитташ|nittaš	<i>noun</i><br><ol><li>nettle</li></ol>
нохчий|noχčī|noχčīn|нохчийн	<i>noun</i><br><ol><li>Chechen (A member of a Nakh people of the northern Caucasus).</li></ol>
нохчийн|noχčīn	<i>adj</i><br><ol><li>Chechen (language)</li></ol>
нохчийн мотт|noxçiyn mott	<i>noun</i><br><ol><li>Chechen (a North-Central Caucasian language spoken in Chechnya)</li></ol>
нуй|nuj	<i>noun</i><br><ol><li>broom</li></ol>
нус|nus	<i>noun</i><br><ol><li>daughter-in-law</li></ol>
нускал|nuskəl	<i>noun</i><br><ol><li>bride</li></ol>
нуц|nuc	<i>noun</i><br><ol><li>son-in-law</li></ol>
нӏакха|nʿaqa	<i>noun</i><br><ol><li>breast</li></ol>
нӏаьна|nʿäna	<i>noun</i><br><ol><li>worm</li></ol>
о|О|o	<i>character</i><br><ol><li>The twenty-fourth letter of the Chechen alphabet, written in the Cyrillic script.</li></ol>
ов|ow|Ов	<i>character</i><br><ol><li>The twenty-fifth letter of the Chechen alphabet, written in the Cyrillic script.</li></ol><br><i>noun</i><br><ol><li>net</li></ol>
ойла|ojla	<i>noun</i><br><ol><li>thought</li><li>idea</li><li>intention</li><li>purpose</li></ol>
олла|olla	<i>verb</i><br><ol><li>to hang</li></ol>
олхазар|olxazar|олхазараш	<i>noun</i><br><ol><li>bird</li></ol>
ор|or	<i>noun</i><br><ol><li>hole, pit</li></ol>
орам|oram	<i>noun</i><br><ol><li>root</li></ol>
оршот|оршоташ|оршото|oršot	<i>noun</i><br><ol><li>Monday</li></ol>
официант|oficiant	<i>noun</i><br><ol><li>waiter</li></ol>
охьа|oḥa	<i>adv</i><br><ol><li>down</li></ol>
оь|Оь|ö	<i>character</i><br><ol><li>The twenty-sixth letter of the Chechen alphabet, written in the Cyrillic script.</li></ol>
оьлг|ölg	<i>noun</i><br><ol><li>small loaf of bread</li></ol>
оьмар|ömar	<i>noun</i><br><ol><li>age</li></ol>
оьрсий|örsī	<i>adj</i><br><ol><li>Russian</li></ol>
п|p|П	<i>character</i><br><ol><li>The twenty-seventh letter of the Chechen alphabet, written in the Cyrillic script.</li></ol>
пазат|pāzat	<i>noun</i><br><ol><li>sock, stocking</li></ol>
пайхамар|pajχamar	<i>noun</i><br><ol><li>(Islam) prophet</li></ol>
пах	<i>noun</i><br><ol><li>lung</li></ol>
пачхьалкх|пачхьалкхел|пачхьалкхех|пачьхалкхан (pač’χalqan)|пачхьалкхашца|пачхьалкхах|пачхьалкхца|пачхьалкхийн|пачхьалкхна|пачхьалкхашна|пачхьалкхо|пачхьалкхе|пачхьалкхашка|пачхьалкхаш|pach-h'alkh|пачхьалкхал	<i>noun</i><br><ol><li>republic</li></ol>
паччахь|paččaḥ	<i>noun</i><br><ol><li>king</li></ol>
пелаг|pelag	<i>noun</i><br><ol><li>feather</li></ol>
пен|pen	<i>noun</i><br><ol><li>wall</li></ol>
пеш|peš	<i>noun</i><br><ol><li>stove</li></ol>
пилмот|pilmot	<i>noun</i><br><ol><li>machine gun</li></ol>
пилот|pilot	<i>noun</i><br><ol><li>pilot</li></ol>
полла|polla	<i>noun</i><br><ol><li>butterfly</li></ol>
пп|Пп|pp	<i>character</i><br><ol><li>The twenty-eighth letter of the Chechen alphabet, written in the Cyrillic script.</li></ol>
пха|пхенаш	<i>noun</i><br><ol><li>common hornbeam, Carpinus betulus</li><li>vein</li><li>artery</li></ol>
пхийтта|pχītta	<i>num</i><br><ol><li>fifteen</li></ol>
пхиъ	<i>num</i><br><ol><li>five</li></ol>
пхьагал|pḥagal|пхьагалш	<i>noun</i><br><ol><li>rabbit, hare</li></ol>
пхьар|pḥar	<i>noun</i><br><ol><li>master</li></ol>
пхьарс|пхьаьрсаш|пхьаьрсо|pḥars	<i>noun</i><br><ol><li>arm (from the shoulder to the fingers)</li></ol>
пхьид|пхьидарчий|пхьидаш|pẋid	<i>noun</i><br><ol><li>frog</li><li>(anatomy) calf of the leg</li></ol>
пхьор|pḥor	<i>noun</i><br><ol><li>supper</li></ol>
пӏ|Пӏ|ṗ	<i>character</i><br><ol><li>The twenty-ninth letter of the Chechen alphabet, written in the Cyrillic script.</li></ol>
пӏелг|ṗelg	<i>noun</i><br><ol><li>finger</li></ol>
пӏенда|ṗenda	<i>noun</i><br><ol><li>rib</li></ol>
пӏераска|пӏерасканаш|пӏераскано|ṗeraska	<i>noun</i><br><ol><li>Friday</li></ol>
р|r|Р	<i>character</i><br><ol><li>The thirtieth letter of the Chechen alphabet, written in the Cyrillic script.</li></ol>
реза|reza	<i>adj</i><br><ol><li>happy</li></ol>
рхӏ|Рхӏ|rh	<i>character</i><br><ol><li>The thirty-first letter of the Chechen alphabet, written in the Cyrillic script.</li></ol>
с|С	<i>character</i><br><ol><li>The thirty-second letter of the Chechen alphabet, written in the Cyrillic script.</li></ol>
са|sā|sa	<i>noun</i><br><ol><li>soul</li><li>life</li><li>spirit</li><li>light</li><li>vision</li><li>corner</li></ol>
саба|saba	<i>noun</i><br><ol><li>soap</li></ol>
сагал|sagal	<i>noun</i><br><ol><li>flea</li></ol>
сай|saj	<i>noun</i><br><ol><li>deer</li></ol>
салам алейкум|salam alejkum	<i>intj</i><br><ol><li>(Islam) salaam alaikum (Muslim greeting)</li></ol>
сатта|satta	<i>verb</i><br><ol><li>to bend</li></ol>
сахьт|saḥt	<i>noun</i><br><ol><li>hour</li><li>clock</li></ol>
саца|saca	<i>verb</i><br><ol><li>to stop</li></ol>
седа|seda	<i>noun</i><br><ol><li>star</li></ol>
селхана|selχana	<i>adv</i><br><ol><li>yesterday</li></ol>
серло|serlo	<i>noun</i><br><ol><li>light</li><li>brightness</li><li>illumination</li></ol>
сийна|sīna	<i>adj</i><br><ol><li>blue</li></ol>
сирла|sirla	<i>adj</i><br><ol><li>light</li><li>bright</li><li>clear</li></ol>
сиха|siχa	<i>adj</i><br><ol><li>fast, quick</li></ol>
словарь|slowar’|словараш	<i>noun</i><br><ol><li>dictionary</li></ol>
со|соьца|сол|so|соьга|сан|san|сох (soχ)|суна|ас	<i>pron</i><br><ol><li>first-person singular pronoun: I</li></ol>
совдегар|совде̄гарш|совде̄гар|sowdēgar|совде̄гаро̄	<i>noun</i><br><ol><li>businessman, businesswoman</li></ol>
сс|Сс|ss	<i>character</i><br><ol><li>The thirty-third letter of the Chechen alphabet, written in the Cyrillic script.</li></ol>
стаг|stag|стегри	<i>noun</i><br><ol><li>man</li><li>person</li><li>people</li></ol>
сте|ste	<i>noun</i><br><ol><li>female</li></ol>
стигал|stigal	<i>noun</i><br><ol><li>sky</li></ol>
стом|stom	<i>noun</i><br><ol><li>fruit</li></ol>
стомма|stomma	<i>adj</i><br><ol><li>thick</li></ol>
сту|stu	<i>noun</i><br><ol><li>bull</li></ol>
сурт|surt	<i>noun</i><br><ol><li>image</li><li>picture</li></ol>
суртдуьллург|surtdüllurg	<i>noun</i><br><ol><li>artist as in someone who paints or draws, occupation related to pictures.</li></ol>
сурхо|surχo	<i>noun</i><br><ol><li>soldier</li></ol>
суьдхо|südχo	<i>noun</i><br><ol><li>judge</li></ol>
суьйре|süjre	<i>noun</i><br><ol><li>evening</li></ol>
т|Т|t	<i>character</i><br><ol><li>The thirty-fourth letter of the Chechen alphabet, written in the Cyrillic script.</li></ol>
таж|taž	<i>noun</i><br><ol><li>crown</li></ol>
тай|taj	<i>noun</i><br><ol><li>thread</li></ol>
татта|tatta	<i>verb</i><br><ol><li>to push</li></ol>
тахана|taχana	<i>adv</i><br><ol><li>today</li></ol>
тега|tēga	<i>verb</i><br><ol><li>to sew</li></ol>
тегар|tegar	<i>noun</i><br><ol><li>sewing</li></ol>
тегархо|tegarχo	<i>noun</i><br><ol><li>tailor</li></ol>
текхарг|tieqarg	<i>noun</i><br><ol><li>serpent</li></ol>
терхи|terχi	<i>noun</i><br><ol><li>shelf</li></ol>
тилвизор|tilwizor	<i>noun</i><br><ol><li>television set</li></ol>
тилпо|tilpo	<i>noun</i><br><ol><li>telephone</li></ol>
ткъа|ṭq̇a	<i>num</i><br><ol><li>twenty</li></ol><br><i>conj</i><br><ol><li>but</li><li>really, indeed</li></ol>
ткъайоьсна|ṭq̇ajösna	<i>num</i><br><ol><li>nineteen</li></ol>
ткъе итт|ṭq̇e itt	<i>num</i><br><ol><li>thirty</li></ol>
товха|towχa	<i>noun</i><br><ol><li>fireplace</li></ol>
тонка|tonka	<i>noun</i><br><ol><li>tobacco</li></ol>
топ|top	<i>noun</i><br><ol><li>gun</li><li>rifle</li></ol>
тт|Тт|tt	<i>character</i><br><ol><li>The thirty-fifth letter of the Chechen alphabet, written in the Cyrillic script.</li></ol>
тукар|tukar	<i>noun</i><br><ol><li>scissors</li></ol>
тукхам|tuqam	<i>noun</i><br><ol><li>tribe</li></ol>
тур|tur	<i>noun</i><br><ol><li>sword, sabre, shashka</li></ol>
тускар|tuskar	<i>noun</i><br><ol><li>basket</li></ol>
туька|tüka	<i>noun</i><br><ol><li>shop</li></ol>
туьха|tüχa	<i>noun</i><br><ol><li>salt</li></ol>
тхир|tχir	<i>noun</i><br><ol><li>dew</li></ol>
тхо|txo	<i>pron</i><br><ol><li>first-person exclusive plural pronoun: we</li></ol>
тхов|tχow	<i>noun</i><br><ol><li>roof</li></ol>
тӏ|ṭ|Тӏ	<i>character</i><br><ol><li>The thirty-sixth letter of the Chechen alphabet, written in the Cyrillic script.</li></ol>
тӏай|ṭaj	<i>noun</i><br><ol><li>bridge</li></ol>
тӏам|ṭām	<i>noun</i><br><ol><li>wing</li></ol>
тӏаьхьа|ṭäḥa	<i>adv</i><br><ol><li>behind</li><li>after</li></ol>
тӏеда|ṭeda	<i>adj</i><br><ol><li>wet</li></ol>
тӏен|ṭen	<i>noun</i><br><ol><li>penis</li></ol>
тӏом|тӏемаша|тӏемашна|тӏамана|тӏамаца|тӏемийн|тӏамо|тӏемашка|тӏаме|тӏамал|тӏеман|тӏемех|тӏемел|ṭom|тӏемаш|тӏемашца|тӏамах	<i>noun</i><br><ol><li>fight, violence</li><li>war, battle</li></ol>
тӏулг|ṭulg	<i>noun</i><br><ol><li>stone</li></ol>
у|У|u	<i>character</i><br><ol><li>The thirty-seventh letter of the Chechen alphabet, written in the Cyrillic script.</li></ol>
ув|Ув|uw	<i>character</i><br><ol><li>The thirty-eighth letter of the Chechen alphabet, written in the Cyrillic script.</li></ol>
уллохь|ulloḥ	<i>adv</i><br><ol><li>near</li></ol>
университет|университеташ|uniwersitet	<i>noun</i><br><ol><li>university</li></ol>
урам|ӯрамо̄|ӯрамаш|ӯрам	<i>noun</i><br><ol><li>street</li></ol>
урдо|урдо̄|urdō	<i>noun</i><br><ol><li>bride price (paid for divorce)</li></ol>
урс|urs	<i>noun</i><br><ol><li>knife</li><li>chisel</li><li>razor</li></ol>
уь|ü|Уь	<i>character</i><br><ol><li>The thirty-ninth letter of the Chechen alphabet, written in the Cyrillic script.</li></ol>
уьй|Уьй|üj	<i>character</i><br><ol><li>The fortieth letter of the Chechen alphabet, written in the Cyrillic script.</li></ol>
уьстагӏ|üstaġ	<i>noun</i><br><ol><li>sheep</li></ol>
уьш|üš	<i>pron</i><br><ol><li>third-person plural pronoun: they</li></ol>
уьшал|üšal	<i>noun</i><br><ol><li>swamp</li></ol>
ф|Ф	<i>character</i><br><ol><li>The forty-first letter of the Chechen alphabet, written in the Cyrillic script.</li></ol>
х|Х	<i>character</i><br><ol><li>The forty-second letter of the Chechen alphabet, written in the Cyrillic script.</li></ol>
хаам|хаамийн|хаамаша|хааман|хаамна|хаамца|хаамах|хаамех|хаамал|хаамел|хаамашка|haam|хааме|хаамо|хаамаш|хаамашна|хаамашца	<i>noun</i><br><ol><li>information, message</li></ol>
хабар|χabar	<i>noun</i><br><ol><li>news</li></ol>
хаза|χaza	<i>adj</i><br><ol><li>beautiful, nice</li></ol><br><i>verb</i><br><ol><li>to hear</li></ol>
хазалла|xazalla	<i>noun</i><br><ol><li>beauty</li></ol>
хала|χala	<i>adj</i><br><ol><li>difficult</li></ol>
халдилник|χaldilnik	<i>noun</i><br><ol><li>fridge</li></ol>
халкъ|χalq̇	<i>noun</i><br><ol><li>the people</li></ol>
халкь|χalk’	<i>noun</i><br><ol><li>a people</li></ol>
хан|хе̄но̄	<i>noun</i><br><ol><li>time</li></ol>
харжа|χarža	<i>verb</i><br><ol><li>to choose</li></ol>
харца|χarca	<i>verb</i><br><ol><li>to change</li></ol>
хаспанча|хаспанчо̄|хаспанчаш|χaspanča	<i>noun</i><br><ol><li>butcher</li></ol>
хаттар|χattar	<i>noun</i><br><ol><li>question</li></ol>
хелхар|χelχar	<i>noun</i><br><ol><li>dancing</li></ol>
хелхархо|χelχarχo	<i>noun</i><br><ol><li>dancer</li><li>dancing as an occupation</li><li>someone who is dancing a lezginka</li></ol>
хен	<i>noun</i><br><ol><li>wood, piece of wood</li><li>tree (archaic)</li></ol>
хенан хӏоттам|χenan hottam	<i>noun</i><br><ol><li>weather</li></ol>
херх	<i>noun</i><br><ol><li>a saw</li></ol>
хеча	<i>noun</i><br><ol><li>pants, trousers</li></ol>
хи|xi	<i>noun</i><br><ol><li>water</li><li>river</li></ol>
хила|χila	<i>verb</i><br><ol><li>to be</li></ol>
хола|χola	<i>noun</i><br><ol><li>stack of hay</li></ol>
хох|xox	<i>noun</i><br><ol><li>onion</li></ol>
хь|ḥ|Хь	<i>character</i><br><ol><li>The forty-third letter of the Chechen alphabet, written in the Cyrillic script.</li></ol>
хьаж|ḥaž	<i>noun</i><br><ol><li>forehead</li></ol>
хьажа|ḥaža	<i>verb</i><br><ol><li>to look</li><li>to taste</li><li>to try</li><li>to wait</li></ol>
хьакха|хьакхарчи|ḥaqa	<i>noun</i><br><ol><li>pig</li></ol>
хьал да|ḥal da	<i>verb</i><br><ol><li>to build</li></ol>
хьала|ḥala	<i>adv</i><br><ol><li>up</li></ol>
хьалха|ḥalχa	<i>adv</i><br><ol><li>before, in front</li></ol>
хьацар|ḥacar	<i>noun</i><br><ol><li>sweat</li></ol>
хье|ḥe	<i>noun</i><br><ol><li>brain</li></ol>
хьера|ḥera	<i>noun</i><br><ol><li>mill</li></ol>
хьеха	<i>verb</i><br><ol><li>to teach</li></ol>
хьехар|ḥeχar	<i>noun</i><br><ol><li>teaching</li></ol>
хьехархо|хьехархой|ḥeχarχo|хьехархочо	<i>noun</i><br><ol><li>teacher, instructor</li></ol>
хьеша|hēsha	<i>noun</i><br><ol><li>guest</li></ol>
хьо|ḥo	<i>pron</i><br><ol><li>second-person singular pronoun: you</li></ol>
хьогалла|ḥogalla	<i>noun</i><br><ol><li>thirst</li></ol>
хьожа|ḥoža	<i>noun</i><br><ol><li>a smell</li></ol>
хьоза|h’oza	<i>noun</i><br><ol><li>sparrow</li><li>bird</li></ol>
хьостам|ḥostam	<i>noun</i><br><ol><li>nail (for fastening)</li></ol>
хьун|ḥun|хьуьно|хьаннаш	<i>noun</i><br><ol><li>forest</li></ol>
хӏ|Хӏ|h	<i>character</i><br><ol><li>The forty-fourth letter of the Chechen alphabet, written in the Cyrillic script.</li></ol>
хӏаваъ|hawaʾ	<i>noun</i><br><ol><li>air</li></ol>
хӏан-хӏа|han-ha	<i>particle</i><br><ol><li>no</li></ol>
хӏара|хӏорш|хӏокхарна|хӏокхарел|хӏокхо|хӏокхарах|хӏокхаьрга|hara|хӏокхунах|хӏокхаьрца|хӏокхуьнга|хӏокхара|хӏокхуьнан|хӏокхунна|хӏокхуьнца|хӏокхеран|хӏокхул	<i>pron</i><br><ol><li>this — demonstrative pronoun indicating an object is near the speaker</li></ol>
хӏаъ|haʾ	<i>particle</i><br><ol><li>yes</li></ol>
хӏинца|hinca	<i>adv</i><br><ol><li>now</li></ol>
хӏоа|hoa	<i>noun</i><br><ol><li>egg</li></ol>
хӏорам|ḥoram	<i>noun</i><br><ol><li>forum</li></ol>
хӏорд|hord	<i>noun</i><br><ol><li>sea</li></ol>
хӏоъ|hoʾ	<i>noun</i><br><ol><li>grain forage</li></ol>
хӏу|hu	<i>verb</i><br><ol><li>seed</li></ol>
хӏума|huma	<i>noun</i><br><ol><li>thing</li></ol>
хӏун|hun	<i>pron</i><br><ol><li>what</li></ol>
хӏунда|hunda	<i>adv</i><br><ol><li>why</li></ol>
хӏусам|husam	<i>noun</i><br><ol><li>house</li></ol>
ц|c|Ц	<i>character</i><br><ol><li>The forty-fifth letter of the Chechen alphabet, written in the Cyrillic script.</li></ol>
ца|ca	<i>particle</i><br><ol><li>not</li></ol>
це|ce	<i>noun</i><br><ol><li>horse's tooth</li></ol>
церг|cerg	<i>noun</i><br><ol><li>tooth</li></ol>
цергийн лор|tsergiyn lor	<i>noun</i><br><ol><li>dentist</li></ol>
цициг|cicig	<i>noun</i><br><ol><li>cat</li></ol>
цхьайтта|cḥajtta	<i>num</i><br><ol><li>eleven</li></ol>
цхьаъ|cḥaʾ	<i>num</i><br><ol><li>one</li></ol>
цхьогал|цхьо̄гал|cḥōgal	<i>noun</i><br><ol><li>fox</li></ol>
цӏ|c̣|Цӏ	<i>character</i><br><ol><li>The forty-sixth letter of the Chechen alphabet, written in the Cyrillic script.</li></ol>
цӏа|цӏенош|цӏеноша|цӏенна|цӏенойл|цӏийнан|цӏийно|цӏийнаца|цӏеношка|цӏеношна|цӏе̄нош|c'ienosh|цӏенойх|c̣a|цӏеношца|цӏийне|цӏийнал|цӏенойн|цӏийнах	<i>noun</i><br><ol><li>house, home</li><li>room</li></ol>
цӏаста|c̣asta	<i>noun</i><br><ol><li>copper</li></ol>
цӏе|c̣e	<i>adj</i><br><ol><li>red</li></ol><br><i>noun</i><br><ol><li>name</li><li>fire</li></ol>
цӏен|c̣ēn|цӏēн	<i>adj</i><br><ol><li>red</li></ol>
цӏена|c̣ena	<i>adj</i><br><ol><li>clean (not dirty)</li></ol>
цӏенош|c'ienosh|цӏе̄нош	<i>noun</i><br><ol><li>house</li></ol>
цӏерметдош|ċermetdoş	<i>noun</i><br><ol><li>pronoun</li></ol>
цӏий|c̣ī	<i>noun</i><br><ol><li>blood</li></ol>
цӏина|c̣ina	<i>adj</i><br><ol><li>new</li></ol>
цӏога|c̣oga	<i>noun</i><br><ol><li>tail</li></ol>
цӏока|c̣oka	<i>noun</i><br><ol><li>skin</li></ol>
цӏокъберг|c̣oq̇berg	<i>noun</i><br><ol><li>ounce, snow leopard or lynx</li></ol>
цӏонга|c̣onga	<i>noun</i><br><ol><li>(anatomy) navel</li></ol>
цӏоькъалом|ċöķalom	<i>noun</i><br><ol><li>tiger</li></ol>
ч|č|Ч	<i>character</i><br><ol><li>The forty-seventh letter of the Chechen alphabet, written in the Cyrillic script.</li></ol>
ча|чаш|ča|чено̄|черчий	<i>noun</i><br><ol><li>bear</li><li>straw</li></ol>
чам|čam	<i>noun</i><br><ol><li>a taste</li></ol>
четар|četar	<i>noun</i><br><ol><li>tent</li></ol>
чим|čim	<i>noun</i><br><ol><li>ash</li></ol>
чиркъ|čirq̇	<i>noun</i><br><ol><li>lamp</li></ol>
чо|čo	<i>noun</i><br><ol><li>hair</li></ol>
човка|чоекарчий|čovka	<i>noun</i><br><ol><li>jackdaw</li></ol>
чорпа|čorpa	<i>noun</i><br><ol><li>soup</li></ol>
чот|čot	<i>noun</i><br><ol><li>account</li></ol>
чоь|čö	<i>noun</i><br><ol><li>room</li></ol>
чу|ču	<i>adv</i><br><ol><li>in</li></ol>
чухчари|čuχčari	<i>noun</i><br><ol><li>waterfall</li></ol>
чӏ|č̣|Чӏ	<i>character</i><br><ol><li>The forty-eighth letter of the Chechen alphabet, written in the Cyrillic script.</li></ol>
чӏара|chāra	<i>noun</i><br><ol><li>fish</li></ol>
чӏениг|č̣enig	<i>noun</i><br><ol><li>chin</li></ol>
чӏурам|č̣uramaš|чӏурамаш|č̣urəm	<i>noun</i><br><ol><li>candle</li></ol>
чӏуьрг|č̣ürg	<i>noun</i><br><ol><li>wheel</li></ol>
ш|Ш|š	<i>character</i><br><ol><li>The forty-ninth letter of the Chechen alphabet, written in the Cyrillic script.</li></ol>
ша|ša|шā|šā	<i>noun</i><br><ol><li>ice</li></ol><br><i>pron</i><br><ol><li>self, oneself (reflexive pronoun)</li></ol>
шад|šad	<i>noun</i><br><ol><li>knot</li></ol>
шаьлта|šälta	<i>noun</i><br><ol><li>dagger</li></ol>
шекар|шекаро|šekar|шекарш	<i>noun</i><br><ol><li>sugar</li></ol>
шеко|šeko	<i>noun</i><br><ol><li>doubt</li></ol>
шелиг|šelig	<i>noun</i><br><ol><li>refrigerator, fridge</li></ol>
шера|shēra	<i>adj</i><br><ol><li>smooth</li></ol>
ши бӏе|ši bʿe	<i>num</i><br><ol><li>two hundred</li></ol>
шийла|šīla	<i>adj</i><br><ol><li>cold</li></ol>
шийтта|šītta	<i>num</i><br><ol><li>twelve</li></ol>
шинара|šinara	<i>noun</i><br><ol><li>Tuesday</li></ol>
шиша|šiša	<i>noun</i><br><ol><li>glass</li><li>bottle</li></ol>
шиъ|šiʾ	<i>num</i><br><ol><li>two</li></ol>
шо|šo	<i>noun</i><br><ol><li>year</li></ol>
шовзткъа|šowzṭq̇a	<i>num</i><br><ol><li>forty</li></ol>
шовзткъе итт|šowzṭq̇e itt	<i>num</i><br><ol><li>fifty</li></ol>
шок|šok	<i>noun</i><br><ol><li>whistle</li></ol>
шопар|šopar	<i>noun</i><br><ol><li>chauffeur</li></ol>
шоршал|сорсал|шаршул|sorsal|šoršal|šaršul	<i>noun</i><br><ol><li>thrush</li></ol>
шот|šot|шоьташ|шоьто	<i>noun</i><br><ol><li>Saturday</li></ol>
шу|şu	<i>pron</i><br><ol><li>second-person plural pronoun: you</li></ol>
шура|šura	<i>noun</i><br><ol><li>milk</li></ol>
шуьйра|šüjra	<i>adj</i><br><ol><li>wide</li></ol>
щ|Щ|šč	<i>character</i><br><ol><li>The fiftieth letter of the Chechen alphabet, written in the Cyrillic script.</li></ol>
ъ|Ъ	<i>character</i><br><ol><li>The fifty-first letter of the Chechen alphabet, written in the Cyrillic script.</li></ol>
ы|y|Ы	<i>character</i><br><ol><li>The fifty-second letter of the Chechen alphabet, written in the Cyrillic script.</li></ol>
ь|Ь	<i>character</i><br><ol><li>The fifty-third letter of the Chechen alphabet, written in the Cyrillic script.</li></ol>
э|Э|e	<i>character</i><br><ol><li>The fifty-fourth letter of the Chechen alphabet, written in the Cyrillic script.</li></ol>
эвл|ewl	<i>noun</i><br><ol><li>village</li></ol>
эвла|eula	<i>noun</i><br><ol><li>village</li></ol>
эзар|ezar	<i>num</i><br><ol><li>thousand</li></ol>
эла|ēla|э̄ла	<i>noun</i><br><ol><li>prince</li><li>queen bee</li></ol>
эладит|eladit|эладитанаш	<i>noun</i><br><ol><li>gossip (idle talk)</li><li>rumor</li></ol>
эса|esa	<i>noun</i><br><ol><li>calf</li></ol>
эскар|eskar	<i>noun</i><br><ol><li>army</li></ol>
этмаьӏиг|etmäʿig	<i>noun</i><br><ol><li>snail</li></ol>
эхь|eḥ	<i>noun</i><br><ol><li>shame</li></ol>
эца|ētsa	<i>noun</i><br><ol><li>to get</li></ol>
эчиг|ečig	<i>noun</i><br><ol><li>iron (the metal)</li></ol>
ю|Ю|ju	<i>character</i><br><ol><li>The fifty-fifth letter of the Chechen alphabet, written in the Cyrillic script.</li></ol>
юкъ|juq̇	<i>noun</i><br><ol><li>ash</li><li>partition</li><li>interval</li><li>center</li><li>waist</li></ol>
юрист|jurist	<i>noun</i><br><ol><li>lawyer</li><li>advocate</li></ol>
юрт|ярташ|jurt|юрто̄	<i>noun</i><br><ol><li>village</li><li>town</li></ol>
юургйийриг|yurgyiyrig	<i>noun</i><br><ol><li>chef</li><li>a cook as a profession</li><li>anyone who is cooking something</li></ol>
юь|Юь|jü	<i>character</i><br><ol><li>The fifty-sixth letter of the Chechen alphabet, written in the Cyrillic script.</li></ol>
юьхь|yüh’	<i>noun</i><br><ol><li>face</li></ol>
я|ja|Я	<i>character</i><br><ol><li>The fifty-seventh letter of the Chechen alphabet, written in the Cyrillic script.</li></ol>
яа хӏума|jaa huma	<i>noun</i><br><ol><li>food</li></ol>
яздар|jazdar	<i>noun</i><br><ol><li>writing</li></ol>
яздархо|yazdarho	<i>noun</i><br><ol><li>writer; someone who writes</li><li>author</li></ol>
ялсамани|jalsamani	<i>noun</i><br><ol><li>paradise</li><li>heaven</li></ol>
ялта|yalta	<i>noun</i><br><ol><li>crop, harvest</li><li>bread</li></ol>
ялхийтта|jalχītta	<i>num</i><br><ol><li>sixteen</li></ol>
яь|jä|Яь	<i>character</i><br><ol><li>The fifty-eighth letter of the Chechen alphabet, written in the Cyrillic script.</li></ol>
яьшка|jäška	<i>noun</i><br><ol><li>box</li><li>drawer</li></ol>
ё|Ё|ë	<i>character</i><br><ol><li>The ninth letter of the Chechen alphabet, written in the Cyrillic script.</li></ol>
Ӏожалла|joƶalla	<i>noun</i><br><ol><li>death</li></ol>
ӏ|Ӏ|ʿ	<i>character</i><br><ol><li>The fifty-ninth letter of the Chechen alphabet, written in the Cyrillic script.</li></ol>
ӏа|ʿa	<i>noun</i><br><ol><li>winter</li></ol>
ӏадат|ʿadat	<i>noun</i><br><ol><li>custom</li></ol>
ӏаж|ʿaž	<i>noun</i><br><ol><li>apple</li></ol>
ӏайг|ʿajg	<i>noun</i><br><ol><li>spoon</li></ol>
ӏам|ʿam	<i>noun</i><br><ol><li>lake</li></ol>
ӏаса|ʿasa	<i>noun</i><br><ol><li>a stick</li></ol>
ӏахар|ʿaχar	<i>noun</i><br><ol><li>lamb</li></ol>
ӏаьржа|ʿärža	<i>adj</i><br><ol><li>black</li><li>dark</li></ol>
ӏилма|ʿilma	<i>noun</i><br><ol><li>science</li></ol>
ӏилманча|ʿilmanča	<i>noun</i><br><ol><li>scientist</li></ol>
ӏуьйре|ʿüjre	<i>noun</i><br><ol><li>morning</li></ol>
ӏуьрг|ʿürg	<i>noun</i><br><ol><li>hole</li></ol>
ڨ|q̇af	<i>character</i><br><ol><li>The twenty-eighth letter of the Chechen alphabet in the Arabic script.</li></ol>
ẋ|хь|ḥ|Хь|Ẋ	<i>character</i><br><ol><li>The fifteenth letter of the Chechen alphabet, written in the Latin script.</li></ol>
Ꞑ|ꞑ	<i>character</i><br><ol><li>The twenty-third letter of the Chechen alphabet, written in the Latin script.</li></ol>
ꞑ|Ꞑ	<i>character</i><br><ol><li>The twenty-third letter of the Chechen alphabet, written in the Latin script.</li></ol>
