A|a	<i>character</i><br><ol><li>The first letter of the Choctaw alphabet, written in the Latin script.</li></ol>
Chalakki|Chalahki	<i>name</i><br><ol><li>Cherokee</li></ol>
Chalvkki|Chalʋkki	<i>name</i><br><ol><li>Cherokee</li></ol>
Chihowa|Chihōwahakhī|Chihōwahakakō|Chihōwahako|Chihōwa|Chihōwahakkia|Chihōwaho|Chihōwahakō|Chihōwahak|Chihōwama|Chihōwahato|Chihōwakia|Chihōwahakōsh|Chihōwahōk|Chihōwaha|Chihōwah|Chihōwaba|Chihōwahōsh|Chihōwapa|Chihōwahano|Chihōwahō|Chihōwahat	<i>name</i><br><ol><li>God</li></ol>
Chiisas|Chisạs	<i>name</i><br><ol><li>Jesus</li></ol>
Chiisas Kilaist imanumpeshi	<i>name</i><br><ol><li>an apostle of Jesus Christ</li></ol>
Chikasha	<i>noun</i><br><ol><li>Chickasaw</li></ol>
Chisvs|Chisʋs	<i>name</i><br><ol><li>Jesus</li></ol>
Chukfi haksobish falaya	<i>noun</i><br><ol><li>jackrabbit</li></ol>
Fibuali	<i>name</i><br><ol><li>February</li></ol>
Filanchi	<i>noun</i><br><ol><li>French</li></ol><br><i>adj</i><br><ol><li>French</li></ol>
Issa|Filvmmi	<i>noun</i><br><ol><li>to leave something</li></ol>
Mach	<i>noun</i><br><ol><li>March</li></ol>
Macha	<i>name</i><br><ol><li>Alternative letter-case form of mach</li></ol>
Mashkoki|Mashkōki	<i>name</i><br><ol><li>Creek, Seminole</li></ol>
Mislaim	<i>name</i><br><ol><li>(biblical) Egypt</li></ol>
Muskoki	<i>name</i><br><ol><li>Muskogee</li></ol>
Sesa	<i>name</i><br><ol><li>Caesar</li></ol>
Simunoli	<i>noun</i><br><ol><li>Seminole</li></ol>
Tisimba	<i>noun</i><br><ol><li>December</li></ol>
VPA	<i>noun</i><br><ol><li>to eat</li></ol>
a	<i>conj</i><br><ol><li>yes</li></ol>
aayokla'	<i>noun</i><br><ol><li>academic alternative form of ayokla</li></ol>
abeka aiasha	<i>noun</i><br><ol><li>hospital</li></ol>
abeka apesuchi	<i>noun</i><br><ol><li>nurse</li></ol>
abi	<i>noun</i><br><ol><li>killer, murderer</li><li>killing, slaughter</li></ol><br><i>verb</i><br><ol><li>to kill, to murder</li><li>to be sick or infected (usually with a skin disease)</li></ol>
achaffa	<i>num</i><br><ol><li>one</li></ol><br><i>noun</i><br><ol><li>oneness, unity</li><li>unit</li></ol><br><i>adj</i><br><ol><li>other, another</li><li>individual, particular, certain</li><li>sole, only</li><li>undivided</li></ol><br><i>verb</i><br><ol><li>to be one</li><li>to unify</li><li>to do one</li></ol>
achukma|hochukma	<i>noun</i><br><ol><li>goodness, good</li><li>excellency, excellence</li><li>purity. pureness</li><li>fairness</li><li>safety, soundness. peace</li></ol><br><i>adj</i><br><ol><li>good</li><li>excellent, nice</li><li>benevolent, kind, gracious</li><li>sound, wholesome, healthful</li><li>handsome</li><li>delightful</li></ol><br><i>verb</i><br><ol><li>to be good, to be excellent, to be easy</li><li>(transitive) to like, to love, to delight</li><li>(intransitive) to feel well, to do well</li><li>(passive) improved, bettered, made good</li></ol><br><i>adv</i><br><ol><li>finely, soundly</li></ol>
afisa	<i>noun</i><br><ol><li>officer</li></ol>
ahe holbi	<i>noun</i><br><ol><li>a boiled potato</li><li>a steamed potato</li></ol>
ahe ibish	<i>noun</i><br><ol><li>a potato hill, a hill of potatoes</li></ol>
aholhpokonna	<i>verb</i><br><ol><li>to dream</li></ol>
aiimpa chukka	<i>noun</i><br><ol><li>resteraunt</li></ol>
aiitvnaha	<i>noun</i><br><ol><li>church</li></ol>
akaka|akakama|akakayakkia|akakayak|akakayo|akakaba|pimakaka|akakayō|akanka|hachimakaka|akakakia|imakaka|amakaka|akakayōsh|akakayano|akakayakō|akakayato|akakayōk|hapimakaka|akakapa|akakayako|chimakaka|akakayakōsh|akakaya|akakayakakō|akakayat	<i>noun</i><br><ol><li>chicken</li><li>poultry</li></ol>
akaka nakni|akak nakni	<i>noun</i><br><ol><li>rooster</li></ol>
akaka nipi|akaka nipi alienable	<i>noun</i><br><ol><li>chicken meat</li><li>poultry</li></ol>
akaka tik	<i>noun</i><br><ol><li>hen</li></ol>
akakoshi|akakoshiya|akakoshipa|amakakoshi|akakoshiba|akank ushi|akakoshiyat|imakakoshi|akakoshiyato|akakoshiyakōsh|akankushi|akakoshiyak|akakoshiyano|pimakakoshi|akakoshiyo|akakoshikia|chimakakoshi|hachimakakoshi|akakoshiyakō|akakoshiyōsh|akakoshiyō|akakoshiyōk|akakoshiyako|akakoshima|hapimakakoshi|akakoshiyakkia|akakoshiyakakō	<i>noun</i><br><ol><li>egg</li><li>chick</li></ol>
akakoshi holba	<i>noun</i><br><ol><li>oval</li></ol>
akakoshi lakna	<i>noun</i><br><ol><li>egg yolk</li></ol>
akanka nipi|akaka nipi|akaka nipi alienable	<i>noun</i><br><ol><li>traditional alternative of akaka nipi</li></ol>
akchalhpi	<i>noun</i><br><ol><li>bark (of a tree)</li></ol>
akkashtala	<i>noun</i><br><ol><li>root</li></ol>
alhpoa	<i>noun</i><br><ol><li>domesticated animal</li></ol>
alhpowa	<i>noun</i><br><ol><li>domesticated animal</li></ol>
alhtoka	<i>verb</i><br><ol><li>to choose</li></ol>
alikchi'	<i>noun</i><br><ol><li>doctor</li></ol>
alla	<i>noun</i><br><ol><li>child</li></ol>
ammi|hapimmi|pishno|pimmi|ammi|ilāp|chimmi|ilap|chishno|transnumeral possessive|hapishno|yamma|hachishno|ano|hachimmi|sashno	<i>pron</i><br><ol><li>(now chiefly Oklahoma Choctaw, archaic in Mississippi Choctaw) mine</li></ol>
ani|hapiani|piani|siani|chiani|hachiani	<i>noun</i><br><ol><li>berry</li><li>nut</li><li>fruit</li></ol>
ano|hapimmi|pishno|pimmi|ammi|ilāp|chimmi|ilap|chishno|transnumeral possessive|hapishno|yamma|hachishno|ano|hachimmi|sashno	<i>pron</i><br><ol><li>(emphatic) I, me</li><li>(Mississippi) mine</li></ol>
anumpa|annumpa	<i>noun</i><br><ol><li>something spoken</li><li>language, talk, speech</li><li>word, sentence, statement, saying</li><li>communication, message, lecture, news</li><li>law</li></ol><br><i>adj</i><br><ol><li>oral, verbal</li></ol><br><i>adv</i><br><ol><li>orally, verbally</li></ol>
apesuchi	<i>noun</i><br><ol><li>manager</li><li>caregiver</li></ol>
asita|asiitá'|asīta	<i>noun</i><br><ol><li>rope</li></ol>
atia|atiá'	<i>noun</i><br><ol><li>seed</li></ol>
atikkonofa	<i>adj</i><br><ol><li>near</li><li>narrow</li></ol><br><i>verb</i><br><ol><li>to be near</li><li>to be narrow</li></ol>
atta	<i>verb</i><br><ol><li>to live</li></ol>
awah achvffa	<i>noun</i><br><ol><li>eleven</li></ol>
awah tuklo	<i>noun</i><br><ol><li>twelve</li></ol>
ayochololi|piayocholōli|hachiayocholōli|ayocholōli|hapiayocholōli|siayocholōli|chiayocholōli|ayocholóoli'	<i>noun</i><br><ol><li>descendant</li></ol>
ayokla|piāyokla|hachimāyokla|chimāyokla|imāyokla|siāyokla|hachiāyokla|hapiāyokla|pimāyokla|chiāyokla|hapimāyokla|āyokla|amāyokla	<i>noun</i><br><ol><li>kin, relation</li></ol>
ačǎfa	<i>num</i><br><ol><li>one</li></ol>
ałpoa	<i>noun</i><br><ol><li>Mississippian alternative of alhpoa</li></ol>
baptismo	<i>noun</i><br><ol><li>baptism</li></ol>
baptismochi	<i>verb</i><br><ol><li>to baptize</li></ol>
bashli	<i>verb</i><br><ol><li>to cut</li></ol>
bila	<i>noun</i><br><ol><li>fat, grease, oil</li></ol><br><i>verb</i><br><ol><li>to thaw, to melt</li></ol>
bissa	<i>noun</i><br><ol><li>blueberry</li></ol>
bok|bōkak|bōkō|hapibōk|bōkakakō|bōk|bōkkia|bōkpa|bōkakōsh|bōkako|bayuk|bōkakkia|bōkakō|ibōk|bōkato|chibōk|hachibōk|bōka|bōkba|bōkakhī|bōkōsh|bōkōk|bōkat|abōk|bōkma|pibōk|bōkano|bōko	<i>noun</i><br><ol><li>creek, stream</li><li>river</li></ol>
bokushi	<i>noun</i><br><ol><li>creek</li></ol>
chahta|chahtá'	<i>noun</i><br><ol><li>Choctaw</li></ol><br><i>adj</i><br><ol><li>Choctaw</li></ol>
chahta anopa	<i>noun</i><br><ol><li>Choctaw language</li></ol>
chahta yakni	<i>noun</i><br><ol><li>Choctaw Nation</li></ol>
chahta'	<i>noun</i><br><ol><li>academic alternative of chahta</li></ol>
chakkali|chakkāli	<i>num</i><br><ol><li>nine</li></ol>
chanaha folota achafa	<i>noun</i><br><ol><li>a square</li></ol>
chanal	<i>noun</i><br><ol><li>a general</li></ol>
chimmi|hapimmi|pishno|pimmi|ammi|ilāp|chimmi|ilap|chishno|transnumeral possessive|hapishno|yamma|hachishno|ano|hachimmi|sashno	<i>pron</i><br><ol><li>(now chiefly Oklahoma Choctaw, archaic in Mississippi Choctaw) thine, yours</li></ol>
chinisa	<i>noun</i><br><ol><li>chipmunk</li><li>a small ground squirrel</li></ol><br><i>adj</i><br><ol><li>brindled, striped</li></ol><br><i>verb</i><br><ol><li>to be brindled or striped</li></ol>
chipota	<i>adj</i><br><ol><li>small</li></ol>
chishno|hapimmi|pishno|pimmi|ammi|ilāp|chimmi|ilap|chishno|transnumeral possessive|hapishno|yamma|hachishno|ano|hachimmi|sashno	<i>pron</i><br><ol><li>you, yours, thou, thee, thine</li></ol>
chisimoha	<i>verb</i><br><ol><li>to yawn</li></ol>
chito|hochito	<i>noun</i><br><ol><li>size, largeness</li></ol><br><i>verb</i><br><ol><li>be large</li></ol><br><i>adj</i><br><ol><li>big, large</li></ol><br><i>adv</i><br><ol><li>largely</li></ol>
chokash|ichokash|chihchokash|chichokash|achokash|hachichokash|hapichokash|pihchokash|pichokash|hachihchokash|hapihchokash|sahchokash	<i>noun</i><br><ol><li>heart</li></ol>
chokfi|hachichokfi|chokfihakkia|chokfihakhī|chokfihako|chokfiba|chokfihak|chokfiha|chokfihakakō|ichokfi|chokfihōsh|chokfihano|chokfihakōsh|chokfiho|pichokfi|chokfihato|chokfima|chókfih|chokfihat|achokfi|hapichokfi|chokfihō|chokfikia|chokfihōk|chokfipa|chokfihakō|chichokfi|chokfih	<i>noun</i><br><ol><li>rabbit</li><li>sheep</li></ol>
chola|cholá'	<i>noun</i><br><ol><li>fox</li></ol>
chonkvsh	<i>noun</i><br><ol><li>traditional alternative of chokash</li></ol>
chopa	<i>verb</i><br><ol><li>to buy</li></ol>
choshshak|sachoshshak|hachichoshshak|chichoshshak|hapichoshshak|pichoshshak|choshshák	<i>noun</i><br><ol><li>nape, back of the neck</li></ol>
chuała	<i>noun</i><br><ol><li>cedar</li></ol>
chufak	<i>noun</i><br><ol><li>nail</li><li>spike</li><li>awl</li><li>fork</li></ol>
chufak ushi	<i>noun</i><br><ol><li>pin</li><li>tack</li><li>small nail</li><li>needle</li></ol>
chufki hishi almo	<i>noun</i><br><ol><li>a fleece</li></ol>
chuka	<i>noun</i><br><ol><li>home, house</li><li>building</li><li>den, nest</li></ol><br><i>verb</i><br><ol><li>to house</li><li>to live</li></ol>
chukfahlpowa nakni	<i>noun</i><br><ol><li>a ram</li><li>a buck</li></ol>
chukfalhpoba	<i>noun</i><br><ol><li>domesticated rabbit</li></ol>
chukfi	<i>noun</i><br><ol><li>rabbit</li><li>sheep</li></ol>
chukfi aiasha	<i>noun</i><br><ol><li>sheep herd</li></ol>
chukfi hakshup	<i>noun</i><br><ol><li>sheep skin</li></ol>
chukfi hishi	<i>noun</i><br><ol><li>cotton</li></ol>
chukfi hishi nan tanna aiskiachi	<i>noun</i><br><ol><li>clothier</li></ol>
chukfi hishi shana	<i>noun</i><br><ol><li>woolen yarn</li></ol>
chukfi isht abeka	<i>noun</i><br><ol><li>the rot, a disease for sheep.</li></ol>
chukfi luma	<i>noun</i><br><ol><li>a cottontail rabbit</li></ol>
chukfi nipi	<i>noun</i><br><ol><li>rabbit meat</li></ol>
chukfi nishkin	<i>noun</i><br><ol><li>an ulcer, comes from the foot or the leg</li></ol>
chukfi oka aiasha	<i>noun</i><br><ol><li>a swamp rabbit</li></ol>
chukfi pattakata nakni	<i>noun</i><br><ol><li>the male of the hare</li></ol>
chukfi pattakita	<i>noun</i><br><ol><li>a hare</li></ol>
chukfi yoba	<i>noun</i><br><ol><li>a cramp in the hand</li></ol>
chukfikoa	<i>noun</i><br><ol><li>hiccup</li></ol>
chukka	<i>noun</i><br><ol><li>house</li></ol>
chuktipelo	<i>noun</i><br><ol><li>the northeast</li></ol>
chula	<i>noun</i><br><ol><li>fox</li></ol>
chvnvl|chʋnʋl	<i>noun</i><br><ol><li>(military) general</li></ol>
falaya|falāya	<i>adj</i><br><ol><li>long</li></ol>
fani	<i>noun</i><br><ol><li>squirrel</li></ol>
fani imalakosi|fani imālakosi	<i>noun</i><br><ol><li>chameleon</li></ol>
fichik	<i>noun</i><br><ol><li>a star</li><li>a planet</li></ol>
fichik hela	<i>noun</i><br><ol><li>shooting star</li><li>meteor</li></ol>
fichik lukoli	<i>noun</i><br><ol><li>constellation</li></ol>
fichik pohluli	<i>noun</i><br><ol><li>meteor shower</li></ol>
foe	<i>noun</i><br><ol><li>bee</li></ol>
fohi	<i>noun</i><br><ol><li>honey</li></ol>
foni|chifoni|pihfoni|sahfoni|hapifoni|hapihfoni|chihfoni|hachifoni|pifoni|ifoni|afoni|hachihfoni	<i>noun</i><br><ol><li>bone</li><li>stone of a fruit</li><li>shell of a nut</li></ol>
fowi	<i>noun</i><br><ol><li>honey</li><li>bee</li></ol>
fvni|fʋni	<i>noun</i><br><ol><li>squirrel</li></ol>
fvni hasimbish holba	<i>noun</i><br><ol><li>kind of daisy</li></ol>
fvni imalakusi	<i>noun</i><br><ol><li>chameleon</li></ol>
fvni lusa	<i>noun</i><br><ol><li>black squirrel</li></ol>
fvni okchako	<i>noun</i><br><ol><li>gray squirrel</li></ol>
fvni shvpha	<i>noun</i><br><ol><li>mistletoe</li></ol>
fvnikoyo	<i>noun</i><br><ol><li>sycamore</li></ol>
fvnushi	<i>noun</i><br><ol><li>little squirrel</li></ol>
fạla	<i>noun</i><br><ol><li>crow</li></ol>
hachimmi|hapimmi|pishno|pimmi|ammi|ilāp|chimmi|ilap|chishno|transnumeral possessive|hapishno|yamma|hachishno|ano|hachimmi|sashno	<i>pron</i><br><ol><li>(now chiefly Oklahoma Choctaw, archaic in Mississippi Choctaw) yours, you all's, y'all's</li></ol>
hachishno|hapimmi|pishno|pimmi|ammi|ilāp|chimmi|ilap|chishno|transnumeral possessive|hapishno|yamma|hachishno|ano|hachimmi|sashno	<i>pron</i><br><ol><li>(emphatic) you (all), ye, y'all</li><li>(Mississippi) yours, y'all's</li></ol>
hakchin|chihakchin|sahakchin|hakchín|pihakchin|hachihakchin|hapihakchin	<i>noun</i><br><ol><li>penis</li></ol>
haklo	<i>noun</i><br><ol><li>to hear</li></ol>
haknip|sahaknip|hapihaknip|hachihaknip|chihaknip|pihaknip	<i>noun</i><br><ol><li>body</li><li>trunk, thorax</li><li>chest</li></ol>
hakshish|pihakshish|hachihakshish|hapihakshish|chihakshish|hakshísh|sahakshish	<i>noun</i><br><ol><li>vein, artery</li><li>sinews</li><li>tendon</li></ol>
hakshop|hákshop	<i>noun</i><br><ol><li>skin</li></ol>
haksobish|hachihaksobish|haksobísh|pihaksobish|chihaksobish|sahaksobish|hapihaksobish	<i>noun</i><br><ol><li>ear</li></ol>
halito	<i>intj</i><br><ol><li>hello</li></ol>
haloppa	<i>noun</i><br><ol><li>sharpness, keenness</li><li>edge</li><li>point</li><li>chisel</li></ol><br><i>adj</i><br><ol><li>sharp, keen</li><li>piked</li><li>poignant</li><li>rough, rugged</li></ol>
hannali|hannāli	<i>num</i><br><ol><li>six</li></ol>
hanta	<i>noun</i><br><ol><li>white</li></ol>
hapi|hạpi	<i>noun</i><br><ol><li>salt</li></ol><br><i>verb</i><br><ol><li>be salty</li></ol><br><i>adj</i><br><ol><li>salty</li></ol>
hapimmi|hapimmi|pishno|pimmi|ammi|ilāp|chimmi|ilap|chishno|transnumeral possessive|hapishno|yamma|hachishno|ano|hachimmi|sashno	<i>pron</i><br><ol><li>(now chiefly Oklahoma Choctaw, archaic in Mississippi Choctaw) ours, us many's</li></ol>
hapishno|hapimmi|pishno|pimmi|ammi|ilāp|chimmi|ilap|chishno|transnumeral possessive|hapishno|yamma|hachishno|ano|hachimmi|sashno	<i>pron</i><br><ol><li>we, ours</li></ol>
hapollo|hachihapollo|chihapollo|hapihapollo|sahapollo|pihapollo|hapóllo'	<i>noun</i><br><ol><li>bottocks</li></ol>
hashi|hạshi	<i>noun</i><br><ol><li>sun</li><li>luminary, light</li><li>sunflower</li><li>moon</li><li>lunar month, month</li></ol>
hashshok	<i>noun</i><br><ol><li>grass</li></ol>
hashtola	<i>noun</i><br><ol><li>winter</li></ol>
hasi|sahasi|chihasi|hachihasi|pihasi|hapihasi	<i>noun</i><br><ol><li>vagina</li></ol>
hatabish|hapihatabish|chihatabish|pihatabish|sahatabish|hachihatabish	<i>noun</i><br><ol><li>navel</li></ol>
hatak	<i>noun</i><br><ol><li>man</li><li>person</li><li>husband</li></ol>
hattak	<i>noun</i><br><ol><li>man</li><li>person, human</li></ol>
hattak upi homma	<i>noun</i><br><ol><li>Native American, or Indian</li></ol>
hattip|pihattip|hachihattip|chihattip|hattíp|hapihattip|sahattip	<i>noun</i><br><ol><li>thigh</li><li>small of the back</li><li>hindquarters, rump</li></ol>
himmita|himmitá'	<i>noun</i><br><ol><li>flower</li></ol>
himona	<i>adj</i><br><ol><li>new</li></ol>
hishi|híshi'|sahishi|pihishi|hachihishi|hapihishi|chihishi	<i>noun</i><br><ol><li>body hair</li><li>feather</li><li>leaf</li></ol>
hitokchobi	<i>noun</i><br><ol><li>ashes</li></ol>
hobak	<i>noun</i><br><ol><li>eunuch, castrated person or animal</li><li>coward; an insult</li></ol>
hofati	<i>verb</i><br><ol><li>to grow</li></ol>
hohchafo	<i>adj</i><br><ol><li>hungry</li></ol>
hohchifo|hapihohchifo|hachihohchifo|pihohchifo|chihohchifo|sahohchifo	<i>noun</i><br><ol><li>name</li></ol>
hokopa	<i>verb</i><br><ol><li>to steal</li></ol>
holisso pisa	<i>noun</i><br><ol><li>student</li><li>learner</li></ol>
homa	<i>adj</i><br><ol><li>red</li></ol>
hoponi|hopōni	<i>noun</i><br><ol><li>a cook</li></ol><br><i>verb</i><br><ol><li>to cook</li></ol>
hoshi	<i>noun</i><br><ol><li>bird, fowl</li></ol>
hotilhko	<i>verb</i><br><ol><li>to cough</li></ol>
hotonlvkna	<i>noun</i><br><ol><li>brown</li></ol>
howa	<i>verb</i><br><ol><li>to smell</li></ol>
humma	<i>noun</i><br><ol><li>red</li></ol>
hushi	<i>noun</i><br><ol><li>sparrow</li></ol>
hvpi|hʋpi	<i>noun</i><br><ol><li>salt</li></ol><br><i>verb</i><br><ol><li>be salty</li></ol><br><i>adj</i><br><ol><li>salty</li></ol>
hvshi|hʋshi	<i>noun</i><br><ol><li>sun</li><li>luminary, light</li><li>sunflower</li><li>moon</li><li>lunar month, month</li></ol>
hvshi aiokatula	<i>noun</i><br><ol><li>west</li></ol>
hvshi akochaka	<i>noun</i><br><ol><li>east</li></ol>
hvshi kanvlli	<i>noun</i><br><ol><li>hour</li></ol>
iakaya	<i>noun</i><br><ol><li>follower</li></ol>
ibbak|sabbak|hachibbak|hapibbak|pibbak|chibbak	<i>noun</i><br><ol><li>hand</li><li>forearm</li><li>paw</li></ol>
ibbak abeha	<i>noun</i><br><ol><li>gloves</li></ol>
ibbak alhto	<i>noun</i><br><ol><li>a handful (of something)</li></ol>
ibbak aska	<i>noun</i><br><ol><li>wrist</li></ol>
ibbak chush	<i>noun</i><br><ol><li>fingernail</li></ol>
ibbak ishki	<i>noun</i><br><ol><li>thumb</li></ol>
ibbak isht impaka	<i>noun</i><br><ol><li>right hand</li></ol>
ibbakoshi|hapibbakoshi|chibbakoshi|hachibbakoshi|ibbakóshi|sabbakoshi|pibbakoshi	<i>noun</i><br><ol><li>finger</li></ol>
ibilhkan|ibílhkan|sabilhkan|pibilhkan|chibilhkan|hapibilhkan|hachibilhkan	<i>noun</i><br><ol><li>nasal mucus, snot</li></ol>
ibishakni|pibīshakni|hapibīshakni|ibiishákni'|sabīshakni|ibīshakni|chibīshakni|hachibīshakni	<i>noun</i><br><ol><li>nose</li></ol>
ichapa|hapichāpa|pichāpa|hachichāpa|ichaapá'|chichāpa|ichāpa|sachāpa	<i>noun</i><br><ol><li>partner, mate</li></ol>
iffoka	<i>noun</i><br><ol><li>abdomen, belly, stomach</li><li>waist</li></ol>
iffoka'	<i>noun</i><br><ol><li>abdomen, belly</li><li>waist</li></ol>
ikhana	<i>verb</i><br><ol><li>to know</li></ol>
iki|hachiki|aki|chiki|hapiki|piki	<i>noun</i><br><ol><li>(obligatory possessive) father, paternal uncle</li></ol>
ikkishi|hachikkishi|sakkishi|ikkishí'|hapikkishi|chikkishi|pikkishi	<i>noun</i><br><ol><li>chest, thorax, breast</li></ol>
ikkola|hapikkola|chikkola|sakkola|hachikkola|pikkola	<i>noun</i><br><ol><li>neck</li></ol>
iksa	<i>noun</i><br><ol><li>clan</li></ol>
ilap|hapimmi|pishno|pimmi|ammi|ilāp|chimmi|ilap|chishno|hapishno|yamma|hachishno|transnumeral possessive|hachimmi|ano|sashno	<i>pron</i><br><ol><li>his, hers, its, theirs</li></ol><br><i>adv</i><br><ol><li>self</li><li>alone</li></ol>
ilappa	<i>pron</i><br><ol><li>(proximal demonstative) this, these</li></ol><br><i>det</i><br><ol><li>this, these</li></ol><br><i>adv</i><br><ol><li>here</li></ol>
illi	<i>verb</i><br><ol><li>to die</li></ol>
imalakosi|amālakosi|imālakosi|pimālakosi|hachimālakosi|chimālakosi|hapimālakosi	<i>noun</i><br><ol><li>brother-in-law (wife's brother)</li></ol>
ippok|hachippok|chippok|sappok|hapippok|ippók|pippok	<i>noun</i><br><ol><li>grandchild</li></ol>
ishki|hashki|pishki|sashki|hvpishki|hachishki|svshki|hapishki|chishke|hvshki|chishki	<i>noun</i><br><ol><li>(obligatory possessive) mother, maternal aunt</li></ol>
ishkish	<i>noun</i><br><ol><li>buttocks</li><li>anus</li></ol>
isito|isito yʋno|isito yakako|ʋm isito|isito yakosh|hʋpim isito|isito yosh|im isito|isito (yak)kia|isito yako|isito ya|isito ba|isito yak|isito yʋt|hʋchim isito|isito ma|isito yok|chim isito|isito yo|isito yʋto|isito pa|pim isito	<i>noun</i><br><ol><li>pumpkin</li><li>squash</li><li>pompion</li></ol>
iskona	<i>noun</i><br><ol><li>guts, bowels, intestines</li><li>core, pith</li></ol>
iskʋli|iskali	<i>noun</i><br><ol><li>money</li></ol>
iso tek	<i>noun</i><br><ol><li>daughter</li></ol>
issap	<i>noun</i><br><ol><li>louse, lice</li></ol>
issi|issiyōsh|hʋchim issi|issiyōk|issiyak|issiyako|issima|issiyano|issi yosh|im issi|issiyat|issiyato|hʋpim issi|issiya|amissi|chim issi|pimissi|issi yʋto|hapimissi|issi ma|pim issi|issi yʋno|issi ba|imissi|hachimissi|issi ushi|issiyakakō|issi yak|issiyakō|issikia|issiyō|issiyakōsh|issiyakkia|issiba|issushi|issi yo|issi ya|issi pa|issoshi|ʋm issi|chimissi|issi yako|issi (yak)kia|issi yok|issi yakako|issipa|issi yakosh|issiyo|issi yʋt	<i>noun</i><br><ol><li>deer</li></ol>
issi kosoma|issi kosōmayako|issi kosōma|issi kosōmayat|issi kosōmayōsh|issi kosōmaya|issi kosōmayakō|issi kosōmāba|issi kosōmāma|issi kosōmao|issi kosōmayak|issi kosōmayakakō|issi kosōma'at|issi kosōmāpa|issi kosōmayakkia|issi kosōmāt|issi' kosṓma'|issi kosōmayato|issi kosōmayakōsh|issi kosōmayōk|issi kosōmayō|issi kosōmayano|issi kosōmākia|issi kosōmayakhī	<i>noun</i><br><ol><li>goat</li></ol>
issish|sassish|hachissish|chissish|hachimissish|hapissish|imissish|chimissish|hapimissish|pissish|amissish|pimissish	<i>noun</i><br><ol><li>blood</li></ol>
issito|issitoba|hachimissito|issitoyōk|issito ba|im issito|issitokia|issitoyakōsh|hapimissito|issitoma|imissito|issitoyo|issito pa|issito yako|issitoyako|issito yakosh|ʋm issito|issitoyakō|issitoyakakō|issito yʋno|issito yosh|issitoyakkia|issitoya|issitoyano|chimissito|issito ya|issitoyōsh|issito yʋt|issitoyat|issito yak|issitoyato|chim issito|issito yakako|issito ma|issito (yak)kia|issito yok|pimissito|hʋchim issito|issitoyō|issitopa|issito yʋto|hʋpim issito|issitoyak|issito yo|pim issito|amissito	<i>noun</i><br><ol><li>pumpkin</li><li>squash</li><li>pompion</li></ol>
issito holba	<i>adj</i><br><ol><li>squash-like</li></ol>
issitushi	<i>noun</i><br><ol><li>pumpkin</li></ol>
isso|pisso|hapisso|issó'|chisso|sasso|hachisso	<i>noun</i><br><ol><li>(archaic) son</li></ol><br><i>verb</i><br><ol><li>to hit, to strike, to beat, to bump</li></ol>
issoba|issóba'	<i>noun</i><br><ol><li>horse</li></ol>
issolash	<i>noun</i><br><ol><li>tongue</li></ol>
issuba basoa	<i>noun</i><br><ol><li>zebra</li></ol>
itakha	<i>noun</i><br><ol><li>mouth</li></ol>
iti	<i>noun</i><br><ol><li>tree</li><li>wood</li></ol>
itialbi	<i>noun</i><br><ol><li>lips, mouth</li></ol>
itibapisa	<i>noun</i><br><ol><li>classmate</li></ol>
itibapishi	<i>noun</i><br><ol><li>sibling</li><li>friend</li><li>one who was nursed together with (someone)</li></ol>
itibapishili	<i>noun</i><br><ol><li>my sibling (or friend) (literally "we suckled together")</li></ol>
itibbi	<i>verb</i><br><ol><li>to fight</li></ol>
itikana|spelling	<i>noun</i><br><ol><li>friends</li><li>peace</li></ol><br><i>adj</i><br><ol><li>friendly, kind-hearted</li><li>happy, harmonious</li></ol>
itisukpi	<i>noun</i><br><ol><li>cheek</li></ol>
ittahchi	<i>noun</i><br><ol><li>shoulder</li></ol>
itti'	<i>noun</i><br><ol><li>tree</li><li>wood, timber</li></ol>
ittibbi	<i>verb</i><br><ol><li>fight</li></ol>
iyi	<i>noun</i><br><ol><li>foot</li></ol>
iyvpi	<i>noun</i><br><ol><li>leg</li></ol>
iyyi	<i>noun</i><br><ol><li>foot, leg</li></ol>
iyyop	<i>noun</i><br><ol><li>daughter's husband (son-in-law)</li><li>niece's husband</li></ol>
kaa	<i>noun</i><br><ol><li>car</li></ol>
kafi	<i>noun</i><br><ol><li>sassafras</li><li>coffee</li></ol>
kallo	<i>noun</i><br><ol><li>strength, nerve</li><li>hardness</li></ol><br><i>adj</i><br><ol><li>strong, sturdy</li><li>hard, solid, heavy, tough</li></ol><br><i>adv</i><br><ol><li>rigidly</li></ol><br><i>verb</i><br><ol><li>to be strong</li><li>(intransitive) to harden</li></ol>
kanohmi	<i>adj</i><br><ol><li>some, few, several</li></ol>
kaskaha	<i>noun</i><br><ol><li>sourness</li><li>acidity</li></ol><br><i>adj</i><br><ol><li>sour</li><li>acid</li><li>tart</li></ol><br><i>verb</i><br><ol><li>to sour, to turn sour, to become sour</li></ol>
kaskahachi	<i>verb</i><br><ol><li>to make something sour</li></ol>
katos|katosat|pikatos|katosato|katoso|katosakhī|katosano|kátos|katosakkia|katosba|katosōk|katosako|katosakō|katoskia|ikatos|katosa|katosōsh|katosō|hapikatos|akatos|katosma|hachikatos|chikatos|katosakakō|katosakōsh|katosak|katospa	<i>noun</i><br><ol><li>cat</li></ol>
keyu	<i>conj</i><br><ol><li>no</li></ol>
kilikoba	<i>adj</i><br><ol><li>green</li></ol>
kiliⁿkoba	<i>adj</i><br><ol><li>green</li></ol>
koi	<i>noun</i><br><ol><li>cougar</li><li>mountain lion</li><li>puma.</li></ol>
kolhkoki	<i>adj</i><br><ol><li>short</li></ol>
komota	<i>verb</i><br><ol><li>to fear</li></ol>
koni|koniha|konihōsh|konihakhī|konihakkia|konihako|konih|konihak|konihakakō|konihano|konihat|konihato|konihōk|konihakōsh|konihakō|koniho|konihō|konima|konipa|koniba|konikia	<i>noun</i><br><ol><li>skunk</li><li>polecat</li></ol>
kopoli|kopōli	<i>noun</i><br><ol><li>bite</li><li>biter</li></ol><br><i>verb</i><br><ol><li>(transitive) to bite</li><li>to pinch with instrument, such as tongs</li></ol>
kopooli	<i>noun</i><br><ol><li>bite</li><li>biter</li></ol><br><i>verb</i><br><ol><li>(transitive) to bite</li><li>to pinch with instrument, such as tongs</li></ol>
kowi|kōwi	<i>noun</i><br><ol><li>woods</li><li>bobcat, wildcat</li><li>tiger, panther, jaguar</li><li>mile</li></ol>
kvfi|kʋfi	<i>noun</i><br><ol><li>sassafras</li><li>coffee</li></ol>
kápassa	<i>noun</i><br><ol><li>cold, coldness</li><li>a cold (illness)</li><li>frigidity</li><li>strangeness</li></ol><br><i>adj</i><br><ol><li>cold</li></ol><br><i>verb</i><br><ol><li>to be cold (not the sensation)</li></ol>
lapish|lapishano|lapisha|lapishō|lapishako|lapishakōsh|lapishōk|lapishpa|lapishakhī|lapishōsh|alapish|lapishba|lapishakō|hachilapish|hapilapish|pilapish|salapish|lapishak|lapishakkia|lapishkia|lapishato|ilapish|lapishma|chilapish|lapisho|lapishakakō|lapishat	<i>noun</i><br><ol><li>horn</li><li>trumpet</li></ol>
lapish flamminchi	<i>noun</i><br><ol><li>antler</li></ol>
lawa	<i>adj</i><br><ol><li>many. much</li><li>a lot of</li><li>too much</li></ol>
loksi	<i>noun</i><br><ol><li>modern alternative form of luksi</li></ol>
losa	<i>noun</i><br><ol><li>black, blackness</li><li>smut, soil, blot</li></ol><br><i>adj</i><br><ol><li>black, dark</li></ol><br><i>verb</i><br><ol><li>to be black</li></ol>
luksi	<i>noun</i><br><ol><li>terrapin, turtle, tortoise</li><li>padlock, lock</li></ol>
lumbo	<i>noun</i><br><ol><li>ball, globe, sphere</li><li>lump</li><li>packet</li><li>roll</li><li>roundness</li></ol><br><i>adj</i><br><ol><li>round, globular, spherical</li><li>convex</li><li>oval</li><li>rotund</li></ol><br><i>verb</i><br><ol><li>to be round</li></ol>
lusa	<i>noun</i><br><ol><li>black</li></ol>
lvkna	<i>noun</i><br><ol><li>yellow</li></ol>
mahli	<i>noun</i><br><ol><li>wind, air, atmosphere</li></ol><br><i>verb</i><br><ol><li>to blow</li></ol>
mahli chito	<i>noun</i><br><ol><li>storm</li></ol>
misa|misisukachi|misisu̠kachi|missukachi|mi̠sa	<i>noun</i><br><ol><li>scar</li><li>stripe</li></ol>
mishash	<i>adv</i><br><ol><li>day before yesterday</li></ol>
moma	<i>noun</i><br><ol><li>continuation</li><li>sum, amount, total</li></ol><br><i>adj</i><br><ol><li>all</li><li>every</li></ol><br><i>adv</i><br><ol><li>most. more</li><li>all</li></ol><br><i>verb</i><br><ol><li>to be all</li></ol>
naapowa	<i>noun</i><br><ol><li>Modified traditional alternative of napoa</li></ol>
nakfi|nakfiyakkia|nakfi'|hachinakfi|nakfiyak|nakfiyano|nakfīkia|nakfīpa|nafki'|nakfiyōsh|nakfiyat|nakfiyakō|nakfiyakakō|hapinakfi|nakfiyato|nakfio|sanakfi|nakfiyakōsh|nakfiyako|nakfība|nakfiyō|nakfiyōk|chinakfi|nakfiyakhī|nakfi'at|nakfiya|nakfīt|nakfīma|pinakfi|nakfí'	<i>noun</i><br><ol><li>(obligatory possessive) brother of a female</li></ol>
nakfish|nakfishak|nakfishma|nakfisha|nakfishano|hachinakfish|nakfishako|nakfishpa|nakfishō|nakfishakhī|nakfishkia|sanakfish|nakfishakō|nakfishba|nakfisho|nakfishōk|nakfishat|nakfishakakō|pinakfish|nakfishakōsh|nakfísh|chinakfish|nakfishōsh|hapinakfish|nakfishato|nakfishakkia	<i>noun</i><br><ol><li>(obligatory possessive) younger sibling of the same sex</li></ol>
nakni	<i>adj</i><br><ol><li>male</li></ol>
nani|chinani|pinani|hapinani|anani|hachinani|inani	<i>noun</i><br><ol><li>fish (animal)</li></ol>
napakali	<i>noun</i><br><ol><li>flower</li></ol>
napoa	<i>noun</i><br><ol><li>wild animal</li></ol>
napowa	<i>noun</i><br><ol><li>wild animal</li></ol>
nashkoka	<i>noun</i><br><ol><li>face</li></ol>
nashoba	<i>noun</i><br><ol><li>wolf</li></ol>
nashobushi	<i>noun</i><br><ol><li>wolf cub</li></ol>
nasholichi	<i>noun</i><br><ol><li>to destroy</li></ol>
nihi	<i>noun</i><br><ol><li>seed</li></ol>
nishkin	<i>noun</i><br><ol><li>eye</li></ol>
nita	<i>noun</i><br><ol><li>bear (animal)</li></ol>
nokshopa	<i>verb</i><br><ol><li>to fear</li></ol>
nonachi	<i>verb</i><br><ol><li>to cook</li></ol>
noshkobo	<i>noun</i><br><ol><li>head</li></ol>
nosi	<i>verb</i><br><ol><li>to sleep</li></ol>
nosika	<i>verb</i><br><ol><li>to dream</li></ol>
notakfish|notakfishkia|notakfishakakō|notakfisho|notakfishō|chinotakfish|notakfishma|notakfishat|notakfishano|notakfishba|notakfishakhī|hapinotakfish|notakfishōsh|notakfishakō|notakfishakkia|notakfishōk|notakfishato|pinotakfish|notakfisha|hachinotakfish|notakfishako|notakfishak|sanotakfish|notakfishpa|notakfishakōsh	<i>noun</i><br><ol><li>beard, mustache</li></ol>
noti	<i>noun</i><br><ol><li>tooth</li></ol>
nutakfa	<i>noun</i><br><ol><li>chin</li></ol>
nvni	<i>noun</i><br><ol><li>traditional alternative form of nani</li></ol>
nvni yukachi	<i>verb</i><br><ol><li>to catch a fish</li></ol>
obalaka|obālaka	<i>noun</i><br><ol><li>behind, posterior</li></ol>
offo	<i>verb</i><br><ol><li>to grow</li></ol>
ofi|ofio|sappaf|ippaf|chimofi|imofi|ofi'at|chippaf|ofiyakakō|ofīpa|ofīkia|ofiya|ippáf|ofiyato|ofīma|ofiyakhī|hachippaf|ofiyakōsh|ofiyakō|ofiyōk|ofiyak|ofība|hapimofi|pippaf|hapippaf|ofiyōsh|ofiyat|amofi|ofiyako|ofiyano|pimofi|ofīt|hachimofi|ofiyakkia|ofiyō	<i>noun</i><br><ol><li>dog</li></ol>
ofi ipokni	<i>noun</i><br><ol><li>first snow</li></ol>
ofunlo	<i>noun</i><br><ol><li>owl</li></ol>
ohoyo|ohōyo	<i>noun</i><br><ol><li>woman</li></ol>
oka	<i>noun</i><br><ol><li>water</li></ol>
okchakvlbi	<i>noun</i><br><ol><li>purple</li></ol>
okchamali|okchamali	<i>noun</i><br><ol><li>blue</li><li>green</li><li>gray</li><li>verdure</li><li>verdigris</li></ol><br><i>adj</i><br><ol><li>blue</li><li>green</li><li>gray</li><li>verdant</li></ol><br><i>verb</i><br><ol><li>(intransitive) to be green, to be blue</li><li>(causative) to rust (of copper), to turn green</li></ol>
okchanawisha	<i>noun</i><br><ol><li>an icicle</li></ol>
okchaya	<i>verb</i><br><ol><li>to live</li></ol>
okcha̲ya	<i>verb</i><br><ol><li>to live</li></ol>
okchi	<i>noun</i><br><ol><li>broth, juice, sap, liquid, water</li></ol>
okfa|okfałi	<i>noun</i><br><ol><li>valley</li></ol>
okhạta	<i>noun</i><br><ol><li>sea</li><li>lake</li><li>bay</li><li>gulf</li></ol>
okla	<i>noun</i><br><ol><li>people, tribe, nation, population</li></ol>
okshachobi	<i>noun</i><br><ol><li>fog</li></ol>
okshimmichih	<i>verb</i><br><ol><li>to drizzle</li></ol>
oktabih	<i>adj</i><br><ol><li>frostbitten</li></ol>
okti	<i>noun</i><br><ol><li>frost, ice</li><li>icicle</li></ol>
okti hata	<i>noun</i><br><ol><li>frost</li></ol>
okti lakchi	<i>noun</i><br><ol><li>sleet</li></ol>
okti poshi	<i>noun</i><br><ol><li>fine snow</li></ol>
olbal	<i>noun</i><br><ol><li>behind</li></ol>
ona	<i>verb</i><br><ol><li>to go</li></ol>
oshi|chioshi|hachioshi|sioshi|pioshi|hapioshi	<i>noun</i><br><ol><li>son</li><li>(unmarked possessive form) his son, her son, its son, their son, of the son, of a son</li></ol>
oshta	<i>num</i><br><ol><li>four</li></ol>
otochchina|otochchīna	<i>num</i><br><ol><li>eight</li></ol>
otoklo	<i>num</i><br><ol><li>seven</li></ol>
pakanli	<i>noun</i><br><ol><li>flower</li><li>bloom, blossom</li></ol><br><i>verb</i><br><ol><li>to bloom, to blossom, to flower</li></ol>
palhali	<i>verb</i><br><ol><li>to split</li></ol>
pashi	<i>noun</i><br><ol><li>hair</li></ol>
patha	<i>adj</i><br><ol><li>wide</li></ol>
pimmi|hapimmi|pishno|pimmi|ammi|ilāp|chimmi|ilap|chishno|transnumeral possessive|hapishno|yamma|hachishno|ano|hachimmi|sashno	<i>pron</i><br><ol><li>(now chiefly Oklahoma Choctaw, archaic in Mississippi Choctaw) ours, us few's</li></ol>
pinti	<i>noun</i><br><ol><li>mouse, rat</li></ol>
pintukfi	<i>noun</i><br><ol><li>field mouse</li></ol>
pishno|hapimmi|pishno|pimmi|ammi|ilāp|chimmi|ilap|chishno|transnumeral possessive|hapishno|yamma|hachishno|ano|hachimmi|sashno	<i>pron</i><br><ol><li>we (few), us (few), ours (us few's)</li></ol>
pishokchi	<i>noun</i><br><ol><li>milk</li></ol>
piti	<i>noun</i><br><ol><li>mouse, rat</li></ol>
pokkoli|pokkōli	<i>num</i><br><ol><li>ten</li></ol><br><i>noun</i><br><ol><li>ten</li><li>decade</li></ol><br><i>adj</i><br><ol><li>ten</li><li>(ordinal number) tenth</li></ol>
sakli	<i>noun</i><br><ol><li>trout</li></ol>
sashno|hapimmi|pishno|pimmi|ammi|ilāp|chimmi|ilap|chishno|transnumeral possessive|hapishno|yamma|hachishno|ano|hachimmi|sashno	<i>pron</i><br><ol><li>(Mississippi, emphatic) I, me</li><li>(Mississippi) mine</li></ol>
shakba	<i>noun</i><br><ol><li>arm</li><li>sleeve</li></ol>
shatanni	<i>noun</i><br><ol><li>tick (arachnid)</li><li>wood tick</li></ol>
shaui	<i>noun</i><br><ol><li>raccoon</li></ol>
shaui hattak	<i>noun</i><br><ol><li>ape</li><li>monkey</li></ol>
shaui imanchaha	<i>noun</i><br><ol><li>moccasin (snake)</li></ol>
sheki	<i>noun</i><br><ol><li>buzzard</li></ol>
shila	<i>adj</i><br><ol><li>dry</li><li>arid</li><li>hoarse</li><li>mealy</li><li>dried, cured, evaporated, withered</li></ol><br><i>verb</i><br><ol><li>to dry</li><li>to become dry</li><li>to cure (meat)</li><li>to season (of wood)</li><li>to bake (of earth)</li><li>to evaporate</li><li>to wither</li></ol>
shilaklak	<i>noun</i><br><ol><li>goose</li></ol>
shinuk	<i>noun</i><br><ol><li>sand</li></ol>
shoshi|shuⁿshi	<i>noun</i><br><ol><li>insect, bug</li><li>fly</li><li>worm</li><li>moth</li></ol>
shukha	<i>noun</i><br><ol><li>pig, hog</li></ol>
shukshi	<i>noun</i><br><ol><li>watermelon</li></ol>
shukvta|shukʋta	<i>noun</i><br><ol><li>opossum</li></ol>
shulush	<i>noun</i><br><ol><li>shoe, sandal, footwear</li></ol>
shupik	<i>noun</i><br><ol><li>mudfish</li></ol>
shushi	<i>noun</i><br><ol><li>insect, bug</li><li>fly</li><li>worm</li><li>moth</li></ol>
shạpo	<i>noun</i><br><ol><li>hat, cap</li></ol>
silik	<i>noun</i><br><ol><li>silk</li></ol>
sinti	<i>noun</i><br><ol><li>snake, serpent</li></ol>
sipi	<i>verb</i><br><ol><li>be old</li></ol><br><i>adj</i><br><ol><li>old</li></ol>
siti	<i>noun</i><br><ol><li>snake</li></ol>
sokko	<i>adj</i><br><ol><li>thick</li></ol>
tachi	<i>noun</i><br><ol><li>maze</li><li>corn</li></ol>
tahakchi	<i>verb</i><br><ol><li>to tie quickly</li></ol>
taha̱kchi	<i>noun</i><br><ol><li>to tie repeatedly</li></ol>
tahchi	<i>noun</i><br><ol><li>shoulder</li></ol>
tahchi foni	<i>noun</i><br><ol><li>shoulderblade</li></ol>
taiyakchi	<i>verb</i><br><ol><li>to have finally tied</li></ol>
takchi	<i>noun</i><br><ol><li>to tie</li></ol>
takkon	<i>noun</i><br><ol><li>peach</li></ol>
takkon chito	<i>noun</i><br><ol><li>apple</li></ol>
takkon masofa	<i>noun</i><br><ol><li>apple</li></ol>
takkonlipun	<i>noun</i><br><ol><li>apple</li></ol>
takkonlushi	<i>noun</i><br><ol><li>plum</li></ol>
talhapi	<i>num</i><br><ol><li>five</li></ol>
talhlhapi	<i>num</i><br><ol><li>five</li></ol>
tali	<i>noun</i><br><ol><li>rock, stone</li><li>iron</li><li>metal</li><li>mineral</li></ol>
taloa	<i>noun</i><br><ol><li>song</li><li>singer</li><li>music</li></ol><br><i>verb</i><br><ol><li>sing</li></ol>
talowa|taloowá|talōwa	<i>name</i><br><ol><li>to sing</li></ol>
tanamp chito	<i>noun</i><br><ol><li>cannon</li></ol>
tanamp chito aiisht hushsa achaffa	<i>noun</i><br><ol><li>gunshot</li></ol>
tanamp chito isht atta	<i>noun</i><br><ol><li>a cannoneer</li></ol>
tanampi	<i>noun</i><br><ol><li>war</li></ol>
tanampo	<i>noun</i><br><ol><li>gun; firearm</li></ol>
tanampushi	<i>noun</i><br><ol><li>pistol; gun</li></ol>
tanchi	<i>noun</i><br><ol><li>corn, maize</li></ol>
tapaski	<i>adj</i><br><ol><li>thin, fine</li><li>subtle</li></ol>
tałapi	<i>num</i><br><ol><li>five</li></ol>
tałepa	<i>num</i><br><ol><li>hundred</li></ol>
tałepa sipokni	<i>num</i><br><ol><li>thousand</li></ol>
tek	<i>noun</i><br><ol><li>female, "she"</li></ol><br><i>adj</i><br><ol><li>female, "she-"</li></ol>
tekchi	<i>noun</i><br><ol><li>wife</li></ol>
ti|tī	<i>noun</i><br><ol><li>tea</li></ol>
tiak	<i>noun</i><br><ol><li>pine</li></ol>
tik|tīk	<i>noun</i><br><ol><li>female</li><li>sister (of a man)</li></ol>
tikchi	<i>noun</i><br><ol><li>wife</li></ol>
tikshạneli	<i>noun</i><br><ol><li>dictionary</li></ol>
tiliko	<i>noun</i><br><ol><li>wheat</li></ol>
tishi homi	<i>noun</i><br><ol><li>pepper</li></ol>
tishkila	<i>noun</i><br><ol><li>blue jay</li></ol>
tishu	<i>noun</i><br><ol><li>servant, waiter</li></ol>
tiwwi	<i>verb</i><br><ol><li>to open</li></ol>
tobaksi	<i>noun</i><br><ol><li>coal</li></ol>
tobi	<i>noun</i><br><ol><li>bean</li></ol>
tochchina	<i>num</i><br><ol><li>three</li></ol>
toffa	<i>noun</i><br><ol><li>summer</li></ol>
tohbi	<i>adj</i><br><ol><li>white</li><li>light (in color, appearance)</li></ol>
tohto	<i>noun</i><br><ol><li>red elm</li></ol>
tokchi	<i>noun</i><br><ol><li>saliva</li></ol>
toklo	<i>num</i><br><ol><li>two</li></ol>
toni	<i>noun</i><br><ol><li>a small wild animal</li></ol>
tuchena	<i>noun</i><br><ol><li>three</li></ol>
tuchina	<i>num</i><br><ol><li>three</li></ol><br><i>verb</i><br><ol><li>to be three</li><li>to make three</li></ol>
tuklo	<i>num</i><br><ol><li>two</li></ol><br><i>noun</i><br><ol><li>pair, couple</li><li>yoke, brace</li><li>twain</li></ol><br><i>adj</i><br><ol><li>double</li></ol><br><i>verb</i><br><ol><li>to be two</li><li>to make two</li></ol>
tulhakoba	<i>noun</i><br><ol><li>orange</li></ol>
tạli	<i>noun</i><br><ol><li>rock, stone</li><li>iron</li><li>metal</li><li>mineral</li></ol>
tạnạp	<i>noun</i><br><ol><li>enemy</li></ol>
tạshka	<i>noun</i><br><ol><li>warrior</li></ol>
ulhti	<i>noun</i><br><ol><li>fire, council fire</li><li>government, state</li></ol>
ulla apesuchi	<i>noun</i><br><ol><li>babysitter</li></ol>
ushetek	<i>noun</i><br><ol><li>daughter</li></ol>
ushi	<i>noun</i><br><ol><li>child</li><li>son</li><li>(in compounds) forms diminutive nouns</li></ol>
ushi afoka	<i>noun</i><br><ol><li>womb</li></ol>
ushi ifohka	<i>adj</i><br><ol><li>pregnant</li></ol>
ushi kaiya	<i>noun</i><br><ol><li>pregnant</li></ol>
ushi tek	<i>noun</i><br><ol><li>stepdaughter</li></ol>
ushi toba	<i>noun</i><br><ol><li>stepson</li></ol>
ushi tobat taha	<i>noun</i><br><ol><li>fetus</li></ol>
ushta	<i>num</i><br><ol><li>four</li></ol><br><i>verb</i><br><ol><li>to be four</li><li>to make four</li></ol>
vlhpoa	<i>noun</i><br><ol><li>traditional alternative of alhpoa</li></ol>
vlla	<i>noun</i><br><ol><li>traditional alterative of alla</li></ol>
vni|piʋni|chiʋni|siʋni|ʋni|hachiʋni|hapiʋni	<i>noun</i><br><ol><li>berry</li><li>nut</li><li>fruit</li></ol>
waak	<i>noun</i><br><ol><li>cow, cattle</li><li>beef</li></ol>
wak	<i>noun</i><br><ol><li>cow</li></ol>
wak apesuchi	<i>noun</i><br><ol><li>cowboy</li></ol>
watonlak|watonla	<i>noun</i><br><ol><li>crane (bird)</li></ol>
watonluk oshi	<i>noun</i><br><ol><li>white sandhill crane</li></ol>
wayya	<i>verb</i><br><ol><li>to grow</li></ol>
wik|wīk	<i>noun</i><br><ol><li>week</li></ol>
wiki|wīki	<i>adj</i><br><ol><li>heavy</li></ol>
yak	<i>adv</i><br><ol><li>thus</li></ol>
yakni|yakní'|ayakni|piyakni|hapiyakni|hachiyakni|iyakni|chiyakni	<i>noun</i><br><ol><li>the Earth, the world</li><li>earth, soil, ground</li><li>country</li></ol>
yakoke|yokoke	<i>intj</i><br><ol><li>thank you, thanks</li></ol>
yakoke ahni	<i>verb</i><br><ol><li>to thank</li></ol>
yamma|hapimmi|pishno|pimmi|ammi|ilāp|chimmi|ilap|chishno|transnumeral possessive|hapishno|yamma|hachishno|ano|hachimmi|sashno	<i>pron</i><br><ol><li>(distal demonstative) that, those</li><li>(emphatic) he, she, it, they</li></ol><br><i>det</i><br><ol><li>that, those</li><li>(distal demonstrative, with possessed noun) his, her, its, their</li></ol><br><i>adv</i><br><ol><li>there</li></ol><br><i>intj</i><br><ol><li>indeed</li></ol>
yanasa	<i>noun</i><br><ol><li>Alternative version of yvnnvsh (bison), typically spoken in Mississippi.</li></ol>
yannash	<i>noun</i><br><ol><li>bison, buffalo</li></ol>
yannash hakshop	<i>noun</i><br><ol><li>buffalo skin</li></ol>
yannashoshi	<i>noun</i><br><ol><li>little buffalo</li></ol>
yaya	<i>verb</i><br><ol><li>to cry</li></ol>
yoppa	<i>adj</i><br><ol><li>happy</li></ol><br><i>verb</i><br><ol><li>to laugh</li></ol>
yuka	<i>noun</i><br><ol><li>a slave</li><li>a prisoner</li><li>a captive</li></ol>
yvnnvsh|yʋnnʋsh	<i>noun</i><br><ol><li>bison, buffalo</li></ol>
yʋnnʋshushi	<i>noun</i><br><ol><li>a newborn buffalo</li></ol>
čahta	<i>noun</i><br><ol><li>Mississippian alternative of chahta</li></ol>
čito	<i>noun</i><br><ol><li>Mississipian alternative of chito</li></ol>
čola	<i>noun</i><br><ol><li>Mississipian alternative of chola</li></ol>
čǫkaš	<i>noun</i><br><ol><li>Mississipian alternative of chokash</li></ol>
