'm	<i>det</i><br><ol><li>my</li></ol><br><i>pron</i><br><ol><li>me</li></ol>
'th	<i>det</i><br><ol><li>your (informal second person singular possessive determiner)</li><li>thy; thine</li></ol><br><i>pron</i><br><ol><li>you (informal second person singular pronoun)</li><li>thee</li></ol>
Adam	<i>name</i><br><ol><li>Adam (biblical figure)</li></ol>
Almayn	<i>name</i><br><ol><li>Germany</li></ol>
Almaynek	<i>name</i><br><ol><li>the German language</li></ol>
Amerika	<i>name</i><br><ol><li>America, United States of America (a country in North America)</li></ol>
Anton	<i>name</i><br><ol><li>Antony, A village and civil parish in east Cornwall, England</li></ol>
Arberth	<i>name</i><br><ol><li>Arberth (city in South-West Wales)</li></ol>
Arwednak	<i>name</i><br><ol><li>Falmouth (a harbour town in Cornwall, United Kingdom)</li></ol>
Asvens	<i>name</i><br><ol><li>Advent (period between Advent Sunday and Christmas)</li></ol>
Australya	<i>name</i><br><ol><li>(Standard Cornish) Australia</li></ol>
Austrya	<i>name</i><br><ol><li>Austria</li></ol>
Azerek	<i>name</i><br><ol><li>Azeri (a language in Azerbaijan)</li></ol>
Baskek	<i>name</i><br><ol><li>Basque (a language in the Basque Country)</li></ol>
Bethalem	<i>name</i><br><ol><li>Bethlehem (a city in Palestine)</li></ol>
Beybel	<i>name</i><br><ol><li>Bible</li></ol>
Brython|Brythonion	<i>noun</i><br><ol><li>a Briton, Brythonic Celt.</li></ol>
Bulgari	<i>name</i><br><ol><li>Bulgaria</li></ol>
CH|ch	<i>character</i><br><ol><li>Third letter of the Cornish alphabet</li></ol>
De Halan Gwâv	<i>name</i><br><ol><li>(Standard Cornish) All Saints' Day (Christian feast day on 1st November)</li></ol>
Dewnans	<i>name</i><br><ol><li>Devon (a county of England)</li></ol>
Du	<i>name</i><br><ol><li>November</li></ol>
Duw|Dhuw|Tuw	<i>name</i><br><ol><li>God</li></ol>
Ebrel	<i>adv</i><br><ol><li>in April (month)</li></ol><br><i>name</i><br><ol><li>April (month)</li></ol>
Ebryl	<i>name</i><br><ol><li>(Common Cornish) April</li></ol>
Efen	<i>adv</i><br><ol><li>in June</li></ol><br><i>name</i><br><ol><li>June</li></ol>
Ejyp	<i>name</i><br><ol><li>Egypt</li></ol>
Ejyptek	<i>name</i><br><ol><li>Egyptian (language)</li></ol>
Est	<i>name</i><br><ol><li>August</li></ol>
Estoni	<i>name</i><br><ol><li>Estonia</li></ol>
Frenk|Frenkyon	<i>noun</i><br><ol><li>(Revived Late Cornish) Frenchman</li></ol><br><i>name</i><br><ol><li>(Revived Late Cornish) France</li></ol>
Frenkek	<i>name</i><br><ol><li>(Revived Late Cornish) the French language</li></ol>
Frenkes|Frenkesow	<i>noun</i><br><ol><li>(Revived Late Cornish) Frenchwoman</li></ol>
Frynk|Frynkyon	<i>noun</i><br><ol><li>Frenchman</li></ol><br><i>name</i><br><ol><li>France</li></ol>
Frynkek	<i>name</i><br><ol><li>the French language</li></ol>
Frynkes|Frynkesow	<i>noun</i><br><ol><li>Frenchwoman</li></ol>
Galathyans	<i>name</i><br><ol><li>Galatians (book of the Bible)</li></ol>
Genver|Enver|Henver|Kenver	<i>name</i><br><ol><li>January</li></ol>
Godhal|Hwodhal|Kodhal|Wodhal|Godhyli	<i>noun</i><br><ol><li>Irishman</li><li>Gael</li></ol>
Godhaleger	<i>noun</i><br><ol><li>Irish-speaker</li></ol>
Godhalek	<i>name</i><br><ol><li>the Irish language</li></ol>
Godhales|Hwodhales|Godhalesow|Kodhales|Wodhales	<i>noun</i><br><ol><li>Irishwoman</li></ol>
Gorefan	<i>name</i><br><ol><li>July</li></ol>
Gorefen	<i>adv</i><br><ol><li>in July</li></ol><br><i>name</i><br><ol><li>July</li></ol>
Gortheren	<i>adv</i><br><ol><li>in July</li></ol><br><i>name</i><br><ol><li>July</li></ol>
Grêk|Grêkys	<i>noun</i><br><ol><li>(Standard Cornish) Greek (person from Greece)</li></ol>
Gwlas an Hâv	<i>name</i><br><ol><li>Somerset (a county of England)</li></ol>
Gwydngala	<i>name</i><br><ol><li>September</li></ol>
Gwynngala	<i>name</i><br><ol><li>September</li></ol>
Gyni	<i>name</i><br><ol><li>Guinea (a country in Africa)</li></ol>
Hedra	<i>name</i><br><ol><li>October</li></ol>
Hwevrel|Hwevrer	<i>name</i><br><ol><li>February</li></ol>
Itali	<i>name</i><br><ol><li>Italy</li></ol>
Iwerdhon	<i>name</i><br><ol><li>Ireland (a country in Europe)</li></ol>
Iwerdhonek	<i>name</i><br><ol><li>the Irish language</li></ol>
Japanek	<i>name</i><br><ol><li>Synonym of Nihonek</li></ol>
Jenver	<i>name</i><br><ol><li>January</li></ol>
Jermany	<i>name</i><br><ol><li>(Standard Cornish) Germany</li></ol>
Jibraltar	<i>name</i><br><ol><li>Gibraltar (a peninsula and overseas territory of the United Kingdom, at the southern end of Iberia)</li></ol>
Jovyn	<i>name</i><br><ol><li>(Roman mythology) Jupiter</li><li>(astronomy, astrology) Jupiter</li></ol>
K.O.K.	<i>adv</i><br><ol><li>BCE/BC</li></ol>
Kaliforni	<i>name</i><br><ol><li>California</li></ol>
Kembra	<i>name</i><br><ol><li>Wales</li></ol>
Kernewek	<i>name</i><br><ol><li>(Unified Cornish, Common Cornish, Standard Written Form) the Cornish language</li></ol>
Kernow|Kernowyon	<i>name</i><br><ol><li>Cornwall</li><li>Cornishman</li></ol>
Kernowak	<i>name</i><br><ol><li>the Cornish language</li></ol>
Kernowek	<i>name</i><br><ol><li>(Unified Cornish Revised, Standard Written Form, Standard Cornish) the Cornish language</li></ol>
Kernowyon	<i>noun</i><br><ol><li>Cornishmen</li></ol>
Kernûak	<i>name</i><br><ol><li>(Revived Late Cornish) the Cornish language</li></ol>
Kevardhu	<i>name</i><br><ol><li>December</li></ol>
Kok	<i>noun</i><br><ol><li>cocaine/Coke (beverage)</li></ol>
Krist|Cryst	<i>name</i><br><ol><li>(Christianity) Christ</li></ol>
Kristoneth	<i>name</i><br><ol><li>(Christianity) Christianity</li></ol>
Kynt	<i>name</i><br><ol><li>Kent (English county)</li></ol>
Loundres	<i>name</i><br><ol><li>London (the capital city of the United Kingdom; capital city of England)</li></ol>
Lushaborgek	<i>name</i><br><ol><li>Luxembourgish language</li></ol>
Me|Fe|Ve	<i>name</i><br><ol><li>May</li></ol>
Merth	<i>adv</i><br><ol><li>in March (month)</li></ol><br><i>name</i><br><ol><li>March (month)</li></ol>
Metheven|Fetheven|Vetheven	<i>name</i><br><ol><li>June</li></ol>
Meurth|Veurth|Feurth	<i>name</i><br><ol><li>March</li><li>(astronomy, astrology) Mars</li><li>(Roman mythology) Mars</li></ol>
My a'th kar	<i>phrase</i><br><ol><li>I love you</li></ol>
Nadelyk	<i>name</i><br><ol><li>(Standard Cornish) Christmas (Christian holiday)</li></ol>
Nihonek	<i>name</i><br><ol><li>Japanese language</li></ol>
Norgagh	<i>noun</i><br><ol><li>Norway</li></ol>
Ostrali	<i>name</i><br><ol><li>Australia (a continent and country in Oceania)</li></ol>
PUA	<i>name</i><br><ol><li>Initialism of Pennternasedh Unys Arabek (“United Arab Emirates”).</li></ol>
Papwa Gyni Nowydh	<i>name</i><br><ol><li>Papua New Guinea (a country in Oceania)</li></ol>
Parti Gwithadorek	<i>name</i><br><ol><li>Conservative Party</li></ol>
Parti Lavur	<i>name</i><br><ol><li>Labour Party</li></ol>
Pask|Fask|Bask	<i>name</i><br><ol><li>Easter</li></ol>
Pennsylvaynek	<i>name</i><br><ol><li>Pennsylvania German language</li></ol>
Pennternasedh Unys Arabek|Bennternasedh Unys Arabek|Fennternasedh Unys Arabek	<i>name</i><br><ol><li>United Arab Emirates</li></ol>
Portyngal	<i>name</i><br><ol><li>Portugal (a country in Europe)</li></ol>
Pow Belg	<i>name</i><br><ol><li>Belgium</li></ol>
Pow Frenk|Bow Frenk|Fow Frenk	<i>name</i><br><ol><li>(Revived Late Cornish) France</li></ol>
Pow Frynk|Fow Frynk|Bow Frynk	<i>name</i><br><ol><li>France</li></ol>
Pow Sows|Bow Sows|Fow Sows	<i>name</i><br><ol><li>England</li></ol>
Pow an Sowson|Fow an Sowson|Bow an Sowson	<i>name</i><br><ol><li>England</li></ol>
Rewenys	<i>name</i><br><ol><li>Iceland</li></ol>
Rewenysek	<i>name</i><br><ol><li>Icelandic (language)</li></ol>
SUA	<i>name</i><br><ol><li>USA (a country in North America); initialism of Statys Unys Amerika (“United States of America”)</li></ol>
Scotlond	<i>name</i><br><ol><li>(Standard Cornish) Scotland</li></ol>
Sows|Sowson	<i>noun</i><br><ol><li>Englishman</li></ol>
Sowses|Sowsesow	<i>noun</i><br><ol><li>Englishwoman</li></ol>
Sowsneger|Sowsnegoryon	<i>noun</i><br><ol><li>English-speaker, Anglophone</li></ol>
Sowsnek	<i>name</i><br><ol><li>the English language</li></ol>
Spayn	<i>name</i><br><ol><li>Spain (a country in Europe)</li></ol>
Statys Unys Amerika	<i>name</i><br><ol><li>United States of America</li></ol>
Taylond	<i>name</i><br><ol><li>Thailand</li></ol>
Truru	<i>name</i><br><ol><li>Truro, a city in Cornwall, United Kingdom</li></ol>
Trûrû	<i>name</i><br><ol><li>(Standard Cornish) Truro (a city in Cornwall, United Kingdom)</li></ol>
Vyena	<i>name</i><br><ol><li>Vienna</li></ol>
Whevrel	<i>adv</i><br><ol><li>in February</li></ol><br><i>name</i><br><ol><li>(Standard Cornish, Standard Written Form) February</li></ol>
Wordhen	<i>name</i><br><ol><li>Ireland</li></ol>
Wordhenek	<i>name</i><br><ol><li>the Irish language</li></ol>
a|anodhans|ahanas|anodho (m)|ahanaf|ahanowgh|anedhy (f)|anedha|ahanan	<i>particle</i><br><ol><li>Marks the following verb to the preceding subject.</li></ol><br><i>prep</i><br><ol><li>of (expressing separation, origin, composition/substance or a quality)</li><li>of (between a preceding large number and a following plural noun to express quantity)</li><li>from (indicating provenance)</li></ol>
a bris	<i>prep_phrase</i><br><ol><li>outstanding, renowned, significant</li></ol>
a vri	<i>prep_phrase</i><br><ol><li>famous, prominent</li><li>relevant, significant, renowned</li></ol>
a-ban	<i>conj</i><br><ol><li>(Standard Written Form) since</li></ol>
a-barth	<i>prep</i><br><ol><li>in the name of</li><li>on behalf of</li><li>for the sake of</li><li>in favour of</li></ol>
a-barth a-woles	<i>adv</i><br><ol><li>down below</li></ol>
a-barth dyghow dhe	<i>prep</i><br><ol><li>on the right side of</li></ol>
a-barth kledh dhe	<i>prep</i><br><ol><li>on the left side of</li></ol>
a-barth woles dhe	<i>prep</i><br><ol><li>on the bottom of</li></ol>
a-berth	<i>prep</i><br><ol><li>within</li></ol>
a-berth en	<i>prep</i><br><ol><li>within</li></ol>
a-berth yn	<i>prep</i><br><ol><li>(Revived Middle Cornish) within</li></ol>
a-dhelergh dhe	<i>prep</i><br><ol><li>at the back of, behind</li></ol>
a-dhia ban	<i>conj</i><br><ol><li>since</li></ol>
a-dhistowgh	<i>adv</i><br><ol><li>immediately</li></ol>
a-dhyghow	<i>adv</i><br><ol><li>on the right</li></ol>
a-dhyghow dhe	<i>prep</i><br><ol><li>to the right of</li></ol>
a-dreus dhe	<i>prep</i><br><ol><li>across</li></ol>
a-drev	<i>adv</i><br><ol><li>(Revived Late Cornish) behind</li></ol>
a-drev dhe	<i>prep</i><br><ol><li>(Revived Late Cornish) behind</li></ol>
a-dro	<i>adv</i><br><ol><li>about, around</li></ol>
a-dro dhe	<i>prep</i><br><ol><li>about, around, concerning</li><li>(of clothes) on</li></ol>
a-dryv	<i>adv</i><br><ol><li>(Revived Middle Cornish) behind</li></ol>
a-dryv dhe	<i>prep</i><br><ol><li>(Revived Middle Cornish) behind</li></ol>
a-gledh	<i>adv</i><br><ol><li>on the right</li></ol>
a-gledh dhe	<i>prep</i><br><ol><li>to the left of</li></ol>
a-jei	<i>adv</i><br><ol><li>(Revived Late Cornish) behind</li></ol>
a-jei dhe	<i>prep</i><br><ol><li>(Revived Late Cornish) within</li></ol>
a-ji	<i>adv</i><br><ol><li>(Revived Middle Cornish) inside</li></ol>
a-ji dhe	<i>prep</i><br><ol><li>(Revived Middle Cornish) within</li></ol>
a-vorow	<i>adv</i><br><ol><li>tomorrow</li></ol>
abarth awoles	<i>adv</i><br><ol><li>(Standard Cornish) down below</li></ol>
abas|abasow	<i>noun</i><br><ol><li>abbot</li></ol>
abasel	<i>adj</i><br><ol><li>abbatial</li></ol>
abases|abasesow	<i>noun</i><br><ol><li>abbess</li></ol>
abatti|abattiow	<i>noun</i><br><ol><li>abbey</li></ol>
aberveth|a-bervedh	<i>adj</i><br><ol><li>(Standard Cornish) inner, interior, internal</li></ol><br><i>adv</i><br><ol><li>(Standard Cornish) indoors, inside, internally, inwards</li></ol>
abesteleth	<i>noun</i><br><ol><li>apostolate</li></ol>
abm|abmow	<i>noun</i><br><ol><li>(Revived Late Cornish) kiss</li></ol>
abma	<i>verb</i><br><ol><li>(Revived Late Cornish) to kiss</li></ol>
abostol|abesteli|abesteleth	<i>noun</i><br><ol><li>(Christianity) apostle</li></ol>
abostolek	<i>adj</i><br><ol><li>apostolic</li></ol>
abrës	<i>adv</i><br><ol><li>(Standard Cornish) early, on time</li></ol>
abrÿs	<i>adv</i><br><ol><li>(Standard Cornish) early, on time</li></ol>
abyl	<i>adj</i><br><ol><li>(Standard Cornish) able, capable</li></ol>
abàn	<i>conj</i><br><ol><li>(Standard Cornish) since</li></ol>
abâtya	<i>verb</i><br><ol><li>to abate</li></ol>
acheson rag skonya|achesonys rag skonya	<i>noun</i><br><ol><li>objection</li></ol>
acord	<i>noun</i><br><ol><li>(Standard Cornish, Standard Written Form) accord, agreement</li></ol>
acordya	<i>verb</i><br><ol><li>(Standard Cornish, Standard Written Form) to agree</li></ol>
acowntyas|acowntysy	<i>noun</i><br><ol><li>(Standard Cornish) accountant</li></ol>
adamant|adamantow	<i>noun</i><br><ol><li>The mineral, diamond</li><li>A gemstone made from diamond.</li></ol>
addya	<i>verb</i><br><ol><li>(Standard Cornish, Standard Written Form) to add</li></ol>
ader dro	<i>adv</i><br><ol><li>(Standard Cornish) around, about (from place to place)</li></ol>
adermyn	<i>adv</i><br><ol><li>(Standard Cornish) in time, on time, punctually</li></ol>
adhelergh	<i>adv</i><br><ol><li>(Standard Cornish) aft, at the back, behind</li></ol>
adhewedhes	<i>adv</i><br><ol><li>(Standard Cornish) lately</li></ol>
adhyskans|adhyskansow	<i>noun</i><br><ol><li>The process or art of imparting knowledge, skill and judgment.</li><li>Facts, skills and ideas that have been learned, either formally or informally.</li></ol>
adhyski	<i>noun</i><br><ol><li>to instruct or train</li></ol>
adhyskonieth	<i>noun</i><br><ol><li>The profession of teaching.</li><li>The activities of educating, teaching or instructing.</li><li>The strategies of instruction.</li></ol>
adhyskoniethel	<i>noun</i><br><ol><li>Of, or relating to pedagogy; teaching.</li></ol>
adhyskonydh|adhyskonydhow	<i>noun</i><br><ol><li>A teacher or instructor of children; one whose occupation is to teach the young.</li></ol>
adoptya	<i>verb</i><br><ol><li>to adopt</li></ol>
adre	<i>adv</i><br><ol><li>(Standard Cornish) from home</li></ol>
adro dhe	<i>prep</i><br><ol><li>(Standard Cornish) around, about (in a circle around, on every side of)</li><li>(Standard Cornish) about, concerning, regarding</li></ol>
adâl	<i>prep</i><br><ol><li>(Standard Cornish) opposite</li></ol>
affirmya	<i>verb</i><br><ol><li>to affirm</li></ol>
affordya	<i>verb</i><br><ol><li>to afford</li></ol>
afia	<i>verb</i><br><ol><li>to affirm</li></ol>
afînus	<i>noun</i><br><ol><li>decorative, ornamental</li></ol>
aga	<i>det</i><br><ol><li>their</li></ol>
agan	<i>det</i><br><ol><li>our</li></ol>
agan honan	<i>pron</i><br><ol><li>ourselves</li></ol>
agan re	<i>pron</i><br><ol><li>theirs (plural only)</li></ol>
agas	<i>det</i><br><ol><li>your (belonging to you; plural or formal)</li></ol>
agas honan	<i>pron</i><br><ol><li>yourselves</li></ol>
agensow	<i>adv</i><br><ol><li>(Standard Cornish) recently</li></ol>
ages	<i>prep</i><br><ol><li>than (introduces part of comparison)</li></ol>
agh|agh!|ahow	<i>noun</i><br><ol><li>race, ethnicity</li></ol><br><i>intj</i><br><ol><li>oh!</li><li>fie!</li></ol>
agria	<i>verb</i><br><ol><li>(Standard Cornish, Standard Written Form) to agree</li></ol>
ahwer	<i>noun</i><br><ol><li>anxiety, trouble</li></ol>
ahës	<i>adv</i><br><ol><li>(Standard Cornish) lengthwise</li></ol><br><i>prep</i><br><ol><li>(Standard Cornish) along (by the length of; parallel to the length of)</li></ol>
ahÿs	<i>adv</i><br><ol><li>(Standard Cornish) lengthwise</li></ol><br><i>prep</i><br><ol><li>(Standard Cornish) along (by the length of; parallel to the length of)</li></ol>
air	<i>noun</i><br><ol><li>air</li></ol>
akont|akontys|akontow	<i>noun</i><br><ol><li>account</li></ol>
akont arghantti|arkontow arghantti|arkontys arghantti	<i>noun</i><br><ol><li>bank account</li></ol>
akont arghow|arkontys arghow|arkontow arghow	<i>noun</i><br><ol><li>deposit account</li></ol>
akont kesres|akontys kesres|akontow kesres	<i>noun</i><br><ol><li>current account</li></ol>
akordya	<i>verb</i><br><ol><li>to accord, to agree</li></ol>
akwirya	<i>verb</i><br><ol><li>to acquire</li></ol>
alamand|alamandow|alamandys	<i>noun</i><br><ol><li>almond</li></ol>
alarm ladron|alarmow ladron	<i>noun</i><br><ol><li>burglar alarm</li></ol>
alarm tan|alarmow tan	<i>noun</i><br><ol><li>fire alarm</li></ol>
alebma	<i>adv</i><br><ol><li>hence, from here</li></ol>
alemma	<i>adv</i><br><ol><li>hence, from here</li></ol>
alena	<i>adv</i><br><ol><li>thence, from there</li></ol>
alergedh|alergedhow	<i>noun</i><br><ol><li>allergy</li></ol>
aljebra	<i>noun</i><br><ol><li>algebra</li></ol>
alkohologeth	<i>noun</i><br><ol><li>alcoholism</li></ol>
als|alsyow	<i>noun</i><br><ol><li>(Standard Written Form) cliff</li></ol>
alsen|alsednow|alsennow	<i>noun</i><br><ol><li>razor</li></ol>
aluminiom	<i>noun</i><br><ol><li>aluminium</li></ol>
alusenji|alusenjiow	<i>noun</i><br><ol><li>food bank</li></ol>
alwheth|alwhedhow	<i>noun</i><br><ol><li>(Standard Cornish) key (device to open and close locks)</li></ol>
amal|emlow	<i>noun</i><br><ol><li>border, edge, margin, verge, side, periphery</li></ol>
amal arghans	<i>noun</i><br><ol><li>silver lining</li></ol>
amanyn	<i>noun</i><br><ol><li>(Standard Cornish, Standard Written Form) butter (dairy product)</li></ol>
amary|amarys	<i>noun</i><br><ol><li>(Standard Cornish) cupboard</li></ol>
amendya	<i>verb</i><br><ol><li>to amend</li></ol>
amendyans|amendyansow	<i>noun</i><br><ol><li>amendment, change, revision, reform</li></ol>
amm|ammow	<i>noun</i><br><ol><li>kiss</li></ol>
amma	<i>verb</i><br><ol><li>to kiss</li></ol>
amontya	<i>verb</i><br><ol><li>to count</li></ol>
amowntya	<i>verb</i><br><ol><li>(Standard Cornish) to count</li></ol>
amowntyor|amowntyoryon	<i>noun</i><br><ol><li>(Standard Cornish) computer</li></ol>
an	<i>article</i><br><ol><li>the (definite article)</li></ol>
an awtoritas	<i>noun</i><br><ol><li>powers that be</li></ol>
anger	<i>noun</i><br><ol><li>anger (strong feeling of displeasure)</li></ol>
anlaghel	<i>adj</i><br><ol><li>illegal, unlawful</li></ol>
apa	<i>noun</i><br><ol><li>ape</li></ol>
aral|erel	<i>adj</i><br><ol><li>other (not the one previously referred to)</li></ol>
argel|argelyow	<i>noun</i><br><ol><li>refuge, retreat, secluded place</li></ol>
arghans	<i>noun</i><br><ol><li>money</li><li>silver, argent</li></ol>
arghansek	<i>adj</i><br><ol><li>silvery</li></ol>
arghantti|arghanttiow	<i>noun</i><br><ol><li>bank (financial institution)</li></ol>
arhans	<i>noun</i><br><ol><li>money</li><li>silver, argent</li></ol>
arlodh|arlydhi	<i>noun</i><br><ol><li>lord</li></ol>
arnowydhheans|arnowydhheansow	<i>noun</i><br><ol><li>modernisation</li></ol>
art|artys	<i>noun</i><br><ol><li>art</li></ol>
arth|arthes	<i>noun</i><br><ol><li>bear (mammal)</li></ol>
asklos|asklosen	<i>noun</i><br><ol><li>chips</li><li>splinters</li></ol>
asklotti|asklottiow	<i>noun</i><br><ol><li>chip shop</li></ol>
askrifa	<i>verb</i><br><ol><li>to attribute, ascribe</li></ol>
askrifys	<i>adj</i><br><ol><li>attributed, ascribed</li></ol>
asow|asowen	<i>noun</i><br><ol><li>(anatomy) ribs</li></ol>
assa	<i>intj</i><br><ol><li>how</li></ol>
aval|avallow|avalow	<i>noun</i><br><ol><li>apple</li></ol>
aval dor|avalow dor	<i>noun</i><br><ol><li>potato</li></ol>
aval goodh|avalow goodh	<i>noun</i><br><ol><li>crabapple, wild apple</li></ol>
aval gwlanek|avalow gwlanek	<i>noun</i><br><ol><li>peach</li></ol>
aval kerensa|avalow kerensa	<i>noun</i><br><ol><li>tomato</li></ol>
aval paradhis|avalow paradhis	<i>noun</i><br><ol><li>grapefruit</li></ol>
avalen|avalennow|avalednow	<i>noun</i><br><ol><li>apple tree</li></ol>
avan|avanen	<i>noun</i><br><ol><li>raspberries</li></ol>
avokado|avokados	<i>noun</i><br><ol><li>avocado</li></ol>
avorow	<i>adv</i><br><ol><li>tomorrow</li></ol>
awtorita|awtoritys|awtoritas	<i>noun</i><br><ol><li>authority</li></ol>
awtorita udnik|awtoritas udnik	<i>noun</i><br><ol><li>unitary authority</li></ol>
ayr	<i>noun</i><br><ol><li>air</li></ol>
baban|faban|babanes|vaban|paban	<i>noun</i><br><ol><li>baby</li></ol>
bacbîtya	<i>verb</i><br><ol><li>to backbite</li></ol>
balyer|palyer|balyerow|valyer|falyer	<i>noun</i><br><ol><li>barrel</li></ol>
banadhel|fanadhlen|panadhel|fanadhel|panadhlen|vanadhlen|banadhlen|vanadhel	<i>noun</i><br><ol><li>(botany) brooms</li></ol>
banana|bananas|panana|fanana|vanana	<i>noun</i><br><ol><li>banana</li></ol>
bar'	<i>prep</i><br><ol><li>in the name of</li><li>on behalf of</li><li>for the sake of</li><li>in favour of</li></ol>
barv|varv|varf|farv|parv|farf|barvow|barf|parf	<i>noun</i><br><ol><li>beard</li></ol>
barvus|varvus|barvusi|barvuji|parvus|farvus	<i>adj</i><br><ol><li>bearded</li></ol><br><i>noun</i><br><ol><li>cod</li></ol>
basar|basars	<i>noun</i><br><ol><li>bazaar</li><li>jumble sale</li></ol>
bay|vay|pay|fay|bayow	<i>noun</i><br><ol><li>kiss</li></ol>
bejeth	<i>noun</i><br><ol><li>face</li><li>countenance</li></ol>
benyn|venyn|venenes|penenes|fenenes|penyn|benenes|fenyn	<i>noun</i><br><ol><li>woman</li></ol>
benyn efanvos|benenes efanvos	<i>noun</i><br><ol><li>spacewoman</li></ol>
beol|beolyow	<i>noun</i><br><ol><li>elecampane</li></ol>
berr|perr|ferr|verr	<i>adj</i><br><ol><li>short, brief</li></ol>
berrskrif|berrskrifow	<i>noun</i><br><ol><li>summary, abstract</li></ol>
berrskrifa	<i>verb</i><br><ol><li>to summarise</li></ol>
bes|pesen|besow|pes|fes|ves	<i>noun</i><br><ol><li>(Revived Late Cornish) world</li></ol>
besel|beslen	<i>noun</i><br><ol><li>(Revived Late Cornish) mussels</li></ol>
bewnans|vewnans|bewnansow|pewnans|fewnans	<i>noun</i><br><ol><li>(Revived Middle Cornish) life</li></ol>
bewskrif|bywskrifow|bewskrifow|bywskrif	<i>noun</i><br><ol><li>biography</li></ol>
bian	<i>adj</i><br><ol><li>little, small</li></ol>
bili|bilien	<i>noun</i><br><ol><li>pebbles</li></ol>
blas|blasow	<i>noun</i><br><ol><li>taste</li></ol>
bledhen|bledhennyow|bledhynnyow|bledhydnyow	<i>noun</i><br><ol><li>year</li></ol>
blejan|plejan|blejyow|vlejan|flejan|flejyow|plejyow|vlejyow	<i>noun</i><br><ol><li>(Unified Cornish) flower</li></ol>
blejen|flejen|vlejen|blejyow|flejyow|blejennow|plejyow|vlejyow|plejen	<i>noun</i><br><ol><li>(Standard Cornish) flower</li></ol>
bleujen|bleujennow	<i>noun</i><br><ol><li>flower</li></ol>
bleujenn|fleujenn|pleujenn|vleujenn|bleujennow	<i>noun</i><br><ol><li>flower</li></ol>
bleus|bleusyow	<i>noun</i><br><ol><li>flour</li></ol>
blew|blewen	<i>noun</i><br><ol><li>hair</li></ol>
bleydh|bleydhas|pleydhas|pleydh|vleydh|vleydhas|bleydhes|fleydhas|fleydh	<i>noun</i><br><ol><li>wolf</li></ol>
blou|flou|vlou|plou	<i>adj</i><br><ol><li>blue</li></ol>
bogh|bohow|vohow|pogh|pohow|fogh|diwvogh|dhiwvogh|fohow|vogh|tiwvogh	<i>noun</i><br><ol><li>cheek</li></ol>
bones|bowns y|on ny|bedhowgh hwi|esen vy|en ni|esowgh|esewgh hwi|os|erewgh why|bêns y|bons i|bien vy|bien ny|on ni|beuv vy|bydh ev|esens i|bëdh ev|ow pones|esta|bon ny|beus jy|eron ni|esewgh why|yns i|bien ni|bes|owgh hwi|bedhons y|esa ev|bo ev|bi jy|ywa|ewgh hwi|eson ny|owgh why|usons y|bedhyn ni|bewgh hwi|eros jy|o ev|future|oma|yns y|eus|ewgh why|bedhons i|ber|ov vy|bos jy|eren ny|byn ni|ymons i|bÿdh ev|bedhyn ny|o'ma|eres jy|bedhyn|bedher|bedhys jy|bewgh why|erowgh hwi|os jy|or|eses jy|biens y|erov vy|eja ev|esen ni|eren vy|bon ni|es jy|yma ev|bies jy|bëdh|bydh|by jy|besta|esens y|beun ny|ens i|osta|biens i|os ta|biewgh hwi|byma|en ny|bedhowgh|beun ni|erowgh why|biv vy|erens y|bedhaf vy|Verbal adjective: (not used)|ben ni|bedhyth jy|usi ev|bowgh hwi|bies|bowgh why|usons i|eder|be ev|era ev|Habitual|beusta|bedhydh jy|ben vy|beus|yw ev|bedhes|bedhav vy|bÿdh|êns y|esen ny|bens i|usy ev|eses|beu ev|biewgh why|ymowns y|esof vy|eron ny|ben ny|ymôns y|bia ev|esos jy|ow pos|bedhens|bon vy|bedhowgh why|bosta|bes jy|es ta|en vy|eroma	<i>verb</i><br><ol><li>to be</li></ol>
bord|pord|vord|bordys|ford	<i>noun</i><br><ol><li>(Revived Late Cornish) A table</li></ol>
bord gwynn|pord gwynn|ford gwynn|vord gwynn	<i>noun</i><br><ol><li>whiteboard</li></ol>
bore|pore|vore|fore	<i>noun</i><br><ol><li>morning</li></ol>
bos|bowns y|on ny|esen vy|en ni|esowgh|bydhydh jy|vos|esewgh hwi|os|erewgh why|bêns y|bons i|bien vy|bien ny|on ni|beuv vy|bydh ev|esens i|bëdh ev|ow pones|pos|bydhyn ni|esta|bydhav vy|bon ny|beus jy|eson ni|esewgh why|yns i|bien ni|bes|owgh hwi|bedhons y|esa ev|bo ev|bi jy|ywa|ewgh hwi|eson ny|owgh why|usons y|bewgh hwi|o ev|future|oma|yns y|eus|ewgh why|esowgh hwi|ber|ov vy|bos jy|eren ny|byn ni|ymons i|bÿdh ev|bedhyn ny|o'ma|eres jy|bedhyn|bedher|bedhys jy|bewgh why|os jy|or|eses jy|biens y|eja ev|esen ni|eren vy|bon ni|es jy|yma ev|bies jy|bëdh|bydh|by jy|besta|esens y|beun ny|ens i|osta|biens i|os ta|biewgh hwi|byma|en ny|bedhowgh|beun ni|erowgh why|biv vy|erens y|bedhaf vy|Verbal adjective: (not used)|ben ni|bedhyth jy|usi ev|bowgh hwi|bies|bowgh why|usons i|eder|be ev|era ev|Habitual|beusta|ben vy|beus|yw ev|bedhes|bÿdh|êns y|esen ny|bens i|usy ev|eses|beu ev|biewgh why|bydhowgh hwi|ymowns y|esof vy|eron ny|ben ny|ymôns y|bia ev|esos jy|ow pos|fos|bedhens|bon vy|bedhowgh why|bosta|bes jy|bydhons i|es ta|en vy|eroma|esov vy	<i>verb</i><br><ol><li>to be</li></ol>
bos da|vos da|fos da|pos da	<i>verb</i><br><ol><li>to be good</li><li>to like (with English object and subject as Cornish subject of verb and object of preposition respectively)</li></ol>
bos trigys|fos trigys|vos trigys|pos trigys	<i>verb</i><br><ol><li>to live (somewhere), to dwell</li></ol>
bos trigys en argel|fos trigys en argel|pos trigys en argel|vos trigys en argel	<i>verb</i><br><ol><li>to live in the back of beyond</li></ol>
bos trigys yn argel|pos trigys yn argel|vos trigys yn argel|fos trigys yn argel	<i>verb</i><br><ol><li>to live in the back of beyond</li></ol>
botas|botasen	<i>noun</i><br><ol><li>boots</li></ol>
botas palvek|votasen palvek|fotas palvek|potasen palvek|votas palvek|fotasen palvek|potas palvek|botasen balvek|botasen palvek	<i>noun</i><br><ol><li>(anatomy) flippers</li></ol>
botel|botellow	<i>noun</i><br><ol><li>bottle</li></ol>
bownans|fownans|pownans|bownanjow|vownans	<i>noun</i><br><ol><li>(Revived Late Cornish) life</li></ol>
bran|briny|brini	<i>noun</i><br><ol><li>crow</li></ol>
bras|fras|bras|vras|pras	<i>adj</i><br><ol><li>big, great</li></ol>
brednik|brenigen	<i>noun</i><br><ol><li>(Revived Late Cornish) limpets</li></ol>
bregh|tywvregh|prehow|dhiwvregh|frehow|vrehow|dhywvregh|vregh|fregh|pregh|dywvregh|tiwvregh|diwvregh|brehow	<i>noun</i><br><ol><li>arm</li></ol>
brennik|brenigen	<i>noun</i><br><ol><li>limpets</li></ol>
brialli|briallen	<i>noun</i><br><ol><li>primroses</li></ol>
broas|froas|proas|vroas	<i>adj</i><br><ol><li>(Revived Late Cornish) big, great</li></ol>
broaz	<i>adj</i><br><ol><li>big, large</li></ol>
broder|vroder|breder|proder|froder	<i>noun</i><br><ol><li>brother</li></ol>
brodn|vrodnow|dhywvron|tywvron|brodnen|prodnow|brodnow|frodnow|dywvron	<i>noun</i><br><ol><li>(Revived Late Cornish) rushes</li><li>(anatomy) breast</li></ol>
brogh|progh|frogh|broghas|vrogh	<i>noun</i><br><ol><li>badger</li></ol>
broghky	<i>noun</i><br><ol><li>dachshund</li></ol>
bronkitis	<i>noun</i><br><ol><li>bronchitis</li></ol>
bronn|vronn|pronnen|fronnen|pronn|bronnen|vronnow|tiwvronn|fronnow|bronn|dhywvron|vronnen|dywvron|bronnow|dhiwvronn|pronnow|diwvron|fronn|tywvron|diwvronn	<i>noun</i><br><ol><li>(anatomy) breast</li><li>rushes</li></ol>
broweghyades|vroweghyades|froweghyades|broweghyadesow|proweghyades	<i>noun</i><br><ol><li>female terrorist</li></ol>
broweghyas|vroweghyas|broweghysi|proweghyas|froweghyas	<i>noun</i><br><ol><li>male terrorist</li></ol>
browsyon|browsyonen	<i>noun</i><br><ol><li>crumbs</li></ol>
brykedh|brykedhen	<i>noun</i><br><ol><li>apricots</li></ol>
brynk|frynk|prynk|vrynk|brynken|vrynken|frynken|prynken	<i>noun</i><br><ol><li>gills (of a fish)</li></ol>
brâs|vrâs|prâs|frâs	<i>adj</i><br><ol><li>(Standard Cornish) big, great</li></ol>
bucca	<i>noun</i><br><ol><li>hobgoblin</li></ol>
bugel	<i>noun</i><br><ol><li>shepherd</li></ol>
bugh|buhes|vugh|pugh|fugh	<i>noun</i><br><ol><li>cow</li></ol>
buluk|bulugen	<i>noun</i><br><ol><li>earthworms</li></ol>
buwgh|buhas	<i>noun</i><br><ol><li>(Standard Cornish) cow</li></ol>
bys|pesen|pys|bysow|vys|fys	<i>noun</i><br><ol><li>(Revived Middle Cornish) world</li></ol>
byskon|byskonyow	<i>noun</i><br><ol><li>thimble</li></ol>
byskon mes|byskonyow mesen	<i>noun</i><br><ol><li>acorn cup</li></ol>
bêwnans|bêwnansow	<i>noun</i><br><ol><li>life</li></ol>
bës	<i>noun</i><br><ol><li>world</li></ol>
bÿs|besias|fÿs|bÿs|bysow|vÿs|pÿs	<i>noun</i><br><ol><li>world</li><li>finger</li></ol>
calyum	<i>noun</i><br><ol><li>potassium</li></ol>
cath|cathes|cathas	<i>noun</i><br><ol><li>(Standard Cornish, Standard Written Form) cat</li></ol>
caugh	<i>noun</i><br><ol><li>shit</li></ol>
chambour|chambouryow|chambours|jambour	<i>noun</i><br><ol><li>chamber, bedroom</li></ol>
chassya	<i>verb</i><br><ol><li>to chase</li></ol>
chayn	<i>noun</i><br><ol><li>chain</li></ol>
chi|chiow|ji|treven	<i>noun</i><br><ol><li>(Standard Written Form) house</li></ol>
chogha|choghys|jogha	<i>noun</i><br><ol><li>chough</li></ol>
choklet|chocklets|joklet	<i>noun</i><br><ol><li>chocolate</li></ol>
choklet tomm|joklet tomm	<i>noun</i><br><ol><li>hot chocolate</li></ol>
chy|chei|jei|chiow|treven|jy	<i>noun</i><br><ol><li>(Standard Cornish) house</li></ol>
chymbla|chymblow|chymblys	<i>noun</i><br><ol><li>chimney</li></ol>
cita|citys|gita|hita	<i>noun</i><br><ol><li>city</li></ol>
comol|comolen	<i>noun</i><br><ol><li>(Unified Cornish Revised) clouds</li></ol>
coth	<i>adj</i><br><ol><li>old, ancient</li></ol>
cowan|cowannes|gowan|howan	<i>noun</i><br><ol><li>owl</li></ol>
cowethas|cowethasow	<i>noun</i><br><ol><li>society</li></ol>
creftus	<i>adj</i><br><ol><li>artificial</li></ol>
cres	<i>adj</i><br><ol><li>central, middle</li></ol><br><i>noun</i><br><ol><li>centre, middle</li><li>midst</li><li>peace</li><li>creed</li></ol>
cria	<i>verb</i><br><ol><li>to cry, to call</li><li>to call, to name</li></ol>
cul	<i>adj</i><br><ol><li>narrow</li></ol>
cussyn|cussydnow|cussynnow	<i>noun</i><br><ol><li>kiss</li></ol>
cyta|cytas	<i>noun</i><br><ol><li>(Standard Cornish) city</li></ol>
cùntell	<i>verb</i><br><ol><li>to collect, to gather</li></ol>
cùntelles|cùntelesow	<i>noun</i><br><ol><li>congress, assembly, convocation, meeting</li></ol>
cüssyn|cüssynnow	<i>noun</i><br><ol><li>(Unified Cornish) kiss</li></ol>
dama|damyow	<i>noun</i><br><ol><li>mother, dam</li></ol>
dama-wydn|\|f\|damyow-gwydn}}	<i>noun</i><br><ol><li>grandmother</li></ol>
dans|dens	<i>noun</i><br><ol><li>tooth</li></ol>
dans olifans	<i>noun</i><br><ol><li>ivory</li></ol>
dar|deri	<i>noun</i><br><ol><li>oak</li></ol>
daras|darasow|darjow	<i>noun</i><br><ol><li>door</li></ol>
davas|devysyow|deves|tavas|dhavas	<i>noun</i><br><ol><li>sheep</li></ol>
de Gwener	<i>adv</i><br><ol><li>(Standard Cornish) on Friday</li></ol><br><i>name</i><br><ol><li>(Standard Cornish) Friday</li></ol>
de Lun	<i>adv</i><br><ol><li>(Standard Cornish) on Monday</li></ol><br><i>name</i><br><ol><li>(Standard Cornish) Monday</li></ol>
de Merher	<i>adv</i><br><ol><li>(Standard Cornish) on Wednesday</li></ol><br><i>name</i><br><ol><li>(Standard Cornish) Wednesday</li></ol>
de Merth	<i>adv</i><br><ol><li>(Standard Cornish) on Tuesday</li></ol><br><i>name</i><br><ol><li>(Standard Cornish) Tuesday</li></ol>
de Sadorn	<i>adv</i><br><ol><li>(Standard Cornish) on Saturday</li></ol><br><i>name</i><br><ol><li>(Standard Cornish) Saturday</li></ol>
de Sul	<i>adv</i><br><ol><li>(Standard Cornish) on Sunday</li></ol><br><i>name</i><br><ol><li>(Standard Cornish) Sunday</li></ol>
de Yow	<i>adv</i><br><ol><li>(Standard Cornish) on Thursday</li></ol><br><i>noun</i><br><ol><li>(Standard Cornish) Thursday</li></ol>
de Zadorn	<i>adv</i><br><ol><li>(Standard Cornish) on Saturday</li></ol><br><i>noun</i><br><ol><li>(Standard Cornish) Saturday</li></ol>
debri|tebri|dhebri	<i>verb</i><br><ol><li>(Standard Written Form) to eat</li></ol>
debry	<i>verb</i><br><ol><li>to eat</li></ol>
dedh|dhedh|tedh|dedhyow	<i>noun</i><br><ol><li>day</li></ol>
deg|teg|dheg	<i>num</i><br><ol><li>ten</li></ol>
deg ha dew ugens|dheg ha dew ugens|teg ha dew ugens	<i>num</i><br><ol><li>fifty</li></ol>
deg ha peswar ugens|teg ha peswar ugens|dheg ha peswar ugens	<i>num</i><br><ol><li>ninety</li></ol>
deg ha tri ugens|dheg ha tri ugens|teg ha tri ugens	<i>num</i><br><ol><li>seventy</li></ol>
deg warn ugens|teg warn ugens|dheg warn ugens	<i>num</i><br><ol><li>thirty</li></ol>
degves|tegves|10ves|dhegves	<i>adj</i><br><ol><li>tenth</li></ol>
dehen|dehennow|dehednow	<i>noun</i><br><ol><li>cream</li></ol>
dehen molys	<i>noun</i><br><ol><li>clotted cream</li></ol>
demondya	<i>verb</i><br><ol><li>to demand</li></ol>
den|tus|dhen|ten	<i>noun</i><br><ol><li>man</li><li>person</li></ol>
den efanvos|tus efanvos	<i>noun</i><br><ol><li>spaceman</li></ol>
dena	<i>verb</i><br><ol><li>to absorb, suck</li></ol>
denagha	<i>verb</i><br><ol><li>withdraw, retract, refuse, reject</li></ol>
dengibya	<i>verb</i><br><ol><li>to abduct</li></ol>
denladha	<i>verb</i><br><ol><li>to commit manslaughter</li></ol>
denladra	<i>verb</i><br><ol><li>to abduct, kidnap</li></ol>
densel	<i>verb</i><br><ol><li>to munch, crunch</li></ol>
dentethyel|tentethyel|dhentethyel	<i>adj</i><br><ol><li>delicious</li></ol>
denti|tenti|dhenti|denti	<i>adj</i><br><ol><li>dainty, delicate</li><li>fastidious, fussy</li></ol>
dernigel|dhernigel|ternigel	<i>adj</i><br><ol><li>fragmentary</li></ol>
derow|derow|derwen|terow|derowen|dherow|derowyow	<i>noun</i><br><ol><li>oaks</li><li>beginning, start</li></ol>
desegha	<i>verb</i><br><ol><li>to dry out, dry up</li></ol>
deseha	<i>verb</i><br><ol><li>to dry out, dry up</li></ol>
deservya	<i>verb</i><br><ol><li>to deserve</li></ol>
desinya	<i>verb</i><br><ol><li>to design</li></ol>
deski	<i>verb</i><br><ol><li>(intransitive) to learn</li><li>(transitive) to teach, train, instruct</li></ol>
deskrifa	<i>verb</i><br><ol><li>to describe</li></ol>
desygha	<i>verb</i><br><ol><li>to dry out, dry up</li></ol>
determya	<i>verb</i><br><ol><li>to determine</li></ol>
devera	<i>verb</i><br><ol><li>to drip, leak, trickle, shed</li></ol>
devera dagrow	<i>verb</i><br><ol><li>to shed tears</li></ol>
deviser|devisoryon	<i>noun</i><br><ol><li>(male) inventor</li></ol>
devisores|devisoresow	<i>noun</i><br><ol><li>(female) inventor</li></ol>
devisya	<i>verb</i><br><ol><li>to devise, invent, plan, scheme</li></ol>
devorya	<i>verb</i><br><ol><li>to devour</li></ol>
devydna	<i>verb</i><br><ol><li>to quote</li></ol>
devynna	<i>verb</i><br><ol><li>to quote</li></ol>
dew|dhew|tew|diw	<i>num</i><br><ol><li>two</li></ol>
dew ugens|tew ugens|dhew ugens	<i>num</i><br><ol><li>forty</li></ol>
dewdhegves|tewdhegves|dhewdhegves|12ves	<i>adj</i><br><ol><li>twelfth</li></ol>
dewdhek|dhewdhek|tewdhek	<i>num</i><br><ol><li>twelve</li></ol>
dewfrik|dhewfrik|tewfrik	<i>noun</i><br><ol><li>nose</li></ol>
dewheles	<i>verb</i><br><ol><li>to return (go back)</li></ol>
dewi	<i>verb</i><br><ol><li>to kindle</li></ol>
dha	<i>det</i><br><ol><li>your (singular)</li><li>thy</li></ol>
dhe|dhymm|dha|dhedhy (f)|dhedhans|dhedha|dhyn|dhodhans|dhywgh|dhodho (m)|dhis|dhybm|dhèm	<i>prep</i><br><ol><li>to (expresses purpose)</li><li>(when inflected for person) to someone, towards someone</li><li>expresses possession</li></ol>
diagnosa	<i>verb</i><br><ol><li>to diagnose</li></ol>
diala	<i>verb</i><br><ol><li>to avenge, take revenge</li></ol>
diank	<i>verb</i><br><ol><li>to escape</li></ol>
didakla	<i>verb</i><br><ol><li>to dismantle</li></ol>
didhana	<i>verb</i><br><ol><li>to amuse, entertain, delight</li></ol>
didhemedhi	<i>verb</i><br><ol><li>to divorce</li></ol>
difen	<i>verb</i><br><ol><li>to forbid, prohibit</li><li>(sports) to suspend</li></ol>
dillas|dhillas|dilasen|tillas	<i>noun</i><br><ol><li>clothes, clothing</li></ol>
divarva|dhivarva|tivarva	<i>verb</i><br><ol><li>to shave</li></ol>
dohajëdh	<i>noun</i><br><ol><li>afternoon</li></ol>
dohajÿdh	<i>noun</i><br><ol><li>afternoon</li></ol>
dor|tor|dorow|dhor	<i>noun</i><br><ol><li>ground, earth</li><li>Earth</li></ol>
dorgi	<i>noun</i><br><ol><li>terrier</li></ol>
dorn|torn|tornow|dhorn|tiwla|diwla|tewdhorn|dewdhorn|dhiwla|dhornow|dornow|dhewdhorn	<i>noun</i><br><ol><li>hand</li><li>fist</li><li>handle</li></ol>
dowr|dowrow|towr|dhowr	<i>noun</i><br><ol><li>water</li><li>urine</li><li>river, lake</li></ol>
dowr teudh|dowrow teudh	<i>noun</i><br><ol><li>meltwater</li></ol>
dowrgi|dhowrgi|towrgi|dowrgy|dowrgeun	<i>noun</i><br><ol><li>otter</li></ol>
dowrhe	<i>verb</i><br><ol><li>to water, to irrigate</li></ol>
dren|dreyn	<i>noun</i><br><ol><li>(botany) thorn</li></ol>
drenek	<i>adj</i><br><ol><li>thorny</li></ol>
dreys|dreysen	<i>noun</i><br><ol><li>brambles</li></ol>
drog|gweth|gwetha	<i>adj</i><br><ol><li>bad</li><li>evil, wicked</li></ol>
dry in rag	<i>verb</i><br><ol><li>to bring forth</li></ol>
du|tu|dhu	<i>adj</i><br><ol><li>black</li></ol>
duw|dhuw|tuw|duwow	<i>noun</i><br><ol><li>god (male deity)</li></ol>
duwes|duwesow	<i>noun</i><br><ol><li>goddess (female deity)</li></ol>
dybarth|dybarthow	<i>noun</i><br><ol><li>separation, division</li><li>departure</li></ol><br><i>verb</i><br><ol><li>to depart, to leave</li><li>to separate</li></ol>
dybedna	<i>verb</i><br><ol><li>to behead, to decapitate</li></ol>
dybenna	<i>verb</i><br><ol><li>to behead, to decapitate</li></ol>
dybri|tybri|dhybri	<i>verb</i><br><ol><li>to eat</li></ol>
dydh|dedhyow	<i>noun</i><br><ol><li>day</li></ol>
dydh da	<i>intj</i><br><ol><li>hello, good day</li></ol>
dyghow|tyghow|dhyghow	<i>adj</i><br><ol><li>right, right-handed</li><li>southern</li></ol>
dyghowbarth|tyghowbarth|dhyghowbarth	<i>noun</i><br><ol><li>south</li></ol>
dyskador|tyskador|dyskadoryon|dhyskador	<i>noun</i><br><ol><li>(male) teacher</li></ol>
dyskadores|dhyskadores|dyskadoresow|tyskadores	<i>noun</i><br><ol><li>(female) teacher</li></ol>
dyski	<i>verb</i><br><ol><li>(intransitive) to learn</li><li>(transitive) to teach, train, instruct</li></ol>
dysqwedhes	<i>verb</i><br><ol><li>show</li><li>appear</li></ol>
dyw|dhyw|tyw	<i>num</i><br><ol><li>two (before nouns)</li></ol>
dâ	<i>adj</i><br><ol><li>good</li></ol>
dëdh|dedhyow	<i>noun</i><br><ol><li>day</li></ol>
dÿdh|dedhyow	<i>noun</i><br><ol><li>day</li></ol>
ebron	<i>noun</i><br><ol><li>sky</li></ol>
edhen|edhyn|edhnow	<i>noun</i><br><ol><li>bird</li></ol>
efanvos	<i>noun</i><br><ol><li>space (astronomical)</li></ol>
eghen|eghennow|eghednow	<i>noun</i><br><ol><li>(ecology) species</li><li>kind, type, sort, variety</li></ol>
eghen beryllys|eghennow beryllys|eghednow beryllys	<i>noun</i><br><ol><li>(ecology) endangered species</li></ol>
eglos|eglosyow	<i>noun</i><br><ol><li>church</li></ol>
eglos teg|eglosyow teg	<i>noun</i><br><ol><li>temple</li></ol>
egyna	<i>verb</i><br><ol><li>sprout</li></ol>
ekologieth	<i>noun</i><br><ol><li>ecology</li></ol>
el|eledh	<i>noun</i><br><ol><li>(religion) angel</li></ol>
elin|dhewelin|elinnyow|tewelin|dewelin	<i>noun</i><br><ol><li>elbow</li></ol>
elyver|elyvrow	<i>noun</i><br><ol><li>e-book</li></ol>
en akord gen	<i>prep</i><br><ol><li>(Revived Late Cornish) consistent with</li></ol>
enep|enebow	<i>noun</i><br><ol><li>page</li><li>surface</li></ol>
enys|enesow	<i>noun</i><br><ol><li>(geography) island</li></ol>
er|erys|eres|eryon	<i>noun</i><br><ol><li>eagle</li><li>heir</li></ol>
ergh	<i>noun</i><br><ol><li>snow</li></ol>
escar|eskerens	<i>noun</i><br><ol><li>enemy</li></ol>
esedhva|esedhvaow	<i>noun</i><br><ol><li>sitting room, living room</li></ol>
esedhvos|esedhvosow	<i>noun</i><br><ol><li>eisteddfod (Welsh festival)</li></ol>
est	<i>noun</i><br><ol><li>east</li></ol>
ester|estren	<i>noun</i><br><ol><li>oysters</li></ol>
estren	<i>adj</i><br><ol><li>alien, strange</li></ol>
etegves|18ves	<i>adj</i><br><ol><li>eighteenth</li></ol>
etek	<i>num</i><br><ol><li>(Standard Written Form) eighteen</li></ol>
eth|ethen	<i>num</i><br><ol><li>eight</li></ol><br><i>noun</i><br><ol><li>scents</li></ol>
ethves|8ves	<i>adj</i><br><ol><li>eighth</li></ol>
ev	<i>pron</i><br><ol><li>he</li></ol>
eva	<i>verb</i><br><ol><li>to drink</li></ol>
evor|evoren	<i>noun</i><br><ol><li>hogweed</li></ol>
ewro|ewros	<i>noun</i><br><ol><li>EMU currency; a euro</li></ol>
ewyn|ewynen	<i>noun</i><br><ol><li>foam</li></ol>
eythin|eythinen	<i>noun</i><br><ol><li>furze, gorse</li></ol>
fatel	<i>adv</i><br><ol><li>how</li></ol>
fav|faven	<i>noun</i><br><ol><li>beans</li></ol>
faynt	<i>adj</i><br><ol><li>feeble</li></ol>
fayntys	<i>noun</i><br><ol><li>hypocrisy</li></ol>
filosofieth|filosofiethow	<i>noun</i><br><ol><li>philosophy</li></ol>
flogh|fleghes|fleghys	<i>noun</i><br><ol><li>child, kid, young person</li></ol>
flour|flourys|flowrys|flowr	<i>adj</i><br><ol><li>flower, choice (best of a collective)</li></ol><br><i>noun</i><br><ol><li>(botany) flower</li><li>flower (the best of a collective)</li></ol>
flows	<i>noun</i><br><ol><li>nonsense, idle talk</li></ol>
fon|fons	<i>noun</i><br><ol><li>telephone, phone</li></ol>
fon kodnyk|fons kodnyk	<i>noun</i><br><ol><li>smartphone</li></ol>
fon konnyk|fons konnyk	<i>noun</i><br><ol><li>smartphone</li></ol>
fordh|fordhow	<i>noun</i><br><ol><li>road</li><li>way, manner</li></ol>
forn|fornow	<i>noun</i><br><ol><li>oven</li></ol>
forn gorrdon|forn korrdon|fornow korrdon	<i>noun</i><br><ol><li>microwave oven</li></ol>
forsâkya	<i>verb</i><br><ol><li>to forsake, to abandon</li></ol>
fos|fosow	<i>noun</i><br><ol><li>wall</li></ol>
fosforos	<i>noun</i><br><ol><li>phosphorus</li></ol>
frenkek	<i>adj</i><br><ol><li>(Revived Late Cornish) French</li></ol>
frig|dhewfrik|frigow|dewfrik|tewfrik	<i>noun</i><br><ol><li>nostril</li></ol>
frigow	<i>noun</i><br><ol><li>nose</li></ol>
frooth|frothen	<i>noun</i><br><ol><li>fruit</li></ol>
frut|frutys	<i>noun</i><br><ol><li>fruit</li></ol>
frynkek	<i>adj</i><br><ol><li>French</li></ol>
frût|frûtys	<i>noun</i><br><ol><li>fruit</li></ol>
frûtwedhen|frûtwÿdh|frûtwëdh	<i>noun</i><br><ol><li>fruit tree</li></ol>
fug|fugyow	<i>noun</i><br><ol><li>feint, forgery</li></ol><br><i>adj</i><br><ol><li>counterfeit, fake, forged</li></ol>
fugya	<i>noun</i><br><ol><li>to forge, counterfeit</li></ol>
fylm|fylmow|fylmys	<i>noun</i><br><ol><li>film</li></ol>
fâss|fâssow	<i>noun</i><br><ol><li>(anatomy) face</li></ol>
fâssow	<i>noun</i><br><ol><li>(anatomy) faces</li><li>pretence, hypocrisy</li><li>threatening appearance</li></ol>
gallos|gyllyn ni|galsen ni|ow kallos|allos|gyllowgh|galla ev|gyllyn|gallons i|gylsyn ni|gylli jy|galles jy|gylles|gylliv vy|Pres-fut|gyllis vy|gallen vy|kallos|gyll ev|gallen ni|galles|gyllewgh hwi|galsa ev|gyllons i|gyll|gallewgh hwi|gallo ev|galses|gylli ev|gylles jy|galsens i|gylsys|gyller|gyllens i|galsewgh hwi|galses jy|gyllen vy|hallos|gyllydh jy|gyllen ni|gyllir|Verbal adjective: none|gallons|gallens i|gyllowgh hwi|gallas ev|gallav vy|galsen vy|gylsys jy|gylsowgh hwi	<i>verb</i><br><ol><li>can, be able</li></ol>
galow a-bell|kalow a-bell|halow a-bell|alow a-bell|galowyow a bell	<i>noun</i><br><ol><li>long-distance call</li></ol>
ganow|ganowow	<i>noun</i><br><ol><li>mouth</li></ol>
gans|gena jy|gansa|genama|genes|ganso (m)|gansans|ganjans|genen|genjy (f)|gena nei|gena hwei|gensy (f)|gena|gans ev (m)|genowgh|ganjo (m)|genev|gans anjei|genam|genef|gensi (f)|gans hei (f)	<i>prep</i><br><ol><li>with (in the company of)</li><li>with (expresses possession of something on one's person)</li><li>by (indicates the actor of a clause in the passive voice)</li><li>by (indicates the creator of a work)</li></ol>
gansip	<i>prep</i><br><ol><li>with</li></ol>
garan|garanes	<i>noun</i><br><ol><li>crane (bird)</li></ol>
garr|karr|garrow|tiwar|harrow|arr|dhiwar|diwar|karrow|harr|arrow|kerri	<i>noun</i><br><ol><li>(anatomy) leg</li></ol>
gell|kell|diwgell|kellow|hell|kellyow|hellyow|gellow|tiwgell|ell|hellow|dhiwgell|gellyow	<i>adj</i><br><ol><li>light brown</li></ol>
gelwel	<i>verb</i><br><ol><li>to call (on the phone)</li><li>to name (to give a name)</li></ol>
ger|geryow|ker|er|her|erys|eryon|eres	<i>noun</i><br><ol><li>word</li><li>saying</li><li>report</li></ol>
gerdhal	<i>adj</i><br><ol><li>dyslexic</li></ol>
gerdhelni	<i>noun</i><br><ol><li>(neurology) dyslexia</li></ol>
gerlyver|gerlyvrow	<i>noun</i><br><ol><li>dictionary</li></ol>
geryel	<i>adj</i><br><ol><li>verbal (about words)</li></ol>
gevell|hevell|evell|kevell|gevellas	<i>noun</i><br><ol><li>twin</li></ol>
gevelles|gevellesow	<i>noun</i><br><ol><li>(female) twin</li></ol>
gigabayt|gigabaytys	<i>noun</i><br><ol><li>gigabyte</li></ol>
glanhe	<i>verb</i><br><ol><li>to clean</li></ol>
glas|las|klas	<i>adj</i><br><ol><li>blue</li><li>green (of living things)</li><li>grey</li></ol>
glasrudh|klasrudh|lasrudh	<i>adj</i><br><ol><li>purple, bluish red</li></ol>
glaw|klaw|law	<i>noun</i><br><ol><li>rain</li></ol>
glawlen|klawlen|glawlennow|lawlen	<i>noun</i><br><ol><li>umbrella</li></ol>
gleb|leb|kleb	<i>adj</i><br><ol><li>wet</li></ol>
glin|lin|dewlin|klin|linen|dhewlin|linednow|linyow|glinyow|klinyow|tewlin|linennow	<i>noun</i><br><ol><li>knee</li></ol>
glusa	<i>verb</i><br><ol><li>to glue</li></ol>
glyb|klyb|lyb	<i>adj</i><br><ol><li>wet</li></ol>
gnasen|gnasennow	<i>noun</i><br><ol><li>trait</li></ol>
godhalek	<i>adj</i><br><ol><li>Irish</li></ol>
godhan|godhanes|kodhan|wodhan|wodhanes|hwodhanes|hwodhan|kodhanes	<i>noun</i><br><ol><li>moth</li></ol>
godhvos|godhvons|godhvens|godhvyn|ow kodhvos|godhyewgh|wodhvos|godhvowgh|godhyes|godhvedhewgh|godhves|godhvi|godhviv|Pres-fut|godhvia|godhons|hwodhvos|godhvedhes|godhva|godhowgh|godhya|godhvewgh|gonn|godhvev|godhes|Verbal adjective: godhvedhys|godhyens|gor|godhvedhyn|godhvies|godhvedhens|godhyen|godhvydh|godhviewgh|godhon|godher|kodhvos|godhven|godhviens|godhor|godhvo|godhvien	<i>verb</i><br><ol><li>know</li></ol>
goes|koes|hwoes|woes	<i>noun</i><br><ol><li>blood</li></ol>
gohi|gohien	<i>noun</i><br><ol><li>wasps</li></ol>
gol|wool|wol|kool|gol|gool|hwool|golyow|hwol|kol	<i>noun</i><br><ol><li>feast, fair</li><li>sail, veil</li></ol>
golhi	<i>verb</i><br><ol><li>to wash</li></ol>
golow|golowys	<i>noun</i><br><ol><li>light</li></ol>
gols	<i>noun</i><br><ol><li>hair</li></ol>
gonador|gonadoryon	<i>noun</i><br><ol><li>sower</li></ol>
goodh|woodh|hwoodh|koodh	<i>adj</i><br><ol><li>wild</li></ol>
goolan|hwoolan|woolan|golanes|koolan	<i>noun</i><br><ol><li>gull, seagull</li></ol>
goos|hwoos|wosow|koos|woos|hwosow|kosow|gosow	<i>noun</i><br><ol><li>blood</li><li>bloodline</li></ol>
gorbryvylejek	<i>adj</i><br><ol><li>privileged</li></ol>
gordhuwher	<i>adv</i><br><ol><li>in the evening</li></ol><br><i>noun</i><br><ol><li>evening</li></ol>
goredhom hin|goredhommow hin	<i>noun</i><br><ol><li>climate emergency</li></ol>
gorhel|gorholyon	<i>noun</i><br><ol><li>ship</li></ol>
gorlewin|korlewin|hworlewin|worlewin	<i>noun</i><br><ol><li>west</li></ol>
gorm|worm|korm|hworm	<i>adj</i><br><ol><li>dark brown</li></ol>
gorra|korra|worra|hworra	<i>verb</i><br><ol><li>to put, place, set</li></ol>
gorra a-bervedh|worra a-bervedh|korra a-bervedh|hworra a-bervedh	<i>verb</i><br><ol><li>to insert</li></ol>
gorra a-denewen|worra a-denewen|hworra a-denewen|korra a-denewen	<i>verb</i><br><ol><li>to set aside</li><li>to reverse</li></ol>
gortos	<i>verb</i><br><ol><li>to stay, wait, remain</li></ol><br><i>noun</i><br><ol><li>wait</li></ol>
grappa|grappys	<i>noun</i><br><ol><li>grape</li></ol>
greun|reunyon|kreun|greunen|reunes|reun	<i>noun</i><br><ol><li>grain</li></ol>
grows|growsen	<i>noun</i><br><ol><li>gooseberries</li></ol>
grug|wrug|krug|gruglon|hwrug|grugow	<i>noun</i><br><ol><li>heather</li></ol>
gul|gwrussowgh hwi|gwrewgh|gwrav vy|gwruss'ta|gwrelles jy|gwrewgh hwi|gwrens i|gwren|gwra ev|gwrellen ni|ow kul|gwrusses jy|wul|gwul|gwrussons i|gwryllyn ni|gwrugys jy|gwrug|gwrussens i|Verbal adjective: gwrys|gwrellys|gwrellens i|gwrussys|gwre ev|Pres-fut|gwrussen ni|gwrylli jy|ow kwul|gwrer|gwrellewgh hwi|gwres jy|gwrussyn ni|gwryllowgh hwi|gwrens|gwrellen vy|gwren vy|gwren ni|kwul|gwrons i|gwrello ev|gwrug vy|gwrellons i|gwrella ev|gwreller|hwul|gwre'ta|kul|gwrugav vy|gwrussewgh hwi|gwredh jy|gwres|gwrug ev|gwrylliv vy|gwrussen vy|gwrussa ev|gwra	<i>verb</i><br><ol><li>do, make</li></ol>
gun|gonyow	<i>noun</i><br><ol><li>plain</li></ol>
gwag	<i>adj</i><br><ol><li>empty</li><li>hungry</li></ol>
gwariell|gwariellow	<i>noun</i><br><ol><li>toy</li></ol>
gwav|gwavow	<i>noun</i><br><ol><li>(Standard Written Form) winter</li></ol>
gwaynten	<i>noun</i><br><ol><li>spring (season)</li></ol>
gwedh|gwedhennow|gwedhen	<i>noun</i><br><ol><li>(Revived Late Cornish) trees</li></ol>
gwedh krabbys|gwedhen krabbys	<i>noun</i><br><ol><li>(Revived Late Cornish) crabapple trees</li></ol>
gwedhan jiraff|hwedhan jiraff|gwedhan jiraff|kwedhan jiraff|gwedhanes jiraff|wedhan jiraff	<i>noun</i><br><ol><li>giraffe weevil</li></ol>
gwedhen grappys	<i>noun</i><br><ol><li>grapevine</li></ol>
gwegbys|gwegbysen	<i>noun</i><br><ol><li>vetches</li></ol>
gwegbys an ke|gwegbysen an ke	<i>noun</i><br><ol><li>bush vetches</li></ol>
gwel|gwelen	<i>noun</i><br><ol><li>rods, sticks</li></ol>
gwel kala|gwelen gala|gwelynni kala|gwelydni kala	<i>noun</i><br><ol><li>straw</li></ol>
gwelednik|gwelenigow	<i>noun</i><br><ol><li>(Revived Late Cornish) chopstick</li></ol>
gwelennik|gwelenigow	<i>noun</i><br><ol><li>chopstick</li></ol>
gweles|gwello|gwellons|gwelsens|Verbal adjective: gwelys|gwelsyn|ow kweles|gweli|gwelav|gwela|gwelyn|Pres-fut|gwelsons|gwelowgh|gwellewgh|gwelsen|kweles|gwelli|gwelis|gwelsys|gweller|gwelydh|gwelas|gwellens|gwellyn|gwellowgh|weles|gwelsa|gwelsowgh|gwella|hweles|gwelir|gwelen|gwelles|gwellen|gwelliv|gwel|gwelens|gwelses|gwelons|gwelsewgh|gwelewgh|gwellys	<i>verb</i><br><ol><li>to see</li></ol>
gwels|wels|gwelsen|hwels|kwels	<i>noun</i><br><ol><li>grass</li></ol>
gwelsen	<i>noun</i><br><ol><li>blade of grass</li></ol>
gwenen|wenen|hwenen|kwenen|gwenenen|hwenenen|kwenenen|wenenen	<i>noun</i><br><ol><li>bees</li></ol>
gwenton	<i>noun</i><br><ol><li>(Standard Written Form) spring (season)</li></ol>
gwenyn|hwenyn|kwenyn|gwenenen|hwenenen|kwenenen|wenenen|gwenyn|wenyn	<i>noun</i><br><ol><li>(Standard Cornish) bees</li><li>(Standard Cornish) poison</li></ol>
gwer|kwer|hwer|wer	<i>adj</i><br><ol><li>(artificial) green</li></ol>
gwern|gwernen	<i>noun</i><br><ol><li>alders</li><li>mast</li><li>swamp</li></ol>
gwerthji|gwerthjiow	<i>noun</i><br><ol><li>shop</li></ol>
gweus|weusyow|hweusyow|kweus|kweusyow|gweusyow|dhiwweus|tiwweus|diwweus|weus|hweus	<i>noun</i><br><ol><li>lip</li></ol>
gwewen|gwewennow|hwewen|tiwwewen|wewennow|dhiwwewen|diwwewen|kwewen|hwewennow|kwewennow|wewen	<i>noun</i><br><ol><li>heel</li></ol>
gwiasva|gwiasvaow|kwiasva|wiasva|gwiasva|hwiasva	<i>noun</i><br><ol><li>website</li></ol>
gwibes|gwibesen	<i>noun</i><br><ol><li>gnats, midges</li></ol>
gwin|gwyn	<i>noun</i><br><ol><li>wine</li></ol>
gwithyas kres|gwithysi kres	<i>noun</i><br><ol><li>policeman</li></ol>
gwiver|wivren|gwivren|kwivren|gwivrow|hwivren	<i>noun</i><br><ol><li>wire</li></ol>
gwlanek|kwlanek|hwlanek|wlanek	<i>adj</i><br><ol><li>woollen, woolly</li></ol>
gwlascor|gwlascordhow	<i>noun</i><br><ol><li>kingdom</li></ol>
gwragh|gwraghes	<i>noun</i><br><ol><li>old woman</li><li>witch</li></ol>
gwrek|gwrageth	<i>noun</i><br><ol><li>wife</li></ol>
gwreydh|gwreydhen	<i>noun</i><br><ol><li>roots</li></ol>
gwydh|gwedhennow|kwydh|wydh|hwydh|gwedhen	<i>noun</i><br><ol><li>trees</li></ol>
gwydh krabbys|gwedhen krabbys	<i>noun</i><br><ol><li>crabapple trees</li></ol>
gwydhbol	<i>noun</i><br><ol><li>chess</li></ol>
gwynn|hwydn|kwydn|wynn|wydn|kwynn|gwydn|hwynn	<i>adj</i><br><ol><li>white</li><li>fair</li><li>blessed</li></ol>
gwynnrudh|wynnrudh|hwynnrudh|kwynnrudh	<i>adj</i><br><ol><li>pink, pale red</li></ol>
gwyrdh|hwyrdh|kwyrdh|wyrdh	<i>adj</i><br><ol><li>(artificial) green</li></ol>
gwythi|hwythien|wythi|hwythi|wythien|gwythien|kwythi|kwythien	<i>noun</i><br><ol><li>veins</li></ol>
gwâv|gwavow	<i>noun</i><br><ol><li>(Standard Cornish) winter</li></ol>
gwëdh|gwedhennow|gwedhen	<i>noun</i><br><ol><li>trees</li></ol>
gwÿdh|gwedhennow|gwedhen	<i>noun</i><br><ol><li>trees</li></ol>
gà	<i>det</i><br><ol><li>(Standard Cornish) Short for aga.</li></ol>
ha	<i>conj</i><br><ol><li>and</li><li>while</li></ol>
ha'n	<i>abbrev</i><br><ol><li>and the</li></ol>
hag	<i>conj</i><br><ol><li>and</li></ol>
hanaf|hanafow	<i>noun</i><br><ol><li>cup</li></ol>
hanow|henwyn	<i>noun</i><br><ol><li>name</li><li>(grammar) noun</li></ol>
hanow gwan|henwyn gwan	<i>noun</i><br><ol><li>(grammar) adjective</li></ol>
hansel|hanselyow	<i>noun</i><br><ol><li>breakfast</li></ol>
hanterkans	<i>num</i><br><ol><li>fifty</li></ol>
has|hasednow|hasen|hasennow	<i>noun</i><br><ol><li>seeds</li></ol>
hav|havyow|havow	<i>noun</i><br><ol><li>(Standard Written Form) summer</li></ol>
havi	<i>verb</i><br><ol><li>to pass or spend the summer, to summer</li></ol>
heb ahwer	<i>prep_phrase</i><br><ol><li>readily</li></ol>
hebtu	<i>adj</i><br><ol><li>neutral</li></ol>
hedhi	<i>verb</i><br><ol><li>to stop, cease, halt</li><li>to cancel</li><li>to pause</li></ol>
helyk|helygen	<i>noun</i><br><ol><li>willows</li></ol>
heptu	<i>adj</i><br><ol><li>neutral, nonaligned</li></ol>
herdhya	<i>verb</i><br><ol><li>to push, shove</li></ol>
hern|hernen|hernennow	<i>noun</i><br><ol><li>pilchards, sardines</li></ol>
hern gwydn|hernen wydn	<i>noun</i><br><ol><li>(Revived Late Cornish) herrings</li></ol>
hern gwynn|hernen wynn	<i>noun</i><br><ol><li>herrings</li></ol>
hernen|hernennow	<i>noun</i><br><ol><li>pilchard, sardine</li></ol>
hi	<i>pron</i><br><ol><li>she (third-person feminine singular personal pronoun).</li></ol>
hil|hilyow	<i>noun</i><br><ol><li>race, ethnicity</li></ol>
hilegydh|hilegydhyon	<i>noun</i><br><ol><li>racist</li></ol>
hilgaswas|hilgaswesyon	<i>noun</i><br><ol><li>racist</li></ol>
hireth	<i>noun</i><br><ol><li>homesickness for a home to which you cannot return, or for a home which may have never been</li><li>an intense form of longing or nostalgia, wistfulness</li><li>the grief for the lost places of your past</li></ol>
hogen|hogednow|hoggan|hogennow	<i>noun</i><br><ol><li>pie</li></ol>
hogh|hohes	<i>noun</i><br><ol><li>pig</li></ol>
hos	<i>noun</i><br><ol><li>duck (aquatic bird of the family Anatidae)</li></ol>
howl|howlyow	<i>noun</i><br><ol><li>sun</li></ol>
howldrehevel	<i>noun</i><br><ol><li>east</li></ol>
howldrevel	<i>noun</i><br><ol><li>east</li></ol>
howlsedhes	<i>noun</i><br><ol><li>west</li></ol>
hujes	<i>adj</i><br><ol><li>(Revived Late Cornish) enormous, huge</li></ol>
hwarthus	<i>noun</i><br><ol><li>funny, comic</li><li>laughable, ridiculous, ludicrous</li></ol>
hweg	<i>adj</i><br><ol><li>sweet</li><li>gentle, kind, nice, pleasant, pleasing</li><li>dear (in letters)</li></ol>
hwegh	<i>num</i><br><ol><li>six</li></ol>
hweghves|6ves	<i>adj</i><br><ol><li>sixth</li></ol>
hwegyn|hwegednow|hwegennow	<i>noun</i><br><ol><li>sweet, candy</li></ol>
hwegys|hwegysen	<i>noun</i><br><ol><li>maize</li></ol>
hwegysen	<i>noun</i><br><ol><li>kernel of maize</li></ol>
hwel	<i>noun</i><br><ol><li>mine</li></ol>
hwenn|hwennen	<i>noun</i><br><ol><li>weeds</li></ol>
hwesker|hweskeren	<i>noun</i><br><ol><li>insects</li></ol>
hwetegves|16ves	<i>adj</i><br><ol><li>sixteenth</li></ol>
hwetek	<i>num</i><br><ol><li>(Standard Written Form) sixteen</li></ol>
hwethans|hwethanjow	<i>noun</i><br><ol><li>inflation, an increase of size</li><li>(economics) inflation</li></ol>
hwi	<i>pron</i><br><ol><li>(Standard Written Form) you (formal or plural)</li></ol>
hwibana	<i>verb</i><br><ol><li>to whistle</li></ol>
hwiski|hwiskiow	<i>noun</i><br><ol><li>whiskey, whisky</li></ol>
hwor|hwerydh	<i>noun</i><br><ol><li>sister</li></ol>
hwypp|hwyppys	<i>noun</i><br><ol><li>whip</li></ol>
hwyppya	<i>verb</i><br><ol><li>to whip</li></ol>
hwystra	<i>verb</i><br><ol><li>to whisper</li></ol>
hwythans|hwythansow	<i>noun</i><br><ol><li>inflation, an increase of size</li><li>(economics) inflation</li></ol>
hy	<i>det</i><br><ol><li>her (possessive determiner)</li></ol><br><i>pron</i><br><ol><li>she</li><li>her</li></ol>
hyli	<i>noun</i><br><ol><li>salt water</li></ol>
hyr	<i>adj</i><br><ol><li>long</li></ol>
hâv|havyow|havow	<i>noun</i><br><ol><li>(Standard Cornish) summer (season)</li></ol>
i	<i>pron</i><br><ol><li>they</li></ol>
idhyow|idhyowen	<i>noun</i><br><ol><li>ivy</li></ol>
ikon|ikonys	<i>noun</i><br><ol><li>icon</li></ol>
ikonek	<i>adj</i><br><ol><li>iconic</li></ol>
ilewydh|ilewydhyon	<i>noun</i><br><ol><li>(male) musician</li></ol>
ilewydhes|ilewydhesow	<i>noun</i><br><ol><li>(female) musician</li></ol>
ilow	<i>noun</i><br><ol><li>music</li></ol>
in gwetha prës	<i>adv</i><br><ol><li>unfortunately</li></ol>
in gwetha prÿs	<i>adv</i><br><ol><li>unfortunately</li></ol>
indella	<i>adv</i><br><ol><li>thus (in that way; accordingly)</li></ol>
indelma	<i>adv</i><br><ol><li>thus (in this way)</li></ol>
indelna	<i>adv</i><br><ol><li>thus (in that way)</li></ol>
inwedh	<i>adv</i><br><ol><li>also, as well</li></ol>
iskarga	<i>verb</i><br><ol><li>to download</li></ol>
islinya	<i>verb</i><br><ol><li>to underline</li></ol>
isotop|isotopow	<i>noun</i><br><ol><li>(physics) isotope</li></ol>
isotopek	<i>adj</i><br><ol><li>isotopic</li></ol>
isrudh	<i>adj</i><br><ol><li>infrared</li></ol>
istitla	<i>verb</i><br><ol><li>to subtitle</li></ol>
iwerdhonek	<i>adj</i><br><ol><li>Irish</li></ol>
jiraff|jiraffes	<i>noun</i><br><ol><li>giraffe</li></ol>
jorna	<i>noun</i><br><ol><li>day</li></ol>
juj	<i>noun</i><br><ol><li>judge</li></ol>
jy	<i>pron</i><br><ol><li>you (informal second person singular pronoun)</li><li>thou</li><li>thee</li></ol>
jyn	<i>noun</i><br><ol><li>(Standard Cornish) device, engine, machine, motor</li></ol>
jyn tedna|jynys tedna	<i>noun</i><br><ol><li>(Standard Cornish) tractor</li></ol>
jyn tenna|jynys tenna	<i>noun</i><br><ol><li>(Standard Cornish) tractor</li></ol>
jynn|jynnow|jynnys	<i>noun</i><br><ol><li>engine, machine, motor</li></ol>
jynn amontya|jynnow amontya|jynnys amontya	<i>noun</i><br><ol><li>computer</li></ol>
jynnskrifa	<i>verb</i><br><ol><li>to type</li></ol>
kador|hadoryow|gadoryow|gador|hador|kadoryow	<i>noun</i><br><ol><li>chair, seat</li></ol>
kal|kalghyow	<i>noun</i><br><ol><li>(anatomy) penis</li></ol>
kala	<i>noun</i><br><ol><li>straw (collective)</li></ol>
kalaven|kalavennow|kalavednow	<i>noun</i><br><ol><li>straw</li></ol>
kales	<i>adj</i><br><ol><li>hard, tough (resistant to pressure)</li><li>hard, difficult (not easy)</li><li>hard-bitten</li></ol>
kalester	<i>noun</i><br><ol><li>pebble</li></ol>
kaletter|kaletterow|kaletteryow	<i>noun</i><br><ol><li>difficulty, hardness</li><li>(Tregear) calamity</li></ol>
kalgh|kalghyow	<i>noun</i><br><ol><li>(anatomy) penis</li><li>(mineralogy) lime, limestone</li></ol>
kamfor	<i>noun</i><br><ol><li>camphor</li></ol>
kantol|gantolyow|hantolyow|hantol|gantol|kantolyow	<i>noun</i><br><ol><li>candle</li></ol>
kantolbren|kantolbrennyer|gantolbrennyer|kantolbrenn|hantolbrennyer|gantolbrenn|hantolbrenn	<i>noun</i><br><ol><li>candlestick</li></ol>
kanyon	<i>noun</i><br><ol><li>canyon</li></ol>
kara|karrens|karav|karewgh|kares|karsa|kersys|karsens|kersowgh|karsewgh|Verbal adjective: kerys|kerryn|kyrrer|kerowgh|kerir|karses|kersons|karren|karsen|Pres-fut|keris|karrons|karsys|karro|kerydh|karrys|kar|karen|karrewgh|kerrowgh|kyrri|gara|ow kara|karres|hara|karas|karons|karens|keryn|kersyn|kyrriv|karra	<i>verb</i><br><ol><li>to love</li></ol>
kardamon	<i>noun</i><br><ol><li>cardamom</li></ol>
karetys|karetysen	<i>noun</i><br><ol><li>carrots</li></ol>
karigell|harigell|karigellow|garigell	<i>noun</i><br><ol><li>trolley, shopping cart</li></ol>
karow|kerewi|garow|harow	<i>noun</i><br><ol><li>deer, stag</li></ol>
karr|tiwar|garrow|harrow|arr|garr|dhiwar|diwar|karrow|harr|arrow|kerri	<i>noun</i><br><ol><li>car</li></ol>
karrek|karrygi|harrek|kerrek|garrek	<i>noun</i><br><ol><li>rock, stone</li></ol>
karrostel|harrostel|karrostelyow|garrostel	<i>noun</i><br><ol><li>motel</li></ol>
karten rudh|kartennow rudh|kartednow rudh	<i>noun</i><br><ol><li>red card</li></ol>
kasel|hlunyow|kaselyow|diwgasel|tiwgasel|klunyow|glunyow|gaselyow|gasel|dhiwgasel|haselyow|hasel	<i>noun</i><br><ol><li>armpit</li></ol>
kasiterit	<i>noun</i><br><ol><li>cassiterite</li></ol>
kath|hath|gath|kathes	<i>noun</i><br><ol><li>cat</li></ol>
kavach|kavajys	<i>noun</i><br><ol><li>cabbage</li></ol>
kavos|kaves|y'n jevo|kevowgh|kevyn|kyffi|kevir|kaffens|y'th o|y's jevydh|Pres-fut|y's jeffo|y'gan bydh|kevsowgh|kaffys|y'n jevedha|y' fe|kavons|y'th eus|y's tevo|kevsys|y'm beu|y'gan be|Verbal adjective: kevys|kavens|y'gas beu|y' feu|future|kavsens|y'm bydh|y's tevedha|y's tevydh|y's teffa|y'n jeves|kyffer|y'n jevydh|y'gan bedha|kevsons|y's teves|y'gan beu|y'gan bo|kaffewgh|kyffiv|y's jeva|y'm beus|kaffo|kav|y'gas bedha|kavewgh|kaffons|kevis|y's teva|kaffa|havos|y'n jeffa|kavsewgh|gavos|y's jeves|Verbal adjective: (not used)|y' fo|kaffes|y's jeffa|kavav|kavsys|y'm bo|keffyn|kavses|kaven|y' fedha|y'm be|y's teffo|y'n jeva|y'm bedha|y'n jeffo|kevydh|kavos|kava|kavas|y's jevo|y's jevedha|kavsa|y' fydh|y'gas bydh|y'gan beus|kevsyn|y'gas bo|keffowgh|y'gas beus|y'gas be|kaffen|ow kavos|kavsen	<i>verb</i><br><ol><li>to have</li><li>to find</li></ol>
kayak	<i>noun</i><br><ol><li>kayak</li></ol>
keek	<i>adj</i><br><ol><li>hedged</li></ol>
kegin|hegin|keginow|gegin	<i>noun</i><br><ol><li>kitchen</li></ol>
kegis|kegisen	<i>noun</i><br><ol><li>hemlocks</li></ol>
kegis hweg|kegisen hweg	<i>noun</i><br><ol><li>celery</li></ol>
keher|heheren|geher|keheren|heher|geheren	<i>noun</i><br><ol><li>muscles</li></ol>
kell|kell|diwgell|kellow|hell|kellyow|gell|hellyow|gellow|tiwgell|ell|hellow|dhiwgell|gellyow	<i>noun</i><br><ol><li>testicle</li><li>cell</li></ol>
kellgowser|kellgowsoryon	<i>noun</i><br><ol><li>mobile phone, cell phone</li></ol>
kelli	<i>name</i><br><ol><li>Wood</li></ol>
kelyon|kelyonen|gelyon|helyon	<i>noun</i><br><ol><li>flies</li></ol>
kelyon garan|kelyonen aran	<i>noun</i><br><ol><li>craneflies</li></ol>
kelyon kig|kelyonen gig	<i>noun</i><br><ol><li>bluebottles</li></ol>
kelyon margh|kelyonen vargh	<i>noun</i><br><ol><li>gadflies</li></ol>
kemmyn	<i>adj</i><br><ol><li>(Kernowek Standard) common, ordinary</li></ol>
kemper|kemperyow	<i>noun</i><br><ol><li>confluence</li></ol>
kenes|kenesen	<i>noun</i><br><ol><li>(Revived Late Cornish) spiders</li></ol>
kenn|henn|kennow|genn	<i>noun</i><br><ol><li>peel, scum, skin</li></ol>
kennek	<i>adj</i><br><ol><li>scummy</li></ol>
kennen|kennow|gennen|hennen	<i>noun</i><br><ol><li>film, membrane</li></ol>
kennin|keninen	<i>noun</i><br><ol><li>garlic</li></ol>
kensa	<i>adj</i><br><ol><li>first</li></ol>
kenyver	<i>adj</i><br><ol><li>each, every, all</li></ol>
kenyver den	<i>pron</i><br><ol><li>everybody, everyone</li></ol>
kenyver onen	<i>pron</i><br><ol><li>everyone</li><li>every single one</li></ol>
ker	<i>noun</i><br><ol><li>Hard mutation of ger.</li></ol>
kerdhes	<i>verb</i><br><ol><li>walk</li></ol>
keredhi	<i>verb</i><br><ol><li>to scold, reproach, tell off, rebuke</li></ol>
kerensa	<i>noun</i><br><ol><li>love</li><li>charity</li></ol>
keres|keresen	<i>noun</i><br><ol><li>cherries</li></ol>
kerrik|herrik|gerrik|kerrigow	<i>noun</i><br><ol><li>cart, carriage</li></ol>
kervya	<i>verb</i><br><ol><li>to carve</li></ol>
keschanjya	<i>verb</i><br><ol><li>to exchange, interchange, swap</li></ol>
keskreuni	<i>verb</i><br><ol><li>to concentrate</li></ol>
keslowena	<i>noun</i><br><ol><li>congratulations</li></ol>
keslowenhe	<i>verb</i><br><ol><li>to congratulate</li></ol>
kespos|kesposow|gespos|hespos	<i>noun</i><br><ol><li>balance, equilibrium</li></ol>
kespos arghantti|kesposow arghantti|hespos arghantti|gespos arghantti	<i>noun</i><br><ol><li>bank balance</li></ol>
kesten|kestenen	<i>noun</i><br><ol><li>chestnuts</li></ol>
kethreydhel	<i>adj</i><br><ol><li>homosexual, gay</li></ol>
keunegi|keunegen|keunegennow|keunegednow	<i>noun</i><br><ol><li>bogs</li></ol>
keunys|keunysen	<i>noun</i><br><ol><li>firewood</li></ol>
kevelek|hevelek|keveloges|gevelek	<i>noun</i><br><ol><li>woodcock</li></ol>
kevnis|kevnisen	<i>noun</i><br><ol><li>spiders</li></ol>
kewargh|kewarhen	<i>noun</i><br><ol><li>hemp</li></ol>
kewsel	<i>verb</i><br><ol><li>to speak, talk</li></ol>
ki|hi|hei|keun|geun|kei|gi|heun|gei	<i>noun</i><br><ol><li>dog</li></ol>
kig|kigyow	<i>noun</i><br><ol><li>meat, flesh</li></ol>
kig bewin	<i>noun</i><br><ol><li>beef</li></ol>
kig bowin	<i>noun</i><br><ol><li>(Revived Late Cornish) beef</li></ol>
kig dens|kigyow dens|gig dens|higyow dens|hig dens|gigyow dens	<i>noun</i><br><ol><li>(anatomy) gum</li></ol>
kig leugh	<i>noun</i><br><ol><li>veal</li></ol>
kig mogh	<i>noun</i><br><ol><li>pork</li></ol>
kig porhel	<i>noun</i><br><ol><li>pork</li></ol>
kig yar	<i>noun</i><br><ol><li>chicken (meat)</li></ol>
kiger|kigoryon	<i>noun</i><br><ol><li>butcher</li></ol>
kigliw|gigliw|higliw	<i>adj</i><br><ol><li>pink</li><li>flesh-coloured</li></ol>
kigti|kigtiow	<i>noun</i><br><ol><li>butcher's, butcher shop</li></ol>
kilokalori|kilokaloris	<i>noun</i><br><ol><li>kilocalorie</li></ol>
klapkodh|klapkodhow	<i>noun</i><br><ol><li>mobile phone, cell phone</li></ol>
kledh|hledh|gledh	<i>adj</i><br><ol><li>left, left-handed</li><li>northern</li></ol>
kledhbarth|hledhbarth|gledhbarth	<i>noun</i><br><ol><li>north</li></ol>
klin	<i>noun</i><br><ol><li>Hard mutation of glin.</li></ol>
klock|hlock|klockow|glock|klockys	<i>noun</i><br><ol><li>clock</li></ol>
klun|hlunyow|tiwglun|klunyow|dhiwglun|glunyow|diwglun|hlun|glun	<i>noun</i><br><ol><li>hip</li></ol>
klyji|klyjienn	<i>noun</i><br><ol><li>toffee</li></ol>
klys	<i>adj</i><br><ol><li>cosy, snug</li></ol>
know|hnow|knowen|knofen|gnow	<i>noun</i><br><ol><li>nuts</li></ol>
know Frynk|knowen Frynk|knofen Frenk	<i>noun</i><br><ol><li>walnuts</li></ol>
know dor|knowen dor|knofen|knowen|knofen dor|know|hnow|gnow	<i>noun</i><br><ol><li>peanuts</li></ol>
know toos|gnow toos|hnow toos|knowen doos	<i>noun</i><br><ol><li>doughnuts</li></ol>
kober	<i>noun</i><br><ol><li>copper</li></ol>
kobmol|komolen	<i>noun</i><br><ol><li>(Standard Written Form, Revived Late Cornish) clouds</li></ol>
kocha|kochys	<i>noun</i><br><ol><li>carriage</li></ol>
kocha debri|kochow debri	<i>noun</i><br><ol><li>(Revived Late Cornish) dining car</li></ol>
kocha dybri|kochow dybri	<i>noun</i><br><ol><li>dining car</li></ol>
kogh|hogh|gogh	<i>adj</i><br><ol><li>blood-red, crimson, scarlet</li></ol>
kok	<i>noun</i><br><ol><li>coke/treated coal</li><li>fishing boat</li></ol>
kol	<i>noun</i><br><ol><li>Hard mutation of gol.</li></ol>
kollel|kelylli	<i>noun</i><br><ol><li>knife</li></ol>
kolodhyon|holodhyonen|kolodhyn|golodhyn|golodhyonen|kolodhyonen|holodhyn	<i>noun</i><br><ol><li>guts</li></ol>
koltrebyn|koltrebynnyer|holtrebynnyer|holtrebyn|goltrebyn|goltrebynnyer	<i>noun</i><br><ol><li>candlestick</li></ol>
kolyn|holyn|kelyn|golyn	<i>noun</i><br><ol><li>puppy, cub</li></ol>
kommol|kommolenn|komolen	<i>noun</i><br><ol><li>(Standard Written Form, Kernewek Kemmyn) clouds</li></ol>
konin|konines	<i>noun</i><br><ol><li>rabbit</li></ol>
konna|honaow|gonna|gonaow|konaow|honna	<i>noun</i><br><ol><li>neck</li></ol>
konna bregh|honna bregh|tewgonna bregh|dewgonna bregh|gonna bregh|konaow bregh|dhewgonna bregh|gonaow bregh|honaow bregh	<i>noun</i><br><ol><li>wrist</li></ol>
konsel	<i>noun</i><br><ol><li>(local government) A council</li></ol>
kool	<i>noun</i><br><ol><li>Hard mutation of gool.</li></ol>
kor|koren	<i>noun</i><br><ol><li>wax</li></ol>
koriander	<i>noun</i><br><ol><li>coriander</li></ol>
korrdon|korrdonnow|horrdon|gorrdon	<i>noun</i><br><ol><li>microwave</li></ol>
korset|korsettys	<i>noun</i><br><ol><li>corset</li></ol>
kosmek	<i>adj</i><br><ol><li>cosmic</li></ol>
kosmos	<i>noun</i><br><ol><li>cosmos</li></ol>
kost|host|gostow|kost|gost|kostys|hostow|kostow	<i>noun</i><br><ol><li>cost, charge, expense</li><li>coast, district, region</li></ol>
kovskrifa	<i>verb</i><br><ol><li>to register</li></ol>
kowar'|kowarhen	<i>noun</i><br><ol><li>(Revived Late Cornish) hemp</li></ol>
kowl|kowlen	<i>noun</i><br><ol><li>kale</li><li>cabbages</li></ol>
kowles|kowlesen	<i>noun</i><br><ol><li>jelly</li></ol>
kowlleski	<i>verb</i><br><ol><li>to burn up, consume by fire</li></ol>
kowlniver|kowlniverow	<i>noun</i><br><ol><li>integer</li></ol>
kowlwerth|gowlwerth|kowlwerth|howlwerth	<i>adj</i><br><ol><li>wholesale</li></ol>
kowlwertha	<i>verb</i><br><ol><li>to sell wholesale</li></ol>
kowlys|howlys|kowlys|gowlys	<i>adj</i><br><ol><li>clotted, curdled</li></ol>
kows	<i>verb</i><br><ol><li>to speak, talk</li></ol>
kowsel	<i>verb</i><br><ol><li>to speak, talk</li></ol>
krackya	<i>verb</i><br><ol><li>to break, crack</li></ol>
krampoth|krampothen	<i>noun</i><br><ol><li>pancakes</li></ol>
kras|krasen	<i>noun</i><br><ol><li>toast</li></ol><br><i>adj</i><br><ol><li>toasted</li></ol>
krasa	<i>verb</i><br><ol><li>to parch, toast</li></ol>
krasen	<i>noun</i><br><ol><li>piece of toast</li></ol>
kreslu|kresluyow	<i>noun</i><br><ol><li>police, police force</li></ol>
kreswas|kreswesyon	<i>noun</i><br><ol><li>policeman</li><li>(rugby) centre</li></ol>
kreun	<i>noun</i><br><ol><li>Hard mutation of greun.</li></ol>
krev|grev|hrev|crev	<i>adj</i><br><ol><li>strong</li><li>mighty</li><li>vigorous</li></ol>
kreyth|kreythen	<i>noun</i><br><ol><li>scars</li></ol>
kronek|kronogow	<i>noun</i><br><ol><li>toad</li></ol>
kuntel|guntel|kuntellow|huntel	<i>noun</i><br><ol><li>collection</li></ol><br><i>verb</i><br><ol><li>to collect, to pick, to gather, to accumulate</li></ol>
kuntilow	<i>noun</i><br><ol><li>(music) album</li></ol>
kunys|keunysen	<i>noun</i><br><ol><li>(Revived Late Cornish) firewood</li></ol>
kussyn|kussynnow|kussydnow	<i>noun</i><br><ol><li>kiss</li></ol>
kwedhan jiraff|hwedhan jiraff|gwedhan jiraff|kwedhan jiraff|gwedhanes jiraff|wedhan jiraff	<i>noun</i><br><ol><li>Hard mutation of gwedhan jiraff.</li></ol>
kwenen	<i>noun</i><br><ol><li>Hard mutation of gwenen.</li></ol>
kwiasva|hwiasva|wiasva|gwiasva	<i>adj</i><br><ol><li>Hard mutation of gwiasva.</li></ol>
kwilkyn|hwilkyn|hwilkynyow|gwilkyn|kwilkynyow|gwilkynyow	<i>noun</i><br><ol><li>frog</li></ol>
ky|keun|geun|gy|heun|hy	<i>noun</i><br><ol><li>(Standard Cornish) dog</li></ol>
kydnyaf	<i>noun</i><br><ol><li>(Standard Cornish) autumn, fall (season)</li></ol>
kymyk	<i>adj</i><br><ol><li>chemical</li></ol>
kynda|kyndys	<i>noun</i><br><ol><li>kind</li></ol>
kynnyaf	<i>noun</i><br><ol><li>(Standard Cornish) autumn, fall (season)</li></ol>
kynnyav|kynnyavow	<i>noun</i><br><ol><li>(Standard Written Form) autumn</li></ol>
kynsa|1a|gynsa|hynsa	<i>adj</i><br><ol><li>first</li></ol>
kynyaf	<i>noun</i><br><ol><li>(Standard Cornish) autumn, fall (season)</li></ol>
kyv kov|kyvyon kov|hyv kov|gyv kov	<i>noun</i><br><ol><li>(computing) memory stick</li></ol>
lagas|dewlagas|tewlagas|dhewlagas|lagasow	<i>noun</i><br><ol><li>(anatomy) eye</li></ol>
lasogeth	<i>noun</i><br><ol><li>alcoholism</li></ol>
lebmyn	<i>adv</i><br><ol><li>now</li></ol>
ledan	<i>adj</i><br><ol><li>broad</li></ol>
leel	<i>adj</i><br><ol><li>local</li></ol>
legryas	<i>noun</i><br><ol><li>corruption</li><li>decadence</li></ol>
lel	<i>adj</i><br><ol><li>genuine, loyal, reliable, trusty</li></ol>
lemmel	<i>verb</i><br><ol><li>jump/hop/leap</li></ol>
lemmyn	<i>adv</i><br><ol><li>now</li></ol>
lenel	<i>verb</i><br><ol><li>fill</li></ol>
lesel	<i>adj</i><br><ol><li>beneficial</li></ol>
leth	<i>noun</i><br><ol><li>milk</li></ol>
lether|letherow	<i>noun</i><br><ol><li>letter, epistle</li></ol>
leugh|leuhi	<i>noun</i><br><ol><li>calf (young cow)</li></ol>
leuv|tiwla|leuvyow|diwla|dhiwla	<i>noun</i><br><ol><li>hand, arm</li></ol>
leverel	<i>verb</i><br><ol><li>to say</li><li>to tell</li><li>to pronounce</li></ol>
lew|lewyon	<i>noun</i><br><ol><li>lion</li></ol>
lewes|lewesow	<i>noun</i><br><ol><li>lioness</li></ol>
lewpard|lewpardes	<i>noun</i><br><ol><li>leopard</li></ol>
lewya	<i>verb</i><br><ol><li>to drive</li></ol>
lewydh|lewydhyon	<i>noun</i><br><ol><li>(male) president, helmsman</li></ol>
lewydhes|lewydhesow	<i>noun</i><br><ol><li>(female) president, helmsman</li></ol>
leys|leysyow	<i>noun</i><br><ol><li>mud, slime</li></ol>
lien|liennow	<i>noun</i><br><ol><li>literature</li></ol>
liesskrif|liesskrifow	<i>noun</i><br><ol><li>photocopy</li></ol>
liesskrifa	<i>verb</i><br><ol><li>to photocopy</li></ol>
lili|lilien	<i>noun</i><br><ol><li>lilies</li></ol>
limaval|limavalow	<i>noun</i><br><ol><li>(fruit) lime</li></ol>
lin|linednow|linen|linennow	<i>noun</i><br><ol><li>linen</li></ol>
linas|linasen	<i>noun</i><br><ol><li>nettles</li></ol>
linen|linednow|linennow	<i>noun</i><br><ol><li>thread</li></ol>
livrel	<i>adj</i><br><ol><li>liberal</li></ol>
liw|liwyow	<i>noun</i><br><ol><li>colour</li><li>paint, dye</li></ol>
lo|loyow	<i>noun</i><br><ol><li>spoon</li></ol>
logos|logojen|logosen|logosennow	<i>noun</i><br><ol><li>mice</li></ol>
logos broas|logojen vroas	<i>noun</i><br><ol><li>(Revived Late Cornish) rats</li></ol>
logosen|logosennow	<i>noun</i><br><ol><li>mouse</li></ol>
lojow|lojowen	<i>noun</i><br><ol><li>(Revived Late Cornish) plants, herbs</li></ol>
lojow debri|lojowen dhebri	<i>noun</i><br><ol><li>vegetables</li></ol>
loor|loryow	<i>noun</i><br><ol><li>moon</li></ol>
loos	<i>adj</i><br><ol><li>grey</li></ol>
losk|loskow	<i>noun</i><br><ol><li>burn</li></ol>
losk an vriansen	<i>noun</i><br><ol><li>bronchitis</li></ol>
losow|losowys|losowen	<i>noun</i><br><ol><li>plants, herbs</li></ol>
losow kegin|losowen gegin	<i>noun</i><br><ol><li>vegetables</li></ol>
losow mogh|losowen vogh	<i>noun</i><br><ol><li>hogweed</li></ol>
losowen|losowys	<i>noun</i><br><ol><li>plant, herb</li></ol>
lost	<i>noun</i><br><ol><li>A tail.</li><li>(informal) a cock, a penis.</li></ol>
lostya	<i>verb</i><br><ol><li>to queue</li></ol>
lowarn|lewern	<i>noun</i><br><ol><li>fox</li></ol>
lowen	<i>adj</i><br><ol><li>happy, glad</li></ol>
lowenhe	<i>verb</i><br><ol><li>(intransitive) to rejoice</li><li>(transitive) to make happy, delight</li></ol>
luhes|luhesen	<i>noun</i><br><ol><li>lightning</li></ol>
lym	<i>adj</i><br><ol><li>sharp, pointed</li></ol>
lymmaval|lymmavalow	<i>noun</i><br><ol><li>lemon</li></ol>
lyther|lytherow	<i>noun</i><br><ol><li>letter, epistle</li></ol>
lytherva|lythervaow	<i>noun</i><br><ol><li>post office</li></ol>
lyver|lyvrow	<i>noun</i><br><ol><li>book</li></ol>
lyverva|levervaow|lyvervaow|leverva	<i>noun</i><br><ol><li>library</li></ol>
mab|mebyon|fab|vab	<i>noun</i><br><ol><li>son</li><li>male child, boy</li></ol>
mab-wydn|mebyon-wydn|\|m\|mebyon-wydn}}	<i>noun</i><br><ol><li>grandson</li></ol>
mab-wynn|\|m\|mebyon-wynn}}|mebyon-wynn	<i>noun</i><br><ol><li>grandson</li></ol>
maghteth|maghtythyon|maghtethyon	<i>name</i><br><ol><li>maid, maiden</li></ol>
mamm|famm|vamm|mabmow|mabm|mammow	<i>noun</i><br><ol><li>mother</li></ol>
mamm-wynn|\|f\|mammow-wynn}}	<i>noun</i><br><ol><li>grandmother</li></ol>
manbluv|manbluven	<i>noun</i><br><ol><li>down (fine feathers)</li></ol>
mango|fango|mangos|vango	<i>noun</i><br><ol><li>mango</li></ol>
mann	<i>adv</i><br><ol><li>at all</li></ol><br><i>noun</i><br><ol><li>nothing, nil</li></ol><br><i>num</i><br><ol><li>zero</li></ol>
map|mebyow	<i>noun</i><br><ol><li>son</li><li>boy</li></ol>
margh|fargh|merhes|fergh|vargh|mergh|vergh	<i>noun</i><br><ol><li>horse</li></ol>
margh asen|mergh asen	<i>noun</i><br><ol><li>jackass</li></ol>
margh leska|mergh leska	<i>noun</i><br><ol><li>rocking horse</li></ol>
margh skrifa|mergh skrifa|margh-skrifa|mergh-skrifa	<i>noun</i><br><ol><li>easel</li></ol>
mathematigel	<i>adj</i><br><ol><li>mathematical</li></ol>
maw	<i>noun</i><br><ol><li>boy</li></ol>
me	<i>pron</i><br><ol><li>(Standard Cornish) I, me</li></ol>
medh|fedh|vedh	<i>noun</i><br><ol><li>mead</li></ol>
mel|vel|fel	<i>noun</i><br><ol><li>honey</li></ol>
melhwes|melhwesen|velhwes|felhwes|melhwyjen	<i>noun</i><br><ol><li>snails</li><li>slugs</li></ol>
mellyon|melyonen	<i>noun</i><br><ol><li>violets</li></ol>
melyn|felyn|velyn	<i>adj</i><br><ol><li>yellow</li></ol>
melynrudh|velynrudh|felynrudh	<i>adj</i><br><ol><li>orange, yellowish red</li></ol>
melys|felys|velys	<i>adj</i><br><ol><li>sweet, sugary</li></ol>
menestrouthy	<i>noun</i><br><ol><li>instrumental music</li></ol>
mergh|mergh|merhes|fergh|vergh	<i>noun</i><br><ol><li>(Revived Late Cornish) daughter, girl</li></ol>
meskel|mesklen	<i>noun</i><br><ol><li>mussels</li></ol>
meur|veur|feur	<i>adj</i><br><ol><li>great</li></ol>
meur ras	<i>intj</i><br><ol><li>thanks, thank you</li></ol>
milonieth	<i>noun</i><br><ol><li>zoology</li></ol>
milva|milvaow	<i>noun</i><br><ol><li>zoo</li></ol>
mim	<i>noun</i><br><ol><li>mime, mimic</li></ol>
min|minen	<i>noun</i><br><ol><li>kids (young goats)</li></ol>
mis Du	<i>adv</i><br><ol><li>in November (month)</li></ol><br><i>name</i><br><ol><li>November (month)</li></ol>
mis Ebrel	<i>adv</i><br><ol><li>in April</li></ol><br><i>name</i><br><ol><li>April</li></ol>
mis Efen	<i>adv</i><br><ol><li>in June (month)</li></ol><br><i>name</i><br><ol><li>June (month)</li></ol>
mis Est	<i>adv</i><br><ol><li>in August (month)</li></ol><br><i>name</i><br><ol><li>August (month)</li></ol>
mis Genver	<i>adv</i><br><ol><li>in January</li></ol><br><i>name</i><br><ol><li>January</li></ol>
mis Gorefen	<i>adv</i><br><ol><li>in July (month)</li></ol><br><i>name</i><br><ol><li>July (month)</li></ol>
mis Gortheren	<i>adv</i><br><ol><li>in July (month)</li></ol><br><i>name</i><br><ol><li>July (month)</li></ol>
mis Gwydngala	<i>adv</i><br><ol><li>in September (month)</li></ol><br><i>name</i><br><ol><li>September (month)</li></ol>
mis Gwynngala	<i>adv</i><br><ol><li>in September (month)</li></ol><br><i>name</i><br><ol><li>September (month)</li></ol>
mis Hedra	<i>adv</i><br><ol><li>in October (month)</li></ol><br><i>name</i><br><ol><li>October (month)</li></ol>
mis Kevardhu	<i>adv</i><br><ol><li>in December (month)</li></ol><br><i>name</i><br><ol><li>December (month)</li></ol>
mis Me	<i>adv</i><br><ol><li>in May (month)</li></ol><br><i>name</i><br><ol><li>May (month)</li></ol>
mis Merth	<i>adv</i><br><ol><li>in March (month)</li></ol><br><i>name</i><br><ol><li>March (month)</li></ol>
mis Metheven	<i>adv</i><br><ol><li>in June (month)</li></ol><br><i>name</i><br><ol><li>June (month)</li></ol>
mis Whevrel	<i>adv</i><br><ol><li>in February</li></ol><br><i>name</i><br><ol><li>February</li></ol>
mogh|vogh|fogh	<i>noun</i><br><ol><li>pigs, swine</li></ol>
mols	<i>noun</i><br><ol><li>wether</li><li>sheep</li></ol>
mona|monyes	<i>noun</i><br><ol><li>money, cash, change</li></ol>
moos|foos|mosow|voos	<i>noun</i><br><ol><li>table</li></ol>
mor|mor|moren|for|voren|vor|moryow|morenyow|foren	<i>noun</i><br><ol><li>sea</li><li>berries</li></ol>
mor du|vor du|foren du|moren du|voren du|for du|moren dhu	<i>noun</i><br><ol><li>blackberries</li></ol>
morek	<i>adj</i><br><ol><li>maritime</li></ol>
moren|morenyow|foren|voren|moren	<i>noun</i><br><ol><li>maiden</li></ol>
morgi|morgeun	<i>noun</i><br><ol><li>dogfish</li></ol>
morgowles|morgowlesen	<i>noun</i><br><ol><li>jellyfish</li></ol>
morhogh|forhohes|vorhogh|vorhohes|morhohes|forhogh	<i>noun</i><br><ol><li>porpoise</li><li>dolphin</li></ol>
morlader|morladron	<i>noun</i><br><ol><li>(male) pirate</li></ol>
morladres|devisoresow|morladresow	<i>noun</i><br><ol><li>(female) pirate</li></ol>
morthol|mortholow|vorthol|forthol	<i>noun</i><br><ol><li>hammer</li></ol>
morvil|morviles	<i>noun</i><br><ol><li>whale</li></ol>
morvleydh|forvleydh|morvleydhes|vorvleydh	<i>noun</i><br><ol><li>shark</li></ol>
moryon|moryonennow|moryonen	<i>noun</i><br><ol><li>ants</li><li>(derogatory) tourists</li></ol>
moryonen|moryonennow	<i>noun</i><br><ol><li>ant</li></ol>
mos a-dro|vos a-dro|fos a-dro	<i>verb</i><br><ol><li>to get about</li></ol>
mosek	<i>adj</i><br><ol><li>stinky</li></ol>
mowes|mowesi	<i>noun</i><br><ol><li>girl</li></ol>
my	<i>pron</i><br><ol><li>I, me</li></ol>
my'tern|my'ternyow	<i>noun</i><br><ol><li>(Revived Late Cornish) king</li></ol>
my'ternes|my'ternesow	<i>noun</i><br><ol><li>queen</li></ol>
myghtern|myghternedh	<i>noun</i><br><ol><li>king</li></ol>
myghternes|myghternesow	<i>noun</i><br><ol><li>queen</li></ol>
mynn|mynnen	<i>noun</i><br><ol><li>kids (baby goats)</li></ol>
mynnes|mynnen ni|mynsen ni|mynnens i|mynsys jy|mynnys|mynnis vy|mynnowgh hwi|mynnons i|mynsens i|mynnens|mynnyn|mynna ev|mynn|mynniv vy|mynnes jy|mynnyn ni|Pres-fut|mynses|mynnen vy|mynnas ev|mynsyn ni|mynsys|mynnowgh|mynnydh jy|mynnewgh hwi|mynsowgh hwi|mynses jy|mynsons i|mynn ev|mynno ev|mynni jy|Verbal adjective: mynnys|mynsen vy|mynsa ev|mynnav vy|mynnir|mynner|ow mynnes|mynsewgh hwi|vynnes|fynnes	<i>verb</i><br><ol><li>to will, to wish</li></ol>
myrgh|myrhes|myrghes|fyrgh|vyrgh	<i>noun</i><br><ol><li>daughter</li><li>girl</li></ol>
mytern|myterneth|myternow|myternedh	<i>noun</i><br><ol><li>king</li></ol>
myternes|myternesow	<i>noun</i><br><ol><li>queen</li></ol>
myttin|myttinow	<i>noun</i><br><ol><li>morning</li></ol>
myttyn	<i>noun</i><br><ol><li>(Standard Cornish) morning</li></ol>
mìn	<i>noun</i><br><ol><li>kids (young goats)</li></ol>
mûsyk	<i>noun</i><br><ol><li>(Standard Cornish) music</li></ol>
na borth ahwer	<i>phrase</i><br><ol><li>don't worry</li></ol>
na'gan	<i>abbrev</i><br><ol><li>nor our</li></ol>
nagonen	<i>pron</i><br><ol><li>nobody, no one</li></ol>
nasya	<i>verb</i><br><ol><li>to affect</li></ol>
naw	<i>num</i><br><ol><li>nine</li></ol>
nawnjek	<i>num</i><br><ol><li>(Standard Cornish) nineteen</li></ol>
nawnsek	<i>num</i><br><ol><li>(Common Cornish) nineteen</li></ol>
nawves|9ves	<i>adj</i><br><ol><li>ninth</li></ol>
nebonen	<i>pron</i><br><ol><li>anyone, anybody</li><li>someone, somebody</li></ol>
neghi	<i>verb</i><br><ol><li>to fret</li></ol>
nen	<i>noun</i><br><ol><li>ceiling</li></ol>
neppyth	<i>pron</i><br><ol><li>something</li></ol>
nerth|nerthyow|nerthow	<i>noun</i><br><ol><li>force</li><li>energy</li><li>power</li><li>strength</li></ol>
nessa|2a	<i>adj</i><br><ol><li>second</li><li>next</li></ol>
neus|neusen|neujen	<i>noun</i><br><ol><li>threads</li></ol>
neuvyer|neuvyoryon	<i>noun</i><br><ol><li>a male swimmer</li></ol>
neuvyores|neuvyoresow	<i>noun</i><br><ol><li>a female swimmer</li></ol>
nev|nevow	<i>noun</i><br><ol><li>heaven</li></ol>
nivel|nivelyow	<i>noun</i><br><ol><li>level</li></ol>
north	<i>noun</i><br><ol><li>north</li></ol>
north-est	<i>noun</i><br><ol><li>north-east</li></ol>
north-west	<i>noun</i><br><ol><li>northwest</li></ol>
norvës	<i>noun</i><br><ol><li>Earth</li><li>world</li></ol>
norvÿs	<i>noun</i><br><ol><li>Earth</li><li>world</li></ol>
nos|nosow	<i>noun</i><br><ol><li>night</li><li>mark</li><li>token</li></ol>
nos da	<i>phrase</i><br><ol><li>good night</li></ol>
nownsegves|19ves	<i>adj</i><br><ol><li>nineteenth</li></ol>
nownsek	<i>num</i><br><ol><li>(Standard Written Form) nineteen</li></ol>
nownsek ha peswar ugens	<i>num</i><br><ol><li>ninety-nine</li></ol>
nowodhow	<i>noun</i><br><ol><li>news</li></ol>
nowydh	<i>adj</i><br><ol><li>(Common Cornish, Standard Written Form) new</li></ol>
nowyth	<i>adj</i><br><ol><li>(Standard Cornish) new</li></ol>
nuklerek	<i>adj</i><br><ol><li>nuclear</li></ol>
ny	<i>particle</i><br><ol><li>not</li></ol><br><i>pron</i><br><ol><li>we</li><li>us</li></ol>
ny wrav vy kewsel sowsnek	<i>phrase</i><br><ol><li>I don't speak English</li></ol>
obma	<i>adv</i><br><ol><li>here (in or to this place)</li></ol>
oferen	<i>noun</i><br><ol><li>mass, eucharist</li></ol>
oksyjen	<i>noun</i><br><ol><li>oxygen</li></ol>
oles	<i>noun</i><br><ol><li>hearth, fireplace</li></ol>
olew	<i>noun</i><br><ol><li>olive oil</li></ol>
olifans|olifanses	<i>noun</i><br><ol><li>elephant</li></ol>
oliv|oliven	<i>noun</i><br><ol><li>olives</li></ol>
omdhivarva	<i>verb</i><br><ol><li>to shave one's beard off</li></ol>
omma	<i>adv</i><br><ol><li>here (in or to this place)</li></ol>
omwolhi	<i>verb</i><br><ol><li>to wash (oneself)</li></ol>
on|en	<i>noun</i><br><ol><li>lamb</li></ol>
onan	<i>num</i><br><ol><li>one</li></ol>
onen	<i>num</i><br><ol><li>(Standard Cornish, Standard Written Form) one</li></ol>
onyon|onyonen	<i>noun</i><br><ol><li>onions</li></ol>
ors|orses	<i>noun</i><br><ol><li>bear</li></ol>
ostel|ostelyow	<i>noun</i><br><ol><li>hotel, hostel</li></ol>
ostel yowynkneth|ostelyow yowynkneth	<i>noun</i><br><ol><li>youth hostel</li></ol>
ostes|ostesow	<i>noun</i><br><ol><li>hostess</li></ol>
owr	<i>noun</i><br><ol><li>gold</li></ol>
owra	<i>verb</i><br><ol><li>to gild</li></ol>
owraval|owravalow	<i>noun</i><br><ol><li>orange (fruit)</li></ol>
owrek	<i>adj</i><br><ol><li>golden</li></ol>
owryek	<i>adj</i><br><ol><li>golden</li></ol>
oy|oyow	<i>noun</i><br><ol><li>egg</li></ol>
oyl|oylys	<i>noun</i><br><ol><li>oil</li></ol>
p'eur	<i>adv</i><br><ol><li>when</li></ol>
palmwedh|palmwedhen	<i>noun</i><br><ol><li>(Revived Late Cornish) palm trees</li></ol>
palmwydh|palmwedhen	<i>noun</i><br><ol><li>palm trees</li></ol>
palores|falores|balores|paloresow	<i>noun</i><br><ol><li>chough</li></ol>
palv|balv|balvow|palvow|falvow|falv	<i>noun</i><br><ol><li>palm</li></ol>
paper	<i>noun</i><br><ol><li>paper</li></ol>
paper fos	<i>noun</i><br><ol><li>wallpaper</li></ol>
parth|parthow	<i>noun</i><br><ol><li>part, zone, side</li></ol>
pasti|basti|fasti	<i>noun</i><br><ol><li>pasty</li></ol>
patatys|patatysen	<i>noun</i><br><ol><li>potatoes</li></ol>
peder	<i>num</i><br><ol><li>(Standard Cornish) four</li></ol>
pedncita|pedncitys	<i>noun</i><br><ol><li>(Revived Late Cornish) capital (city)</li></ol>
pednseythen|pednseythednow	<i>noun</i><br><ol><li>weekend</li></ol>
pedrek|fedrek|pedrogow|bedrek	<i>noun</i><br><ol><li>square</li></ol>
pedren|bedrennow|fedrennow|bedren|diwbedren|fedren|pedrennow	<i>noun</i><br><ol><li>bottom, buttock, haunch</li></ol>
pegh	<i>noun</i><br><ol><li>sin</li></ol>
pehas|pehosow	<i>noun</i><br><ol><li>sin</li></ol>
pellgowsel|pellgowsellow	<i>noun</i><br><ol><li>(Revived Middle Cornish) mobile phone, cell phone</li></ol>
pempbes|pempbeses	<i>noun</i><br><ol><li>(Revived Late Cornish) starfish</li></ol>
penn|benn|fenn|fennow|bennow|pennow	<i>noun</i><br><ol><li>head</li><li>top</li><li>end</li></ol>
penncita|penncitys	<i>noun</i><br><ol><li>capital (city)</li></ol>
pennscol|pennscolyow	<i>noun</i><br><ol><li>university</li></ol>
pennseythen|pennseythennow	<i>noun</i><br><ol><li>weekend</li></ol>
pennskol|pennskolyow	<i>noun</i><br><ol><li>university</li></ol>
per|peren	<i>noun</i><br><ol><li>pears</li></ol>
perna	<i>verb</i><br><ol><li>(Revived Late Cornish) to buy</li></ol>
perr	<i>adj</i><br><ol><li>Hard mutation of berr.</li></ol>
persil|persilen	<i>noun</i><br><ol><li>parsley</li></ol>
peryl|feryl|beryl|peryllyow	<i>noun</i><br><ol><li>danger, peril, risk</li></ol>
peryllys|peryllys|beryllys|feryllys	<i>adj</i><br><ol><li>endangered</li></ol>
pes|pesen	<i>noun</i><br><ol><li>(Revived Late Cornish) peas</li></ol>
pesk|fesk|puskes|besk	<i>noun</i><br><ol><li>(Revived Late Cornish) fish</li></ol>
peswar|feswar|beswar|peder	<i>num</i><br><ol><li>four</li></ol>
peswar ugens|beswar ugens|feswar ugens	<i>num</i><br><ol><li>eighty</li></ol>
peswara	<i>adj</i><br><ol><li>fourth</li></ol>
peswardhegves|14ves|feswardhegves|beswardhegves	<i>adj</i><br><ol><li>fourteenth</li></ol>
peswardhek|beswardhek|feswardhek	<i>num</i><br><ol><li>(Standard Written Form) fourteen</li></ol>
peswora|feswora|beswora|4a	<i>adj</i><br><ol><li>fourth</li></ol>
peth|feth|beth|pethow	<i>noun</i><br><ol><li>thing</li></ol><br><i>pron</i><br><ol><li>(interrogative) what</li></ol>
peuns|peunsow	<i>noun</i><br><ol><li>pound (currency unit)</li></ol>
pies|piesen	<i>noun</i><br><ol><li>magpies</li></ol>
pin|pinen	<i>noun</i><br><ol><li>pines</li></ol>
pinaval|pinavalow|finaval|binaval	<i>noun</i><br><ol><li>pineapple</li></ol>
piw|biw|fiw	<i>pron</i><br><ol><li>(interrogative) who</li></ol>
plans|plansow	<i>noun</i><br><ol><li>plant</li></ol>
platinom	<i>noun</i><br><ol><li>platinum</li></ol>
plisk|plisken	<i>noun</i><br><ol><li>eggshells</li></ol>
ploum|ploumen	<i>noun</i><br><ol><li>plums</li></ol>
ploum segh|ploumen segh	<i>noun</i><br><ol><li>(Revived Late Cornish) prunes</li></ol>
ploum sygh|ploumen sygh	<i>noun</i><br><ol><li>prunes</li></ol>
pluv|pluvednow|fluven|fluv|bluven|pluvennow|pluven|bluv	<i>noun</i><br><ol><li>feathers</li><li>pens</li></ol>
pluven|pluvednow|bluven|pluvennow|fluven	<i>noun</i><br><ol><li>pen</li></ol>
po	<i>conj</i><br><ol><li>or</li></ol>
pob	<i>pron</i><br><ol><li>everyone, everybody</li></ol>
pobas	<i>verb</i><br><ol><li>to bake</li></ol>
pocket|pocketys|pocketow	<i>noun</i><br><ol><li>pocket</li></ol>
pocket ayr|pocketow ayr|pocketys ayr	<i>noun</i><br><ol><li>air pocket</li></ol>
politegieth	<i>noun</i><br><ol><li>politics</li></ol>
politegieth a-bervedh	<i>noun</i><br><ol><li>domestic politics, internal affairs</li></ol>
politegieth keswlasek	<i>noun</i><br><ol><li>international relations, international politics</li></ol>
pons|ponsow	<i>noun</i><br><ol><li>bridge</li></ol>
ponsfordh|ponsfordhow	<i>noun</i><br><ol><li>viaduct</li></ol>
por|poren	<i>noun</i><br><ol><li>leeks</li></ol>
pore	<i>noun</i><br><ol><li>Hard mutation of bore.</li></ol>
porhel|porhelli	<i>noun</i><br><ol><li>pig</li></ol>
porhel dor|porhellow dor	<i>noun</i><br><ol><li>aardvark</li></ol>
porhellik|forhellik|borhellik|porheligow	<i>noun</i><br><ol><li>piglet</li></ol>
post|postow	<i>noun</i><br><ol><li>post (method of sending mail)</li></ol>
pow|powyow	<i>noun</i><br><ol><li>country, land</li><li>province, region</li></ol>
pras|fras|vras|bras|pras	<i>adj</i><br><ol><li>Hard mutation of bras.</li></ol>
prev|brev|preves|frev	<i>noun</i><br><ol><li>(Revived Late Cornish) Alternative form of pryv</li></ol>
proas	<i>adj</i><br><ol><li>Hard mutation of broas.</li></ol>
pronn	<i>noun</i><br><ol><li>Hard mutation of bronn.</li></ol>
pronter|prontyryon	<i>noun</i><br><ol><li>priest, cleric</li></ol>
prys	<i>noun</i><br><ol><li>time; season</li></ol>
prysk|prysken	<i>noun</i><br><ol><li>bushes</li></ol>
pryv|bryv|prevyon|preves|fryv	<i>noun</i><br><ol><li>insect</li><li>worm</li></ol>
prës|prejyow	<i>noun</i><br><ol><li>time, occasion</li></ol>
prÿs|prejyow	<i>noun</i><br><ol><li>time, occasion</li></ol>
pugh	<i>noun</i><br><ol><li>Hard mutation of bugh.</li></ol>
pur|fur|bur	<i>adj</i><br><ol><li>pure, absolute</li></ol>
pur lowen	<i>adj</i><br><ol><li>delighted</li></ol>
purpur|furpur|burpur	<i>adj</i><br><ol><li>purple</li></ol>
pyffyer|fyffyer|fyffyers|byffyers|byffyer|pyffyers	<i>noun</i><br><ol><li>dolphin</li></ol>
pymp|bymp|fymp	<i>num</i><br><ol><li>five</li></ol>
pympbys|pympbyses	<i>noun</i><br><ol><li>starfish</li></ol>
pympes|bympes|5es|fympes	<i>adj</i><br><ol><li>fifth</li></ol>
pymthegves|bymthegves|15ves|fymthegves	<i>adj</i><br><ol><li>fifteenth</li></ol>
pymthek|fymthek|bymthek	<i>num</i><br><ol><li>(Standard Written Form) fifteen</li></ol>
pys|pesen	<i>noun</i><br><ol><li>peas</li></ol>
pysk|pùscas|fysk|puskes|bysk	<i>noun</i><br><ol><li>fish</li></ol>
pyskador|pyskadoryon	<i>noun</i><br><ol><li>fisherman</li></ol>
pyth|byth|fyth|pythow	<i>noun</i><br><ol><li>thing</li></ol><br><i>pron</i><br><ol><li>(interrogative) what</li></ol>
pò	<i>conj</i><br><ol><li>(Standard Cornish) or</li></ol>
pùb	<i>adj</i><br><ol><li>each, every</li></ol>
pùb huny	<i>pron</i><br><ol><li>everyone</li></ol>
pùbonen	<i>pron</i><br><ol><li>everyone</li></ol>
queth|quethow	<i>verb</i><br><ol><li>(nautical) breasthook</li></ol>
radar	<i>noun</i><br><ol><li>radar</li></ol>
rath|rathes	<i>noun</i><br><ol><li>rat</li></ol>
reden|redenen	<i>noun</i><br><ol><li>ferns</li></ol>
redik|redigen	<i>noun</i><br><ol><li>radishes</li></ol>
resek	<i>verb</i><br><ol><li>to run (refers both to rivers and to people)</li></ol>
reser	<i>noun</i><br><ol><li>(male) runner</li></ol>
reun|reunes|reunyon	<i>noun</i><br><ol><li>seal (animal)</li></ol>
rewer	<i>noun</i><br><ol><li>freezer</li></ol>
rewlya	<i>verb</i><br><ol><li>to rule</li></ol>
rewweresonieth	<i>noun</i><br><ol><li>cryopedology</li></ol>
ris|risen	<i>noun</i><br><ol><li>rice</li></ol>
risen	<i>noun</i><br><ol><li>grain of rice</li></ol>
rolya	<i>verb</i><br><ol><li>to roll</li></ol>
rom|romys	<i>noun</i><br><ol><li>room (in a house)</li></ol>
rom gortos|romys gortos	<i>noun</i><br><ol><li>waiting room</li></ol>
ros|rosow|rosen|rosyow	<i>noun</i><br><ol><li>A wheel.</li><li>A heathland.</li><li>roses</li></ol>
rudh	<i>adj</i><br><ol><li>red</li></ol>
rudhlas	<i>adj</i><br><ol><li>purple, reddish blue</li></ol>
rudhvelyn	<i>adj</i><br><ol><li>orange, reddish yellow</li></ol>
rudhwynn	<i>adj</i><br><ol><li>pink, reddish white</li></ol>
ruwvanes|ruwvanesow	<i>noun</i><br><ol><li>queen</li></ol>
ruwvaneth|ruwvanethow	<i>noun</i><br><ol><li>kingdom</li></ol>
ry	<i>verb</i><br><ol><li>to give</li></ol>
sab|saben	<i>noun</i><br><ol><li>pines</li></ol>
sagh|seghyer	<i>name</i><br><ol><li>bag, sack</li></ol>
salami|salamis	<i>noun</i><br><ol><li>salami</li></ol>
salm	<i>noun</i><br><ol><li>A psalm</li></ol>
scol|scolyow	<i>noun</i><br><ol><li>school</li></ol>
scovarnak|scovarnogas	<i>noun</i><br><ol><li>(Standard Cornish) hare (herbivorous mammal)</li></ol>
secùnd	<i>adj</i><br><ol><li>second</li></ol>
segh	<i>adj</i><br><ol><li>(Revived Late Cornish) dry, dried</li><li>(Revived Late Cornish) arid</li></ol>
selsik|selsigennow|selsigen	<i>noun</i><br><ol><li>sausages</li></ol>
sempel	<i>adj</i><br><ol><li>simple, primitive, homely, ordinary</li></ol>
senedh|senedhow	<i>noun</i><br><ol><li>parliament, congress, assembly, senate</li></ol>
seres	<i>noun</i><br><ol><li>craftswoman</li></ol>
settya	<i>verb</i><br><ol><li>to set, to place, to put</li></ol>
seudhel|seudhelyow	<i>noun</i><br><ol><li>(anatomy) heel</li></ol>
sevi|sevy|sevien	<i>noun</i><br><ol><li>strawberries</li></ol>
seytegves|17ves	<i>adj</i><br><ol><li>seventeenth</li></ol>
seytek	<i>num</i><br><ol><li>(Standard Written Form) seventeen</li></ol>
seyth	<i>num</i><br><ol><li>seven</li></ol>
seythen|seythennow|seythednow	<i>noun</i><br><ol><li>week</li></ol>
seythves|7ves	<i>adj</i><br><ol><li>seventh</li></ol>
shap adamant|shapys adamant	<i>noun</i><br><ol><li>lozenge</li></ol>
shoppa|shoppys	<i>noun</i><br><ol><li>shop</li><li>workshop</li></ol>
silikon	<i>noun</i><br><ol><li>silicon</li></ol>
sin|sînys	<i>noun</i><br><ol><li>sign</li></ol>
sira|sirys	<i>noun</i><br><ol><li>sire, father</li></ol>
sira-wydn|\|m\|sirys-gwydn}}	<i>noun</i><br><ol><li>grandfather</li></ol>
skaw|skawen	<i>noun</i><br><ol><li>elder trees</li></ol>
skobm|skobmow|skobmyn	<i>noun</i><br><ol><li>(Revived Late Cornish) chip</li><li>(Revived Late Cornish) splinters</li></ol>
skol|skolyow	<i>noun</i><br><ol><li>school</li></ol>
skomm|skommow|skommyn	<i>noun</i><br><ol><li>chip (food)</li><li>splinters</li></ol>
skons|skonsen	<i>noun</i><br><ol><li>scones</li></ol>
skoodh|skodhow|diwskodh|tiwskodh|dhiwskodh	<i>noun</i><br><ol><li>shoulder</li></ol>
skorr|skorren|skorrow	<i>noun</i><br><ol><li>branches</li><li>branch</li></ol>
skovarn|tiwskovarn|dhiwskovarn|diwskovarn|skovornow	<i>noun</i><br><ol><li>ear</li><li>handle (of a jar)</li></ol>
skrif|skrifow	<i>noun</i><br><ol><li>article, document</li></ol>
skrifa	<i>verb</i><br><ol><li>to write</li></ol>
skudel|skudellow	<i>noun</i><br><ol><li>bowl, dish, plate</li></ol>
skydnya	<i>verb</i><br><ol><li>descend</li></ol>
skynnya	<i>verb</i><br><ol><li>descend</li></ol>
snod|snodys	<i>noun</i><br><ol><li>ribbon, tape</li></ol>
sobm|sobmen|somednow	<i>noun</i><br><ol><li>(Revived Late Cornish) sums</li></ol>
sodhva|sodhvaow	<i>noun</i><br><ol><li>office</li></ol>
sodhva an post|sodhvaow an post	<i>noun</i><br><ol><li>post office</li></ol>
somm|somennow|sommen	<i>noun</i><br><ol><li>sums</li></ol>
sonskrifa	<i>verb</i><br><ol><li>(audio) to record</li></ol>
sos	<i>noun</i><br><ol><li>friend/mate/pal</li></ol>
soth	<i>noun</i><br><ol><li>south</li></ol>
soth-est	<i>noun</i><br><ol><li>south-east</li></ol>
soth-west	<i>noun</i><br><ol><li>south-west</li></ol>
sowsnek	<i>adj</i><br><ol><li>English</li></ol>
sowter	<i>noun</i><br><ol><li>A psalter</li></ol>
spern|spernen	<i>noun</i><br><ol><li>thornbushes</li></ol>
spern du|spernen dhu	<i>noun</i><br><ol><li>blackthorns</li></ol>
spern gwydn|spernen wydn	<i>noun</i><br><ol><li>(Revived Late Cornish) hawthorns</li></ol>
spern gwynn|spernen wynn	<i>noun</i><br><ol><li>hawthorns</li></ol>
spernek	<i>adj</i><br><ol><li>thorny</li></ol>
spethas|spedhasen	<i>noun</i><br><ol><li>briars</li></ol>
splann	<i>adj</i><br><ol><li>bright, luminous</li><li>great, fantastic</li></ol>
spyrys|spyrysyon|spyryjyon	<i>noun</i><br><ol><li>spirit</li><li>fairy</li></ol>
stat|statys|statow	<i>noun</i><br><ol><li>(politics) state, polity</li><li>situation, state, affair</li><li>estate</li></ol>
sten	<i>noun</i><br><ol><li>tin</li></ol>
ster|sterednow|sterennow|steren	<i>noun</i><br><ol><li>stars</li></ol>
stervarner|stervarnoryon	<i>noun</i><br><ol><li>(male) astronaut</li></ol>
stervarnores|stervarnoresow	<i>noun</i><br><ol><li>(female) astronaut</li></ol>
stevel|stevellow	<i>noun</i><br><ol><li>room (in a house)</li></ol>
stevel dhebri|stevellow debri	<i>noun</i><br><ol><li>(Revived Late Cornish) dining room</li></ol>
stevel dhybri|stevellow dybri	<i>noun</i><br><ol><li>dining room</li></ol>
stevel omwolhi|stevellow omwolhi|stevellow omwolghi|stevel omwolghi	<i>noun</i><br><ol><li>bathroom</li></ol>
stevel wortos|stevellow gortos	<i>noun</i><br><ol><li>waiting room</li></ol>
stif|stifow	<i>noun</i><br><ol><li>A jet, squirt; a stream of fluid or gas</li><li>(aviation) A jet plane; Type of airplane propelled by jet engines instead of propellers</li></ol>
stifa	<i>verb</i><br><ol><li>to jet, to squirt</li></ol>
stifek|stifoges	<i>noun</i><br><ol><li>squid</li></ol>
stifliv	<i>noun</i><br><ol><li>jet stream</li></ol>
stlavedh	<i>noun</i><br><ol><li>lisp</li></ol><br><i>adj</i><br><ol><li>lisping</li></ol>
stlevi	<i>verb</i><br><ol><li>to lisp</li></ol>
sugal|sugalen	<i>noun</i><br><ol><li>rye</li></ol>
sygh	<i>adj</i><br><ol><li>dry, dried</li><li>arid</li></ol>
syra|syryow	<i>noun</i><br><ol><li>sire, father</li></ol>
sëgh	<i>adj</i><br><ol><li>dry</li></ol>
sÿgh	<i>adj</i><br><ol><li>dry</li></ol>
takla	<i>verb</i><br><ol><li>to adorn, furnish, deck out, trim</li><li>(sports) to tackle</li></ol>
tan|tanow|dan|than	<i>noun</i><br><ol><li>fire</li></ol>
tanweyth|tanweythen	<i>noun</i><br><ol><li>fireworks</li></ol>
tarow|darow|terewi|tharow	<i>noun</i><br><ol><li>bull</li></ol>
tas|thas|das|tasow	<i>noun</i><br><ol><li>father</li></ol>
tas-gwydn|tasow-wydn|gwydn|kw|tas{l m \|tasow-wydn}}	<i>noun</i><br><ol><li>grandfather</li></ol>
tas-gwynn|tasow-wynn|\|m\|tasow-wynn}}	<i>noun</i><br><ol><li>grandfather</li></ol>
tavas	<i>noun</i><br><ol><li>Hard mutation of davas.</li></ol>
taves|daves|tavosow|thaves	<i>noun</i><br><ol><li>language, tongue</li></ol>
tavol|tavolen	<i>noun</i><br><ol><li>(botany) dock</li></ol>
te	<i>pron</i><br><ol><li>you (informal second person singular pronoun), thou, thee</li></ol><br><i>noun</i><br><ol><li>tea</li></ol>
tedna	<i>verb</i><br><ol><li>to pull (apply force to something so that it comes towards the one applying the force)</li></ol>
teg	<i>num</i><br><ol><li>Hard mutation of deg.</li></ol><br><i>adj</i><br><ol><li>pretty, attractive</li></ol>
ten	<i>noun</i><br><ol><li>Hard mutation of den.</li></ol>
tenna	<i>verb</i><br><ol><li>to pull (apply force to something so that it comes towards the one applying the force)</li></ol>
tenti|tenti|denti|dhenti	<i>adj</i><br><ol><li>Hard mutation of denti.</li></ol>
termyn|termynyow	<i>noun</i><br><ol><li>time</li></ol>
testskrif|testskrifow	<i>noun</i><br><ol><li>certificate</li></ol>
tetti|tettys	<i>noun</i><br><ol><li>potato</li></ol>
teudh	<i>adj</i><br><ol><li>molten</li></ol>
tevy	<i>verb</i><br><ol><li>to grow</li></ol>
tew	<i>num</i><br><ol><li>Hard mutation of dew.</li></ol>
tewlder	<i>noun</i><br><ol><li>darkness</li></ol>
teylu|deylu|theylu|teyluow	<i>noun</i><br><ol><li>family</li></ol>
teyr	<i>num</i><br><ol><li>(Standard Cornish, Standard Written Form) three</li></ol>
teythi|teythien	<i>noun</i><br><ol><li>traits</li></ol>
tiger|tigri|tigres	<i>noun</i><br><ol><li>tiger</li></ol>
tir|tiryow	<i>noun</i><br><ol><li>land, earth</li></ol>
toos|doos|tosow|thoos|toos	<i>noun</i><br><ol><li>dough</li><li>tuft, bunch</li></ol>
toos alamandys|doos alamandys|thoos alamandys	<i>noun</i><br><ol><li>marzipan</li></ol>
toos gwari|thoos gwari|doos gwari	<i>noun</i><br><ol><li>playdough</li></ol>
torn	<i>noun</i><br><ol><li>Hard mutation of dorn.</li></ol>
torth|torthow	<i>noun</i><br><ol><li>loaf</li></ol>
torthell|torthellow	<i>noun</i><br><ol><li>bun</li></ol>
trad|tradys	<i>noun</i><br><ol><li>way, trade</li></ol>
tredan|thredan|dredan	<i>noun</i><br><ol><li>electricity</li></ol>
tredanek	<i>adj</i><br><ol><li>electric</li></ol>
tredhegves|dredhegves|thredhegves|13ves	<i>adj</i><br><ol><li>thirteenth</li></ol>
tredhek|thredhek|dredhek	<i>num</i><br><ol><li>(Standard Cornish, Standard Written Form) thirteen</li></ol>
tregh|trehow	<i>noun</i><br><ol><li>section, slice, portion</li><li>cut (of meat)</li></ol>
tregh kig|trehow kig	<i>noun</i><br><ol><li>steak</li></ol>
trenkles|drenkles|threnkles	<i>noun</i><br><ol><li>(botany) rhubarb</li></ol>
tressa|dressa|3a|thressa	<i>adj</i><br><ol><li>third</li></ol>
treth|trethow	<i>noun</i><br><ol><li>beach, seashore</li><li>sand</li></ol>
treusva|treusvaow	<i>noun</i><br><ol><li>crossing</li></ol>
treylya	<i>verb</i><br><ol><li>to translate</li></ol>
tri|thri|dri|teyr	<i>num</i><br><ol><li>three</li></ol>
tri ugens|thri ugens|dri ugens	<i>num</i><br><ol><li>sixty</li></ol>
triga	<i>verb</i><br><ol><li>to dwell (in a place)</li><li>to stay, remain</li></ol>
trigys	<i>adj</i><br><ol><li>settled</li></ol>
trist	<i>adj</i><br><ol><li>sad, mournful</li></ol>
tron|thron|thronow|dronyow|dron|thronyow|tronyow|dronow|tronow	<i>noun</i><br><ol><li>nose, snout</li><li>point (of land)</li><li>(Revived Late Cornish) tunnel</li></ol>
trongornvil|throngornvil|drongornvil|trongornviles	<i>noun</i><br><ol><li>rhinoceros</li></ol>
troos|threys|dhewdros|treys|throos|tewdros|dewdros|dreysen|droos|dreys	<i>noun</i><br><ol><li>(anatomy) foot</li></ol>
trovya	<i>verb</i><br><ol><li>to discover</li></ol>
truedha	<i>verb</i><br><ol><li>to look after, tend</li></ol>
trufla	<i>verb</i><br><ol><li>to trifle, toy with</li></ol>
try	<i>num</i><br><ol><li>(Standard Cornish) three</li></ol>
trydhek	<i>num</i><br><ol><li>(Common Cornish) thirteen</li></ol>
tryghi	<i>verb</i><br><ol><li>to conquer, vanquish, defeat</li></ol>
tu	<i>adj</i><br><ol><li>Hard mutation of du.</li></ol>
tus	<i>noun</i><br><ol><li>men</li><li>people, persons</li></ol>
ty	<i>pron</i><br><ol><li>you (informal second person singular pronoun)</li><li>thou</li><li>thee</li></ol>
tyckya	<i>verb</i><br><ol><li>to tick</li></ol>
tykki|dykki|tykkiow|thykki	<i>noun</i><br><ol><li>pretty thing</li></ol>
tykki Duw|dykkiow Duw|thykki Duwes|thykkiow Duw|tykkiow Duw|dykki Duw|tykki Duwes|thykki Duw|dykki Duwes	<i>noun</i><br><ol><li>butterfly</li></ol>
tykki Duw nos|tykkiow Duw nos|thykki Duw nos|dykki Duw nos|dykki Duwes nos|dykkiow Duw nos|thykki Duwes nos|tykki Duwes nos|thykkiow Duw nos	<i>noun</i><br><ol><li>moth</li></ol>
tyller|tyleryow	<i>noun</i><br><ol><li>place</li></ol>
udn	<i>num</i><br><ol><li>(Standard Cornish, Standard Written Form) one (used before nouns)</li></ol>
udnek	<i>num</i><br><ol><li>eleven</li></ol>
ufern|tewufern|dewufern|ufernyow|dhewufern	<i>noun</i><br><ol><li>ankle</li></ol>
ugans	<i>num</i><br><ol><li>(Standard Cornish) twenty</li></ol>
ugens	<i>num</i><br><ol><li>twenty</li></ol>
ugensves|20ves	<i>adj</i><br><ol><li>twentieth</li></ol>
ughkarga	<i>verb</i><br><ol><li>to upload</li></ol>
ughradha	<i>verb</i><br><ol><li>to upgrade</li></ol>
universita|universites	<i>noun</i><br><ol><li>university</li></ol>
unn	<i>num</i><br><ol><li>(Standard Cornish, Standard Written Form) one (used before nouns)</li></ol>
unnegves|11ves	<i>adj</i><br><ol><li>eleventh</li></ol>
unnek	<i>num</i><br><ol><li>eleven</li></ol>
untu	<i>noun</i><br><ol><li>unilateral</li></ol>
unverhe	<i>verb</i><br><ol><li>to agree</li></ol>
unya	<i>verb</i><br><ol><li>to unite</li></ol>
uraniom	<i>noun</i><br><ol><li>uranium</li></ol>
va	<i>pron</i><br><ol><li>he</li></ol>
vandalisa	<i>verb</i><br><ol><li>to vandalise</li></ol>
veksya	<i>verb</i><br><ol><li>to vex, irk, irritate</li></ol>
viajya	<i>verb</i><br><ol><li>to travel, journey</li></ol>
virus|virusys	<i>noun</i><br><ol><li>virus</li></ol>
vodka|vodkas	<i>noun</i><br><ol><li>vodka</li></ol>
voter|votoryon	<i>noun</i><br><ol><li>(male) voter</li></ol>
votores|votoresow	<i>noun</i><br><ol><li>(female) voter</li></ol>
vy	<i>pron</i><br><ol><li>I, me</li></ol>
vynyard|vynyardys	<i>noun</i><br><ol><li>vineyard</li></ol>
west	<i>noun</i><br><ol><li>west</li></ol>
whegh	<i>num</i><br><ol><li>six</li></ol>
whetek	<i>num</i><br><ol><li>sixteen</li></ol>
why	<i>pron</i><br><ol><li>(Standard Cornish, Standard Written Form with Traditional Graphs) you (formal or plural)</li></ol>
whyogen|whyogas	<i>noun</i><br><ol><li>pastry cake</li></ol>
whêtek	<i>num</i><br><ol><li>(Standard Cornish) sixteen</li></ol>
wojow	<i>noun</i><br><ol><li>dessert(s)/pudding</li></ol>
wordhenek	<i>adj</i><br><ol><li>Irish</li></ol>
y	<i>pron</i><br><ol><li>(Standard Cornish) they (third person plural pronoun)</li><li>(Standard Cornish, Standard Written Form) his</li></ol>
yar|yer	<i>noun</i><br><ol><li>chicken, hen</li></ol>
yar Gyni|yer Gyni	<i>noun</i><br><ol><li>turkey</li></ol>
yeghes	<i>noun</i><br><ol><li>health</li></ol>
yeth|yethow	<i>noun</i><br><ol><li>language</li></ol>
yey	<i>noun</i><br><ol><li>ice</li></ol>
yeyn	<i>adj</i><br><ol><li>cold</li></ol>
yn akord gans	<i>prep</i><br><ol><li>(Revived Middle Cornish) consistent with</li></ol>
ynjynorieth	<i>noun</i><br><ol><li>engineering</li></ol>
yonker|yonkoryon|yonkers	<i>noun</i><br><ol><li>(male) youth, youngster</li></ol>
yonkores|yonkoresow	<i>noun</i><br><ol><li>(female) youth, youngster</li></ol>
yos kergh	<i>noun</i><br><ol><li>porridge</li></ol>
yown|yownes	<i>noun</i><br><ol><li>bass (fish)</li></ol>
yowynkneth	<i>noun</i><br><ol><li>youth</li></ol>
yr	<i>noun</i><br><ol><li>fresh</li></ol>
ys|ysow|ysen	<i>noun</i><br><ol><li>corn</li></ol>
ys hweg|ysen hweg	<i>noun</i><br><ol><li>maize</li></ol>
ys pop|ysen pop	<i>noun</i><br><ol><li>popcorn</li></ol>
ysel	<i>adj</i><br><ol><li>low</li></ol>
ysen hweg	<i>noun</i><br><ol><li>kernel of maize</li></ol>
ysen pop	<i>noun</i><br><ol><li>kernel of popcorn</li></ol>
yskans|yskansen	<i>noun</i><br><ol><li>cornflakes</li></ol>
yskar	<i>noun</i><br><ol><li>sackcloth, sacking</li></ol>
yurl|yurlys	<i>noun</i><br><ol><li>earl</li></ol>
zombi|zombis	<i>noun</i><br><ol><li>zombie</li></ol>
âls|âlsyow	<i>noun</i><br><ol><li>(Standard Cornish) cliff, shore</li></ol>
ès	<i>prep</i><br><ol><li>(Standard Cornish) Short for ages.</li></ol>
êtek	<i>num</i><br><ol><li>(Standard Cornish) eighteen</li></ol>
ôn|en	<i>noun</i><br><ol><li>lamb</li></ol>
