Avainch	<i>name</i><br><ol><li>(Vegliot) Vrbnik (a village and municipality on the east coast of Krk, Croatia)</li></ol>
Dalmazia	<i>name</i><br><ol><li>Dalmatia</li></ol>
Di	<i>noun</i><br><ol><li>God</li></ol>
Verbenik|Verbeník	<i>name</i><br><ol><li>Vrbnik (a city in Veglia)</li></ol>
a	<i>prep</i><br><ol><li>to</li><li>at</li></ol>
a la luorga	<i>adv</i><br><ol><li>(Vegliot) far, distant</li></ol>
a lič	<i>adv</i><br><ol><li>near</li><li>at</li></ol>
abandonur|bandunure|abandunure	<i>verb</i><br><ol><li>to abandon, leave behind</li></ol>
abas	<i>adv</i><br><ol><li>down</li></ol><br><i>intj</i><br><ol><li>down!, down with!</li></ol>
abastrain	<i>noun</i><br><ol><li>(Vegliot) a type of red grape</li></ol>
abrasur	<i>verb</i><br><ol><li>to hug, embrace</li><li>to encompass</li></ol>
abreviatiaun	<i>noun</i><br><ol><li>abbreviation</li></ol>
abreviur|abreviut	<i>verb</i><br><ol><li>to abbreviate</li></ol>
abrivur	<i>verb</i><br><ol><li>(of a boat or aircraft) To get underway and pick up speed.</li></ol>
abrivuta|brivuota	<i>noun</i><br><ol><li>speed</li><li>headway</li><li>thrust</li></ol>
abstraict	<i>noun</i><br><ol><li>abstract</li></ol>
abucur	<i>verb</i><br><ol><li>to advocate</li></ol>
abás	<i>adv</i><br><ol><li>down</li></ol>
acaid	<i>noun</i><br><ol><li>(Vegliot) vinegar</li></ol>
acait	<i>noun</i><br><ol><li>vinegar</li></ol>
actiaun	<i>noun</i><br><ol><li>action</li></ol>
adias	<i>adv</i><br><ol><li>now</li></ol>
adviant	<i>noun</i><br><ol><li>(Vegliot) arrival, advent</li></ol>
advocur	<i>verb</i><br><ol><li>to advocate</li></ol>
advocut|abucuta|abucut|advocuta	<i>noun</i><br><ol><li>advocate, attorney, lawyer</li><li>counsel, legal adviser</li><li>barrister</li></ol>
afacro|afur|affacro	<i>noun</i><br><ol><li>matter, affair</li><li>bargain, deal, trade</li></ol>
afaict|affaict|afet	<i>noun</i><br><ol><li>affect</li></ol>
afaictur|affaictur	<i>verb</i><br><ol><li>to affect</li></ol>
affuor|affuar	<i>noun</i><br><ol><li>(Vegliot) affair</li></ol>
agariuól	<i>noun</i><br><ol><li>needlecase</li></ol>
agaun	<i>noun</i><br><ol><li>(Vegliot) twaite shad</li></ol>
agnial|gnial	<i>noun</i><br><ol><li>(Vegliot) lamb</li></ol>
agniál	<i>noun</i><br><ol><li>ring</li><li>lamb</li></ol>
agost|aguast	<i>noun</i><br><ol><li>(Vegliot) August</li></ol>
agusta|aguste|argúst	<i>noun</i><br><ol><li>spiny lobster</li></ol>
ail	<i>noun</i><br><ol><li>(Vegliot) garlic</li></ol>
aimarí	<i>noun</i><br><ol><li>Hail Mary</li></ol>
alaite	<i>noun</i><br><ol><li>(Vegliot) intestines, bowels, guts</li></ol>
alaura	<i>adv</i><br><ol><li>so</li><li>then</li><li>thus</li></ol>
alborur	<i>verb</i><br><ol><li>to hoist, raise</li><li>to flare up</li></ol>
aleger|alegar	<i>adj</i><br><ol><li>(Vegliot) cheerful</li></ol>
alegr	<i>adj</i><br><ol><li>happy, glad, cheerful</li></ol>
alegraia	<i>noun</i><br><ol><li>fun, merriment</li><li>playfulness</li></ol>
altramiant	<i>adv</i><br><ol><li>or else, otherwise, otherwise else</li></ol>
altramiante	<i>adv</i><br><ol><li>(Vegliot) Alternative form of altramiant</li></ol>
altur	<i>noun</i><br><ol><li>(Vegliot) altar</li></ol>
alviar	<i>noun</i><br><ol><li>beehive, hive</li></ol>
alzuarse	<i>verb</i><br><ol><li>to stand up, to rise</li></ol>
alzur|alzuarse	<i>verb</i><br><ol><li>(Vegliot) to raise, lift</li></ol>
alzur cole palaure	<i>verb</i><br><ol><li>(Vegliot) to read</li></ol>
amaic|amaič	<i>noun</i><br><ol><li>friend (male)</li></ol>
amaica|amaice	<i>noun</i><br><ol><li>friend (female)</li></ol>
amaur	<i>noun</i><br><ol><li>love</li><li>sweetheart, darling</li></ol>
amazur	<i>verb</i><br><ol><li>to kill</li></ol>
amia	<i>noun</i><br><ol><li>aunt</li></ol>
amuar	<i>verb</i><br><ol><li>(Vegliot) Alternative form of amur (“to love”)</li></ol>
amur|amuora	<i>verb</i><br><ol><li>to love</li></ol><br><i>adj</i><br><ol><li>bitter</li></ol>
anca	<i>adv</i><br><ol><li>also, too, as well</li><li>even, even though</li></ol>
ancusene	<i>noun</i><br><ol><li>(Vegliot) anvil</li></ol>
andua	<i>adv</i><br><ol><li>(Vegliot) where</li></ol>
anduar	<i>verb</i><br><ol><li>(Vegliot) to go</li></ol>
andur	<i>verb</i><br><ol><li>to go, move</li></ol>
andure	<i>verb</i><br><ol><li>(Vegliot) Alternative form of anduar (“to go”)</li></ol>
anduve	<i>adv</i><br><ol><li>(Vegliot) Alternative form of andua (“where”)</li></ol>
anera	<i>noun</i><br><ol><li>duck</li></ol>
angiòla	<i>noun</i><br><ol><li>eel</li></ol>
anial	<i>noun</i><br><ol><li>(Vegliot) ring</li></ol>
animúl	<i>noun</i><br><ol><li>animal</li></ol>
aninč	<i>adv</i><br><ol><li>before</li><li>previously</li></ol>
anjial	<i>noun</i><br><ol><li>lamb</li></ol>
anǧola	<i>noun</i><br><ol><li>eel</li></ol>
apetiat	<i>noun</i><br><ol><li>(Vegliot) appetite</li></ol>
apiar|piarto|apiart	<i>verb</i><br><ol><li>(Vegliot) to open</li></ol>
aplicatiaun	<i>noun</i><br><ol><li>application</li></ol>
aplich	<i>noun</i><br><ol><li>altercation</li></ol>
aplicur|aplicut	<i>verb</i><br><ol><li>to apply</li><li>to applicate</li></ol>
aplič	<i>noun</i><br><ol><li>quarrel</li></ol>
aprail	<i>noun</i><br><ol><li>(Vegliot) April</li></ol>
aprendro|aprais	<i>verb</i><br><ol><li>to learn</li><li>to apprehend</li></ol>
aprensiaun	<i>noun</i><br><ol><li>apprehension</li></ol>
aprer|piarto|apiart	<i>verb</i><br><ol><li>to open</li></ol>
aqua	<i>noun</i><br><ol><li>(Vegliot) water</li></ol>
ardar	<i>verb</i><br><ol><li>(Vegliot) to burn</li></ol>
argust	<i>noun</i><br><ol><li>(Vegliot) spiny lobster</li></ol>
aria	<i>noun</i><br><ol><li>air</li><li>appearance</li></ol>
armir	<i>noun</i><br><ol><li>wardrobe</li></ol>
arur	<i>verb</i><br><ol><li>(Vegliot) to plow</li></ol>
arziant	<i>noun</i><br><ol><li>(Vegliot) silver</li></ol>
arziprés	<i>noun</i><br><ol><li>cypress</li></ol>
arǧant	<i>noun</i><br><ol><li>silver</li></ol>
ascaun	<i>noun</i><br><ol><li>(Vegliot) nail (fastener)</li></ol>
ascianz	<i>noun</i><br><ol><li>absinthe</li><li>wormwood</li></ol>
ascondro	<i>verb</i><br><ol><li>(Vegliot) to hide</li></ol>
atendro|atendait	<i>verb</i><br><ol><li>to wait for</li><li>to attend</li></ol>
atentiaun	<i>noun</i><br><ol><li>attention</li></ol>
atuarn	<i>adv</i><br><ol><li>(Vegliot) around</li></ol>
atuár	<i>noun</i><br><ol><li>actuary</li></ol>
autun	<i>noun</i><br><ol><li>autumn</li></ol>
avanzur	<i>verb</i><br><ol><li>to advance</li></ol>
avar|avoit|naun avai|avando|avaja|avai avoit|avajaite avoit|avajaime|avassa|jaite|jaime|avasse|jaite avoit|jai|avassaite|ju avoit|avas|avra|avaja avoit|ju|avai|ji avoit|avarme|jai avoit|jaime avoit|avas avoit|avrai|avarte|naun avaime|avaite|avaime|naun avaite|avajaite|ji|avassaime|avajaime avoit|avre	<i>verb</i><br><ol><li>(Vegliot) to have</li></ol>
avaraus	<i>adj</i><br><ol><li>stingy, ungenerous, penny-pinching, parsimonious, miserly</li></ol>
bajur	<i>verb</i><br><ol><li>to bark, bark at</li></ol>
balluar	<i>verb</i><br><ol><li>to dance</li></ol>
bar|baite	<i>verb</i><br><ol><li>to drink</li></ol>
basalca	<i>noun</i><br><ol><li>(Vegliot) church</li></ol>
batar	<i>verb</i><br><ol><li>(Vegliot) to beat, strike, hit</li></ol>
baud	<i>noun</i><br><ol><li>voice</li></ol>
bial	<i>adj</i><br><ol><li>beautiful, pretty</li></ol>
bin	<i>adv</i><br><ol><li>well</li></ol><br><i>noun</i><br><ol><li>good</li></ol>
biss	<i>noun</i><br><ol><li>kiss</li></ol>
bissur|bissuor	<i>verb</i><br><ol><li>to kiss</li></ol>
biṡát	<i>noun</i><br><ol><li>eel</li></ol>
blanc|blanke|blank|blance|blanca|blanka	<i>adj</i><br><ol><li>white</li></ol>
blasmuat	<i>noun</i><br><ol><li>sin</li></ol>
blasmur|blasmuat	<i>verb</i><br><ol><li>to blaspheme</li></ol>
bluta	<i>noun</i><br><ol><li>wafer, host</li></ol>
bocuola	<i>noun</i><br><ol><li>jar</li><li>jug</li><li>vessel</li></ol>
bonbíst	<i>noun</i><br><ol><li>braggart</li></ol>
bonduanza	<i>noun</i><br><ol><li>abundance</li><li>opulence</li></ol>
bos	<i>noun</i><br><ol><li>oak tree</li><li>thigh, hind quarters</li></ol>
bosaun	<i>noun</i><br><ol><li>bottle</li></ol>
bosca	<i>noun</i><br><ol><li>lie, untruth</li></ol>
boscur	<i>verb</i><br><ol><li>to chop wood</li></ol>
boscurd	<i>noun</i><br><ol><li>liar</li></ol>
bot	<i>noun</i><br><ol><li>blow, slap, smack, whack, knock, strike, thud</li></ol>
botaiga	<i>noun</i><br><ol><li>workshop</li></ol>
botaila|botaile	<i>noun</i><br><ol><li>bottle</li></ol>
botaun	<i>noun</i><br><ol><li>button</li></ol>
botičél	<i>noun</i><br><ol><li>cask</li></ol>
bott	<i>noun</i><br><ol><li>barrel</li></ol>
botur	<i>verb</i><br><ol><li>to throw away, trash, chuck, dump</li></ol>
bragaun	<i>noun</i><br><ol><li>trousers, breeches, pants</li></ol>
braina	<i>noun</i><br><ol><li>bridle</li></ol>
bramur	<i>verb</i><br><ol><li>to wish, long for, desire</li></ol>
branzain	<i>noun</i><br><ol><li>sea bass</li></ol>
braz|brez	<i>noun</i><br><ol><li>arm</li></ol>
broin|broina	<i>adj</i><br><ol><li>brown</li><li>dark</li></ol>
bruf|bruva	<i>adj</i><br><ol><li>good, nice</li></ol>
bruod	<i>noun</i><br><ol><li>broth</li><li>soup</li></ol>
brusc	<i>adj</i><br><ol><li>rude</li><li>offhanded</li><li>brusque</li></ol>
brusur	<i>verb</i><br><ol><li>to burn, flame</li><li>to overcook, char</li><li>to singe</li></ol>
brut|bruta|brot	<i>adj</i><br><ol><li>ugly</li><li>bad</li></ol>
brágol	<i>noun</i><br><ol><li>outcry, noise, uproar, hubbub</li></ol>
brágul	<i>noun</i><br><ol><li>fuss; uproar</li></ol>
brúscole	<i>noun</i><br><ol><li>tendril</li><li>climber</li></ol>
bu|buč	<i>noun</i><br><ol><li>ox</li></ol>
bualp	<i>noun</i><br><ol><li>fox</li></ol>
buarba	<i>noun</i><br><ol><li>beard</li><li>chin</li><li>uncle</li></ol>
buarca	<i>noun</i><br><ol><li>boat</li><li>ship</li></ol>
buarsa	<i>noun</i><br><ol><li>purse, pocketbook, bag, handbag</li></ol>
buasc	<i>noun</i><br><ol><li>wood, forest</li></ol>
buast	<i>noun</i><br><ol><li>bust</li><li>sculpture</li><li>trunk</li></ol>
buaza	<i>noun</i><br><ol><li>caraffe, vase, jar</li></ol>
buač	<i>noun</i><br><ol><li>bocce (game)</li></ol>
bubana	<i>noun</i><br><ol><li>fun, merriment, joy</li><li>playfulness, cheerfulness</li></ol>
bubú	<i>noun</i><br><ol><li>bogeyman, hobgoblin</li></ol>
buc	<i>noun</i><br><ol><li>small ox</li><li>beehive</li></ol>
buca	<i>noun</i><br><ol><li>(anatomy) mouth</li></ol>
buluat	<i>adj</i><br><ol><li>elegant, well-dressed</li></ol>
bun|buna	<i>adj</i><br><ol><li>good</li></ol>
bun dai	<i>intj</i><br><ol><li>good morning</li></ol>
buna nuot|buna nuat	<i>intj</i><br><ol><li>good night</li></ol>
bunagrez	<i>noun</i><br><ol><li>picklock</li><li>skeleton key</li></ol>
bunalana	<i>noun</i><br><ol><li>scoundrel</li></ol>
buola|buole	<i>noun</i><br><ol><li>ball</li></ol>
buonda	<i>noun</i><br><ol><li>party, pack, group, gang</li></ol>
buosta	<i>intj</i><br><ol><li>enough!</li></ol>
bura	<i>noun</i><br><ol><li>north wind</li></ol>
burbur	<i>noun</i><br><ol><li>barber</li></ol>
busca|bousca	<i>noun</i><br><ol><li>cow</li></ol>
butir	<i>noun</i><br><ol><li>butter</li></ol>
búrbor	<i>adj</i><br><ol><li>crusty</li><li>rough</li><li>gruff</li></ol>
cacur|cacuor	<i>verb</i><br><ol><li>to shit, defecate</li></ol>
cadar	<i>verb</i><br><ol><li>to fall</li></ol>
cadrial	<i>noun</i><br><ol><li>brick</li></ol>
caina	<i>noun</i><br><ol><li>supper</li></ol>
caira	<i>noun</i><br><ol><li>wax</li></ol>
cal	<i>conj</i><br><ol><li>as</li></ol><br><i>noun</i><br><ol><li>road, street</li></ol>
calco	<i>adj</i><br><ol><li>some, any</li></ol>
cale	<i>noun</i><br><ol><li>road, street</li><li>time</li></ol>
calčaina	<i>noun</i><br><ol><li>lime mortar</li></ol>
camain	<i>noun</i><br><ol><li>chimney</li><li>fireplace</li></ol>
camaisa	<i>noun</i><br><ol><li>shirt</li></ol>
campanaid	<i>noun</i><br><ol><li>belfry</li></ol>
campuona|campuone	<i>noun</i><br><ol><li>bell</li></ol>
canaisa	<i>noun</i><br><ol><li>ash, ashes</li></ol>
canapial	<i>noun</i><br><ol><li>cord</li></ol>
cand	<i>adv</i><br><ol><li>when</li></ol>
caniastro|caniastri	<i>noun</i><br><ol><li>basket</li></ol>
cantur	<i>verb</i><br><ol><li>to sing</li></ol>
canul	<i>noun</i><br><ol><li>canal</li><li>channel</li></ol>
capei	<i>noun</i><br><ol><li>hair (collective), hairs</li></ol>
capraina	<i>noun</i><br><ol><li>she-goat</li></ol>
capula	<i>noun</i><br><ol><li>onion</li></ol>
caricur	<i>verb</i><br><ol><li>to charge</li><li>to load</li></ol>
carituat	<i>noun</i><br><ol><li>charity</li></ol>
carnoit	<i>noun</i><br><ol><li>viper</li></ol>
carnual	<i>noun</i><br><ol><li>mutton</li></ol>
carviale	<i>noun</i><br><ol><li>brain</li></ol>
castial	<i>noun</i><br><ol><li>castle</li></ol>
castrur	<i>verb</i><br><ol><li>to castrate</li></ol>
cataina	<i>noun</i><br><ol><li>chain</li></ol>
catraida	<i>noun</i><br><ol><li>chair</li></ol>
catur	<i>verb</i><br><ol><li>to find</li></ol>
cauc	<i>adv</i><br><ol><li>here</li></ol>
cauda	<i>noun</i><br><ol><li>tail</li></ol>
caul	<i>noun</i><br><ol><li>cabbage</li></ol>
causa	<i>noun</i><br><ol><li>thing</li></ol>
cautiaun	<i>noun</i><br><ol><li>caution</li></ol>
caval|cavul	<i>noun</i><br><ol><li>horse</li></ol>
cenur|cenut	<i>verb</i><br><ol><li>to have supper, have a meal, dine, eat</li></ol>
chilauna	<i>noun</i><br><ol><li>column, pillar</li></ol>
chis	<i>noun</i><br><ol><li>cheese</li></ol>
ci	<i>pron</i><br><ol><li>who</li></ol>
ciant	<i>num</i><br><ol><li>hundred</li></ol>
ciart	<i>pron</i><br><ol><li>certain</li></ol>
cic	<i>pron</i><br><ol><li>someone, somebody</li><li>anyone, anybody</li></ol><br><i>noun</i><br><ol><li>tobacco, quid</li><li>butt (cigarette)</li></ol>
cicoluota	<i>noun</i><br><ol><li>chocolate</li></ol>
cidal	<i>noun</i><br><ol><li>chicken coop, chicken shack</li></ol>
cil	<i>noun</i><br><ol><li>sky</li><li>heaven</li></ol>
cinco	<i>noun</i><br><ol><li>bedbug</li></ol>
cincto	<i>num</i><br><ol><li>fifth</li></ol>
cinko	<i>noun</i><br><ol><li>bedbug</li></ol>
cir	<i>noun</i><br><ol><li>candle</li><li>altar candle</li></ol>
circol	<i>noun</i><br><ol><li>circle</li><li>group</li><li>set</li></ol>
cistierna	<i>noun</i><br><ol><li>cistern, water tank</li></ol>
cituot	<i>noun</i><br><ol><li>city</li></ol>
civet	<i>noun</i><br><ol><li>owl</li><li>burrowing owl</li></ol>
cič	<i>noun</i><br><ol><li>chickpea</li></ol>
clamur|clam|clamuor	<i>verb</i><br><ol><li>to call</li></ol>
cluf	<i>noun</i><br><ol><li>key</li></ol>
co	<i>pron</i><br><ol><li>what</li></ol>
codial	<i>noun</i><br><ol><li>rectum, arsehole</li></ol>
coisa	<i>adv</i><br><ol><li>so</li><li>as, like</li><li>like this/that</li></ol>
col	<i>pron</i><br><ol><li>that</li></ol>
colaur	<i>noun</i><br><ol><li>color</li></ol>
colectiaun	<i>noun</i><br><ol><li>collection</li></ol>
colegro|colaict	<i>verb</i><br><ol><li>to collect</li></ol>
comanduar	<i>verb</i><br><ol><li>to rule, command</li></ol>
comnut	<i>noun</i><br><ol><li>brother-in-law</li></ol>
comparer|conparer	<i>verb</i><br><ol><li>to appear</li></ol>
complicur|complicut	<i>verb</i><br><ol><li>to complicate</li></ol>
comprendro|comprais	<i>verb</i><br><ol><li>to comprehend</li></ol>
comprensiaun	<i>noun</i><br><ol><li>comprehension</li></ol>
comprur	<i>verb</i><br><ol><li>to buy</li></ol>
compuar	<i>noun</i><br><ol><li>godfather</li></ol>
con	<i>prep</i><br><ol><li>with</li></ol><br><i>noun</i><br><ol><li>(vulgar) vulva, cunt</li></ol>
conmaic	<i>prep</i><br><ol><li>with me</li></ol>
cont	<i>adv</i><br><ol><li>when</li></ol>
contiant	<i>adj</i><br><ol><li>satisfied</li></ol>
contra	<i>adv</i><br><ol><li>against</li></ol>
contractiaun	<i>noun</i><br><ol><li>contraction</li></ol>
contraict	<i>noun</i><br><ol><li>contract</li></ol>
contribuer|contribuendo|contribuaite|contribuait|avas contribuait|avajaite contribuait|contribuissaime|jaite contribuait|contribuaime|contribuaja|jai contribuait|contribuisse|contribuajaite|contribuera|contribuo|contribuis|contribuar|ju contribuait|naun contribui|contribuere|contribuerte|naun contribuaite|ji contribuait|contribuissaite|jaime contribuait|avai contribuait|contribui|contribuerme|avajaime contribuait|naun contribuaime|contribuissa	<i>verb</i><br><ol><li>to contribute</li></ol>
conversatiaun	<i>noun</i><br><ol><li>conversation</li></ol>
conversur|conversut	<i>verb</i><br><ol><li>to converse</li></ol>
cončaro	<i>verb</i><br><ol><li>to conquer</li></ol>
coprer|copiart	<i>verb</i><br><ol><li>to cover</li></ol>
copsa	<i>noun</i><br><ol><li>(Vegliot) thigh</li></ol>
coresma	<i>noun</i><br><ol><li>Lent</li></ol>
cort	<i>adj</i><br><ol><li>short</li></ol>
cortial	<i>noun</i><br><ol><li>knife</li></ol>
coser	<i>verb</i><br><ol><li>to sew</li></ol>
cosobrain	<i>noun</i><br><ol><li>cousin</li></ol>
cosuol	<i>noun</i><br><ol><li>pigsty</li></ol>
cotidiun	<i>adj</i><br><ol><li>daily</li></ol>
cočaina	<i>noun</i><br><ol><li>kitchen</li></ol>
cratoire	<i>noun</i><br><ol><li>children</li></ol>
crauc	<i>noun</i><br><ol><li>cross</li></ol>
credro|crait	<i>verb</i><br><ol><li>to believe</li></ol>
crepur	<i>verb</i><br><ol><li>to burst</li></ol>
crescro|crescrai|craskro|cresco|jai crescait|crescassa|crescassaime|je crescait|crescaite|crescre|jaime crescait|crescute|naun crescaite|avaime crescait|crescas|crescendo|crescume|naun crescai|crescaja|jaite crescait|ju crescait|crescasse|crascro|crescua|crescassaite|avas crescait|crescai|crescait|crescerte|crescerme|avaja crescait|crescaime|avaite crescait|naun crescaime|crescra	<i>verb</i><br><ol><li>to grow</li></ol>
cris	<i>noun</i><br><ol><li>cherry</li></ol>
croit	<i>adj</i><br><ol><li>raw</li></ol>
cual	<i>noun</i><br><ol><li>neck</li></ol>
cuantra	<i>prep</i><br><ol><li>against</li></ol><br><i>adv</i><br><ol><li>against</li></ol>
cuarb	<i>noun</i><br><ol><li>crow</li></ol>
cuarne	<i>noun</i><br><ol><li>meat</li></ol>
cuarno	<i>noun</i><br><ol><li>horn</li></ol>
cuarp|quarp	<i>noun</i><br><ol><li>body</li></ol>
cuasta	<i>noun</i><br><ol><li>(Vegliot, anatomy) rib</li></ol>
cucro	<i>verb</i><br><ol><li>to cook</li></ol>
cuma	<i>noun</i><br><ol><li>godmother</li></ol>
cun|cuon|cuini	<i>noun</i><br><ol><li>dog</li></ol>
cuolt	<i>adj</i><br><ol><li>warm, hot</li></ol>
cuomp|kimpi|chinpi|kinpi|chimpi	<i>noun</i><br><ol><li>field</li></ol>
cuorna	<i>noun</i><br><ol><li>meat</li></ol>
cuorta	<i>noun</i><br><ol><li>paper</li></ol>
cuosa	<i>noun</i><br><ol><li>(Vegliot) house</li></ol>
cup	<i>noun</i><br><ol><li>head</li></ol>
cur|cuor|cuora	<i>adj</i><br><ol><li>dear, beloved</li></ol><br><i>noun</i><br><ol><li>heart</li></ol>
curro|cuar	<i>verb</i><br><ol><li>to run</li></ol>
d'as	<i>pron</i><br><ol><li>of them</li></ol>
da	<i>prep</i><br><ol><li>from</li><li>of</li></ol>
dacuard|dacuardi	<i>adj</i><br><ol><li>okay, in accord, one with</li></ol>
dai	<i>noun</i><br><ol><li>day</li></ol><br><i>intj</i><br><ol><li>go away, get lost</li></ol>
dais|daisa	<i>adj</i><br><ol><li>dense</li><li>thick</li></ol>
dalmat|dalmata	<i>adj</i><br><ol><li>dalmatian</li></ol>
damno	<i>noun</i><br><ol><li>harm, damage</li><li>havoc</li></ol>
dapú	<i>adv</i><br><ol><li>after, afterwards</li><li>later, later on</li></ol>
dauc	<i>noun</i><br><ol><li>plug, cork, stopper</li></ol>
de	<i>prep</i><br><ol><li>of</li></ol>
debeta|debete	<i>noun</i><br><ol><li>debt</li></ol>
debituar	<i>noun</i><br><ol><li>debtor</li><li>payer</li></ol>
defendar	<i>verb</i><br><ol><li>to defend, guard</li><li>to vindicate</li></ol>
defuant	<i>adj</i><br><ol><li>deceased, dead</li><li>defunct</li></ol>
dementicur|dementikur	<i>verb</i><br><ol><li>to forget</li><li>to leave behind</li></ol>
demun	<i>noun</i><br><ol><li>demon</li></ol>
denacle	<i>noun</i><br><ol><li>knees</li></ol>
denj	<i>adj</i><br><ol><li>worthy</li></ol>
dentul	<i>adj</i><br><ol><li>dental</li></ol>
dentís	<i>noun</i><br><ol><li>sea bream</li><li>red snapper</li></ol>
depentaur|pentaur	<i>noun</i><br><ol><li>painter</li></ol>
depiandro	<i>verb</i><br><ol><li>to paint</li></ol>
depotur	<i>verb</i><br><ol><li>to delegate</li></ol>
depotut	<i>adj</i><br><ol><li>delegated</li></ol><br><i>noun</i><br><ol><li>delegate</li></ol>
dermun|dermuoni	<i>noun</i><br><ol><li>wood</li><li>bark</li></ol>
desirur	<i>verb</i><br><ol><li>to want, long for, desire</li></ol>
desmun|desmuoni	<i>noun</i><br><ol><li>tomorrow</li><li>morning</li></ol><br><i>adv</i><br><ol><li>tomorrow</li></ol>
desorden	<i>noun</i><br><ol><li>disorder</li><li>untidiness</li></ol>
despoliur|dispoliur|dispojur	<i>verb</i><br><ol><li>to strip, undress, divest</li></ol>
desponar	<i>verb</i><br><ol><li>to arrange, dispose, order</li></ol>
despreziur	<i>verb</i><br><ol><li>to despise, hate, dislike</li></ol>
dessendiansia	<i>noun</i><br><ol><li>descent, extraction, pedigree, parentage, stock</li></ol>
dessendro|dessendoit	<i>verb</i><br><ol><li>to descend</li><li>to get off, dismount</li></ol>
desser	<i>verb</i><br><ol><li>to sin</li></ol>
destinur|destinut	<i>verb</i><br><ol><li>to intend</li><li>to destine, fate</li><li>to assign, earmark, appoint, appropriate</li><li>to channel</li></ol>
destruar	<i>verb</i><br><ol><li>to awake, rouse</li></ol>
detco|dacli	<i>noun</i><br><ol><li>finger</li></ol>
deventur|deventut	<i>verb</i><br><ol><li>to become</li></ol>
dezipur|deziput	<i>verb</i><br><ol><li>to spoil</li></ol>
dezun	<i>noun</i><br><ol><li>fast, fasting</li></ol><br><i>adj</i><br><ol><li>fasting</li><li>hungry</li><li>(of the stomach) empty</li></ol>
diant|dianč	<i>noun</i><br><ol><li>(Vegliot, anatomy) tooth</li></ol>
diastro|diastra	<i>adj</i><br><ol><li>right</li><li>skillful</li></ol>
diatremun	<i>adv</i><br><ol><li>then</li></ol>
diaul	<i>noun</i><br><ol><li>devil</li></ol>
dic	<i>num</i><br><ol><li>ten</li></ol>
dichidapto	<i>num</i><br><ol><li>eighteen</li></ol>
dichinú	<i>num</i><br><ol><li>nineteen</li></ol>
dichisapto	<i>num</i><br><ol><li>seventeen</li></ol>
dicro|dat|dicume|naun dicaite|dicui|dicute|jaime daict|naun dicai|daict|dicaime|dicua|dicerme|avajaime daict|dicaite|dico|dicai|dicendo|avai daict|avaja daict|ju daict|dicra|dicassa|avas daict|daic|dicasse|jaite daict|dicassaime|ji daict|dicassaite|dicaja|naun dicaime|dicrai|dicas|decro|decaja|jai daict|dicerte|avajaite daict|dicre|dait	<i>verb</i><br><ol><li>to say, tell</li></ol>
dicto	<i>num</i><br><ol><li>tenth</li></ol>
dindiuota	<i>noun</i><br><ol><li>turkey</li></ol>
disa	<i>noun</i><br><ol><li>tub</li></ol>
dischiodur	<i>verb</i><br><ol><li>to pull nails out of</li></ol>
discopiart	<i>adj</i><br><ol><li>uncovered</li></ol>
discualz	<i>adj</i><br><ol><li>barefoot</li></ol>
discuars	<i>noun</i><br><ol><li>speech, talk, discourse, address, delivery, remark, chat</li></ol>
dismissur|desmissut|dismissut|desmissur	<i>verb</i><br><ol><li>to wake up, awaken</li></ol>
disnur	<i>verb</i><br><ol><li>to have lunch, eat lunch, lunch</li></ol>
dispiat	<i>noun</i><br><ol><li>spite</li></ol>
dispojua	<i>noun</i><br><ol><li>spoils</li><li>mortal remains</li><li>skin (of an animal)</li></ol>
dissipur|dissiput	<i>verb</i><br><ol><li>to squander</li></ol>
distenguar	<i>verb</i><br><ol><li>to distinguish, tell apart</li></ol>
distiruota	<i>noun</i><br><ol><li>expanse, sprawl</li></ol>
distruzar|distruzaja	<i>verb</i><br><ol><li>to destroy</li></ol>
distuont	<i>adj</i><br><ol><li>far, distant</li></ol>
docut|dochič	<i>noun</i><br><ol><li>duke</li></ol>
doi|doje	<i>num</i><br><ol><li>two</li></ol>
doiciant	<i>num</i><br><ol><li>two hundred</li></ol>
doir	<i>adj</i><br><ol><li>hard</li></ol>
dolar|dul	<i>verb</i><br><ol><li>to hurt, ache (feel pain)</li></ol>
dolc|dualz	<i>adj</i><br><ol><li>sweet</li></ol>
domandur|domunda	<i>verb</i><br><ol><li>to ask, demand, inquire</li></ol>
domienca	<i>noun</i><br><ol><li>Sunday</li></ol>
dona	<i>noun</i><br><ol><li>woman</li></ol>
doperur	<i>verb</i><br><ol><li>to use</li></ol>
dormer|jai dormait|dormisse|ju dormait|dormissa|avajaite dormait|dormere|naun dormaite|dormera|jaime dormait|dormerme|dormendo|duarmo|dormaite|dormissaite|jaite dormait|naun duarmi|dormaime|dormerte|avas dormait|dormis|duarmi|dormissaime|dormajaite|naun dormaime|dormait|ji dormait|avai dormait|dormaja|avajaime dormait	<i>verb</i><br><ol><li>to sleep</li></ol>
dorur|dorut	<i>verb</i><br><ol><li>to last, endure</li><li>to keep</li></ol>
dotco	<i>num</i><br><ol><li>twelve</li></ol>
dotuar	<i>noun</i><br><ol><li>doctor, medic</li></ol>
dovar	<i>verb</i><br><ol><li>to have to; must</li></ol>
dramur|dramut	<i>verb</i><br><ol><li>to butcher, slay, slaughter, kill</li></ol>
drante	<i>adv</i><br><ol><li>in, inside, indoors</li></ol>
drap	<i>noun</i><br><ol><li>drape, cloth</li><li>linen</li><li>underwear</li></ol><br><i>adj</i><br><ol><li>having the color of sand</li><li>having the color of human skin</li></ol>
drat	<i>adj</i><br><ol><li>straight</li></ol>
drecno	<i>noun</i><br><ol><li>sheep tick</li></ol>
dri	<i>prep</i><br><ol><li>behind</li></ol><br><i>adv</i><br><ol><li>behind</li><li>back</li></ol>
driaz	<i>noun</i><br><ol><li>plait, braid, twist, pigtail</li></ol>
drucno	<i>noun</i><br><ol><li>clingstone grape</li></ol>
du andú	<i>adv</i><br><ol><li>where from</li></ol>
duag	<i>noun</i><br><ol><li>stave</li></ol>
duanc	<i>adv</i><br><ol><li>therefore</li><li>accordingly</li></ol><br><i>conj</i><br><ol><li>thus, so</li></ol>
duas	<i>noun</i><br><ol><li>back</li></ol>
duauta	<i>noun</i><br><ol><li>dowry</li></ol>
dubitur|dobitur	<i>verb</i><br><ol><li>to doubt</li></ol>
dulsassa	<i>noun</i><br><ol><li>sweetness, gentleness, pleasantness</li><li>darling, sweetie</li></ol>
duot	<i>adj</i><br><ol><li>wet, moist</li></ol>
duplir	<i>noun</i><br><ol><li>torch</li></ol>
dur|da|du|duor|dua|dut|duot	<i>verb</i><br><ol><li>to give</li></ol>
débol	<i>adj</i><br><ol><li>weak</li><li>dim</li><li>faint</li></ol>
e	<i>conj</i><br><ol><li>and</li></ol>
efaict|effaict	<i>noun</i><br><ol><li>effect</li></ol>
el	<i>article</i><br><ol><li>the; masculine singular definite article</li></ol>
electiaun	<i>noun</i><br><ol><li>election</li></ol>
elegro|elaict	<i>verb</i><br><ol><li>to pick, to choose</li></ol>
embruar	<i>verb</i><br><ol><li>to count</li></ol>
embrunc	<i>noun</i><br><ol><li>bunch, cluster</li></ol>
emplar	<i>verb</i><br><ol><li>to fill</li></ol>
en	<i>prep</i><br><ol><li>in</li></ol>
encontrur|encuantra	<i>verb</i><br><ol><li>to meet</li></ol>
engrassur	<i>verb</i><br><ol><li>to oil, lubricate</li><li>to fatten, get/grow fat, gain weight</li></ol>
entrur	<i>verb</i><br><ol><li>to enter; go in</li></ol>
esiliur|esiljur|esailj	<i>verb</i><br><ol><li>to exile, banish, send away, cast out</li></ol>
fabricur|fabricuat	<i>verb</i><br><ol><li>to build, manufacture, fabricate</li></ol>
facain	<i>noun</i><br><ol><li>porter</li></ol>
facianda	<i>noun</i><br><ol><li>matter, business, affair, concern, issue, job</li><li>nature</li></ol>
facro|faite|fura|fuaza|fazume|fazua|avajaite faict|fezme|jaite faict|facassaite|faime|fuzte|avaja fut|faiss|facendo|facaime|avajaime faict|facaja|jai faict|facasse|naun faite|ju fut|fut|avas fut|fai|ju faict|jaime faict|je fut|naun facaime|fuzme|naun faime|avas faict|faz|facre|facra|naun fai|facaite|avaite fut|jai fut|avaime fut|facassaime|facas|naun facaite|facerte|fazute|furme|fezte|ji faict|facassa|fundo|facrai|jaite fut|fazui|fur|furai|furte|avaja faict|jaime fut|fure|far|facerme|faict	<i>verb</i><br><ol><li>to do, to make</li></ol>
faguor	<i>noun</i><br><ol><li>beech; beech tree</li><li>beechwood</li></ol>
faica|faiche	<i>noun</i><br><ol><li>fig (fruit)</li></ol>
faid	<i>noun</i><br><ol><li>belief</li></ol>
fain	<i>noun</i><br><ol><li>end</li></ol>
falja	<i>noun</i><br><ol><li>sheaf</li></ol>
falop	<i>noun</i><br><ol><li>big mistake</li></ol>
falur	<i>verb</i><br><ol><li>to fail</li></ol>
famalja	<i>noun</i><br><ol><li>family</li></ol>
fanel	<i>noun</i><br><ol><li>flannel</li></ol>
faraina	<i>noun</i><br><ol><li>flour</li></ol>
farm	<i>adj</i><br><ol><li>still, firm, steady, stationary</li></ol>
fastaide	<i>noun</i><br><ol><li>nuisance, inconvenience, bother, annoyance, tiresomeness</li></ol>
fasul|fasuli	<i>noun</i><br><ol><li>kidney bean</li></ol>
fataica|fataiche	<i>noun</i><br><ol><li>effort, hard work, fatigue, difficulty</li></ol>
faticur|faticut	<i>verb</i><br><ol><li>to toil, work hard</li></ol>
favlur|naun favlai|favlurme|faular|favlundo|avaite favlut|favluas|favlaime|favlute|jai favlut|favlui|favluassaime|favlume|favlaite|favlure|favluasse|favlurte|ju favlut|jaime favlut|favlurai|favlua|favlai|favular|naun favlaite|avas favlut|je favlut|favlut|faula|favula|favlura|favla|jaite favlut|avaja favlut|avaime favlut|naun favlaime|favluassa|favluassaite	<i>verb</i><br><ol><li>to speak</li></ol>
favorer	<i>verb</i><br><ol><li>to favour, promote, encourage, prefer, further, support</li></ol>
favro	<i>noun</i><br><ol><li>smith, blacksmith</li><li>locksmith</li></ol>
fazuol	<i>noun</i><br><ol><li>handkerchief, hanky, tissue</li></ol>
februar	<i>noun</i><br><ol><li>February</li></ol>
fecuat	<i>noun</i><br><ol><li>liver</li></ol>
fejustro	<i>noun</i><br><ol><li>stepson</li></ol>
felj|felji	<i>noun</i><br><ol><li>son</li></ol>
felja|felje	<i>noun</i><br><ol><li>daughter</li></ol>
femia	<i>noun</i><br><ol><li>female</li></ol>
fen|faina	<i>adj</i><br><ol><li>fine</li><li>subtle</li><li>pure</li></ol>
fenait	<i>adj</i><br><ol><li>finished</li></ol>
fenalmiant	<i>adv</i><br><ol><li>at last, finally</li></ol>
fermur|fermuar|fermuot	<i>verb</i><br><ol><li>to stop, arrest, staunch, halt, end</li><li>to fasten</li></ol>
fial	<i>noun</i><br><ol><li>bile</li><li>bitterness</li></ol>
fiar	<i>noun</i><br><ol><li>iron</li></ol>
fiara	<i>noun</i><br><ol><li>fair</li></ol>
fiasta|fiaste	<i>noun</i><br><ol><li>holiday</li></ol>
fiata	<i>noun</i><br><ol><li>slice, cut</li></ol>
fiaur	<i>noun</i><br><ol><li>flower</li></ol>
fichiera|fichir	<i>noun</i><br><ol><li>fig tree</li></ol>
figur	<i>noun</i><br><ol><li>A (shady) character.</li></ol>
figurut	<i>adj</i><br><ol><li>roguish</li></ol>
fil	<i>noun</i><br><ol><li>thread, yarn, string</li></ol>
filur|faila	<i>verb</i><br><ol><li>to spin (yarn)</li></ol>
fin	<i>noun</i><br><ol><li>hay</li></ol>
finiastra|finiastre	<i>noun</i><br><ol><li>window</li></ol>
fiorain	<i>noun</i><br><ol><li>little flower</li></ol>
fisčut	<i>noun</i><br><ol><li>penny whistle</li></ol>
floc|flok	<i>noun</i><br><ol><li>flock, tuft</li><li>flake</li></ol>
floim	<i>noun</i><br><ol><li>river</li></ol>
fois	<i>noun</i><br><ol><li>spindle</li></ol>
formaica	<i>noun</i><br><ol><li>ant</li></ol>
forsaura	<i>noun</i><br><ol><li>pan</li></ol>
fortauna	<i>noun</i><br><ol><li>luck, fortune</li></ol>
fosc	<i>adj</i><br><ol><li>black</li></ol>
frazial	<i>noun</i><br><ol><li>flail</li></ol>
fregur	<i>verb</i><br><ol><li>to fry</li></ol>
fresc	<i>adj</i><br><ol><li>fresh</li></ol>
frete	<i>noun</i><br><ol><li>(in the plural) pancakes</li></ol>
fruant	<i>noun</i><br><ol><li>(anatomy) forehead</li></ol>
fruot	<i>noun</i><br><ol><li>fruit</li></ol>
frutro|frutri	<i>noun</i><br><ol><li>brother</li></ol>
fua	<i>noun</i><br><ol><li>broad bean</li></ol>
fualja	<i>noun</i><br><ol><li>leaf</li></ol>
fuals	<i>adj</i><br><ol><li>false</li></ol>
fuarca	<i>noun</i><br><ol><li>fork</li></ol>
fuart	<i>adj</i><br><ol><li>strong</li></ol>
fuc|fuok	<i>noun</i><br><ol><li>fire</li></ol>
fum	<i>noun</i><br><ol><li>hunger</li></ol>
fumur	<i>verb</i><br><ol><li>to smoke</li></ol>
fuorma	<i>noun</i><br><ol><li>shape, form</li></ol>
fure	<i>adv</i><br><ol><li>outside</li></ol>
furmiant	<i>noun</i><br><ol><li>grain, wheat</li></ol>
fusaina	<i>noun</i><br><ol><li>forge</li></ol>
fázil	<i>adv</i><br><ol><li>easily</li><li>probably</li></ol>
galaina	<i>noun</i><br><ol><li>hen</li></ol>
ganer	<i>verb</i><br><ol><li>to shout</li></ol>
gaudar	<i>verb</i><br><ol><li>to enjoy</li></ol>
gaula	<i>noun</i><br><ol><li>throat</li></ol>
gelut	<i>adj</i><br><ol><li>cold</li></ol>
glaiba	<i>noun</i><br><ol><li>lump, clod, tussock, hassock</li><li>turf</li></ol>
glaz|glas	<i>noun</i><br><ol><li>ice</li></ol>
glazait	<i>adj</i><br><ol><li>(also past participle) frozen</li></ol>
golaus	<i>adj</i><br><ol><li>greedy</li><li>jealous</li></ol>
gombro	<i>verb</i><br><ol><li>to vomit</li></ol>
gomitur|gomituor	<i>verb</i><br><ol><li>to vomit</li></ol>
grabia	<i>noun</i><br><ol><li>rake</li></ol>
gril	<i>noun</i><br><ol><li>cricket</li></ol>
gruas	<i>adj</i><br><ol><li>big, huge</li><li>strong</li><li>thick</li></ol>
grun	<i>noun</i><br><ol><li>grain</li></ol>
grund|gruond	<i>adj</i><br><ol><li>big, large, great</li></ol>
gualisur|gualisuor	<i>verb</i><br><ol><li>to level, make flat (e.g. the ground/earth)</li></ol>
guardur	<i>verb</i><br><ol><li>to guard</li><li>to look</li></ol>
i	<i>article</i><br><ol><li>the; masculine plural definite article</li></ol>
imperataur	<i>noun</i><br><ol><li>emperor</li></ol>
imprendro|imprandro	<i>verb</i><br><ol><li>to light, kindle</li><li>to undertake</li></ol>
inamiant	<i>adv</i><br><ol><li>by heart</li></ol>
incaricur	<i>verb</i><br><ol><li>to charge</li><li>to load, burden</li></ol>
infiarn	<i>noun</i><br><ol><li>(Vegliot) hell</li></ol>
inflorer	<i>verb</i><br><ol><li>to begin to blossom, flower</li></ol>
informuar	<i>verb</i><br><ol><li>to inform</li></ol>
inganuar	<i>verb</i><br><ol><li>to deceive</li></ol>
inghiastro	<i>noun</i><br><ol><li>ink</li></ol>
inizur|nizur|nizuor	<i>verb</i><br><ol><li>to begin, start</li></ol>
inparur	<i>verb</i><br><ol><li>to learn</li></ol>
inserur|inseruor	<i>verb</i><br><ol><li>to enclose, shut in</li></ol>
instuat	<i>noun</i><br><ol><li>summer</li></ol>
intentiaun	<i>noun</i><br><ol><li>intention</li></ol>
interpretatiaun	<i>noun</i><br><ol><li>interpretation</li></ol>
interpretur|interpretut	<i>verb</i><br><ol><li>to interpret</li></ol>
intric	<i>adj</i><br><ol><li>whole, intact, entire</li></ol>
invelenuot	<i>adj</i><br><ol><li>poisoned</li><li>resentful</li><li>rabid, enraged</li></ol>
inviarno	<i>noun</i><br><ol><li>winter</li></ol>
jacqua|jácqua	<i>noun</i><br><ol><li>water</li></ol>
jag	<i>noun</i><br><ol><li>needle</li></ol>
jai	<i>pron</i><br><ol><li>(third-person plural masculine and feminine pronoun, oblique case) them</li></ol>
jal|jali	<i>pron</i><br><ol><li>(third person masculine singular pronoun) he</li></ol><br><i>noun</i><br><ol><li>wing</li></ol>
jala|jale	<i>pron</i><br><ol><li>(third person feminine singular pronoun) she</li></ol>
jale|jala	<i>pron</i><br><ol><li>(third-person feminine plural pronoun) they</li></ol>
jali|jal	<i>pron</i><br><ol><li>(third-person masculine plural pronoun) they</li></ol>
jamna	<i>noun</i><br><ol><li>soul</li></ol>
jamo	<i>adv</i><br><ol><li>now</li><li>yet</li><li>still</li></ol>
jan|jain|jein	<i>noun</i><br><ol><li>year</li></ol>
jaquaíz	<i>noun</i><br><ol><li>high tide</li></ol>
jarba	<i>noun</i><br><ol><li>grass</li><li>herb</li></ol>
jarkbaluen	<i>noun</i><br><ol><li>rainbow</li></ol>
jarma	<i>noun</i><br><ol><li>weapon</li></ol>
jasca	<i>noun</i><br><ol><li>table</li></ol>
jauca	<i>noun</i><br><ol><li>goose</li></ol>
jaun|jauna	<i>adj</i><br><ol><li>young</li></ol>
jaur	<i>noun</i><br><ol><li>gold</li></ol>
jaura|aura|aure|jaure	<i>noun</i><br><ol><li>hour</li></ol>
jedma	<i>noun</i><br><ol><li>week</li></ol>
jere	<i>adv</i><br><ol><li>yesterday</li></ol>
jo	<i>adv</i><br><ol><li>where</li></ol>
jocur|jokur	<i>verb</i><br><ol><li>to play</li></ol>
joe|jai	<i>pron</i><br><ol><li>(third-person feminine singular pronoun, oblique case) her</li></ol>
joi|jai	<i>pron</i><br><ol><li>(third-person masculine singular pronoun, oblique case) him</li></ol>
join|joina|yoin	<i>num</i><br><ol><li>one</li></ol>
joit	<i>adj</i><br><ol><li>wet</li></ol>
joiva|joive	<i>noun</i><br><ol><li>grape; grapes</li></ol>
jomno|jomni	<i>noun</i><br><ol><li>man</li><li>human being</li></ol>
jonco	<i>num</i><br><ol><li>eleven</li></ol>
jonda	<i>noun</i><br><ol><li>wave</li></ol>
jongar	<i>verb</i><br><ol><li>to anoint, rub with ointment</li></ol>
jongla	<i>noun</i><br><ol><li>(anatomy) nail</li></ol>
jorden	<i>noun</i><br><ol><li>order</li></ol>
jost	<i>adj</i><br><ol><li>just</li><li>correct</li></ol>
ju	<i>pron</i><br><ol><li>(first person singular pronoun) I</li></ol>
juac	<i>noun</i><br><ol><li>needle</li></ol>
jualb	<i>adj</i><br><ol><li>white</li></ol>
juarbol	<i>noun</i><br><ol><li>tree</li></ol>
juf	<i>noun</i><br><ol><li>egg</li></ol>
jultro|jultra|jualtra|joltra	<i>adj</i><br><ol><li>other</li><li>another</li></ol>
junkaura	<i>adv</i><br><ol><li>still</li><li>against</li></ol>
juopa|juop	<i>noun</i><br><ol><li>bee</li></ol>
kis	<i>noun</i><br><ol><li>cheese</li></ol>
kosuor	<i>verb</i><br><ol><li>to sew</li></ol>
kualp	<i>noun</i><br><ol><li>blame, fault</li></ol>
kuosa	<i>noun</i><br><ol><li>house</li></ol>
kuoza	<i>noun</i><br><ol><li>house</li></ol>
la	<i>article</i><br><ol><li>the; feminine singular definite article</li></ol>
lac	<i>noun</i><br><ol><li>lake</li></ol>
lamentuar	<i>verb</i><br><ol><li>to lament</li></ol>
lampur	<i>verb</i><br><ol><li>to lighten</li><li>to flash</li></ol>
lanc	<i>noun</i><br><ol><li>wood</li></ol>
langa|lange	<i>noun</i><br><ol><li>language</li><li>tongue</li></ol>
lasčur	<i>verb</i><br><ol><li>to leave</li><li>to let</li></ol>
latera	<i>noun</i><br><ol><li>letter (of the alphabet)</li></ol>
lavorar|lavora	<i>verb</i><br><ol><li>to work</li></ol>
lavuar	<i>verb</i><br><ol><li>to wash</li></ol>
lačar	<i>noun</i><br><ol><li>lizard</li></ol>
lačas	<i>noun</i><br><ol><li>a mackerel-type fish</li></ol>
le	<i>article</i><br><ol><li>the</li></ol>
lebro	<i>noun</i><br><ol><li>book</li></ol>
legro|avaja laict|legasse|legaja|legre|legas|legua|legerte|legassaite|legassaime|legassa|legaite|legui|jaime laict|naun legaime|laict|legendo|naun legai|ji laict|legerme|legrai|jaite laict|legaime|avajaite laict|legute|naun legaite|legai|avajaime laict|avas laict|avai laict|legra|jai laict|ju laict|legume|lego	<i>verb</i><br><ol><li>to read</li></ol>
lenzul	<i>noun</i><br><ol><li>bedsheet</li></ol>
levur|levut	<i>verb</i><br><ol><li>to take</li></ol>
ligur|liguar|liguor	<i>verb</i><br><ol><li>to tie, bind</li></ol>
limp	<i>noun</i><br><ol><li>lightning</li></ol>
lipro	<i>noun</i><br><ol><li>hare</li></ol>
ljat	<i>noun</i><br><ol><li>bed</li></ol>
loic	<i>noun</i><br><ol><li>light</li></ol>
loina	<i>noun</i><br><ol><li>moon</li></ol>
lois	<i>adj</i><br><ol><li>smooth</li></ol>
lotum	<i>noun</i><br><ol><li>manure</li></ol>
luang	<i>adj</i><br><ol><li>long</li></ol>
luanza	<i>noun</i><br><ol><li>spear</li></ol>
luarc	<i>adj</i><br><ol><li>wide</li></ol>
luc	<i>adv</i><br><ol><li>there</li></ol><br><i>noun</i><br><ol><li>place</li><li>estate</li><li>farm</li></ol>
luminur	<i>verb</i><br><ol><li>to light</li><li>to illuminate</li></ol>
luntun	<i>adj</i><br><ol><li>far away</li></ol>
luona	<i>noun</i><br><ol><li>wool</li></ol>
lusmarin	<i>noun</i><br><ol><li>rosemary</li></ol>
macnur	<i>verb</i><br><ol><li>to grind</li></ol>
mail	<i>noun</i><br><ol><li>millet</li><li>birdseed</li></ol>
main	<i>pron</i><br><ol><li>(first-person singular pronoun, oblique case) me</li></ol>
mais	<i>noun</i><br><ol><li>month</li></ol>
maisa	<i>noun</i><br><ol><li>table</li></ol>
maja|mi	<i>pron</i><br><ol><li>mine; first-person feminine singular possessive pronoun</li><li>my</li></ol>
mal	<i>noun</i><br><ol><li>evil, harm</li></ol>
malamiant	<i>adv</i><br><ol><li>badly, wrongly, incorrectly, dissolutely</li></ol>
manzula	<i>noun</i><br><ol><li>small sheaf (usually rye)</li></ol>
mančur|manonca|manciur	<i>verb</i><br><ol><li>to eat</li></ol>
marait	<i>noun</i><br><ol><li>husband</li></ol>
maraun	<i>adj</i><br><ol><li>brown</li></ol>
marcus	<i>adj</i><br><ol><li>bitter</li></ol>
marianda	<i>noun</i><br><ol><li>light meal; snack</li></ol>
martial	<i>noun</i><br><ol><li>hammer</li></ol>
martur	<i>verb</i><br><ol><li>to marry</li></ol>
masa	<i>noun</i><br><ol><li>Mass</li></ol>
matoir	<i>adj</i><br><ol><li>ripe</li></ol>
matraja	<i>noun</i><br><ol><li>stepmother</li></ol>
matuos	<i>noun</i><br><ol><li>skein, hank</li></ol>
maur|maura	<i>adj</i><br><ol><li>large</li></ol>
medco	<i>noun</i><br><ol><li>doctor</li></ol>
medcur	<i>verb</i><br><ol><li>to heal, medicate</li></ol>
medesem	<i>adj</i><br><ol><li>same</li></ol>
mejatoira	<i>noun</i><br><ol><li>urine</li></ol>
mel	<i>num</i><br><ol><li>thousand</li></ol>
meliurur	<i>verb</i><br><ol><li>to improve, to ameliorate</li></ol>
menur	<i>verb</i><br><ol><li>to lead</li></ol>
mercuante	<i>noun</i><br><ol><li>merchant</li></ol>
mescur	<i>verb</i><br><ol><li>to mix</li></ol>
mesu	<i>noun</i><br><ol><li>middle</li><li>half</li></ol>
metar|miater	<i>verb</i><br><ol><li>to put, place</li></ol>
mežul	<i>noun</i><br><ol><li>glass</li></ol>
mi|maja	<i>pron</i><br><ol><li>mine; first-person masculine singular possessive pronoun</li><li>my</li></ol>
miarda	<i>noun</i><br><ol><li>(vulgar) shit, excrement</li></ol>
miarla	<i>noun</i><br><ol><li>blackbird</li></ol>
mil	<i>noun</i><br><ol><li>honey</li></ol>
mirte	<i>noun</i><br><ol><li>Tuesday</li></ol>
mis|misa|misi	<i>adj</i><br><ol><li>half, half a/an</li><li>middle, mid</li><li>mid, in the middle of</li><li>mean, average</li></ol>
misedma	<i>noun</i><br><ol><li>Wednesday</li></ol>
miur	<i>verb</i><br><ol><li>to urinate, piss</li></ol>
moduonde	<i>noun</i><br><ol><li>pants (UK), underpants (US)</li><li>knickers</li></ol>
moitur	<i>verb</i><br><ol><li>to move</li></ol>
mojer	<i>noun</i><br><ol><li>woman</li><li>wife</li></ol>
molier	<i>noun</i><br><ol><li>(Vegliot) woman</li><li>(Vegliot) wife</li></ol>
moluar	<i>verb</i><br><ol><li>to grind</li></ol>
monaita	<i>noun</i><br><ol><li>coin</li></ol>
mor	<i>noun</i><br><ol><li>wall</li></ol>
moraus|morauza	<i>adj</i><br><ol><li>amorous, loving</li></ol><br><i>noun</i><br><ol><li>lover</li></ol>
morer	<i>verb</i><br><ol><li>to die</li></ol>
morscur|moscuar|morscuor	<i>verb</i><br><ol><li>to bite</li></ol>
muant	<i>noun</i><br><ol><li>mountain, mount</li></ol>
muarka	<i>noun</i><br><ol><li>dregs, sediment</li></ol>
muart	<i>adj</i><br><ol><li>dead</li></ol><br><i>noun</i><br><ol><li>death</li></ol>
muas	<i>adj</i><br><ol><li>rotten</li></ol>
muasca	<i>noun</i><br><ol><li>fly (insect)</li></ol>
mucna	<i>noun</i><br><ol><li>millstone</li></ol>
mui	<i>adv</i><br><ol><li>more</li></ol><br><i>conj</i><br><ol><li>but</li></ol>
mul	<i>adj</i><br><ol><li>bad</li></ol><br><i>noun</i><br><ol><li>evil</li></ol>
mult|muolt|muolta	<i>adj</i><br><ol><li>many</li></ol>
mun	<i>noun</i><br><ol><li>(anatomy) hand</li></ol>
muncial	<i>noun</i><br><ol><li>hill</li></ol>
muogro	<i>adj</i><br><ol><li>thin, lean, meagre</li></ol>
muosclo	<i>noun</i><br><ol><li>male</li></ol>
mur	<i>noun</i><br><ol><li>sea</li></ol>
muradaur	<i>noun</i><br><ol><li>mason</li></ol>
mut	<i>adv</i><br><ol><li>now</li></ol>
muvar|mugro	<i>verb</i><br><ol><li>to move</li></ol>
na	<i>adv</i><br><ol><li>no</li><li>not</li></ol>
nai	<i>noun</i><br><ol><li>snow</li></ol>
naid	<i>noun</i><br><ol><li>nest</li></ol>
nascoit	<i>adj</i><br><ol><li>(also past participle) born</li></ol>
nauc	<i>noun</i><br><ol><li>nut</li></ol>
naul	<i>noun</i><br><ol><li>uncle</li></ol>
naum	<i>noun</i><br><ol><li>name</li></ol>
naun	<i>noun</i><br><ol><li>name</li></ol><br><i>adv</i><br><ol><li>not</li></ol>
navigur	<i>verb</i><br><ol><li>to sail, navigate</li></ol>
ne	<i>adv</i><br><ol><li>neither</li></ol>
nemaic	<i>noun</i><br><ol><li>enemy</li></ol>
nenčoin	<i>pron</i><br><ol><li>no one, none</li></ol>
nepaut	<i>noun</i><br><ol><li>grandson</li><li>nephew</li></ol>
niapta	<i>noun</i><br><ol><li>niece</li></ol>
niar	<i>adj</i><br><ol><li>black</li></ol><br><i>noun</i><br><ol><li>nerve</li></ol>
nina	<i>noun</i><br><ol><li>mother</li></ol>
ninapta	<i>noun</i><br><ol><li>fiancée</li></ol>
ninapto	<i>noun</i><br><ol><li>fiancé</li></ol>
nochiera	<i>noun</i><br><ol><li>walnut (tree)</li></ol>
noi	<i>pron</i><br><ol><li>(first-person plural pronoun, oblique case) us</li></ol>
noid	<i>adj</i><br><ol><li>naked, nude</li></ol>
nolja	<i>pron</i><br><ol><li>nothing</li></ol>
nosko	<i>pron</i><br><ol><li>something (unspecified object)</li></ol>
nu	<i>num</i><br><ol><li>nine</li></ol><br><i>pron</i><br><ol><li>(second-person plural pronoun) we</li></ol>
nuester|nuestra	<i>pron</i><br><ol><li>our first-person masculine plural possessive pronoun</li></ol>
nuestra|nuester	<i>pron</i><br><ol><li>our; first-person feminine plural possessive pronoun</li></ol>
nuf|núa	<i>adj</i><br><ol><li>new</li></ol>
nuos	<i>noun</i><br><ol><li>nose</li></ol>
nuot|nuate|nuote|nuat	<i>noun</i><br><ol><li>night</li></ol>
octuanta	<i>num</i><br><ol><li>eighty</li></ol>
odaur	<i>noun</i><br><ol><li>smell, odor</li></ol>
odiur	<i>verb</i><br><ol><li>to hate</li></ol>
olea	<i>noun</i><br><ol><li>olive</li></ol>
onaur	<i>noun</i><br><ol><li>honor</li></ol>
oracla	<i>noun</i><br><ol><li>ear</li></ol>
otuonta	<i>num</i><br><ol><li>eighty</li></ol>
ourata	<i>noun</i><br><ol><li>the dorado, dolphin (fish)</li></ol>
pacur	<i>verb</i><br><ol><li>to pay</li></ol>
padella	<i>noun</i><br><ol><li>pan</li></ol>
pail	<i>noun</i><br><ol><li>(body) hair</li></ol>
paila	<i>noun</i><br><ol><li>jug</li></ol>
paira	<i>noun</i><br><ol><li>pear</li></ol>
paiš	<i>noun</i><br><ol><li>country</li></ol>
palas	<i>noun</i><br><ol><li>palace</li></ol>
paradais	<i>noun</i><br><ol><li>paradise</li></ol>
paraul	<i>noun</i><br><ol><li>word</li></ol>
paraula|palaura|paraura	<i>noun</i><br><ol><li>word</li></ol>
parlur|paulur|parla|paula	<i>verb</i><br><ol><li>to speak</li><li>to chat</li></ol>
pasc	<i>noun</i><br><ol><li>fish</li></ol>
pascu	<i>noun</i><br><ol><li>bishop</li></ol>
paserain	<i>noun</i><br><ol><li>bird</li></ol>
pasnur	<i>verb</i><br><ol><li>to dig up a vineyard</li></ol>
pauc	<i>adj</i><br><ol><li>little</li></ol>
pauper	<i>adj</i><br><ol><li>poor</li></ol>
pecataur|pecaudur	<i>noun</i><br><ol><li>sinner</li></ol>
pecla	<i>noun</i><br><ol><li>melted pitch</li></ol>
pedlo|pedla	<i>adj</i><br><ol><li>small, little</li></ol>
pedoclo	<i>noun</i><br><ol><li>(Vegliot) louse</li></ol>
pepro	<i>noun</i><br><ol><li>pepper</li></ol>
percó	<i>conj</i><br><ol><li>why</li></ol>
perfaict|perfaicta	<i>adj</i><br><ol><li>perfect</li></ol>
perké	<i>adv</i><br><ol><li>why</li></ol>
pernaica	<i>noun</i><br><ol><li>partridge</li></ol>
pesaint	<i>adj</i><br><ol><li>heavy</li></ol>
pescatoira	<i>noun</i><br><ol><li>lock</li></ol>
pescuar	<i>verb</i><br><ol><li>to fish</li></ol>
pesunt	<i>verb</i><br><ol><li>(present participle, in the expression "da pesunt") with difficulty</li></ol>
pezlur|pezla	<i>verb</i><br><ol><li>to drip</li></ol>
pi|pič	<i>noun</i><br><ol><li>foot</li></ol>
piacno	<i>noun</i><br><ol><li>comb</li></ol>
pial	<i>noun</i><br><ol><li>skin</li></ol>
piandar	<i>verb</i><br><ol><li>to hang</li></ol>
piandro	<i>verb</i><br><ol><li>to paint</li></ol>
piardro	<i>verb</i><br><ol><li>to lose</li></ol>
pinsamiant	<i>noun</i><br><ol><li>thought</li><li>worry</li></ol>
pitra	<i>noun</i><br><ol><li>stone</li></ol>
pizaraul	<i>noun</i><br><ol><li>bun</li></ol>
pjancura	<i>noun</i><br><ol><li>wall plant</li></ol>
placar	<i>verb</i><br><ol><li>to please</li></ol>
plain|plaina	<i>adj</i><br><ol><li>full</li></ol>
plaza	<i>noun</i><br><ol><li>street</li></ol>
ple	<i>adj</i><br><ol><li>(comparative adjective) more</li></ol>
plomb	<i>noun</i><br><ol><li>lead</li></ol>
plongur	<i>verb</i><br><ol><li>to push on, to press</li></ol>
pluaja	<i>noun</i><br><ol><li>rain</li></ol>
plui	<i>noun</i><br><ol><li>sloping street</li><li>beach</li></ol>
plungro	<i>verb</i><br><ol><li>to complain</li><li>to cry</li></ol>
polber	<i>noun</i><br><ol><li>dust, powder</li></ol>
poluastro	<i>noun</i><br><ol><li>young fowl, cockerel</li></ol>
ponro	<i>verb</i><br><ol><li>to put, to place</li></ol>
poplo|popli	<i>noun</i><br><ol><li>people</li></ol>
portur	<i>verb</i><br><ol><li>to carry, bear</li><li>to bring</li></ol>
potar|puasa|javaite potoit|potrai|avaite potoit|potas|potajaite|jai potoit|potarte|puas|potassaite|potaja|potai|avaime potoit|avaja potoit|potasse|potassaime|potassa|avas potoit|potaite|potoit|javaime potoit|potando|naun potai|naun puasaime|potarme|potra|ji potoit|potajaime|naun potaite|ju potoit|potre|puasaime	<i>verb</i><br><ol><li>can; be able to</li></ol>
potuor	<i>verb</i><br><ol><li>to prune</li></ol>
praimo|praima|preina|prein	<i>adj</i><br><ol><li>first</li></ol><br><i>noun</i><br><ol><li>first, the first</li></ol>
prandar	<i>verb</i><br><ol><li>to dine</li></ol>
precur	<i>verb</i><br><ol><li>to ask, request</li></ol>
preguar	<i>verb</i><br><ol><li>to pray</li></ol>
prendro|prendra|prendre|prendute|prendassaite|prendaite|prendar|avaite prais|prendua|prendendo|prendas|prendassa|naun prendai|prendaime|jaite prais|je prais|avaja prais|prendume|prendassaime|prenderte|prendasse|prendaja|prendO|ju prais|naun prendaime|avas prais|jai prais|prendrai|prenderme|naun prendaite|jaime prais|prais|prendai|avaime prais	<i>verb</i><br><ol><li>to take</li></ol>
priast	<i>noun</i><br><ol><li>priest</li></ol>
prin	<i>adj</i><br><ol><li>pregnant</li></ol>
prinsep	<i>noun</i><br><ol><li>prince</li></ol>
prinz	<i>noun</i><br><ol><li>breakfast</li></ol>
provocur	<i>verb</i><br><ol><li>to provoke</li></ol>
provur	<i>verb</i><br><ol><li>to try</li></ol>
puant	<i>noun</i><br><ol><li>bridge</li></ol>
puarc|puarč	<i>noun</i><br><ol><li>pig, swine</li></ol>
puart	<i>noun</i><br><ol><li>part</li></ol>
puarta	<i>noun</i><br><ol><li>door</li></ol>
puas	<i>noun</i><br><ol><li>step</li></ol>
pula	<i>noun</i><br><ol><li>penis</li></ol>
pulco	<i>noun</i><br><ol><li>flea</li></ol>
pulvro	<i>noun</i><br><ol><li>dust</li></ol>
pun	<i>noun</i><br><ol><li>(Vegliot) bread</li></ol>
puolma	<i>noun</i><br><ol><li>(anatomy) palm</li></ol>
puoscro	<i>verb</i><br><ol><li>to graze</li></ol>
puoscua|puasc|puosc	<i>noun</i><br><ol><li>Easter</li></ol>
pur|puor	<i>verb</i><br><ol><li>to appear</li></ol>
quaranta	<i>num</i><br><ol><li>forty</li></ol>
ra	<i>noun</i><br><ol><li>king</li></ol>
racuardar|rekordüa	<i>verb</i><br><ol><li>to recall, remember, remind</li></ol>
radaica	<i>noun</i><br><ol><li>root</li></ol>
raigno	<i>noun</i><br><ol><li>kingdom</li></ol>
raim	<i>noun</i><br><ol><li>oar</li></ol>
raipa|raipe	<i>noun</i><br><ol><li>shore</li></ol>
rait	<i>noun</i><br><ol><li>net</li></ol>
rasaun	<i>noun</i><br><ol><li>reason</li></ol>
recanjala	<i>noun</i><br><ol><li>cover</li></ol>
recolegro|recolgro	<i>verb</i><br><ol><li>to gather</li></ol>
redro	<i>verb</i><br><ol><li>to laugh</li></ol>
respondro	<i>verb</i><br><ol><li>to respond</li></ol>
restur|restuote	<i>verb</i><br><ol><li>to stay</li></ol>
retentiaun	<i>noun</i><br><ol><li>retention</li></ol>
reticuot|retikuot	<i>noun</i><br><ol><li>heretic</li></ol>
ri|raja	<i>adj</i><br><ol><li>bad</li></ol>
rivision|rivisi̯óṅ	<i>noun</i><br><ol><li>dream (imaginary events seen during sleep)</li></ol>
roita	<i>noun</i><br><ol><li>rue, common rue (Ruta graveolens)</li></ol>
rondaina	<i>noun</i><br><ol><li>swallow (bird)</li></ol>
ruoma	<i>noun</i><br><ol><li>branch, twig</li></ol>
ruosa|ruose	<i>noun</i><br><ol><li>rose</li><li>flower</li></ol>
rus	<i>noun</i><br><ol><li>ray</li></ol>
ruzuda	<i>noun</i><br><ol><li>dew</li></ol>
sabata	<i>noun</i><br><ol><li>Saturday</li></ol>
sablaun|salbaun	<i>noun</i><br><ol><li>sand</li></ol>
saira	<i>noun</i><br><ol><li>evening</li><li>yesterday evening</li></ol>
sait	<i>noun</i><br><ol><li>thirst</li></ol>
saita	<i>noun</i><br><ol><li>silk</li></ol>
saite|sante|avas foit|fera|fuasse|ji foit|ju foit|sant|foite|jera|naun saime|jaite foit|fuassaite|jeri|jai foit|fuassaime|avaja foit|sait|avajaite foit|jaime foit|avai foit|naun sai|foi|fere|jeraime|fero|foit|fuas|foime|stut|saime|furme|stundo|sai|furte|naun saite|avajaime foit|fure|jeraite|fuassa	<i>verb</i><br><ol><li>(irregular) to be</li></ol>
saltur	<i>verb</i><br><ol><li>to jump</li></ol>
samno	<i>noun</i><br><ol><li>(Vegliot) sleep</li></ol>
samur	<i>noun</i><br><ol><li>donkey, ass</li></ol>
sanglo|sangla	<i>adj</i><br><ol><li>alone</li></ol>
sansoike	<i>noun</i><br><ol><li>(in the plural) leeches</li></ol>
santificuot	<i>adj</i><br><ol><li>sanctified, holy, hallowed</li></ol>
santut	<i>noun</i><br><ol><li>health</li></ol>
sapaun	<i>noun</i><br><ol><li>soap</li></ol>
sapro|sapai|sapendo|sapasse|avaja sapait|sapassa|ju sapait|sapaja|sapait|sapute|naun sapai|sapassaime|naun sapaite|javaime sapait|sapar|sapre|avas sapait|avai sapait|sapui|sapassaite|sapaite|saprai|sai|je sapait|saperme|sapume|avajaite sapait|avajaime sapait|sapua|saperte|naun sapaime|sapas|jai sapait|sapra|sapaime|javaite sapait	<i>verb</i><br><ol><li>to know</li></ol>
sapto	<i>num</i><br><ol><li>seven</li></ol>
saran	<i>adj</i><br><ol><li>serene</li></ol>
satoil	<i>adj</i><br><ol><li>sated, satisfied</li></ol>
satur	<i>verb</i><br><ol><li>to jump</li></ol>
saul	<i>noun</i><br><ol><li>sun</li></ol>
saupra	<i>prep</i><br><ol><li>on, on top of</li></ol><br><i>adj</i><br><ol><li>upper</li></ol>
saur|seraur	<i>noun</i><br><ol><li>sister</li></ol>
scol|skól	<i>noun</i><br><ol><li>school</li></ol>
scribro|scriber	<i>verb</i><br><ol><li>to write</li></ol>
scul	<i>noun</i><br><ol><li>armpit</li></ol>
scutro	<i>verb</i><br><ol><li>to remove</li></ol>
se	<i>pron</i><br><ol><li>(reflexive) oneself</li></ol>
secla	<i>noun</i><br><ol><li>sickle</li></ol>
seclur	<i>verb</i><br><ol><li>to reap</li></ol>
secut	<i>adj</i><br><ol><li>(also past participle) dried</li></ol>
sedarul	<i>noun</i><br><ol><li>handkerchief</li></ol>
senter|sentait|siante	<i>verb</i><br><ol><li>to feel</li><li>to perceive</li></ol>
septuanta	<i>num</i><br><ol><li>seventy</li></ol>
seraul	<i>noun</i><br><ol><li>sister</li></ol>
serur|seruar	<i>verb</i><br><ol><li>to close, shut</li></ol>
setco	<i>num</i><br><ol><li>sixteen</li></ol>
setemúna	<i>noun</i><br><ol><li>week</li></ol>
si	<i>num</i><br><ol><li>six</li></ol>
siala	<i>noun</i><br><ol><li>saddle</li></ol>
siampro|siampre	<i>adv</i><br><ol><li>always</li></ol>
sianpro	<i>adv</i><br><ol><li>always</li></ol>
siansa	<i>prep</i><br><ol><li>without</li></ol>
sieglu	<i>noun</i><br><ol><li>bucket, pail</li></ol>
sinar|sinari	<i>noun</i><br><ol><li>mister</li></ol>
sinaur|sinauri	<i>noun</i><br><ol><li>mister</li></ol>
sinjaur	<i>noun</i><br><ol><li>sir</li></ol>
skol	<i>noun</i><br><ol><li>school</li></ol>
skul	<i>noun</i><br><ol><li>armpit</li></ol>
sois	<i>adv</i><br><ol><li>upward</li></ol>
sombreja	<i>noun</i><br><ol><li>shade</li></ol>
sonur	<i>verb</i><br><ol><li>to ring</li><li>to sound</li></ol>
sostuanza	<i>noun</i><br><ol><li>substance</li><li>property</li></ol>
sot	<i>adj</i><br><ol><li>dry</li></ol>
sote	<i>adv</i><br><ol><li>under</li></ol>
spaica	<i>noun</i><br><ol><li>(botany) spike (ear of grain)</li></ol>
spaina|spaine	<i>noun</i><br><ol><li>thorn</li></ol>
spangro	<i>verb</i><br><ol><li>to push</li></ol>
sperur|sperut	<i>verb</i><br><ol><li>to hope</li><li>to wait</li></ol>
spirač	<i>noun</i><br><ol><li>asparagus</li></ol>
sploima	<i>noun</i><br><ol><li>foam</li></ol>
spoit	<i>noun</i><br><ol><li>sputum, spit, spittle, saliva</li></ol>
sputa	<i>noun</i><br><ol><li>sword</li></ol>
stal	<i>noun</i><br><ol><li>millstone shaft</li></ol>
stala|stalla|stale|stalle	<i>noun</i><br><ol><li>(Vegliot) star</li></ol>
stasaun	<i>noun</i><br><ol><li>store, shop</li></ol>
stataira	<i>noun</i><br><ol><li>steelyard</li></ol>
stentur	<i>verb</i><br><ol><li>to work</li></ol>
stiass	<i>adj</i><br><ol><li>same</li></ol>
stomac	<i>noun</i><br><ol><li>stomach</li></ol>
stotur	<i>verb</i><br><ol><li>to extinguish</li></ol>
strengar	<i>verb</i><br><ol><li>to squeeze</li></ol>
stupair	<i>verb</i><br><ol><li>to surprise</li></ol>
stur|stut	<i>verb</i><br><ol><li>to be</li></ol>
suald|sualdi	<i>noun</i><br><ol><li>penny, cent</li><li>(in the plural) money</li></ol>
sualdi	<i>noun</i><br><ol><li>money</li></ol>
suang	<i>noun</i><br><ol><li>blood</li></ol>
suant	<i>adj</i><br><ol><li>holy</li></ol><br><i>noun</i><br><ol><li>saint</li></ol>
suard	<i>adj</i><br><ol><li>deaf</li></ol>
suars	<i>noun</i><br><ol><li>sip</li></ol>
suart	<i>noun</i><br><ol><li>fate, destiny</li></ol>
subatu	<i>noun</i><br><ol><li>Saturday</li></ol>
sublar	<i>verb</i><br><ol><li>to whistle</li></ol>
sudaur	<i>noun</i><br><ol><li>sweat</li></ol>
sugol	<i>noun</i><br><ol><li>lamb</li></ol>
surca pizigaun	<i>noun</i><br><ol><li>bat (animal)</li></ol>
surco	<i>noun</i><br><ol><li>mouse</li></ol>
susana|susane	<i>noun</i><br><ol><li>plum</li></ol>
sčela	<i>noun</i><br><ol><li>chip, splinter</li></ol>
sčor	<i>adj</i><br><ol><li>dark</li></ol><br><i>noun</i><br><ol><li>axe, hatchet</li></ol>
tacar	<i>verb</i><br><ol><li>to be silent, keep quiet</li></ol>
tacla	<i>noun</i><br><ol><li>pan; baking pan</li></ol>
taljur|taljuat	<i>verb</i><br><ol><li>to cut</li></ol>
tara|tiara	<i>noun</i><br><ol><li>earth, ground</li></ol>
te	<i>pron</i><br><ol><li>(second-person singular pronoun) you, thou</li></ol>
tempiasta	<i>noun</i><br><ol><li>storm</li></ol>
tenar	<i>verb</i><br><ol><li>to hold, keep</li></ol>
tentatiaun	<i>noun</i><br><ol><li>temptation</li></ol>
tesuor	<i>verb</i><br><ol><li>to weave</li></ol>
tial	<i>noun</i><br><ol><li>cloth</li></ol>
tiamp|tianp	<i>noun</i><br><ol><li>time</li></ol>
tierč	<i>adj</i><br><ol><li>slow</li><li>late</li></ol>
tinir	<i>noun</i><br><ol><li>tub, vat</li></ol>
to|toa	<i>pron</i><br><ol><li>your; second-person masculine singular possessive pronoun</li></ol>
toa|to	<i>pron</i><br><ol><li>your; second-person feminine singular possessive pronoun</li></ol>
toi	<i>pron</i><br><ol><li>(second-person singular pronoun, oblique case) you, thee</li></ol>
tonur	<i>verb</i><br><ol><li>to thunder</li></ol>
tormiant	<i>noun</i><br><ol><li>torture, torment</li></ol>
tornuar	<i>verb</i><br><ol><li>to return, come back</li></ol>
tot|tota|toč	<i>adj</i><br><ol><li>all</li></ol><br><i>pron</i><br><ol><li>everything</li></ol>
tra	<i>num</i><br><ol><li>three</li></ol>
tragala	<i>noun</i><br><ol><li>fishing net</li></ol>
trairo|traict	<i>verb</i><br><ol><li>to bring</li><li>to drag</li></ol>
tranta	<i>num</i><br><ol><li>thirty</li></ol>
travalur	<i>verb</i><br><ol><li>to work</li></ol>
tretco	<i>num</i><br><ol><li>thirteen</li></ol>
trok|troki	<i>noun</i><br><ol><li>child, youngster</li></ol>
troka	<i>noun</i><br><ol><li>girl</li></ol>
tronc	<i>noun</i><br><ol><li>trunk</li></ol>
trua	<i>noun</i><br><ol><li>beam, rafter, raft</li></ol>
truar	<i>verb</i><br><ol><li>to throw</li></ol>
trufo	<i>noun</i><br><ol><li>wine jug</li></ol>
tuant|tuonti|tuonta|tuonte	<i>adj</i><br><ol><li>much, many, a lot of</li><li>such</li></ol><br><i>adv</i><br><ol><li>so much</li><li>very</li></ol>
tun	<i>noun</i><br><ol><li>thunderclap, thunder</li></ol>
tuota	<i>noun</i><br><ol><li>(Vegliot) father, dad</li></ol>
turta	<i>noun</i><br><ol><li>Four attached little loaves of bread; row of loaves attached by thin kissing crust.</li></ol>
uaclo	<i>noun</i><br><ol><li>eye</li></ol>
uapto|guapto	<i>num</i><br><ol><li>eight</li></ol>
uarno	<i>noun</i><br><ol><li>ash tree, ash</li></ol>
usur	<i>verb</i><br><ol><li>to use</li></ol>
vaca|bacca|baca|vacca	<i>noun</i><br><ol><li>cow</li></ol>
vai|vuai	<i>adv</i><br><ol><li>today</li></ol>
vaila	<i>noun</i><br><ol><li>sail</li></ol>
vain	<i>noun</i><br><ol><li>wine</li></ol>
vaina	<i>noun</i><br><ol><li>vein</li></ol>
vaita	<i>noun</i><br><ol><li>vine</li><li>life</li></ol>
valar	<i>verb</i><br><ol><li>to be worth</li></ol>
vaple	<i>noun</i><br><ol><li>maple tree</li></ol>
vart	<i>noun</i><br><ol><li>vegetable garden</li></ol>
veclisun|veklisun|veklisúṅ	<i>noun</i><br><ol><li>Vegliot (the dialect of Dalmatian spoken in Veglia)</li></ol>
vedar|vedoit|viad|vi	<i>verb</i><br><ol><li>to see</li></ol>
vedmur	<i>verb</i><br><ol><li>to harvest grapes</li></ol>
vejur	<i>verb</i><br><ol><li>to watch over</li><li>to stay up, keep a vigil</li></ol>
ven	<i>noun</i><br><ol><li>wine</li></ol>
vendro|vandro	<i>verb</i><br><ol><li>to sell</li></ol>
vener	<i>verb</i><br><ol><li>to come</li></ol>
venja	<i>noun</i><br><ol><li>vineyard</li></ol>
venč	<i>num</i><br><ol><li>twenty</li></ol>
vestemiant	<i>noun</i><br><ol><li>clothing, clothes, garment</li></ol>
vester	<i>verb</i><br><ol><li>to dress, clothe</li></ol><br><i>det</i><br><ol><li>your second-person masculine plural possessive determiner</li></ol>
vestra|vestro	<i>pron</i><br><ol><li>your; second-person feminine plural possessive pronoun</li></ol>
vestro|vestra	<i>pron</i><br><ol><li>your second-person masculine plural possessive pronoun</li></ol>
vetrun|vetruona	<i>adj</i><br><ol><li>(Vegliot) old, aged</li></ol>
vi|vei	<i>adj</i><br><ol><li>alive, living</li></ol>
viala	<i>noun</i><br><ol><li>squirrel</li><li>hamster</li></ol>
viant	<i>noun</i><br><ol><li>wind</li></ol>
viantro	<i>noun</i><br><ol><li>(Vegliot) belly</li></ol>
viard|viarda	<i>adj</i><br><ol><li>green</li></ol>
viarz|viarze	<i>noun</i><br><ol><li>type of cabbage</li></ol>
viaspro	<i>noun</i><br><ol><li>evening</li></ol>
viatro	<i>noun</i><br><ol><li>glass (substance)</li></ol>
vieclo	<i>adj</i><br><ol><li>old</li></ol>
vindre	<i>noun</i><br><ol><li>Friday</li></ol>
vis	<i>verb</i><br><ol><li>(first-person singular indicative present) of zer</li></ol>
visiaun	<i>noun</i><br><ol><li>vision</li></ol>
vičain	<i>noun</i><br><ol><li>neighbor</li></ol>
voi	<i>pron</i><br><ol><li>(second-person plural pronoun, oblique case) you</li></ol>
voluntuot	<i>noun</i><br><ol><li>will</li></ol>
vu	<i>pron</i><br><ol><li>(second-person plural pronoun) you, you all, ye</li></ol>
vuarb	<i>adj</i><br><ol><li>blind</li></ol>
vuarz	<i>noun</i><br><ol><li>barley</li></ol>
vuas	<i>noun</i><br><ol><li>(Vegliot) bone</li></ol>
vular|avaja vuloit|blassa|vulare|blassaime|blaja|vulai|vularai|vulajaime|vulajaite|avajaite vuloit|bloit|avaja bloit|jaime vuloit|blarte|avaime bloit|naun blaime|vulando|vularte|ji vuloit|blai|vuloit|avajaime vuloit|vulajo|avas vuloit|jai bloit|blare|avas bloit|vulassa|blarme|vularme|vulassaime|je bloit|jai vuloit|vulaja|naun blai|jaite bloit|blarai|blaiame|vulasse|avai vuloit|blara|blando|jaime bloit|naun vulai|avaite bloit|vulaite|ju vuloit|jaite vuloit|vulaime|blaire|blaime|vulassaite|naun vulaite|blaite|blassaite|blar|vulara|ju bloit|avai bloit|naun vulaime|blas|blaiate|blasse|blajo|naun blaite|vulas	<i>verb</i><br><ol><li>to want, wish</li></ol>
vun	<i>noun</i><br><ol><li>oats</li></ol>
vuon	<i>noun</i><br><ol><li>oat</li></ol>
yan	<i>noun</i><br><ol><li>year (Vegliot)</li></ol>
yedma	<i>noun</i><br><ol><li>week (Vegliot)</li></ol>
zaug	<i>noun</i><br><ol><li>yoke</li></ol>
zer|visa|vaime|vaite|zisse|visaime|zait|zissaime|zero|zissaite|jai zait|avas zait|ju zait|zis|avaja zait|zera|zerte|zai|zaja|zaite|zere|naun zaime|naun zaite|zissa|ji zait|zaime|jaime zait|naun zai|jaite zait|avajaime zait|vi|visaite|vis|zajaime|zerme|zerai|avajaite zait|zajaite|zendo	<i>verb</i><br><ol><li>to go</li></ol>
ziant	<i>noun</i><br><ol><li>people</li></ol>
ziziul	<i>noun</i><br><ol><li>thimble</li></ol>
zoglo	<i>noun</i><br><ol><li>neck</li></ol>
zuap	<i>adj</i><br><ol><li>lame, crippled</li></ol>
zue	<i>noun</i><br><ol><li>Thursday</li></ol>
zuola	<i>adj</i><br><ol><li>yellow</li></ol>
čaico	<i>adv</i><br><ol><li>here</li></ol>
čala	<i>intj</i><br><ol><li>look!</li></ol>
čama	<i>noun</i><br><ol><li>peak, summit, top</li></ol>
čap	<i>noun</i><br><ol><li>flock</li></ol>
časa	<i>noun</i><br><ol><li>noise, hubbub, sound, din</li></ol>
čauca	<i>noun</i><br><ol><li>hen, mother hen</li><li>(figuratively) mothering woman</li></ol>
čedur	<i>verb</i><br><ol><li>to surrender, relinquish, submit, cede</li></ol>
čeja|ci	<i>noun</i><br><ol><li>lash</li><li>brow</li></ol>
čelka	<i>noun</i><br><ol><li>sparrow</li></ol>
čemitier	<i>noun</i><br><ol><li>cemetery, burial ground</li></ol>
čenc	<i>num</i><br><ol><li>five</li></ol>
čertjoin	<i>pron</i><br><ol><li>somebody</li></ol>
čoc|čoč	<i>noun</i><br><ol><li>peasant</li></ol>
čol	<i>noun</i><br><ol><li>(vulgar, Vegliot) arse, ass</li></ol>
čonco	<i>num</i><br><ol><li>fifteen</li></ol>
čoncuanta	<i>num</i><br><ol><li>fifty</li></ol>
čuarv	<i>adj</i><br><ol><li>cockeyed, squinting</li></ol>
čuolta	<i>noun</i><br><ol><li>hold, grasp, handle</li></ol>
