أبيب|ʔabīb	<i>name</i><br><ol><li>The eleventh month of the Coptic calendar.</li></ol>
أجر|ḥatʾaggar|أجّري|ʾaggart|بتأجّروا|ḥaʾaggar|اأجّر|بنأجّر|ḥayʾaggaru|أجّروا|تأجّر|aʾaggar|حيأجّروا|yiʾaggar|tiʾaggaru|بأجّر|أجّرت|ʾaggarti|حأجّر|بيأجّر|baʾaggar|yiʾaggaru|متأجر|bitʾaggari|ʾaggarit|binʾaggar|يأجّر|أجّرنا|تأجّري|بتأجّر|أجّرتي|يأجّروا|ʾaggaru|ḥatʾaggaru|biyʾaggar|أجّر|أجّرتوا|نأجّر|tiʾaggar|حتأجّروا|ḥayʾaggar|حنأجّر|ḥatʾaggari|ʾaggarna|bitʾaggar|بتأجّري|ḥanʾaggar|ʾaggar|bitʾaggaru|تأجّروا|حيأجّر|بيأجّروا|niʾaggar|tiʾaggari|حتأجّري|Term?|ʾaggari|ʾaggartu|biyʾaggaru|حتأجّر	<i>verb</i><br><ol><li>(transitive) to rent</li></ol>
أربعة|ʾaṛbaʿa	<i>num</i><br><ol><li>four</li></ol>
أربعتاشر|ʾaṛbaʿtāšaṛ	<i>num</i><br><ol><li>fourteen</li></ol>
أربعين|ʾarbaʿīn	<i>num</i><br><ol><li>forty</li></ol>
أرضية|ارضية|ʾarḍiyya	<i>noun</i><br><ol><li>floor</li><li>flooring</li><li>background</li><li>storage charge</li><li>rental of ground</li></ol>
أستيكة|أساتيك|اساتيك|astīka|استيكات|استيكه|مستيكة|أستيكات|استيكة|mastīka|مساتيك	<i>noun</i><br><ol><li>chewing gum</li><li>rubber to erase writing</li><li>squeegee for printing etc.</li><li>rubber bowl such as used by a barber</li><li>stick, cue</li></ol>
أسد|أسود|أسدة|ʾasad	<i>noun</i><br><ol><li>lion</li><li>(astrology) Leo</li></ol>
أصر|يصرّ|yiṣirr|ʾaṣarr	<i>verb</i><br><ol><li>(intransitive) to insist, to persist</li></ol>
أكرة|أكر|ʔukra	<i>noun</i><br><ol><li>handle</li><li>doorknob</li></ol>
أكل|ʾakal|ياكل	<i>verb</i><br><ol><li>(transitive, sometimes humorous) to eat at, to vex, to irritate</li><li>(transitive) to irritate the skin of</li></ol>
ألف|آلاف|ʾalf	<i>num</i><br><ol><li>thousand</li></ol>
أم|أمّ|'umm	<i>noun</i><br><ol><li>mother</li></ol>
أمشير|ʔamšir	<i>name</i><br><ol><li>The twelfth month of the Coptic calendar.</li></ol>
أنا|'ána	<i>pron</i><br><ol><li>I</li></ol>
أنا ما بتكلمش إنجليزي|ana ma batkallimsh ingilizi	<i>phrase</i><br><ol><li>I don't speak English</li></ol>
أنا مبتكلمش عربي|ʾanā mabatkallimš ʿarabi|أَنَا مَبَتْكَلِّمْش عَرَبِي	<i>phrase</i><br><ol><li>I don't speak Arabic</li></ol>
أنبا|ʔamba	<i>noun</i><br><ol><li>apa (a title used for male clergy or saints in the Coptic Church)</li></ol>
أنهي|ʔanhi	<i>pron</i><br><ol><li>(interrogative) which?</li></ol>
أوضة|إوض|أوض|أوضات|ʾōḍa	<i>noun</i><br><ol><li>room (part of a building)</li><li>suite (of furniture)</li></ol>
أوضة نوم|ʾōḍit nōm	<i>noun</i><br><ol><li>bedroom</li></ol>
إخوانجي|iḵwangi|إخوانجية	<i>noun</i><br><ol><li>Islamist; Salafist; particularly but not necessarily a member or supporter of the Muslim Brotherhood</li></ol>
إيه|إِيه|ʾēh	<i>pron</i><br><ol><li>what?</li></ol>
ابتسم|ibtásam|يبتسم	<i>verb</i><br><ol><li>to smile</li></ol>
ابو دقيق|أَبُو دَقِيق|ʾabu diʾīʾ	<i>noun</i><br><ol><li>butterfly</li></ol>
ابو شبت|ʾabu šabat	<i>noun</i><br><ol><li>spider</li></ol>
ابو قردان|ʾabu ʾirdān|أَبُو قِرْدَان	<i>noun</i><br><ol><li>cattle egret</li><li>ibis</li></ol>
اتكلم|ħanitkállim|itkallímtu|bititkállim|حتتكلّموا|itkallími|اتكلّمتي|بتتكلّم|حيتكلّموا|ħatitkallímu|بتتكلّمي|itkallímti|itkallímit|بنكلّم|ħatitkallími|اتكلّمنا|binitkállim|bititkallími|تتكلّمي|حيتكلّم|atkállim|ħatkállim|nitkállim|اتكلّمت|titkállim|itkallímna|بيتكلّم|yitkallímu|اتكلّم|batkállim|حتكلّم|اتكلّمتوا|biyitkallímu|متكلم|بتتكلّموا|تتكلّم|بيتكلّموا|itkallímt|اتكلّموا|ħatitkállim|بتكلّم|ħayitkállim|يتكلّموا|yitkállim|تكلّم|itkallímu|titkallímu|itkállim|bititkallímu|نتكلّم|تتكلّموا|biyitkállim|حنتكلّم|اتكلّمي|ħayitkallímu|حتتكلّمي|يتكلّم|Term?|يتكلم|حتتكلّم|titkallími	<i>verb</i><br><ol><li>to speak</li></ol>
اتمنى|itmana	<i>verb</i><br><ol><li>to hope (“to want something to happen”)</li></ol>
اتناشر|itnāšar	<i>num</i><br><ol><li>twelve</li></ol>
اتنين|itnēn	<i>num</i><br><ol><li>two</li></ol>
اتيكيت|ʾitikēt|اتيكيتات	<i>noun</i><br><ol><li>etiquette</li><li>label or tag</li></ol>
احا|aḥḥa	<i>intj</i><br><ol><li>(vulgar) exclamation of anger or surprise</li></ol>
احتاج|iħtāg|يحتاج	<i>verb</i><br><ol><li>(with ل) to be in need (of)</li></ol>
احتجاج|eḥtegāg	<i>noun</i><br><ol><li>protest</li></ol>
احنا|ihna	<i>pron</i><br><ol><li>we (subject pronoun)</li></ol>
ازاى|izzāy	<i>adv</i><br><ol><li>how</li></ol>
ازاي|izzāy	<i>adv</i><br><ol><li>(interrogative) how?</li></ol>
ازيك|izzáyyik?|اِزَّيَّك؟|izzáyyak?|اِزَّيِّك؟	<i>phrase</i><br><ol><li>how are you? (to a man)</li><li>how are you? (to a woman)</li></ol>
استحمى|istaḥamma|يستحمّى|استحمّى	<i>verb</i><br><ol><li>(intransitive) to bathe, to have a bath</li><li>(intransitive, euphemistic) to have sexual intercourse</li><li>(intransitive) to bathe, to go for a swim</li></ol>
استخدم|يستخدم|istaḵdim	<i>verb</i><br><ol><li>to use, to exercise</li></ol>
استريح|استريّح|يستريّح|istarayyaḥ	<i>verb</i><br><ol><li>(intransitive) to rest, to relax</li><li>(intransitive) to feel comfortable</li><li>(intransitive) to find relief</li></ol>
استعمل|istaʿmil|يستخدم	<i>verb</i><br><ol><li>to use, to exercise</li></ol>
استنى|يستنى|istanna	<i>verb</i><br><ol><li>to wait (for)</li></ol>
اشترى|ištarā|يشتري	<i>verb</i><br><ol><li>to buy (“to obtain for money”)</li></ol>
اشتغل|ishtaghal|yishtaghil	<i>verb</i><br><ol><li>to work (to do a specific task)</li></ol>
اقول تور، يقول احلبوه|يقول احلبوه.|اقول تور	<i>proverb</i><br><ol><li>I say, "It's a bull"; he says, "milk it."</li></ol>
ال|الـ	<i>article</i><br><ol><li>the</li></ol>
الجزاير|el-gazāyer	<i>name</i><br><ol><li>Algeria (a country in Africa)</li></ol>
الله يسهلك|allah ysahillak	<i>phrase</i><br><ol><li>A phrase commonly used to turn away beggars.</li></ol>
النهارده|en-nahār-da	<i>adv</i><br><ol><li>today</li></ol>
امبارح|imbāriḥ	<i>adv</i><br><ol><li>yesterday</li></ol>
امبو|ʔumbū	<i>noun</i><br><ol><li>(childish) water (children's language: any drink, but especially water)</li><li>(childish) drink</li></ol>
امتى|imta	<i>adv</i><br><ol><li>when (at what time ?)</li></ol>
انا جيى|ana gey	<i>phrase</i><br><ol><li>I'm gay</li></ol>
انا مش متدين|ána mish mutadayyin|انا مش متدينة	<i>phrase</i><br><ol><li>I'm not religious</li></ol>
انت|inta|intu|inti	<i>pron</i><br><ol><li>you</li></ol>
انت متدين|انت متدين؟	<i>phrase</i><br><ol><li>are you religious?</li></ol>
انتخب|انتخبتي|تنتخبوا|intaḵabna|ḥayintiḵibu|yintiḵib|ننتخب|بينتخبوا|ḥantiḵib|انتخبتوا|ينتخبوا|yintiḵibu|binintiḵib|تنتخب|tintiḵib|intaḵabit|ḥatintiḵib|بتنتخبوا|ḥatintiḵibi|حينتخبوا|bitintiḵibu|انتخبوا|ḥatintiḵibu|بننتخب|intaḵabu|حتنتخبي|حننتخب|tintiḵibi|بتنتخب|حتنتخب|bitintiḵib|منتخب|bitintiḵibi|حنتخب|بينتخب|intaḵabtu|حتنتخبوا|انتخبت|intaḵab|tintiḵibu|biyintiḵib|ḥanintiḵib|ḥayintiḵib|intaḵabt|bantiḵib|تنتخبي|biyintiḵibu|antiḵib|nintiḵib|بتنتخبي|ينتخب|intaḵabti|بنتخب|Term?|انتخبنا|حينتخب	<i>verb</i><br><ol><li>to choose</li></ol>
انتم|intum	<i>pron</i><br><ol><li>you pl</li></ol>
انتوا|íntu|انتو	<i>pron</i><br><ol><li>you (subject pronoun)</li></ol>
انتي|íntu|انتو|inti	<i>pron</i><br><ol><li>you</li></ol>
اه|آه|ʾāh	<i>adv</i><br><ol><li>yes, yeah</li></ol>
اوكوليله|اوكوليليات|ʔukulēleh	<i>noun</i><br><ol><li>ukulele</li></ol>
اول|أول|ʾawwel	<i>adj</i><br><ol><li>first</li></ol>
اونطة|ˀawanta	<i>noun</i><br><ol><li>deceit</li><li>trickery</li></ol>
اوهايو|ōhāyō	<i>name</i><br><ol><li>Ohio</li></ol>
ايد|إِيدِين|أيادي|īd	<i>noun</i><br><ol><li>(anatomy) hand</li></ol>
ايه|ēh|اِيه	<i>pron</i><br><ol><li>what?</li></ol>
ايون|ʾuyun|ʾuyin|ايويون|ايونات	<i>noun</i><br><ol><li>(backgammon) a win</li><li>(vulgar) a fuck, or a lay</li></ol>
ايوه|'aywa	<i>adv</i><br><ol><li>yes</li></ol>
ب|be	
بؤنه|baʔūna	<i>name</i><br><ol><li>The tenth month of the Coptic calendar.</li></ol>
باب|بيبان|bāb|'abwaab|أبواب	<i>noun</i><br><ol><li>door</li></ol>
بابه|bāba	<i>name</i><br><ol><li>The second month of the Coptic calendar.</li></ol>
باس|būsi|بستي|بايس|busti|بتبوس|تبوس|būsu|babūs|tibūsu|bās|حبوس|bust|ابوس|bustu|nibūs|busna|ḥaybūsu|حتبوس|bitbūsu|bitbūs|ḥatbūs|بوسي|حتبوسوا|bāsit|تبوسوا|tibūsi|yibūs|ببوس|ḥatbūsu|tibūs|ḥaybūs|ḥabūs|بوس|حيبوس|بستوا|abūs|يبوس|بتبوسي|būs|بيبوسوا|ḥanbūs|يبوسوا|yibūsu|بيبوس|بنبوس|باست|بسنا|بتبوسوا|biybūsu|تبوسي|حتبوسي|binbūs|بوسوا|متباس|biybūs|بست|نبوس	<i>verb</i><br><ol><li>to kiss</li></ol>
باشا|bāša	<i>noun</i><br><ol><li>sir, mister (polite term of address for a male stranger)</li><li>dude, man (informal term of address to a male friend)</li><li>pasha, bashaw</li></ol>
باط|باطات|bāṭ	<i>noun</i><br><ol><li>(anatomy) armpit</li></ol>
باع|baʿatna|بيع|نبيع|ibʿatu|ḥatibʿat|nibīʿ|baʿatt|بعنا|حيبيع|يبيعوا|بتبعتوا|بتبيعوا|baʿat|مبعوت|يبيع|ḥayibʿatu|تبيع|حتبعتوا|baʿatu|bīʿi|بيبعتوا|بعتوا|ḥabʿat|ḥabīʿ|bīʿu|ḥatibʿatu|حنبعت|biybīʿ|حبيع|حيبعت|nibʿat|tibīʿ|bāʿit|ببعت|حتبيعوا|بنبيع|tibʿati|بيعوا|bāʿ|بنبعت|baʿatit|bitibʿat|ابعت|حيبعتوا|ḥatibʿati|ḥaybīʿu|تبيعي|بعتي|بيبعت|بتبيع|بيبيع|نبعت|tibīʿu|ibʿat|بعتنا|حتبيع|yibʿat|ابعتي|بايع|بتبيعي|abīʿ|tibʿat|ابيع|babʿat|bīʿ|tibīʿi|ḥaybīʿ|yibīʿu|ḥatbīʿ|ḥanbīʿ|بعت|binibʿat|ḥanibʿat|بعتتي|حتبعت|bitibʿati|biʿt|تبعتي|بعتت|biyibʿat|بيبيعوا|حتبيعي|باعت|يبعت|biʿna|تبعتوا|بتبعتي|ḥayibʿat|حتبعتي|بعتتوا|بتبعت|يبعتوا|حبعت|tibʿatu|bitbīʿu|baʿatti|bitbīʿ|biyibʿatu|yibīʿ|تبيعوا|binbīʿ|yibʿatu|بيعي|biʿtu|ابعتوا|ḥatbīʿu|abʿat|ibʿati|biʿti|babīʿ|biybīʿu|bitibʿatu|baʿattu|تبعت|Term?|ببيع	<i>verb</i><br><ol><li>to sell</li></ol>
بالهنا والشفا|bil-hanaa wil-shifaa	<i>intj</i><br><ol><li>bon appétit</li></ol>
بانجو|bángo	<i>noun</i><br><ol><li>marijuana, weed</li></ol>
باى|baay	<i>intj</i><br><ol><li>bye!</li></ol>
بتاع|bitāʿ|بتوع|بتاعة	<i>noun</i><br><ol><li>thing whose name is unknown or cannot be remembered by the speaker; thingy</li><li>(vulgar) penis</li></ol><br><i>adj</i><br><ol><li>Expresses the possessive or genitive: of, 's</li></ol>
بحبك|baHíbbak|baHíbbik	<i>phrase</i><br><ol><li>I love you</li></ol>
بدروم|بَدْرُونَات|badrū́m|بدرون|badráwn|badrū́n|بدرومات	<i>noun</i><br><ol><li>basement (floor below ground level)</li></ol>
بدنجان|bidingā́n	<i>noun</i><br><ol><li>eggplant</li></ol>
براد|barrād	<i>noun</i><br><ol><li>teapot</li></ol>
برافو	<i>intj</i><br><ol><li>bravo (“interjection”)</li></ol>
برتقان|burtuʾān|برتقانة	<i>noun</i><br><ol><li>orange (fruit)</li></ol>
برداق|براديق|bardāq|barādīq	<i>noun</i><br><ol><li>(obsolete) jug, pitcher</li></ol>
برلين|berlīn	<i>name</i><br><ol><li>Berlin (the capital and largest city of Germany)</li></ol>
برمهات|baramhāt	<i>name</i><br><ol><li>The seventh month of the Coptic calendar.</li></ol>
برموده|baramūda	<i>name</i><br><ol><li>The eighth month of the Coptic calendar.</li></ol>
برنيتة|barnī́ta|بَرْنِيتَة|burnḗta|بُرْنِيتَة	<i>noun</i><br><ol><li>top hat</li></ol>
بروفيسور|brūfisūr	<i>noun</i><br><ol><li>professor</li></ol>
بس|bas	<i>conj</i><br><ol><li>but</li><li>only, just</li></ol>
بشنس|bašans	<i>name</i><br><ol><li>The ninth month of the Coptic calendar.</li></ol>
بص|بتبصوا|ḥatbuṣṣ|tibuṣṣu|يبصوا|تبص|تبصوا|yibuṣṣu|بتبص|بصينا|bitbuṣṣ|باصص|ḥanbuṣṣ|buṣṣi|babuṣṣ|بصيتوا|ببص|tibuṣṣi|biybuṣṣ|مبصوص|حنبص|ḥaybuṣṣu|bitbuṣṣu|بصيت|بيبصوا|biybuṣṣu|نبص|buṣṣ|يبص|buṣṣu|بصي|bitbúṣṣ|بصيتي|بصوا|tíbuṣṣ|بتبصي|حبص|ḥaybuṣṣ|بصت|baṣṣētu|حيبصوا|abuṣṣ|baṣṣ|bitbuṣṣi|حتبصي|حتبص|baṣṣēna|baṣṣit|ḥatbuṣṣi|تبصي|بيبص|tibuṣṣ|حيبص|baṣṣēt|nibuṣṣ|ḥabuṣṣ|ḥatbuṣṣu|حتبصوا|ابص|binbuṣṣ|baṣṣu|بنبص|yibuṣṣ|baṣṣēti	<i>verb</i><br><ol><li>to look at</li></ol>
بصراحة|bi-ṣarāḥa	<i>adv</i><br><ol><li>frankly</li></ol>
بطارية|بَطَّارِيَّة|baṭṭāriyya|بَطَّارِيَّات	<i>noun</i><br><ol><li>(electronics) battery (device producing electricity)</li><li>torch; flashlight</li><li>(military) battery</li><li>array; assemblage</li></ol>
بطاطس|baṭā́ṭis	<i>noun</i><br><ol><li>potato</li></ol>
بطر|بطرات|buṭr	<i>noun</i><br><ol><li>(obsolete) knee-breeches for a soldier</li></ol>
بعت|tibʿati|بنبعت|baʿatna|بعتتوا|baʿatit|tibʿat|بتبعت|bitibʿat|babʿat|ابعت|حيبعتوا|ḥatibʿati|ibʿatu|يبعتوا|حبعت|ḥatibʿat|tibʿatu|بيبعت|baʿatt|بتبعتوا|مبعوت|baʿat|baʿatti|binibʿat|biyibʿatu|ḥanibʿat|ḥayibʿatu|ابعتي|حتبعتوا|بعتتي|حتبعت|نبعت|baʿatu|yibʿatu|بيبعتوا|bitibʿati|بعتوا|ḥabʿat|ibʿat|تبعتي|ابعتوا|بعتت|abʿat|biyibʿat|ḥatibʿatu|حنبعت|ibʿati|بعتنا|باعت|يبعت|حيبعت|nibʿat|bitibʿatu|تبعتوا|بتبعتي|baʿattu|تبعت|ḥayibʿat|حتبعتي|ببعت|yibʿat	<i>verb</i><br><ol><li>to send (“make something go somewhere”)</li></ol>
بعد|baʿd	<i>prep</i><br><ol><li>after</li></ol>
بق|buʾʾ	<i>noun</i><br><ol><li>(anatomy) mouth</li></ol>
بقا|baʔa	<i>adv</i><br><ol><li>modal particle used for focus; often used at the end of questions, or to express an objection or contrast, as well as other contexts</li></ol>
بقدونس|baʔdū́nis	<i>noun</i><br><ol><li>parsley</li></ol>
بكرة|bukra|بكره	<i>adv</i><br><ol><li>tomorrow</li></ol>
بلطجى|بلطجيّة|balṭági	<i>noun</i><br><ol><li>a thug, a gangster, a hoodlum, a goon, a hooligan</li><li>a bully</li><li>(obsolete, military) a pioneer, a sapper (a class of palace guards in the Ottoman Empire)</li></ol>
بلكونة|balakáwna	<i>noun</i><br><ol><li>balcony</li></ol>
بنسة|binas|بنس|binsa	<i>noun</i><br><ol><li>pliers</li></ol>
بنش|biniš|بنيشات|بنشات|بنيش|binīš|benš	<i>noun</i><br><ol><li>(bodybuilding) bench</li><li>(historical) a ceremonial robe with long sleeves, pelisse</li></ol>
بنفسجى|banáfsigi	<i>adj</i><br><ol><li>purple</li></ol>
بنى ادم|bani ādam	<i>noun</i><br><ol><li>a human being, a person.</li></ol>
به|beh	<i>noun</i><br><ol><li>The name of the second letter of the Arabic alphabet (ب).</li></ol>
بياع|بياعين|bayyā́ʕ	<i>noun</i><br><ol><li>salesman</li></ol>
بير|bīr|ʾabyār|biyār	<i>noun</i><br><ol><li>well</li><li>shaft</li><li>manhole</li></ol>
بيرة|bīra|بيرات	<i>noun</i><br><ol><li>beer</li><li>(obsolete) beer shop</li></ol>
تاسع|tāsiʕ	<i>adj</i><br><ol><li>ninth</li></ol>
تالت|tālit	<i>adj</i><br><ol><li>third</li></ol>
تامن|tāmin	<i>adj</i><br><ol><li>eighth</li></ol>
تاني|تانية|tāni|تانيين	<i>adj</i><br><ol><li>second</li><li>other</li></ol><br><i>adv</i><br><ol><li>again</li></ol>
تخويل|taḵwīl	<i>noun</i><br><ol><li>(vulgar, humorous) emasculation</li></ol>
تخين|تخان|tiḵīn|تخينة	<i>adj</i><br><ol><li>fat</li><li>thick (of solids and liquids)</li><li>deep (of voice)</li></ol>
تربيزة|تَرَبِيزَة|ṭarabḗza|تربيزات|ṭarabī́za	<i>noun</i><br><ol><li>table (item of furniture)</li></ol>
ترجم|يترجم|targim	<i>verb</i><br><ol><li>to translate</li></ol>
تزلك|tuzluk|tüzlük	<i>noun</i><br><ol><li>cloth spread onto aught for protection</li><li>gaiter</li></ol>
تسعة|tisʕa	<i>num</i><br><ol><li>nine</li></ol>
تسعتاشر|tisʿatāšaṛ	<i>num</i><br><ol><li>nineteen</li></ol>
تسعين|tisʿīn	<i>num</i><br><ol><li>ninety</li></ol>
تعبان|تعابين|taʕbā́n|tuʕbā́n	<i>adj</i><br><ol><li>tired</li><li>sick</li></ol><br><i>noun</i><br><ol><li>snake</li></ol>
تعلب|تعالب|táʿlab	<i>noun</i><br><ol><li>fox</li></ol>
تقيل|teʔīl	<i>adj</i><br><ol><li>heavy</li></ol>
تك|tekk	<i>noun</i><br><ol><li>(obsolete) a small pistol</li></ol>
تلاتاشر|talattāšaṛ	<i>num</i><br><ol><li>thirteen</li></ol>
تلاتة|talê̄ta	<i>num</i><br><ol><li>three</li></ol>
تلاتين|talatīn	<i>num</i><br><ol><li>thirty</li></ol>
تمانية|tamanya	<i>num</i><br><ol><li>eight</li></ol>
تملي|tamalli|temelli	<i>adv</i><br><ol><li>(archaic, poetic) always</li></ol>
تمنتاشر|tamantāšaṛ	<i>num</i><br><ol><li>eighteen</li></ol>
تمنين|tamanīn	<i>num</i><br><ol><li>eighty</li></ol>
توبة|tōba	<i>adv</i><br><ol><li>never</li></ol>
توت|tūt	<i>name</i><br><ol><li>The first month of the Coptic calendar.</li></ol><br><i>noun</i><br><ol><li>(collective) mulberry, mulberry tree</li></ol>
توم|tōm	<i>noun</i><br><ol><li>garlic</li></ol>
تيل|تيلة|tīla|tīl	<i>noun</i><br><ol><li>fibre such as of flax or hemp or cotton, wire</li></ol>
ج|gīm|ـجـ|جـ|ـج	
جا|gā|ييجي	<i>verb</i><br><ol><li>to come</li></ol>
جاب|gāb|يجيب	<i>verb</i><br><ol><li>to bring (“to transport toward somebody/somewhere”)</li></ol>
جاكتة|جاكتّة|žakitta|جاكتّات	<i>noun</i><br><ol><li>jacket, cardigan</li></ol>
جامع|جوامع|gā́miʿ	<i>noun</i><br><ol><li>mosque</li></ol>
جامعة|جامعات|gamʕa	<i>noun</i><br><ol><li>university</li></ol>
جايز|gāyiz	<i>adv</i><br><ol><li>maybe, perhaps</li></ol>
جبا|gaba	<i>adv</i><br><ol><li>(archaic) gratis, free of charge</li></ol>
جبى|gabba|يجبي	<i>verb</i><br><ol><li>to offer gratis, to stand, to cover the expenses of, to let live off, to spend on</li></ol>
جدع|gad'	<i>adj</i><br><ol><li>chivalrous, noble</li><li>brave, heroic</li></ol>
جرى|يجري|gara	<i>verb</i><br><ol><li>to run (“to move quickly on two feet”)</li></ol>
جزر|gázar	<i>noun</i><br><ol><li>carrot</li></ol>
جزمة|gázma|جزمات|جزم	<i>noun</i><br><ol><li>shoes (a pair)</li><li>(vulgar) associated with uncleanliness and impurity</li><li>(obsolete) boots (a pair)</li></ol>
جزمة باتيناچ|جزمات باتيناچ|gazmat bātīnāj	<i>noun</i><br><ol><li>roller skate</li></ol>
جعر|جَعَر|يِجْعَر|جِعِير|gaʿar	<i>verb</i><br><ol><li>to bellow, to bleat</li></ol>
جفن|جفون|gifn	<i>noun</i><br><ol><li>eyelid</li></ol>
جلبان|gulabbān|gilbān|جُلَبَّان|جُلبان|gulbān|جِلبان	<i>noun</i><br><ol><li>grasspea (Lathyrus sativus, and by extension other Lathyrus species and the genus)</li></ol>
جلد|جلود|gild|جِلُود|gilūd	<i>noun</i><br><ol><li>(anatomy) skin</li></ol>
جلس|بيجلسوا|حيجلس|حيجلسوا|galasu|iglisu|جلسوا|galasit|galast|نجلس|تجلس|ḥaniglis|yiglis|bitiglisi|جلسنا|ḥayiglisu|حجلس|بنجلس|biyiglis|حتجلس|بجلس|iglis|tiglisu|bitiglis|اجلسي|galasna|جلستي|جلستوا|galasti|ḥatiglis|جالس|حنجلس|مجلوس|iglisi|biniglis|بتجلسي|ḥayiglis|baglis|تجلسوا|bitiglisu|اجلسوا|ḥatiglisu|biyiglisu|حتجلسوا|حتجلسي|yiglisu|aglis|galastu|جلست|tiglis|niglis|يجلسوا|بتجلس|بتجلسوا|tiglisi|تجلسي|galas|اجلس|ḥaglis|ḥatiglisi|يجلس|بيجلس	<i>verb</i><br><ol><li>to sit</li></ol>
جمبري|جمْبَري|gambari	<i>noun</i><br><ol><li>shrimp, prawn</li></ol>
جمجمة|gumgúma|جماجم	<i>noun</i><br><ol><li>skull</li></ol>
جمهورية مصر العربيه|gumhūriyya maṣr el-ʿarabiyya	<i>name</i><br><ol><li>Arab Republic of Egypt</li></ol>
جموسة|جموس|gamūsa	<i>noun</i><br><ol><li>water buffalo (mammal)</li></ol>
جناح|genāḥ	<i>noun</i><br><ol><li>wing</li></ol>
جندر|gandar	<i>verb</i><br><ol><li>to mangle, to calender, to press by roll</li></ol>
جندرة|gandara	<i>noun</i><br><ol><li>mangle, calender and any rotary press</li></ol>
جنينة|جناين|جنينات|جنائن|ganaayin|gunēna	<i>noun</i><br><ol><li>garden (in some dialects)</li></ol>
جه|ييجي|geh	<i>verb</i><br><ol><li>to come</li></ol>
جواز|جوازات|gawāz	<i>noun</i><br><ol><li>wedding, marriage</li></ol>
جوانتي|gúwanti|جَوانتيات|جُوانتيات|gáwanti|جُوانتي|جَوانتي	<i>noun</i><br><ol><li>gloves</li></ol>
جوز|gōz	<i>noun</i><br><ol><li>husband</li></ol>
جيبة|جيبات|žība	<i>noun</i><br><ol><li>skirt</li></ol>
حاجة|حاجات|ḥāga	<i>noun</i><br><ol><li>thing</li></ol><br><i>pron</i><br><ol><li>something (an unspecified object)</li></ol>
حب|يحب|tiḥibb|ḥabbit|bitḥibbu|ḥanḥibb|ḥabb|حيحب|تحب|biyḥibb|بتحبوا|حنحب|حتحبي|ḥatḥibbi|يحبوا|ḥatḥibb|niḥibb|نحب|ḥibbi|ḥabbētu|تحبي|tiḥibbu|حبت|aḥibb|ḥatḥibbu|حابب|ḥayḥibbu|حبي|محبوب|ḥabbēt|احب|ḥabbu|حبيت|بحب|yiḥibbu|حبينا|حبيتوا|بيحب|tíḥibb|tiḥibbi|بنحب|حيحبوا|bitḥibb|تحبوا|ḥaḥibb|bitḥibbi|حبيتي|ححب|yiḥibb|حتحب|بتحبي|ḥibbu|ḥabbēna|حبوا|بيحبوا|ḥayḥibb|حتحبوا|بتحب|biyḥibbu|ḥabbēti|baḥibb|binḥibb|ḥibb	<i>verb</i><br><ol><li>to love</li></ol>
حج|biyḥiggu|biyḥigg|حاجج|حيحجوا|محجوج|حجيت|احج|ḥatḥiggu|تحجوا|بتحجي|بحج|ḥayḥigg|yiḥiggu|ḥaggit|tiḥiggi|ḥiggu|حجينا|ḥagg|tiḥigg|بيحج|حيحج|حجي|تحج|ḥaggēti|ḥiggi|حتحج|نحج|حجت|بتحجوا|ḥatḥiggi|tiḥiggu|ḥigg|ḥatḥigg|tíḥigg|ḥaggētu|حجيتي|حتحجي|bitḥiggi|ḥaggu|baḥigg|بيحجوا|حتحجوا|حجوا|ḥayḥiggu|yiḥigg|bitḥiggu|بتحج|يحجوا|ḥanḥigg|ححج|تحجي|binḥigg|يحج|حجيتوا|حنحج|بنحج|ḥaggēna|ḥaggēt|bitḥigg|aḥigg|ḥaḥigg|niḥigg	<i>verb</i><br><ol><li>to make a pilgrimage to mecca</li></ol>
حداشر|ḥidāšaṛ	<i>num</i><br><ol><li>eleven</li></ol>
حرر|حرّر|yeḥarrar|يحرر|ḥarrar|يحرّر	<i>verb</i><br><ol><li>to free someone from restraint/prison</li><li>to make one feel hotter (more heat)</li></ol>
حس|ḥassēti|احس|يحس|ḥissu|ḥassētu|niḥiss|بتحسي|نحس|محسوس|يحسوا|ḥass|tiḥissi|حسيتي|baḥiss|bitḥissu|tiḥiss|ḥayḥissu|تحسوا|ḥassēna|حسيت|بحس|حتحسي|ḥassu|حسينا|aḥiss|tíḥiss|حسي|حيحس|تحسي|حنحس|حتحسوا|yiḥissu|حيحسوا|ḥiss|bitḥiss|ḥassit|ḥassēt|ححس|حتحس|بيحسوا|yiḥiss|tiḥissu|حست|بتحس|بتحسوا|تحس|حاسس|ḥatḥiss|حسيتوا|بيحس|ḥayḥiss|ḥatḥissi|ḥaḥiss|biyḥissu|bitḥissi|binḥiss|ḥissi|بنحس|حسوا|ḥanḥiss|ḥatḥissu|biyḥiss	<i>verb</i><br><ol><li>to feel</li></ol>
حصان|ʾaḥṣína|ḥúṣān	<i>noun</i><br><ol><li>horse</li></ol>
حضرتك|ḥadretik|ḥadretak	<i>pron</i><br><ol><li>you (formal)</li></ol>
حط|bitḥuṭṭ|حطيتي|ḥaṭṭu|بيحط|ḥuṭṭu|ḥaṭṭēna|tiḥuṭṭu|tíḥuṭṭ|ḥanḥuṭṭ|biyḥuṭṭu|حطينا|biyḥuṭṭ|بتحطي|حتحطوا|ḥaṭṭēt|ḥayḥuṭṭu|حيحطوا|ḥaṭṭēti|حطت|niḥuṭṭ|ḥuṭṭi|yiḥuṭṭ|binḥuṭṭ|bitḥúṭṭ|بحط|بنحط|ḥaṭṭētu|ḥaḥuṭṭ|تحطي|ḥayḥuṭṭ|حنحط|ḥuṭṭ|بيحطوا|ḥatḥuṭṭ|حطوا|حتحطي|ḥatḥuṭṭi|bitḥuṭṭu|نحط|ḥatḥuṭṭu|بتحط|حيحط|ححط|baḥuṭṭ|ḥaṭṭit|تحط|yiḥuṭṭu|حاطط|حطيتوا|يحطوا|حتحط|بتحطوا|حطيت|حطي|يحط|tiḥuṭṭ|تحطوا|bitḥuṭṭi|tiḥuṭṭi|ḥaṭṭ|محطوط|aḥuṭṭ|احط	<i>verb</i><br><ol><li>to put, place, set</li></ol>
حفظ|حنحفظ|حفظنا|حتحفظ|حفظت|محفوظ|bitiḥfaẓi|ḥayiḥfaẓu|biyiḥfaẓ|ḥifiẓtu|احفظوا|ḥifẓu|حفظوا|aḥfaẓ|ḥifẓit|iḥfaẓi|يحفظوا|حفظتوا|yiḥfaẓ|iḥfaẓ|حيحفظ|حتحفظوا|بنحفظ|ḥatiḥfaẓu|ḥayiḥfaẓ|tiḥfaẓu|بتحفظ|tiḥfaẓi|ḥatiḥfaẓ|bitiḥfaẓ|تحفظ|حيحفظوا|حفظتي|niḥfaẓ|بيحفظوا|ححفظ|tiḥfaẓ|تحفظوا|ḥifiẓti|حتحفظي|iḥfaẓu|bitiḥfaẓu|biniḥfaẓ|baḥfaẓ|ḥaniḥfaẓ|بتحفظوا|ḥaḥfaẓ|yiḥfaẓu|احفظي|بيحفظ|نحفظ|ḥifiẓ|حافظ|ḥifiẓna|يحفظ|تحفظي|احفظ|ḥatiḥfaẓi|بتحفظي|ḥifiẓt|بحفظ|biyiḥfaẓu	<i>verb</i><br><ol><li>to memorize</li></ol>
حفلة|ḥaflaat	<i>noun</i><br><ol><li>party (“social gathering”)</li><li>show (music)</li></ol>
حلاق|ḥallāʾ	<i>noun</i><br><ol><li>barber</li></ol>
حلو|حلوة|ḥilw|أحلى	<i>adj</i><br><ol><li>sweet (to taste)</li><li>nice, good</li><li>pretty, nice, handsome, good-looking</li></ol>
حلوم|ḥalūm	<i>noun</i><br><ol><li>a mild white cheese similar to halloumi</li></ol>
حمام|ḥammām|حمّامات	<i>noun</i><br><ol><li>a washroom; a bathroom; a restroom</li><li>a toilet</li><li>a urinal</li><li>(rare) a bathhouse, a spa</li></ol>
حنش|ḥanaš	<i>noun</i><br><ol><li>eel</li><li>(rural) snake</li></ol>
حنك|ḥanak|ḥannik	<i>noun</i><br><ol><li>mouth</li><li>mouth of an animal, beak</li></ol><br><i>verb</i><br><ol><li>to train, to make gain experience</li></ol>
حوالي|ḥawālī	<i>prep</i><br><ol><li>approximately, around (“Near, determining approximately quantity”)</li></ol>
حيطة|ḥīṭa|ḥiṭān|حطان	<i>noun</i><br><ol><li>wall (division in a building)</li></ol>
خاشوقة|ḵāšūqa|خَاشُوقَة|خَاشُوكَة|خَوَاشِيق|خاشوكة|خَوَاشِيك	<i>noun</i><br><ol><li>spoon</li></ol>
خاف|يخاف|xāf	<i>verb</i><br><ol><li>to fear</li></ol>
خالص|khaaleṣ|خَالِص	<i>adv</i><br><ol><li>(with negative) at all</li></ol>
خامس|ḵāmis	<i>adj</i><br><ol><li>fifth</li></ol>
خد|ḵadd|ياخد|ḵad|خدود	<i>verb</i><br><ol><li>to take (to grab with the hands)</li></ol><br><i>noun</i><br><ol><li>(anatomy) cheek (part of face)</li></ol>
خربش|ḵarbiš|يخربش	<i>verb</i><br><ol><li>to scratch</li></ol>
خرج|حتخرجوا|خرجتي|يخرجوا|nuḵrug|bituḵrug|خرجوا|تخرج|خارج|بتخرجوا|binuḵrug|aḵrug|بيخرج|uḵrugi|yuḵrug|ḵaragt|يخرج|yuḵrugu|biyuḵrugu|ḥatuḵrugu|نخرج|مخروج|بيخرجوا|حتخرجي|اخرج|خرجنا|ḵaragu|حتخرج|حيخرج|بتخرج|uḵrug|ḵaragtu|ḵarag|تخرجي|اخرجي|بنخرج|تخرجوا|حيخرجوا|tuḵrugi|اخرجوا|ḥatuḵrugi|حنخرج|uḵrugu|خرجت|ḥayuḵrug|بخرج|بتخرجي|tuḵrug|ḥanuḵrug|خرجتوا|ḥaḵrug|bituḵrugi|tuḵrugu|ḵaragna|baḵrug|ḥatuḵrug|ḵaragti|bituḵrugu|ḥayuḵrugu|حخرج|ḵaragit|biyuḵrug	<i>verb</i><br><ol><li>to go out, to exit</li></ol>
خرسيس|ḵarsīs|خَرْسِيس	<i>noun</i><br><ol><li>bowsy, person of thuggish comportment</li></ol>
خرم|أخرام|ḵurm	<i>noun</i><br><ol><li>hole</li></ol>
خلاص|ḵalāṣ	<i>intj</i><br><ol><li>there's no more</li><li>it's over</li><li>stop it</li></ol><br><i>adv</i><br><ol><li>already</li></ol>
خلاويص|ḵalāwīṣ	<i>intj</i><br><ol><li>(informal, slang) variant of خلاص (ḵalāṣ), commonly used as a call out during games of hide and seek.</li></ol>
خمسة|ḵamsa	<i>num</i><br><ol><li>five</li></ol>
خمستاشر|ḵamastāšaṛ	<i>num</i><br><ol><li>fifteen</li></ol>
خمسين|ḵamsīn	<i>num</i><br><ol><li>fifty</li></ol>
خول|ḵáwal|خولات	<i>noun</i><br><ol><li>(vulgar) fag</li></ol>
خيار|khiyaar	<i>noun</i><br><ol><li>cucumber</li></ol>
داق|duʾna|dūʾi|دقتي|ندوق|dūʾ|yidūʾ|biydūʾ|تدوقي|بتدوق|بندوق|يدوقوا|bindūʾ|حدوق|bitdūʾ|حتدوقي|دقت|دايق|duʾti|nidūʾ|ادوق|tidūʾi|حيدوق|dāʾit|بدوق|داقت|دوقي|duʾt|دقتوا|بتدوقي|حتدوق|dāʾ|tidūʾu|متداق|تدوق|tidūʾ|بتدوقوا|ḥatdūʾ|biydūʾu|دوقوا|ḥandūʾ|دقنا|yidūʾu|ḥaydūʾ|حتدوقوا|adūʾ|duʾtu|ḥadūʾ|badūʾ|ḥatdūʾu|بيدوقوا|يدوق|تدوقوا|دوق|بيدوق|bitdūʾu|dūʾu|ḥaydūʾu	<i>verb</i><br><ol><li>to taste</li></ol>
دحرج|dahrag|دَحْرَج|دَحْرَجَة	<i>verb</i><br><ol><li>(transitive) to trundle, to roll</li><li>(transitive, nautical) to parbuckle</li></ol>
دراع|derāʿ	<i>noun</i><br><ol><li>arm</li><li>forearm</li></ol>
دغري|duḡri	<i>adj</i><br><ol><li>straightforward</li></ol><br><i>adv</i><br><ol><li>straight</li></ol>
دقماق|duʔmāʔ|دَقَامِيق|دُقْمَاق	<i>noun</i><br><ol><li>mallet, hammer of wood or rubber, cudgel or similar thing</li></ol>
دقن|daʔn|دقون	<i>noun</i><br><ol><li>chin</li><li>beard</li></ol>
دكتور|duktūr|دكتورة|دكاترة	<i>noun</i><br><ol><li>doctor, physician</li></ol>
دكر|dakar	<i>noun</i><br><ol><li>(especially of animals) male</li><li>displaying masculinity</li></ol>
دلاب|dulāb|dawalīb|دواليب	<i>noun</i><br><ol><li>cupboard</li></ol>
دلوقت|dilwaʾt	<i>adv</i><br><ol><li>now</li></ol>
دلوقتى|dilwa'ti	<i>adv</i><br><ol><li>now</li></ol>
دلوقتي|dilwaʾti	<i>adv</i><br><ol><li>now</li></ol>
دماغ|dimāḡ	<i>noun</i><br><ol><li>(countable) the upper front part of the body of an animal, the head</li><li>(of humans) the crown of the head; the scalp</li><li>(uncountable) mind; intelligence; reason</li><li>(countable, uncommon) the brain</li><li>(uncountable, informal) the state or feeling of being under the effect of a drug; euphoria, excitement, or stupor from narcosis; being, looking, sounding, or feeling high or stoned</li></ol>
دنجل|dongol|دناجل|dungul|dangil|dingil	<i>noun</i><br><ol><li>axle</li><li>sharper, swindler</li><li>dongle, a device faciliting transmission of information to another computer in spite of incompatible interfaces</li></ol><br><i>verb</i><br><ol><li>to go on the hog train by attachment near the axletree</li><li>to finesse, to trick</li></ol>
ده|da|dōl|دول	<i>det</i><br><ol><li>this</li></ol><br><i>pron</i><br><ol><li>this</li></ol>
دور|ʾadwār|أدوار|dawr|'adwaar	<i>noun</i><br><ol><li>floor (“storey”)</li></ol>
دول|dōl	<i>det</i><br><ol><li>these</li></ol><br><i>pron</i><br><ol><li>these</li></ol>
دي|di|dōl|دول	<i>det</i><br><ol><li>this</li></ol><br><i>pron</i><br><ol><li>this</li></ol>
ديب|دياب|dīb	<i>noun</i><br><ol><li>wolf</li></ol>
ديموقراطية|dīmūqrāṭiyya	<i>noun</i><br><ol><li>democracy</li></ol>
ذهبى|zahabi	<i>adj</i><br><ol><li>gold</li></ol>
رابع|rābiʕ	<i>adj</i><br><ol><li>fourth</li></ol>
راجل|رجالة|rā́gil	<i>noun</i><br><ol><li>a man</li><li>(uncommon) a woman's man, a husband (especially one who is deemed manly)</li><li>king (playing cards)</li></ol>
راح|بروح|تروحي|تروح|حتروح|ruḥtu|راحت|حتروحوا|حيروح|روح|binrūḥ|rūḥu|يروح|bitrūḥ|اروح|بيروحوا|تروحوا|رحتي|biyrūḥ|رحنا|حتروحي|ruḥna|yirūḥ|نروح|arūḥ|رحت|بيروح|ḥatrūḥu|tirūḥi|rāḥit|رايح|rāḥ|yirūḥu|بتروح|ḥarūḥ|رحتوا|متراح|ḥayrūḥ|بتروحي|nirūḥ|rūḥ|روحي|biyrūḥu|bitrūḥu|ruḥt|ḥatrūḥ|يروحوا|حروح|barūḥ|ḥanrūḥ|ḥayrūḥu|rūḥi|tirūḥu|ruḥti|بنروح|روحوا|tirūḥ|بتروحوا	<i>verb</i><br><ol><li>to go</li></ol>
راس|رُؤُوس|rās|رُوس	<i>noun</i><br><ol><li>head (part of the body)</li><li>chief, top (of a hierarchy)</li><li>top part, summit</li><li>cape</li></ol>
رامي|rāmi	<i>noun</i><br><ol><li>archer</li><li>Sagittarius</li></ol>
رايب|rayeb	<i>noun</i><br><ol><li>sour milk</li></ol>
رجع|bitirgaʕu|رجعتوا|حترجعوا|ḥatirgaʕi|ارجعوا|nirgaʕ|rigiʕna|biyirgaʕ|bitirgaʕi|binirgaʕ|irgaʕi|irgaʕu|برجع|حرجع|رجعتي|tirgaʕu|راجع|نرجع|bargaʕ|ḥanirgaʕ|rigʕu|rigiʕ|ترجع|ḥatirgaʕ|tirgaʕ|بنرجع|بترجعي|bitirgaʕ|حترجع|مرجوع|رجعوا|حيرجعوا|حنرجع|biyirgaʕu|ḥayirgaʕu|حيرجع|ḥargaʕ|yirgaʕ|ارجعي|بترجعوا|بيرجع|بيرجعوا|ارجع|ترجعي|irgaʕ|argaʕ|rigʕit|رجعت|rigiʕtu|ḥayirgaʕ|رجعنا|حترجعي|rigiʕt|يرجعوا|yirgaʕu|بترجع|يرجع|tirgaʕi|ḥatirgaʕu|rigiʕti|ترجعوا	<i>verb</i><br><ol><li>to return, to come back, to go back</li></ol>
رحيم|raḥīm|رحما	<i>adj</i><br><ol><li>merciful</li><li>compassionate</li></ol>
رخيص|ríxīṣ	<i>adj</i><br><ol><li>cheap (“low in price”)</li></ol>
رد|مردود|tirudd|bitrudd|rudd|بتردي|arudd|ردوا|bitrúdd|رادد|رديتوا|ارد|binrudd|yirudd|يردوا|raddit|حرد|ḥayruddu|بترد|raddu|ترد|نرد|nirudd|yiruddu|radd|raddēt|تردي|حنرد|ḥatruddu|ruddu|raddēna|بنرد|حيرد|ردت|ردي|ردينا|يرد|ḥatrudd|رديتي|tiruddi|raddēti|ḥanrudd|bitruddi|حيردوا|biyruddu|biyrudd|ḥarudd|حترد|رديت|برد|raddētu|barudd|bitruddu|حتردوا|ruddi|tiruddu|ḥatruddi|تردوا|tírudd|ḥayrudd|بتردوا|بيرد|بيردوا|حتردي	<i>verb</i><br><ol><li>(with على) to answer, reply (to)</li></ol>
رقبة|رقاب|raʔaba	<i>noun</i><br><ol><li>(anatomy) neck</li></ol>
ركب|حنركب|حتركبي|ḥarkab|biyirkab|ḥatirkab|ركبت|arkab|biyirkabu|مركوب|حركب|ḥatirkabu|يركبوا|irkabi|rikibna|rikibtu|ركبتي|حتركب|تركبوا|ḥayirkab|ḥanirkab|حيركب|tirkabi|حيركبوا|بنركب|بيركبوا|اركبي|راكب|حتركبوا|ḥayirkabu|rikib|بيركب|اركب|rikibt|بركب|ركبوا|بتركبوا|نركب|binirkab|بتركبي|rikbit|irkab|bitirkab|rikbu|yirkabu|ḥatirkabi|تركبي|اركبوا|irkabu|ركبنا|yirkab|بتركب|ركبتوا|bitirkabi|يركب|tirkab|تركب|tirkabu|barkab|rikibti|nirkab|bitirkabu	<i>verb</i><br><ol><li>to ride (a vehicle or animal)</li></ol>
رمرم|ramramu|niramram|برمرم|رمرمتوا|biyramramu|ترمرموا|ḥayramram|ḥatramrami|aramram|tiramramu|ḥaramram|حترمرم|بترمرمي|ramramti|ramramit|بنرمرم|bitramramu|رمرمي|رمرمت|binramram|yiramramu|رمرمتي|بترمرم|ترمرم|حترمرموا|ترمرمي|ramramna|حترمرمي|بيرمرم|بترمرموا|ارمرم|حيرمرموا|ḥanramram|tiramrami|ḥayramramu|حنرمرم|ramramtu|baramram|ramramt|biyramram|ramram|bitramram|يرمرموا|مترمرم|ḥatramramu|يرمرم|tiramram|yiramram|ramrami|ḥatramram|حيرمرم|حرمرم|رمرموا|Term?|نرمرم|bitramrami|بيرمرموا|رمرمنا	<i>verb</i><br><ol><li>(intransitive) to eat junk food or nasty food</li></ol>
روق|rawwaʔ|يروَق	<i>verb</i><br><ol><li>to calm down, to relax (transitive)</li><li>to clean up, to tidy up (e.g., a room)</li></ol>
روچ|rūj|أرواچ	<i>noun</i><br><ol><li>lipstick</li></ol>
زار|zār|يزور|tizūru|زرنا|زوروا|ḥatzūr|تزوري|ḥayzūr|بتزوري|زرتي|بيزور|bazūr|تزوروا|zurtu|zurti|زور|tizūr|ḥatzūru|حتزور|zurt|tizūri|nizūr|حزور|حتزوري|zārit|ḥazūr|حتزوروا|زاير|يزوروا|بيزوروا|زوري|zurna|zūru|binzūr|ḥanzūr|تزور|بزور|yizūr|biyzūr|بنزور|zūr|ازور|bitzūru|زرت|زرتوا|azūr|نزور|biyzūru|بتزوروا|zūri|متزار|زارت|حيزور|yizūru|بتزور|bitzūr|ḥayzūru	<i>verb</i><br><ol><li>to visit</li></ol>
زعلان|zaʿlān	<i>adj</i><br><ol><li>upset, sad</li></ol>
زكي|zakii	<i>adj</i><br><ol><li>intelligent (a form of ذكي)</li></ol>
زلمكة|زلموكة|زَلَمُوكَة|zalamukka|zalamūka|زَلَمُكَّة	<i>noun</i><br><ol><li>the tewel of a chicken or other fowl, parson's nose</li><li>(slang) one of the 1984–95 models of a Mercedes-Benz</li></ol>
زوجة	<i>noun</i><br><ol><li>wife</li></ol>
زي|زَيّ|zayy	<i>prep</i><br><ol><li>like</li></ol>
سأل|saʾal|يسأل	<i>verb</i><br><ol><li>to ask</li></ol>
سابع|sābiʕ	<i>adj</i><br><ol><li>seventh</li></ol>
سادس|sādis	<i>adj</i><br><ol><li>sixth</li></ol>
ساعة|sāʿa	<i>noun</i><br><ol><li>hour</li><li>watch</li></ol>
ساق|suʾti|bitsūʾ|تسوقي|بيسوقوا|bitsūʾu|تسوق|suʾtu|basūʾ|binsūʾ|بتسوقوا|ḥansūʾ|ḥatsūʾ|ḥasūʾ|سوقي|sāʾit|yisūʾu|ḥaysūʾu|yisūʾ|sāʾ|سوق|سوقوا|حسوق|nisūʾ|بيسوق|ḥatsūʾu|بنسوق|suʾna|حتسوق|suʾt|biysūʾu|اسوق|ḥaysūʾ|ساقت|سايق|tisūʾi|sūʾ|سقت|sūʾu|بتسوق|بسوق|بتسوقي|سقنا|نسوق|حتسوقي|متساق|sūʾi|asūʾ|سقتوا|حيسوق|يسوق|سقتي|biysūʾ|tisūʾu|تسوقوا|حتسوقوا|tisūʾ|يسوقوا	<i>verb</i><br><ol><li>to drive</li></ol>
سبع|sabʿ|سبوع|سباع	<i>noun</i><br><ol><li>(slang or humorous) lion</li></ol><br><i>adj</i><br><ol><li>(slang or humorous) lionesque</li></ol>
سبعة|sabʕa	<i>num</i><br><ol><li>seven</li></ol>
سبعتاشر|sabaʿtāšaṛ	<i>num</i><br><ol><li>seventeen</li></ol>
ست|sitt|ستات	<i>noun</i><br><ol><li>woman</li><li>Mrs, Miss, lady (title for a woman)</li><li>(archaic) grandmother</li></ol>
ستاشر|sittāšaṛ	<i>num</i><br><ol><li>sixteen</li></ol>
ستة|sitta	<i>num</i><br><ol><li>six</li></ol>
ستيان|ستيانات|sutyān	<i>noun</i><br><ol><li>bra</li></ol>
ستيرنج|stīring|سْتِيرِنْج	<i>noun</i><br><ol><li>steering wheel</li></ol>
ستين|sittīn	<i>num</i><br><ol><li>sixty</li></ol>
سطح|suTuuH|saṭḥ|سطوح	<i>noun</i><br><ol><li>roof</li></ol>
سقف|سقفة|أسقف|suqūf|سقوف|saʔf	<i>noun</i><br><ol><li>ceiling</li></ol>
سكت|ḥayuskut|baskut|حيسكت|حتسكت|بيسكتوا|sikit|sakatna|sakatti|حنسكت|اسكتوا|بنسكت|tuskut|uskutu|اسكتي|binuskut|يسكت|sakatit|yuskut|nuskut|بسكت|حيسكتوا|بيسكت|sakat|bituskut|uskut|بتسكتي|yuskutu|بتسكتوا|tuskutu|bituskutu|biyuskutu|تسكتوا|ḥatuskutu|ḥatuskut|ḥatuskuti|سكات|sakattu|uskuti|sakatt|سكتوا|askut|تسكت|تسكتي|بتسكت|حتسكتوا|bituskuti|sakatu|نسكت|ḥayuskutu|ḥanuskut|سكتنا|يسكتوا|مسكوت|حسكت|ḥaskut|سكتتوا|حتسكتي|سكتتي|سكتت|اسكت|biyuskut|ساكت|tuskuti|سكوت	<i>verb</i><br><ol><li>(intransitive) to be silent, to become silent, to stop speaking</li></ol>
سكس|seks	<i>noun</i><br><ol><li>(vulgar) sexual intercourse, sex</li><li>(vulgar) media featuring sexual intercourse; pornography</li></ol>
سكن|يسكن|sikin	<i>verb</i><br><ol><li>(transitive or intransitive) to inhabit, to dwell</li></ol>
سلم|sillim|سلالم|salālim	<i>noun</i><br><ol><li>stairs</li></ol>
سمع|ḥatismaʕi|بنسمع|اسمع|يسمع|yismaʕu|حتسمعي|اسمعوا|tismaʕi|بتسمع|حيسمع|سمعت|bitismaʕ|سمعتي|basmaʕ|ḥayismaʕ|ismaʕ|simiʕtu|سامع|حنسمع|simiʕna|ismaʕi|tismaʕu|yismaʕ|simiʕ|ḥatismaʕ|simʕit|simiʕt|biyismaʕu|ḥatismaʕu|binismaʕ|بتسمعوا|حسمع|حتسمع|تسمعي|حتسمعوا|سمعوا|simiʕti|تسمعوا|ḥasmaʕ|تسمع|bitismaʕu|حيسمعوا|tismaʕ|نسمع|يسمعوا|ḥayismaʕu|ismaʕu|nismaʕ|بتسمعي|بسمع|بيسمع|مسموع|سمعتوا|asmaʕ|biyismaʕ|بيسمعوا|ḥanismaʕ|bitismaʕi|سمعنا|simʕu|اسمعي	<i>verb</i><br><ol><li>to hear (to perceive with the ear)</li><li>to listen (to pay attention to a sound)</li></ol>
سنة|sána|sínīn|sánawāt	<i>noun</i><br><ol><li>year</li></ol>
سهل|سهّل|بتسهّل|حسهّل|نسهّل|يسهّلوا|بسهّل|bitsahhil|ḥaysahhil|sahhilna|ḥatsahhilu|تسهّل|سهّلوا|sahhilt|nisahhil|بتسهّلوا|حتسهّل|ḥaysahhilu|yisahhil|sahl|سهّلتي|bitsahhilu|بتسهّلي|bitsahhili|أسهل|sahhilit|اسهّل|سهّلت|binsahhil|ḥansahhil|سهّلي|بيسهّل|asahhil|سهّلنا|sahhilu|tisahhilu|basahhil|متسهل|حيسهّلوا|ḥatsahhil|يسهل|تسهّلوا|سهّلتوا|biysahhilu|حتسهّلوا|sahhilti|يسهّل|حتسهّلي|ḥatsahhili|tisahhili|تسهّلي|yisahhilu|ḥasahhil|حنسهّل|tisahhil|biysahhil|حيسهّل|sahhili|Term?|sahhiltu|sahhil|بيسهّلوا|بنسهّل	<i>verb</i><br><ol><li>to facilitate</li></ol><br><i>adj</i><br><ol><li>easy, convenient</li></ol>
سيخ|sīḵ|أسياخ	<i>noun</i><br><ol><li>spit, skewer, rod</li></ol>
شاف|اشوف|tišūfu|šūf|ḥatšūfu|شفتي|ḥašūf|šūfi|šuftu|شوف|yišūf|يشوف|šuft|tišūf|بيشوف|بشوف|تشوفوا|بيشوفوا|ḥayšūf|حيشوف|تشوف|šufti|تشوفي|bitšūf|šāf|tišūfi|ḥanšūf|بتشوف|binšūf|بنشوف|biyšūf|šufna|شوفوا|نشوف|ḥatšūf|شفتوا|šāfit|شفت|bašūf|biyšūfu|شفنا|شافت|بتشوفي|حشوف|شوفي|bitšūfu|متشاف|بتشوفوا|yišūfu|حتشوف|ašūf|nišūf|يشوفوا|ḥayšūfu|حتشوفوا|šūfu|شايف|حتشوفي	<i>verb</i><br><ol><li>to see (to perceive with the eyes)</li></ol>
شال|يشيل|šāl	<i>verb</i><br><ol><li>to carry (to transport by lifting)</li><li>to remove</li></ol>
شباك|šibbāk|شبابيك	<i>noun</i><br><ol><li>window</li></ol>
شبت|šabat	<i>noun</i><br><ol><li>dill</li></ol>
شبرية|šabrīya	<i>noun</i><br><ol><li>camel-litter, cacolet</li><li>bedstead</li></ol>
شبورة|šabbūra	<i>noun</i><br><ol><li>(weather) fog</li></ol>
شخر|bašaḵḵar|بيشخّروا|ḥatšaḵḵaru|šaḵḵart|bitšaḵḵari|بتشخّر|حتشخّري|شخّر|šaḵḵaru|يشخّر|بيشخّر|بشخّر|حشخّر|ḥayšaḵḵar|ašaḵḵar|تشخّري|šáḵár|حتشخّر|šaḵḵari|نشخّر|binšaḵḵar|بتشخّري|بنشخّر|تشخّروا|اشخّر|nišaḵḵar|šaḵḵarti|شخّرت|ḥašaḵḵar|biyšaḵḵar|tišaḵḵari|شخّرتوا|بتشخّروا|حتشخّروا|šaḵḵartu|شخّرتي|حيشخّر|يشخر|شخّري|ḥayšaḵḵaru|šaḵḵar|bitšaḵḵar|šáḵḵár|bitšaḵḵaru|ḥatšaḵḵar|tišaḵḵar|يشخّروا|biyšaḵḵaru|yišaḵḵar|حنشخّر|yišaḵḵaru|حيشخّروا|ḥatšaḵḵari|متشخر|šaḵḵarna|شخّرنا|tišaḵḵaru|šaḵḵarit|ḥanšaḵḵar|تشخّر|Term?|شخّروا	<i>verb</i><br><ol><li>(intransitive, of animals) to grunt</li><li>(intransitive, of humans, vulgar, slang) to produce a loud, low-pitched sound through the nose (often as a sign of indignation, disapproval, or disparagement), to grunt or snort like a pig</li><li>(intransitive) to snore</li></ol>
شراب|شُرَاب|شَرَاب|شُرَابَات|šarāb|شرابات|šorāb|شَرَابَات	<i>noun</i><br><ol><li>sock</li><li>(uncountable) syrup</li></ol>
شرب|bašrab|tišrab|حشرب|ḥanišrab|تشربي|حيشرب|širibtu|بنشرب|ḥayišrabu|ašrab|nišrab|حتشربي|يشربوا|širibti|حيشربوا|تشرب|اشرب|šírib|بشرب|شربتوا|حنشرب|biyišrabu|ḥayišrab|išrab|širibna|بيشربوا|tišrabi|حتشرب|bitišrab|شربت|بتشرب|bitišrabi|شربنا|yišrabu|شربوا|نشرب|تشربوا|بتشربي|širib|išrabu|širibt|binišrab|بيشرب|ḥatišrabi|مشروب|شارب|širbit|ḥatišrab|اشربوا|شربتي|بتشربوا|biyišrab|ḥatišrabu|tišrabu|išrabi|ḥašrab|اشربي|yišrab|bitišrabu|širbu|حتشربوا|يشرب	<i>verb</i><br><ol><li>to drink</li></ol>
شركة|šerka|شركات	<i>noun</i><br><ol><li>company (business)</li></ol>
شغل|šuḡl	<i>noun</i><br><ol><li>work, occupation</li></ol>
شفة|šiffa|شفايف	<i>noun</i><br><ol><li>(anatomy) lip</li></ol>
شفشق|شفاشق|šafšaʔ	<i>noun</i><br><ol><li>jug, pitcher</li></ol>
شقة|شقق|šuqaq	<i>noun</i><br><ol><li>apartment (domicile occupying part of a building)</li></ol>
شكرا|šukran	<i>intj</i><br><ol><li>thanks</li></ol>
شكليك|šaklīk	<i>noun</i><br><ol><li>(obsolete) bandolier</li></ol>
شليك|šilēk|شليكة	<i>noun</i><br><ol><li>(archaic) strawberry</li></ol>
شنطة|شنط|šanṭa|شنطه	<i>noun</i><br><ol><li>bag</li><li>briefcase</li><li>suitcase</li><li>trunk or boot of a car</li></ol>
شنف|يشنف|اشناف|شنوف|šanaf|šinf|شناف|شنوفة	<i>verb</i><br><ol><li>to sniff or sniffle</li></ol><br><i>noun</i><br><ol><li>a basket that bends well or a cloth sack</li><li>(rural) clodhopper, git</li></ol>
شوية|šuwayya	<i>adv</i><br><ol><li>a little</li></ol>
صبغ|ḥayuṣbuḡ|yuṣbuḡu|tuṣbuḡ|حنصبغ|يصبغوا|بتصبغوا|حتصبغ|اصبغ|اصبغي|bituṣbuḡu|بتصبغ|aṣbuḡ|بيصبغوا|تصبغ|ṣabaḡit|بنصبغ|بتصبغي|ṣabaḡ|صبغت|ḥatuṣbuḡu|yuṣbuḡ|ṣabaḡtu|حيصبغ|حتصبغوا|صبغتوا|tuṣbuḡu|bituṣbuḡi|ḥatuṣbuḡi|صبغوا|ṣabaḡt|uṣbuḡ|uṣbuḡu|ṣabaḡu|tuṣbuḡi|تصبغي|اصبغوا|ḥatuṣbuḡ|ḥayuṣbuḡu|ḥanuṣbuḡ|حيصبغوا|binuṣbuḡ|nuṣbuḡ|صبغنا|حتصبغي|بيصبغ|بصبغ|حصبغ|تصبغوا|نصبغ|biyuṣbuḡ|uṣbuḡi|ṣabaḡna|صابغ|يصبغ|baṣbuḡ|ṣabaḡti|ḥaṣbuḡ|مصبوغ|biyuṣbuḡu|bituṣbuḡ|صبغتي	<i>verb</i><br><ol><li>to dye</li></ol>
صرخ|يصرخ|ṣaraḵ	<i>verb</i><br><ol><li>to scream, to shout, to shriek</li></ol>
صرصار|ṣurṣār|صراصير	<i>noun</i><br><ol><li>cockroach</li></ol>
صرمة|صَرْمَة|ṣarma|صُرَم	<i>noun</i><br><ol><li>(dated) an old shoe particularly of leather or a pair thereof</li></ol>
صغير|sʿoğayyar	<i>adj</i><br><ol><li>small</li><li>young (for a person)</li></ol>
صقر|صقور	<i>noun</i><br><ol><li>falcon</li></ol>
صوت|ṣōt	<i>noun</i><br><ol><li>voice (sound uttered by the mouth)</li></ol>
صورة|ṣūra	<i>noun</i><br><ol><li>photograph</li></ol>
ضحك|ḍiḥikna|حتضحكي|ḍiḥikti|ḥaḍḥak|بتضحك|ḍiḥku|ḥatiḍḥak|نضحك|ضحكتوا|بيضحكوا|بنضحك|اضحكي|تضحك|biniḍḥak|ضاحك|niḍḥak|bitiḍḥak|تضحكوا|ḥatiḍḥaki|tiḍḥaku|يضحك|ḥayiḍḥaku|ḥayiḍḥak|ḥaniḍḥak|bitiḍḥaku|iḍḥaki|حتضحك|حيضحكوا|ḍiḥkit|tiḍḥaki|biyiḍḥak|حيضحك|iḍḥaku|مضحوك|ḍiḥik|aḍḥak|اضحكوا|حنضحك|بتضحكي|حضحك|ضحكتي|ḥatiḍḥaku|ضحكنا|ضحكوا|iḍḥak|يضحكوا|ḍiḥiktu|اضحك|bitiḍḥaki|بيضحك|yiḍḥaku|yiḍḥak|biyiḍḥaku|tiḍḥak|ضحكت|بضحك|baḍḥak|بتضحكوا|حتضحكوا|ḍiḥikt|تضحكي	<i>verb</i><br><ol><li>to laugh</li><li>to smile</li></ol>
ضرط|ḥayiẓraṭu|حيضرطوا|iẓraṭ|ẓiriṭtu|bitiẓraṭu|niẓraṭ|تضرط|tiẓraṭi|ẓiriṭt|iẓraṭu|ẓiriṭ|بيضرطوا|ḥatiẓraṭ|ضرطت|biyiẓraṭ|اضرطي|ẓiriṭna|yiẓraṭ|ضرطتي|ضرطتوا|tiẓraṭ|ẓirṭit|iẓraṭi|نضرط|biniẓraṭ|يضرط|bitiẓraṭ|بيضرط|ẓiriṭti|حتضرط|ḥatiẓraṭi|مضروط|تضرطوا|ḥaniẓraṭ|بضرط|baẓraṭ|ḥayiẓraṭ|يضرطوا|بتضرطي|yiẓraṭu|حنضرط|حيضرط|تضرطي|بتضرطوا|اضرطوا|بنضرط|ضرطنا|bitiẓraṭi|حضرط|tiẓraṭu|حتضرطوا|ضارط|biyiẓraṭu|ضرطوا|اضرط|aẓraṭ|ḥaẓraṭ|ḥatiẓraṭu|بتضرط|ẓirṭu|حتضرطي	<i>verb</i><br><ol><li>to fart audibly</li></ol>
طاش|ṭāš	<i>noun</i><br><ol><li>(agricultural) border, boundary</li></ol>
طبق|Tabaq	<i>noun</i><br><ol><li>plate (serving dish)</li></ol>
طبنجة|طبنجات|ṭabanga	<i>noun</i><br><ol><li>pistol, revolver, handgun</li></ol>
طربيزة|ṭarabēza|طربيزات|ṭarabīza	<i>noun</i><br><ol><li>table</li></ol>
طرقى|Turqaa|Torqaat	<i>noun</i><br><ol><li>corridor (“Narrow hall or passage”)</li></ol>
طريق|ṭarīʔ|طرق	<i>noun</i><br><ol><li>way</li><li>road</li></ol>
طعمة|ṭeʕma	<i>noun</i><br><ol><li>tasty</li><li>cute</li></ol>
طعمية|ṭaʿmiyya	<i>noun</i><br><ol><li>(uncountable) falafel</li></ol>
طفل|ṭifl|اطفال	<i>noun</i><br><ol><li>child</li></ol>
طوبه|ṭūba	<i>name</i><br><ol><li>The fifth month of the Coptic calendar.</li></ol>
طويل|ṭawīl|ṭowīl	<i>adj</i><br><ol><li>tall</li><li>long</li></ol>
طيز|ṭīz	<i>noun</i><br><ol><li>(vulgar) ass; arse (buttocks)</li></ol>
ظبط|حتظبطي|اظبطي|tuẓbuṭ|حنظبط|uẓbuṭi|bituẓbuṭu|ẓabaṭna|ظبطنا|ظبطت|tuẓbuṭu|حتظبطوا|ظبطتوا|ظابط|ḥaẓbuṭ|ḥayuẓbuṭ|ظبطتي|نظبط|بتظبط|بتظبطوا|حيظبط|مظبوط|ẓabaṭti|yuẓbuṭu|binuẓbuṭ|اظبطوا|ḥatuẓbuṭ|بظبط|يظبطوا|تظبطوا|حيظبطوا|ẓabaṭtu|bituẓbuṭi|tuẓbuṭi|biyuẓbuṭ|biyuẓbuṭu|baẓbuṭ|بتظبطي|ḥanuẓbuṭ|ظبطوا|تظبطي|ḥatuẓbuṭu|اظبط|بنظبط|حظبط|nuẓbuṭ|يظبط|ẓabaṭt|ẓabaṭit|bituẓbuṭ|حتظبط|uẓbuṭu|ẓabaṭ|بيظبطوا|ḥayuẓbuṭu|بيظبط|تظبط|uẓbuṭ|ẓabaṭu|aẓbuṭ|ḥatuẓbuṭi|yuẓbuṭ	<i>verb</i><br><ol><li>to adjust</li></ol>
ظه|ẓɑh	<i>noun</i><br><ol><li>The name of the seventeenth letter of the Arabic alphabet (ظ).</li></ol>
ع|ʿa	<i>prep</i><br><ol><li>see على</li></ol>
عارف|عارفة|عارفين|ʿārif	<i>adj</i><br><ol><li>knowing</li></ol>
عاز|ʿuzt|ʿāzit|tiʿūzu|biyʿūzu|عوزوا|tiʿūzi|اعوز|يعوزوا|ʿūzu|yiʿūz|ʿuzna|بتعوزوا|بيعوز|عزنا|ḥaʿūz|يعوز|عايز|حعوز|aʿūz|ʿuztu|biyʿūz|bitʿūzu|بتعوزي|حتعوزوا|binʿūz|baʿūz|حتعوز|تعوز|عزتي|عزتوا|ḥayʿūz|بتعوز|عازت|عوزي|عوز|niʿūz|حيعوز|ʿūzi|نعوز|ḥatʿūzu|ʿuzti|ḥayʿūzu|متعاز|yiʿūzu|بيعوزوا|ḥanʿūz|عزت|حتعوزي|ʿūz|تعوزي|تعوزوا|بنعوز|tiʿūz|bitʿūz|ḥatʿūz|بعوز|ʿāz	<i>verb</i><br><ol><li>to want</li></ol>
عاشر|ʕāšir	<i>adj</i><br><ol><li>tenth</li></ol>
عاصمة|ʿāṣima|عواصم	<i>noun</i><br><ol><li>capital (city)</li></ol>
عاوز|ʕāwez|عاوزة|عاوزين	<i>adj</i><br><ol><li>wanting</li></ol>
عايز|عايزين|عايزة|ʕāyez	<i>adj</i><br><ol><li>wanting</li></ol>
عربية|ʿarabiyyah|عربيات	<i>noun</i><br><ol><li>carriage, vehicle</li><li>araba, coach</li><li>automobile, car</li></ol>
عرف|عرفتوا|ʕiriftu|نعرف|tiʕrafu|بتعرفي|حنعرف|ḥayiʕrafu|ʕirifti|biyiʕrafu|biniʕraf|عرفتي|ʕirfit|بيعرفوا|معروف|ʕirift|yiʕraf|اعرف|تعرفوا|بتعرفوا|حعرف|تعرفي|عرفت|ḥatiʕrafi|tiʕrafi|baʕraf|عرفنا|aʕraf|ʕirifna|عارف|بتعرف|حيعرفوا|يعرف|biyiʕraf|حتعرفي|يعرفوا|حيعرف|عرفوا|bitiʕraf|بيعرف|bitiʕrafu|ḥaʕraf|اعرفوا|ʕirif|تعرف|ḥatiʕraf|iʕrafu|بنعرف|ḥatiʕrafu|tiʕraf|iʕrafi|ḥayiʕraf|اعرفي|ʕirfu|بعرف|niʕraf|yiʕrafu|حتعرفوا|حتعرف|iʕraf|ḥaniʕraf|bitiʕrafi	<i>verb</i><br><ol><li>to know</li></ol>
عسول|ʕassul|عسولة	<i>adj</i><br><ol><li>cute</li></ol>
عشرة|ʿašaṛa	<i>num</i><br><ol><li>ten</li></ol>
عشرين	<i>num</i><br><ol><li>twenty</li></ol>
عصلج	<i>verb</i><br><ol><li>(intransitive) to jib, balk, resist, be stubborn</li><li>(intransitive) to jam, to stick</li><li>(transitive) to obstruct and jam</li></ol>
عصير|ʿaṣīr	<i>noun</i><br><ol><li>juice</li></ol>
عطر|عُطور|ʿaṭṭar|ʿiṭr|ʿeṭer|عِطُور	<i>noun</i><br><ol><li>(uncommon) perfume</li><li>(uncommon) cologne</li></ol><br><i>verb</i><br><ol><li>(transitive) to perfume</li><li>(intransitive, with في (“into”), dated) to bump into, to clash with, to cross paths with, to come across</li></ol>
عطس|ʿiṭsu|حعطس|اعطس|حتعطسوا|ḥayiʿṭasu|ḥayiʿṭas|yiʿṭas|tiʿṭasi|بيعطس|عاطس|بتعطسوا|ḥaniʿṭas|biyiʿṭas|ʿiṭisna|تعطسوا|بعطس|اعطسي|tiʿṭas|ʿiṭisti|biniʿṭas|يعطسوا|حتعطس|عطستي|تعطس|نعطس|yiʿṭasu|biyiʿṭasu|baʿṭas|بنعطس|بتعطس|عطستوا|ḥatiʿṭas|ʿiṭistu|حتعطسي|حنعطس|اعطسوا|ʿiṭis|حيعطسوا|iʿṭasu|معطوس|تعطسي|bitiʿṭas|ḥatiʿṭasu|ʿiṭsit|aʿṭas|bitiʿṭasi|بتعطسي|عطست|bitiʿṭasu|ʿiṭist|يعطس|عطسنا|niʿṭas|tiʿṭasu|بيعطسوا|عطسوا|ḥaʿṭas|ḥatiʿṭasi|iʿṭas|حيعطس|iʿṭasi	<i>verb</i><br><ol><li>to sneeze</li></ol>
على|عليهم|عليه|علينا|علي|عليها|عليكوا|ʕala|عليك	<i>prep</i><br><ol><li>on, upon</li></ol>
عم|عمه|ʿamm|أعمام	<i>noun</i><br><ol><li>paternal uncle (“brother of one's father”)</li><li>(informal) Term of address to an older person</li></ol>
عمارة|3imaaraat	<i>noun</i><br><ol><li>building</li></ol>
عمل|عملت|بتعملوا|aʕmil|yiʕmil|baʕmil|تعملوا|bitiʕmil|حعمل|عامل|اعمل|حتعمل|حيعملوا|تعملي|iʕmili|biyiʕmil|بيعملوا|اعملوا|عملنا|اعملي|niʕmil|ʕamalit|biyiʕmilu|بتعمل|بعمل|ʕamalu|ʕamal|يعملوا|نعمل|عملتي|ḥaniʕmil|بنعمل|iʕmil|بتعملي|yiʕmilu|iʕmilu|ʕamalti|حتعملي|بيعمل|حيعمل|ḥatiʕmili|biniʕmil|tiʕmili|ḥaʕmil|bitiʕmili|ḥayiʕmilu|ʕamaltu|tiʕmilu|تعمل|معمول|ʕamalt|bitiʕmilu|tiʕmil|حنعمل|حتعملوا|يعمل|ḥatiʕmilu|عملوا|عملتوا|ḥayiʕmil|ʕamalna|ḥatiʕmil	<i>verb</i><br><ol><li>to do</li></ol>
عنتيل|عناتيل|ʕantīl	<i>noun</i><br><ol><li>hero, legend</li><li>strong and muscular person</li><li>(derogatory) pervert, deviant</li></ol>
عند|عندنا|ʿand|عندكو|عندك|عندهم|عندي|عنده|عندها	<i>prep</i><br><ol><li>at the house of</li><li>expresses possession, to have</li></ol>
عنوان|عناوين|ʿinwān	<i>noun</i><br><ol><li>address</li><li>title</li></ol>
عيان|ʕayyān	<i>adj</i><br><ol><li>sick (in poor health)</li><li>crazy</li></ol>
عيش الغراب|ɛēš el-ġorāb	<i>noun</i><br><ol><li>mushrooms, fungi</li></ol>
عيط|يعيّط	<i>verb</i><br><ol><li>to cry</li></ol>
عيل|ʿayyel	<i>noun</i><br><ol><li>child</li></ol>
عيلة|عائلات|ʿēla|ʿaʾilāt|عيلات	<i>noun</i><br><ol><li>family</li></ol>
غابة	<i>noun</i><br><ol><li>forest</li></ol>
غالي|ġāli	<i>adj</i><br><ol><li>expensive (having a high price)</li></ol>
غيط|ḡīṭ|غيطان	<i>noun</i><br><ol><li>field</li></ol>
ف|fe	
فارسي|فارسى|fārsi|فارسية	<i>name</i><br><ol><li>Persian, Farsi (language)</li></ol><br><i>adj</i><br><ol><li>Persian, Farsi</li></ol>
فتح|بتفتحي|افتح|فتحتوا|حتفتح|ḥatiftaḥu|يفتح|فاتح|fataḥtu|yiftaḥu|baftaḥ|بنفتح|تفتحي|افتحوا|fataḥti|حيفتحوا|iftaḥu|تفتحوا|biniftaḥ|بتفتح|ḥayiftaḥ|iftaḥ|بيفتحوا|bitiftaḥu|fataḥt|ḥayiftaḥu|tiftaḥu|بفتح|حفتح|fataḥna|تفتح|بتفتحوا|فتحت|aftaḥ|fataḥ|iftaḥi|مفتوح|ḥaftaḥ|ḥaniftaḥ|ḥatiftaḥi|حنفتح|نفتح|حتفتحوا|افتحي|yiftaḥ|niftaḥ|فتحوا|حتفتحي|بيفتح|tiftaḥi|فتحنا|tiftaḥ|يفتحوا|biyiftaḥ|fataḥu|bitiftaḥ|biyiftaḥu|ḥatiftaḥ|bitiftaḥi|حيفتح|fataḥit|فتحتي	<i>verb</i><br><ol><li>to open (to make something accessible)</li></ol>
فخد|فخاد|faḵd	<i>noun</i><br><ol><li>(anatomy) thigh</li></ol>
فرجية|فَرَاجِيّ|فَرَجِيَّة|farajiyya	<i>noun</i><br><ol><li>a kind of robe, floating and with long sleeves, ferace</li></ol>
فرنساوي|فَرَنْسَاوِي|faransāwi	<i>adj</i><br><ol><li>French</li></ol>
فضى|faḍḍi	<i>adj</i><br><ol><li>silver</li></ol>
فظيع|فَظَايع|fazīʿ|فَظِيعَة	<i>adj</i><br><ol><li>awful, horrible, terrible, very bad</li></ol>
فلاح|فلّاحة|fallāḥ|فلّاحين	<i>noun</i><br><ol><li>(countable, Cairene, derogatory, offensive, slang) a rustic, a peasant, a provincial</li><li>(countable, Cairene, derogatory or humorous, slang) an ignorant, a peasant</li></ol>
فلوس|flūs	<i>noun</i><br><ol><li>money</li></ol>
فم|أَفْمَام|fumm	<i>noun</i><br><ol><li>mouth</li><li>muzzle</li><li>orifice, aperture, hole, vent</li><li>mouthpiece (of pipe or cigarette), cigarette holder</li></ol>
فن|fann	<i>noun</i><br><ol><li>art</li></ol>
فهم|فهموا|تفهم|بتفهمي|fihim|تفهمي|افهموا|fihimna|بفهم|حتفهموا|fihimt|بيفهم|فهمتوا|فهمنا|bafham|ḥafham|bitifham|nifham|حيفهم|biyifhamu|افهم|fihimtu|فاهم|يفهم|ḥayifhamu|فهمتي|afham|bitifhami|ifham|ifhami|حتفهم|يفهموا|حفهم|افهمي|ḥanifham|fihmit|tifham|biyifham|تفهموا|ḥatifham|fihmu|حتفهمي|فهمت|yifham|binifham|مفهوم|بنفهم|حنفهم|ḥayifham|tifhamu|حيفهموا|ḥatifhami|fihimti|بتفهموا|ifhamu|tifhami|بتفهم|بيفهموا|yifhamu|bitifhamu|ḥatifhamu|نفهم	<i>verb</i><br><ol><li>to understand</li></ol>
فوضوية|فَوْضَوِيَّة|fawḍawiyya	<i>noun</i><br><ol><li>(politics) anarchism</li></ol>
فوطة|fūṭa	<i>noun</i><br><ol><li>towel</li></ol>
فوق|fooq	<i>prep</i><br><ol><li>above, on top of</li></ol>
فيشة|fīša|فِيَش	<i>noun</i><br><ol><li>(countable) a hollow with one or more terminals that receives a plug, a socket</li></ol>
فيلا|filla|فيلل|فيلّات|villa|فيلّا	<i>noun</i><br><ol><li>villa, detached house, bungalow</li></ol>
فين|fēn	<i>pron</i><br><ol><li>(interrogative) where?</li></ol>
قال|ʾultu|بنقول|يقولوا|بيقول|ʾūl|قولي|قلتي|baʾūl|ʾāl|ḥayʾūl|نقول|tiʾūli|ḥanʾūl|ʾult|ḥatʾūlu|ḥatʾūl|ḥaʾūl|يقول|اقول|تقول|قول|تقولوا|yiʾūl|حيقول|biyʾūlu|حقول|binʾūl|قلت|ʾūlu|بقول|tiʾūlu|قلنا|بتقولوا|bitʾūlu|ḥayʾūlu|tiʾūl|aʾūl|niʾūl|تقولي|قالت|حتقولي|قايل|بتقولي|قولوا|حتقول|ʾulti|yiʾūlu|قلتوا|biyʾūl|بيقولوا|حتقولوا|bitʾūl|ʾālit|ʾulna|بتقول|ʾūli|متقال	<i>verb</i><br><ol><li>to say</li></ol>
قدام|قدامي|قدامك|قدامها|قدامنا|ʔuddām|قدامكو|قدامه|قدامهم	<i>prep</i><br><ol><li>in front of, before</li></ol>
قدر|حيقدروا|تقدر|مقدور|قادر|biniʾdar|ḥayiʾdaru|ḥaniʾdar|iʾdari|حتقدر|ḥaʾdar|ḥatiʾdari|aʾdar|قدرتوا|ḥayiʾdar|اقدروا|بيقدروا|biyiʾdaru|ʾidir|تقدروا|بتقدر|ḥatiʾdar|يقدر|niʾdar|iʾdaru|tiʾdar|ʾidirt|ʾidrit|اقدري|biyiʾdar|قدرتي|حيقدر|yiʾdaru|بنقدر|تقدري|iʾdar|tiʾdaru|بتقدري|حتقدري|ʾidirti|ʾidirtu|قدروا|اقدر|قدرت|baʾdar|بتقدروا|حنقدر|bitiʾdari|ʾidirna|yiʾdar|نقدر|بيقدر|ḥatiʾdaru|بقدر|bitiʾdar|tiʾdari|bitiʾdaru|ʾidru|حقدر|قدرنا|يقدروا|حتقدروا	<i>verb</i><br><ol><li>to be able to, to can</li></ol>
قرا|ʾara|يقرا	<i>verb</i><br><ol><li>to read</li></ol>
قراية|ʾirāyāt|ʾirāya|قرايات	<i>noun</i><br><ol><li>reading</li></ol>
قرد|ʾird|قرود	<i>noun</i><br><ol><li>monkey, ape (mammal)</li></ol>
قرش|ʾerš|ʾorūš	<i>noun</i><br><ol><li>shark</li><li>piaster (one hundredth of an Egyptian pound)</li></ol>
قرفة|ʔirfa	<i>noun</i><br><ol><li>cinnamon</li></ol>
قزاز|ʔizāz|قزازين|ازاز|ʔazzāz	<i>noun</i><br><ol><li>glass</li><li>window pane</li><li>window pane and mirror seller</li><li>(obsolete) weaver</li></ol>
قزازة|ʔizāza|ازازة|أزايز	<i>noun</i><br><ol><li>bottle</li></ol>
قزق|ʾazaʾ|qazaq|قَزَقَة|قَزَق|قِزَقَات|قِزَق	<i>noun</i><br><ol><li>dolly, trolley, lever, slipway</li><li>poles, posts (such as used for telecommunication)</li></ol>
قزمة|qazma	<i>noun</i><br><ol><li>(Upper Egypt) pickaxe, mattock</li></ol>
قشر|baʾaššar|tiʾaššaru|ʾaššart|تقشّري|ḥatʾaššari|قشّري|ḥaʾaššar|قشّروا|ḥatʾaššar|yiʾaššar|bitʾaššaru|حيقشّر|تقشّروا|تقشّر|ʾaššarna|ḥayʾaššar|niʾaššar|tiʾaššari|بتقشّري|حيقشّروا|بتقشّروا|قشّرتي|اقشّر|ʾaššarit|بقشّر|bitʾaššari|قشّرتوا|قشّرنا|نقشّر|حتقشّروا|بيقشّر|ḥanʾaššar|ḥatʾaššaru|ḥayʾaššaru|قشّر|biyʾaššar|حتقشّري|yiʾaššaru|ʾaššaru|بتقشّر|binʾaššar|aʾaššar|ʾaššartu|ʾaššarti|حنقشّر|حقشّر|biyʾaššaru|ʾaššar|قشّرت|يقشر|يقشّروا|يقشّر|بنقشّر|ʾaššari|tiʾaššar|بيقشّروا|متقشر|Term?|bitʾaššar|حتقشّر	<i>verb</i><br><ol><li>peel</li></ol>
قشطة|ʔišṭa	<i>noun</i><br><ol><li>cream</li><li>cool, awesome</li></ol>
قصاد|قصادك|قصادي|قصادنا|قصادكو|قصادهم|قصاده|ʔuṣād|قصادها	<i>prep</i><br><ol><li>in front of, before</li></ol>
قط|قُطَّة|قُطَط|ʔuṭṭ	<i>noun</i><br><ol><li>tomcat, male equivalent of قطة</li></ol>
قطة|قُطَطْ|ʔuṭṭa	<i>noun</i><br><ol><li>(any) cat</li></ol>
قطر|ʾaṭr	<i>noun</i><br><ol><li>railroad train</li></ol>
قطع|يقطع|ʾaṭaʿ	<i>verb</i><br><ol><li>to cut</li></ol>
قعد|يقعد|ʾaʿad	<i>verb</i><br><ol><li>sit, stay</li></ol>
قفل|ʾafal|يقفل	<i>verb</i><br><ol><li>to close</li></ol>
قلب|قلوب|ʔalb	<i>noun</i><br><ol><li>heart</li></ol>
قلش|حيقلشوا|قلشان|ʾalašu|اقلش|ḥayiʾlišu|ʾalaš|نقلش|yiʾlišu|yiʾliš|ḥatiʾlišu|iʾlišu|تقلشوا|ʾalašit|بنقلش|ḥatiʾliši|قلشوا|بتقلش|حقلش|ʾalašna|tiʾliši|قالش|حيقلش|يقلشوا|تقلش|بيقلشوا|ḥaʾliš|بقلش|ʾalaštu|حتقلشي|ʾalašti|مقلوش|حتقلش|aʾliš|اقلشوا|iʾliš|niʾliš|يقلش|قلشنا|ʾalašt|قلشتوا|baʾliš|tiʾliš|اقلشي|تقلشي|bitiʾliš|بتقلشوا|بتقلشي|ḥaniʾliš|biyiʾliš|ḥayiʾliš|قلشتي|biniʾliš|iʾliši|حنقلش|bitiʾliši|biyiʾlišu|قلشت|حتقلشوا|ḥatiʾliš|tiʾlišu|bitiʾlišu|بيقلش	<i>verb</i><br><ol><li>(transitive) to oust, to throw out</li></ol>
قلم|أقلام|ʾalam	<i>noun</i><br><ol><li>pen</li></ol>
قورة|قور|ʔūṛa	<i>noun</i><br><ol><li>forehead</li></ol>
قوقعة|kawkaˤa|قَوْقَعَة	<i>noun</i><br><ol><li>snail</li></ol>
قونة|qūna|قُوَن	<i>noun</i><br><ol><li>(amongst Coptic Christians) icon</li></ol>
قوي|ʾawi	<i>adv</i><br><ol><li>very</li></ol>
ك	<i>pron</i><br><ol><li>masculine singular bound object pronoun: you, your</li><li>feminine singular bound object pronoun: you, your</li></ol>
كابوريا|kāburya	<i>noun</i><br><ol><li>crabs</li></ol>
كاوتش|كاويتشة|كوتش|كويتشات|كاويتشات|كويتش|كوتشات|كوتشة|كويتشة|kawetš|كاويتش|كاوتشات|كاوتشة	<i>noun</i><br><ol><li>(collective) rubber</li><li>(countable) a piece of rubber; a rubber covering, a tire</li></ol>
كباية|kubbāya|كبّايات|كبّاية	<i>noun</i><br><ol><li>glass, tumbler (drinking vessel)</li></ol>
كبير|kibiir|كبار|كبيرة	<i>adj</i><br><ol><li>big</li><li>great</li><li>old (for a person)</li></ol>
كتب|كتبتوا|كتبتي|iktib|katabti|tiktibi|ḥatiktibu|اكتب|biyiktibu|كتبوا|bitiktibi|katabna|بنكتب|يكتبوا|حتكتبوا|ḥaktib|iktibi|كاتب|بيكتب|كتبان|حتكتب|كتابة|aktib|iktibu|ḥatiktibi|اكتبوا|katabit|يكتب|نكتب|بكتب|كتبت|baktib|katabu|ḥayiktibu|حنكتب|اكتبي|تكتبوا|bitiktib|حيكتبوا|tiktib|حيكتب|katab|yiktib|niktib|تكتبي|biniktib|bitiktibu|tiktibu|ḥaniktib|biyiktib|مكتوب|katabtu|كتبنا|بيكتبوا|حكتب|بتكتبوا|تكتب|ḥatiktib|حتكتبي|katabt|بتكتب|yiktibu|ḥayiktib|بتكتبي	<i>verb</i><br><ol><li>to write</li></ol>
كرسي|كراسي|kursi	<i>noun</i><br><ol><li>chair, seat</li></ol>
كرويتة|كَرَوِيتَة|كَرَوِيتَات|karawēta	<i>noun</i><br><ol><li>wooden frame, wood rack (as a piece of furniture)</li></ol>
كس|kuss	<i>noun</i><br><ol><li>(vulgar) pussy, cunt</li></ol>
كس أختك|كُس أُخْتَك|kus ʾuḵhtak|kus ʾuḵtak|كس اختك	<i>intj</i><br><ol><li>(vulgar) your sister’s pussy (general term of discontentment, like English fuck!)</li></ol>
كستر|kastar|كسترة|kastara	<i>verb</i><br><ol><li>to nap, to impart a fuzzy cloth-surface to</li></ol><br><i>noun</i><br><ol><li>custard</li></ol>
كسترة|كسترات|كستره|kustarra|kastara	<i>noun</i><br><ol><li>(archaic) ruler for drawing lines</li></ol>
كستور|kastūr	<i>noun</i><br><ol><li>a kind of soft cotton cloth, nap, flannel, winceyette</li></ol>
كسلان|kaslān	<i>adj</i><br><ol><li>lazy</li></ol>
كسم|kasm|kassim	<i>noun</i><br><ol><li>cut, fit, shape</li></ol><br><i>verb</i><br><ol><li>to fit, to try to apply or mould the form of to</li></ol>
كل|koll	<i>pron</i><br><ol><li>all</li></ol>
كلمة|kilma|كلام	<i>noun</i><br><ol><li>word</li></ol>
كمان|kamān	<i>adv</i><br><ol><li>too (likewise)</li><li>in addition</li><li>even</li></ol>
كنبة|kanaba|كنب	<i>noun</i><br><ol><li>couch, sofa</li></ol>
كو|ـكو	<i>suffix</i><br><ol><li>you, your (bound object pronoun)</li></ol>
كوتش|kawetš|كوتشة|كوتشات|kotš	<i>noun</i><br><ol><li>(collective) running shoes</li><li>(countable) a coach</li></ol>
كورة|كُوَر|كورَات|kōra|كِوَر	<i>noun</i><br><ol><li>ball</li><li>football</li></ol>
كوسة|kōsa	<i>noun</i><br><ol><li>zucchini</li></ol>
كوفتس|kūftis	<i>noun</i><br><ol><li>(ethnic slur) an offensive word for a Copt</li></ol>
كوهرجلة|kūhargala	<i>noun</i><br><ol><li>saltpetre, potassium nitrate</li></ol>
كويس|كويسين|كويسة|kwayyis|kuwáyyis	<i>adj</i><br><ol><li>good</li></ol><br><i>adv</i><br><ol><li>well</li></ol>
كياك|kiyāk	<i>name</i><br><ol><li>The fourth month of the Coptic calendar.</li></ol>
كيزر|kayzar	<i>noun</i><br><ol><li>hamburger bun, bread roll</li></ol>
كيس|اكياس|kīs	<i>noun</i><br><ol><li>bag, sack</li></ol>
لب|lebb	<i>noun</i><br><ol><li>kernels (specifically seed kernels)</li></ol>
لبان|لبانة|libān|لبن	<i>noun</i><br><ol><li>olibanum; frankincense</li><li>any kind of gum or resin</li><li>chewing gum</li><li>cable of a ship, tow, hawser</li></ol>
لبس|binilbis|حلبّس|يلبّس|alabbis|labbisna|حتلبّسي|tilbisu|labbis|يلبسوا|tilabbisi|حيلبس|nilbis|ilbis|لبسوا|تلبّسوا|yilbisu|ḥatilbisi|حتلبسوا|yilbis|labbisit|تلبسوا|لبّسوا|يلبّسوا|حتلبس|لبسنا|البسي|حيلبّسوا|labbist|حتلبّس|yilabbis|ḥanlabbis|biylabbis|ḥatilbis|tilbisi|ملبوس|tilabbis|تلبّسي|ḥalabbis|biylabbisu|labbisi|لبّسنا|لبستي|ḥalbis|labbisti|ilbisu|bitlabbisi|بيلبّسوا|nilabbis|libist|libsit|لابس|bitlabbisu|لبّستوا|حيلبّس|bitilbis|bitilbisi|بتلبسوا|albis|tilabbisu|لبّستي|بيلبسوا|البس|البسوا|بلبّس|libis|libisti|تلبّس|يلبس|لبّست|ḥayilbisu|binlabbis|بنلبس|بتلبّس|balbis|ilbisi|libsu|ḥayilbis|لبستوا|نلبّس|لبست|تلبس|بتلبس|ḥaylabbisu|تلبسي|بتلبّسي|ḥatlabbisu|بلبس|labbisu|biyilbisu|libisna|ḥatlabbisi|بتلبسي|نلبس|لبّسي|حلبس|حيلبسوا|tilbis|biyilbis|ḥaylabbis|بتلبّسوا|بنلبّس|حنلبس|bitlabbis|بيلبس|حتلبسي|balabbis|البّس|ḥatlabbis|labbistu|بيلبّس|bitilbisu|متلبس|حتلبّسوا|yilabbisu|ḥatilbisu|ḥanilbis|libistu|حنلبّس|لبّس|Term?	<i>verb</i><br><ol><li>to wear (to have on (clothes))</li><li>(transitive) to dress</li></ol>
لبوة|lábwa|لباوي	<i>noun</i><br><ol><li>(vulgar) a slut; a bitch</li><li>(widely avoided) a lioness</li></ol>
لسا|lissa	<i>adv</i><br><ol><li>still</li><li>not yet</li></ol>
لفت|lift	<i>noun</i><br><ol><li>turnip</li></ol>
لم|بتلموا|لمت|بلم|yilimm|ḥalimm|نلم|lammit|ḥatlimmu|limmu|lamm|حيلم|حتلموا|limm|لموا|yilimmu|حتلم|ḥanlimm|ḥaylimmu|بتلمي|balimm|bitlimm|bitlimmu|tilimmu|بيلموا|ملموم|لميتي|بيلم|lammēti|lammēna|limmi|lammu|يلم|ḥatlimmi|الم|nilimm|حنلم|لميتوا|alimm|حيلموا|لامم|tilimmi|tílimm|biylimm|ḥaylimm|lammēt|لمينا|تلمي|lammētu|بنلم|تلم|يلموا|بتلم|حتلمي|تلموا|حلم|tilimm|binlimm|لميت|bitlimmi|biylimmu|لمي|ḥatlimm	<i>verb</i><br><ol><li>to collect, to gather</li></ol>
لمس|bitilmisi|حتلمسي|تلمس|حنلمس|ilmisi|lamasu|حتلمس|المس|بتلمسوا|lamas|لمسنا|يلمس|ilmisu|balmis|لمست|bitilmisu|tilmis|yilmis|لمسوا|بنلمس|almis|ḥatilmis|حتلمسوا|ḥayilmisu|tilmisi|ملموس|المسوا|ḥayilmis|binilmis|bitilmis|ḥatilmisu|لامس|بتلمس|biyilmis|lamasna|lamast|حلمس|ḥatilmisi|lamasit|lamastu|ilmis|نلمس|biyilmisu|lamasti|nilmis|حيلمس|لمستي|بيلمسوا|ḥanilmis|ḥalmis|yilmisu|بيلمس|يلمسوا|المسي|تلمسوا|tilmisu|بلمس|تلمسي|لمستوا|بتلمسي|حيلمسوا	<i>verb</i><br><ol><li>to touch</li></ol>
لوح|lōḥ	<i>noun</i><br><ol><li>shoulderblade</li></ol>
لون|ألوان|lūn	<i>noun</i><br><ol><li>color</li></ol>
ليه|lēh	<i>adv</i><br><ol><li>why?</li></ol>
مات|تموتوا|mutna|اموت|موت|يموتوا|موتي|mātit|يموت|timūti|mutti|māt|حيموت|بيموت|ḥatmūtu|حتموتوا|biymūtu|ḥatmūt|متمات|نموت|ḥamūt|حموت|mūti|بتموتي|بموت|bitmūtu|ḥaymūt|binmūt|ḥanmūt|mutt|تموت|nimūt|حتموتي|ماتت|amūt|موتوا|mūt|timūt|متت|حتموت|متنا|بتموتوا|متتوا|بنموت|ḥaymūtu|yimūtu|yimūt|timūtu|bamūt|muttu|متتي|تموتي|بتموت|بيموتوا|مايت|biymūt|bitmūt|mūtu	<i>verb</i><br><ol><li>to die</li></ol>
مايع|māyiʕ|مايعة	<i>adj</i><br><ol><li>sissy, girly, effeminate</li></ol>
مبسوط|مبسوطين|مبسوطة|mabsūṭ	<i>adj</i><br><ol><li>happy, pleased, content</li><li>rich</li></ol>
متدين|mutadayyin|متدينة|مُتَدَيِّن	<i>adj</i><br><ol><li>religious</li><li>devout, pious</li><li>God-fearing</li></ol>
محامي|محامين|muḥā́mi	<i>noun</i><br><ol><li>lawyer</li></ol>
محطة|maḥáṭṭa	<i>noun</i><br><ol><li>station</li></ol>
محظوظ|maḥẓūẓ	<i>adj</i><br><ol><li>lucky</li></ol>
محل|maḥall	<i>noun</i><br><ol><li>store</li></ol>
مخ|muḵḵ|أَمْخَاخ	<i>noun</i><br><ol><li>(anatomy) brain (“organ”)</li></ol>
مختلف|mukhtalif	<i>adj</i><br><ol><li>different</li></ol>
مراة	<i>noun</i><br><ol><li>wife</li></ol>
مريلة|maryala|مرايل	<i>noun</i><br><ol><li>apron, bib</li></ol>
مز|mizz|مزد|mizd|mazz|mazd	<i>noun</i><br><ol><li>inner shoes, slippers, chaussons</li></ol>
مزة|مزز|mozza	<i>noun</i><br><ol><li>(informal) an attractive woman; chick, bird</li></ol>
مزيكا|mazzīka	<i>noun</i><br><ol><li>music</li></ol>
مسرى|misra	<i>name</i><br><ol><li>The sixth month of the Coptic calendar.</li></ol>
مسطرة|مساطر|masṭara	<i>noun</i><br><ol><li>ruler (measuring or drawing device)</li></ol>
مسك|timsik|يمسك|بتمسكي|misikna|biyimsiku|مسكت|binimsik|مسكوا|timsiku|حتمسكوا|timsiki|ḥayimsik|imsik|amsik|nimsik|misku|yimsik|ماسك|تمسكوا|misikt|ḥayimsiku|امسكوا|imsiku|imsiki|bitimsiku|حنمسك|ḥatimsik|امسكي|تمسكي|بتمسك|misik|yimsiku|misiktu|bitimsik|بنمسك|حيمسكوا|مسكنا|حتمسكي|مسكان|ḥatimsiki|misikti|bamsik|حمسك|miskit|مسكتوا|بيمسكوا|نمسك|تمسك|مسكتي|بمسك|يمسكوا|بتمسكوا|ḥamsik|حيمسك|biyimsik|امسك|ḥatimsiku|bitimsiki|ḥanimsik|حتمسك|ممسوك|بيمسك	<i>verb</i><br><ol><li>(transitive) to take hold of, to grasp</li><li>(transitive) to capture, to arrest</li></ol>
مش|muš|مِش|miš|مُش	<i>particle</i><br><ol><li>not</li></ol>
مشى|يمشي|maša	<i>verb</i><br><ol><li>to walk</li><li>(intransitive) to leave</li></ol>
مصر|maṣr	<i>name</i><br><ol><li>Egypt (a country in Africa)</li></ol>
مصري|مصريين|maṣri|مصرية	<i>adj</i><br><ol><li>Egyptian</li></ol><br><i>noun</i><br><ol><li>Egyptian (person)</li><li>Egyptian Arabic dialect, Masri</li></ol>
مطبخ|maṭābiḵ|maṭbaḵ|مطابخ	<i>noun</i><br><ol><li>kitchen</li></ol>
مطعم|مطاعم|maṭʕam	<i>noun</i><br><ol><li>restaurant</li></ol>
معلقة|maʿláʾa|معالق	<i>noun</i><br><ol><li>spoon (utensil)</li></ol>
مغرفة|maḡrafa|مغارف	<i>noun</i><br><ol><li>ladle</li></ol>
مغسلة|maḡsala	<i>noun</i><br><ol><li>car wash</li></ol>
مقص|maʾáṣṣ	<i>noun</i><br><ol><li>scissors</li></ol>
مقلي|maʾli	<i>adj</i><br><ol><li>fried (cooked by frying)</li></ol>
ملاك|ملايكة|malā́k	<i>noun</i><br><ol><li>angel</li></ol>
مليان|malyān	<i>adj</i><br><ol><li>full (containing the maximum possible amount)</li></ol>
مناخير|manaḵī́r	<i>noun</i><br><ol><li>(anatomy) nose</li></ol>
منع|منعوا|تمنع|biyimnaʿ|حيمنع|تمنعي|ḥayimnaʿ|timnaʿ|ḥamnaʿ|امنع|امنعوا|يمنع|حنمنع|منعنا|manaʿti|biyimnaʿu|بمنع|حمنع|bitimnaʿi|تمنعوا|imnaʿi|بتمنعي|manaʿt|ḥatimnaʿi|منعت|حتمنع|imnaʿ|منعتوا|امنعي|بيمنع|manaʿ|bitimnaʿ|يمنعوا|yimnaʿu|منعتي|ḥatimnaʿu|manaʿna|bamnaʿ|بتمنعوا|ḥatimnaʿ|manaʿtu|yimnaʿ|مانع|nimnaʿ|binimnaʿ|timnaʿu|بتمنع|نمنع|حيمنعوا|manaʿit|ḥayimnaʿu|حتمنعي|bitimnaʿu|amnaʿ|بنمنع|imnaʿu|حتمنعوا|manaʿu|timnaʿi|ممنوع|بيمنعوا|ḥanimnaʿ	<i>verb</i><br><ol><li>to prevent, to obstruct, to block</li></ol>
منين|meniin	<i>adv</i><br><ol><li>where...from ? (from what place)</li></ol>
مهم|mohimm	<i>adj</i><br><ol><li>interesting</li><li>important</li></ol>
موس|mūs	<i>noun</i><br><ol><li>razor</li></ol>
موميا|mūmiyā	<i>noun</i><br><ol><li>mummy</li><li>bitumen</li></ol>
مية|ميت|míyya|mɑ̀yyɑ	<i>noun</i><br><ol><li>water</li></ol><br><i>num</i><br><ol><li>hundred</li></ol>
ميتم|مَيْتَم|maytam|مَيَتِم	<i>noun</i><br><ol><li>funeral procession</li></ol>
ميتين|mītēn	<i>num</i><br><ol><li>two hundred</li></ol>
ميتينج|mītīng	<i>noun</i><br><ol><li>meeting, a gathering of peoples for a purpose.</li></ol>
مين|mīn	<i>pron</i><br><ol><li>who?</li></ol>
نا|ـنا	<i>suffix</i><br><ol><li>us, our (bound object pronoun)</li></ol>
ناك|nāk|ينيك	<i>verb</i><br><ol><li>(vulgar) to fuck</li></ol>
نام|nām|ينام	<i>verb</i><br><ol><li>to sleep</li></ol>
نبيت|nibī́t	<i>noun</i><br><ol><li>wine</li></ol>
نتاية|nitāya	<i>noun</i><br><ol><li>(especially of animals) female</li></ol>
نسي|ينسى|nisi	<i>verb</i><br><ol><li>to forget (to lose remembrance of)</li></ol>
نص|nuṣṣ	<i>noun</i><br><ol><li>half</li></ol>
نعم|naʕam	<i>intj</i><br><ol><li>yes?, response to being called by one's name.</li></ol>
نمرة|nimra	<i>noun</i><br><ol><li>number</li></ol>
نهارك سعيد|nahārak saʿīd	<i>phrase</i><br><ol><li>good day</li></ol>
ني	<i>suffix</i><br><ol><li>me (bound object pronoun)</li></ol>
ه|ـه	<i>suffix</i><br><ol><li>him, his (bound object pronoun)</li></ol>
ها|ـها	<i>suffix</i><br><ol><li>her (bound object pronoun)</li></ol>
هتور|hatūr	<i>name</i><br><ol><li>The third month of the Coptic calendar.</li></ol>
هدوم|hidū́m	<i>noun</i><br><ol><li>clothes</li></ol>
هم|humma|ـهم	<i>pron</i><br><ol><li>they</li></ol><br><i>suffix</i><br><ol><li>them, their</li></ol>
هنا|hina	<i>adv</i><br><ol><li>here</li></ol>
هناك|hināk	<i>adv</i><br><ol><li>there</li></ol>
هو|húwwa	<i>pron</i><br><ol><li>he (subject pronoun)</li></ol>
هوا|hawa	<i>noun</i><br><ol><li>air</li></ol>
هي|híyya	<i>pron</i><br><ol><li>she (subject pronoun)</li></ol>
واحد|واحدة|wāḥid	<i>num</i><br><ol><li>one</li></ol>
وحش|وحشة|wiḥš|وحشين	<i>adj</i><br><ol><li>bad</li></ol>
ودن|widn|ودان	<i>noun</i><br><ol><li>(anatomy) ear (organ)</li></ol>
وزة|وز|wizza	<i>noun</i><br><ol><li>goose</li></ol>
وش|وشوش|wišš	<i>noun</i><br><ol><li>(anatomy) face</li></ol>
وصل|wiṣil|يوصل	<i>verb</i><br><ol><li>to arrive</li></ol>
وعد|biniwʿid|waʿadit|موعود|waʿadt|نوعد|بتوعدوا|بوعد|bitiwʿidi|niwʿid|توعد|tiwʿidu|بتوعدي|حوعد|بتوعد|وعدوا|وعدنا|بنوعد|ḥaniwʿid|توعدوا|بيوعد|حيوعدوا|awʿid|ḥatiwʿidi|حيوعد|حتوعد|waʿadu|توعدي|حنوعد|ḥatiwʿidu|حتوعدوا|waʿad|ḥayiwʿid|tiwʿidi|ḥayiwʿidu|وعدتوا|bitiwʿidu|waʿadti|ḥawʿid|biyiwʿid|ḥatiwʿid|biyiwʿidu|حتوعدي|bawʿid|اوعدي|iwʿid|واعد|tiwʿid|waʿadtu|يوعدوا|iwʿidu|iwʿidi|yiwʿid|waʿadna|yiwʿidu|اوعدوا|وعدتي|bitiwʿid|اوعد|بيوعدوا|وعدت|يوعد	<i>verb</i><br><ol><li>to promise</li></ol>
وقت|أوقات|waʾt	<i>noun</i><br><ol><li>time</li></ol>
ولادة|wallāda	<i>noun</i><br><ol><li>midwife</li></ol>
يا|ya	<i>particle</i><br><ol><li>vocative particle</li></ol><br><i>conj</i><br><ol><li>either ... or</li></ol>
يد واحدة ماتسقفش|يد واحدَة ماتسقفش|īd waḥda ma-tsaʾʾaf-š	<i>proverb</i><br><ol><li>one hand doesn't clap; i.e., cooperation from all sides is necessary to accomplish anything</li></ol>
يع|yaʿ	<i>intj</i><br><ol><li>an exclamation of disgust in regards to an offensive odor, taste, sight, or thought: yuck!, ew!, ugh!</li></ol>
يمكن|yimkin	<i>adv</i><br><ol><li>maybe</li></ol>
ينف|yenéff	<i>verb</i><br><ol><li>To blow one's nose</li></ol>
پ|be be-tálat nóʾaṭ	
چ|gīm with three dots|gīm be tálat nóʾaṭ	
ڤ|fe be-tálat nóʾaṭ	
ڤاچاينا|vāžāyna|ڤاچاينات	<i>noun</i><br><ol><li>vagina</li></ol>
کام|kām	<i>adv</i><br><ol><li>how much, how many</li></ol>
