Алгамасторт|Algamastort	<i>name</i><br><ol><li>the Netherlands</li></ol>
Блаушка|Blauška	<i>name</i><br><ol><li>(religion) Feast of the Annunciation</li></ol>
ВР|VR	<i>noun</i><br><ol><li>UN (United Nations)</li></ol>
Инечи|Ineči	<i>noun</i><br><ol><li>Easter</li></ol>
Колмоце инязорпазксчи|Kolmoce injazorpazksči	<i>name</i><br><ol><li>Third Reich</li></ol>
Кранцмастор|Krancmastor	<i>name</i><br><ol><li>France</li></ol>
Кри.|Kri.	<i>adv</i><br><ol><li>B.C., BC (abbreviation for Кристозонь икеле, before Christ)</li></ol>
Крм.|Krm.	<i>adv</i><br><ol><li>A.D., AD (abbreviation for Кристозодо мейле, anno Domini)</li></ol>
Куловне|Kulovne	<i>name</i><br><ol><li>Cinderella (the fairy tale and the protagonist)</li></ol>
Курсякст|Kursjakst	<i>noun</i><br><ol><li>(astronomy): Libra.</li><li>(astrology): Libra.</li></ol>
Ловняське|Lovnäśke	<i>name</i><br><ol><li>Snow White</li></ol>
Папазей|Papazej|Папазейс|Папазейсэ|Папазейстэ|Папазейга|Папазейкс|Папазейнень|Папазейде|Папазейшка|Папазеень|Папазейтеме	<i>noun</i><br><ol><li>(in magic incantations) ruler of the penis</li></ol>
Пелькине|Pelʹkine	<i>name</i><br><ol><li>Tom Thumb</li></ol>
Пурцуз Пукшай|Purcuz Pukšaj	<i>name</i><br><ol><li>Porky Pig</li></ol>
Эстэнь Мастор|Estenʹ Mastor	<i>name</i><br><ol><li>Estonia</li></ol>
Якстере Кепече|Äkstere Kepeče	<i>name</i><br><ol><li>Little Red Riding Hood</li></ol>
Яку Яксярго|Jaku Jaksjargo	<i>name</i><br><ol><li>Donald Duck</li></ol>
Якшаматя|Äkšamatä	<i>name</i><br><ol><li>Father Frost, Ded Moroz, Santa Claus</li></ol>
ава|авашка|ават|авас|авадо|ava|авасо|авань|авакс|ававтомо|аванень|авава|авасто	<i>noun</i><br><ol><li>woman</li><li>mother</li></ol>
ававт|avavt	<i>noun</i><br><ol><li>mother-in-law (husband's mother)</li></ol>
аволдавомс|avoldavoms	<i>verb</i><br><ol><li>to be swept</li></ol>
аволдавтомс|avoldavtoms	<i>verb</i><br><ol><li>wave</li><li>sweep, besom</li><li>strike at</li><li>nod</li><li>grab</li><li>overdo</li></ol>
аволдакшномс|avoldakšnoms	<i>verb</i><br><ol><li>to wave</li><li>to besom, to sweep</li><li>to strike at</li><li>to nod</li><li>to grab</li><li>to overdo</li></ol>
аволдамс|avoldams	<i>verb</i><br><ol><li>to wave</li><li>to besom, to sweep</li><li>to strike at</li><li>to nod</li><li>to grab</li><li>to overdo</li></ol>
аволямс|avoljams	<i>verb</i><br><ol><li>to wave</li><li>to besom, to sweep</li><li>to strike at</li><li>to nod</li><li>to grab</li><li>to overdo</li></ol>
автемс|avtems	<i>verb</i><br><ol><li>to open</li></ol>
аель|aeľ	<i>noun</i><br><ol><li>girth, cinch</li></ol>
азор|azor	<i>noun</i><br><ol><li>master, owner</li></ol>
айгор|ajgor	<i>noun</i><br><ol><li>stallion</li></ol>
ал|al	<i>noun</i><br><ol><li>egg</li></ol>
ал ашо|al ašo	<i>noun</i><br><ol><li>egg white</li></ol>
алаша|alaša	<i>noun</i><br><ol><li>horse</li><li>gelding, hoss</li></ol>
ало|alo	<i>adj</i><br><ol><li>lower</li></ol>
аловбандт|alovbandt	<i>adv</i><br><ol><li>downhill,</li><li>on the wane, on the decrease</li></ol>
алойшть|alojštʹ	<i>adv</i><br><ol><li>very, extremely, highly</li></ol>
алтыма|altyma	<i>noun</i><br><ol><li>net, fishnet</li></ol>
алтюжа|altüža	<i>noun</i><br><ol><li>egg yolk</li></ol>
андомс|andoms	<i>verb</i><br><ol><li>feed</li></ol>
анок|anok	<i>adj</i><br><ol><li>ready</li></ol>
аравтыця|aravtycja	<i>noun</i><br><ol><li>film director</li></ol>
арво|arvo	<i>noun</i><br><ol><li>non-fermented mead, water with honey</li><li>nectar</li></ol><br><i>adj</i><br><ol><li>clean, pure</li></ol>
аргумне|argumne	<i>noun</i><br><ol><li>raven</li><li>Pegasus, winged horse (in Erzya mythology)</li></ol>
аржо|aržo	<i>noun</i><br><ol><li>black woodpecker</li></ol>
арсемапель|arsemapeľ	<i>noun</i><br><ol><li>(computing) computer</li></ol>
арт	<i>noun</i><br><ol><li>pattern, design, tracery</li><li>picture</li><li>image</li><li>photograph, photo</li></ol>
атя|atja	<i>noun</i><br><ol><li>elder, old man</li><li>husband</li></ol>
атявт|atjavt	<i>noun</i><br><ol><li>father-in-law (husband's father)</li></ol>
атякш|atjakš	<i>noun</i><br><ol><li>rooster, cock</li></ol>
атякшбуло|atjakšbulo	<i>noun</i><br><ol><li>cocktail</li></ol>
атярозь|atjarozʹ	<i>noun</i><br><ol><li>ergot</li></ol>
атятеште|atjatešte	<i>noun</i><br><ol><li>hellebore</li></ol>
ацерь|acerʹ	<i>noun</i><br><ol><li>(anatomy) A nerve.</li></ol>
ацерьке|acerʹke	<i>noun</i><br><ol><li>(anatomy) A neuron.</li></ol>
ашкал|aškal	<i>noun</i><br><ol><li>(zoology) European sturgeon, beluga</li></ol>
ашо|ašo	<i>adj</i><br><ol><li>white</li></ol><br><i>noun</i><br><ol><li>white, whiteness</li><li>ruble</li></ol>
ашука|ашукань|ашукасо|ашукавтомо|ашукава|ашукас|ашукакс|ашукашка|ашукасто|ашукат|ашукадо|ашуканень|ašuka	<i>noun</i><br><ol><li>porcelain, china</li></ol>
бала|bala	<i>noun</i><br><ol><li>bachelor (unmarried man)</li></ol>
баря|barä	<i>noun</i><br><ol><li>(children) sheep</li></ol>
бачка|bačka	<i>noun</i><br><ol><li>(religion) (Orthodox Christian) priest</li></ol>
башкань|baškaň	<i>adj</i><br><ol><li>special</li></ol>
белой|beloj	<i>noun</i><br><ol><li>pantry</li></ol>
булдыгай|buldygaj	<i>noun</i><br><ol><li>eagle-owl</li></ol>
вадов|vadov	<i>noun</i><br><ol><li>hawk</li></ol>
вазь|vazʹ	<i>noun</i><br><ol><li>headwear</li><li>cap</li></ol>
ваксар|vaksar|ваксарке|vaksarke	<i>noun</i><br><ol><li>shield</li></ol>
ваксарке|vaksarke	<i>noun</i><br><ol><li>(zoology) clypeus, scute, mail</li><li>(botany) cyme, corymb</li><li>(engineering) dashboard</li><li>(sports) guard</li><li>(automobiles) visor, mudguard, splash guard</li></ol>
ваксарчамо|vaksarčamo	<i>noun</i><br><ol><li>armor</li></ol>
вал|val	<i>noun</i><br><ol><li>word</li></ol>
валбрамо|valbramo	<i>noun</i><br><ol><li>grammatical case</li></ol>
валвакс|valvaks	<i>noun</i><br><ol><li>adverb</li></ol>
валвелявкс|valveljavks	<i>noun</i><br><ol><li>allegory</li></ol>
валдарт|valdart	<i>noun</i><br><ol><li>photograph, photo</li></ol>
валдартомапель|valdartomapelʹ	<i>noun</i><br><ol><li>camera</li></ol>
валкс|valks	<i>noun</i><br><ol><li>dictionary</li><li>stretched and dried skin</li><li>ruble</li></ol>
валмельгакс|valmelʹgaks	<i>noun</i><br><ol><li>postposition</li></ol>
валыкелькс|valykeľks	<i>noun</i><br><ol><li>foreword</li></ol>
вана|vana	<i>particle</i><br><ol><li>here (is), this (is)</li><li>there</li></ol><br><i>intj</i><br><ol><li>here, look (at it)</li><li>take it! (when offering something, casual)</li></ol>
варака|varaka	<i>noun</i><br><ol><li>crow</li></ol>
варамс|вары|varams|варась	<i>verb</i><br><ol><li>To swear, take an oath, vow.</li></ol>
варма|varma	<i>noun</i><br><ol><li>wind</li></ol>
вармазей|varmazej	<i>noun</i><br><ol><li>red-footed falcon (Falco vespertinus)</li></ol>
васоньбеельть|vasonʹbejelʹtʹ	<i>noun</i><br><ol><li>scissors</li></ol>
васоньгоморо|vasonʹgomoro	<i>noun</i><br><ol><li>cupped hand, handful</li></ol>
васта|vasta	<i>noun</i><br><ol><li>spouse, one's husband or wife</li></ol>
вастаньчи|vastanʹči	<i>noun</i><br><ol><li>Tuesday</li></ol>
вастомазонок|vastomazonok	<i>intj</i><br><ol><li>goodbye</li></ol>
вата|vata	<i>noun</i><br><ol><li>father-in-law (wife's father)</li></ol>
вашо|vašo	<i>noun</i><br><ol><li>foal</li></ol>
ваямс|vajams	<i>verb</i><br><ol><li>sink, drown</li><li>disappear</li></ol>
ве|вес|ve|векс|весэ|вева|вевтеме|вестэ|веть|вешка|веде|венень|вень	<i>noun</i><br><ol><li>night</li></ol>
вединзей|vedinzej	<i>noun</i><br><ol><li>blackberry, brambleberry</li></ol>
ведь|веднень|ведде|věď|ведьс|ведьстэ|ведтеме|ведьшка|ведьсэ|ведьга|ведькс|ведть|ведень	<i>noun</i><br><ol><li>water</li></ol>
ведьбача|veďbača	<i>noun</i><br><ol><li>mink</li></ol>
ведьбеште|veďbešte	<i>noun</i><br><ol><li>water caltrop</li><li>rhombus, lozenge, diamond</li></ol>
ведьбов|veďbov	<i>noun</i><br><ol><li>drop</li></ol>
ведьбука|veďbuka	<i>noun</i><br><ol><li>fire-bellied toad</li></ol>
ведьгев|veďgev	<i>noun</i><br><ol><li>mill</li></ol>
вежава|vežava	<i>noun</i><br><ol><li>younger daughter-in-law</li></ol>
веженсь|veženś	<i>adj</i><br><ol><li>younger, youngest, little</li></ol>
вейке|вейкес|вейкешка|вейкесэ|vejke|вейкева|вейкестэ|вейкекс|вейкеде|вейкенень|вейкень|вейкевтеме|вейкеть	<i>num</i><br><ol><li>one</li></ol>
вейксэ|vejksė	<i>num</i><br><ol><li>nine</li></ol>
вельксэс|veľksěs	<i>postp</i><br><ol><li>above</li></ol>
вельмемс|вельми|veľmems|velʹmi|вельмесь	<i>verb</i><br><ol><li>to be resurrected, to return to life, revive</li><li>to perk up, to come alive</li></ol>
венч|venč	<i>noun</i><br><ol><li>boat</li></ol>
верь|верьга|верьшка|верьс|вертеме|верень|верьсэ|верьстэ|верть|верькс|veř|вернень|верде	<i>noun</i><br><ol><li>(body) blood</li></ol>
верьгиз|verʹgiz	<i>noun</i><br><ol><li>wolf</li></ol>
верьгума|verʹguma	<i>noun</i><br><ol><li>flint</li></ol>
вете|vete	<i>num</i><br><ol><li>five</li></ol>
видьгеме|vidʹgeme	<i>noun</i><br><ol><li>Orthodoxy</li></ol>
вирь|вирень|virʹse|virde|вирьсэ|virʹ|вирьшка|вирьс|вирть|virʹga|вирьга|вирькс|вирнень|вирьстэ|virnenʹ|virʹste|virteme|виртеме|вирде	<i>noun</i><br><ol><li>forest</li></ol>
вирьверьгиз|viřveřgiz	<i>noun</i><br><ol><li>eastern wolf, Canis lycaon</li></ol>
виряш|virjaš	<i>noun</i><br><ol><li>sister-in-law (elder brother's wife)</li></ol>
вить|vitʹ	<i>adj</i><br><ol><li>right, opposite of left</li></ol>
гавдан|gavdan	<i>noun</i><br><ol><li>aftergrass, aftermath, eddish, fog grass, regrowth</li></ol>
гайна|gajna	<i>noun</i><br><ol><li>pigsty, pigpen</li><li>pig bed, pig bedding</li></ol>
гуй|гуйсэ|гуйтеме|гуйс|гуйга|гуйшка|гуйкс|гуйть|гуйстэ|гуйнень|гуйде|гуень|guj	<i>noun</i><br><ol><li>snake</li></ol>
дикамо|dikamo	<i>noun</i><br><ol><li>violin, fiddle</li></ol>
дёрть|djortʹ	<i>noun</i><br><ol><li>(anatomy) male genitalia, penis</li></ol>
жаба|žaba	<i>noun</i><br><ol><li>child</li><li>glutton</li></ol>
жабаксчи|žabaksči	<i>noun</i><br><ol><li>childhood</li></ol>
жабарда|žabarda	<i>noun</i><br><ol><li>gluttony</li></ol>
жомка|žоmka	<i>noun</i><br><ol><li>gingerbread</li></ol>
заводкс|zavodks	<i>noun</i><br><ol><li>refrain (in song)</li></ol>
замедь|zameď	<i>noun</i><br><ol><li>fence, hedge</li></ol>
запон|zapon	<i>noun</i><br><ol><li>pinafore, apron</li></ol>
зарка|zarka	<i>noun</i><br><ol><li>cricket ball</li></ol>
здынь|zdyň	<i>noun</i><br><ol><li>picket, stake, pole</li></ol>
зепе|зептнесэ|зептнес|зептнеде|зепеванть|зепесь|зепеденть|зепенть|зептнешка|зепевтементь|зептневтеме|зепсэнть|зептнева|zepe|зептнень|зептнестэ|зепентень|зепешканть|зепстэнть|зептне|зептненень	<i>noun</i><br><ol><li>pocket</li></ol>
злыдарь|zlydař	<i>noun</i><br><ol><li>vagabond, tramp</li></ol>
зобня|zobnä	<i>noun</i><br><ol><li>stomach</li></ol>
зобуня|zobunä	<i>noun</i><br><ol><li>birchbark basket, hanaper</li></ol>
зуйть|zujť	<i>noun</i><br><ol><li>creeps, goosebumps, goosies</li></ol>
зэме|zĕme|singularia tantum	<i>noun</i><br><ol><li>something of prime quality, refined</li><li>skin on the surface of a liquid</li><li>pitch, heart, point (of a question)</li><li>stamina, endurance, fortitude</li></ol>
зэрть|zĕrť	<i>noun</i><br><ol><li>sound, rumble, bellow</li></ol>
зэхель|zĕheľ	<i>noun</i><br><ol><li>breath, waft (of wind)</li><li>calm, peace, repose</li></ol>
игла|igla	<i>noun</i><br><ol><li>bar, hasp, bolt</li></ol>
игриней|igrinej	<i>noun</i><br><ol><li>miser</li></ol>
идемка|idemka	<i>noun</i><br><ol><li>game, wild fowl</li></ol>
идиця|idicä	<i>noun</i><br><ol><li>saviour</li></ol>
ие|ie	<i>noun</i><br><ol><li>year</li></ol>
иза|iza	<i>noun</i><br><ol><li>harrow</li></ol>
изниця|iznicä	<i>noun</i><br><ol><li>winner, champion</li></ol>
икелепелькс|ikelepeľks	<i>noun</i><br><ol><li>front, face, foreside</li><li>future</li></ol>
илей|ilej	<i>noun</i><br><ol><li>osier</li></ol>
илык|илыксэ|илыктэ|илыкс|илыктеме|илыкка|илыкшка|илыкнэнь|илыкстэ|илыкень|ilyk|илыккс	<i>noun</i><br><ol><li>(uncountable) power</li></ol>
индерь|indeř	<i>noun</i><br><ol><li>honeysuckle</li><li>spindle wood</li><li>blackthorn, sloe</li><li>wire in shuttle</li></ol>
ине|ine	<i>adj</i><br><ol><li>great, grand, big</li></ol>
инегуй|ineguj	<i>noun</i><br><ol><li>dragon</li></ol>
иненсь|inenś	<i>adj</i><br><ol><li>elder</li></ol>
инескеть|ineskeť	<i>adv</i><br><ol><li>please</li></ol>
инже|inže	<i>noun</i><br><ol><li>guest</li></ol>
инзамо|inzamo	<i>noun</i><br><ol><li>reproach</li></ol>
инзей|inzej	<i>noun</i><br><ol><li>raspberry</li></ol>
инкс|inks	<i>noun</i><br><ol><li>strickle, adze</li></ol>
инязор|inäzor	<i>noun</i><br><ol><li>king</li></ol>
инязорава|inäzorava	<i>noun</i><br><ol><li>queen</li></ol>
инязорпаз|inäzorpaz	<i>noun</i><br><ol><li>emperor</li></ol>
инязорпазксчи|inäzorpazksči	<i>noun</i><br><ol><li>empire</li></ol>
инятя|inätä	<i>noun</i><br><ol><li>elder, alderman</li></ol>
ирдез|irdez	<i>noun</i><br><ol><li>rib</li><li>frame (nautical)</li></ol>
исень|iseň	<i>adj</i><br><ol><li>yesterday, yesterday's, yester</li><li>outdated, retrograde</li></ol>
итевть|itevť	<i>noun</i><br><ol><li>sheaf (of hemp or flax)</li><li>bundle</li></ol>
ишем|išem	<i>noun</i><br><ol><li>camel</li></ol>
кав|kav	<i>noun</i><br><ol><li>closet, cuddy, boxroom</li><li>(train) compartment</li></ol>
каваз|kavaz	<i>noun</i><br><ol><li>dam, dike</li></ol>
кавал|kaval	<i>noun</i><br><ol><li>kite (vulture)</li></ol>
кавалалкс|kavalalks	<i>noun</i><br><ol><li>armpit</li></ol>
кавксо|kavkso	<i>num</i><br><ol><li>eight</li></ol>
каворынза|kavorynza	<i>noun</i><br><ol><li>brittlegill (a mushroom of genus Russula)</li></ol>
каворь|kavoř	<i>noun</i><br><ol><li>gristle, cartilage</li></ol>
кавто|kavto	<i>num</i><br><ol><li>two</li></ol>
кайга|kajga	<i>noun</i><br><ol><li>zither, chordophone, psaltery, kantele</li></ol>
кайгарш|kajgarš	<i>noun</i><br><ol><li>ground squirrel</li></ol>
кал|kal	<i>noun</i><br><ol><li>fish</li></ol>
каломс|калы|kaloms|калсь	<i>verb</i><br><ol><li>to fish</li></ol>
каркс|karks	<i>noun</i><br><ol><li>belt, girdle</li></ol>
каршовал|karšoval	<i>noun</i><br><ol><li>a reply, written or spoken response, answer</li></ol>
карь|карьстэ|карьга|карнень|карьшка|картеме|карькс|карть|карьс|карьсэ|карень|kař|карде	<i>noun</i><br><ol><li>bast shoe, lapti</li></ol>
касыкс|kasyks	<i>noun</i><br><ol><li>(botany) plant (organism capable of photosynthesis)</li></ol>
катьляс|kaťläs	<i>noun</i><br><ol><li>dwarf, midget, gnome (mythology)</li></ol>
качадомка|kačadomka	<i>noun</i><br><ol><li>perfume</li></ol>
каяш|kajaš	<i>noun</i><br><ol><li>broken beer, deadish beer, vapid beer</li></ol>
кедь|kedʹ	<i>noun</i><br><ol><li>hand, arm</li></ol>
келее|келеень|келеевтеме|келееде|келеесэ|келеева|келеекс|келееть|келеестэ|келеешка|келеенень|келеес|keleje	<i>noun</i><br><ol><li>black grouse</li></ol>
кель|kelʹ	<i>noun</i><br><ol><li>language</li></ol>
кельмевкске|kelʹmevkske	<i>noun</i><br><ol><li>ice cream</li></ol>
кельмой|kelʹmoj	<i>noun</i><br><ol><li>suet</li></ol>
кем|kem	<i>noun</i><br><ol><li>boot</li></ol>
кемень|kemenj	<i>num</i><br><ol><li>ten</li></ol>
кене|kene	<i>noun</i><br><ol><li>quill</li></ol>
кенере|kenere	<i>noun</i><br><ol><li>elbow</li><li>cubit, ell</li></ol>
кенерезь|kenerezʹ	<i>adj</i><br><ol><li>ripe</li></ol>
кенерь|kenerʹ	<i>noun</i><br><ol><li>elbow</li><li>cubit, ell</li></ol>
кенже|kenže	<i>noun</i><br><ol><li>nail</li><li>claw</li><li>hoof</li></ol>
кенкшикелькс|kenkšikeľks	<i>noun</i><br><ol><li>threshold</li></ol>
керша|kerša	<i>noun</i><br><ol><li>club assotiation of members</li></ol>
ки|кистэ|кить|кикс|кинень|кишка|кива|кисэ|кивтеме|ki|кинь|кис|киде	<i>noun</i><br><ol><li>way, road</li></ol>
кивкснав|kivksnav	<i>noun</i><br><ol><li>bullet</li></ol>
кизна|kizna	<i>adv</i><br><ol><li>in summer</li></ol>
кизэ|kize	<i>noun</i><br><ol><li>summer</li><li>year (compare Russian лето)</li></ol>
кизэнек-теленек|kizenek-telenek	<i>adv</i><br><ol><li>summer and winter alike</li></ol>
кизэнь|kizenʹ	<i>adj</i><br><ol><li>of summer</li></ol>
килей|килейкс|килейшка|килейть|килейстэ|килейс|килейга|килеень|килейде|килейнень|килейтеме|килейсэ|kilej	<i>noun</i><br><ol><li>(botany) birch</li></ol>
киньгуловтома|kiňgulovtoma	<i>noun</i><br><ol><li>mothball, insecticide, naphthalene</li></ol>
кире|kire	<i>noun</i><br><ol><li>ball of string</li><li>lump</li></ol>
киска|kiska	<i>noun</i><br><ol><li>dog</li></ol>
кича|kiča|кичас|кичасто|кичашка|кичанень|кичавтомо|кичасо|кичава|кичат|кичань|кичадо|кичакс	<i>noun</i><br><ol><li>siskin</li></ol>
кияло|kijalo	<i>noun</i><br><ol><li>sister-in-law</li></ol>
ков|ковтомо|kov|ковсто|ковшка|ковдо|ковга|ковнэнь|ковкс|ковс|ковонь|ковсо|ковт	<i>noun</i><br><ol><li>moon</li><li>month</li></ol><br><i>adv</i><br><ol><li>where</li></ol>
ковкерькс|kovkeřks	<i>noun</i><br><ol><li>calendar</li></ol>
ковставкс|kovstavks	<i>noun</i><br><ol><li>magazine</li></ol>
кой|koj	<i>noun</i><br><ol><li>law</li><li>tradition, custom</li></ol><br><i>particle</i><br><ol><li>As part of compound particles:</li></ol>
колмо|колмот|колмонть|колмонь|колмотневтеме|колмованть|колмошка|колмотнень|колмостонть|колмотнес|колмосто|kolmo|колмось|колмотнестэ|колмошканть|колмотнешка|колмос|колмовтомо|колмодонть|колмовтомонть|колмонтень|колмотнева|колмова|колмонень|колмотнесэ|колмосонть|колмосо|колмодо|колмотне|колмокс|колмотнеде|колмотненень	<i>num</i><br><ol><li>three</li></ol>
комсь|komsʹ	<i>num</i><br><ol><li>twenty</li></ol>
конёв|konjov	<i>noun</i><br><ol><li>paper</li><li>document</li></ol>
конёвкс|konövks	<i>noun</i><br><ol><li>book</li></ol>
корш|korš	<i>noun</i><br><ol><li>owl</li></ol>
кота|котадо|котанень|котасо|kota|котава|котань|котавтомо|коташка|котат|котакс|котас|котасто	<i>noun</i><br><ol><li>shoe</li></ol>
коткудав|kotkudav	<i>noun</i><br><ol><li>ant</li></ol>
коткудавкудо|kotkudavkudo	<i>noun</i><br><ol><li>anthill</li></ol>
коткудавпизэ|kotkudavpize	<i>noun</i><br><ol><li>anthill</li></ol>
кото|koto	<i>num</i><br><ol><li>six</li></ol>
котян|kotän	<i>noun</i><br><ol><li>rectum</li><li>gammon</li></ol>
кохви|kohvi	<i>noun</i><br><ol><li>coffee</li></ol>
кочкиця|kočkicä	<i>noun</i><br><ol><li>voter, elector</li><li>weeder, vintager, picker</li></ol>
кочкодык|kočkodyk	<i>noun</i><br><ol><li>quail</li></ol>
кош|koš	<i>noun</i><br><ol><li>hovel, hut, cot</li></ol>
кошт|košt	<i>noun</i><br><ol><li>air</li><li>climate</li></ol>
кренч|krenč	<i>noun</i><br><ol><li>raven</li></ol>
кстый|kstyj	<i>noun</i><br><ol><li>wild strawberry, wood strawberry</li></ol>
кудо|kudo	<i>noun</i><br><ol><li>house (building)</li><li>home (dwelling)</li></ol>
кудораське|kudoraśke	<i>noun</i><br><ol><li>family</li></ol>
куко|kuko	<i>noun</i><br><ol><li>cuckoo</li></ol>
кулов|kulov	<i>noun</i><br><ol><li>ash, solid residue from burning</li></ol>
куломс|kuloms|кулось|кулы	<i>verb</i><br><ol><li>to die</li></ol>
кулсемс|кулси|кулсесь|kulsems	<i>verb</i><br><ol><li>to be epileptic</li></ol>
култаемс|култаи|kultaems|култаесь	<i>verb</i><br><ol><li>to limp, be lame</li></ol>
кумба|kumba	<i>noun</i><br><ol><li>carpet.</li></ol>
кумбава|kumbava	<i>noun</i><br><ol><li>water nymph</li></ol>
кумбо|kumbo	<i>noun</i><br><ol><li>wave.</li></ol>
курда|курдасто|курдашка|курдатнес|курдатнень|курдавтомонть|курдас|курданень|курдавтомо|курдадонть|курдакс|курдатнесэ|курдастонть|курдасо|курдатнешка|курдатневтеме|курдат|курдантень|курдаванть|kurda|курдатне|курдатнестэ|курдашканть|курдась|курдатнева|курдасонть|курданть|курдатнеде|курдадо|курдава|курдань|курдатненень	<i>noun</i><br><ol><li>(zoology) crucian carp</li></ol>
курмуш|kurmuš	<i>noun</i><br><ol><li>city block, neighborhood</li></ol>
куцькан|kućkan	<i>noun</i><br><ol><li>eagle</li></ol>
кши|кшистэ|кшис|кшикс|кшиде|кшисэ|кшишка|kši|кшивтеме|кшинень|кшива|кшить|кшинь	<i>noun</i><br><ol><li>bread</li></ol>
кшна|кшнат|кшнас|кшнасто|кшнань|кшнакс|кшнасо|кшнашка|кшнавтомо|кшнанень|кшнава|кшнадо|kšna	<i>noun</i><br><ol><li>leather belt</li></ol>
кшни|кшнис|кшнива|kšni|кшникс|кшнить|кшниде|кшнинь|кшнистэ|кшнисэ|кшнишка|кшнинень|кшнивтеме	<i>noun</i><br><ol><li>iron</li></ol>
кшумань|kšumaň	<i>noun</i><br><ol><li>radish</li></ol>
кёльнаведь|köľnaveď	<i>noun</i><br><ol><li>cologne, eau de Cologne</li></ol>
ламбамо|lambamo	<i>adj</i><br><ol><li>sweet</li></ol>
леля|lelja	<i>noun</i><br><ol><li>elder brother</li><li>uncle</li></ol>
лем|lem	<i>noun</i><br><ol><li>name</li></ol>
лембеёнксонь|lembejonksonʹ	<i>adj</i><br><ol><li>southern</li></ol>
лемвал|lemval	<i>noun</i><br><ol><li>noun</li></ol>
лепе|lepe	<i>noun</i><br><ol><li>alder tree</li></ol>
ливтяка|livtjaka	<i>noun</i><br><ol><li>airplane</li></ol>
ликша|likša	<i>noun</i><br><ol><li>(uncountable) buckwheat</li></ol>
лисьмапря|liśmaprä	<i>noun</i><br><ol><li>spring (of water)</li></ol>
лишме|lišme	<i>noun</i><br><ol><li>horse</li></ol>
лов|lov	<i>noun</i><br><ol><li>snow</li></ol>
ловсо|lovso	<i>noun</i><br><ol><li>milk</li></ol>
локсей|loksej	<i>noun</i><br><ol><li>swan</li></ol>
лёмзёркс|ljomzjorks	<i>noun</i><br><ol><li>bird cherry (also called hagberry, hackberry), a cherry tree native to northern Eurasia.</li></ol>
максо|makso	<i>noun</i><br><ol><li>liver anatomy; food</li></ol>
мастор|mastor	<i>noun</i><br><ol><li>land</li><li>country, state</li><li>countryside</li></ol>
мевть|mevtʹ	<i>noun</i><br><ol><li>sail</li></ol>
мевтямс|mevtjams	<i>noun</i><br><ol><li>to sail</li></ol>
медь|medʹ	<i>noun</i><br><ol><li>honey</li></ol>
мекш|mekš	<i>noun</i><br><ol><li>bee</li></ol>
менге|menge	<i>noun</i><br><ol><li>medicine, drug</li></ol>
менель|meneľ	<i>noun</i><br><ol><li>sky</li></ol>
менельгев|meneľgev	<i>noun</i><br><ol><li>meteorite</li></ol>
ментюк|mentük	<i>noun</i><br><ol><li>(zoology) burbot</li></ol>
метьказ|metʹkaz	<i>noun</i><br><ol><li>lizard</li></ol>
миле|mile	<i>noun</i><br><ol><li>oar</li></ol>
миледиця|miledicä	<i>noun</i><br><ol><li>oarsman</li></ol>
минь|minʹ	<i>pron</i><br><ol><li>(first person plural) we</li></ol>
мирде|mirde	<i>noun</i><br><ol><li>husband</li></ol>
мода|moda	<i>noun</i><br><ol><li>soil</li></ol>
модаре|modare	<i>noun</i><br><ol><li>serf</li></ol>
мон|mon	<i>pron</i><br><ol><li>(first person singular personal pronoun) I</li></ol>
морокерькс|morokerʹks	<i>noun</i><br><ol><li>epic</li></ol>
муниця|муницякс|municä|муницясо|муницядо|муницянь|муницясто|муницят|муницяшка|муницявтомо|муницяс|муницява|муницянень	<i>noun</i><br><ol><li>wizard</li></ol>
муё|mujo	<i>noun</i><br><ol><li>moustache, whisker</li></ol>
нама|nama	<i>adv</i><br><ol><li>sure, surely, of course, really</li></ol>
нар|nar	<i>noun</i><br><ol><li>weed, grass</li><li>meadow</li></ol>
нарамгудо|naramgudo	<i>noun</i><br><ol><li>barbershop</li></ol>
нарамо|naramo	<i>noun</i><br><ol><li>shaving</li><li>shearing</li></ol>
наргедь|nargeď	<i>noun</i><br><ol><li>turf, sod</li></ol>
наркодевемс|narkodevems	<i>verb</i><br><ol><li>to be haunted</li></ol>
наркодемс|narkodems	<i>verb</i><br><ol><li>to haunt</li></ol>
наркоть|narkotʹ	<i>noun</i><br><ol><li>delusion of persecution</li></ol>
нармунь|narmunʹ	<i>noun</i><br><ol><li>bird</li></ol>
нартнемка|nartnemka	<i>noun</i><br><ol><li>eraser</li></ol>
недь|neď	<i>noun</i><br><ol><li>handle, helve, shaft</li></ol>
нейдь|nejdʹ	<i>noun</i><br><ol><li>miss</li></ol>
ни|ni	<i>noun</i><br><ol><li>wife</li></ol>
низаня|nizanä	<i>noun</i><br><ol><li>mother-in-law (wife's mother)</li></ol>
ниле|nile	<i>num</i><br><ol><li>four</li></ol>
нимиляв|nimiläv	<i>noun</i><br><ol><li>butterfly</li></ol>
нов|nov	<i>noun</i><br><ol><li>advice</li></ol>
норовжорч|norovžorč	<i>noun</i><br><ol><li>lark</li></ol>
нупаль|nupalʹ	<i>noun</i><br><ol><li>room</li></ol>
нупонь|nupoň	<i>noun</i><br><ol><li>moss</li></ol>
нуртямопель|nurtämopeľ	<i>noun</i><br><ol><li>liquid</li></ol>
нусма|nusma	<i>noun</i><br><ol><li>sadness, grief, sorrow</li></ol>
нусманя|nusmanja	<i>adj</i><br><ol><li>sad</li></ol>
нучко|нучктнес|нучктнень|нучктнева|нучкошканть|нучктне|нучктнестэ|нучконтень|нучкось|нучкодонть|нучкованть|нучктневтеме|нучктнеде|нучктнесэ|нучконть|нучктнешка|нучковтомонть|нучктненень|нучкстонть|нучксонть|nučko	<i>noun</i><br><ol><li>(zoology) pike</li></ol>
овто|ovto	<i>noun</i><br><ol><li>bear</li></ol>
огай|ogaj	<i>noun</i><br><ol><li>echo</li></ol>
од|od	<i>adj</i><br><ol><li>new</li></ol>
одирьва|odiřva	<i>noun</i><br><ol><li>bride</li><li>daughter-in-law</li><li>young woman</li></ol>
одра|odra	<i>noun</i><br><ol><li>shroud</li></ol>
ожа|oža	<i>noun</i><br><ol><li>sleeve</li></ol>
ожня|ožnja	<i>noun</i><br><ol><li>amber</li></ol>
ожо|ožo	<i>adj</i><br><ol><li>yellow</li></ol><br><i>noun</i><br><ol><li>jaundice</li></ol>
ожопуло|ožopulo	<i>noun</i><br><ol><li>oriole</li></ol>
озамс|ozams	<i>verb</i><br><ol><li>sit</li></ol>
озатя|ozatja	<i>noun</i><br><ol><li>priest</li><li>(Erzya folk religion) a pagan priest</li></ol>
озяз|ozjaz	<i>noun</i><br><ol><li>sparrow</li></ol>
ой|oj	<i>noun</i><br><ol><li>oil</li><li>butter</li></ol>
олговедь|olgoveď	<i>noun</i><br><ol><li>beer</li></ol>
орма|orma	<i>noun</i><br><ol><li>disease</li></ol>
оска|oska	<i>noun</i><br><ol><li>ball</li></ol>
отраз|otraz	<i>noun</i><br><ol><li>bun, scone</li></ol>
очко|očko	<i>noun</i><br><ol><li>tub, trough</li></ol>
ош|ошга|ошс|ошонь|oš|ошдо|ошт|оштомо|ошнэнь|ошсо|ошсто|ошшка|ошкс	<i>noun</i><br><ol><li>town</li></ol>
пад|pad	<i>noun</i><br><ol><li>(anatomy) vagina</li></ol>
падо|pado	<i>noun</i><br><ol><li>wall</li></ol>
пазморо|pazmoro	<i>noun</i><br><ol><li>psalm</li><li>hymn</li></ol>
пазуре|pazure	<i>noun</i><br><ol><li>angel</li></ol>
пакся|паксяшканть|паксясованть|паксякс|паксявтомо|паксява|паксяшка|паксявтомотнесэ|паксявтомотнева|паксят|паксявтомошканть|паксясонтень|паксясотнеде|паксятнеде|паксясось|паксясосонть|паксятнешка|паксявтомонтень|паксятнева|паксявтомотнеде|паксясотневтеме|паксявтомотневтеме|паксявтомованть|паксясостонть|паксятневтеме|паксявтомотнень|паксясотнес|паксядо|паксясотнешка|паксясовтомонть|паксянтень|паксятнень|paksjavtomo|паксясотнесэ|паксясонть|паксятнестэ|паксяс|паксятне|paksja|паксясотне|паксявтомостонть|паксявтомось|паксявтомотнес|паксянь|паксявтомонть|паксянень|паксятнес|паксясотнень|паксявтомодонть|паксявтомотне|паксясотненень|паксявтомотнешка|паксядонть|паксянть|паксятнесэ|паксявтомовтомонть|паксясошканть|паксясо|паксявтомотненень|паксясто|paksjaso|паксясотнева|паксятненень|паксясодонть|паксястонть|паксявтомотнестэ|паксявтомосонть|паксяванть|паксясь|паксясотнестэ	<i>noun</i><br><ol><li>field</li></ol>
пал|pal	<i>noun</i><br><ol><li>bit</li></ol>
паломс|paloms	<i>verb</i><br><ol><li>burn</li></ol>
панар|panar	<i>noun</i><br><ol><li>shirt</li></ol>
панжиков|panžikov	<i>noun</i><br><ol><li>May (fifth month of the year)</li></ol>
паникудо|panikudo	<i>noun</i><br><ol><li>kitchen</li></ol>
папа|папастонть|папатнешка|папавтомонть|пападо|папашка|папатнес|папатневтеме|папатнестэ|папавтомо|папасто|папанть|папат|папасонть|papa|папакс|пападонть|папатненень|папасо|папанень|папась|папатнень|папас|папатнева|папань|папатне|папаванть|папава|папантень|папашканть|папатнеде|папатнесэ	<i>noun</i><br><ol><li>(anatomy) penis</li></ol>
парнэ|parne	<i>noun</i><br><ol><li>foal</li></ol>
паскомс|паски|пасксь|paskoms	<i>verb</i><br><ol><li>to copulate</li></ol>
пе|pe	<i>noun</i><br><ol><li>head</li></ol>
пезэмапель|pezěmapeľ	<i>noun</i><br><ol><li>shampoo</li></ol>
пей|пейтеме|пейкс|пейсэ|пейнень|pej|пейде|пеень|пейстэ|пейшка|пейть|пейс|пейга	<i>noun</i><br><ol><li>tooth</li></ol>
пейвадема|pejvadema	<i>noun</i><br><ol><li>toothpaste</li></ol>
пейзывель|pejzyveľ	<i>noun</i><br><ol><li>gum (soft tissue around the teeth)</li></ol>
пейзэме|pejzěme	<i>noun</i><br><ol><li>toothbrush</li></ol>
пейнурдо|pejnurdo	<i>noun</i><br><ol><li>jaw</li></ol>
пеке|peke	<i>noun</i><br><ol><li>stomach</li></ol>
пекев|pekev	<i>adj</i><br><ol><li>pregnant</li></ol>
пенге|penge	<i>noun</i><br><ol><li>billet, log, chock (of wood), wood block (for use as firewood)</li><li>log-shaped cake, e.g. a Yule log</li></ol>
пенч|пенчень|пенчкс|пенчнень|pěnč|пенчтеме|пенчстэ|пенчсэ|пенчшка|пенчде|пенчга|пенчть|пенчс	<i>noun</i><br><ol><li>spoon</li></ol>
переусь|pereuś	<i>noun</i><br><ol><li>ground squirrel</li></ol>
пеште|пештева|пештес|pešte|пештеть|пештень|пештестэ|пештевтеме|пештеде|пештенень|пештесэ|пештешка|пештекс	<i>noun</i><br><ol><li>nut, hazelnut</li></ol>
пивтембарь|pivtembař	<i>noun</i><br><ol><li>butter churn</li></ol>
пиже|пижесэ|пижеде|пижекс|пижень|пиженень|пижешка|piže|пижеть|пижева|пижестэ|пижес|пижевтеме	<i>noun</i><br><ol><li>(chemistry) copper</li></ol><br><i>adj</i><br><ol><li>green</li></ol>
пиземе|pizeme	<i>noun</i><br><ol><li>rain</li></ol>
пиземечирьке|pizemečirʹke	<i>noun</i><br><ol><li>(meteorology) rainbow</li></ol>
пизьгата|pizʹgata	<i>noun</i><br><ol><li>swift, swallow</li></ol>
пизэ|pize	<i>noun</i><br><ol><li>nest</li></ol>
пизэке|pizeke	<i>noun</i><br><ol><li>(pathology) growth (mass of cells affected by a disease)</li><li>(microbiology) colony (of bacteria e.g. in a Petri dish)</li><li>(military) nest (as in: machine gun nest)</li><li>hot spot (center of dangerous activity, normally used with a modifier to specify the kind of danger)</li></ol>
пизяз|pizjaz	<i>noun</i><br><ol><li>titmouse</li></ol>
пил|pil	<i>noun</i><br><ol><li>elephant</li></ol>
пиле|pile	<i>noun</i><br><ol><li>(anatomy) ear</li></ol>
пилекс|pileks	<i>noun</i><br><ol><li>earring</li></ol>
пильге|пильгешка|пильгестэ|pilʹge|пильгеде|пильгень|пильгевтеме|пильгеть|пильгесэ|пильгева|pilʹgevteme|pilʹgenʹ|пильгенень|пильгес|пильгекс	<i>noun</i><br><ol><li>(anatomy) leg</li><li>foot</li></ol>
пинге|пингес|пингень|пингевтеме|пингенень|пингешка|пингеде|пингесэ|пингекс|пингеть|pinge|пингева|пингестэ	<i>noun</i><br><ol><li>age, epoch</li><li>century</li></ol>
пине|pine	<i>noun</i><br><ol><li>dog</li></ol>
пире|пирес|пиревтеме|пирень|пиресэ|пирекс|пирестэ|пиреде|пирева|пирешка|пиренень|pire|пиреть	<i>noun</i><br><ol><li>garden</li></ol>
пиря|pirja	<i>noun</i><br><ol><li>wall</li></ol>
письмар|pisʹmar	<i>noun</i><br><ol><li>starling</li></ol>
питере|pitere	<i>noun</i><br><ol><li>corncrake</li></ol>
пиче|piče|пичеть	<i>noun</i><br><ol><li>pine</li><li>kidney</li></ol>
пичемарь|пичемарнень|пичемарде|пичемарень|пичемарьс|пичемарьга|пичемартеме|пичемарьсэ|пичемарьстэ|pičemarʹ|пичемарть|пичемарькс|пичемарьшка	<i>noun</i><br><ol><li>(fruit) pineapple</li></ol>
повамс|povams	<i>verb</i><br><ol><li>strangle</li></ol>
пово|povo	<i>noun</i><br><ol><li>partridge, grouse</li></ol>
поза|poza	<i>noun</i><br><ol><li>kvass, boza</li></ol>
пой|poj	<i>noun</i><br><ol><li>aspen, asp tree</li></ol>
покшолма|pokšolma	<i>noun</i><br><ol><li>command, direction</li><li>authorities</li><li>(colloquial) chief, head, boss</li></ol>
поназ|ponaz	<i>noun</i><br><ol><li>(archaic) honey</li></ol>
понкст|ponkst	<i>noun</i><br><ol><li>pants, trousers</li></ol>
потявтомс|potjavtoms|потявтсь|потявты	<i>verb</i><br><ol><li>to milk</li><li>to breastfeed</li></ol>
почо|počo	<i>noun</i><br><ol><li>(anatomy) navel</li><li>pole (as in South Pole)</li><li>pivot</li><li>head, e.g. in propeller head (central part of propeller)</li><li>(in compounds) polar</li></ol>
промкс|promks	<i>noun</i><br><ol><li>meeting, gathering, conference</li></ol>
пря|прятнесэ|пряванть|пряс|прясонть|пряшканть|прявтомонть|прятнева|prja|прясо|пряшка|prjaks|прят|прянть|прястонть|прянтень|прядонть|прятнень|прятневтеме|прядо|прятненень|прясь|прякс|прятнеде|прянь|прятнешка|прянень|прятне|прявтомо|прява|прятнес|прясто|прятнестэ	<i>noun</i><br><ol><li>head (in many senses)</li><li>top, peak</li><li>tip, point</li><li>bulb, clove</li><li>roof</li><li>toebox</li><li>ear</li></ol>
прявт|prjavt	<i>noun</i><br><ol><li>president</li><li>chief</li><li>head</li><li>leader</li><li>commander</li><li>boss, manager</li></ol>
прякс|prjaks	<i>noun</i><br><ol><li>top, peak</li><li>roof</li></ol>
псака|psaka	<i>noun</i><br><ol><li>cat</li></ol>
пувоз|puvoz	<i>noun</i><br><ol><li>swarm</li></ol>
пукшо|pukšo	<i>noun</i><br><ol><li>buttocks</li><li>rump</li></ol>
пулакш|pulakš	<i>noun</i><br><ol><li>nape, occiput</li></ol>
пуня|punja	<i>noun</i><br><ol><li>hazel hen, hazel grouse</li></ol>
пуре|pure	<i>noun</i><br><ol><li>mead, honey wine</li></ol>
пуро|puro	<i>noun</i><br><ol><li>herd</li><li>flock, muster, kettle, swarm, school, pod, gam, cast</li><li>group, cluster</li><li>(astronomy) cluster</li></ol>
пустачей|pustačej	<i>noun</i><br><ol><li>yellowhammer</li></ol>
пучо|pučo	<i>noun</i><br><ol><li>reindeer</li></ol>
пуярмо|puärmo	<i>noun</i><br><ol><li>stomach of poultry</li></ol>
пшти|pšti	<i>adj</i><br><ol><li>sharp</li></ol>
ракша|rakša	<i>noun</i><br><ol><li>animal</li></ol>
раужо|raužo	<i>adj</i><br><ol><li>black</li></ol>
реве|reve	<i>noun</i><br><ol><li>sheep</li></ol>
ривезь|ривезекс|ривезень|ривезес|ривезьстэ|ривезьшка|ривезтеме|ривезть|riveź|ривезьсэ|ривезнень|ривезьга|ривезде	<i>noun</i><br><ol><li>fox</li></ol>
сакало|sakalo	<i>noun</i><br><ol><li>beard</li></ol>
саламс|salams	<i>verb</i><br><ol><li>abduct</li></ol>
сан|санга|санс|сандо|сант|san|сансо|саншка|санкс|саннэнь|сантомо|сансто|санонь	<i>noun</i><br><ol><li>(anatomy) tendon, sinew</li><li>(dialectal, anatomy) penis</li></ol>
сараз|saraz	<i>noun</i><br><ol><li>hen</li></ol>
седей|sedej	<i>noun</i><br><ol><li>heart</li><li>middle</li></ol>
сезьган|sezʹgan	<i>noun</i><br><ol><li>magpie</li></ol>
сельме|сельмевтементь|сельмесь|сельмсэнть|сельмтневтеме|сельмтнесэ|сельмтнень|сельмеденть|сельмешканть|сельмтнестэ|сельмстэнть|сельмтненень|сельменть|selʹme|сельмтнес|сельмеванть|сельментень|сельмтнева|сельмтнеде|сельмтне|сельмтнешка	<i>noun</i><br><ol><li>(anatomy) eye</li></ol>
сельмукшт|selʹmukšt	<i>noun</i><br><ol><li>glasses, eyeglasses, spectacles</li></ol>
сенксь|senksʹ	<i>noun</i><br><ol><li>heron, grey heron</li></ol>
серькай|serʹkaj	<i>noun</i><br><ol><li>devil</li></ol>
сея|seja	<i>noun</i><br><ol><li>goat (especially she-goat)</li></ol>
сирть|sirtʹ	<i>noun</i><br><ol><li>ash (ash tree)</li></ol>
сисем|śiśem	<i>num</i><br><ol><li>seven</li></ol>
сия|сиява|сияшка|сиянень|сиянь|сиядо|сият|сиясто|сиякс|siä|сиявтомо|сияс|сиясо	<i>noun</i><br><ol><li>silver</li></ol>
скал|skal	<i>noun</i><br><ol><li>cow</li></ol>
скирипкай|skiripkaj	<i>noun</i><br><ol><li>wagtail</li></ol>
содамкундо|sodamkundo	<i>noun</i><br><ol><li>encyclopedia</li></ol>
содамс|sodams	<i>verb</i><br><ol><li>know, understand</li></ol>
содомс|sodoms	<i>verb</i><br><ol><li>tie up</li><li>hang</li></ol>
сокс|соксс|сокскс|сокст|соксонь|соксга|soks|сокстомо|сокссо|соксдо|соксшка|сокссто|сокснэнь	<i>noun</i><br><ol><li>ski</li></ol>
сон|son	<i>pron</i><br><ol><li>he, she, it (third-person singular)</li></ol>
стакачи|stakači	<i>noun</i><br><ol><li>obstacle, problem, trouble</li></ol>
сталмо|stalmo	<i>noun</i><br><ol><li>weight</li><li>heaviness, load, burden</li></ol>
стамо|stamo	<i>noun</i><br><ol><li>sewing, needlework</li></ol>
сувозей|suvozej	<i>noun</i><br><ol><li>western capercaillie, wood grouse, mountain cock, horse-of-the-wood</li></ol>
сукс|suks	<i>noun</i><br><ol><li>worm</li></ol>
сулейкс|sulejks	<i>noun</i><br><ol><li>silhouette</li></ol>
сульть|suľť	<i>noun</i><br><ol><li>echo</li></ol>
сундерькс|sundeřks	<i>noun</i><br><ol><li>twilight</li></ol>
супрят|suprät	<i>noun</i><br><ol><li>epaulette, shoulder strap</li></ol>
сургудо|сургудошка|сургудонень|сургудот|сургудос|surgudo|сургудосто|сургудокс|сургудовтомо|сургудодо|сургудова|сургудосо|сургудонь	<i>noun</i><br><ol><li>thimble</li></ol>
суре|суреде|сурекс|sure|суресэ|суревтеме|сурень|сурес|сурева|суреть|сурестэ|сурешка|суренень	<i>noun</i><br><ol><li>thread</li></ol>
суркс|surks	<i>noun</i><br><ol><li>ring (piece of jewellery)</li></ol>
суро|сурова|сурос|сурокс|суронень|суросо|сурошка|суродо|сурот|суросто|суровтомо|suro|суронь	<i>noun</i><br><ol><li>millet</li></ol>
сывель|сывелть|сывельс|сывелтеме|сывелькс|сывелде|сывельшка|сывелнень|сывельсэ|сывельстэ|syveľ|сывелень|сывельга	<i>noun</i><br><ol><li>meat</li></ol>
сывть|syvť	<i>noun</i><br><ol><li>stuffing, inning</li></ol>
сый|syj	<i>noun</i><br><ol><li>pus</li></ol>
сынь|synʹ	<i>pron</i><br><ol><li>they (third person plural)</li></ol>
сырне|сырнеть|сырнеде|сырнекс|сырнешка|сырненень|сырнесэ|сырнестэ|сырнес|сырнева|сырнень|сырневтеме|syrne	<i>noun</i><br><ol><li>gold</li></ol>
сырнема|сырнемас|syrnema|сырнемасо|сырнемавтомо|сырнемань|сырнемакс|сырнеманень|сырнемадо|сырнемашка|сырнемава|сырнемат|сырнемасто	<i>noun</i><br><ol><li>marasmus</li></ol>
сэдь|sedʹ	<i>noun</i><br><ol><li>bridge</li></ol>
сэль|selʹ	<i>noun</i><br><ol><li>fathom</li></ol>
сэльге|selʹge	<i>noun</i><br><ol><li>fibre</li></ol>
сэме|seme	<i>noun</i><br><ol><li>brush</li></ol>
сэнь|senʹ	<i>adj</i><br><ol><li>blue</li></ol>
сэпе|sepe	<i>noun</i><br><ol><li>bile</li></ol>
сэрьге|serʹge	<i>noun</i><br><ol><li>roach</li></ol>
сэря|serja	<i>noun</i><br><ol><li>acorn</li><li>gland</li></ol>
сэтьме|sěťme	<i>noun</i><br><ol><li>peace</li></ol><br><i>adj</i><br><ol><li>peacefull</li><li>quiet</li></ol>
сюва|sjuva	<i>noun</i><br><ol><li>chaff</li></ol>
сюкоро|sükoro	<i>noun</i><br><ol><li>pastry</li></ol>
сялго|sälgo	<i>noun</i><br><ol><li>stinger</li><li>thorn, spine, pickle</li><li>fish-bone</li></ol>
сянгине|sängine	<i>noun</i><br><ol><li>fork</li></ol>
сянго|sängo	<i>noun</i><br><ol><li>pitchfork</li></ol>
сярдай|särdaj	<i>noun</i><br><ol><li>elecampane, horse-heal (Inula helenium)</li></ol>
сярдо|särdo	<i>noun</i><br><ol><li>moose (USA), elk (British), Alces alces</li></ol>
сярко|särko	<i>noun</i><br><ol><li>nit (louse egg)</li><li>scumbag, rascal</li></ol>
сятказ|sätkaz	<i>noun</i><br><ol><li>chive</li></ol>
сятко|sjatko	<i>noun</i><br><ol><li>sparkle</li></ol>
сёвонь|sjovonʹ	<i>noun</i><br><ol><li>clay</li></ol>
сёкань|sjokanʹ	<i>noun</i><br><ol><li>deer</li></ol>
сёксень|sjoksenʹ	<i>adv</i><br><ol><li>of autumn, of fall</li></ol>
сёксня|sjoksnja	<i>adv</i><br><ol><li>in autumn, in fall</li></ol>
сёксь|sjoksʹ	<i>noun</i><br><ol><li>autumn, fall</li></ol>
сёлмо|sjolmo	<i>noun</i><br><ol><li>wing</li><li>fin</li></ol>
сёлт|sjolt	<i>noun</i><br><ol><li>pond</li></ol>
сёрма|сёрмава|сёрмас|сёрмань|сёрмашка|sörma|сёрманень|сёрмат|сёрмасто|сёрмакс|сёрмавтомо|сёрмасо|сёрмадо	<i>noun</i><br><ol><li>letter</li><li>writ, writing</li></ol>
сёрмадей|sörmadej	<i>noun</i><br><ol><li>author, writer</li></ol>
сёрмадома|сёрмадоманень|сёрмадомасо|сёрмадомашка|сёрмадомат|сёрмадомань|sörmadoma|сёрмадомадо|сёрмадомакс|сёрмадомас|сёрмадомава|сёрмадомавтомо|сёрмадомасто	<i>noun</i><br><ol><li>writing, script, scripture</li></ol>
сёрмадыця|sörmadycä	<i>noun</i><br><ol><li>clerk</li></ol>
сёрманька|sörmaňka	<i>noun</i><br><ol><li>letter (of alphabet)</li></ol>
сёрмацтома|sjormactoma	<i>noun</i><br><ol><li>subscription</li></ol>
сёрмацтомс|сёрмацты|сёрмацтсь|sörmactoms	<i>verb</i><br><ol><li>to subscribe</li><li>to register</li></ol>
сёрмыкелькс|sjormykelʹks	<i>noun</i><br><ol><li>(computing) a program, an application, an application program</li></ol>
сёрмыне|sörmyne	<i>noun</i><br><ol><li>note, memo</li></ol>
таго|tago	<i>adv</i><br><ol><li>again</li></ol>
тагояк|tagojak	<i>adv</i><br><ol><li>once again</li></ol>
тазт|tazt	<i>noun</i><br><ol><li>itch, mange</li></ol>
тандал|tandal	<i>noun</i><br><ol><li>candlestick</li></ol>
тарваз|tarvaz	<i>noun</i><br><ol><li>sickle</li></ol>
тарво|tarvo	<i>noun</i><br><ol><li>pain, anguish, torment, suffering, torture</li><li>ordeal</li><li>harassment</li></ol>
тарго|targo	<i>noun</i><br><ol><li>week</li></ol>
таргочи|targoči	<i>noun</i><br><ol><li>Sunday</li></ol>
тарка|tarka	<i>noun</i><br><ol><li>place</li></ol>
тевбарго|тевбаргтнес|тевбаргтненень|тевбаргтневтеме|тевбаргстонть|тевбаргодонть|тевбаргтнестэ|тевбаргованть|тевбаргтне|тевбаргтнень|тевбаргсонть|тевбаргтнеде|тевбаргтнесэ|тевбаргтнешка|тевбаргонтень|tevbargo|тевбаргось|тевбаргонть|тевбарговтомонть|тевбаргтнева|тевбаргошканть	<i>noun</i><br><ol><li>workbox, workbasket</li><li>(colloquial) businessman, busy man, boomster</li></ol>
тевконёв|tevkonöv	<i>noun</i><br><ol><li>document</li></ol>
теле|tele	<i>noun</i><br><ol><li>winter</li></ol>
телень|telenʹ	<i>adj</i><br><ol><li>of winter</li></ol>
тельня|telʹnja	<i>adv</i><br><ol><li>in winter</li></ol>
тетя|tjetja	<i>noun</i><br><ol><li>father</li></ol>
теште|tešte	<i>noun</i><br><ol><li>star</li></ol>
тикше|tikše	<i>noun</i><br><ol><li>grass</li></ol>
тире|tire	
тол|tol	<i>noun</i><br><ol><li>fire</li></ol>
тон|ton	<i>pron</i><br><ol><li>(second person singular) you</li></ol>
тона|tona	<i>pron</i><br><ol><li>that</li></ol><br><i>noun</i><br><ol><li>study, -logy; in this sense usually the head of a compound term</li></ol>
топо|topo	<i>noun</i><br><ol><li>quark (cheese), cottage cheese, curd cheese, cheese</li><li>seed, stone</li><li>nucleus</li></ol>
топоведь|topovedʹ	<i>noun</i><br><ol><li>whey</li><li>serum</li></ol>
торкай|torkaj	<i>noun</i><br><ol><li>lark</li></ol>
торо|toro	<i>noun</i><br><ol><li>sword</li><li>sabre, saber</li></ol>
торсей|torsej	<i>noun</i><br><ol><li>mast (support of a sail)</li></ol>
туво|tuvo|тувонень|тувовтомонть|туводонть|тувотнестэ|тувосо|тувотнес|тувонтень|туводо|тувошканть|тувос|тувонь|тувот|тувотнешка|тувостонть|тувошка|тувотневтеме|тувованть|тувотненень|тувотне|тувотнесэ|тувось|тувосонть|тувовтомо|тувотнеде|тувотнева|тувова|тувокс|тувонть|тувотнень|тувосто	<i>noun</i><br><ol><li>pig</li><li>a disgusting person</li></ol>
тувор|tuvor	<i>noun</i><br><ol><li>table</li></ol>
тувтал|tuvtal	<i>noun</i><br><ol><li>reason, cause, ground, occasion</li></ol>
тулго|тулгтнешка|тулгованть|тулгтненень|тулгодонть|тулгтнестэ|тулгтнева|тулгстонть|тулгошканть|tulgo|тулгтнень|тулгонтень|тулгтневтеме|тулгтнес|тулговтомонть|тулгтнесэ|тулгось|тулгтне|тулгтнеде|тулгонть|тулгсонть	<i>noun</i><br><ol><li>(anatomy) muscle</li></ol>
тунда|tunda	<i>adv</i><br><ol><li>in spring</li></ol>
тундо|tundo	<i>noun</i><br><ol><li>spring</li></ol>
тундонь|tundonʹ	<i>adj</i><br><ol><li>of spring</li></ol>
тутко|тутксонть|tutko|тутктнеде|тутконтень|туткось|тутктненень|тутктнень|туткошканть|тутктнестэ|тутктнесэ|тутктнешка|тутктнева|тутктне|тутктневтеме|тутковтомонть|тутктнес|туткстонть|туткодонть|туткованть|тутконть	<i>noun</i><br><ol><li>(zoology) tench</li></ol>
тынгай|tyngaj	<i>noun</i><br><ol><li>bullfinch</li></ol>
тынь|tynʹ	<i>pron</i><br><ol><li>you (second person plural)</li></ol>
тырдаз|tyrdaz	<i>noun</i><br><ol><li>thrush</li></ol>
тюжа|tjuža	<i>adj</i><br><ol><li>brown</li><li>orange</li><li>red (hair)</li></ol>
тюжапря|tüžaprä	<i>noun</i><br><ol><li>mustard</li></ol>
тюрема|türema	<i>noun</i><br><ol><li>war</li></ol>
тюс|tjus	<i>noun</i><br><ol><li>color</li></ol>
удем|udem	<i>noun</i><br><ol><li>marrow</li></ol>
узере|uzere	<i>noun</i><br><ol><li>axe</li></ol>
улав|ulav	<i>noun</i><br><ol><li>wagon</li></ol>
ума|умашка|уматнеде|умава|умаванть|уматневтеме|умакс|уматне|умастонть|умадонть|умасо|умасто|умань|уманень|уматнесэ|уматнешка|уматнева|умась|умашканть|умасонть|уматнестэ|умантень|уматнес|умадо|умавтомонть|uma|уманть|уматнень|умас|уматненень|умавтомо|умат	<i>noun</i><br><ol><li>plot, strip of land</li></ol>
умарь|умартеме|умарьга|умарть|умарьсэ|умарьшка|умарьс|умарькс|умарьстэ|умарде|umař|умарень|умарнень	<i>noun</i><br><ol><li>apple</li></ol>
ур|ur	<i>noun</i><br><ol><li>squirrel</li></ol>
уре|ure	<i>noun</i><br><ol><li>slave (male)</li></ol>
уредев|uredev	<i>noun</i><br><ol><li>groomsman</li></ol>
уро|uro	<i>noun</i><br><ol><li>awl</li></ol>
урозей|urozej	<i>noun</i><br><ol><li>boar, barrow (male pig)</li></ol>
уропей|uropej	<i>noun</i><br><ol><li>fang, tusk</li></ol>
уроске|uroske	<i>noun</i><br><ol><li>violet (flower of the genus Viola)</li><li>pansy (cultivated variety of this plant, with considerably larger flowers)</li></ol>
урьва|urʹva	<i>noun</i><br><ol><li>a man’s daughter-in-law (a wife’s daughter-in-law is her уря)</li></ol>
усад|usad	<i>noun</i><br><ol><li>kitchen garden</li></ol>
усия|usiä	<i>noun</i><br><ol><li>island</li></ol>
усксевиця|usksevicä	<i>noun</i><br><ol><li>whore, promiscuous woman</li></ol>
усьве|usʹve	<i>noun</i><br><ol><li>spear</li></ol>
уськаз|uśkaz	<i>noun</i><br><ol><li>couch grass, dog grass, quitch grass (Elymus repens)</li></ol>
уське|uśke	<i>noun</i><br><ol><li>wire</li></ol>
утом|utom	<i>noun</i><br><ol><li>barn, granary, warehouse, storehouse</li></ol>
уцекудо|ucekudo	<i>noun</i><br><ol><li>doss-house, doss, flophouse (sleeping-place for the homeless)</li></ol>
уця|ucä	<i>noun</i><br><ol><li>nape, withers</li><li>back</li></ol>
уцяска|ucäska	<i>noun</i><br><ol><li>happiness, good luck</li><li>luck, fortune</li></ol>
ушман|ušman	<i>noun</i><br><ol><li>soldier</li><li>warrior</li></ol>
ушмо|ušmo	<i>noun</i><br><ol><li>army</li><li>horde</li></ol>
уштомапель|uštomapelʹ	<i>noun</i><br><ol><li>fuel</li></ol>
цапа|цапавтомо|цапас|цапашка|цапат|цапава|capa|цапасо|цапасто|цапакс|цапань|цападо|цапанень	<i>noun</i><br><ol><li>(zoology) ruffe</li></ol>
целковой|celkovoj	<i>noun</i><br><ol><li>ruble (a unit of monetary value in Russia)</li></ol>
целься|celsä	<i>noun</i><br><ol><li>slug</li></ol>
цеця|cecja	<i>noun</i><br><ol><li>flower</li></ol>
цибирькай|cibiŕkaj	<i>noun</i><br><ol><li>lapwing</li></ol>
цитерь|citerʹ	<i>noun</i><br><ol><li>electricity</li></ol>
цяй|cäj	<i>noun</i><br><ol><li>tea</li></ol>
цяйчакш|cäjčakš	<i>noun</i><br><ol><li>teapot</li></ol>
цянав|cjanav	<i>noun</i><br><ol><li>barn swallow</li></ol>
цёков|цёковс|цёковшка|цёковтомо|цёковнэнь|цёковдо|цёковкс|цёковонь|цёковсто|цёковга|cökov|цёковсо|цёковт	<i>noun</i><br><ol><li>(bird) nightingale</li></ol>
цёмара|cömara	<i>noun</i><br><ol><li>dumpling</li></ol>
цёра|cjora	<i>noun</i><br><ol><li>son</li></ol>
чавоко|čavoko	<i>noun</i><br><ol><li>desert</li></ol>
чавоня|čavonä	<i>noun</i><br><ol><li>desert</li></ol>
чадыков|čadykov	<i>noun</i><br><ol><li>April (month)</li></ol>
чакш|čakš	<i>noun</i><br><ol><li>pot</li></ol>
чама|čama	<i>noun</i><br><ol><li>face (front part of the head)</li><li>face, figure</li></ol>
чандо|čando	<i>noun</i><br><ol><li>bride price (a sum of money or other valuables paid by a bridegroom or on his behalf to the family of the bride)</li><li>ransom</li></ol>
чапа|čapa	<i>noun</i><br><ol><li>Any sour or acidic liquid: acid.</li><li>(chemistry) A substance that can give a proton to another substance (Brønsted acid)</li><li>(chemistry) A substance that can act as an electron pair donor (Lewis acid).</li><li>(slang) lysergic acid diethylamide (LSD)</li></ol>
чапамо|čapamo	<i>adj</i><br><ol><li>sour</li></ol>
чарыкш|čarykš	<i>noun</i><br><ol><li>bicycle</li></ol>
чарытеште|čarytešte	<i>noun</i><br><ol><li>planet</li></ol>
чачо|čačo	<i>noun</i><br><ol><li>shape, form</li><li>figure</li></ol>
чевте|čevte	<i>adj</i><br><ol><li>soft</li></ol>
чиряз|čirjaz	<i>noun</i><br><ol><li>mister (form of address)</li></ol>
човине|čovine	<i>adj</i><br><ol><li>thin</li></ol>
чочко|чочктневтеме|чочктнестэ|чочкодонть|чочконтень|čočko|чочктнень|чочкстонть|чочкошканть|чочктнева|чочконть|чочковтомонть|чочктнешка|чочксонть|чочктненень|чочктнеде|чочктне|чочктнесэ|чочктнес|чочкось|чочкованть	<i>noun</i><br><ol><li>log, beam (a tree trunk with branches removed)</li></ol>
чувто|čuvto	<i>noun</i><br><ol><li>tree</li></ol>
чувтой|čuvtoj	<i>noun</i><br><ol><li>olive oil</li></ol>
чувтомомс|čuvtomoms	<i>verb</i><br><ol><li>to stiffen (to become stiff)</li></ol>
чувтонь|čuvtonʹ	<i>adj</i><br><ol><li>wooden</li></ol>
чулга|čulga	<i>noun</i><br><ol><li>seal</li></ol>
чуля|čulä	<i>noun</i><br><ol><li>cone</li></ol>
чумо|čumo	<i>noun</i><br><ol><li>crime, sin</li></ol>
чурька|čuřka	<i>noun</i><br><ol><li>onion</li></ol>
шабра|šabra	<i>noun</i><br><ol><li>neighbour</li></ol>
шанжав|šanžav	<i>noun</i><br><ol><li>spider</li></ol>
шанч|šanč	<i>noun</i><br><ol><li>gallop</li><li>galop</li></ol>
шекшата|šekšata	<i>noun</i><br><ol><li>woodpecker</li></ol>
шекшей|šekšej	<i>noun</i><br><ol><li>woodpecker</li></ol>
шенже|šenže	<i>noun</i><br><ol><li>duck</li></ol>
шенш|šenš	<i>noun</i><br><ol><li>duck</li></ol>
шерже|šerže	<i>noun</i><br><ol><li>hoar, gray hair</li></ol>
шечей|šečej	<i>noun</i><br><ol><li>spleen, milt</li></ol>
шкерьге|škerʹge	<i>noun</i><br><ol><li>wartycabbage (Bunias orientalis)</li></ol>
шлямгудо|šlämgudo	<i>noun</i><br><ol><li>sauna</li></ol>
шлямзей|šljamzej	<i>noun</i><br><ol><li>bath sponge (Spongia officinalis)</li><li>sponge, bath sponge (implement for washing)</li></ol>
шок|šok	<i>noun</i><br><ol><li>ball</li></ol>
шта|šta	<i>noun</i><br><ol><li>wax</li></ol>
штатол|štatol	<i>noun</i><br><ol><li>candle</li></ol>
што|što	<i>conj</i><br><ol><li>that</li></ol>
штюрьба|štüřba	<i>noun</i><br><ol><li>ukha, fish soup</li></ol>
шуж|šuž	<i>noun</i><br><ol><li>barley</li></ol>
шукшторов|šukštorov	<i>noun</i><br><ol><li>currant</li></ol>
шумбрачи|šumbrači	<i>noun</i><br><ol><li>health</li></ol>
шушмо|šušmo	<i>noun</i><br><ol><li>snowdrift</li></ol>
эзем|ezem	<i>noun</i><br><ol><li>bench, chair</li><li>seat</li></ol>
эй|ěj	<i>noun</i><br><ol><li>ice</li></ol>
эйбал|ějbal	<i>noun</i><br><ol><li>ice cube</li></ol>
эйбандо|ějbando	<i>noun</i><br><ol><li>iceberg</li></ol>
эйвелькс|ejvelʹks	<i>noun</i><br><ol><li>ice cream</li></ol>
эйкакш|ejkakš	<i>noun</i><br><ol><li>child</li></ol>
эльде|elʹde	<i>noun</i><br><ol><li>mare</li></ol>
эрейкс|erejks	<i>noun</i><br><ol><li>animal</li></ol>
эрексия|эрексиява|ěreksiä|эрексиядо|эрексиякс|эрексият|эрексиянь|эрексиясто|эрексияс|эрексияшка|эрексиясо|эрексиявтомо|эрексиянень	<i>noun</i><br><ol><li>mercury, quicksilver</li></ol>
эрзя|erzja	<i>noun</i><br><ol><li>Erzya (a member of the ethnic group Erzya-Mordvin, closely related to the Moksha or Moksha-Mordvin).</li><li>Erzya language (a Finno-Ugrian language).</li></ol>
эрямарт|erjamart	<i>noun</i><br><ol><li>movie (individual film)</li><li>cinema (art form)</li><li>movies, cinema (theater in which films are shown for the public)</li></ol>
эрямо|erjamo	<i>noun</i><br><ol><li>life</li></ol>
эрямс|eräms|эри|эрясь	<i>verb</i><br><ol><li>to live</li></ol>
эчке|ečke	<i>noun</i><br><ol><li>thickness</li></ol><br><i>adj</i><br><ol><li>thick</li></ol>
юндо|jundo	<i>noun</i><br><ol><li>group, cluster, band</li><li>(military) troops</li><li>(mathematics) set</li><li>Used as modifier in compound term (юндо-); mass (involving a mass of people or things)</li></ol>
юром|jurom	<i>noun</i><br><ol><li>family</li></ol>
явизем|ävizem	<i>noun</i><br><ol><li>bacteria</li></ol>
якамс|яки|äkams|якась	<i>verb</i><br><ol><li>to go</li></ol>
яксема|jaksema	<i>noun</i><br><ol><li>adventure</li></ol>
якстере|jakstere	<i>adj</i><br><ol><li>red</li></ol>
яксярго|jaksjargo	<i>noun</i><br><ol><li>duck</li></ol>
ялга|ялгасто|ялгань|ялгава|älga|ялганень|ялгас|ялгакс|ялгат|ялгадо|ялгавтомо|ялгасо|ялгашка	<i>noun</i><br><ol><li>friend, comrade</li><li>comrade (title)</li></ol>
ям|ямшка|ямт|ямтомо|ямга|ямс|ямкс|ямдо|äm|ямнэнь|ямсо|ямонь|ямсто	<i>noun</i><br><ol><li>soup</li></ol>
ямся|ämsä	<i>noun</i><br><ol><li>something doubled, twinned</li></ol>
янгамс|ängams|янгась|янги	<i>verb</i><br><ol><li>to break</li><li>to ache</li><li>to bastardize, to butcher (language)</li></ol>
ярмак|jarmak	<i>noun</i><br><ol><li>coin</li><li>money</li></ol>
ярсамс|ярсась|ärsams|ярсы	<i>verb</i><br><ol><li>to eat</li></ol>
ят|ät	<i>noun</i><br><ol><li>enemy</li><li>alien, stranger</li></ol><br><i>adj</i><br><ol><li>alien, strange</li></ol>
ёвкс|övks	<i>noun</i><br><ol><li>tale</li><li>fairy-tale</li></ol>
ёвтамо|övtamo	<i>noun</i><br><ol><li>message</li></ol>
ёвтнема|övtnema	<i>noun</i><br><ol><li>story</li><li>short story, novella</li></ol>
ёжо	<i>noun</i><br><ol><li>feeling, state, health</li></ol>
ёзамо|özamo	<i>noun</i><br><ol><li>friction</li></ol>
ёзнэ|ёзнэшканть|ёзнтнестэ|ёзнтневтеме|ёзнтненень|jozne|ёзнэвтеме|ёзнтнень|ёзнтне|ёзнэсь|ёзнстэнть|ёзнтнесэ|ёзнэнть|ёзнтнева|ёзнэденть|ёзнэсэ|ёзнэстэ|ёзнэванть|ёзнэде|ёзнэкс|ёзнэс|ёзнтнешка|ёзнэшка|ёзнтнеде|ёзнэва|ёзнэнень|ёзнэнь|ёзнэть|ёзнсэнть|ёзнэвтементь|ёзнтнес|ёзнэнтень	<i>noun</i><br><ol><li>snake</li></ol>
ёзь|öź	<i>noun</i><br><ol><li>chub (zoology)</li></ol>
ёл|öl	<i>noun</i><br><ol><li>pond</li><li>twig, switch</li><li>rod</li><li>wicker</li></ol>
ёндол|öndol	<i>noun</i><br><ol><li>lightning</li></ol>
ёнкс|önks	<i>noun</i><br><ol><li>direction, quarter, compass point</li><li>side</li></ol>
ёнкуля|jonkulja	<i>noun</i><br><ol><li>gospel, evangel</li></ol>
ёр|jor	<i>noun</i><br><ol><li>quail</li></ol>
ёрниця|örnicä	<i>noun</i><br><ol><li>brave man</li></ol>
ёрок|örok	<i>noun</i><br><ol><li>skill, proficiency, dexterity, craft</li></ol>
ёток|ötok	<i>noun</i><br><ol><li>fool</li></ol>
ёшка|öška	<i>noun</i><br><ol><li>landmark, milestone</li></ol>
