А|а	<i>character</i><br><ol><li>The first letter of the Evenki alphabet, written in the Cyrillic script.</li></ol>
авгара|awgara	<i>adj</i><br><ol><li>healthy</li></ol><br><i>noun</i><br><ol><li>health</li></ol>
авданна|awdanna	<i>noun</i><br><ol><li>leaf</li></ol>
авду|awdu	<i>noun</i><br><ol><li>cattle</li></ol>
авми|awmī|авмӣ|а̄вмӣ|āwmī	<i>verb</i><br><ol><li>(transitive) to wash</li><li>(intransitive) to bathe</li><li>(transitive) to wipe</li><li>(transitive) to get wet</li><li>(transitive) to add</li></ol>
авса|awsa	<i>noun</i><br><ol><li>box (container)</li></ol>
авун|awun	<i>noun</i><br><ol><li>hat</li></ol>
агды|agdi	<i>noun</i><br><ol><li>thunder</li><li>storm</li><li>lightning</li></ol>
ады|adi	<i>pron</i><br><ol><li>how many</li></ol>
ака|akā|ака̄	<i>noun</i><br><ol><li>Zeya-dialect form of акӣн (akīn, “elder brother”)</li></ol>
акин|akin	<i>noun</i><br><ol><li>elder brother</li></ol>
ала|ala	<i>adj</i><br><ol><li>sweet</li></ol>
алагуми|alagūmī|алагӯмӣ	<i>verb</i><br><ol><li>(transitive) to teach</li></ol>
алатми|alātmī|ала̄тмӣ	<i>verb</i><br><ol><li>(transitive) to await</li><li>(intransitive) to wait</li></ol>
алта|alta	<i>noun</i><br><ol><li>gold</li></ol>
амака|amāka|ама̄ка	<i>noun</i><br><ol><li>bear</li></ol>
ами|amī|а̄мӣ|āmī|амӣ	<i>noun</i><br><ol><li>father, dad (used when addressing one's father)</li><li>sleep</li></ol><br><i>verb</i><br><ol><li>(intransitive) to sleep</li></ol>
амин|amin	<i>noun</i><br><ol><li>father</li></ol>
амта|amta	<i>noun</i><br><ol><li>taste</li></ol>
амут|а̄мут|āmut	<i>noun</i><br><ol><li>lake</li></ol>
амңа|amŋa|амӈа	<i>noun</i><br><ol><li>mouth</li></ol>
анда|anda	<i>noun</i><br><ol><li>friend</li></ol>
анңани	<i>noun</i><br><ol><li>year</li></ol>
араки|araki	<i>noun</i><br><ol><li>liquor</li><li>wine</li></ol>
арба|arba	<i>adj</i><br><ol><li>shallow</li></ol>
асаки|asaki	<i>noun</i><br><ol><li>wing</li></ol>
асаткан|asatkan	<i>noun</i><br><ol><li>girl</li></ol>
аси|asi	<i>noun</i><br><ol><li>woman</li><li>wife</li></ol>
асикта|asikta	<i>noun</i><br><ol><li>fir</li></ol>
ачакта|açakta	<i>noun</i><br><ol><li>maple</li></ol>
ачин|açin	<i>adv</i><br><ol><li>no; not</li></ol>
багдавки|багдавкӣ|bagdawkī	<i>noun</i><br><ol><li>swan</li></ol>
багдама|bagdama	<i>adj</i><br><ol><li>white</li></ol>
бадялаки|baʒalaki	<i>noun</i><br><ol><li>frog</li></ol>
балдыми|baldīmī|балды̄мӣ	<i>verb</i><br><ol><li>(intransitive) to be born</li><li>(intransitive) to live</li><li>(intransitive) to bear (a child or young)</li><li>(intransitive, of animals or plants) to grow</li></ol>
баян|bajan	<i>adj</i><br><ol><li>rich</li></ol>
бебевки|бебевкӣ|bebewkī	<i>noun</i><br><ol><li>sheep</li></ol>
бега|bēga|бе̄га	<i>noun</i><br><ol><li>moon</li><li>month</li></ol>
белика|бе̄лика|bēlika	<i>noun</i><br><ol><li>swallow (bird)</li></ol>
беру|beru	<i>noun</i><br><ol><li>sheep</li></ol>
би|bi	<i>pron</i><br><ol><li>I (personal pronoun)</li></ol>
билэ|bilə	<i>noun</i><br><ol><li>place</li></ol>
бими|бимӣ|bimī	<i>verb</i><br><ol><li>(copulative) to be</li><li>(intransitive) to be</li><li>(intransitive) to live</li></ol>
бира|bira	<i>noun</i><br><ol><li>river</li></ol>
бираг|birag	<i>noun</i><br><ol><li>river</li></ol>
бичэкэй|biçəkəj	<i>noun</i><br><ol><li>spleen</li></ol>
бокан|бо̄ка̄н|bōkān	<i>noun</i><br><ol><li>thigh</li></ol>
бокта|бо̄кта|bōkta|bokta	<i>noun</i><br><ol><li>hail</li></ol>
болгиг|bolgig	<i>noun</i><br><ol><li>hazel</li></ol>
болони|boloņi	<i>noun</i><br><ol><li>autumn</li></ol>
босокто|bosokto	<i>noun</i><br><ol><li>kidney</li></ol>
бу|bu	<i>pron</i><br><ol><li>we</li></ol>
буга|buga	<i>noun</i><br><ol><li>sky, heaven</li><li>world</li></ol>
булми|булмӣ|bulmī	<i>verb</i><br><ol><li>(intransitive) to be dying</li><li>(transitive) to pet</li><li>(transitive) to wash (clothes)</li><li>(transitive) to smear</li><li>(transitive) to smoothen; to straighten</li></ol>
бултумэ|bultumə	<i>adj</i><br><ol><li>slippery</li></ol>
булэн|bulən	<i>noun</i><br><ol><li>enemy</li></ol>
буми|bumi	<i>verb</i><br><ol><li>to give</li></ol>
буни|бунӣ|buņī	<i>noun</i><br><ol><li>death</li><li>corpse</li></ol>
бургу|burgu	<i>adj</i><br><ol><li>thick, fat</li></ol>
бурдук|burduk	<i>noun</i><br><ol><li>flour</li><li>bread</li></ol>
бэе|bəje	<i>noun</i><br><ol><li>man</li></ol>
бэйңэ|beynge	<i>noun</i><br><ol><li>wild animal</li></ol>
бэйӈо|bəjŋo	<i>noun</i><br><ol><li>wild deer</li></ol>
бэюн|bəjun	<i>noun</i><br><ol><li>animal</li></ol>
вами|ва̄мӣ|wāmī	<i>verb</i><br><ol><li>(transitive) to catch (on a hunt)</li><li>(transitive) to kill</li><li>(transitive) to bruise (a limb)</li></ol>
гаг|gag	<i>noun</i><br><ol><li>swan</li></ol>
гаки|gaki	<i>noun</i><br><ol><li>crow</li></ol>
гами|гамӣ|gamī	<i>verb</i><br><ol><li>(transitive) to take</li><li>(transitive) to receive</li><li>(transitive) to buy</li><li>(transitive) to remove</li><li>(intransitive) to use two poles to push oneself through water while sitting on the stern of a hunting canoe</li></ol>
гара|gara	<i>noun</i><br><ol><li>branch</li></ol>
ге|gē|ге̄	<i>adj</i><br><ol><li>other, another</li><li>second</li><li>following, next, new</li><li>reverse</li></ol>
гивчэн|giwçən	<i>noun</i><br><ol><li>wild goat</li><li>roe deer</li></ol>
гида|gida	<i>noun</i><br><ol><li>spear</li></ol>
гирамна|giramna	<i>noun</i><br><ol><li>bone</li></ol>
гирки|girki	<i>noun</i><br><ol><li>friend</li></ol>
гирку|girku	<i>noun</i><br><ol><li>wolf</li></ol>
гиркуми|girkumī|гиркумӣ	<i>verb</i><br><ol><li>(intransitive) to step</li><li>(intransitive) to walk</li></ol>
горо|goro	<i>adj</i><br><ol><li>far, distant, remote</li></ol>
городу|gorodu	<i>adv</i><br><ol><li>far</li></ol>
гугда|gugda	<i>adj</i><br><ol><li>high</li></ol>
гулдука|gulduka	<i>noun</i><br><ol><li>thigh</li></ol>
гулэ|gulə	<i>noun</i><br><ol><li>house</li></ol>
гунми|гӯнмӣ|gūnmī	<i>verb</i><br><ol><li>(transitive) to say</li><li>(transitive) to reply</li></ol>
гургакта|gurgakta	<i>noun</i><br><ol><li>beard</li></ol>
гускэ|guskə	<i>noun</i><br><ol><li>wolf</li></ol>
гуткэн|гуткэ̄н|gutkə̄n	<i>noun</i><br><ol><li>pike (fish)</li></ol>
гуткэчэн|gutkəçən	<i>noun</i><br><ol><li>pike (fish)</li></ol>
гэвун|gəwun	<i>noun</i><br><ol><li>oar, paddle</li></ol>
гэлэми|гэлэмӣ|gələmī	<i>verb</i><br><ol><li>(transitive) to ask; to beg</li><li>(transitive) to demand</li><li>(transitive) to wish; to want</li><li>(transitive) to be bored</li></ol>
гэмургэн|gəmurgən	<i>noun</i><br><ol><li>clavicle</li></ol>
гэрби|gərbī|гэрбӣ	<i>noun</i><br><ol><li>name</li><li>reputation</li></ol>
гэчипчу|gəçipçu	<i>adj</i><br><ol><li>bitter</li></ol>
давладеми|dawlāʒemī|давла̄демӣ	<i>verb</i><br><ol><li>(transitive, intransitive) to sing</li></ol>
давлами|давла̄мӣ|dawlāmī	<i>verb</i><br><ol><li>(transitive) to sing (long songs)</li></ol>
дага|daga	<i>adv</i><br><ol><li>near</li></ol>
даран|daran	<i>noun</i><br><ol><li>row</li></ol>
девми|девмӣ|ʒewmī	<i>verb</i><br><ol><li>(transitive) to eat</li></ol>
дег|ʒeg	<i>noun</i><br><ol><li>chin</li></ol>
дегдэми|дегдэмӣ|ʒegdəmī	<i>verb</i><br><ol><li>(transitive) to burn</li><li>(intransitive) to burn</li></ol>
дегинңу|žeginngu	<i>adj</i><br><ol><li>left</li></ol>
делбэн|ʒelbən	<i>noun</i><br><ol><li>taimen (fish)</li></ol>
дему|ʒemu	<i>noun</i><br><ol><li>hunger</li></ol>
диктэ|ʒiktə	<i>noun</i><br><ol><li>berry</li></ol>
догу|dogu	<i>adj</i><br><ol><li>inner</li></ol>
долбони|dolboņī|долбонӣ	<i>noun</i><br><ol><li>night</li></ol>
долдыдями|doldiʒami	<i>verb</i><br><ol><li>to hear</li></ol>
долдыми|dōldīmī|до̄лды̄мӣ	<i>verb</i><br><ol><li>to hear, to listen</li></ol>
доӈото|доңото|doŋoto	<i>noun</i><br><ol><li>cold</li><li>frost</li></ol>
дугэ|dugə	<i>noun</i><br><ol><li>tip, top</li></ol>
дукувун|dukuwun	<i>noun</i><br><ol><li>letter (written message)</li></ol>
дукуми|dukūmī|дукӯмӣ	<i>verb</i><br><ol><li>(transitive) to write</li><li>(intransitive) to write</li><li>(transitive) to copy</li></ol>
дулин|dulin	<i>noun</i><br><ol><li>middle</li></ol>
дуннэ|dunnə	<i>noun</i><br><ol><li>earth</li><li>world</li></ol>
дыги|дыгӣ|digī	<i>adj</i><br><ol><li>fourth</li></ol>
дыгин|digin	<i>num</i><br><ol><li>four</li></ol>
дыл|dil	<i>noun</i><br><ol><li>head</li></ol>
дылача|dilaçā|дылача̄	<i>noun</i><br><ol><li>sun</li></ol>
дылган|dilgan	<i>noun</i><br><ol><li>voice; sound; noise</li></ol>
дылкэн|dilkən	<i>noun</i><br><ol><li>fly (insect)</li></ol>
дырам|diram	<i>adj</i><br><ol><li>thick</li></ol>
дэги|dəg|дэг|dəgi	<i>noun</i><br><ol><li>bird</li></ol>
дэгинӈэктэ|dəginŋə̄ktə|дэгинӈэ̄ктэ	<i>noun</i><br><ol><li>mushroom</li></ol>
дэгми|dəgmī|дэгмӣ	<i>verb</i><br><ol><li>(intransitive) to fly</li></ol>
дэктэннэ|dəktənnə	<i>noun</i><br><ol><li>wing</li><li>feather</li></ol>
дэлкими|dəlkimī|дэлкимӣ	<i>verb</i><br><ol><li>(transitive) to chop</li><li>(transitive) to cleave (with one's chest)</li></ol>
дэлкин|dəlkin	<i>noun</i><br><ol><li>spleen</li></ol>
дэрэ|dərə	<i>noun</i><br><ol><li>face</li></ol>
дэӈкэ|dəŋkə	<i>noun</i><br><ol><li>sable</li></ol>
дю|дю̄|ʒū	<i>noun</i><br><ol><li>house</li></ol>
дюгани|ʒugaņi	<i>noun</i><br><ol><li>summer</li></ol>
дюгуктэ|ʒuguktə	<i>noun</i><br><ol><li>(usually) wasp</li><li>(Barguzin) bee</li></ol>
дюгуми|дюгӯмӣ|ʒugūmī	<i>verb</i><br><ol><li>(transitive) to transport</li></ol>
дюкэ|ʒukə	<i>noun</i><br><ol><li>ice</li></ol>
дюлакин|ʒulakin	<i>adj</i><br><ol><li>naked</li></ol>
дюлэгу|ʒuləgu	<i>adj</i><br><ol><li>front</li></ol>
дюлэски|ʒuləski	<i>adv</i><br><ol><li>forward</li></ol>
дюр|дю̄р|ʒūr	<i>num</i><br><ol><li>two</li></ol>
дяв|ʒaw	<i>noun</i><br><ol><li>boat</li></ol>
дягда|ʒagda	<i>noun</i><br><ol><li>pine</li></ol>
дяги|дя̄гӣ|ʒāgī	<i>adj</i><br><ol><li>tenth</li></ol>
дяланкакта|ʒalankakta	<i>noun</i><br><ol><li>elder (tree)</li></ol>
дяликса|ʒaliksa	<i>noun</i><br><ol><li>saliva</li></ol>
дялум|ʒalum	<i>adj</i><br><ol><li>full</li></ol>
дян|ʒān|дя̄н	<i>num</i><br><ol><li>ten</li></ol>
дяпки|ʒapkī|дяпкӣ	<i>adj</i><br><ol><li>eighth</li></ol>
дяпкун|ʒapkun	<i>num</i><br><ol><li>eight</li></ol>
дяргул|ʒargul	<i>noun</i><br><ol><li>dhole</li></ol>
дёло|ʒolo	<i>noun</i><br><ol><li>stone</li></ol>
еги|егӣ|jegī	<i>adj</i><br><ol><li>ninth</li></ol>
егин|jegin	<i>num</i><br><ol><li>nine</li></ol>
екэ|ёко̄|екэ̄мнӣ|jekə̄|jokō|ёко̄мнӣ|ёко|екэ̄	<i>noun</i><br><ol><li>Yakut, Sakha (person)</li></ol>
екэды|jekə̄di|jokōdi|ёко̄ды|екэ̄ды|ёкоды	<i>adj</i><br><ol><li>Yakut, Sakha</li></ol><br><i>noun</i><br><ol><li>Yakut, Sakha (language)</li></ol>
екэдыт|jekə̄dit|ёко̄дыт|jokōdit|екэ̄дыт|ёкодыт	<i>adv</i><br><ol><li>in Yakut, Sakha (language)</li></ol>
иг|ig	<i>noun</i><br><ol><li>sound, noise</li></ol>
игдяма|igʒama	<i>adj</i><br><ol><li>grey</li></ol>
иду|idu	<i>pron</i><br><ol><li>where</li></ol>
ие|ije	<i>noun</i><br><ol><li>horn</li></ol>
иктэ|ӣктэл|ӣктэлтыкӣ|ӣктэлнун|ӣктэлӣ|ӣктэнги|ӣктэвэ|ӣктэлдулӣ|ӣктэдук|īktə|ӣктэлдук|ӣктэклӣ|ӣктэлъе|ӣктэнун|ӣктэе|ӣктэт|ӣктэлдӯ|ӣктэлгит|ӣктэлвэ|ӣктэ|ӣктэликлӣ|ӣктэлди|ӣктэткӣ|ӣктэлэ̄|ӣктэгит|ӣктэлнги|ӣктэлдиклэ̄|ӣктэлулэ̄|ӣктэклэ̄	<i>noun</i><br><ol><li>tooth</li></ol>
икэвкэ|ikəwkə	<i>noun</i><br><ol><li>singing</li></ol>
икэдеми|ikə̄ʒemī|икэ̄демӣ	<i>verb</i><br><ol><li>(transitive, intransitive) to sing</li></ol>
икэми|ikə̄mī|икэ̄мӣ	<i>verb</i><br><ol><li>(intransitive) to sing</li><li>(intransitive) to rejoice</li></ol>
илан|ilan	<i>num</i><br><ol><li>three</li></ol>
или|ilī|илӣ	<i>adj</i><br><ol><li>third</li></ol>
илими|илӣмӣ|ilīmī|ilimī|илимӣ	<i>verb</i><br><ol><li>(transitive) to strip off</li><li>(transitive) to cook (make food)</li><li>(transitive) to measure</li></ol>
иллэ|illə	<i>noun</i><br><ol><li>body</li></ol>
илми|ilmi	<i>verb</i><br><ol><li>to stand</li></ol>
илэн|ӣлэн|īlən	<i>noun</i><br><ol><li>spleen</li></ol>
иманна|imanna	<i>noun</i><br><ol><li>snow</li></ol>
ими|ӣмӣ|īmī	<i>verb</i><br><ol><li>(transitive) to enter</li><li>(transitive) to hear</li><li>(intransitive) to sound</li></ol>
имуксэ|imuksə	<i>noun</i><br><ol><li>fat, grease</li></ol>
инектэдеми|iņektəʒemi	<i>verb</i><br><ol><li>to laugh</li></ol>
инеми|iņemī|инемӣ	<i>verb</i><br><ol><li>(intransitive) to laugh</li><li>(intransitive) to joke</li><li>(intransitive) to jeer</li></ol>
инми|īnmī|ӣнмӣ	<i>verb</i><br><ol><li>(intransitive) to live</li></ol>
инмэ|inmə	<i>noun</i><br><ol><li>needle</li></ol>
инни|inņi	<i>noun</i><br><ol><li>tongue (organ)</li></ol>
инэӈи|inəŋi	<i>noun</i><br><ol><li>day</li></ol>
инңакта|inngakta	<i>noun</i><br><ol><li>fur</li><li>wool</li></ol>
инӈэктэмкурэ|inŋəktəmkūrə̄|инӈэктэмкӯрэ̄	<i>noun</i><br><ol><li>bird cherry</li></ol>
иракта|irakta	<i>noun</i><br><ol><li>tsar</li></ol>
ирги|irgi	<i>noun</i><br><ol><li>tail</li></ol>
иргичи|irgiçi	<i>noun</i><br><ol><li>wolf</li></ol>
иргэ|irgə	<i>noun</i><br><ol><li>brain</li><li>mind</li></ol>
ириктэ|iriktə	<i>noun</i><br><ol><li>ant</li></ol>
ирими|ирӣмӣ|īrimī|irīmī|ӣримӣ	<i>verb</i><br><ol><li>(transitive) to bake; to fry</li><li>(intransitive) to get a nervous breakdown</li></ol>
ирми|irmi	<i>verb</i><br><ol><li>to be/get ripe; to ripen</li></ol>
ичэми|ичэмӣ|içəmī	<i>verb</i><br><ol><li>(transitive) to see</li><li>(transitive) to notice</li></ol>
ичэн|içən	<i>noun</i><br><ol><li>elbow</li></ol>
иңа|inga	<i>noun</i><br><ol><li>sand</li></ol>
иӈин|iŋin	<i>adj</i><br><ol><li>cold</li><li>frost</li></ol>
иӈинипчу|iŋiņipçu	<i>adj</i><br><ol><li>cold</li></ol>
каир|kajir	<i>noun</i><br><ol><li>goat</li></ol>
калим|kalim	<i>noun</i><br><ol><li>whale</li></ol>
килгасун|kilgāsun|килга̄сун	<i>noun</i><br><ol><li>hair</li></ol>
киран|kiran	<i>noun</i><br><ol><li>eagle</li></ol>
комурган|komurgan	<i>noun</i><br><ol><li>clavicle</li></ol>
конин|koņin	<i>noun</i><br><ol><li>sheep</li></ol>
конңорин	<i>adj</i><br><ol><li>black</li></ol>
кубаҕай	<i>noun</i><br><ol><li>a brown deer (in Russian, коричневый олень)</li></ol>
кулин|kulin	<i>noun</i><br><ol><li>snake</li></ol>
кумака|kumaka	<i>noun</i><br><ol><li>red deer</li></ol>
кумикэн|kumikə̄n|кумикэ̄н	<i>noun</i><br><ol><li>insect, worm</li></ol>
кусин|kusin	<i>noun</i><br><ol><li>war, fight</li></ol>
куңакан|kungakan	<i>noun</i><br><ol><li>child</li></ol>
кэрэмун|kərəmun	<i>noun</i><br><ol><li>squirrel</li></ol>
лакамавун|lakamawun	<i>noun</i><br><ol><li>elm</li></ol>
лалбука|lalbuka	<i>noun</i><br><ol><li>moss</li></ol>
ламу|lamu	<i>noun</i><br><ol><li>sea</li></ol>
локоми|lokomī|локомӣ	<i>verb</i><br><ol><li>(transitive) to hang</li><li>(transitive) to weigh</li><li>(transitive) to put on (moccasins)</li></ol><br><i>noun</i><br><ol><li>A type of summer moccasins.</li></ol>
лоптуки|лоптукӣ|loptukī	<i>noun</i><br><ol><li>burbot (fish)</li></ol>
лучады|luçadi	<i>adj</i><br><ol><li>Russian</li></ol>
манни|manņi	<i>adj</i><br><ol><li>strong, tough</li></ol>
мачалэ|maçalə	<i>noun</i><br><ol><li>cow</li></ol>
маңа	<i>adj</i><br><ol><li>hard</li></ol>
ме̄ван|mēwan	<i>noun</i><br><ol><li>heart</li></ol>
меван|mewan	<i>noun</i><br><ol><li>heart</li></ol>
минэдеми|minəʒemi	<i>verb</i><br><ol><li>to cut</li></ol>
минэми|minə̄mī|минэ̄мӣ	<i>verb</i><br><ol><li>(transitive) to cut</li></ol>
мирэ|mirə	<i>noun</i><br><ol><li>shoulder</li></ol>
мит|mit	<i>pron</i><br><ol><li>we (inclusive)</li></ol>
мо|mo	<i>noun</i><br><ol><li>tree</li><li>wood</li></ol>
монон|monon	<i>noun</i><br><ol><li>maple</li></ol>
монӈими|monŋimī|монӈимӣ	<i>verb</i><br><ol><li>(dialectal) Alternative form of мэнӈимӣ (mənŋimī)</li></ol>
моты|мо̄ты|mōti	<i>noun</i><br><ol><li>elk</li></ol>
моңон	<i>noun</i><br><ol><li>throat</li></ol>
му|mu|мӯ|mū	<i>noun</i><br><ol><li>water</li></ol>
мудан|mudan	<i>noun</i><br><ol><li>end</li></ol>
муннукан|munnukan	<i>noun</i><br><ol><li>hare</li></ol>
мурин|murin	<i>noun</i><br><ol><li>horse</li></ol>
мучукай|muçukaj	<i>noun</i><br><ol><li>swallow (bird)</li></ol>
мучуми|мучумӣ|muçumī|мучӯмӣ|muçūmī	<i>verb</i><br><ol><li>(intransitive) to turn green</li><li>(intransitive) to return</li></ol>
мэдэвкэ|mədəwkə	<i>noun</i><br><ol><li>news</li></ol>
мэкчэн|məkçən	<i>noun</i><br><ol><li>Siberian hornless deer</li></ol>
мэнӈими|мэнӈимӣ|mənŋimī	<i>verb</i><br><ol><li>(transitive) to knead</li></ol>
мэрикта|mərikta	<i>noun</i><br><ol><li>perch (fish)</li></ol>
мэңун	<i>noun</i><br><ol><li>silver</li><li>money</li></ol>
мэӈун|məŋun	<i>noun</i><br><ol><li>silver</li><li>money</li></ol>
мёд|mjōd|мё̄д	<i>noun</i><br><ol><li>honey</li></ol>
надан|nadan	<i>num</i><br><ol><li>seven</li></ol>
нады|нады̄|nadī	<i>adj</i><br><ol><li>seventh</li></ol>
намнэ|на̄мнэ|nāmnə	<i>noun</i><br><ol><li>dust</li></ol>
наптама|naptama	<i>adj</i><br><ol><li>flat</li></ol>
некэ|некэ̄|ņekə̄	<i>noun</i><br><ol><li>sable</li></ol>
некэчэн|не̄кэчэ̄н|ņēkəçə̄n	<i>noun</i><br><ol><li>perch (fish)</li></ol>
немумэ|ņemumə	<i>adj</i><br><ol><li>soft</li></ol>
ненңени	<i>noun</i><br><ol><li>springtime</li></ol>
нербэкэ|ņerbəkə	<i>noun</i><br><ol><li>hill</li></ol>
неӈнени|ņeŋņeņi|неӈненӣ|ņeŋņeņī	<i>noun</i><br><ol><li>spring-time</li></ol>
нивми|ņīwmī|нӣвмӣ	<i>verb</i><br><ol><li>(intransitive) to open; to open up</li><li>(intransitive) to be open; to be uncorked</li></ol>
ники|ņiki	<i>noun</i><br><ol><li>duck</li></ol>
никимна|ņikimna	<i>noun</i><br><ol><li>neck; nape; vertebra</li></ol>
нимңакан	<i>noun</i><br><ol><li>tale</li></ol>
нирусан	<i>noun</i><br><ol><li>grayling (Thymallus thymallus)</li></ol>
нодами|но̄да̄мӣ|nōdāmī	<i>verb</i><br><ol><li>(transitive) to leave</li><li>(transitive) to throw out</li><li>(transitive) to lose</li><li>(transitive) to overthrow</li></ol>
нулми|nūlmī|нулмӣ|nulmī|нӯлмӣ	<i>verb</i><br><ol><li>(transitive) to kindle</li><li>(intransitive) to smoke</li><li>(transitive) to remove hair from a pelt</li></ol>
нуме|nume	<i>noun</i><br><ol><li>habit, custom</li></ol>
нуңан	<i>pron</i><br><ol><li>he</li></ol>
нэкун|nəkun	<i>noun</i><br><ol><li>younger brother</li></ol>
нэлки|nəlki	<i>noun</i><br><ol><li>spring</li></ol>
нэми|нэ̄мӣ|nə̄mī	<i>verb</i><br><ol><li>(transitive) to put</li><li>(transitive) to award</li><li>(transitive) to accept</li><li>(transitive) to elect</li><li>(transitive) to drop</li><li>(intransitive) to sweat</li></ol><br><i>noun</i><br><ol><li>doe (wild female deer)</li></ol>
нэмкун|nəmkun	<i>adj</i><br><ol><li>thin</li></ol>
нэптэкун|nəptəkun	<i>adj</i><br><ol><li>low</li></ol>
нэрэнӈэри|нэрэнӈэрӣ|nərənŋərī	<i>noun</i><br><ol><li>lark</li></ol>
нюр|ņur	<i>noun</i><br><ol><li>arrow</li></ol>
нюриктэ|ņuriktə	<i>noun</i><br><ol><li>hair</li></ol>
нюӈи|ņuŋī|нюӈӣ	<i>adj</i><br><ol><li>sixth</li></ol>
нюӈняки|ņuŋņakī|нюӈнякӣ	<i>noun</i><br><ol><li>goose</li></ol>
нюӈун|ņuŋun	<i>num</i><br><ol><li>six</li></ol>
няма|ņama	<i>adj</i><br><ol><li>warm</li></ol>
нямади|ņamaʒi	<i>num</i><br><ol><li>hundred</li></ol>
нярут|ня̄рут|ņārut	<i>noun</i><br><ol><li>lake</li></ol>
няңня|няӈня|ņaŋņa	<i>noun</i><br><ol><li>dirt, mud</li><li>sky, heaven</li></ol>
няңта	<i>noun</i><br><ol><li>nut, walnut</li></ol>
нёгу|ņōgū|нё̄гӯ	<i>adj</i><br><ol><li>first</li></ol>
овур|owur	<i>noun</i><br><ol><li>bosom, breast</li></ol>
окин|okin	<i>pron</i><br><ol><li>when</li></ol>
окин-да|okin-da	<i>adv</i><br><ol><li>always</li></ol>
олгокин|olgokin	<i>adj</i><br><ol><li>dry</li></ol>
олгоми|olgomī|олгомӣ	<i>verb</i><br><ol><li>(intransitive) to dry</li></ol>
олдон|oldon	<i>noun</i><br><ol><li>side</li><li>wall</li></ol>
олло|ollo	<i>noun</i><br><ol><li>fish</li></ol>
омакта|omakta	<i>adj</i><br><ol><li>new</li></ol>
оми|о̄мӣ|ōmī	<i>verb</i><br><ol><li>(transitive) to do</li><li>(transitive) to make</li><li>(transitive) to build</li><li>(transitive) to solve</li><li>(transitive) to devote</li><li>(copulative) to become</li><li>(intransitive) to appear</li><li>(intransitive) to happen</li><li>(intransitive) to come to</li><li>(intransitive) to get better</li></ol>
омкото|omkoto	<i>noun</i><br><ol><li>forehead</li></ol>
омолги|omolgi	<i>noun</i><br><ol><li>grandson</li></ol>
омӈоми|omŋomī|омӈомӣ	<i>verb</i><br><ol><li>(transitive) to forget</li></ol>
орокон|orokōn	<i>noun</i><br><ol><li>clavicle</li></ol>
орокто|orokto	<i>noun</i><br><ol><li>dried grass, hay</li></ol>
орон|oron	<i>noun</i><br><ol><li>deer</li></ol>
осикта|osikta	<i>noun</i><br><ol><li>nail (on fingers/toes)</li><li>star</li></ol>
осиктачи|о̄сиктачӣ|ōsiktaçī	<i>adj</i><br><ol><li>stellar</li></ol>
ота|ota	<i>noun</i><br><ol><li>wave</li></ol>
оңокто|oŋokto|оӈокто|ongokto	<i>noun</i><br><ol><li>nose</li></ol>
пурта|purta	<i>noun</i><br><ol><li>knife</li></ol>
савкан|sawkan	<i>noun</i><br><ol><li>habit</li></ol>
сагды|sagdi	<i>adj</i><br><ol><li>old (e.g. person)</li></ol>
саканин|sakaņin	<i>noun</i><br><ol><li>pike (fish)</li></ol>
саман|сама̄нӈи|şamān|сама̄сэлдула̄|сама̄сэлтыкӣ|сама̄сэлэ|сама̄ндӯ|сама̄сэлдулӣ|сама̄сэл|шама̄н|сама̄ндулӣ|сама̄сэлдук|hamān|сама̄сэлӈи|сама̄нгит|сама̄нди|сама̄сэлдӯ|сама̄клӣ|сама̄сэлди|сама̄нэ|хаман|samān|сама̄сэлвэ|сама̄кла̄|шаман|сама̄сэлнун|сама̄н|сама̄ндук|сама̄сэликлӣ|сама̄сэлгит|сама̄нмэ|сама̄ннун|хама̄н|сама̄нтыкӣ|сама̄сэликла̄|сама̄ндула̄	<i>noun</i><br><ol><li>shaman</li></ol>
самасик|samasik	<i>noun</i><br><ol><li>shamanic robes</li></ol>
сами|samī|самӣ	<i>verb</i><br><ol><li>(transitive) to know</li></ol>
самэлки|saməlki	<i>noun</i><br><ol><li>sign</li></ol>
саргака|sargaka	<i>noun</i><br><ol><li>perch (fish)</li></ol>
саримикта|sarimikta	<i>noun</i><br><ol><li>(anatomy) eyebrow</li></ol>
саримиктал|sarimiktal	<i>noun</i><br><ol><li>eyelash</li></ol>
саңар|sangar	<i>noun</i><br><ol><li>hole</li></ol>
саңнян	<i>noun</i><br><ol><li>smoke</li></ol>
седями|seʒami	<i>verb</i><br><ol><li>to chew</li></ol>
секта|sekta	<i>noun</i><br><ol><li>willow</li></ol>
семи|sēmī|се̄мӣ	<i>verb</i><br><ol><li>(transitive) to chew</li><li>(transitive) to gnaw through</li><li>(intransitive) to champ; to slurp</li></ol>
сен|се̄н|sēn	<i>noun</i><br><ol><li>ear</li></ol>
серун|се̄рун|sērun	<i>noun</i><br><ol><li>rainbow</li></ol>
сеӈан|се̄ӈан|sēŋan	<i>noun</i><br><ol><li>burbot (fish)</li></ol>
си|si	<i>pron</i><br><ol><li>you (singular)</li></ol>
сигун|сигӯн|sigūn	<i>noun</i><br><ol><li>sun</li></ol>
силгивун|силгивӯн|şilgiwūn|хилгивун|hilgiwūn|шилгивун|шилгивӯн|хилгивӯн|silgiwūn	<i>noun</i><br><ol><li>awl</li></ol>
силкими|silkimī|силкимӣ	<i>verb</i><br><ol><li>(transitive) to wash; to wring (clothes)</li></ol>
силэ|silə	<i>noun</i><br><ol><li>soup; broth</li></ol>
сими|сӣмӣ|sīmī	<i>verb</i><br><ol><li>(transitive) to extinguish</li><li>(transitive) to bag (when hunting or fishing)</li></ol>
симңун	<i>noun</i><br><ol><li>shadow</li></ol>
синмами|синмамӣ|sinmamī	<i>verb</i><br><ol><li>(transitive) to choose; to elect</li></ol>
сирба|sirba	<i>noun</i><br><ol><li>soup</li></ol>
сируги|сиругӣ|sirugī	<i>noun</i><br><ol><li>sand</li></ol>
сиңама	<i>adj</i><br><ol><li>yellow</li></ol>
сиңэрэкэн|сиӈэрэкэн|siŋərəkən|singereken	<i>noun</i><br><ol><li>mouse; rat</li></ol>
согдонно|sogdonno	<i>noun</i><br><ol><li>the back</li></ol>
соӈоми|soŋomī|соӈомӣ	<i>verb</i><br><ol><li>(intransitive) to weep; to cry</li></ol>
су|su	<i>pron</i><br><ol><li>you</li></ol>
суги|sugi	<i>noun</i><br><ol><li>storm</li></ol>
сукэ|suke	<i>noun</i><br><ol><li>axe</li></ol>
сулаки|sulakī|сулакӣ	<i>noun</i><br><ol><li>fox</li></ol>
сунюрин|suņurin	<i>noun</i><br><ol><li>pig</li></ol>
суңта	<i>adj</i><br><ol><li>deep</li></ol>
сэксэ|сэ̄ксэ|sə̄ksə	<i>noun</i><br><ol><li>blood</li></ol>
сэлэ|sələ	<i>noun</i><br><ol><li>iron (Fe)</li></ol>
сэмту|səmtu	<i>noun</i><br><ol><li>rust</li></ol>
сэривми|сэривмӣ|səriwmī	<i>verb</i><br><ol><li>(transitive) to wake</li><li>(intransitive) to wake up</li></ol>
тактыкаг|taktikāg|тактыка̄г	<i>noun</i><br><ol><li>hazel</li></ol>
тала|tala	<i>adv</i><br><ol><li>there</li></ol>
тамами|тамамӣ|tamamī	<i>verb</i><br><ol><li>(transitive) to pay</li></ol>
таман|taman	<i>noun</i><br><ol><li>price</li></ol>
тамнакса|tamnaksa	<i>noun</i><br><ol><li>fog</li></ol>
тар|tar	<i>pron</i><br><ol><li>that</li></ol>
татын|tatin	<i>noun</i><br><ol><li>habit</li></ol>
таӈми|taŋmī|таӈмӣ	<i>verb</i><br><ol><li>(transitive, intransitive) to read</li><li>(transitive, intransitive) to count</li></ol>
того|togo	<i>noun</i><br><ol><li>fire</li><li>warmth, heat</li><li>(Upper Aldan) lightning</li></ol>
толгоки|tolgokī	<i>noun</i><br><ol><li>sledge, sleigh, sled (a vehicle on runners, used for conveying loads over the snow or ice)</li></ol>
толкин|tolkin	<i>noun</i><br><ol><li>dream</li></ol>
томко|tomko	<i>noun</i><br><ol><li>thread</li></ol>
тугэни|tugəņi	<i>noun</i><br><ol><li>winter</li></ol>
туксами|туксамӣ|tuksamī	<i>verb</i><br><ol><li>(intransitive, of humans) to run</li></ol>
туксу|тӯксу|tūksu	<i>noun</i><br><ol><li>cloud</li></ol>
тулигидэ|tuligidə	<i>noun</i><br><ol><li>courtyard</li></ol>
тулигу|tuligu	<i>adj</i><br><ol><li>outer</li></ol>
тунңа|тунӈа|tunŋa	<i>num</i><br><ol><li>five</li></ol>
тунӈа|tunŋa	<i>num</i><br><ol><li>five</li></ol>
тунӈи|tunŋī|тунӈӣ	<i>adj</i><br><ol><li>fifth</li></ol>
тураки|turakī|туракӣ	<i>noun</i><br><ol><li>jackdaw</li></ol>
турими|turimi	<i>verb</i><br><ol><li>to hold up</li></ol>
туринми|turinmi	<i>verb</i><br><ol><li>to stop</li></ol>
турлаки|turlaki	<i>noun</i><br><ol><li>jackdaw</li></ol>
турукэ|turukə	<i>noun</i><br><ol><li>salt</li></ol>
турэн|турэ̄н|turə̄n	<i>noun</i><br><ol><li>language</li><li>speech</li></ol>
тутэкэн|тутэкэ̄н|tutəkə̄n	<i>noun</i><br><ol><li>sword</li></ol>
туӈэр|tuŋə̄r|туӈэ̄р	<i>noun</i><br><ol><li>lake</li></ol>
тыгдэ|tigdə	<i>noun</i><br><ol><li>rain</li></ol>
тылэ|tilə	<i>noun</i><br><ol><li>bear</li></ol>
тымани|timaņi	<i>noun</i><br><ol><li>morning</li></ol>
тыматиэ|timatiə	<i>adv</i><br><ol><li>tomorrow</li></ol>
тынмукит|tīnmukīt|ты̄нмукӣт	<i>noun</i><br><ol><li>freedom</li></ol>
тыпкэн|tipkən	<i>noun</i><br><ol><li>nail (fastener)</li></ol>
тыргани|tirgaņī|тырганӣ	<i>noun</i><br><ol><li>day</li></ol>
тэвми|тэвмӣ|təwmī	<i>verb</i><br><ol><li>(transitive) to put</li><li>(transitive) to load</li><li>(transitive) to dress up</li><li>(intransitive) to get up (in the morning)</li></ol>
тэгэми|тэгэмӣ|təgəmī	<i>noun</i><br><ol><li>tomorrow</li></ol><br><i>verb</i><br><ol><li>(intransitive) to sit down</li><li>(intransitive) to sit up on the bed (in the morning)</li><li>(intransitive) to be sedentary; to live on a fixed location</li></ol>
тэгэр|təgər	<i>noun</i><br><ol><li>foundation</li><li>root</li></ol>
тэде|təʒe	<i>noun</i><br><ol><li>faith, belief</li></ol>
тэй|tey	<i>pron</i><br><ol><li>that</li></ol>
тэли|təli	<i>adv</i><br><ol><li>then</li></ol>
тэн|tə̄n|тэ̄н	<i>noun</i><br><ol><li>tree</li></ol>
тэру|təru	<i>noun</i><br><ol><li>time</li></ol>
угиривми|ugiriwmi	<i>verb</i><br><ol><li>to ascend</li></ol>
угиски|ugiski	<i>adv</i><br><ol><li>up</li></ol>
угу|ugu	<i>adj</i><br><ol><li>upper</li></ol>
удун|udun	<i>noun</i><br><ol><li>rain</li></ol>
уксэ|uksə	<i>noun</i><br><ol><li>sleeve</li></ol>
укумни|ukumņī|укумнӣ	<i>noun</i><br><ol><li>milk</li></ol>
укун|ukun	<i>noun</i><br><ol><li>breast</li></ol>
уливун|uliwun	<i>noun</i><br><ol><li>oar, paddle</li></ol>
улими|ulīmī|улӣмӣ	<i>verb</i><br><ol><li>(transitive) to feed</li><li>(intransitive) to row; to paddle</li></ol>
уллими|ullīmī|уллӣмӣ	<i>verb</i><br><ol><li>(transitive) to sew</li></ol>
уллэ|ullə	<i>noun</i><br><ol><li>meat</li></ol>
улуки|улукӣ|ulukī	<i>noun</i><br><ol><li>squirrel</li></ol>
улэк|ulək	<i>noun</i><br><ol><li>a lie</li></ol>
улэми|ulə̄mī|улэмӣ|uləmī|улэ̄мӣ	<i>verb</i><br><ol><li>(transitive) to spawn (roe)</li><li>(transitive) to rip open</li><li>(transitive) to put into a cauldron</li><li>(transitive) to cook</li><li>(transitive) to brew; to make (tea)</li><li>(transitive) to dig</li></ol>
умми|ummī|уммӣ	<i>verb</i><br><ol><li>(transitive, intransitive) to drink</li><li>(transitive) to send</li></ol>
умук|umuk	<i>noun</i><br><ol><li>nest</li></ol>
умукта|umūkta|умӯкта	<i>noun</i><br><ol><li>egg</li></ol>
умун|umūn|умӯн	<i>num</i><br><ol><li>one</li></ol>
умунду|umundu	<i>adv</i><br><ol><li>together</li></ol>
умэки|умэкӣ|uməkī	<i>noun</i><br><ol><li>thigh (of an animal)</li></ol>
унми|ūnmī|ӯнмӣ	<i>verb</i><br><ol><li>(intransitive) to melt</li></ol>
унта|unta	<i>noun</i><br><ol><li>shoes</li></ol>
унңу	<i>noun</i><br><ol><li>a smell</li></ol>
ур|ur	<i>noun</i><br><ol><li>belly</li></ol>
ургэ|urgə	<i>adj</i><br><ol><li>heavy</li></ol>
урим|urim	<i>adj</i><br><ol><li>grey</li></ol>
уркэ|urkə	<i>noun</i><br><ol><li>door</li></ol>
урумкун|urumkun	<i>adj</i><br><ol><li>short</li></ol>
урэ|urə	<i>noun</i><br><ol><li>mountain</li></ol>
урэкэн|urəkən	<i>noun</i><br><ol><li>hill</li></ol>
урэлды|urəldi	<i>adj</i><br><ol><li>similar</li></ol>
уюктами|ujuktamī|уюктамӣ	<i>verb</i><br><ol><li>(intransitive, of birds) to swim</li><li>(intransitive, of children) to crawl</li></ol>
уңурэ|ungure	<i>noun</i><br><ol><li>middle</li></ol>
уӈикта|uŋīkta|уӈӣкта	<i>noun</i><br><ol><li>blood vessel</li></ol>
хайласун|hajlasun	<i>noun</i><br><ol><li>elm</li></ol>
хакин|hakin	<i>noun</i><br><ol><li>liver</li></ol>
халган|halgan	<i>noun</i><br><ol><li>foot, leg</li></ol>
халка|halka	<i>noun</i><br><ol><li>hammer</li></ol>
ханян|haņan	<i>noun</i><br><ol><li>shadow</li></ol>
ханячувка|haņaçuwka	<i>noun</i><br><ol><li>mirror</li></ol>
ханңга|hannga	<i>noun</i><br><ol><li>palm (of the hand)</li></ol>
ханңуктами	<i>verb</i><br><ol><li>to ask</li></ol>
хее|heje	<i>noun</i><br><ol><li>swamp</li></ol>
хелаки|хе̄лакӣ|hēlakī	<i>noun</i><br><ol><li>partridge</li></ol>
хигин|higin	<i>noun</i><br><ol><li>storm</li></ol>
хикэн|hikən	<i>noun</i><br><ol><li>breast</li></ol>
хилбик|hilbik	<i>noun</i><br><ol><li>burbot (fish)</li></ol>
хима|hima	<i>adj</i><br><ol><li>fast, speedy</li></ol>
химамэ|himamə	<i>adj</i><br><ol><li>fast, speedy</li></ol>
хисэлэ|хисэлэ̄|hisələ̄	<i>noun</i><br><ol><li>lizard</li></ol>
хокто|hokto	<i>noun</i><br><ol><li>way</li><li>path</li><li>trail</li></ol>
хомоты|хомо̄ты|homōti	<i>noun</i><br><ol><li>bear</li></ol>
хоролдёми|хоролдёмӣ|horolʒomī	<i>verb</i><br><ol><li>(intransitive) to twirl</li><li>(intransitive) to dance</li></ol>
хувдеми|huwʒemī|хувдемӣ	<i>verb</i><br><ol><li>(transitive) to blow; to fan (a fire)</li></ol>
хувун|huvun	<i>noun</i><br><ol><li>saw (tool)</li></ol>
хуги|hugi	<i>noun</i><br><ol><li>nest</li></ol>
хуе|huye	<i>noun</i><br><ol><li>wound</li></ol>
хукэн|хукэ̄н|hukeen	<i>noun</i><br><ol><li>craw, crop</li></ol>
хула|hula	<i>noun</i><br><ol><li>aspen</li></ol>
хулама|hulama	<i>adj</i><br><ol><li>red</li></ol>
хулла|hulla	<i>noun</i><br><ol><li>blanket</li></ol>
хулэптэн|huləptən	<i>noun</i><br><ol><li>ash</li></ol>
хунами|hunami	<i>verb</i><br><ol><li>to saw</li></ol>
хунат|hunat	<i>noun</i><br><ol><li>daughter</li><li>girl</li></ol>
хусивун|husivun	<i>noun</i><br><ol><li>razor</li></ol>
хусчами|хусчамӣ|husçamī	<i>verb</i><br><ol><li>(transitive) to reap</li><li>(transitive) to shave</li></ol>
хутэ|hutə	<i>noun</i><br><ol><li>son or daughter, male or female child</li></ol>
хуюдеми|хуюдемӣ|hujuʒemī	<i>verb</i><br><ol><li>(transitive, intransitive) to boil</li></ol>
хэгды|həgdi	<i>adj</i><br><ol><li>big</li></ol>
хэдюн|həʒun	<i>noun</i><br><ol><li>upper lip</li></ol>
хэе|heye	<i>noun</i><br><ol><li>forehead</li></ol>
хэку|heku	<i>adj</i><br><ol><li>hot</li></ol>
хэмун|həmun	<i>noun</i><br><ol><li>lower lip</li><li>mouth</li></ol>
хэнңэн|henngen	<i>noun</i><br><ol><li>knee</li></ol>
хэргиски|hərgiski	<i>adv</i><br><ol><li>down</li></ol>
хэргу|hergu	<i>adj</i><br><ol><li>lower</li></ol>
хэрки|hərki	<i>noun</i><br><ol><li>pants, trousers</li></ol>
хэрэ|hərə	<i>noun</i><br><ol><li>bottom</li></ol>
хэңкэ	<i>noun</i><br><ol><li>language</li></ol>
чагамкура|чагамкура̄|çagamkurā	<i>noun</i><br><ol><li>oak</li></ol>
чалбан|çālban|ча̄лбан	<i>noun</i><br><ol><li>birch</li></ol>
часивки|çasiwki	<i>noun</i><br><ol><li>pike (fish)</li></ol>
чивукчак|çiwukçāk|чивукча̄к	<i>noun</i><br><ol><li>sparrow</li></ol>
чипича|çipiçā|чипича̄	<i>noun</i><br><ol><li>sparrow</li></ol>
чипкан|çipkan	<i>noun</i><br><ol><li>sable</li></ol>
чирукай|çirukaj	<i>noun</i><br><ol><li>pike (fish)</li></ol>
чоли|чолӣ|çolī	<i>noun</i><br><ol><li>tongue (organ)</li></ol>
чуксэ|çuksə	<i>noun</i><br><ol><li>juice</li></ol>
чулама|çulama	<i>adj</i><br><ol><li>blue</li></ol>
чумни|çumņi	<i>noun</i><br><ol><li>pine cone</li></ol>
чэмэл|çəməl	<i>noun</i><br><ol><li>seed</li></ol>
эвидеми|əwīʒemī|эвӣдемӣ	<i>verb</i><br><ol><li>(transitive, intransitive) to play</li></ol>
эвин|əwin	<i>noun</i><br><ol><li>play, game</li></ol>
эвми|əwmi	<i>verb</i><br><ol><li>to destroy</li></ol>
эвтэл|əwtəl	<i>noun</i><br><ol><li>lung</li></ol>
эвэнки|əwənkī|эвэмнӣ|эвэнкӣ	<i>noun</i><br><ol><li>Evenk, Evenki (person)</li></ol>
эден|əʒen	<i>noun</i><br><ol><li>host</li><li>master, lord</li></ol>
эду|ədu	<i>adv</i><br><ol><li>here</li></ol>
эды|ədi	<i>noun</i><br><ol><li>husband</li></ol>
эдын|ədin	<i>noun</i><br><ol><li>wind</li></ol>
эдынми|эдынмӣ|ədinmī	<i>verb</i><br><ol><li>to blow</li></ol>
эендеми|əjenʒemi	<i>verb</i><br><ol><li>to flow</li></ol>
экин|əkin	<i>noun</i><br><ol><li>elder sister</li></ol>
экун|əkun	<i>pron</i><br><ol><li>what</li></ol>
экэри|əkəri	<i>noun</i><br><ol><li>dandruff</li></ol>
элбэскэтчэми|əlbəskətçəmi	<i>verb</i><br><ol><li>to bathe</li></ol>
элбэсчэми|əlbəsçəmi	<i>verb</i><br><ol><li>to swim</li></ol>
элла|əlla	<i>noun</i><br><ol><li>coal</li></ol>
элэкэсипты|ələkəsipti	<i>adj</i><br><ol><li>first</li></ol>
эмугдэ|əmugdə	<i>noun</i><br><ol><li>innards, entrails</li></ol>
эмэр|əmər	<i>adj</i><br><ol><li>sharp</li></ol>
энимкун|enyimkun	<i>adj</i><br><ol><li>light (of weight)</li></ol>
энин|əņin	<i>noun</i><br><ol><li>mother</li></ol>
энумук|ənumuk	<i>noun</i><br><ol><li>sickness</li></ol>
эр|ər	<i>pron</i><br><ol><li>this</li></ol>
эрин|ərin	<i>noun</i><br><ol><li>breath</li></ol>
эрэгэр|ərəgər	<i>adv</i><br><ol><li>at all, completely, permanently</li></ol>
эса|əsa	<i>noun</i><br><ol><li>eye</li></ol>
эңэси	<i>adj</i><br><ol><li>strong</li></ol><br><i>noun</i><br><ol><li>strength</li></ol>
эӈуктэ|эӈуктэвэ|эӈуктэлгит|эӈуктэклӣ|эӈуктэлтыкӣ|эӈуктэликлӣ|эӈуктэлдулӣ|эӈуктэгит|эӈуктэлвэ|эӈуктэнун|эӈуктэклэ̄|эӈуктэдук|эӈуктэл|əŋuktə|эӈуктэлнун|эӈуктэлнги|əŋuktə-l|эӈуктэлэ̄|эӈуктэлдиклэ̄|эӈуктэе|эӈуктэнги|эӈуктэт|эӈуктэлди|эӈуктэ-л|эӈуктэлдӯ|эӈуктэлулэ̄|эӈуктэлӣ|эӈуктэлъе|эӈуктэлдук|эӈуктэткӣ	<i>noun</i><br><ol><li>onion</li></ol>
юми|jumi	<i>verb</i><br><ol><li>to go out, to exit</li></ol>
ңалэ|ŋalə|ӈа̄лэ|ӈалэ|ŋālə	<i>noun</i><br><ol><li>hand</li><li>arm</li></ol>
ңанмакта	<i>noun</i><br><ol><li>mosquito</li></ol>
ңи|ngi	<i>pron</i><br><ol><li>who</li></ol>
ңинакин|ӈинакин|ŋinakin	<i>noun</i><br><ol><li>dog</li></ol>
ңиңтэ	<i>noun</i><br><ol><li>root</li></ol>
ңо|ңo	<i>noun</i><br><ol><li>unpleasant smell</li></ol>
ңоним|ngonim	<i>adj</i><br><ol><li>long</li></ol>
ңэри|ӈэ̄ри|ӈэри|ŋə̄ri|ŋəri	<i>noun</i><br><ol><li>light</li></ol>
ңэрипчу	<i>adj</i><br><ol><li>bright</li></ol>
ӈэлэтчэми|ŋələtçəmi	<i>verb</i><br><ol><li>to fear; to be scared</li></ol>
ӈэнэдеми|ŋənəʒemi	<i>verb</i><br><ol><li>to go</li></ol>
