A|a	<i>character</i><br><ol><li>The first letter of the Fula alphabet, called a and written in the Latin script.</li></ol>
Boɗaaɗo|Woɗaaɓe ɓe|Boɗaaɗo o|Woɗaaɓe	<i>noun</i><br><ol><li>member of a subgroup of nomadic Fulas native to the eastern Sahel.</li></ol>
Fulfulde	<i>name</i><br><ol><li>Fula language</li></ol>
Haalpulaar|Haalpulaar o|Haalpulaar'en|Haalpulaar'en ɓe	<i>noun</i><br><ol><li>a person who speaks Pulaar or Pular</li><li>a member of the Toucouleur people</li></ol>
Motti	<i>name</i><br><ol><li>Mopti (a city in central Mali)</li></ol>
Pulaar	<i>name</i><br><ol><li>Fula language</li></ol>
Pular	<i>name</i><br><ol><li>Fula language</li></ol>
Pullo|Fulɓe ɓe|Pullo o|Fulɓe	<i>noun</i><br><ol><li>a member of the Fula people</li></ol>
Teenengu	<i>name</i><br><ol><li>Tenenkou (a town in central Mali)</li></ol>
a|A	<i>character</i><br><ol><li>The first letter of the Fula alphabet, written in the Latin script.</li></ol><br><i>pron</i><br><ol><li>you (second person singular subject pronoun; short form)</li></ol>
aada|aada o|aadaaji ɗi	<i>noun</i><br><ol><li>custom, tradition</li></ol>
aadagol	<i>verb</i><br><ol><li>(intransitive) to make a decision, decide</li><li>to conclude an accord, make an agreement, give one's word</li></ol>
aadanagol	<i>verb</i><br><ol><li>(transitive) to commit oneself, to promise (to do something), to swear</li></ol>
aaden|aaden o	<i>noun</i><br><ol><li>human, person</li></ol>
aadi|aadi o|aadiiji|aadiiji ɗi	<i>noun</i><br><ol><li>covenant, pact</li></ol>
aafiya|aafiya o	<i>noun</i><br><ol><li>health, well-being</li></ol>
aahiijo|aahiijo o|aahiiɓe ɓe	<i>noun</i><br><ol><li>a Quran student</li></ol>
aala|aala o	<i>noun</i><br><ol><li>tool, instrument</li></ol>
aali|aaliiɓe ɓe	<i>noun</i><br><ol><li>family, clan, lineage</li></ol>
aan	<i>pron</i><br><ol><li>you (second person singular emphatic pronoun)</li></ol>
aanyeere|aanyeere nde|aanyeeje ɗe	<i>noun</i><br><ol><li>grave, tomb</li></ol>
aawdi|aawdi ndi|aawɗi ɗi|awdiiji ɗi|aawdiiji ɗi|awdi|awdi ndi	<i>noun</i><br><ol><li>seed (that which is sown or planted)</li></ol>
aawoowo	<i>noun</i><br><ol><li>sower</li></ol>
aawugol	<i>verb</i><br><ol><li>(transitive) to sow, to plant seed</li></ol>
abada	<i>adv</i><br><ol><li>never</li></ol>
abadan	<i>adv</i><br><ol><li>never</li></ol>
abbere|gabbe	<i>noun</i><br><ol><li>grain, seed</li></ol>
acaari|accaari ndi|accaari|acaari ndi	<i>noun</i><br><ol><li>(Adamawa) fonio (Digitaria exilis)</li></ol>
accitugol	<i>verb</i><br><ol><li>(transitive) to release, let go</li></ol>
adaade	<i>conj</i><br><ol><li>before (with verb phrase)</li><li>before (with noun phrase)</li></ol>
adadu|adadu o	<i>noun</i><br><ol><li>total, sum</li><li>number, figure</li></ol>
adala|adali	<i>noun</i><br><ol><li>(anatomy) muscle</li></ol>
adugol	<i>verb</i><br><ol><li>(transitive) to transport</li></ol>
adunaaru|adunaaru ndu	<i>noun</i><br><ol><li>the world, the earth</li><li>the people of the world</li></ol>
alaa	<i>particle</i><br><ol><li>there is not, there is no</li><li>not</li><li>no</li></ol>
alaadu|galaaɗi ɗi|alaadu ndu	<i>noun</i><br><ol><li>horn</li></ol>
alhan|alhan o	<i>noun</i><br><ol><li>brass, iron</li></ol>
aljam	<i>noun</i><br><ol><li>(Adamawa) thorn apple</li></ol>
aljanna|aljanna o	<i>noun</i><br><ol><li>(Islam) Paradise, Jannah</li></ol>
am	<i>det</i><br><ol><li>(possessive) my</li></ol>
an	<i>det</i><br><ol><li>(possessive) Alternative form of am (my).</li></ol><br><i>pron</i><br><ol><li>second person singular emphatic pronoun you</li></ol>
annabi|annabi o|annabaaɓe|annabaaɓe ɓe	<i>noun</i><br><ol><li>(Pulaar) prophet (one who speaks by divine inspiration)</li></ol>
anndal|anndal ngal|annde ɗe	<i>noun</i><br><ol><li>knowledge, science</li></ol>
anndintinagol	<i>verb</i><br><ol><li>(intransitive) to announce oneself, declare oneself, make a sign of one's presence</li></ol>
anndugol	<i>verb</i><br><ol><li>to know, feel</li></ol>
annoora	<i>noun</i><br><ol><li>light</li></ol>
arma	<i>particle</i><br><ol><li>(Literary) forms the future tense</li></ol>
arsi|arsi o	<i>noun</i><br><ol><li>the divine throne, sky, heavens</li></ol>
arsikegol	<i>verb</i><br><ol><li>to be lucky</li></ol>
arugol	<i>verb</i><br><ol><li>(intransitive) to come, arrive</li></ol>
arɗo|arɗo o|arɓe ɓe	<i>noun</i><br><ol><li>leader, guide, ruler</li><li>conqueror, winner, victor</li></ol>
asama|'asamaaji ɗi|asama nga	<i>noun</i><br><ol><li>sky</li></ol>
asamaa'u|asamaa'u o	<i>noun</i><br><ol><li>sky, firmament, heavens</li></ol>
asangal|asangal ngal|asaale ɗe	<i>noun</i><br><ol><li>pelvis, hip</li><li>thigh</li></ol>
asko|asko ngo	<i>noun</i><br><ol><li>lineage, genealogy, ancestry</li></ol>
asugol	<i>verb</i><br><ol><li>(transitive, active) to dig, excavate</li></ol>
awotooɗo|awotooɗo o	<i>noun</i><br><ol><li>fisherman, fisher</li></ol>
awru|awruuji	<i>noun</i><br><ol><li>seed</li></ol>
aɗa|hiɗa	<i>pron</i><br><ol><li>you (second person singular subject pronoun; long form)</li></ol>
b|B	<i>character</i><br><ol><li>The third letter of the Fula alphabet, written in the Latin script.</li></ol>
ba	<i>particle</i><br><ol><li>question-forming interrogative particle (expressing doubt)</li></ol>
baafata	<i>noun</i><br><ol><li>aluminum</li></ol>
baagol|baagol ngol	<i>noun</i><br><ol><li>harvest</li></ol>
baalii|baali	<i>noun</i><br><ol><li>sheep</li></ol>
baaso|waasuɓe ɓe|baaso o	<i>noun</i><br><ol><li>poor person, pauper</li></ol>
baawɗe|baawɗe ɗe	<i>noun</i><br><ol><li>power, means, capacity</li></ol>
baharu	<i>noun</i><br><ol><li>sea, ocean</li></ol>
baka|baka o	<i>noun</i><br><ol><li>(clothing) tunic, boubou, agbada</li></ol>
bakkaatu	<i>noun</i><br><ol><li>sin</li></ol>
balangol|balangol ngol|balaɗi ɗi	<i>noun</i><br><ol><li>road, path, route</li></ol>
balanngaaru|balanngaaru ndu	<i>noun</i><br><ol><li>stretcher</li></ol>
ballal|balli|balli ɗi|ballal ngal	<i>noun</i><br><ol><li>help, aid</li><li>collective work</li></ol>
bappoore|bappoore nde|bappooje ɗe	<i>noun</i><br><ol><li>type of fish, Lates niloticus</li></ol>
barkingol	<i>verb</i><br><ol><li>intransitive to have divine grace, be blessed</li><li>(transitive) (of God) to bless</li></ol>
bataake|ɓataake	<i>noun</i><br><ol><li>letter, epistle</li></ol>
bayillo|wayluɓe ɓe|bayillo o	<i>noun</i><br><ol><li>blacksmith</li></ol>
bee	<i>particle</i><br><ol><li>it must, it is necessary that</li></ol>
bifi|bifi ɗi	<i>noun</i><br><ol><li>harmattan</li></ol>
bimmbi	<i>adv</i><br><ol><li>in the morning</li></ol>
binndi|binndi ɗi	<i>noun</i><br><ol><li>writing, piece of writing</li></ol>
binndo|binndo o|winndooɓe ɓe	<i>noun</i><br><ol><li>writer, scribe</li></ol>
bolol|boli|bolol ngol	<i>noun</i><br><ol><li>path, road, main artery of a village</li></ol>
bolondaa	<i>noun</i><br><ol><li>enlarged family, clan, tribe</li></ol>
bufenri	<i>noun</i><br><ol><li>snow</li></ol>
buguuru|buguuru ndu|buguruuji ɗi	<i>noun</i><br><ol><li>grass hut, shelter made of grass</li><li>herder's hut</li></ol>
bukkaaru|bukkaaji ɗi|bukkaaru ndu	<i>noun</i><br><ol><li>booth, grass shelter, esp. of herdsmen</li></ol>
bullal|bulle	<i>noun</i><br><ol><li>thorn</li></ol>
buuru|buuruuje ɗe|buuru o	<i>noun</i><br><ol><li>bread</li><li>hyena</li></ol>
c|C	<i>character</i><br><ol><li>A letter of the Fula alphabet, written in the Latin script.</li></ol>
cabbam	<i>noun</i><br><ol><li>sweat</li></ol>
caggal	<i>prep</i><br><ol><li>after, afterward</li><li>behind</li></ol>
cappanɗe	<i>num</i><br><ol><li>a term which marks dozens starting at 30</li></ol>
carmalal|carmalle	<i>noun</i><br><ol><li>twig (used as a combustible)</li></ol>
ceekol	<i>noun</i><br><ol><li>opening, tear, slit</li></ol>
cellal|cellal ngal	<i>noun</i><br><ol><li>health, well-being</li></ol>
coggal|coggal ngal|cogge|cogge ɗe	<i>noun</i><br><ol><li>herd of cattle (or other animals)</li><li>herd of cattle (or other animals) for sale</li><li>driving a herd to market</li></ol>
coggu|cogguuli	<i>noun</i><br><ol><li>price, value</li></ol>
cokko|cokko o|cokkooɓe ɓe	<i>noun</i><br><ol><li>(familiar) cop, police officer</li></ol>
collaari	<i>noun</i><br><ol><li>dust</li></ol>
colte	<i>noun</i><br><ol><li>February</li></ol>
conndi|coneele|coneeli ɗi|conndi ndi	<i>noun</i><br><ol><li>flour</li><li>powder</li></ol>
corfol|corfi ɗi|corfol ngol	<i>noun</i><br><ol><li>path, trail</li></ol>
cukalel|cukalel ngel|cukaloy kon	<i>noun</i><br><ol><li>child</li></ol>
cuuram|cuuram ɗam	<i>noun</i><br><ol><li>milk or porridge diluted with water</li><li>milk that one drinks in the evening</li></ol>
d|D	<i>character</i><br><ol><li>A letter of the Fula alphabet, written in the Latin script.</li></ol>
daaluyee|daaluyee o	<i>noun</i><br><ol><li>the divine word, the word of God</li></ol>
daande|daaɗe ɗe	<i>noun</i><br><ol><li>neck, throat, gullet</li><li>voice</li></ol>
dahugol	<i>verb</i><br><ol><li>(transitive) to conquer, subjugate, subdue, take as spoil of war</li></ol>
dakkere|dakkere nde	<i>noun</i><br><ol><li>balls of flour cooked with steam</li></ol>
dakmugol	<i>verb</i><br><ol><li>(intransitive) to taste good, have an agreeable flavor</li></ol>
dammol|dammol kol	<i>noun</i><br><ol><li>small livestock</li></ol>
dandude	<i>verb</i><br><ol><li>(transitive) to save, secure</li></ol>
dankali	<i>noun</i><br><ol><li>sweet potato</li></ol>
dankata|dankata o	<i>noun</i><br><ol><li>help, assistance</li></ol>
dannaajo|dannaaɓe ɓe|dannaajo o	<i>noun</i><br><ol><li>hunter</li></ol>
darnugol	<i>verb</i><br><ol><li>(transitive) to stop, halt, erect (a tent or structure)</li><li>to build, construct</li><li>to begin prayer, recite the introduction to prayer</li><li>(mathematics) to solve, work out</li></ol>
debbo|debbo o|rewɓe ɓe|rewɓe	<i>noun</i><br><ol><li>woman, female</li><li>wife (spouse)</li></ol>
deftere|deftere nde|dewtere nde|dewtere|defte|defte ɗe|dewte ɗe|dewte	<i>noun</i><br><ol><li>book (collection of sheets of paper)</li></ol>
demal	<i>noun</i><br><ol><li>agriculture, farming, culture (of plants)</li></ol>
dewgal|dewle	<i>noun</i><br><ol><li>marriage, married life, conjugal relations</li></ol>
diidol|diidol ngol|diidi ɗi	<i>noun</i><br><ol><li>design, line, drawing</li><li>(astronomy) the Milky Way</li></ol>
diisagol	<i>verb</i><br><ol><li>(transitive) to consult (with someone), confer with, take counsel with</li></ol>
diiwal|diiwal ngal|diiwe ɗe	<i>noun</i><br><ol><li>(historical) province, region</li></ol>
dolokke	<i>noun</i><br><ol><li>boubou, shirt, clothing</li></ol>
donsanke|donsankooɓe ɓe|donsanke o	<i>noun</i><br><ol><li>hunter</li></ol>
dunnduuru|dunnduuji	<i>noun</i><br><ol><li>a type of large drum used by pagans</li></ol>
duroowo|durooɓe ɓe|duroowo o	<i>noun</i><br><ol><li>(Liptaako, Macina) herdsman, shepherd</li></ol>
duuɓi	<i>noun</i><br><ol><li>time, age, years</li></ol>
duɗal|duɗe ɗe|duɗal ngal	<i>noun</i><br><ol><li>islamic school</li></ol>
e|E	<i>character</i><br><ol><li>A letter of the Fula alphabet, written in the Latin script.</li></ol><br><i>conj</i><br><ol><li>and</li><li>with</li></ol>
en	<i>pron</i><br><ol><li>first person plural inclusive pronoun;short form we</li></ol>
enen	<i>pron</i><br><ol><li>first person plural inclusive; emphatic we, us</li></ol>
enɗingol	<i>verb</i><br><ol><li>(intransitive) to be someone who respects family bonds, participates in the life of one's community</li></ol>
ewnaandu|ewnaali	<i>noun</i><br><ol><li>a public notice, call to prayer</li></ol>
eɓe	<i>pron</i><br><ol><li>(Pulaar, Massina, Benin, S.W. Niger, Sokoto, Zaria, Gombe, Dageeja) third person plural pronoun;long form (they)</li></ol>
eɗen|hiɗen	<i>pron</i><br><ol><li>first person plural (inclusive) pronoun; long form (we)</li></ol>
f|F	<i>character</i><br><ol><li>A letter of the Fula alphabet, written in the Latin script.</li></ol>
faalegol	<i>verb</i><br><ol><li>(transitive) to want, desire, wish</li></ol>
faandaare|faandaareji	<i>noun</i><br><ol><li>objective, goal, intention, meaning</li></ol>
faayugol	<i>verb</i><br><ol><li>(intransitive) to make an error, err, be wrong</li></ol>
faddagol	<i>verb</i><br><ol><li>(transitive) to prevent, stop</li></ol>
faggirko	<i>noun</i><br><ol><li>hay, provender</li></ol>
fajo	<i>noun</i><br><ol><li>possibility, chance</li></ol>
falawal|falaaje	<i>noun</i><br><ol><li>handle of a tool</li></ol>
falimawal	<i>noun</i><br><ol><li>twig</li></ol>
faljere|palje	<i>noun</i><br><ol><li>error, mistake</li></ol>
falo|falo ngo	<i>noun</i><br><ol><li>cliff, slope</li></ol>
fammeere|pammeeje	<i>noun</i><br><ol><li>cave, cavern</li></ol>
fankere	<i>noun</i><br><ol><li>silence, calm</li></ol>
farilla|farilla o	<i>noun</i><br><ol><li>obligation, religious prescription</li><li>period, menstruation</li></ol>
farñitere|parñite	<i>noun</i><br><ol><li>a thunderclap, roll of thunder, lightning strike</li></ol>
fattorde	<i>noun</i><br><ol><li>refuge</li></ol>
feccere|feccere nde|pecce ɗe|pecce	<i>noun</i><br><ol><li>part (fraction of a whole)</li></ol>
feere|feere nde|pehe ɗe	<i>noun</i><br><ol><li>means, capacity, plan, artifice</li></ol><br><i>adv</i><br><ol><li>elsewhere</li></ol>
feewugol	<i>verb</i><br><ol><li>(intransitive) to be straight (of a road)</li><li>to be upright, honest</li><li>to go to</li></ol>
feeñugol	<i>verb</i><br><ol><li>(intransitive) to appear, be manifest, be visible, be perceptible</li></ol>
fello|pelle	<i>noun</i><br><ol><li>mountain</li></ol>
fellugol	<i>verb</i><br><ol><li>(transitive) to shoot at, execute</li><li>to launch a military campaign, raid</li></ol>
fenaande|fenaande nde|penaale	<i>noun</i><br><ol><li>lie, untruth, mistruth</li></ol>
fensito	<i>noun</i><br><ol><li>analysis, explanation</li></ol>
ferugol	<i>verb</i><br><ol><li>(intransitive) to emigrate, go into exile, take part in an exodus</li></ol>
fetere|pete	<i>noun</i><br><ol><li>rock, ledge</li></ol>
fettere|pette	<i>noun</i><br><ol><li>spark</li></ol>
fii honɗum	<i>adv</i><br><ol><li>why?</li></ol>
firo	<i>noun</i><br><ol><li>translation, interpretation, meaning</li></ol>
fitaare|pitaaji	<i>noun</i><br><ol><li>bush, thicket</li></ol>
fittaandu|pittaali	<i>noun</i><br><ol><li>soul, spirit</li></ol>
fiɲaare|piɲaaje ɗe|fiɲaare nde	<i>noun</i><br><ol><li>type of fish, Lates niloticus</li></ol>
fodugol	<i>verb</i><br><ol><li>(transitive) to promise</li></ol>
follere|follere nde|polle ɗe	<i>noun</i><br><ol><li>roselle (Hibiscus sabdariffa)</li><li>plant that is source of kenaf fiber (Hibiscus cannabinus)</li></ol>
fow	<i>adv</i><br><ol><li>all, all of</li></ol>
fundu|fundu ndu	<i>noun</i><br><ol><li>dust</li></ol>
fuɗugol	<i>verb</i><br><ol><li>(intransitive) to grow, germinate</li><li>to come up, rise (as the sun)</li></ol>
fuɗɗagol	<i>verb</i><br><ol><li>(transitive) to begin, commence, be the first to</li></ol>
fuɗɗoode	<i>noun</i><br><ol><li>beginning, start</li><li>preface, forward</li><li>embryo</li></ol>
g|G	<i>character</i><br><ol><li>A letter of the Fula alphabet, written in the Latin script.</li></ol>
gaanin	<i>adv</i><br><ol><li>on this side</li></ol>
ganndiɗugol	<i>verb</i><br><ol><li>(intransitive) to be wise, have wisdom</li></ol>
gatal|gate	<i>noun</i><br><ol><li>mat</li></ol>
gawri|gaweeje ɗe|gawri ndi	<i>noun</i><br><ol><li>pearl millet</li><li>millet</li></ol>
gaɗa|gaɗa o	<i>noun</i><br><ol><li>behind, bottom</li></ol>
gelenru|gelenji	<i>noun</i><br><ol><li>shin, tibia</li></ol>
geɓal|geɓal ngal|geɓe ɓe	<i>noun</i><br><ol><li>(Pular) part, portion, share, right</li></ol>
giggol|gilli	<i>noun</i><br><ol><li>love, passion, affection</li></ol>
gimɗo|yimɓe ɓe|gimɗo o|yimɓe	<i>noun</i><br><ol><li>person, human being</li></ol>
gimɗol	<i>noun</i><br><ol><li>poetry, verse</li></ol>
giyal|giyal ngal	<i>noun</i><br><ol><li>thorn</li></ol>
go'o	<i>num</i><br><ol><li>one</li></ol>
golle|golle ɗe	<i>noun</i><br><ol><li>work, occupation, job, task</li></ol>
golloowo|golloowo o|gollooɓe ɓe	<i>noun</i><br><ol><li>worker</li></ol>
gollugol	<i>verb</i><br><ol><li>(intransitive) to work</li></ol>
gomɗal	<i>noun</i><br><ol><li>faith, piety, sincerity</li></ol>
gonngol|gonɗi ɗi	<i>noun</i><br><ol><li>tear</li></ol>
goofoondi|goofooɗi ɗi|goofoondi ndi	<i>noun</i><br><ol><li>brain</li><li>bone marrow</li></ol>
goonga|goongaa ɗi|goonga ji	<i>noun</i><br><ol><li>truth</li></ol>
gooto	<i>pron</i><br><ol><li>nobody</li></ol>
gootun	<i>adj</i><br><ol><li>same</li></ol>
gorgilaaɗo|gorgilaaɗo o	<i>noun</i><br><ol><li>paternal aunt</li></ol>
gorko|worɓe ɓe|gorko o|worɓe	<i>noun</i><br><ol><li>man, male</li><li>husband (spouse)</li></ol>
goro	<i>noun</i><br><ol><li>cola</li></ol>
gurii|gurii ngii	<i>noun</i><br><ol><li>skin, hide</li></ol>
guttere|guttere nde	<i>noun</i><br><ol><li>cloud</li></ol>
h|H	<i>character</i><br><ol><li>A letter of the Fula alphabet, written in the Latin script.</li></ol>
haa	<i>adv</i><br><ol><li>until</li></ol>
haako|kaake ɗe|haako ko	<i>noun</i><br><ol><li>(botany) leaf</li></ol>
haala|haalaajii|haala ka	<i>noun</i><br><ol><li>language, dialect, idiom</li></ol>
haande	<i>conj</i><br><ol><li>in lieu of</li></ol>
hakkunde|hakkunde nde|hakkundeeji ɗi	<i>prep</i><br><ol><li>between</li><li>among</li><li>in the middle</li></ol><br><i>noun</i><br><ol><li>middle</li><li>center</li></ol>
hakkundeejo|hakkundeejo o|hakkunde'en ɓe	<i>noun</i><br><ol><li>intermediary (person)</li></ol>
hamdinagol	<i>verb</i><br><ol><li>(intransitive) to praise Allah using the phrase alhamdulillah</li></ol>
hanndugol	<i>verb</i><br><ol><li>(intransitive) to merit, be worthy of, deserve, have the right to</li></ol>
haray	<i>conj</i><br><ol><li>it will happen that, it will be that, and thus, and consequently</li></ol>
harfeere|halfeere nde|halfeere|kalfeeje ɗe|karfeeje|karfeeje ɗe|harfeere nde	<i>noun</i><br><ol><li>letter of the alphabet</li></ol>
harfu|harfu o|karfeeje ɗe	<i>noun</i><br><ol><li>syllable</li></ol>
hari	<i>particle</i><br><ol><li>particle marking the preterite</li></ol>
hayre|kaaƴe	<i>noun</i><br><ol><li>rock, stone</li></ol>
hebilagol	<i>verb</i><br><ol><li>(intransitive) to prepare, get ready</li></ol>
heege|heege nge	<i>noun</i><br><ol><li>hunger, famine</li></ol>
hello|hello ngo|hellooji ɗi	<i>noun</i><br><ol><li>a page</li><li>one side of a wall, a wall</li><li>a slap in the face</li></ol>
heyɗintingol	<i>verb</i><br><ol><li>(transitive) to renew, renovate, refurbish, restore</li></ol>
hikkagol	<i>verb</i><br><ol><li>(intransitive) to be located, be situated, be (in a certain place)</li></ol>
hikma|hikma o	<i>noun</i><br><ol><li>wisdom, knowledge</li></ol>
himo	<i>pron</i><br><ol><li>third person singular;long form he/she</li></ol>
himɓe	<i>noun</i><br><ol><li>(Western Niger dialect) Alternative form of yimɓe (people).</li></ol>
hinaa	<i>particle</i><br><ol><li>it is not, is not</li></ol>
hinney|hinney o	<i>noun</i><br><ol><li>grace</li></ol>
hippagol	<i>verb</i><br><ol><li>(transitive) to seize, plunder, loot, capture, pillage, raid</li><li>to rape</li></ol>
hisnoowo|hisnoowo o|hisinooɓe ɓe	<i>noun</i><br><ol><li>savior</li></ol>
hiɓe	<i>pron</i><br><ol><li>(Fouta-Jalon, Fouta-Toro) third person plural pronoun;long form</li></ol>
hollitugol	<i>verb</i><br><ol><li>(transitive) to announce, declare, inform</li></ol>
holɓunde	<i>noun</i><br><ol><li>ankle</li></ol>
homanagol	<i>verb</i><br><ol><li>(transitive) to covet, be jealous of, to lust after</li></ol>
hommbo	<i>pron</i><br><ol><li>who?</li></ol>
honcugol	<i>verb</i><br><ol><li>(transitive) to melt, liquify (especially of a metal)</li></ol>
honnde	<i>pron</i><br><ol><li>(interrogative) when?</li></ol>
honndu|honndu ndu|kolli ɗi	<i>noun</i><br><ol><li>finger, toe</li></ol>
honto	<i>pron</i><br><ol><li>(interogative) where?</li></ol>
honugol	<i>verb</i><br><ol><li>(transitive) to war, to wage war, combat</li><li>to conquer</li></ol>
hoodere|hoodere nde|ɗe koode	<i>noun</i><br><ol><li>star</li></ol>
hoondu	<i>noun</i><br><ol><li>(Adamawa) finger, toe</li></ol>
hoore|kohe ɗe|hoore nde|ko'e ɗe	<i>noun</i><br><ol><li>(anatomy) head</li><li>(social) head, leader</li></ol>
hooreejo|hooreejo o|hooreeɓe ɓe	<i>noun</i><br><ol><li>leader, chief, ruler</li></ol>
hoorugol	<i>verb</i><br><ol><li>(intransitive, religion) to fast, abstain from eating or drinking</li></ol>
hooti	<i>conj</i><br><ol><li>and, then, subsequently</li></ol>
howru|koppi	<i>noun</i><br><ol><li>knee</li></ol>
hoɗo|koɗooli	<i>noun</i><br><ol><li>village</li></ol>
huccere|kucce	<i>noun</i><br><ol><li>fruit pulp</li></ol>
hunnditagol	<i>verb</i><br><ol><li>(transitive) to surround, encompass</li></ol>
hunnduko|kunndule	<i>noun</i><br><ol><li>(anatomy) mouth</li><li>beak, muzzle</li><li>neck (of a bottle), opening</li></ol>
huntere|kunte	<i>noun</i><br><ol><li>a piece, part</li></ol>
huuduure	<i>noun</i><br><ol><li>(Adamawa) wound</li></ol>
huutoral	<i>noun</i><br><ol><li>utilization, employment, use</li></ol>
i|I	<i>character</i><br><ol><li>A letter of the Fula alphabet, written in the Latin script.</li></ol>
ilol	<i>noun</i><br><ol><li>torrent, current</li></ol>
innde|innde nde|inɗe ɗe	<i>noun</i><br><ol><li>name, title (of a thing or place)</li><li>name (of a person), first name</li></ol>
iwde	<i>prep</i><br><ol><li>since, from</li></ol>
iwdi|iwdi ndi	<i>noun</i><br><ol><li>origin, source</li></ol>
j|J	<i>character</i><br><ol><li>A letter of the Fula alphabet, written in the Latin script.</li></ol>
jaaraama	<i>intj</i><br><ol><li>thanks!</li></ol>
jabbaaruujo|jabbaaruujo o|jabbaaruuɓe ɓe	<i>noun</i><br><ol><li>an impious person</li></ol>
jahdodinal|jahdodinal ngal	<i>noun</i><br><ol><li>agreement</li></ol>
jalbugol	<i>verb</i><br><ol><li>(intransitive) to shine, shimmer, glow</li></ol>
janano|janano o|jananɓe ɓe	<i>noun</i><br><ol><li>stranger, guest</li></ol>
jannde	<i>noun</i><br><ol><li>reading, study</li></ol>
janngannde|jannganɗe ɗe	<i>noun</i><br><ol><li>lesson</li></ol>
janngirde|janngirde nde|janngirɗe ɗe	<i>noun</i><br><ol><li>school, classroom</li></ol>
janngo	<i>adv</i><br><ol><li>tomorrow</li></ol>
jappaajo|jappaajo o|jappaaɓe ɓe	<i>noun</i><br><ol><li>leather worker, tanner</li><li>cobbler</li></ol>
jarrabuyee|jarrabuyee o	<i>noun</i><br><ol><li>test, ordeal, temptation</li></ol>
jawdi|jawle	<i>noun</i><br><ol><li>wealth, herd, livestock</li></ol>
jawdiri|jawdiri ndi|jawɗi ɗi	<i>noun</i><br><ol><li>ram</li></ol>
jawleeru|jawleeru ndu|jawleeji ɗi	<i>noun</i><br><ol><li>guesthouse (for men only)</li><li>grass-roofed hut through which entrance is made to a compound</li></ol>
jaŋgurdu|jaŋgurduuji|jaŋgurdu ndu	<i>noun</i><br><ol><li>learning, education</li></ol>
jeegom	<i>num</i><br><ol><li>six</li></ol>
jeenayi	<i>num</i><br><ol><li>nine</li></ol>
jeetati	<i>num</i><br><ol><li>eight</li></ol>
jeeɗiɗi	<i>num</i><br><ol><li>seven</li></ol>
jetti	<i>num</i><br><ol><li>(Maasina Fulfulde) Alternative form of jeetati (eight).</li></ol>
jeɗɗi	<i>num</i><br><ol><li>(Maasina Fulfulde) Alternative form of jeeɗiɗi (seven).</li></ol>
jiidi|jiidi o	<i>noun</i><br><ol><li>procreation, descendants, children</li></ol>
jinngu|jinngu ngu|jinnguuji ɗi	<i>noun</i><br><ol><li>love</li></ol>
joga-hare|jogaaji-hare|joga-hare o	<i>noun</i><br><ol><li>weapon, arm</li></ol>
jopal|jope	<i>noun</i><br><ol><li>lung</li></ol>
joyi	<i>num</i><br><ol><li>five</li></ol>
joɗɗingol	<i>verb</i><br><ol><li>(transitive) to seat, install, put down, place</li></ol>
jukka	<i>verb</i><br><ol><li>To poke.</li></ol>
jula|julaaɓe ɓe|jula o	<i>noun</i><br><ol><li>merchant, tradesman, monger</li></ol>
julde	<i>noun</i><br><ol><li>prayer</li><li>festival of the end of Ramadan, Eid al-Fitr</li></ol>
junngo|junngo ngo|juuɗe ɗe|juŋŋgo ŋgo|juŋŋgo|juuɗe	<i>noun</i><br><ol><li>(anatomy) hand</li></ol>
junuubu|junuubu o	<i>noun</i><br><ol><li>sin</li></ol>
k|K	<i>character</i><br><ol><li>A letter of the Fula alphabet, written in the Latin script.</li></ol>
kaala|kaala ka	<i>noun</i><br><ol><li>a type of scarf worn by men</li></ol>
kaalisi	<i>noun</i><br><ol><li>silver</li><li>(in the plural) money, funds</li></ol>
kaaɗo|kaaɗo o|haaɓe ɓe	<i>noun</i><br><ol><li>slave</li></ol>
kahi|kahe ɗe|kahi ki|kahe	<i>noun</i><br><ol><li>African mahogany (Khaya senegalensis)</li></ol>
kala	<i>pron</i><br><ol><li>each, every, all</li></ol>
kammu|kammuuli|kammu ngu	<i>noun</i><br><ol><li>sky, firmament</li></ol>
kamɓe	<i>pron</i><br><ol><li>third person plural;emphatic they, them</li></ol>
karallo	<i>noun</i><br><ol><li>expert, engineer</li></ol>
karfeeje	<i>noun</i><br><ol><li>alphabet</li></ol>
karha|karha ka	<i>noun</i><br><ol><li>oppression, subjugation</li></ol>
karhugol	<i>verb</i><br><ol><li>(transitive) to oblige, subject, impose one's force on</li></ol>
kasannge|kasannge o	<i>noun</i><br><ol><li>shroud, veil</li></ol>
kaso|kaso o	<i>noun</i><br><ol><li>jail, prison</li></ol>
kawtaljo|kawtaljo o|kawtalɓe ɓe	<i>noun</i><br><ol><li>neighbor</li></ol>
kawtital	<i>noun</i><br><ol><li>council, assembly, association, union</li></ol>
kaybonru	<i>noun</i><br><ol><li>house, residence, dwelling</li></ol>
kaŋko	<i>pron</i><br><ol><li>third person singular;emphatic him, her, it</li></ol>
kaŋŋe|kaŋŋe o	<i>noun</i><br><ol><li>gold</li></ol>
keerol|keeri ɗi|keerol ngol	<i>noun</i><br><ol><li>border, frontier, limit</li></ol>
kemmbu	<i>noun</i><br><ol><li>charcoal</li></ol>
kersa|kersa o	<i>noun</i><br><ol><li>disgrace, scandal</li></ol>
kewal|kewal ngal|kewe ɗe	<i>noun</i><br><ol><li>cane, stick, bamboo</li></ol>
ki	<i>suffix</i><br><ol><li>Noun class indicator for nouns (singular) including trees and some objects such as knives</li></ol><br><i>article</i><br><ol><li>(definite) the (when it follows the noun)</li></ol><br><i>det</i><br><ol><li>(used in indicating something)</li></ol>
kiikiiɗe	<i>adv</i><br><ol><li>in the evening</li></ol>
kijoori|kijoori ndi	<i>noun</i><br><ol><li>lion</li></ol>
kine	<i>noun</i><br><ol><li>(Adamawa) nose</li></ol>
ko	<i>suffix</i><br><ol><li>Noun class indicator for nouns (singular)</li></ol><br><i>article</i><br><ol><li>(definite) the (when it follows the noun)</li></ol><br><i>det</i><br><ol><li>(used in indicating something)</li></ol>
kono	<i>conj</i><br><ol><li>but, however</li></ol>
konu|konuuli	<i>noun</i><br><ol><li>hoard, throng, mob</li><li>war, campaign</li><li>army</li></ol>
kooho|koohooɓe ɓe|kooho o	<i>noun</i><br><ol><li>lord, chief (Especially the prophet Muhammad)</li></ol>
koosaajo|koosaajo o|koosaaɓe ɓe	<i>noun</i><br><ol><li>butcher</li></ol>
kosam|kosam ɗam|kose ɗe	<i>noun</i><br><ol><li>milk</li></ol>
koŋŋgol|koŋŋguli|koŋŋgol ŋgol|koŋŋguli ɗi	<i>noun</i><br><ol><li>(Pulaar) word (unit of language)</li></ol>
kudaku	<i>noun</i><br><ol><li>sweet potato</li></ol>
kunnawal|kunnaaje	<i>noun</i><br><ol><li>trough, a hollow piece of wood (for livestock to drink from)</li></ol>
kurkanagol	<i>verb</i><br><ol><li>(transitive) to serve (someone), to be subjected to servitude towards someone</li></ol>
kuugal|kuuɗe ɗe	<i>noun</i><br><ol><li>action, act, deed</li><li>(Grammar) verb</li></ol>
kuuran|kuuran o	<i>noun</i><br><ol><li>electrical current, power</li></ol>
l|L	<i>character</i><br><ol><li>A letter of the Fula alphabet, written in the Latin script.</li></ol>
la'aaje	<i>noun</i><br><ol><li>okra</li></ol>
laabudda|laabudda o	<i>noun</i><br><ol><li>obligation, necessity, condition</li></ol>
laadi	<i>noun</i><br><ol><li>tomb, grave</li></ol>
laakun|laakoy	<i>noun</i><br><ol><li>canoe, pirogue</li></ol>
laalawal|laalaje ɗe|laalawal ngal	<i>noun</i><br><ol><li>pod</li></ol>
laamaaku	<i>noun</i><br><ol><li>governance</li></ol>
laamagol	<i>verb</i><br><ol><li>to command, reign, lead</li></ol>
laamiiɗo|laamiiɗo o|laamiiɓe ɓe	<i>noun</i><br><ol><li>king, chief</li></ol>
laamɗo|laamɗo o|laamɓe ɓe	<i>noun</i><br><ol><li>chief</li></ol>
laatagol	<i>verb</i><br><ol><li>(intransitive) to happen, occur, take place, come about, come to pass</li><li>to be, exist (in a certain manner)</li><li>to become</li><li>to succeed</li><li>to be well proportioned (of the body)</li></ol>
laawol|laawi ɗi|laabi|laawol ngol or	<i>noun</i><br><ol><li>path, route, way, method</li></ol>
laañal|laañe|laañal ngal	<i>noun</i><br><ol><li>bow (weapon)</li></ol>
laaɓal|laaɓal ngal	<i>noun</i><br><ol><li>cleanness, hygiene</li><li>(figuratively) clarity, honesty, sincerity, justice</li></ol>
laaɓinde	<i>verb</i><br><ol><li>to clean, cleanse, wash, clean up</li></ol>
laaɓugol	<i>verb</i><br><ol><li>to be clean, sanitary</li><li>to be clear, neat, and correct (of language)</li><li>to be honest</li></ol>
labbo|labbo o|lawɓe ɓe	<i>noun</i><br><ol><li>woodworker</li></ol>
lacceeri|lacceeri ndi	<i>noun</i><br><ol><li>sorghum</li></ol>
lacciri|lacceeje ɗe|lacciri ndi	<i>noun</i><br><ol><li>couscous (usually refers to pounded millet, sorghum, or corn that is steamed, but same term used for the pasta based kind)</li></ol>
ladde|laddeeji	<i>noun</i><br><ol><li>forest, brush, nature</li></ol>
lammbe|lammbe o	<i>noun</i><br><ol><li>amber</li></ol>
lamɗam|lamɗam ɗam|lamɗamaaji ɗi|lamɗamaaji	<i>noun</i><br><ol><li>salt (sodium chloride)</li></ol>
lanɗam	<i>noun</i><br><ol><li>(Pular) Alternative form of lamɗam (salt).</li></ol>
law	<i>adv</i><br><ol><li>early</li></ol>
laɓi|laɓi ki	<i>noun</i><br><ol><li>knife</li></ol>
laɓndal|laɓndal ngal	<i>noun</i><br><ol><li>question</li></ol>
leembol|leembol ngal|leeɓi ɗi	<i>noun</i><br><ol><li>feather, hair</li></ol>
lefol|lefol ngol|leppi ɗi	<i>noun</i><br><ol><li>strip of cloth, band, bandage</li></ol>
leggal|leggal ngal|leɗɗe ɗe	<i>noun</i><br><ol><li>wood, piece of wood, cane, stick</li><li>tree</li></ol>
lekki|leɗɗe|lekki ki|leɗɗe ɗe	<i>noun</i><br><ol><li>tree</li><li>medicine (traditionally often derived from woody plants)</li></ol>
lesdi|lesɗe|lesdi ndi|lesɗe ɗe	<i>noun</i><br><ol><li>earth, soil.</li><li>country, region.</li></ol>
lewde	<i>verb</i><br><ol><li>to clear land for farming</li></ol>
lewru|lewru ndu|lebbi|lebbi ɗi	<i>noun</i><br><ol><li>moon</li><li>month</li></ol>
leydi|leydi ndi|leyɗe|leyɗe ɗe	<i>noun</i><br><ol><li>earth, soil.</li><li>country, region.</li></ol>
leñol|leƴƴi	<i>noun</i><br><ol><li>clan, lineage, tribe, ethnic group, race</li></ol>
liige|liige nge	<i>verb</i><br><ol><li>cotton field</li></ol>
liingu|lingu nde|lingu|liɗɗi ɗi|liinga nde|liɗɗi|liinga|liingu nde|liƴƴi ɗi|liƴƴi	<i>noun</i><br><ol><li>fish</li></ol>
liital|liital ngal	<i>noun</i><br><ol><li>flute, trumpet</li></ol>
limugol	<i>verb</i><br><ol><li>to count</li></ol>
lontagol	<i>verb</i><br><ol><li>(transitive) to succeed, replace</li></ol>
lowre|lowe	<i>noun</i><br><ol><li>parcel of land in a field</li></ol>
luggugol	<i>verb</i><br><ol><li>(intransitive) to be deep</li></ol>
lunndagol	<i>verb</i><br><ol><li>(transitive) to contradict, contravene, oppose, transgress</li></ol>
luttitugol	<i>verb</i><br><ol><li>(transitive) to take the place of</li></ol>
luttugol	<i>verb</i><br><ol><li>(intransitive) to stay, remain</li><li>to die, perish</li><li>(transitive) to visit someone's home and find them absent</li></ol>
luural|luure ɗe|luural ngal	<i>noun</i><br><ol><li>dispute, disagreement, conflict</li></ol>
m|M	<i>character</i><br><ol><li>A letter of the Fula alphabet, written in the Latin script.</li></ol>
maabo|maabo o|maabuuɓe ɓe	<i>noun</i><br><ol><li>griot, a type of griot who may also be leather workers.</li></ol>
maadi|maadiiji	<i>noun</i><br><ol><li>wall</li></ol>
maanditagol	<i>verb</i><br><ol><li>to remember, recall, recollect</li></ol>
maaro|maarooji ɗi|maaro ngo	<i>noun</i><br><ol><li>rice</li></ol>
maayo|maaje	<i>noun</i><br><ol><li>river</li></ol>
maccingol	<i>verb</i><br><ol><li>(transitive) to enslave, subjugate</li></ol>
maccuɗo|maccuɓe ɓe|maccuɗo o	<i>noun</i><br><ol><li>slave</li></ol>
mahoowo|mahooɓe ɓe|mahoowo o	<i>noun</i><br><ol><li>potter, one who makes clay pots</li></ol>
mahugol	<i>verb</i><br><ol><li>(transitive) to construct, build, erect</li></ol>
majjere	<i>noun</i><br><ol><li>ignorance, illiteracy</li><li>(Pulaar) loss</li><li>(Pulaar) misconception</li></ol>
makko	<i>pron</i><br><ol><li>(possessive) his, her</li></ol>
maleyka|maleyka o|maleykaaji|maleykaaji ɗi	<i>noun</i><br><ol><li>(Pulaar) angel (messenger from a deity)</li></ol>
manngaaku|manngaaku ngu	<i>noun</i><br><ol><li>size, largeness</li><li>importance</li><li>maturity, intelligence, age</li></ol>
manngol	<i>noun</i><br><ol><li>large intestine, colon</li></ol>
marga|marga o	<i>noun</i><br><ol><li>store, shop, depot</li><li>(historical) an agricultural village, farm, agricultural lands with homes on it</li></ol>
marke|marke ɗe	<i>noun</i><br><ol><li>(Medicine) vaccination</li></ol>
marsingol	<i>verb</i><br><ol><li>(transitive) to sell</li></ol>
martaba|martaba o	<i>noun</i><br><ol><li>rank, order, place, position</li><li>honor, esteem</li><li>patrimony, culture</li></ol>
marɗo|marɓe ɓe|marɗo o	<i>noun</i><br><ol><li>rich person</li></ol>
mas'ala|mas'ala o	<i>noun</i><br><ol><li>question, theme, subject</li></ol>
masaku	<i>noun</i><br><ol><li>sweet potato</li></ol>
maslaha|maslaha o	<i>noun</i><br><ol><li>conciliation, conciliatory spirit, an amicable resolution</li></ol>
mawba|mawɗi ɗi|mawba o	<i>noun</i><br><ol><li>elephant</li></ol>
mawngu	<i>noun</i><br><ol><li>largeness, greatness</li></ol>
mawniraaɗo|mawniraaɗo o|mawniraawo|mawniraawo o|mawniraaɓe|mawniraaɓe ɓe	<i>noun</i><br><ol><li>elder sibling</li></ol>
mawnugol	<i>verb</i><br><ol><li>(intransitive) to grow, increase, rise</li><li>to be big, be significant, be considerable</li></ol>
mawɗo|mawɗo o|mawɓe ɓe	<i>noun</i><br><ol><li>adult</li><li>elder, senior, old person</li><li>important person, leader</li></ol>
mb|Mb	<i>character</i><br><ol><li>A letter of the Fula alphabet, written in the Latin script.</li></ol>
mbaadi|mbaadiiji	<i>noun</i><br><ol><li>appearance, form, color, physiognomy</li></ol>
mbarin|mbarin o	<i>noun</i><br><ol><li>(familiar) friend, buddy, pal</li></ol>
mbarjaari	<i>noun</i><br><ol><li>recompense, divine reward</li></ol>
mbaroodi	<i>noun</i><br><ol><li>game, prey</li></ol>
mbaru|mbaru o	<i>noun</i><br><ol><li>death</li></ol>
mbawdi	<i>noun</i><br><ol><li>power, means</li></ol>
mbayeere	<i>noun</i><br><ol><li>sorghum</li></ol>
mbayla|mbayla ka	<i>noun</i><br><ol><li>forge</li></ol>
mbedda|mbedda o	<i>noun</i><br><ol><li>street, road</li></ol>
mbeewa|mbeewa ba|be'i ɗi|be'i	<i>noun</i><br><ol><li>goat</li><li>she-goat</li></ol>
mbelam	<i>noun</i><br><ol><li>pleasure</li></ol>
mbelndi|mbelndi ndi	<i>noun</i><br><ol><li>blade</li></ol>
mboddi|bolle	<i>noun</i><br><ol><li>snake, serpent</li></ol>
mbolo	<i>noun</i><br><ol><li>voice</li></ol>
mbooɗirka|mbooɗirka ka	<i>noun</i><br><ol><li>goodness</li></ol>
mbusiri|mbusiri ndi	<i>noun</i><br><ol><li>porridge made with grains and groundnuts</li><li>thin gruel</li></ol>
meetelol|meetelol ngol|meetelli ɗi	<i>noun</i><br><ol><li>turban</li></ol>
meeɗen	<i>pron</i><br><ol><li>our</li></ol>
men	<i>pron</i><br><ol><li>first person plural exclusive;short form we, us</li></ol>
menen	<i>pron</i><br><ol><li>first person plural exclusive;emphatic pronoun we, us</li></ol>
meɗen	<i>pron</i><br><ol><li>1st person plural exclusive pronoun;long form we</li></ol>
mi	<i>pron</i><br><ol><li>I (first person singular subject pronoun; short form)</li></ol>
miijo|miijo ngo	<i>noun</i><br><ol><li>thought, imagination, opinion, idea, point of view, impression</li></ol>
miin	<i>pron</i><br><ol><li>(Liptaako, Maasina, Fouta-toro, Adamawa, Pulaar) 1st person singular emphatic pronoun I, me</li></ol>
min	<i>pron</i><br><ol><li>1st person singular emphatic pronoun I, me</li><li>(Adamawa) first person plural exclusive;short form we, us</li></ol>
minen	<i>pron</i><br><ol><li>(Adamawa) first person plural exclusive;emphatic pronoun we, us</li></ol>
misiide|misiide nde	<i>noun</i><br><ol><li>village-parish, a village which traditionally contains a mosque</li><li>a mosque</li></ol>
miñiraaɗo|miñiraaɓe|miñiraaɓe ɓe|miñiraaɗo o	<i>noun</i><br><ol><li>younger sibling</li></ol>
miɗo	<i>pron</i><br><ol><li>I (first person singular subject pronoun; long form)</li></ol>
mofte|moftanuuji|mofte ɗe	<i>noun</i><br><ol><li>community, people, nation</li><li>(Islam) the ummah</li></ol>
mokobaa|mokobaaɓe ɓe	<i>noun</i><br><ol><li>an adult, a person who is responsible, respected, wise and virtuous</li></ol>
moodi|moodiɓɓe ɓe	<i>noun</i><br><ol><li>A title of respect added to the first name of adults</li><li>husband, spouse, bridegroom</li></ol>
moorde	<i>verb</i><br><ol><li>to plait, braid</li></ol>
mooƴu|mooƴi	<i>noun</i><br><ol><li>termite</li></ol>
mooɓugol	<i>verb</i><br><ol><li>(transitive) to unite, gather, rally, assemble</li></ol>
mooɗon	<i>pron</i><br><ol><li>(possessive) your</li></ol>
moƴƴere	<i>noun</i><br><ol><li>goodness</li><li>generosity</li><li>likeableness</li><li>well-being</li><li>happiness</li><li>health</li><li>mercy</li></ol>
moƴƴingol	<i>verb</i><br><ol><li>(intransitive) to reconcile</li><li>(transitive) to make, fabricate, produce, construct</li></ol>
moƴƴugol	<i>verb</i><br><ol><li>(intransitive) to be good (of people and objects)</li><li>to be well-natured, benevolent, generous, kind, gentle</li></ol>
moƴƴuki	<i>noun</i><br><ol><li>goodness, generosity</li></ol>
munyal|munyal ngal	<i>noun</i><br><ol><li>patience, fortitude</li></ol>
musel|muselaaɓe ɓe|musel o	<i>noun</i><br><ol><li>schoolteacher</li></ol>
musidal	<i>noun</i><br><ol><li>descendance, ancestry, clan, family</li></ol>
n|N	<i>character</i><br><ol><li>A letter of the Fula alphabet, written in the Latin script.</li></ol>
naamu|naamu o	<i>noun</i><br><ol><li>custom, tradition</li></ol>
naange|naange nge|naangeeji ɗi	<i>noun</i><br><ol><li>sun</li></ol>
nafitorgol	<i>verb</i><br><ol><li>(transitive) to utilize, use, employ</li></ol>
nagge|nayi|nagge nge|nayi ɗi	<i>noun</i><br><ol><li>cow</li><li>bovine</li></ol>
nambu|nambu o	<i>verb</i><br><ol><li>garden</li></ol>
nammanduru|nammanduru ndu	<i>noun</i><br><ol><li>abundance, plentifulness</li></ol>
nan	<i>particle</i><br><ol><li>marks the preterite tense</li></ol>
nandude	<i>verb</i><br><ol><li>to resemble, look like</li></ol>
nantinoore	<i>noun</i><br><ol><li>(Pular) translation, interpretation</li></ol>
nantinoowo|nantinoowo o|nantinooɓe ɓe	<i>noun</i><br><ol><li>translator, interpreter</li></ol>
nattinde	<i>verb</i><br><ol><li>to stop</li></ol>
nawliigu|nawliigu ngu	<i>verb</i><br><ol><li>polygamy</li></ol>
nayeejo|nayeeɓe ɓe|nayeejo o	<i>noun</i><br><ol><li>elder, old person</li></ol>
nayi	<i>num</i><br><ol><li>four</li></ol>
nayo	<i>num</i><br><ol><li>(Pulaar, Maasina, dialect, with human nouns) four</li></ol>
nd|Nd	<i>character</i><br><ol><li>A letter of the Fula alphabet, written in the Latin script.</li></ol>
ndarɗe|ndarɗe ɗe	<i>noun</i><br><ol><li>sight, a way of seeing</li></ol>
ndefu	<i>noun</i><br><ol><li>cuisine</li></ol>
nden	<i>prep</i><br><ol><li>then, and then, and so</li></ol><br><i>suffix</i><br><ol><li>Noun class indicator for nouns (singular)</li></ol><br><i>article</i><br><ol><li>(definite) the (when it follows the noun)</li></ol><br><i>det</i><br><ol><li>(used in indicating something)</li></ol>
ndenka|ndenka ka	<i>noun</i><br><ol><li>protection, defense</li></ol>
nder	<i>adv</i><br><ol><li>within, in the interior</li></ol>
ndi	<i>particle</i><br><ol><li>Noun class indicator for nouns (singular)</li></ol><br><i>article</i><br><ol><li>(definite) the (when it follows the noun in ndi class)</li></ol><br><i>det</i><br><ol><li>(used in indicating something in ndi class)</li></ol>
ndiyam|ndiyam ɗam|diƴe ɗe	<i>noun</i><br><ol><li>water</li></ol>
ndonndu|doni	<i>noun</i><br><ol><li>jackal</li></ol>
ndu	<i>suffix</i><br><ol><li>Noun class indicator for nouns (singular) including hollow, round or inflated things</li><li>Noun class indicator for super-augmentative nouns (singular)</li></ol><br><i>article</i><br><ol><li>(definite) the (when it follows the noun)</li></ol>
nduggu|nduggu ngu	<i>noun</i><br><ol><li>dust</li></ol>
nduuguse|nduuguseeɓe ɓe	<i>noun</i><br><ol><li>a young circumcised man old enough to marry</li></ol>
nduungu	<i>noun</i><br><ol><li>rainy season</li></ol>
nebam|nebameeje ɗe|nebam ɗam	<i>noun</i><br><ol><li>oil</li></ol>
nebbam|nebbam ɗam|nebbeele ɗe	<i>noun</i><br><ol><li>oil</li><li>cream, butter</li><li>fat, grease</li></ol>
neema|neema o	<i>noun</i><br><ol><li>divine grace, divine favor</li><li>food</li></ol>
neesila	<i>noun</i><br><ol><li>railroad</li></ol>
nelal|nelal ngal	<i>noun</i><br><ol><li>message, messenger, commission</li></ol>
neɗɗo|yimɓe ɓe|neɗɗo o	<i>noun</i><br><ol><li>person, human being</li></ol>
ng|Ng	<i>character</i><br><ol><li>A letter of the Fula alphabet, written in the Latin script.</li></ol>
ngaari|ga'i	<i>noun</i><br><ol><li>bull</li></ol>
ngalu|ngaluuji ɗi|ngalu ngu	<i>noun</i><br><ol><li>wealth, possessions</li><li>economy</li></ol>
ngam	<i>prep</i><br><ol><li>(Adamawa, Fouta-toro) for</li></ol>
nganndi	<i>noun</i><br><ol><li>brain</li></ol>
ngara|ngara ka	<i>noun</i><br><ol><li>indigo</li></ol>
ngawri	<i>noun</i><br><ol><li>sorghum</li></ol>
ngayka|gayɗe ɗe	<i>noun</i><br><ol><li>hole, ditch</li><li>chasm, ravine</li></ol>
ngaynaako|ngaynaako o|ngaynaakooɓe ɓe	<i>noun</i><br><ol><li>cattle farmer, shepherd, herder</li></ol>
ngayngu	<i>noun</i><br><ol><li>hate, spite</li></ol>
nge	<i>suffix</i><br><ol><li>Noun class indicator for nouns (singular) including bovines and the sun</li></ol><br><i>article</i><br><ol><li>(definite) the (when it follows the noun)</li></ol><br><i>det</i><br><ol><li>(used in indicating something)</li></ol>
ngeenaari	<i>noun</i><br><ol><li>reward, recompense, retribution, salary, wage</li></ol>
ngeera|ngeera ka|ngeeraaji ɗi	<i>noun</i><br><ol><li>ravine, gully</li><li>pit</li></ol>
ngel	<i>suffix</i><br><ol><li>Noun class indicator for nouns (singular) including hollow, round or inflated things</li><li>Noun class indicator for diminutive nouns (singular)</li></ol><br><i>article</i><br><ol><li>(definite) the (when it follows the noun)</li></ol>
ngelooba|gelooɗi ɗi	<i>noun</i><br><ol><li>(Pular) dromedary camel</li></ol>
ngenndi	<i>noun</i><br><ol><li>(rare) country, nation</li></ol>
ngesa|ngesa mba|gese	<i>noun</i><br><ol><li>field</li><li>cultivation</li></ol>
ngol	<i>suffix</i><br><ol><li>Noun class indicator for nouns (singular) including long or extended objects</li></ol><br><i>article</i><br><ol><li>(definite) the (when it follows the noun)</li></ol><br><i>det</i><br><ol><li>(used in indicating something)</li></ol>
ngorgu	<i>noun</i><br><ol><li>virility, bravery, courage, strength, prowess</li></ol>
ngoƴaare|ngooƴaje	<i>noun</i><br><ol><li>(Adamawa) owl; (in particular) the Western barn owl</li></ol>
ngu	<i>suffix</i><br><ol><li>Noun class indicator for nouns (singular)</li></ol><br><i>article</i><br><ol><li>(definite) the (when it follows the noun)</li></ol><br><i>det</i><br><ol><li>(used in indicating something)</li></ol>
ngurndan|ngurndamaaji	<i>noun</i><br><ol><li>life</li></ol>
nguufo	<i>noun</i><br><ol><li>foam, froth, scum</li></ol>
nguure|nguure o	<i>noun</i><br><ol><li>food, sustenance</li></ol>
nguurndam|nguurndam ɗam	<i>noun</i><br><ol><li>life</li><li>living</li></ol>
niwre	<i>noun</i><br><ol><li>darkness, shadow</li></ol>
nj|Nj	<i>character</i><br><ol><li>A letter of the Fula alphabet, written in the Latin script.</li></ol>
njaggu	<i>noun</i><br><ol><li>oppression, arbitrary injustice, domination</li></ol>
njanndi|njanndi ndi	<i>noun</i><br><ol><li>iron</li></ol>
njorndi	<i>noun</i><br><ol><li>dry land, terra firma</li></ol>
njoyo	<i>num</i><br><ol><li>(Pulaar dialect, with human nouns) five</li></ol>
no	<i>adv</i><br><ol><li>how?</li></ol>
no gasa	<i>adv</i><br><ol><li>maybe, perhaps, it could be</li></ol>
noddugol	<i>verb</i><br><ol><li>(transitive) to call, convoke</li></ol>
nofuru|noppi|nofuru ndu|noppi ɗi	<i>noun</i><br><ol><li>(Pulaar) ear</li></ol>
nokku|nokku o|nokkuji	<i>noun</i><br><ol><li>place, location</li></ol>
nokkuure|nokkuure o	<i>noun</i><br><ol><li>place, location</li></ol>
non	<i>adv</i><br><ol><li>a deictic element referring to either a preceding adverb or the preceding statement</li></ol><br><i>particle</i><br><ol><li>a particle of insistance which can be added to a conjunction, interjection or pronoun</li></ol>
noone|noone o	<i>noun</i><br><ol><li>sort, type, kind</li></ol>
noora|noora mba	<i>noun</i><br><ol><li>crocodile, caiman</li></ol>
nowru|noppi	<i>noun</i><br><ol><li>ear</li></ol>
nunɗal	<i>noun</i><br><ol><li>honesty</li></ol>
nyayiiri|nyayiiri ndi	<i>noun</i><br><ol><li>sesame</li></ol>
o|ɓe|O	<i>character</i><br><ol><li>A letter of the Fula alphabet, written in the Latin script.</li></ol><br><i>suffix</i><br><ol><li>Noun class indicator for nouns (singular) having to do with people, and for loan words</li></ol><br><i>pron</i><br><ol><li>he, she (third person singular subject pronoun; short form)</li></ol><br><i>article</i><br><ol><li>(definite) the (when it follows the noun)</li></ol><br><i>det</i><br><ol><li>used in indicating someone</li></ol>
omo	<i>pron</i><br><ol><li>(Pulaar, Fouta-toro, Massina, Liptaako, Benin, S.W. Niger, Sokoto) third person singular;long form he/she</li></ol>
onon	<i>pron</i><br><ol><li>second person plural;emphatic you</li></ol>
ontigi	<i>pron</i><br><ol><li>that one over there, that last one, that (thing just mentioned)</li></ol>
oɗon	<i>pron</i><br><ol><li>(Pulaar, Gambia, Maasina, Liptaako, N.W. Niger, Benin, S.W. Niger, Sokoto,) second person plural pronoun;long form (you)</li></ol>
p|P	<i>character</i><br><ol><li>A letter of the Fula alphabet, written in the Latin script.</li></ol>
paggiri	<i>noun</i><br><ol><li>a type of wild millet</li></ol>
paɗal|paɗe	<i>noun</i><br><ol><li>shoe, sandal</li></ol>
peeral	<i>noun</i><br><ol><li>dawn, daybreak</li></ol>
peewal	<i>noun</i><br><ol><li>uprightness, integrity, honor</li></ol>
piindi	<i>noun</i><br><ol><li>flower</li></ol>
piɓol|piɓi	<i>noun</i><br><ol><li>knot</li></ol>
poofirgel|poofirgel ngel|poofirkoy koy	<i>noun</i><br><ol><li>comma</li></ol>
poolal	<i>noun</i><br><ol><li>victory, triumph, success</li></ol>
puumtugol	<i>noun</i><br><ol><li>pronunciation</li></ol>
qarnu|qarnu o	<i>noun</i><br><ol><li>century</li></ol>
qe	<i>conj</i><br><ol><li>and, with</li></ol>
r|R	<i>character</i><br><ol><li>A letter of the Fula alphabet, written in the Latin script.</li></ol>
raddo|raddo ngo	<i>noun</i><br><ol><li>hunt, hunting</li></ol>
reedu	<i>noun</i><br><ol><li>(Adamawa) stomach</li></ol>
reenugol	<i>verb</i><br><ol><li>(transitive) to guard, protect, surveil, defend</li></ol>
refti	<i>conj</i><br><ol><li>and then, finally, afterwards</li></ol>
remugol	<i>verb</i><br><ol><li>to farm, cultivate, grow (crops)</li></ol>
rerɗingol	<i>verb</i><br><ol><li>(transitive) to encourage, incite to</li></ol>
rewde	<i>verb</i><br><ol><li>to follow, persist, conform, pursue, revere, venerate</li><li>to owe</li></ol>
ronugol	<i>verb</i><br><ol><li>(transitive) to inherit</li></ol>
roogo	<i>noun</i><br><ol><li>cassava</li></ol>
rulde|duule	<i>noun</i><br><ol><li>cloud</li></ol>
ruuhu|ruuhu o|ruuhuuji ɗi|ruuhuuji	<i>noun</i><br><ol><li>(Pulaar) spirit (supernatural being)</li></ol>
s|S	<i>character</i><br><ol><li>A letter of the Fula alphabet, written in the Latin script.</li></ol>
saakaari|caakaaji	<i>noun</i><br><ol><li>ram</li></ol>
saare|saareeji ɗi|saare nde	<i>noun</i><br><ol><li>village, town</li></ol>
sababu	<i>noun</i><br><ol><li>reason, cause, motive</li></ol>
sagataa|sagataaɓe ɓe	<i>noun</i><br><ol><li>a strapping young man, a strong young man, youth</li></ol>
saggitorde|caggitorɗe ɗe|saggitorde nde	<i>noun</i><br><ol><li>dictionary</li></ol>
sakkital	<i>noun</i><br><ol><li>eternity</li></ol>
salli	<i>noun</i><br><ol><li>(religion) cantor, muezzin</li></ol>
sappo	<i>num</i><br><ol><li>ten</li></ol>
sawru|cabbi|sawru ndu|cabbi ɗi|cawel	<i>noun</i><br><ol><li>stick, cane (esp. a long, straight stick used by herders)</li><li>(Pular) switch, flexible rod</li><li>(Nigeria) staff of office</li></ol>
sawrugol	<i>verb</i><br><ol><li>(intransitive) to voyage, travel, journey</li></ol>
sayre|caaƴe	<i>noun</i><br><ol><li>a handful of food, mouthfull of food</li></ol>
saññoowo|saññooɓe ɓe|saññoowo o	<i>noun</i><br><ol><li>weaver</li></ol>
senaare|senaare nde	<i>noun</i><br><ol><li>holiness, sanctification</li></ol>
sendude	<i>verb</i><br><ol><li>(transitive) to separate, divide</li></ol>
sennditugol	<i>verb</i><br><ol><li>(transitive) to share, distribute</li></ol>
seremmbe|seremmbe nde	<i>noun</i><br><ol><li>fonio (Digitaria exilis)</li></ol>
sewngol|cewɗi ɗi	<i>noun</i><br><ol><li>gut, innard, small intestine</li></ol>
sifa|sifa ka|sifaaji	<i>noun</i><br><ol><li>type, sort, kind, fashion, manner</li><li>description, explanation</li><li>adjective</li></ol>
sifagol	<i>verb</i><br><ol><li>(transitive) to explain, describe, relate</li></ol>
sikke|sikke ɗe	<i>noun</i><br><ol><li>doubt, incertitude</li><li>opinion</li></ol>
sikkugol	<i>verb</i><br><ol><li>(intransitive) to think, be of the opinion that, believe</li></ol>
sincugol	<i>verb</i><br><ol><li>(transitive) to found, build, create</li></ol>
sinnjahi	<i>noun</i><br><ol><li>Cassia sieberiana, drumstick tree</li></ol>
sondu|sondu ndu|colli ɗi	<i>noun</i><br><ol><li>bird</li></ol>
sonsoliwii|sonsoliiji	<i>noun</i><br><ol><li>mosquito</li></ol>
soora|sooraaji ɗi	<i>noun</i><br><ol><li>chapter</li></ol>
soɗo|soɗoje ɗe	<i>noun</i><br><ol><li>Aristida stipoides</li></ol>
suka|sukaaɓe ɓe	<i>noun</i><br><ol><li>young man, young person</li></ol>
sutde	<i>verb</i><br><ol><li>(Pulaar) to add</li></ol>
suudu|suudu ndu|cuuɗi|cuuɗi ɗi	<i>noun</i><br><ol><li>house, hut</li><li>room</li></ol>
suudu-depiteeɓe|suudu-depiteeɓe ndu	<i>noun</i><br><ol><li>(politics) national assembly, Chamber of Deputies, Parliament</li></ol>
suumugol	<i>verb</i><br><ol><li>(transitive, active) to hide, dissimulate, conceal (especially of the face by a veil)</li></ol>
suuperefee|suuperefeeɓe ɓe	<i>noun</i><br><ol><li>sub-prefecture</li></ol>
suƴƴagol	<i>verb</i><br><ol><li>(intransitive, middle) to fall on one's face</li></ol>
suƴƴugol	<i>verb</i><br><ol><li>(transitive, active) to make (somebody) fall on one's face</li></ol>
t|T	<i>character</i><br><ol><li>A letter of the Fula alphabet, written in the Latin script.</li></ol>
taakanjo	<i>noun</i><br><ol><li>a native, person originally from the country</li></ol>
tabalde|tabalɗe ɗe	<i>noun</i><br><ol><li>drum</li></ol>
tafugol	<i>verb</i><br><ol><li>(transitive) to forge, to work (metal)</li></ol>
tagudi	<i>noun</i><br><ol><li>form, appearance</li><li>characteristic, nature</li></ol>
tagugol	<i>verb</i><br><ol><li>(transitive) to found, build, create (of God)</li></ol>
takko	<i>prep</i><br><ol><li>near, close to, next to</li></ol>
takuure	<i>noun</i><br><ol><li>okra</li></ol>
tamƴinaare	<i>noun</i><br><ol><li>hope</li></ol>
tan	<i>adj</i><br><ol><li>only</li></ol><br><i>adv</i><br><ol><li>only</li></ol>
tasakuyee|tasakuyeeji	<i>noun</i><br><ol><li>study, investigation, research</li><li>lesson</li><li>experience</li></ol>
taskagol	<i>verb</i><br><ol><li>to research, analyze, study, examine</li></ol>
tati	<i>num</i><br><ol><li>three</li></ol>
tato	<i>num</i><br><ol><li>(Pulaar dialect, with human nouns) three</li></ol>
tawegol	<i>verb</i><br><ol><li>(intransitive) to be a part of, be a member of, participate</li></ol>
tawsaajo|tawsaaɓe ɓe|tawsaajo o	<i>noun</i><br><ol><li>hunter</li></ol>
teddeengal|teddeengal ngal	<i>noun</i><br><ol><li>glory, honor, praise</li></ol>
teddugol	<i>verb</i><br><ol><li>(intransitive) to be heavy, weighty</li><li>to be important, venerable</li></ol>
teemedannde|teemedanɗe	<i>noun</i><br><ol><li>century</li></ol>
teemedere	<i>num</i><br><ol><li>one hundred</li></ol>
teewu|teewu ngu|teewuuji ɗi	<i>noun</i><br><ol><li>meat, flesh</li><li>muscle</li></ol>
teeyteeyngal|teeyteeyngal ngal	<i>noun</i><br><ol><li>lake</li></ol>
tefde	<i>verb</i><br><ol><li>to calm, pacify</li></ol>
tefoowo|tefoowo o	<i>noun</i><br><ol><li>mediator</li></ol>
teheende|teheende nde	<i>noun</i><br><ol><li>(Pulaar) camp</li></ol>
tetekol	<i>noun</i><br><ol><li>intestine</li></ol>
tigi	<i>adv</i><br><ol><li>truly, well</li><li>(one's)-self</li></ol>
tiimo|tiimo ngo	<i>noun</i><br><ol><li>prediction</li></ol>
tiindagol	<i>verb</i><br><ol><li>(transitive) to face, combat, confront</li></ol>
tijjagol	<i>verb</i><br><ol><li>(transitive) to wait for, count on, hope for</li></ol>
tilliisa|tilliisa o	<i>noun</i><br><ol><li>tent</li></ol>
timmugol	<i>verb</i><br><ol><li>(intransitive) to finish, accomplish, complete</li><li>to be perfect</li></ol>
tinndinawol|tinndinawol ngol	<i>noun</i><br><ol><li>participle</li></ol>
tinndinde	<i>verb</i><br><ol><li>to advise, assist, recommend</li><li>to teach, explain</li></ol>
tinndinol|tinndinol ngol	<i>noun</i><br><ol><li>verb</li></ol>
tinndinoore	<i>noun</i><br><ol><li>advice, recommendation</li><li>definition</li></ol>
tinndol|tinndol ngol|tinndi	<i>noun</i><br><ol><li>story, tale, account, legend</li></ol>
tippugol	<i>verb</i><br><ol><li>(intransitive) to place one's foot somewhere</li><li>(transitive) to plant from cuttings</li></ol>
tippuru	<i>noun</i><br><ol><li>hut, shack, shanty</li></ol>
to	<i>prep</i><br><ol><li>in, at, to</li></ol>
ton	<i>adv</i><br><ol><li>there, over there</li></ol>
tonndu|toni ɗi|tonndu ndi	<i>noun</i><br><ol><li>lip</li></ol>
toowugol	<i>verb</i><br><ol><li>(intransitive) to be high, raised, elevated</li><li>to rise, come up</li><li>(figuratively) to be raised, elevated, glorious, splendid</li></ol>
toraare	<i>noun</i><br><ol><li>prayer, supplication, implication</li></ol>
townugol	<i>verb</i><br><ol><li>(transitive) to lift</li></ol>
toyoori|toyoori ndi	<i>noun</i><br><ol><li>stiff porridge</li></ol>
toɓugol	<i>verb</i><br><ol><li>(intransitive) to rain</li></ol>
toɓɓere|toɓɓe	<i>noun</i><br><ol><li>spot, point, dot</li></ol>
toɗɗagol	<i>verb</i><br><ol><li>(transitive) to designate, name (as a person to a position)</li></ol>
tuggordu	<i>noun</i><br><ol><li>stick, cane</li></ol>
tulde|tule	<i>noun</i><br><ol><li>heap, mound, hillock</li><li>hill</li></ol>
tuma	<i>adv</i><br><ol><li>when, at the time that</li></ol>
tummbondiral|tummbondire	<i>noun</i><br><ol><li>meeting, encounter</li></ol>
tun	<i>adj</i><br><ol><li>only</li></ol><br><i>adv</i><br><ol><li>only</li></ol>
tuufeere|tuufeere nde	<i>noun</i><br><ol><li>brick</li></ol>
tuugorde|tuugorde nde	<i>noun</i><br><ol><li>reference</li></ol>
u|U	<i>character</i><br><ol><li>A letter of the Fula alphabet, written in the Latin script.</li></ol>
w|W	<i>character</i><br><ol><li>A letter of the Fula alphabet, written in the Latin script.</li></ol>
waajagol	<i>verb</i><br><ol><li>(transitive) to advise, counsel</li></ol>
waamde	<i>verb</i><br><ol><li>(intransitive) to flood, flow</li></ol>
waande|waande nge|baaɗe ɗe	<i>noun</i><br><ol><li>termite nest, anthill</li></ol>
waandu|baaɗi ɗi|waandu ndu	<i>noun</i><br><ol><li>monkey</li></ol>
waare|ba'e	<i>noun</i><br><ol><li>haybale</li><li>beard</li></ol>
waawugol	<i>verb</i><br><ol><li>(intransitive) to be able</li><li>(transitive) to defeat, win against, defeat, conquer</li></ol>
waañ|waañ o	<i>noun</i><br><ol><li>kitchen</li></ol>
waañde	<i>verb</i><br><ol><li>(transitive) to hunt</li></ol>
waañoowo|waañooɓe ɓe|waañoowo o	<i>noun</i><br><ol><li>hunter</li></ol>
wahabiyyaajo|wahabiyyaajo o|wahabiyyaaɓe ɓe	<i>noun</i><br><ol><li>Wahhabist, islamist</li></ol>
walaa	<i>particle</i><br><ol><li>there is not, there is no</li><li>not</li><li>no</li></ol>
walla	<i>conj</i><br><ol><li>or</li></ol>
wano	<i>adv</i><br><ol><li>like, such, as</li></ol>
warrugol	<i>verb</i><br><ol><li>to do in a certain manner</li></ol>
warugol	<i>verb</i><br><ol><li>(transitive) to kill, murder</li><li>to cross out</li></ol>
waylugol	<i>verb</i><br><ol><li>(transitive) to change, transform, modify</li></ol>
waɓɓugo|gaɓɓule	<i>noun</i><br><ol><li>(Pular) cheek</li></ol>
waɗugol	<i>verb</i><br><ol><li>(transitive) to do, construct</li><li>to place, put, leave (something)</li><li>to cause, provoke, bring about</li><li>(intransitive) to pass (of time), to happen, to take place, to come about</li></ol>
wifitorkun|wifitorkoy	<i>noun</i><br><ol><li>fan, whisk, flyswatter</li></ol>
wifugol	<i>verb</i><br><ol><li>(transitive) to refresh, ventilate, aerate</li></ol>
winndugol	<i>verb</i><br><ol><li>to write, record</li></ol>
wojere|wojere nde	<i>noun</i><br><ol><li>rabbit, hare</li></ol>
wonaa	<i>particle</i><br><ol><li>is not, it is not, not</li></ol>
wonande	<i>prep</i><br><ol><li>for</li></ol>
woncitugol	<i>verb</i><br><ol><li>(transitive) to put in order, fix, clean up, arrange</li></ol>
wonkii|wonkii ki	<i>noun</i><br><ol><li>soul</li></ol>
wonnde	<i>conj</i><br><ol><li>that</li></ol>
woo	<i>particle</i><br><ol><li>it is said that, it seems that</li><li>each, all</li><li>(with negative) none, no, only if</li></ol>
woodugol	<i>verb</i><br><ol><li>(intransitive) to exist</li></ol>
woyndu|boyli	<i>noun</i><br><ol><li>well (pit for extracting water)</li></ol>
wuumre|guuɓe ɓe	<i>noun</i><br><ol><li>bush</li></ol>
wuurugol	<i>verb</i><br><ol><li>(intransitive) to be living, be alive, live</li><li>to live on, survive on, eat</li></ol>
wuɓere|guɓe ɓe	<i>noun</i><br><ol><li>cracked grain</li></ol>
y|Y	<i>character</i><br><ol><li>A letter of the Fula alphabet, written in the Latin script.</li></ol>
yaakaare	<i>noun</i><br><ol><li>hope</li></ol>
yaawre|yaawre nde	<i>noun</i><br><ol><li>speed</li></ol>
yaggingol	<i>verb</i><br><ol><li>(transitive) to punish, correct</li></ol>
yaltugol	<i>verb</i><br><ol><li>(intransitive) to come out, go out, exit</li><li>to appear, happen (of a sign or phenomenon)</li></ol>
yamiroore|yamiroore nde|jamirooje ɗe|jamirooje	<i>noun</i><br><ol><li>(Pulaar) command, order</li></ol>
yankinagol	<i>verb</i><br><ol><li>(intransitive) to be humble, modest</li></ol>
yarirko	<i>noun</i><br><ol><li>moustache</li></ol>
ye	<i>particle</i><br><ol><li>so, therefore</li><li>truly</li><li>not at all</li></ol>
yeeso|geese ɗe|geese|yeeso ngo	<i>noun</i><br><ol><li>face</li><li>front</li></ol>
yewtidugol	<i>verb</i><br><ol><li>(intransitive) to chat with, discuss with, dialogue with</li></ol>
yewtugol	<i>verb</i><br><ol><li>(intransitive) to talk, dialogue, discuss, chat</li></ol>
yewugol	<i>verb</i><br><ol><li>(transitive) to destroy, decimate, eradicate</li></ol>
yiite|giiteeli|yiite nge	<i>noun</i><br><ol><li>fire</li></ol>
yiitirde	<i>noun</i><br><ol><li>address</li></ol>
yila	<i>noun</i><br><ol><li>wit, intelligence, conscience</li></ol>
yimugol	<i>verb</i><br><ol><li>(intransitive) to sing</li></ol>
yirbugol	<i>verb</i><br><ol><li>(intransitive) to fall into ruin, be ruined, be dilapidated, be collapsing, crumble</li><li>to suffer a defeat</li></ol>
yitere|yitere nde|gite ɗe|gite	<i>noun</i><br><ol><li>eye (organ used for seeing)</li></ol>
yurmeende|yurmeende nde	<i>noun</i><br><ol><li>mercy, compassion, clemency, grace</li></ol>
ñaagunde|ñaagunde nde	<i>noun</i><br><ol><li>petition, plea, proposal, request</li></ol>
ñaakii|ñaaki	<i>noun</i><br><ol><li>bee</li></ol>
ñaalal|ñaale ɗe|ñaalal ngal	<i>noun</i><br><ol><li>cattle egret</li></ol>
ñaamugol	<i>verb</i><br><ol><li>(transitive) to eat, consume</li><li>to spend, use up</li></ol>
ñaarde	<i>verb</i><br><ol><li>(intransitive) to shine</li></ol>
ñaañtude	<i>verb</i><br><ol><li>to card cotton</li></ol>
ñalaande|ñalaande or|balɗe ɗe	<i>noun</i><br><ol><li>day</li></ol>
ñallal	<i>noun</i><br><ol><li>day</li></ol>
ñamaande|ñamaande nde	<i>noun</i><br><ol><li>loan, debt</li></ol>
ñanndu	<i>noun</i><br><ol><li>food</li></ol>
ñaw|ñabbuuli|ñaw o	<i>noun</i><br><ol><li>disease, sickness</li></ol>
ñawlugol	<i>verb</i><br><ol><li>(transitive) to lend, give on credit</li></ol>
ñawu|ñabbuuli	<i>noun</i><br><ol><li>sickness, disease, illness</li></ol>
ñayko|ñayko ko	<i>noun</i><br><ol><li>stem</li><li>thatch</li></ol>
ñebbe	<i>noun</i><br><ol><li>bean</li></ol>
ñeeñal	<i>noun</i><br><ol><li>skill, cleverness, astuteness, shrewdness, ingeniousness, knowledge</li></ol>
ñiire|ñiiƴe|ñiire nde	<i>noun</i><br><ol><li>tooth</li></ol>
ñoynaade	<i>verb</i><br><ol><li>(intransitive) to kneel</li></ol>
ŋ|Ŋ	<i>character</i><br><ol><li>A letter of the Fula alphabet, written in the Latin script.</li></ol>
ŋakkugol	<i>verb</i><br><ol><li>(intransitive) to lack</li></ol>
ŋari|ŋari ki	<i>noun</i><br><ol><li>physical beauty</li></ol>
Ɓ|ɓ	<i>character</i><br><ol><li>The third letter of the Fula alphabet, written in the Latin script. Preceded by B and followed by C, and representing /ɓ/.</li></ol>
Ɗ|ɗ	<i>character</i><br><ol><li>The ninth letter of the Fula alphabet, written in the Latin script. Preceded by D (and often Nd) and followed by E, and representing /ɗ/.</li></ol>
ƴ|Ƴ	<i>character</i><br><ol><li>The last letter of the Fula alphabet, preceded by Y.</li></ol>
ƴanngal	<i>noun</i><br><ol><li>wooden bridge</li></ol>
ƴellitagol	<i>verb</i><br><ol><li>(intransitive) to ascend, climb to the summit of</li></ol>
ƴettitagol	<i>verb</i><br><ol><li>(intransitive) to be proud, arrogant</li></ol>
ƴettugol	<i>verb</i><br><ol><li>(transitive) to take, seize</li><li>to marry, take as a spouse</li></ol>
ƴi'al|ƴi'al ngal|ƴi'e ɗe	<i>noun</i><br><ol><li>(anatomy) bone</li><li>(language) consonant</li></ol>
ƴibbehi	<i>noun</i><br><ol><li>fig tree</li></ol>
ƴiire|ƴi'e ɗe|ƴiire nde	<i>noun</i><br><ol><li>(anatomy) bone</li></ol>
ƴiiƴam|ƴiiƴam ɗam	<i>noun</i><br><ol><li>blood</li></ol>
ƴulɓere|ƴulɓe ɓe	<i>noun</i><br><ol><li>embers, glowing coals or wood</li></ol>
ɓ|Ɓ	<i>character</i><br><ol><li>The third letter of the Fula alphabet, written in the Latin script. Preceded by B and followed by C, and representing /ɓ/.</li></ol>
ɓaawo|ɓaawe	<i>noun</i><br><ol><li>(anatomy) back, rear-end</li><li>back (of a thing)</li></ol><br><i>adv</i><br><ol><li>behind</li></ol><br><i>conj</i><br><ol><li>after</li></ol>
ɓadagol	<i>verb</i><br><ol><li>to approach, be near</li></ol>
ɓalal|ɓalal ngal	<i>noun</i><br><ol><li>support, foundation, base</li><li>principle</li></ol>
ɓanndu|ɓanndu ndu|ɓalli	<i>noun</i><br><ol><li>body</li><li>skin</li></ol>
ɓannginaande|ɓannginaaɗe	<i>noun</i><br><ol><li>explanation, clarification, declaration</li></ol>
ɓanngugol	<i>verb</i><br><ol><li>(intransitive) to appear, be manifest, be visible, be perceptible</li></ol>
ɓantaare	<i>noun</i><br><ol><li>development, growth, success</li></ol>
ɓawti	<i>conj</i><br><ol><li>after</li></ol>
ɓawto	<i>conj</i><br><ol><li>after (some amount of time)</li></ol>
ɓaŋagol	<i>verb</i><br><ol><li>(intransitive) to leave, go out</li><li>to recover, improve one's health</li></ol>
ɓe	<i>suffix</i><br><ol><li>Noun class indicator for nouns (plural) especially humans</li></ol><br><i>article</i><br><ol><li>(definite) the (when it follows the noun)</li></ol><br><i>det</i><br><ol><li>(used in indicating something)</li></ol>
ɓernde|ɓerɗe ɗe|ɓernde nde	<i>noun</i><br><ol><li>(anatomy) heart</li></ol>
ɓeydugol	<i>verb</i><br><ol><li>(transitive) to add, increase</li></ol>
ɓeyngu|ɓeyngu ngu	<i>noun</i><br><ol><li>children, one's posterity</li><li>motherhood</li></ol>
ɓeynguure|ɓeynguureeji	<i>noun</i><br><ol><li>family, (all the people living under the same roof, under the authority of a single head of the family, whatever their relation to that person)</li></ol>
ɓii|ɓiɓɓe ɓe|ɓii o	<i>noun</i><br><ol><li>child</li><li>offspring</li><li>fruit</li></ol>
ɓiraaɗan	<i>noun</i><br><ol><li>milk, fresh milk</li></ol>
ɓiɗaare	<i>noun</i><br><ol><li>sadness, melancholy, affliction</li></ol>
ɓiɗɗo|ɓiɓɓe ɓe|ɓiɗɗo o	<i>noun</i><br><ol><li>child, progeny, offspring</li><li>seed</li></ol>
ɓoggol|ɓoggi|ɓoggeeli	<i>noun</i><br><ol><li>cord, string</li><li>cable, telephone line</li></ol>
ɓokki|ɓohe ɗe|ɓokki ki	<i>noun</i><br><ol><li>baobab (Adansonia digitata)</li></ol>
ɓooldi	<i>noun</i><br><ol><li>(Adamawa) Hibiscus cannabinus</li></ol>
ɓornugol	<i>verb</i><br><ol><li>(transitive) to dress, clothe</li></ol>
ɓowro	<i>noun</i><br><ol><li>a thickening agent</li></ol>
ɓowrugol	<i>verb</i><br><ol><li>(intransitive) to be smooth, sticky, slimy, viscous</li></ol>
ɓoyre|ɓooƴe	<i>noun</i><br><ol><li>kidney</li></ol>
ɓunndu|ɓulli	<i>noun</i><br><ol><li>well, spring, fountain</li></ol>
ɓursirde|ɓursirɗe	<i>noun</i><br><ol><li>a stone on which cotton is ginned</li></ol>
ɓurtugol	<i>verb</i><br><ol><li>(intransitive) to exceed the limit, be exaggerated</li></ol>
ɓurugol	<i>verb</i><br><ol><li>exceed, surpass, be better, be superior, excel</li></ol>
ɓuteeru|ɓuteeru ndu	<i>noun</i><br><ol><li>straw hut</li><li>men's hut</li></ol>
ɗ|Ɗ	<i>character</i><br><ol><li>The sixth letter of the Fula alphabet, written in the Latin script. Preceded by D and followed by E, and representing /ɗ/.</li></ol>
ɗaa	<i>adv</i><br><ol><li>there</li></ol>
ɗaaleehi|ɗaaleehi ki|ɗaaleeje ɗe	<i>noun</i><br><ol><li>(Adamawa) African mahogany (Khaya senegalensis)</li></ol>
ɗam	<i>suffix</i><br><ol><li>Noun class indicator for nouns (singular) including liquids</li></ol><br><i>article</i><br><ol><li>(definite) the (when it follows the noun)</li></ol>
ɗatal|ɗatal ngal|ɗate	<i>noun</i><br><ol><li>route, road, path,</li><li>way, method, process</li><li>proceeding, rite</li></ol>
ɗaɗol|ɗaɗi ɗi	<i>noun</i><br><ol><li>root</li><li>tendon, nerve</li><li>vein, artery</li></ol>
ɗemŋgal|ɗemɗe|ɗemŋgal ŋgal|ɗemɗe ɗe	<i>noun</i><br><ol><li>language (system of communication)</li><li>tongue (organ)</li></ol>
ɗi	<i>article</i><br><ol><li>(definite) the (when it follows the noun)</li></ol><br><i>det</i><br><ol><li>(used in indicating something) (when it precedes the noun)</li></ol>
ɗiɗi	<i>num</i><br><ol><li>two</li></ol>
ɗiɗo	<i>num</i><br><ol><li>(Pulaar, Masina Fulfulde dialects, with human nouns) two</li></ol>
ɗo	<i>adv</i><br><ol><li>here</li></ol>
ɗoftaare	<i>noun</i><br><ol><li>obedience, submission</li></ol>
ɗowtude	<i>verb</i><br><ol><li>to accompany someone a short distance, see somebody to the road</li><li>to go along with somebody, accompany</li><li>to guide or lead somebody somewhere</li></ol>
ɗowtugol	<i>verb</i><br><ol><li>(transitive, active) to accompany, escort, lead out</li></ol>
ɗowugol	<i>verb</i><br><ol><li>(transitive) to guide, lead, direct</li></ol>
ɗuuɗugol	<i>verb</i><br><ol><li>(intransitive) to be numerous, abundant, many</li></ol>
ɗuytaare	<i>noun</i><br><ol><li>reduction, loss</li></ol>
ɗuɗɗingol	<i>verb</i><br><ol><li>(transitive) to raise, multiply, increase</li></ol>
ɠ|Ɠ	<i>character</i><br><ol><li>A letter of the Fula alphabet, written in the Latin script.</li></ol>
ݐ|ÿ́e	<i>character</i><br><ol><li>The third letter of the Fula in Arabic Script (equivalent to ƴ in the Latin script).</li></ol>
ݒ|ɓe	<i>character</i><br><ol><li>The fourth letter of the Fula in Arabic Script.</li></ol>
ࢡ|ḃe	<i>character</i><br><ol><li>The fifth letter of the Fula in Arabic Script.</li></ol>
ࢩ|ñah	<i>character</i><br><ol><li>The thirty-first letter of the Adamaua Fulfulde abjad. https://omniglot.com/writing/adamaua.htm</li></ol>
𞤊𞤵𞤤𞤬𞤵𞤤𞤣𞤫|Fulfulde	<i>name</i><br><ol><li>Fula language</li></ol>
