ሀየል|ሀየላት|häyyäl|and collective	<i>noun</i><br><ol><li>ibex</li></ol>
ሀገር|hägär|አህጉር	<i>noun</i><br><ol><li>cultivated field, inhabited land, province, country</li><li>countryside, hamlet, villa</li><li>town, city</li><li>farmer, inhabitant of a land, urban resident</li></ol>
ሁ	<i>pron</i><br><ol><li>him, his, it, its (bound object pronoun)</li></ol>
ሃ	<i>pron</i><br><ol><li>her (bound object pronoun)</li></ol>
ሄኖክ|henok	<i>name</i><br><ol><li>Enoch</li></ol>
ህየ|həyä	<i>adv</i><br><ol><li>there</li></ol>
ለውዝ|läwz	<i>noun</i><br><ol><li>almond</li></ol>
ለፌ|läfe	<i>adv</i><br><ol><li>thence, here and there, hither thither, from there</li><li>since, thenceforth</li><li>above, higher, over</li></ol>
ላህም|አልህምት|lahm	<i>noun</i><br><ol><li>cow, bull</li><li>cattle</li></ol>
ሌሊት|ለያልይ|läyaly|lelit	<i>noun</i><br><ol><li>night</li></ol>
ልሳን|ləsan	<i>noun</i><br><ol><li>tongue</li><li>speech</li><li>an isthmus, peninsula</li></ol>
ልብ|ləbb|አልባብ	<i>noun</i><br><ol><li>heart</li></ol>
ልብን|ləbn	<i>noun</i><br><ol><li>storax (Styrax officinalis, in particular the resin thereof)</li></ol>
ልብያ|ləbya	<i>name</i><br><ol><li>Libya (Greco-Roman client state)</li></ol>
ልጓም|ləgʷam|ልጓማት	<i>noun</i><br><ol><li>bridle</li><li>halter, band, holdfast</li></ol>
ሎሚ|lomi	<i>noun</i><br><ol><li>lime, lemon, citrus</li></ol>
ሐሊብ|ḥälib	<i>noun</i><br><ol><li>milk</li></ol><br><i>name</i><br><ol><li>Aleppo</li></ol>
ሐመዳ|ḥämäda	<i>noun</i><br><ol><li>snow, frost</li></ol>
ሐራቅሊ|ḥäraḳli	<i>name</i><br><ol><li>Heraclea</li></ol>
ሐብስ|ḥäbs	<i>noun</i><br><ol><li>prison, jail</li></ol>
ሓማሴን|ḥamasen	<i>name</i><br><ol><li>Hamasien (a historical province of Ethiopia)</li></ol>
ሓሳብ|ḥasab|ሐሳባት	<i>noun</i><br><ol><li>account, accounting, reckoning, calculation, chronology, price, portion, share</li></ol>
ሕምሥ|ḥəmś	<i>noun</i><br><ol><li>belly, stomach</li></ol>
ሕዝብ|አሕዛብ|ሕዘብ|ḥəzb	<i>noun</i><br><ol><li>tribe, people, nation</li></ol>
መሀረ|mähärä|mähär|መሀር	<i>verb</i><br><ol><li>to teach, instruct</li><li>to educate, train, discipline</li></ol>
መሀር|mähär|məhr|አመሀረ|Aksumite	<i>noun</i><br><ol><li>camels</li><li>goats</li><li>horses</li><li>camel foals</li></ol>
መላጼ|መላጽያት|mälaṣe	<i>noun</i><br><ol><li>knife, blade, razor used for shaving</li></ol>
መልአክ|mälʾäk|መልአክት	<i>noun</i><br><ol><li>(religion) angel</li><li>(rare) messenger, legate</li><li>commander, ruler</li></ol>
መልዕልተ|mälʿəltä	<i>prep</i><br><ol><li>on, upon, on top of</li></ol>
መምክር|መምካርት|mämkər|መምካራን	<i>noun</i><br><ol><li>counselor, adviser</li></ol>
መርከብ|märkäb	<i>noun</i><br><ol><li>boat, ship</li></ol>
መስከረም|mäskäräm	<i>noun</i><br><ol><li>First month of the Ethiopian calendar, roughly equivalent to September in the Gregorian Calendar.</li></ol>
መስኮት|mäskot|መሳክው	<i>noun</i><br><ol><li>window</li></ol>
መስፍሕ|mäsfəḥ	<i>noun</i><br><ol><li>anvil</li><li>surface</li><li>measure</li><li>hammer, mallet</li></ol>
መስፍን|mäsfən|መሳፍንት	<i>noun</i><br><ol><li>prince, prefect, governor, satrap</li><li>(biblical) judges of Israel</li></ol>
መቄዶንያ|mäḳedonya	<i>name</i><br><ol><li>Macedonia (Ancient Greek Kingdom)</li></ol>
መብልዕ|መባልዕ|mäbləʿ	<i>noun</i><br><ol><li>food, sustenance</li></ol>
መብረቅ|መባርቅት|mäbräḳ	<i>noun</i><br><ol><li>lightning</li></ol>
መትከፍት|መትከፍ|መታክፍ|mätkäf|mätkäft	<i>noun</i><br><ol><li>shoulder</li><li>(poetical) the yoke as the body part where a beast of burden carries load</li></ol>
መንግሥት|mängəśt|መንግሥታት	<i>noun</i><br><ol><li>kingdom</li><li>the power or dignity of kings</li><li>the royal family, the progeny of a king</li></ol>
መንፈስ|mänfäs|መንፈሳት	<i>noun</i><br><ol><li>breath</li><li>wind</li><li>spirit, vital force, life</li><li>soul, conscience</li><li>divine spirit, incorporeal spirits (I.e. angels, demons etc...)</li><li>spirit (of the dead)</li><li>ghost, spectre</li></ol>
መካ|mäka	<i>name</i><br><ol><li>Mecca</li></ol>
መካን|mäkan|መካናት	<i>noun</i><br><ol><li>place</li><li>space</li><li>occasion</li><li>inhabited place, region, land, seat</li><li>(arithmetic) number place</li></ol>
መዘምር|mäzämr|መዘምራን	<i>noun</i><br><ol><li>singer of psalms</li><li>psalmist</li><li>cantor</li></ol>
መዘነ|mäzzänä	<i>verb</i><br><ol><li>to weigh</li></ol>
መዝሙር|መዝሙራት|mäzmur	<i>noun</i><br><ol><li>psalm, hymn, sacred ode</li><li>book of psalms, psalter</li><li>psaltery, psalterium</li><li>a choir singing songs</li></ol>
መዲና|mädina	<i>name</i><br><ol><li>Medina</li></ol>
መጽሐፍ|mäṣḥäf|mäṣāḥəft|መጻሕፍት	<i>noun</i><br><ol><li>book</li><li>document</li><li>writing</li><li>inscription</li></ol>
ሙሴ|muse	<i>name</i><br><ol><li>(biblical) Moses</li></ol>
ሙዝ|muz	<i>noun</i><br><ol><li>ensete</li></ol>
ሚዛን|mizan	<i>verb</i><br><ol><li>balance, scales</li><li>Libra</li></ol>
ማእረር|maʾrär	<i>noun</i><br><ol><li>harvest, the action of reaping crops</li><li>harvest-time</li><li>the crops harvested, the crop</li><li>(Beta Israel) Shavuot, Pentecost</li></ol>
ማእድ|maʾədd|ማእዳት	<i>noun</i><br><ol><li>table</li><li>food, banquet</li><li>Eucharistic offering</li></ol>
ማይ|ማያት|may	<i>noun</i><br><ol><li>water</li></ol>
ምልሓ|məlḥa	<i>noun</i><br><ol><li>knowledge, judgement, wisdom</li><li>wit</li></ol>
ምሴት|ምሴታት|məset	<i>noun</i><br><ol><li>evening</li></ol>
ምስማዕ|məsmaʿ|ምስማዓት	<i>noun</i><br><ol><li>hearing, the sense of hearing</li><li>obedience</li><li>a hearing, an audience of listeners</li></ol>
ምንዳቤ|məndabyat|ምንዳቤያት|məndabe|məndabeyat|ምንዳብያት	<i>noun</i><br><ol><li>anguish</li><li>suffering, torment</li><li>hardship, distress</li><li>trouble, vexation</li></ol>
ምዕዋድ|məʿwad|ምዕዋዳት	<i>noun</i><br><ol><li>circuit, orbit</li><li>circle</li><li>sphere, globe</li></ol>
ምድር|mədr	<i>noun</i><br><ol><li>earth, world</li><li>land, nation</li><li>field, lands</li><li>soil, ground</li><li>dust</li><li>floor, pavement</li></ol>
ምጽባእ|məṣbaʾ	<i>noun</i><br><ol><li>castle, fortress, citadel</li></ol>
ሞቅሕ|መዋቅሕት|moḳḥ	<i>noun</i><br><ol><li>chain, shackles</li><li>jail, confinement, imprisonment</li></ol>
ሞተ|motä|conjugation ይሙት	<i>verb</i><br><ol><li>to die</li></ol>
ሞት|mot	<i>noun</i><br><ol><li>death</li></ol>
ሠለስቱ|ሠላስ|śälas|śälästu|ሠለስተ|ሠላሰ	<i>num</i><br><ol><li>three (3)</li></ol>
ሠላሳ|śälasa	<i>num</i><br><ol><li>thirty</li></ol>
ሠላስ|śälas|śälästu|ሠለስተ|ሠለስቱ|ሠላሰ	<i>num</i><br><ol><li>three (3)</li></ol>
ሠልስ|ሠልስት|śäls	<i>num</i><br><ol><li>third (3rd)</li></ol>
ሠርዌ|ሠራዊት|śärwe	<i>noun</i><br><ol><li>beam, rafter, timber, column</li><li>trunk, stem, stalk</li><li>(nautical) mast</li><li>beam of a weaver's loom</li></ol>
ሠቅ|śäḳḳ|ሠቃት	<i>noun</i><br><ol><li>a coarse fabric such as to make sacks</li><li>a vestment of such a fabric</li><li>a sack</li></ol>
ሠያጢ|ሠየጥ|śäyaṭi	<i>noun</i><br><ol><li>seller, vendor</li><li>merchant</li></ol>
ሢራይ|ሢራያት|śəray|ሥራያት|ሥራይ|śiray	<i>noun</i><br><ol><li>a kind of costly vestment</li></ol>
ሣህል|ሣህላት|śahl	<i>noun</i><br><ol><li>mercy, clemency, leniency</li></ol>
ሣሬት|śaret|ሳሬት|saret	<i>noun</i><br><ol><li>spider</li><li>cobweb</li></ol>
ሣዕር|śaʿr|አሥዕርት	<i>noun</i><br><ol><li>herb, grass, herbage, vegetation, hay</li></ol>
ሣጹን|ሣጹናት|śaṣun	<i>noun</i><br><ol><li>chest, box, casket, coffer</li></ol>
ሣፁን|ሣፁናት|śaṣ́un	<i>noun</i><br><ol><li>later form of ሣጹን (śaṣun)</li></ol>
ሥራይ|śəray|ሥራያት	<i>noun</i><br><ol><li>piece of witchcraft, spell</li><li>healing, medical application</li><li>pharmacon, medicament</li></ol>
ሥርናይ|śərnay	<i>noun</i><br><ol><li>wheat</li></ol>
ሥርው|አሥራው|ሥረው|śərw	<i>noun</i><br><ol><li>root</li><li>(figuratively) origin, cause, beginning, principle</li><li>base, foundation</li><li>nerve, muscle</li></ol>
ሥጋ|śəga|ሥጋት	<i>noun</i><br><ol><li>flesh</li><li>meat</li><li>that which is human as opposed to that which is divine</li><li>that which is carnal, as opposed to that which is spiritual</li><li>that which is alive as opposed to that which is dead</li><li>(euphemistic) pudendum, genitalia</li><li>the living body</li><li>corpse, cadaver</li></ol>
ረክብ|räkb	<i>noun</i><br><ol><li>assembly, meeting</li></ol>
ርትዐ|rətʿä	<i>noun</i><br><ol><li>rectitude, uprightness</li><li>probity, integrity, candor</li><li>rightness, legality</li><li>truth</li></ol>
ርእስ|rǝʾs|አርእስት	<i>noun</i><br><ol><li>head</li><li>height, peak, summit, top</li><li>leader, prince, top person</li><li>front, beginning, start</li><li>title, heading, summary</li></ol>
ርግብ|አርጋብ|rəgb	<i>noun</i><br><ol><li>dove, pigeon</li></ol>
ሮማን|roman|ሮማናት	<i>noun</i><br><ol><li>pomegranate</li></ol>
ሰሊካ|sälika	<i>noun</i><br><ol><li>cassia, Cinnamomum cassia syn. Cinnamomum aromaticum</li></ol>
ሰላም|sälam	<i>noun</i><br><ol><li>peace</li><li>security, safety, incolumity</li><li>greeting</li></ol>
ሰማኒ|ሰማንቱ|sämani|ሰማንተ|sämantu	<i>num</i><br><ol><li>eight (8)</li></ol>
ሰማንቱ|ሰማኒ|sämani|ሰማንተ|sämantu	<i>num</i><br><ol><li>eight (8)</li></ol>
ሰማይ|sämay|ሰማያት|ሰማየ	<i>noun</i><br><ol><li>heaven</li><li>sky</li></ol>
ሰምዐ|sämʿä	<i>verb</i><br><ol><li>to hear</li><li>to have the sense of hearing</li><li>to perceive with the ears, apprehend comprehend, discover, learn</li><li>to listen to, pay attention to, lend one's ears to</li><li>to hearken, hear the complaint, counsel, prayer of someone</li><li>to obey, comply with</li><li>to approve, assent, accept</li><li>to bear witness</li></ol>
ሰርዴስ|särdes	<i>name</i><br><ol><li>Sardis, Sardes</li></ol>
ሰበረ|säbärä|ይስብር	<i>verb</i><br><ol><li>to break</li></ol>
ሰበን|säbän	<i>noun</i><br><ol><li>kerchief, miter, scarf</li><li>handkerchief, sudary</li></ol>
ሰብእ|säbʾ	<i>noun</i><br><ol><li>(Singular and collective) man, human, mankind</li><li>household servants, relatives, one's household (those living in the house)</li><li>inhabitants, people, citizens, people of a country</li></ol>
ሰብዐቱ|säbʿu|ሰብዑ|säbʿätu|ሰብዐተ	<i>num</i><br><ol><li>seven (7)</li></ol>
ሰብዑ|ሰብዐቱ|ሰብዐተ|säbʿu|säbʿätu	<i>num</i><br><ol><li>seven (7)</li></ol>
ሰንቡላ|sänbula	<i>noun</i><br><ol><li>virgin</li></ol>
ሰዐት|ሰዓታት|ሰዓት|ሰዐታት|säʿat|säʿät	<i>noun</i><br><ol><li>hour</li><li>specified term or moment in time</li></ol>
ሰይ|säy	<i>noun</i><br><ol><li>woe, anguish, malum, dolour</li></ol>
ሰይል|säyl	<i>intj</i><br><ol><li>woe! alas!</li></ol><br><i>noun</i><br><ol><li>woe, sorrow, malum, calamity</li><li>foetus, embryo</li></ol>
ሰይፍ|säyf|አስያፍ	<i>noun</i><br><ol><li>sword</li></ol>
ሰገም|sägäm	<i>noun</i><br><ol><li>barley</li></ol>
ሲላን|ስለን|ሲለን|səlän|silän|silan	<i>noun</i><br><ol><li>dill (Anethum graveolens)</li></ol>
ሲድራስ|sidras	<i>name</i><br><ol><li>Isidorus</li></ol>
ሲዶና|sidona	<i>name</i><br><ol><li>Sidon</li></ol>
ሳሙኤል|samuʾel	<i>name</i><br><ol><li>Samuel</li></ol>
ሳባ|saba	<i>name</i><br><ol><li>Sheba, Saba</li><li>the Sabaeans</li></ol>
ሳኦል|saʾol	<i>name</i><br><ol><li>Saul</li></ol>
ስም|አስማት|səm	<i>noun</i><br><ol><li>name</li></ol>
ስምዖን|səmʿon	<i>name</i><br><ol><li>Simon, Simeon</li></ol>
ስርየት|səryät	<i>noun</i><br><ol><li>remission, forgiveness</li><li>expiation</li></ol>
ስሱ|ስድስቱ|ስድስተ|sədəstu|səssu	<i>num</i><br><ol><li>six (6)</li></ol>
ስቅራጥ|səḳraṭ	<i>name</i><br><ol><li>Socrates</li></ol>
ስብከት|səbkät	<i>noun</i><br><ol><li>preaching, proclaiming, announcing</li></ol>
ስብጥ|səbṭ	<i>noun</i><br><ol><li>rod, pointed shaft</li></ol>
ስናፔ|sənappe	<i>noun</i><br><ol><li>mustard (plant and spice)</li></ol>
ስን|ስነን|sǝnn	<i>noun</i><br><ol><li>tooth</li></ol>
ስድስቱ|ስድስተ|sədəstu|səssu|ስሱ	<i>num</i><br><ol><li>six (6)</li></ol>
ስግድ|səgd	<i>noun</i><br><ol><li>almond tree</li><li>any nut tree</li></ol>
ሶር|አስዋር|sor|ʾäswar	<i>noun</i><br><ol><li>ox</li><li>bull</li></ol>
ቀሬጢን|ḳäreṭin	<i>name</i><br><ol><li>Crete</li></ol>
ቀበረ|ḳäbärä	<i>verb</i><br><ol><li>to bury</li></ol>
ቀንአት|ḳännəʾät	<i>noun</i><br><ol><li>galbanum or stacta</li></ol>
ቀዳሚ|ḳädamyat|ḳädämt|ḳädami|ቀዳሚት|ḳädamit|ቀዳምያት|ቀደምት	<i>adj</i><br><ol><li>(ordinal number) first</li><li>early, original</li><li>ancient, prior</li></ol><br><i>noun</i><br><ol><li>beginning</li></ol>
ቃህራ|ḳahra	<i>name</i><br><ol><li>Cairo</li></ol>
ቃዴስ|ḳades	<i>name</i><br><ol><li>Mount Sinai</li></ol>
ቅዱስ|ቅዱሳን|qəddus	<i>adj</i><br><ol><li>holy, sacred</li></ol><br><i>noun</i><br><ol><li>saint</li></ol>
ቆመ|ḳomä	<i>verb</i><br><ol><li>to stand</li><li>to stop moving, remain in place</li><li>to stand around</li><li>to remain, persist, endure, withstand</li><li>to resist, stand firm</li><li>to stand apart, be separated</li></ol>
ቆበረ|ḳobärä	<i>verb</i><br><ol><li>to become black, dark, or foggy</li></ol>
ቆባረ|ḳobarä	<i>noun</i><br><ol><li>blackness, darkness</li><li>fog, mist, dust</li></ol>
ቈጽል|ḳʷäṣl|አቍጽል	<i>noun</i><br><ol><li>(singular and collective) leaf, leaves</li><li>page</li></ol>
ቍንፍዝ|ḳənfəz|ቅንፍዝ|ḳʷənfəz	<i>noun</i><br><ol><li>hedgehog</li><li>porcupine</li></ol>
በለስ|በለሳት|bäläs	<i>noun</i><br><ol><li>fig, also sycomore (fruit and tree)</li></ol>
በልዐ|bälʿä	<i>verb</i><br><ol><li>to eat, consume</li><li>(figuratively) to consume (of fire, the sword etc...)</li></ol>
በረቀ|bäräḳä	<i>verb</i><br><ol><li>to lightning</li><li>to thunder</li></ol>
በቅል|አብቅል|bäḳl	<i>noun</i><br><ol><li>mule</li></ol>
በዐልበክ|bäʿälbäk	<i>name</i><br><ol><li>Baalbek</li></ol>
በዓል|bäʿal	<i>noun</i><br><ol><li>owner, paterfamilias, husband</li><li>the Phoenician god Baal</li><li>festival, feast day, feast, banquet</li></ol>
በግዕ|bäggəʿ|አባግዕ	<i>noun</i><br><ol><li>sheep</li></ol>
በግዳድ|bägdad	<i>name</i><br><ol><li>Baghdad</li></ol>
ባሕር|baḥr|አብሕርት	<i>noun</i><br><ol><li>sea, large lake</li></ol>
ባቄላ|baḳela	<i>noun</i><br><ol><li>broad bean (Vicia faba)</li></ol>
ባቢሎን|babilon	<i>name</i><br><ol><li>Babylon</li></ol>
ቤት|bet|አብያት	<i>noun</i><br><ol><li>house</li></ol>
ብህለ|bəhlä	<i>verb</i><br><ol><li>to say</li><li>to speak</li><li>to call, name</li><li>to respond, answer</li><li>inquire, ask</li><li>to opine, relate</li></ol>
ብሔር|bəḥer|በሓውርት	<i>noun</i><br><ol><li>place, location</li><li>population, inhabitants, nations, dwellers</li><li>tribe, clan</li><li>parish, bishopric</li><li>world, earth</li></ol>
ብርስን|bərsən	<i>noun</i><br><ol><li>lentil</li></ol>
ብርክ|bərk	<i>noun</i><br><ol><li>knee</li></ol>
ብዙኅ|bəzuḫ	<i>adj</i><br><ol><li>(time) long</li><li>(people) many</li><li>(comparative) more</li><li>truly, strongly, very</li><li>(number of times) often, frequently, many times</li></ol>
ብዝኀት|bəzḫät	<i>noun</i><br><ol><li>multitude</li></ol>
ተልሚድ|tälmid	<i>noun</i><br><ol><li>student, pupil, disciple</li></ol>
ተመሀረ|tämähärä	<i>verb</i><br><ol><li>to be taught, be instructed</li><li>to learn</li><li>to consider, pay attention to</li></ol>
ተመሃሪ|tämähari|ተመሃርያን	<i>noun</i><br><ol><li>student, pupil, disciple</li></ol>
ተመን|ተመናት|tämän	<i>noun</i><br><ol><li>snake</li></ol>
ተምር|ተመርት|tämr	<i>noun</i><br><ol><li>date (fruit and tree)</li></ol>
ተስዐቱ|täsʿätu|təsʿu|ትስዑ|ተስዐተ	<i>num</i><br><ol><li>nine (9)</li></ol>
ተክሪዝ|täkriz	<i>noun</i><br><ol><li>proclamation, promulgation, edict (often clerical)</li><li>blessing, sanctification</li></ol>
ታሕት|taḥt	<i>adv</i><br><ol><li>below, under, underneath, beneath, downwards</li></ol>
ትርንጐ|tərəngʷä|ትርንጕ|tərəngʷ	<i>noun</i><br><ol><li>citron (Citrus medica)</li></ol>
ትስዑ|täsʿätu|təsʿu|ተስዐተ|ተስዐቱ	<i>num</i><br><ol><li>nine (9)</li></ol>
ትንቢት|ትንቢታት|tənbit	<i>noun</i><br><ol><li>prophecy</li><li>book of prophecy</li></ol>
ትእዛዝ|ትእዛዛት|təʾzaz	<i>noun</i><br><ol><li>imperial power</li><li>order, mandate, edict, statute, command</li><li>law</li><li>testament</li><li>obedience</li></ol>
ኀምስ|ኀምስተ|ኀምስቱ|ḫämsətu|ኀምሰ|ḫäms	<i>num</i><br><ol><li>five (5)</li></ol>
ኀምስቱ|ኀምስተ|ḫämsətu|ኀምሰ|ኀምስ|ḫäms	<i>num</i><br><ol><li>five (5)</li></ol>
ኀሪፍ|ḫärif	<i>noun</i><br><ol><li>this year, current year, current season</li></ol>
ኀንዚር|ኀናዚር|ḫänzir	<i>noun</i><br><ol><li>(uncommon) pig, swine</li></ol>
ኀይል|ḫäyl|ኀይላት	<i>noun</i><br><ol><li>life, power, force, energy</li><li>cause of strength</li><li>violence</li><li>a contest of strength</li><li>virtue, goodness, fortitude</li><li>power, ability</li></ol>
ኀጺን|ḫäṣin	<i>noun</i><br><ol><li>iron, iron tool</li><li>sword</li><li>armor</li><li>chain, band</li></ol>
ነ	<i>pron</i><br><ol><li>us, our (bound object pronoun)</li></ol>
ነቢይ|näbiyy|ነቢያት|näbiyat|ነቢይት|ነቢት|näbiyyət|näbit|ነብያት|ኖብያት|näbyat	<i>noun</i><br><ol><li>prophet</li><li>messenger</li></ol>
ነቢይት|näbiyy|ነቢያት|näbiyat|ነቢት|näbiyyət|ነቢይ|näbit|ነብያት|ኖብያት|näbyat	<i>noun</i><br><ol><li>prophetess</li></ol>
ነጥብ|näṭb	<i>noun</i><br><ol><li>speck, spot</li><li>full stop, period (indicating the end of a sentence)</li></ol>
ነፋስ|ነፋሳት|näfas	<i>noun</i><br><ol><li>wind</li><li>air, breeze</li></ol>
ነፍስ|ነፍሳት|näfs	<i>noun</i><br><ol><li>breath, soul, spirit</li></ol>
ኒ	<i>pron</i><br><ol><li>me (bound object pronoun)</li></ol>
ናሕስ|naḥs	<i>noun</i><br><ol><li>copper</li><li>bronze</li></ol>
ንስር|nəsr|nəsrä|አንስርት|ንስረ	<i>noun</i><br><ol><li>eagle</li></ol>
ንጉሥ|nəguś|ነገሥት|ነገሥታት	<i>noun</i><br><ol><li>king</li><li>duke, prince, prefect, satrap, tyrant, emperor</li></ol>
ኖባ|noba	<i>name</i><br><ol><li>Nubia</li></ol>
ኖኅ|noḫ	<i>name</i><br><ol><li>Noah</li></ol>
አለዳስ|ʾälädas	<i>name</i><br><ol><li>Greece</li></ol>
አላ|ʾäla	<i>conj</i><br><ol><li>but, yet</li><li>however</li></ol>
አልአሕመር|ʾälʾäḥmär	<i>name</i><br><ol><li>the Red Sea</li></ol>
አሐቲ|ʾäḥätti|አሐዱ|አሐተ|አሐደ|ʾäḥädu	<i>num</i><br><ol><li>one (1)</li></ol>
አሐዱ|ʾäḥätti|አሐተ|አሐቲ|አሐደ|ʾäḥädu	<i>num</i><br><ol><li>one (1)</li></ol>
አመት|ʾämät|አእማት	<i>noun</i><br><ol><li>handmaid, female slave</li></ol>
አማዑት|ʾämaʿut|አማዕዋት	<i>noun</i><br><ol><li>bowels, entrails</li></ol>
አራራት|ʾärarat	<i>name</i><br><ol><li>(biblical) Ararat</li></ol>
አርባዕ|አርባዕተ|አርባዐ|ʾärbaʿ|አርባዕቱ|ʾärbaʿtu	<i>num</i><br><ol><li>four (4)</li></ol>
አርባዕቱ|አርባዕተ|አርባዐ|ʾärbaʿ|ʾärbaʿtu|አርባዕ	<i>num</i><br><ol><li>four (4)</li></ol>
አርዝ|ʾärz	<i>noun</i><br><ol><li>cedar</li></ol>
አስብስጥያ|ʾäsbəsṭəya	<i>name</i><br><ol><li>Sebastia (Ancient Greco-Roman City), modern Sivas in Turkey</li></ol>
አስተስርዮ|ʾästäsrəyo	<i>noun</i><br><ol><li>atonement</li><li>(Beta Israel) Yom Kippur, the Day of Atonement</li></ol>
አቅሌስያ|ʾäḳlesya	<i>noun</i><br><ol><li>church</li></ol>
አበቢ|ʾäbäbi	<i>noun</i><br><ol><li>flow, wave</li></ol>
አቡነ|abuna	<i>noun</i><br><ol><li>our father</li></ol>
አብ|ʾab|ʾäb|አበው|ኣብ	<i>noun</i><br><ol><li>father</li></ol>
አቶር|ʾätor	<i>name</i><br><ol><li>Assyria</li></ol>
አንቄ|አናቅይ|ʾänḳe	<i>noun</i><br><ol><li>hawk, kite</li></ol>
አንተ|ከ|ʾantä	<i>pron</i><br><ol><li>you, thou (masculine singular subject pronoun)</li></ol>
አንቲ|ʾanti|ኪ	<i>pron</i><br><ol><li>you, thou (feminine singular subject pronoun)</li></ol>
አእምሮ|ʾäʾməro	<i>noun</i><br><ol><li>thought, knowledge</li><li>intelligence, intellect, discipline</li></ol>
አክሊል|ʾäklil|አክሊላት	<i>noun</i><br><ol><li>crown, diadem, tiara, mitre</li><li>taenia (a ribbon worn in the hair)</li></ol>
አድግ|ʾädg	<i>noun</i><br><ol><li>ass, donkey</li></ol>
አፍ|ʾäf|አፈው	<i>noun</i><br><ol><li>mouth</li><li>orifice, entrance</li><li>cutting edge of a sword</li></ol>
ኢትዮጵያ|ʾityop̣ya	<i>name</i><br><ol><li>Ethiopia (a country in East Africa)</li></ol>
ኤዶም|ʾedom	<i>noun</i><br><ol><li>(religion) paradise, Eden</li></ol>
እልኅቡስ|ʾəlḫəbus	<i>name</i><br><ol><li>Abyssinia</li></ol>
እመ|ʾəmä	<i>conj</i><br><ol><li>if, introduces the protasis of a conditional sentence</li></ol>
እም|ʾəm|ʾəmmat|እማት|ʾəmm	<i>noun</i><br><ol><li>mother</li></ol><br><i>conj</i><br><ol><li>if, introduces the protasis of a conditional sentence</li></ol>
እራሕ|እራሓት|ʾəraḥ	<i>noun</i><br><ol><li>palm of the hand</li><li>foot of a plant</li></ol>
እሳት|ʾəsat	<i>noun</i><br><ol><li>fire</li></ol>
እስራኤል|ʾəsraʾel	<i>noun</i><br><ol><li>(biblical) Israel</li></ol>
እስክንድርያ|ʾəskəndərya	<i>name</i><br><ol><li>Alexandria</li></ol>
እባል|ʾəbal	<i>noun</i><br><ol><li>flesh</li><li>member</li><li>limb</li><li>genitals</li></ol>
እብል|ʾəbl	<i>noun</i><br><ol><li>jackal, lion</li></ol>
እብን|እበን|ʾəbn	<i>noun</i><br><ol><li>stone</li></ol>
እኅት|ʾəḫt|አኃት|እኅታት	<i>noun</i><br><ol><li>sister</li></ol>
እንስሳ|ʾənsəsa|እንስሳት	<i>noun</i><br><ol><li>animal</li></ol>
እንቁጣጣሽ|ʾənḳuṭaṭaš	<i>noun</i><br><ol><li>The first day of the Ethiopian calendar Year, celebrated as a New Year festival</li></ol>
እኤል|ʾəʾel	<i>noun</i><br><ol><li>trellis, lattice, grate, post</li></ol>
እክል|ʾəkl|እክላት	<i>noun</i><br><ol><li>food</li><li>corn, grain, field crop</li></ol>
እዝን|ʾəzn|እዘን	<i>noun</i><br><ol><li>ear</li></ol>
እድ|ʾəd|እደው	<i>noun</i><br><ol><li>hand</li><li>arm</li><li>leg (of animals)</li><li>part</li><li>side</li></ol>
እግር|ʾəgr|እገር	<i>noun</i><br><ol><li>(anatomy) foot</li><li>foot (the measurement)</li><li>ray of sunshine</li><li>prow</li></ol>
እግዚአብሔር|ʾəgziʾäbḥer	<i>name</i><br><ol><li>(Christianity, Judaism) God</li></ol>
ከ	<i>pron</i><br><ol><li>you, your (masculine singular bound object pronoun)</li></ol>
ከላዴዎን|käladewon	<i>noun</i><br><ol><li>Chaldean</li><li>magician</li></ol>
ከላድዮን|käladyon	<i>name</i><br><ol><li>Chaldaea</li></ol>
ከልብ|ከለባት|kalb	<i>noun</i><br><ol><li>dog</li></ol>
ከረዘ|käräzä	<i>verb</i><br><ol><li>to proclaim, preach</li></ol>
ከርካዕ|kärkaʿ	<i>noun</i><br><ol><li>almond (fruit and tree)</li><li>walnut (fruit and tree)</li></ol>
ከበሮ|ከባርው|käbäro	<i>noun</i><br><ol><li>drum, timbrel</li></ol>
ከተማ|kätäma|ከተማት	<i>noun</i><br><ol><li>extremity, fine, end</li><li>tip, apex, summit, cusp</li><li>military camp, garrison, cantonment</li></ol>
ከተበ|conjugation ይክትብ|kätäbä	<i>verb</i><br><ol><li>to write, to register</li></ol>
ከኒሳ|känisa|ከናይስ	<i>noun</i><br><ol><li>congregation, synagogue, religion meeting</li></ol>
ከናኔዎን|känanewon	<i>name</i><br><ol><li>(biblical) the Canaanites</li></ol>
ኪ	<i>pron</i><br><ol><li>you, your (feminine singular bound object pronoun)</li></ol>
ካህን|kahn|ካህናት	<i>noun</i><br><ol><li>priest, clergyman</li></ol>
ካልእ|ካልእት|kalʾ	<i>num</i><br><ol><li>second (2nd)</li></ol>
ካዕብ|kaʿb|ካዔብት	<i>num</i><br><ol><li>second (2nd)</li></ol>
ክልኤቱ|kəlʾeti|ክልኤተ|kəlʾetu|ክልኤቲ	<i>num</i><br><ol><li>two (2)</li></ol>
ክልኤቲ|kəlʾeti|ክልኤቱ|ክልኤተ|kəlʾetu	<i>num</i><br><ol><li>two (2)</li></ol>
ክመ|kəmä	<i>prep</i><br><ol><li>like as</li></ol><br><i>conj</i><br><ol><li>like, as</li><li>but, however, yet</li></ol><br><i>adv</i><br><ol><li>almost, like</li><li>yourself, hisself, itself</li><li>not only _x_but also_y_</li><li>somewhat</li><li>only, just</li></ol>
ክታብ|kətab|ክታባት	<i>noun</i><br><ol><li>book, leaflet, document, chit</li><li>charm, spell, amulet, fetish</li></ol>
ክንፍ|ከነፍ|አከናፍ|kənf	<i>noun</i><br><ol><li>wing, fin (of fish), branch (of tree) , border, edge</li></ol>
ክዳን|kədan|ክዳናት	<i>noun</i><br><ol><li>shelter, cover</li><li>veil, awning</li><li>garment</li><li>covering, sheath, drape</li><li>mantle, cloak</li><li>tunic</li></ol>
ኮር|kor	<i>noun</i><br><ol><li>saddle</li></ol>
ኮከብ|ከዋክብት|kokäb	<i>noun</i><br><ol><li>star</li></ol>
ኮክ|kok	<i>noun</i><br><ol><li>peach, plum</li></ol>
ኵርጅ|kʷərǧ	<i>name</i><br><ol><li>Georgia (in the Caucasus)</li></ol>
ኵናት|ኵያንው|kʷənat	<i>noun</i><br><ol><li>lance, javelin, shorter or generic spear</li><li>sword</li><li>arms</li><li>war</li></ol>
ወልድ|wäld|wəlud|ውሉድ	<i>noun</i><br><ol><li>son, child</li></ol>
ወቅፍ|wäḳf|አውቃፍ	<i>noun</i><br><ol><li>bracelet, armlet</li></ol>
ውሒዝ|ውሒዛት|wəḥiz	<i>noun</i><br><ol><li>river, stream</li></ol>
ውሳጤ|ውሳጥያት|wəsaṭe	<i>noun</i><br><ol><li>the inside (of something), the innermost part, the interior</li><li>chamber, room</li></ol>
ውዕላ|wəʿəla	<i>noun</i><br><ol><li>an antelope or mountain goat</li></ol>
ዐምድ|አዕማድ|ʿämd	<i>noun</i><br><ol><li>column supporting member in a structure</li><li>stylite</li><li>obelisk, pillar</li><li>(nautical) mast</li><li>stele, statue</li><li>scapus, pole of a candlestick</li><li>a column of text</li></ol>
ዐሞን|ʿämon	<i>name</i><br><ol><li>(biblical) Ammon, the Ammonites</li></ol>
ዐሠርቱ|ዐሥሩ|ʿäśru|ʿäśärtu|ዐሠርተ	<i>num</i><br><ol><li>ten (10)</li></ol>
ዐሥሩ|ዐሠርተ|ዐሠርቱ|ʿäśärtu|ʿäśru	<i>num</i><br><ol><li>ten (10)</li></ol>
ዐርክ|ዐርክት|ʿärk|አዕርክት|ʿärəkt|ዐርካት|ዐርካን	<i>noun</i><br><ol><li>friend</li><li>best man</li></ol>
ዐርክት|ዐርክ|ʿärk|አዕርክት|ʿärəkt|ዐርካት|ዐርካን	<i>noun</i><br><ol><li>female friend</li><li>(euphemistic) snake</li></ol>
ዐዋዲ|ʿäwadi	<i>noun</i><br><ol><li>herald</li></ol>
ዓለም|ዓለማት|ʿaläm	<i>noun</i><br><ol><li>universe, world</li></ol>
ዓመት|ʿamät|ዓመታት	<i>noun</i><br><ol><li>year</li><li>era, epoch</li></ol>
ዓም|ʿam	<i>noun</i><br><ol><li>year</li></ol>
ዓዲ|ʿadi	<i>adv</i><br><ol><li>yet, still, even now</li><li>still, further, moreover</li><li>again, once more</li><li>in addition, else</li><li>so many, so much, to such an extent</li><li>however</li><li>rather, instead</li><li>but also, yet also</li></ol>
ዕንጐት|ʿəngʷät|ዕንጐታት	<i>noun</i><br><ol><li>mountain plum (Ximenia americana)</li></ol>
ዕዋዴ|ʿəwade|ዕዋድያት	<i>noun</i><br><ol><li>globe, circuit, revolution</li><li>circle, cycle</li></ol>
ዕጣን|ʿəṭan|ዕጣናት	<i>noun</i><br><ol><li>incense, odorament</li></ol>
ዕፄ|ʿəṣ́e|ዕፄያት	<i>noun</i><br><ol><li>moth; worm</li></ol>
ዕፅ|ʿəṣ́	<i>noun</i><br><ol><li>tree</li></ol>
ዖፍ|አዕዋፋት|አዕዋፍ|ʿof	<i>noun</i><br><ol><li>(Singular and collective) bird</li></ol>
ዘመረ|zämärä	<i>verb</i><br><ol><li>to sing</li><li>to praise with songs, to sing psalms</li></ol>
ዘመን|አዝማን|ዘመናት|zämän	<i>noun</i><br><ol><li>time</li><li>age (of a person)</li><li>age, era, period, century</li><li>time of the year</li><li>season</li></ol>
ዘበጠ|conjugation ይዝብጥ|zäbäṭä	<i>verb</i><br><ol><li>to beat, to hit, to strike, to blow</li><li>to chastise, to beat for punishment etc.</li><li>to beat or strike as on an instrument to play, to pluck (as Serbo-Croatian svírati)</li></ol>
ዘነብ|zänäb|አዝናብ	<i>noun</i><br><ol><li>tail</li></ol>
ዘይት|zäyt	<i>noun</i><br><ol><li>olive tree</li><li>olive</li><li>oil</li></ol>
ዜና|ዜናት|zena	<i>noun</i><br><ol><li>announcement, message, news</li><li>rumor, reputation, fame</li><li>story, narration</li></ol>
ዝእብ|zǝʾb	<i>noun</i><br><ol><li>hyena</li></ol>
ዝክር|zəkr	<i>noun</i><br><ol><li>memory, remembrance, record, mention</li><li>sacrifice, memorial</li><li>commemoration, ode</li><li>grave, sepulcher</li><li>fame, renown</li></ol>
ዝፍት|zəft	<i>noun</i><br><ol><li>pitch, tar, latex, even resin of a pine as well as asphalt</li></ol>
የ	<i>pron</i><br><ol><li>my (bound object pronoun)</li></ol>
ይስሐቅ|yəsḥäḳ	<i>name</i><br><ol><li>Isaac</li></ol>
ዮም|yom	<i>adv</i><br><ol><li>today</li></ol>
ደም|däm|ደማት	<i>noun</i><br><ol><li>blood</li></ol>
ደቂቅና|däḳiḳna	<i>noun</i><br><ol><li>childhood</li></ol>
ደብር|däbr|አድባራት	<i>noun</i><br><ol><li>mountain</li><li>mountain range, hills</li><li>city, metropolis</li><li>boundary, border</li><li>diocese</li><li>monastery, convent</li><li>church</li></ol>
ዲበ|dibä	<i>prep</i><br><ol><li>to, on, for, imminent to, indicates direction, particularly movement over a thing</li><li>on account of, for the sake of</li><li>amongst, in addition to, on top of</li></ol>
ዳንያ|danya	<i>noun</i><br><ol><li>judge</li></ol>
ዳግም|ዳግምት|dagm	<i>num</i><br><ol><li>second (2nd)</li></ol>
ድርዕ|dərʿ	<i>noun</i><br><ol><li>breastplate, coat of mail, harness</li></ol>
ድርገት|dərgät|ድርገታት	<i>noun</i><br><ol><li>union, association, congregation</li><li>order, rank, class</li></ol>
ድብ|ድባት|dǝbb|and collective	<i>noun</i><br><ol><li>bear</li></ol>
ድንግል|ደናግል|dəngəl	<i>noun</i><br><ol><li>virgin (female but also male)</li></ol>
ዶርሆ|dorho|ደዋርህ	<i>noun</i><br><ol><li>chicken</li><li>bird</li></ol>
ገብር|gäbr|አግብርት	<i>noun</i><br><ol><li>servant, slave</li></ol>
ገብገብ|gäbgäb	<i>noun</i><br><ol><li>entrance room, vestibule, atrium</li></ol>
ገቦ|ገበዋት|gäbo	<i>noun</i><br><ol><li>side, flank of the body and other things</li></ol>
ገነት|ገነታት|gännät	<i>noun</i><br><ol><li>garden, park, or any luxuriant stead</li><li>Paradise</li></ol>
ገውዝ|gäwz	<i>noun</i><br><ol><li>walnut</li><li>nut in general (because the walnut isn’t really known in Ethiopia)</li><li>odoriferous substance from hard plant products, perfume</li></ol>
ገይስ|gäys	<i>noun</i><br><ol><li>departure, journey, leave particularly in the morning, verbal noun of ጌሰ (gesä, “to go in the morning”)</li></ol>
ገጽ|ገጻት|gäṣ	<i>noun</i><br><ol><li>(singular and collective) face</li><li>aspect, visage, eyes</li><li>form, appearance, physiognomy, complexion</li><li>presence, countenance</li></ol>
ጊሜ|gime	<i>noun</i><br><ol><li>cloud</li><li>snow, snowy weather</li></ol>
ጋዛ|gaza	<i>name</i><br><ol><li>Gaza</li></ol>
ጌርጌሴዎን|gergesewon	<i>name</i><br><ol><li>(biblical) the Girgashites</li></ol>
ጌሰ|ገይስ|gesä|conjugation ይጊስ	<i>verb</i><br><ol><li>to depart, journey, to go or leave particularly in the morning [+accusative = to]</li></ol>
ጌሰም|gesäm	<i>noun</i><br><ol><li>tomorrow, morrow</li></ol><br><i>adv</i><br><ol><li>tomorrow</li></ol>
ግልባብ|gəlbab	<i>noun</i><br><ol><li>veil</li><li>covering</li></ol>
ግዕዝ|gəʿz	<i>noun</i><br><ol><li>Ge'ez (language)</li></ol>
ጎር|አግዋር|gor	<i>noun</i><br><ol><li>neighbour</li></ol>
ጠሊ|ṭäli|ጠሊት|አጣሊ	<i>noun</i><br><ol><li>goat-child, kid</li><li>goat</li></ol>
ጠራው|ṭäraw	<i>noun</i><br><ol><li>(Astronomy) the Pleiades</li></ol>
ጢሮስ|ṭiros	<i>name</i><br><ol><li>Tyre</li></ol>
ጥንፍ|ጥነፍ|ṭənf	<i>noun</i><br><ol><li>prominence, superstructure</li><li>cornice, crossbeam of a building, joint between pillars etc.</li></ol>
ጸለለ|ṣälälä	<i>verb</i><br><ol><li>to hover, float</li><li>to fly</li></ol>
ጸሊም|ጸላም|ṣälim	<i>adj</i><br><ol><li>black, dark-colored</li><li>dark</li></ol>
ጸልመት|ṣälmät	<i>noun</i><br><ol><li>darkness, shade, shadow, dimness</li></ol>
ጸሐፈ|conjugation ይጽሐፍ|ṣäḥäfä	<i>verb</i><br><ol><li>to write</li></ol>
ጸሓፊ|ṣäḥafi|ጸሐፍ	<i>noun</i><br><ol><li>scribe</li><li>man of letters, scholar</li><li>writer</li><li>author of books</li><li>historian</li></ol>
ጸባኢ|ṣäbaʾi|ጸባእያን	<i>noun</i><br><ol><li>soldier, warrior, fighter</li></ol>
ጸብእ|አጽባእ|አጽባእት|ṣäbʾ	<i>noun</i><br><ol><li>army, armed forces</li><li>host</li><li>war expedition, battle</li></ol>
ጻህቅ|ṣahḳ|ጻህቃት	<i>noun</i><br><ol><li>petition</li><li>lack, dearth, impecuniosity</li><li>study, effort, zeal</li><li>solicitude</li></ol>
ጻጹት|ṣaṣot|ጻጾት|ṣaṣut	<i>noun</i><br><ol><li>gnat</li><li>red ant</li></ol>
ጽላሎት|ṣəlalot	<i>noun</i><br><ol><li>shade</li><li>dimness</li><li>shadow, darkness</li><li>protection</li><li>shade-shelter</li></ol>
ጽሌ|ṣəle	<i>noun</i><br><ol><li>tablet</li></ol>
ጽልመት|ṣəlmät	<i>noun</i><br><ol><li>darkness</li></ol>
ጽሩር|ṣərur	<i>noun</i><br><ol><li>cuirass</li><li>armor</li></ol>
ጽርእ|ṣərʾ	<i>name</i><br><ol><li>Greece</li></ol>
ጽናዔ|ṣənaʿe	<i>noun</i><br><ol><li>constance, firmness</li></ol>
ጽዮን|ṣəyon	<i>name</i><br><ol><li>(biblical) Zion</li></ol>
ጽድቅ|ṣədḳ	<i>noun</i><br><ol><li>law, right, justness</li><li>merit</li><li>innocence, piety, probity, uprightness, virtue, sanctity</li><li>imputed justice, justification</li><li>beneficence, mercy</li><li>restitution, absolution</li><li>wellbeing, health, safety</li><li>truth</li></ol>
ጾላዕ|ጾልዓት|ṣolaʿ	<i>noun</i><br><ol><li>stone, rock, cliff</li></ol>
ፀሓይ|ṣ́äḥay	<i>noun</i><br><ol><li>sun</li></ol>
ፃፄ|ṣ́aṣ́e	<i>noun</i><br><ol><li>moth; worm</li></ol>
ፄወወ|ṣ́ewäwä	<i>verb</i><br><ol><li>to capture, take captive</li><li>to lead off, plunder, loot ( as cattle, goods)</li><li>to lead people into exile</li><li>to conquer, subdue</li></ol>
ፄዋ|ṣ́ewa	<i>noun</i><br><ol><li>exile</li><li>captivity</li></ol>
ፈረስ|አፍራስ|färäs	<i>noun</i><br><ol><li>horse</li></ol>
ፈርየ|färyä	<i>verb</i><br><ol><li>to flower, to emit flowers</li><li>bear fruit</li><li>to come forth (of fruit)</li></ol>
ፈትል|fätl|አፍትልት|አፍታል	<i>noun</i><br><ol><li>thread, yarn, cord</li><li>metallic wire</li><li>lamp-wick</li><li>spiderweb</li></ol>
ፋርስ|fars	<i>name</i><br><ol><li>Persia, the Persians</li><li>Chaldaea, the Chaldaeans</li><li>Assyria, the Assyrians</li></ol>
ፋሲካ|fasika	<i>noun</i><br><ol><li>Easter</li><li>(Beta Israel) Passover, Pesach</li><li>paschal lamb</li></ol>
ፍሬ|fəre	<i>noun</i><br><ol><li>fruit</li><li>seed</li><li>progeny, offspring</li></ol>
ፍቅር|fəḳr	<i>noun</i><br><ol><li>love, fondness</li><li>charity</li><li>hospitality</li><li>agape</li></ol>
’abbasa	<i>romanization</i><br><ol><li>Romanization of አበሰ</li></ol>
