A	<i>character</i><br><ol><li>The first letter of the Haitian Creole alphabet, written in the Latin script.</li></ol>
Afrik	<i>name</i><br><ol><li>Africa</li></ol>
Ajantin	<i>name</i><br><ol><li>Argentina (a country in South America)</li></ol>
Akennsas	<i>name</i><br><ol><li>Arkansas</li></ol>
Amerik dinò	<i>name</i><br><ol><li>North America</li></ol>
Amerik disid	<i>name</i><br><ol><li>South America</li></ol>
An nou pa lage!	<i>phrase</i><br><ol><li>Let's not give up!</li></ol>
Antatik	<i>name</i><br><ol><li>Antarctica</li></ol>
Antiy	<i>name</i><br><ol><li>Antilles</li></ol>
Ayisyen	<i>noun</i><br><ol><li>Haitian (person from Haiti)</li></ol>
Ayiti	<i>name</i><br><ol><li>Haiti (a country in the Caribbean)</li></ol>
Azi	<i>name</i><br><ol><li>Asia</li></ol>
Bondye	<i>name</i><br><ol><li>God</li></ol>
Brezil	<i>name</i><br><ol><li>Brazil (a country in South America)</li></ol>
Dayiti	<i>adj</i><br><ol><li>of Haiti</li></ol>
Enndyana	<i>name</i><br><ol><li>Indiana</li></ol>
Espay	<i>name</i><br><ol><li>Spain</li></ol>
Estoni	<i>name</i><br><ol><li>Estonia</li></ol>
Etazini	<i>name</i><br><ol><li>United States (a country in North America)</li></ol>
Ewòp	<i>name</i><br><ol><li>Europe</li></ol>
Frans	<i>name</i><br><ol><li>France</li></ol>
Indiana	<i>name</i><br><ol><li>Indiana</li></ol>
Iranis	<i>name</i><br><ol><li>Uranus</li></ol>
Itali	<i>name</i><br><ol><li>Italy</li></ol>
Izrayèl	<i>name</i><br><ol><li>Israel</li></ol>
Jakmèl	<i>name</i><br><ol><li>Jacmel (a port town and commune and capital of the Sud-Est department, Haiti)</li></ol>
Jezikri	<i>name</i><br><ol><li>Jesus Christ</li></ol>
Jipitè	<i>name</i><br><ol><li>Jupiter</li></ol>
Jòb	<i>name</i><br><ol><li>Job</li></ol>
Kanada	<i>name</i><br><ol><li>Canada (a country in North America)</li></ol>
Kap Ayisyen	<i>name</i><br><ol><li>Cap-Haïtien (a city on the north coast of Haiti).</li></ol>
Kris	<i>name</i><br><ol><li>Christ</li></ol>
Kwoasi	<i>name</i><br><ol><li>Croatia</li></ol>
Latè	<i>name</i><br><ol><li>Alternative letter-case form of latè</li></ol>
Mas	<i>name</i><br><ol><li>Mars</li></ol>
Monreyal	<i>name</i><br><ol><li>Montreal (the largest city in Quebec, Canada)</li><li>Montreal (an island in Quebec, Canada, the site of the city of Montreal)</li></ol>
Mèki	<i>name</i><br><ol><li>Mercury</li></ol>
Nasyon Zini|Nasyonzini	<i>name</i><br><ol><li>United Nations</li></ol>
Okay	<i>name</i><br><ol><li>A seaport and commune of Cayes borough, Sud department, Haiti</li><li>An arrondissement of the Sud department, Haiti</li></ol>
Olicha	<i>name</i><br><ol><li>(voodoo) A lwa, who considered to be cruel and knowledgeable about medicinal plants.</li></ol>
Oregon	<i>name</i><br><ol><li>Oregon</li></ol>
Oseyani	<i>name</i><br><ol><li>Oceania</li></ol>
Owayo	<i>name</i><br><ol><li>Ohio</li></ol>
Ozetazini	<i>adv</i><br><ol><li>in the United States</li><li>to the United States</li></ol>
Pari	<i>name</i><br><ol><li>Paris (the capital and largest city of France)</li></ol>
Pari Antiy yo	<i>name</i><br><ol><li>(historical) Synonym of Kap Ayisyen</li></ol>
Pawòl	<i>name</i><br><ol><li>Word</li></ol>
Pòl	<i>name</i><br><ol><li>(biblical) Paul</li></ol>
Pòtoprens	<i>name</i><br><ol><li>Port-au-Prince</li></ol>
Satin	<i>name</i><br><ol><li>Saturn</li></ol>
Sentespri	<i>name</i><br><ol><li>Holy Spirit</li></ol>
Seyè	<i>name</i><br><ol><li>Lord (God)</li></ol>
Swis	<i>name</i><br><ol><li>Switzerland</li></ol>
Syèd	<i>name</i><br><ol><li>Sweden</li></ol>
Venezuela	<i>name</i><br><ol><li>Venezuela (a country in South America)</li></ol>
Venis	<i>name</i><br><ol><li>Venus</li></ol>
Vodou	<i>name</i><br><ol><li>voodoo (religion)</li></ol>
Wikipedya	<i>name</i><br><ol><li>Wikipedia</li></ol>
Wòm	<i>name</i><br><ol><li>Rome</li></ol>
a	<i>article</i><br><ol><li>the, definite article</li></ol>
abandone	<i>verb</i><br><ol><li>to abandon</li></ol>
abdenwel	<i>noun</i><br><ol><li>Christmas tree</li></ol>
abi	<i>noun</i><br><ol><li>clothes</li></ol>
abilite	<i>noun</i><br><ol><li>ability</li></ol>
abita	<i>noun</i><br><ol><li>(biology) habitat</li></ol>
abitid	<i>noun</i><br><ol><li>habit</li></ol>
aboli	<i>verb</i><br><ol><li>To abolish</li></ol>
abolisyon	<i>noun</i><br><ol><li>abolition</li></ol>
abondans	<i>noun</i><br><ol><li>abundance</li></ol>
abyotik	<i>adj</i><br><ol><li>(ecology) abiotic</li></ol>
abònman	<i>noun</i><br><ol><li>subscription</li></ol>
achte	<i>verb</i><br><ol><li>To buy</li></ol>
adaptasyon	<i>noun</i><br><ol><li>adaptation</li></ol>
adapte	<i>verb</i><br><ol><li>to adapt</li></ol>
administratè	<i>noun</i><br><ol><li>administrator</li></ol>
adokine	<i>adj</i><br><ol><li>paved</li></ol>
adore	<i>verb</i><br><ol><li>adore</li><li>worship</li></ol>
afyo	<i>noun</i><br><ol><li>nutgrass, Cyperus rotundus</li></ol>
afè	<i>noun</i><br><ol><li>affair</li></ol>
agrave	<i>verb</i><br><ol><li>worsen, aggravate</li></ol>
ahier	<i>adv</i><br><ol><li>(Saint-Domingue) yesterday</li></ol>
aji	<i>verb</i><br><ol><li>act</li></ol>
ak	<i>conj</i><br><ol><li>and; connects two noun phrases.</li></ol><br><i>prep</i><br><ol><li>with</li></ol>
akaryat	<i>adj</i><br><ol><li>grouchy, grumpy, fussy</li></ol>
akeyoloji	<i>noun</i><br><ol><li>archaeology</li></ol>
akimile	<i>verb</i><br><ol><li>accumulate</li></ol>
akselerasyon	<i>noun</i><br><ol><li>acceleration</li></ol>
aksidan	<i>noun</i><br><ol><li>accident</li></ol>
aktivite	<i>noun</i><br><ol><li>activity</li></ol>
akòz	<i>prep</i><br><ol><li>because of</li></ol>
al	<i>verb</i><br><ol><li>to go</li></ol>
ale	<i>verb</i><br><ol><li>go</li></ol>
aletranje	<i>adv</i><br><ol><li>abroad, overseas</li></ol>
alfabe	<i>noun</i><br><ol><li>alphabet</li></ol>
alkòl	<i>noun</i><br><ol><li>alcohol</li></ol>
ameriken	<i>adj</i><br><ol><li>American</li></ol>
an	<i>article</i><br><ol><li>the (definite article)</li></ol><br><i>noun</i><br><ol><li>year</li></ol>
anba	<i>adj</i><br><ol><li>downstairs</li></ol><br><i>adv</i><br><ol><li>below, downstairs</li></ol><br><i>prep</i><br><ol><li>under; below; underneath</li></ol>
anba bra	<i>noun</i><br><ol><li>armpit</li></ol>
anch	<i>noun</i><br><ol><li>hip</li></ol>
andedan	<i>prep</i><br><ol><li>inside, in</li></ol>
andwa	<i>noun</i><br><ol><li>place</li></ol>
ang	<i>noun</i><br><ol><li>angle</li></ol>
angle|anglè	<i>noun</i><br><ol><li>English language</li></ol>
animal	<i>noun</i><br><ol><li>animal</li></ol>
anjeneral	<i>adv</i><br><ol><li>generally, in general</li></ol>
ankò	<i>adv</i><br><ol><li>again</li></ol>
anlè	<i>adj</i><br><ol><li>flighty, frivolous</li></ol><br><i>adv</i><br><ol><li>above, on high</li></ol><br><i>noun</i><br><ol><li>upper part, top</li></ol><br><i>prep</i><br><ol><li>above, on top of</li></ol>
anmenmtan	<i>adv</i><br><ol><li>simultaneously, at the same time</li></ol>
ann	<i>adv</i><br><ol><li>Contraction of annou; let's</li></ol>
annou	<i>adv</i><br><ol><li>let's</li></ol>
anonse	<i>verb</i><br><ol><li>To announce</li></ol>
anpeche	<i>verb</i><br><ol><li>To prevent</li></ol>
anpil	<i>adj</i><br><ol><li>many</li></ol><br><i>adv</i><br><ol><li>very</li></ol>
anpitasyon	<i>noun</i><br><ol><li>amputation</li></ol>
anpwazònman	<i>noun</i><br><ol><li>poisoning</li></ol>
anpàn	<i>adj</i><br><ol><li>out of order, broken, kaputt</li></ol>
anrejistreman	<i>noun</i><br><ol><li>check-in</li></ol>
ansanm	<i>adv</i><br><ol><li>together</li></ol>
ansent	<i>adj</i><br><ol><li>pregnant</li></ol>
ansiklopedi	<i>noun</i><br><ol><li>encyclopedia</li></ol>
ansèkle	<i>verb</i><br><ol><li>To circle</li></ol>
ant	<i>prep</i><br><ol><li>between</li></ol>
anvan	<i>prep</i><br><ol><li>before</li></ol>
anviwònman	<i>noun</i><br><ol><li>environment</li></ol>
anvwaye	<i>noun</i><br><ol><li>envoy</li></ol>
anyen	<i>pron</i><br><ol><li>nothing</li></ol>
ap	<i>adv</i><br><ol><li>Indicates the continuous aspect.</li><li>Indicates a future tense that is relatively certain to happen.</li></ol>
aparèy	<i>noun</i><br><ol><li>penis</li></ol>
apeprè	<i>adv</i><br><ol><li>about, approximately, roughly</li></ol>
aprann	<i>verb</i><br><ol><li>learn</li></ol>
apre	<i>prep</i><br><ol><li>after</li></ol>
aprè	<i>prep</i><br><ol><li>after</li></ol>
après	<i>adv</i><br><ol><li>(Saint-Domingue) Indicates the continuous aspect</li></ol>
areye	<i>noun</i><br><ol><li>spider</li></ol>
arien	<i>pron</i><br><ol><li>(Saint-Domingue) nothing, anything</li></ol>
ase	<i>adj</i><br><ol><li>enough</li></ol><br><i>adv</i><br><ol><li>enough</li></ol>
asire	<i>verb</i><br><ol><li>ensure</li></ol>
asistans	<i>noun</i><br><ol><li>assistance, help</li></ol>
astor	<i>adv</i><br><ol><li>(Saint-Domingue) now</li></ol>
astwonomi	<i>noun</i><br><ol><li>astronomy</li></ol>
asye	<i>noun</i><br><ol><li>steel (metal produced from iron)</li></ol>
atansyon	<i>noun</i><br><ol><li>attention</li></ol><br><i>intj</i><br><ol><li>attention!</li></ol>
atik	<i>noun</i><br><ol><li>article</li></ol>
atlèt	<i>noun</i><br><ol><li>athlete</li></ol>
atomik	<i>adj</i><br><ol><li>atomic</li></ol>
atrap	<i>verb</i><br><ol><li>to catch</li></ol>
atè	<i>noun</i><br><ol><li>artery</li><li>atheist</li></ol>
avanse	<i>verb</i><br><ol><li>advance</li></ol>
avlà	<i>verb</i><br><ol><li>(Saint-Domingue) voilà</li></ol>
avril	<i>noun</i><br><ol><li>April</li></ol>
avyon	<i>noun</i><br><ol><li>airplane</li></ol>
avè	<i>prep</i><br><ol><li>with</li></ol>
avèk	<i>prep</i><br><ol><li>with</li></ol>
ayeropò|ayewopò	<i>noun</i><br><ol><li>airport</li></ol>
ayisyen	<i>adj</i><br><ol><li>Haitian</li></ol>
azòt	<i>noun</i><br><ol><li>nitrogen</li></ol>
ba	<i>verb</i><br><ol><li>give</li></ol>
bab	<i>noun</i><br><ol><li>beard, whiskers</li></ol>
bag	<i>noun</i><br><ol><li>ring</li></ol>
bagage	<i>noun</i><br><ol><li>(Saint-Domingue) an object, thing</li></ol>
bagay	<i>noun</i><br><ol><li>thing</li></ol>
bal	<i>noun</i><br><ol><li>dance party, ball</li></ol>
bale	<i>noun</i><br><ol><li>broom</li></ol><br><i>verb</i><br><ol><li>to sweep</li></ol>
balèn	<i>noun</i><br><ol><li>whale</li><li>candle made from whale blubber</li><li>whalebone</li></ol>
ban	<i>verb</i><br><ol><li>give</li></ol>
bann	<i>noun</i><br><ol><li>bunch, group</li></ol>
bann bèt	<i>noun</i><br><ol><li>herd</li></ol>
banza	<i>noun</i><br><ol><li>(botany) Spanish moss, Tillandsia usneoides</li></ol>
batiman	<i>noun</i><br><ol><li>building</li></ol>
bato	<i>noun</i><br><ol><li>boat, ship</li></ol>
baton	<i>noun</i><br><ol><li>stick</li></ol>
batèm	<i>noun</i><br><ol><li>baptism</li></ol>
bay	<i>verb</i><br><ol><li>to give</li></ol>
bayakou	<i>noun</i><br><ol><li>a person who cleans out latrines</li></ol>
baye	<i>verb</i><br><ol><li>(Saint-Domingue) to give</li></ol>
baze	<i>verb</i><br><ol><li>To base</li></ol>
bebe	<i>noun</i><br><ol><li>baby</li></ol>
bese	<i>verb</i><br><ol><li>decline, fall, lower</li></ol>
bezwen	<i>noun</i><br><ol><li>need</li></ol><br><i>verb</i><br><ol><li>need</li></ol>
bilding	<i>noun</i><br><ol><li>building</li></ol>
bilten vòt	<i>noun</i><br><ol><li>ballot, ballot paper</li></ol>
bisoin	<i>noun</i><br><ol><li>(Saint-Domingue) a need</li></ol><br><i>verb</i><br><ol><li>(Saint-Domingue) to need</li></ol>
biyografi	<i>noun</i><br><ol><li>biography</li></ol>
biznis	<i>noun</i><br><ol><li>business</li></ol><br><i>adj</i><br><ol><li>business</li></ol>
blan	<i>adj</i><br><ol><li>white</li></ol><br><i>noun</i><br><ol><li>foreigner</li></ol>
blanch	<i>adj</i><br><ol><li>white</li></ol>
ble	<i>adj</i><br><ol><li>blue</li></ol>
blesi	<i>noun</i><br><ol><li>wound</li></ol>
bliye	<i>verb</i><br><ol><li>to forget</li></ol>
bobin	<i>noun</i><br><ol><li>spool</li></ol>
bobo	<i>verb</i><br><ol><li>(Saint-Domingue) to kiss</li></ol>
bobota	<i>noun</i><br><ol><li>machin anpàn, vye machin oubyen vwati depafini</li></ol>
bofis	<i>noun</i><br><ol><li>son-in-law</li></ol>
boir	<i>verb</i><br><ol><li>(Saint-Domingue) to drink</li></ol>
bokal	<i>noun</i><br><ol><li>jar</li></ol>
bokit	<i>noun</i><br><ol><li>bucket</li><li>bokit</li></ol>
bon	<i>adj</i><br><ol><li>good</li></ol>
bon Dieu	<i>noun</i><br><ol><li>(Saint-Domingue) God</li></ol>
bonjou	<i>intj</i><br><ol><li>hello</li></ol>
bonnanj	<i>noun</i><br><ol><li>conscience; common sense</li></ol>
bonswa	<i>intj</i><br><ol><li>good evening</li></ol>
bouch	<i>noun</i><br><ol><li>(anatomy) mouth</li></ol>
boule	<i>verb</i><br><ol><li>to burn</li></ol>
bounda	<i>noun</i><br><ol><li>buttocks, ass</li></ol>
boutèy	<i>noun</i><br><ol><li>bottle</li></ol>
bra	<i>noun</i><br><ol><li>arm</li></ol>
branch	<i>noun</i><br><ol><li>branch</li></ol>
brav	<i>adj</i><br><ol><li>brave</li></ol>
bwa	<i>noun</i><br><ol><li>woods, forest</li><li>wood, timber</li><li>penis</li></ol>
bwason	<i>noun</i><br><ol><li>drink, beverage</li></ol>
bwat	<i>noun</i><br><ol><li>box</li></ol>
bwè	<i>verb</i><br><ol><li>to drink</li></ol>
byen	<i>adv</i><br><ol><li>well</li></ol>
byennèt	<i>noun</i><br><ol><li>well-being</li></ol>
byenvini	<i>intj</i><br><ol><li>welcome</li></ol>
byè	<i>noun</i><br><ol><li>beer</li></ol>
bè	<i>noun</i><br><ol><li>butter</li></ol>
bèbè	<i>adj</i><br><ol><li>mute, dumb (unable to talk)</li></ol>
bèl	<i>adj</i><br><ol><li>beautiful, handsome, pretty</li></ol>
bèt	<i>noun</i><br><ol><li>beast</li><li>animal</li></ol>
bò	<i>noun</i><br><ol><li>side</li></ol><br><i>prep</i><br><ol><li>by, alongside, near, next to</li></ol>
bòkò	<i>noun</i><br><ol><li>sorcerer, bocor</li></ol>
caba	<i>verb</i><br><ol><li>(Saint-Domingue) to finish</li></ol>
cabane	<i>verb</i><br><ol><li>(Saint-Domingue) a bed</li></ol>
capable	<i>verb</i><br><ol><li>(Saint-Domingue) (auxiliary) can, to be able to</li></ol>
cassé	<i>verb</i><br><ol><li>(Saint-Domingue) to break</li></ol>
caze	<i>noun</i><br><ol><li>(Saint-Domingue) a house</li></ol>
chache	<i>verb</i><br><ol><li>search for, look for</li></ol>
chadèk	<i>noun</i><br><ol><li>grapefruit (fruit)</li></ol>
chak	<i>det</i><br><ol><li>each</li></ol>
chalè	<i>noun</i><br><ol><li>heat</li></ol>
chamo	<i>noun</i><br><ol><li>camel</li></ol>
chanje	<i>verb</i><br><ol><li>To change</li></ol>
chanjman	<i>noun</i><br><ol><li>change</li></ol>
chanm	<i>noun</i><br><ol><li>room</li></ol>
chante	<i>noun</i><br><ol><li>song</li></ol><br><i>verb</i><br><ol><li>to sing</li></ol>
chape	<i>verb</i><br><ol><li>escape</li></ol>
chat	<i>noun</i><br><ol><li>cat</li><li>(colloquial) thief</li><li>pussy (genitals)</li></ol>
chemen	<i>noun</i><br><ol><li>path</li></ol>
chenn	<i>noun</i><br><ol><li>chain</li></ol>
cheve	<i>noun</i><br><ol><li>hair</li></ol>
chimi	<i>noun</i><br><ol><li>chemistry</li></ol>
chimik	<i>adj</i><br><ol><li>chemical</li></ol>
chimè	<i>noun</i><br><ol><li>ill humor, nervousness</li></ol>
chita	<i>verb</i><br><ol><li>sit down</li></ol>
cho	<i>adj</i><br><ol><li>hot</li><li>warm</li></ol>
choi	<i>noun</i><br><ol><li>(Saint-Domingue) a thing</li></ol>
chosèt	<i>noun</i><br><ol><li>sock</li></ol>
choual	<i>noun</i><br><ol><li>(Saint-Domingue) a horse</li></ol>
chwal	<i>noun</i><br><ol><li>horse</li></ol>
chwal bwa	<i>noun</i><br><ol><li>chouval bwa</li></ol>
chwazi	<i>verb</i><br><ol><li>choose</li></ol>
chyen	<i>noun</i><br><ol><li>dog</li></ol>
chè	<i>noun</i><br><ol><li>meat</li></ol>
chèf	<i>noun</i><br><ol><li>leader, boss</li></ol>
chèvrèt	<i>noun</i><br><ol><li>shrimp</li></ol>
chèz	<i>noun</i><br><ol><li>chair</li></ol>
comben	<i>adv</i><br><ol><li>(Saint-Domingue) how much</li></ol>
commencé	<i>verb</i><br><ol><li>(Saint-Domingue) to begin</li></ol>
comment vou porté	<i>phrase</i><br><ol><li>(Saint-Domingue) how are you</li></ol>
coné	<i>verb</i><br><ol><li>(Saint-Domingue) to know</li></ol>
crére	<i>verb</i><br><ol><li>(Saint-Domingue) to believe</li></ol>
dan	<i>noun</i><br><ol><li>tooth</li></ol>
danje	<i>noun</i><br><ol><li>danger</li></ol>
danjere	<i>adj</i><br><ol><li>dangerous</li></ol>
dans	<i>noun</i><br><ol><li>dance</li></ol>
danse	<i>verb</i><br><ol><li>to dance</li></ol>
dapre	<i>prep</i><br><ol><li>according to</li></ol>
dayè	<i>adv</i><br><ol><li>besides</li></ol>
de	<i>num</i><br><ol><li>two</li></ol>
de sa	<i>prep</i><br><ol><li>ago</li></ol>
defann	<i>verb</i><br><ol><li>defend</li></ol>
defans	<i>noun</i><br><ol><li>defense</li></ol>
definisyon	<i>noun</i><br><ol><li>definition</li></ol>
dega	<i>noun</i><br><ol><li>damage</li></ol>
dejene	<i>noun</i><br><ol><li>breakfast</li></ol>
deklare	<i>verb</i><br><ol><li>declare</li></ol>
dekonpozisyon	<i>noun</i><br><ol><li>decomposition</li></ol>
dekouvri	<i>verb</i><br><ol><li>To discover</li></ol>
dekouvèt	<i>noun</i><br><ol><li>discovery</li></ol>
delivre	<i>verb</i><br><ol><li>deliver</li></ol>
demen	<i>adv</i><br><ol><li>tomorrow</li></ol>
depase	<i>verb</i><br><ol><li>To exceed</li></ol>
depatman	<i>noun</i><br><ol><li>department</li></ol>
depi	<i>prep</i><br><ol><li>since</li></ol>
depoze	<i>verb</i><br><ol><li>put down, set down</li></ol>
deranje	<i>verb</i><br><ol><li>bother, disrupt</li></ol>
desanm	<i>noun</i><br><ol><li>December</li></ol>
deside	<i>verb</i><br><ol><li>decide</li></ol>
devan	<i>prep</i><br><ol><li>before, in front of</li></ol>
dezas	<i>noun</i><br><ol><li>disaster</li></ol>
dezobeyi	<i>verb</i><br><ol><li>disobey</li></ol>
di	<i>verb</i><br><ol><li>to say</li><li>to tell</li></ol>
diau	<i>noun</i><br><ol><li>(Saint-Domingue) water</li></ol>
dife	<i>noun</i><br><ol><li>fire</li></ol>
diferan	<i>adj</i><br><ol><li>different</li></ol>
diferans	<i>noun</i><br><ol><li>difference</li></ol>
difikilte	<i>noun</i><br><ol><li>difficulty</li></ol>
difisil	<i>adj</i><br><ol><li>difficult</li></ol>
dijiné	<i>verb</i><br><ol><li>(Saint-Domingue) to breakfast, to eat breakfast, to have breakfast</li></ol>
diksyonè	<i>noun</i><br><ol><li>dictionary</li></ol>
dimanch	<i>noun</i><br><ol><li>Sunday</li></ol>
dinozò	<i>noun</i><br><ol><li>dinosaur</li></ol>
dir	<i>verb</i><br><ol><li>(Saint-Domingue) to say, to tell</li></ol>
diri	<i>noun</i><br><ol><li>rice</li></ol>
dirijan	<i>noun</i><br><ol><li>leader, ruler</li></ol>
dirèk	<i>adj</i><br><ol><li>direct</li></ol>
dis	<i>num</i><br><ol><li>ten</li></ol>
diskisyon	<i>noun</i><br><ol><li>discussion</li></ol>
disparèt	<i>verb</i><br><ol><li>disappear</li></ol>
distans	<i>noun</i><br><ol><li>distance</li></ol>
disèt	<i>num</i><br><ol><li>seventeen</li></ol>
diznèf	<i>num</i><br><ol><li>nineteen</li></ol>
dizuit	<i>num</i><br><ol><li>eighteen</li></ol>
djèp	<i>noun</i><br><ol><li>wasp</li></ol>
dlo	<i>noun</i><br><ol><li>water</li></ol>
dlo (je)|je|dlo	<i>noun</i><br><ol><li>tear</li></ol>
do	<i>noun</i><br><ol><li>(anatomy) back</li></ol>
dofen	<i>noun</i><br><ol><li>dolphin</li></ol>
doi	<i>verb</i><br><ol><li>(Saint-Domingue) (auxiliary) to have to, must</li></ol>
dokiman	<i>noun</i><br><ol><li>document</li></ol>
doktè	<i>noun</i><br><ol><li>doctor</li></ol>
dola	<i>noun</i><br><ol><li>dollar</li></ol>
dombo	<i>noun</i><br><ol><li>(Saint-Domingue) a concubine</li></ol>
dourér	<i>verb</i><br><ol><li>(Saint-Domingue) to endure</li></ol>
douz	<i>num</i><br><ol><li>twelve</li></ol>
douzèn	<i>noun</i><br><ol><li>dozen</li></ol>
doué	<i>verb</i><br><ol><li>(Saint-Domingue) Alternative form of doi</li></ol>
drapo	<i>noun</i><br><ol><li>flag</li></ol>
droumi	<i>verb</i><br><ol><li>(Saint-Domingue) to sleep</li></ol>
dwa	<i>noun</i><br><ol><li>right (legal or moral entitlement)</li></ol>
dwe	<i>verb</i><br><ol><li>(auxiliary) must</li></ol>
dwèt	<i>noun</i><br><ol><li>(anatomy) finger</li></ol>
dyab	<i>noun</i><br><ol><li>demon, devil</li></ol>
dyamèt	<i>noun</i><br><ol><li>diameter</li></ol>
dye	<i>noun</i><br><ol><li>god</li></ol>
dèyè	<i>prep</i><br><ol><li>behind</li></ol>
dépende	<i>verb</i><br><ol><li>(Saint-Domingue) to depend</li></ol>
dòmi	<i>verb</i><br><ol><li>To sleep</li></ol>
ede	<i>verb</i><br><ol><li>help</li></ol>
edikasyon	<i>noun</i><br><ol><li>education</li></ol>
egal	<i>adj</i><br><ol><li>equal</li></ol>
egzakteman	<i>adv</i><br><ol><li>exactly</li></ol>
egzamine	<i>verb</i><br><ol><li>To examine</li></ol>
egzanp	<i>noun</i><br><ol><li>example</li></ol>
egziste	<i>verb</i><br><ol><li>to exist</li></ol>
egzèse	<i>verb</i><br><ol><li>to exercise</li></ol>
ekri	<i>verb</i><br><ol><li>write</li></ol>
ekriven	<i>noun</i><br><ol><li>writer</li></ol>
eksperyans	<i>noun</i><br><ol><li>experience</li></ol>
ekstrèm	<i>adj</i><br><ol><li>extreme</li></ol>
ekstrèmman	<i>adv</i><br><ol><li>extremely</li></ol>
elektrisite	<i>noun</i><br><ol><li>electricity.</li></ol>
eleman chimik	<i>noun</i><br><ol><li>chemical element</li></ol>
elyòm	<i>noun</i><br><ol><li>helium</li></ol>
emèt	<i>verb</i><br><ol><li>emit</li></ol>
en	<i>num</i><br><ol><li>one</li></ol>
en pile	<i>adj</i><br><ol><li>(Saint-Domingue) a lot, much, many</li></ol><br><i>adv</i><br><ol><li>very</li></ol>
endepandan	<i>adj</i><br><ol><li>independent</li></ol>
endrét	<i>noun</i><br><ol><li>(Saint-Domingue) a place</li></ol>
enfòmasyon	<i>noun</i><br><ol><li>information</li></ol>
enpòtan	<i>adj</i><br><ol><li>important</li></ol>
enpòtans	<i>noun</i><br><ol><li>importance</li></ol>
ensèk	<i>noun</i><br><ol><li>insect, bug</li></ol>
enterè	<i>noun</i><br><ol><li>interest</li></ol>
entènasyonal	<i>adj</i><br><ol><li>international</li></ol>
entènèt	<i>noun</i><br><ol><li>Internet</li></ol>
envizib	<i>adj</i><br><ol><li>invisible</li></ol>
enèji	<i>noun</i><br><ol><li>energy</li></ol>
eprèv	<i>noun</i><br><ol><li>trial, ordeal</li></ol>
epè	<i>adj</i><br><ol><li>thick</li></ol>
erè	<i>noun</i><br><ol><li>error</li></ol>
eseye	<i>verb</i><br><ol><li>try</li></ol>
esklav	<i>noun</i><br><ol><li>slave</li></ol>
esklavaj	<i>noun</i><br><ol><li>slavery</li></ol>
eskèlèt	<i>noun</i><br><ol><li>skeleton</li></ol>
espesyal	<i>adj</i><br><ol><li>special</li></ol>
espò	<i>noun</i><br><ol><li>sport</li></ol>
estati	<i>noun</i><br><ol><li>statue</li></ol>
eta	<i>noun</i><br><ol><li>state</li></ol>
etid	<i>noun</i><br><ol><li>study</li></ol>
etidye	<i>verb</i><br><ol><li>to study</li></ol>
etranje	<i>adj</i><br><ol><li>foreign</li></ol>
etranjè	<i>noun</i><br><ol><li>foreign</li></ol>
evite	<i>verb</i><br><ol><li>avoid</li></ol>
evènman	<i>noun</i><br><ol><li>event</li></ol>
fair	<i>verb</i><br><ol><li>(Saint-Domingue) to do</li></ol>
fanm	<i>noun</i><br><ol><li>wife</li><li>woman</li></ol>
fanmi	<i>noun</i><br><ol><li>family</li></ol>
farizyen	<i>noun</i><br><ol><li>Pharisee</li></ol>
fasil	<i>adj</i><br><ol><li>easy</li></ol>
fason	<i>noun</i><br><ol><li>manner</li></ol>
fenomèn	<i>noun</i><br><ol><li>phenomenon</li></ol>
fevriye	<i>noun</i><br><ol><li>February</li></ol>
fi	<i>noun</i><br><ol><li>girl</li><li>daughter</li></ol>
fig	<i>noun</i><br><ol><li>banana</li></ol>
figi	<i>noun</i><br><ol><li>(anatomy) face</li></ol>
filozofi	<i>noun</i><br><ol><li>philosophy</li></ol>
filozòf	<i>noun</i><br><ol><li>philosopher</li></ol>
fim	<i>noun</i><br><ol><li>movie, film</li></ol>
fimye	<i>noun</i><br><ol><li>dung, manure</li></ol>
fini	<i>verb</i><br><ol><li>to finish</li></ol>
fisi	<i>noun</i><br><ol><li>rifle</li></ol>
fisil	<i>noun</i><br><ol><li>(Saint-Domingue) a rifle</li></ol>
fizi	<i>noun</i><br><ol><li>rifle</li></ol>
fizik	<i>adj</i><br><ol><li>physical</li></ol><br><i>noun</i><br><ol><li>physics</li></ol>
flanm	<i>noun</i><br><ol><li>flame</li></ol>
flann	<i>noun</i><br><ol><li>walk, stroll</li></ol>
flannen	<i>verb</i><br><ol><li>to idle, dawdle, loiter, wander, stroll</li></ol>
flè	<i>noun</i><br><ol><li>flower, bloom</li></ol>
fobou	<i>noun</i><br><ol><li>suburb</li></ol>
fon	<i>noun</i><br><ol><li>bottom</li><li>forehead</li></ol>
fonèm	<i>noun</i><br><ol><li>(linguistics) phoneme</li></ol>
forè	<i>noun</i><br><ol><li>forest</li></ol>
foula	<i>noun</i><br><ol><li>scarf</li></ol>
foumi	<i>noun</i><br><ol><li>ant (insect)</li></ol>
franbwaz	<i>noun</i><br><ol><li>raspberry</li></ol>
fransè	<i>noun</i><br><ol><li>French language</li></ol>
frape	<i>verb</i><br><ol><li>To hit</li></ol>
frijidè	<i>noun</i><br><ol><li>refrigerator</li></ol>
frè	<i>noun</i><br><ol><li>brother</li></ol>
fwa	<i>noun</i><br><ol><li>liver</li></ol>
fwi	<i>noun</i><br><ol><li>fruit</li></ol>
fwidmè	<i>noun</i><br><ol><li>shellfish</li></ol>
fwomaj	<i>noun</i><br><ol><li>cheese</li></ol>
fyète	<i>noun</i><br><ol><li>pride</li></ol>
fè|fèt	<i>verb</i><br><ol><li>do</li><li>make</li></ol><br><i>noun</i><br><ol><li>iron</li></ol>
fè maryaj	<i>verb</i><br><ol><li>marry</li></ol>
fè nwa	<i>verb</i><br><ol><li>(idiomatic) To be dark, or have no light to see</li></ol>
fèb	<i>adj</i><br><ol><li>feeble, weak</li></ol>
fèmen	<i>verb</i><br><ol><li>close, shut</li></ol>
fèt	<i>verb</i><br><ol><li>be born</li></ol><br><i>noun</i><br><ol><li>party</li></ol>
fèy	<i>noun</i><br><ol><li>leaf</li></ol>
fòm	<i>noun</i><br><ol><li>form</li></ol>
fòme	<i>verb</i><br><ol><li>To form</li></ol>
ga	<i>noun</i><br><ol><li>station, terminal</li></ol>
gade	<i>verb</i><br><ol><li>(transitive) to look (at)</li><li>(transitive) to watch</li></ol>
gagann	<i>noun</i><br><ol><li>throat, neck</li></ol>
gagné	<i>verb</i><br><ol><li>(Saint-Domingue) to have</li></ol>
galaksi	<i>noun</i><br><ol><li>(astronomy) galaxy</li></ol>
gason|tigason	<i>noun</i><br><ol><li>man</li></ol>
gate	<i>verb</i><br><ol><li>spoil</li></ol>
gen	<i>verb</i><br><ol><li>Contraction of genyen.</li></ol>
genyen	<i>verb</i><br><ol><li>to have</li><li>there is</li><li>there are</li></ol>
gita	<i>noun</i><br><ol><li>guitar</li></ol>
glas	<i>noun</i><br><ol><li>ice</li></ol>
glase	<i>verb</i><br><ol><li>to freeze</li></ol>
glouglou	<i>noun</i><br><ol><li>(botany) oil palm (Elaeis guineensis)</li></ol>
gonbo	<i>noun</i><br><ol><li>(dialectal) okra</li></ol>
goud	<i>noun</i><br><ol><li>gourde (Haitian currency)</li></ol>
goumenter	<i>verb</i><br><ol><li>(Saint-Domingue) to augment</li></ol>
gouvène	<i>verb</i><br><ol><li>govern</li></ol>
gouvènman	<i>noun</i><br><ol><li>government</li></ol>
gra	<i>adj</i><br><ol><li>fat</li></ol>
grangou	<i>adj</i><br><ol><li>hungry</li></ol><br><i>noun</i><br><ol><li>hunger</li></ol>
granmoun	<i>noun</i><br><ol><li>adult</li></ol>
grenn	<i>noun</i><br><ol><li>seed (of a plant)</li><li>speck</li><li>testicle</li></ol><br><i>adj</i><br><ol><li>kinky (of hair)</li></ol>
grip	<i>noun</i><br><ol><li>influenza, flu</li></ol>
gueté	<i>verb</i><br><ol><li>(Saint-Domingue) to watch</li></ol>
gwo	<i>adj</i><br><ol><li>big</li><li>fat (person)</li></ol>
gwoup	<i>noun</i><br><ol><li>group</li></ol>
gèp	<i>noun</i><br><ol><li>wasp</li></ol>
gòj	<i>noun</i><br><ol><li>throat</li></ol>
haimé	<i>verb</i><br><ol><li>(Saint-Domingue) to like, to love</li></ol>
hinder	<i>verb</i><br><ol><li>(Saint-Domingue) to help</li></ol>
idantifye	<i>verb</i><br><ol><li>identify</li></ol>
ide	<i>noun</i><br><ol><li>idea</li></ol>
idwojèn	<i>noun</i><br><ol><li>hydrogen</li></ol>
ijans	<i>noun</i><br><ol><li>emergency</li></ol>
imaj	<i>noun</i><br><ol><li>image</li></ol>
imen	<i>noun</i><br><ol><li>human</li></ol>
imilyasyon	<i>noun</i><br><ol><li>humiliation</li></ol>
inivèsite	<i>noun</i><br><ol><li>university</li></ol>
inivèsèl	<i>adj</i><br><ol><li>universal</li></ol>
inondasyon	<i>noun</i><br><ol><li>flood</li></ol>
isit	<i>adv</i><br><ol><li>here</li></ol>
isit la	<i>adv</i><br><ol><li>here</li></ol>
istorik	<i>adj</i><br><ol><li>historic</li></ol>
istwa	<i>noun</i><br><ol><li>story</li><li>history</li></ol>
itil	<i>adj</i><br><ol><li>useful</li></ol>
itilizasyon	<i>noun</i><br><ol><li>utilization</li></ol>
itilizatè	<i>noun</i><br><ol><li>user</li></ol>
itilize	<i>verb</i><br><ol><li>use, utilize</li></ol>
jabourik	<i>noun</i><br><ol><li>(botany) ox-eye bean (Mucuna urens)</li></ol>
jalouzi	<i>noun</i><br><ol><li>jealousy</li></ol>
janm	<i>adv</i><br><ol><li>never</li></ol><br><i>noun</i><br><ol><li>leg</li></ol>
janvye	<i>noun</i><br><ol><li>January</li></ol>
je	<i>noun</i><br><ol><li>eye</li></ol>
jedi	<i>noun</i><br><ol><li>Thursday</li></ol>
jen	<i>noun</i><br><ol><li>June</li></ol>
jeneral	<i>adj</i><br><ol><li>general</li></ol>
jenou	<i>noun</i><br><ol><li>knee</li></ol>
jete	<i>verb</i><br><ol><li>throw away, discard</li></ol>
ji	<i>noun</i><br><ol><li>juice</li></ol>
jije	<i>verb</i><br><ol><li>to judge</li></ol>
jimo	<i>noun</i><br><ol><li>twin</li></ol>
jiyè	<i>noun</i><br><ol><li>July</li></ol>
jodi	<i>noun</i><br><ol><li>today</li></ol>
jodi a	<i>adv</i><br><ol><li>today</li></ol>
jordy	<i>adv</i><br><ol><li>(Saint-Domingue) today</li></ol>
jou	<i>noun</i><br><ol><li>day</li></ol>
jounalis	<i>noun</i><br><ol><li>journalist</li></ol>
jwe	<i>verb</i><br><ol><li>to play</li></ol>
jwenn	<i>verb</i><br><ol><li>find</li></ol>
jwenti	<i>noun</i><br><ol><li>joint</li></ol>
jwif	<i>adj</i><br><ol><li>Jewish</li></ol><br><i>noun</i><br><ol><li>Jew</li></ol>
jwèt	<i>noun</i><br><ol><li>toy</li><li>game, diversion</li></ol>
jèn	<i>adj</i><br><ol><li>young</li></ol>
jòn	<i>adj</i><br><ol><li>yellow</li></ol>
ka	<i>noun</i><br><ol><li>case, instance</li></ol><br><i>verb</i><br><ol><li>(auxiliary) can, be able to</li></ol>
kab	<i>verb</i><br><ol><li>(auxiliary) can, be able to</li></ol>
kabann	<i>noun</i><br><ol><li>bed</li></ol>
kach	<i>noun</i><br><ol><li>foreskin</li></ol>
kache	<i>verb</i><br><ol><li>(transitive) to hide</li></ol>
kadav	<i>noun</i><br><ol><li>corpse, cadaver</li></ol>
kado	<i>noun</i><br><ol><li>present; gift</li></ol>
kafe	<i>noun</i><br><ol><li>coffee</li></ol>
kalfou	<i>noun</i><br><ol><li>crossroads, intersection</li></ol>
kalmason	<i>noun</i><br><ol><li>snail</li></ol>
kamouflaj	<i>noun</i><br><ol><li>camouflage</li></ol>
kan	<i>adv</i><br><ol><li>when</li></ol>
kanna	<i>noun</i><br><ol><li>duck</li></ol>
kanpe	<i>verb</i><br><ol><li>To stand</li></ol>
kantite	<i>noun</i><br><ol><li>quantity</li></ol>
kap	<i>verb</i><br><ol><li>Clipping of kapab.</li></ol><br><i>particle</i><br><ol><li>Contraction of ki ap.</li></ol><br><i>noun</i><br><ol><li>cape</li></ol>
kapab	<i>verb</i><br><ol><li>(auxiliary) can, to be able to</li></ol>
karanklou	<i>noun</i><br><ol><li>vulture</li></ol>
karannde	<i>num</i><br><ol><li>forty-two</li></ol>
karant	<i>num</i><br><ol><li>forty</li></ol>
karanteyen	<i>num</i><br><ol><li>forty-one</li></ol>
kare	<i>adj</i><br><ol><li>square</li><li>frank, outspoken</li></ol><br><i>noun</i><br><ol><li>square</li></ol>
kat	<i>num</i><br><ol><li>four</li></ol><br><i>noun</i><br><ol><li>map</li></ol>
katastwòf	<i>noun</i><br><ol><li>catastrophe</li></ol>
kategori	<i>noun</i><br><ol><li>category</li></ol>
katreven	<i>num</i><br><ol><li>eighty</li></ol>
katrevendis	<i>num</i><br><ol><li>ninety</li></ol>
katrevendiznèf	<i>num</i><br><ol><li>ninety-nine</li></ol>
katòz	<i>num</i><br><ol><li>fourteen</li></ol>
kay	<i>noun</i><br><ol><li>house</li></ol>
ke	<i>pron</i><br><ol><li>(relative, object of relative clause) that</li></ol><br><i>noun</i><br><ol><li>tail</li></ol>
kenz	<i>num</i><br><ol><li>fifteen</li></ol>
kenèp	<i>noun</i><br><ol><li>The mamoncillo</li></ol>
kesyon	<i>noun</i><br><ol><li>question</li></ol>
ki	<i>det</i><br><ol><li>what</li></ol><br><i>pron</i><br><ol><li>(relative) who, which</li></ol>
kibò	<i>adv</i><br><ol><li>(interrogative) where.</li></ol>
kijan	<i>adv</i><br><ol><li>how</li></ol>
kikote	<i>adv</i><br><ol><li>(interrogative) where</li></ol>
kilomèt	<i>noun</i><br><ol><li>kilometre</li></ol>
kilti	<i>noun</i><br><ol><li>culture</li></ol>
kiltirèl	<i>adj</i><br><ol><li>cultural</li></ol>
kilè	<i>adv</i><br><ol><li>(interrogative) when</li></ol>
kilès	<i>det</i><br><ol><li>(interrogative) which</li></ol><br><i>pron</i><br><ol><li>(interrogative) who, which one</li></ol>
kimoun	<i>pron</i><br><ol><li>(interrogative) who</li><li>(interrogative) whom</li></ol>
kisa	<i>pron</i><br><ol><li>(interrogative) what</li></ol>
kite	<i>verb</i><br><ol><li>let</li></ol>
kiyès	<i>pron</i><br><ol><li>(interrogative) who</li></ol>
klakson	<i>noun</i><br><ol><li>horn (auto device)</li></ol>
klas mwayèn	<i>noun</i><br><ol><li>middle class</li></ol>
kle	<i>noun</i><br><ol><li>key (for opening a lock)</li></ol>
kleren	<i>noun</i><br><ol><li>clairin (a strong spirit made from sugar cane)</li></ol>
kloak	<i>noun</i><br><ol><li>cloaca</li></ol>
klou	<i>noun</i><br><ol><li>nail</li></ol>
kloure	<i>verb</i><br><ol><li>To nail</li></ol>
kochon	<i>noun</i><br><ol><li>pig</li></ol>
kodenn	<i>noun</i><br><ol><li>turkey (bird)</li></ol>
koken	<i>noun</i><br><ol><li>swindler, crook, scoundrel</li></ol>
kokoye	<i>noun</i><br><ol><li>coconut</li></ol>
kolèj	<i>noun</i><br><ol><li>college</li></ol>
komanse	<i>verb</i><br><ol><li>start, commence</li></ol>
konba	<i>noun</i><br><ol><li>battle</li></ol>
konesans	<i>noun</i><br><ol><li>knowledge</li></ol>
konfyans	<i>noun</i><br><ol><li>confidence</li><li>trust</li></ol>
konn	<i>verb</i><br><ol><li>to know</li></ol>
konnen	<i>verb</i><br><ol><li>know</li></ol>
konplèks	<i>adj</i><br><ol><li>complex</li></ol>
konprann	<i>noun</i><br><ol><li>understanding</li></ol><br><i>verb</i><br><ol><li>understand, comprehend</li></ol>
konpè	<i>noun</i><br><ol><li>mister, sir</li><li>godfather</li></ol>
konsa	<i>adj</i><br><ol><li>like that, such as that</li></ol><br><i>adv</i><br><ol><li>in such a manner</li></ol>
konsidere	<i>verb</i><br><ol><li>To consider</li></ol>
konstitisyon	<i>noun</i><br><ol><li>constitution</li></ol>
konsèp	<i>noun</i><br><ol><li>concept</li></ol>
konsève	<i>verb</i><br><ol><li>conserve, preserve</li></ol>
konsèy	<i>noun</i><br><ol><li>advice</li></ol>
kontak	<i>noun</i><br><ol><li>contact</li></ol>
kontan	<i>adj</i><br><ol><li>happy</li></ol>
konte	<i>verb</i><br><ol><li>To count</li></ol>
kontinan	<i>noun</i><br><ol><li>continent</li></ol>
kontribitè	<i>noun</i><br><ol><li>contributor</li></ol>
kontribye	<i>verb</i><br><ol><li>contribute</li></ol>
kontwole	<i>verb</i><br><ol><li>To control</li></ol>
kontwòl	<i>noun</i><br><ol><li>control</li></ol>
konvansyon	<i>noun</i><br><ol><li>convention</li></ol>
kote	<i>noun</i><br><ol><li>place</li><li>side</li></ol><br><i>conj</i><br><ol><li>where</li></ol>
koud	<i>noun</i><br><ol><li>elbow</li></ol>
koulè	<i>noun</i><br><ol><li>colour, color</li></ol>
koulèv	<i>noun</i><br><ol><li>snake</li></ol>
kounkoun	<i>noun</i><br><ol><li>(colloquial) vulva, pussy, cunt</li></ol>
kounye a	<i>adv</i><br><ol><li>now</li></ol>
kouri	<i>verb</i><br><ol><li>run</li></ol>
kouryèl	<i>noun</i><br><ol><li>(computing) email (system and message)</li></ol>
koute	<i>verb</i><br><ol><li>to cost</li><li>to listen</li></ol>
kouto	<i>noun</i><br><ol><li>knife</li></ol>
krapo	<i>noun</i><br><ol><li>toad, frog</li></ol>
kras	<i>adj</i><br><ol><li>stingy</li></ol><br><i>noun</i><br><ol><li>dirt, filth</li><li>speck, crumb, bit</li></ol>
kraze	<i>adj</i><br><ol><li>shabby, exhausted</li></ol><br><i>noun</i><br><ol><li>A little bit of money.</li></ol><br><i>verb</i><br><ol><li>(transitive) to chew up,</li><li>(transitive) to squash, smash</li></ol>
kreyasyon	<i>noun</i><br><ol><li>creation</li></ol>
kreyatè	<i>noun</i><br><ol><li>creator</li></ol>
kreye	<i>verb</i><br><ol><li>create</li></ol>
kreyòl	<i>noun</i><br><ol><li>creole</li><li>Haitian Creole</li></ol>
kreyòl ayisyen	<i>noun</i><br><ol><li>Haitian Creole</li></ol>
kuis	<i>noun</i><br><ol><li>thigh</li></ol>
kwa	<i>noun</i><br><ol><li>cross</li></ol>
kwafè	<i>noun</i><br><ol><li>hairdresser</li></ol>
kwis	<i>noun</i><br><ol><li>thigh (upper leg)</li></ol>
kwokodil	<i>noun</i><br><ol><li>crocodile</li></ol>
kwè	<i>verb</i><br><ol><li>believe</li></ol>
kè	<i>noun</i><br><ol><li>heart</li></ol>
kèk	<i>adj</i><br><ol><li>a few, some</li></ol>
kò	<i>noun</i><br><ol><li>body</li></ol>
kòk	<i>noun</i><br><ol><li>cock, rooster</li><li>cock, penis</li><li>coconut</li></ol>
kòlgat	<i>noun</i><br><ol><li>toothpaste</li></ol>
kòlè	<i>noun</i><br><ol><li>anger</li></ol>
kòmansman|konmansman	<i>noun</i><br><ol><li>beginning, start</li></ol>
kòmè	<i>noun</i><br><ol><li>madam, Mrs.</li><li>godmother</li></ol>
kòn	<i>noun</i><br><ol><li>horn</li></ol>
l|l'	<i>pron</i><br><ol><li>Contraction of li.</li></ol>
la	<i>noun</i><br><ol><li>art</li></ol><br><i>article</i><br><ol><li>the (definite article)</li></ol><br><i>adv</i><br><ol><li>there</li></ol>
labrim	<i>noun</i><br><ol><li>mist, fog</li></ol>
lachè	<i>noun</i><br><ol><li>flesh</li></ol>
lage	<i>verb</i><br><ol><li>release, let go</li></ol>
lajan	<i>noun</i><br><ol><li>money</li></ol>
lajistis	<i>noun</i><br><ol><li>justice</li></ol>
lakansyèl	<i>noun</i><br><ol><li>rainbow</li></ol>
lakizin	<i>noun</i><br><ol><li>kitchen</li></ol>
lakou	<i>noun</i><br><ol><li>courtyard</li></ol>
lakòz	<i>noun</i><br><ol><li>cause</li></ol>
lalin	<i>noun</i><br><ol><li>moon</li></ol>
lalo	<i>noun</i><br><ol><li>jute or amaranth leaves, sometimes okra pods</li><li>a stew similar to callaloo or gumbo made from the above</li></ol>
lalwa	<i>noun</i><br><ol><li>law</li></ol>
lamè	<i>noun</i><br><ol><li>sea, ocean</li></ol>
lan	<i>article</i><br><ol><li>the (definite article)</li></ol>
lanbi	<i>noun</i><br><ol><li>conch, conch shell</li></ol>
lane	<i>noun</i><br><ol><li>year</li></ol>
lanfè	<i>noun</i><br><ol><li>hell</li></ol>
lang	<i>noun</i><br><ol><li>A language.</li><li>A tongue.</li></ol>
lanmi	<i>noun</i><br><ol><li>enemy, foe</li></ol>
lanmò	<i>noun</i><br><ol><li>death</li></ol>
lanni	<i>noun</i><br><ol><li>fennel</li></ol>
lannuit	<i>noun</i><br><ol><li>night</li></ol>
lannwit	<i>noun</i><br><ol><li>night</li></ol>
lanp	<i>noun</i><br><ol><li>lamp, torch</li></ol>
lapen	<i>noun</i><br><ol><li>rabbit</li></ol>
lapli	<i>noun</i><br><ol><li>rain</li></ol>
lasal	<i>noun</i><br><ol><li>living room, salon</li></ol>
latcha	<i>noun</i><br><ol><li>butt, ass</li></ol>
latè	<i>noun</i><br><ol><li>Earth</li></ol>
lavalas	<i>noun</i><br><ol><li>avalanche</li><li>flood</li><li>a mass of people; everyone together</li></ol>
lave	<i>verb</i><br><ol><li>to wash</li></ol>
lavi	<i>noun</i><br><ol><li>life</li></ol>
lay	<i>noun</i><br><ol><li>garlic</li></ol>
legim	<i>noun</i><br><ol><li>vegetable</li></ol>
legliz	<i>noun</i><br><ol><li>church</li></ol>
lekòl	<i>noun</i><br><ol><li>school</li></ol>
lendepandans	<i>noun</i><br><ol><li>independence</li></ol>
lendi	<i>noun</i><br><ol><li>Monday</li></ol>
lespwa	<i>noun</i><br><ol><li>hope</li></ol>
leve	<i>verb</i><br><ol><li>To rise</li></ol>
leza	<i>noun</i><br><ol><li>lizard</li></ol>
li|form l	<i>pron</i><br><ol><li>he</li><li>him</li><li>she</li><li>her</li><li>it</li></ol><br><i>verb</i><br><ol><li>to read</li></ol>
lib	<i>adj</i><br><ol><li>free</li></ol>
libète	<i>noun</i><br><ol><li>liberty, freedom</li></ol>
lide	<i>noun</i><br><ol><li>instinct, gut feeling</li><li>idea</li></ol>
ligaman	<i>noun</i><br><ol><li>ligament</li></ol>
likid	<i>noun</i><br><ol><li>liquid, fluid</li></ol>
limyè	<i>noun</i><br><ol><li>light</li></ol>
lindy	<i>noun</i><br><ol><li>(Saint-Domingue) a Monday</li></ol>
linettes	<i>verb</i><br><ol><li>(Saint-Domingue) glasses</li></ol>
linivè	<i>noun</i><br><ol><li>universe</li></ol>
linèt	<i>noun</i><br><ol><li>glasses</li></ol>
lis	<i>noun</i><br><ol><li>list</li></ol>
literalman	<i>adv</i><br><ol><li>literally</li></ol>
liv	<i>noun</i><br><ol><li>book</li></ol>
long	<i>adj</i><br><ol><li>long</li></ol>
lontan	<i>adj</i><br><ol><li>long</li></ol><br><i>adv</i><br><ol><li>long ago</li></ol>
lou	<i>adj</i><br><ol><li>heavy</li></ol><br><i>noun</i><br><ol><li>wolf</li></ol>
lougarou	<i>noun</i><br><ol><li>werewolf</li><li>devil</li><li>sorcerer</li></ol>
lous	<i>noun</i><br><ol><li>bear</li></ol>
louvri	<i>verb</i><br><ol><li>To open</li></ol>
lozanj	<i>noun</i><br><ol><li>rhombus</li></ol>
lwa	<i>noun</i><br><ol><li>(voodoo) loa; god, spirit</li><li>law</li></ol>
lyon	<i>noun</i><br><ol><li>lion</li></ol>
lè	<i>noun</i><br><ol><li>hour</li></ol><br><i>conj</i><br><ol><li>when</li></ol>
lèd	<i>adj</i><br><ol><li>ugly</li></ol>
lèt	<i>noun</i><br><ol><li>milk</li><li>letter</li></ol>
lèv	<i>noun</i><br><ol><li>(anatomy) lip</li></ol>
lèzòm	<i>noun</i><br><ol><li>people, men</li></ol>
lò	<i>noun</i><br><ol><li>gold</li></ol>
m|m'	<i>pron</i><br><ol><li>Contraction of mwen.</li></ol>
macandal	<i>noun</i><br><ol><li>(Saint-Domingue) a sorcerer</li></ol>
machann	<i>noun</i><br><ol><li>vendor, trader, dealer</li></ol>
mache	<i>verb</i><br><ol><li>chew</li><li>walk</li><li>work (function correctly)</li></ol><br><i>noun</i><br><ol><li>market</li></ol>
machin	<i>noun</i><br><ol><li>car</li><li>engine</li><li>machine</li><li>vehicle</li></ol>
machoquét	<i>noun</i><br><ol><li>(Saint-Domingue) a blacksmith</li></ol>
machwè	<i>noun</i><br><ol><li>(anatomy) jaw</li></ol>
machòkèt	<i>noun</i><br><ol><li>blacksmith, tinker, potter</li></ol>
madanm	<i>noun</i><br><ol><li>madam, Mrs. (a title or form of address for a woman)</li></ol>
madi	<i>noun</i><br><ol><li>Tuesday</li></ol>
madivinèz	<i>noun</i><br><ol><li>(derogatory) lesbian</li></ol>
magazen	<i>noun</i><br><ol><li>store, shop</li></ol>
makak	<i>noun</i><br><ol><li>monkey</li></ol>
makorèv	<i>noun</i><br><ol><li>microwave</li></ol>
malad	<i>adj</i><br><ol><li>sick</li></ol><br><i>noun</i><br><ol><li>sick person</li></ol>
maladi	<i>noun</i><br><ol><li>illness</li></ol>
maldyòk	<i>noun</i><br><ol><li>evil eye</li></ol>
malere	<i>adj</i><br><ol><li>unhappy, miserable</li></ol>
maltrete	<i>verb</i><br><ol><li>mistreat</li></ol>
manbo	<i>noun</i><br><ol><li>(voodoo) priestess</li></ol>
mande	<i>verb</i><br><ol><li>ask</li></ol>
mandé	<i>verb</i><br><ol><li>(Saint-Domingue) to ask</li></ol>
mange	<i>verb</i><br><ol><li>to eat</li></ol><br><i>noun</i><br><ol><li>food</li></ol>
manje	<i>noun</i><br><ol><li>food</li></ol><br><i>verb</i><br><ol><li>eat</li></ol>
manke	<i>verb</i><br><ol><li>To lack</li></ol>
manman	<i>noun</i><br><ol><li>mother</li></ol>
mantal	<i>adj</i><br><ol><li>mental</li></ol>
manto	<i>noun</i><br><ol><li>coat</li></ol>
manton	<i>noun</i><br><ol><li>chin</li></ol>
mantèg	<i>noun</i><br><ol><li>fat</li></ol>
manyen	<i>verb</i><br><ol><li>touch (make physical contact with)</li></ol>
marasa	<i>noun</i><br><ol><li>twin</li><li>Marassa Jumeaux</li></ol>
marré	<i>verb</i><br><ol><li>(Saint-Domingue) to tie</li></ol>
maryaj	<i>noun</i><br><ol><li>marriage</li></ol>
marye	<i>verb</i><br><ol><li>marry</li></ol>
mas	<i>noun</i><br><ol><li>March</li><li>mass</li></ol>
matematik	<i>noun</i><br><ol><li>mathematics</li></ol>
mayas	<i>noun</i><br><ol><li>unpleasant body odour, especially that of feet</li></ol>
mayo	<i>noun</i><br><ol><li>t-shirt</li></ol>
me	<i>noun</i><br><ol><li>May</li></ol>
medikaman	<i>noun</i><br><ol><li>medication, drug</li></ol>
men	<i>noun</i><br><ol><li>hand</li></ol><br><i>conj</i><br><ol><li>but</li></ol>
mesaj	<i>noun</i><br><ol><li>message</li></ol>
mesye	<i>noun</i><br><ol><li>mister, sir (a title or form of address for a man)</li></ol>
mete	<i>verb</i><br><ol><li>put</li><li>put on</li></ol>
mezanmi	<i>intj</i><br><ol><li>Used for emphasis or to express surprise.</li></ol>
mil	<i>noun</i><br><ol><li>thousand</li><li>mile (measure of distance)</li></ol>
minis	<i>noun</i><br><ol><li>minister</li></ol>
minit	<i>noun</i><br><ol><li>minute</li></ol>
mirak	<i>noun</i><br><ol><li>miracle</li></ol>
misk	<i>noun</i><br><ol><li>muscle</li></ol>
mitan	<i>noun</i><br><ol><li>middle</li></ol>
mizajou	<i>adj</i><br><ol><li>up-to-date</li></ol>
mizik	<i>noun</i><br><ol><li>music</li></ol>
mizisyen	<i>noun</i><br><ol><li>musician</li></ol>
mo	<i>noun</i><br><ol><li>word</li></ol>
molisc	<i>noun</i><br><ol><li>mollusc</li></ol>
monceler	<i>verb</i><br><ol><li>(Saint-Domingue) to accumulate</li></ol>
monde	<i>verb</i><br><ol><li>(Saint-Domingue) a person</li></ol>
mons	<i>noun</i><br><ol><li>(mythology) monster (a terrifying or dangerous mystical creature)</li></ol>
monte	<i>verb</i><br><ol><li>to rise</li></ol>
moso	<i>noun</i><br><ol><li>piece</li></ol>
motosiklèt	<i>noun</i><br><ol><li>motorcycle</li></ol>
mouch	<i>noun</i><br><ol><li>fly (insect)</li></ol>
mouché	<i>noun</i><br><ol><li>(Saint-Domingue) sir</li></ol>
moun	<i>noun</i><br><ol><li>person</li></ol>
mouri	<i>verb</i><br><ol><li>to die</li></ol>
moustach	<i>noun</i><br><ol><li>moustache</li></ol>
mouton	<i>noun</i><br><ol><li>sheep</li></ol>
mouvman	<i>noun</i><br><ol><li>movement</li></ol>
move	<i>adj</i><br><ol><li>bad</li></ol>
msye	<i>noun</i><br><ol><li>mister, sir (a title or form of address for a man)</li></ol>
mwa	<i>noun</i><br><ol><li>month</li></ol>
mwen|form|mouin	<i>pron</i><br><ol><li>I</li><li>me</li></ol>
mwens	<i>adv</i><br><ol><li>less</li></ol>
myèl	<i>noun</i><br><ol><li>bee</li><li>honey</li></ol>
mèkredi	<i>noun</i><br><ol><li>Wednesday</li></ol>
mèsi	<i>intj</i><br><ol><li>thank you</li></ol>
mèt	<i>noun</i><br><ol><li>owner</li><li>metre</li></ol>
mété	<i>verb</i><br><ol><li>(Saint-Domingue) to put</li></ol>
mòn	<i>noun</i><br><ol><li>hill, mountain</li></ol>
n	<i>pron</i><br><ol><li>Contraction of nou.</li></ol>
n'ap boule	<i>intj</i><br><ol><li>well (response)</li></ol>
n'homme	<i>noun</i><br><ol><li>(Saint-Domingue) a man</li></ol>
nan	<i>article</i><br><ol><li>the (definite article)</li></ol><br><i>prep</i><br><ol><li>in</li></ol>
nasyon	<i>noun</i><br><ol><li>nation</li><li>(voodoo) nanchon (one of the major groupings of Vodou lwa)</li></ol>
nasyonal	<i>adj</i><br><ol><li>national</li></ol>
nasyonalite	<i>noun</i><br><ol><li>nationality</li></ol>
nati	<i>noun</i><br><ol><li>nature</li></ol>
natirèl	<i>adj</i><br><ol><li>natural</li></ol>
nenpòt	<i>adj</i><br><ol><li>any</li></ol>
nesans	<i>noun</i><br><ol><li>birth</li></ol>
nesesè	<i>adj</i><br><ol><li>necessary</li></ol>
nesesèman	<i>adv</i><br><ol><li>necessarily</li></ol>
netwaye	<i>verb</i><br><ol><li>To clean</li></ol>
nimewo	<i>noun</i><br><ol><li>number</li></ol>
non	<i>adv</i><br><ol><li>no</li></ol><br><i>noun</i><br><ol><li>name</li></ol>
nou|form	<i>pron</i><br><ol><li>we</li><li>us</li><li>you pl</li></ol>
nouvo	<i>adj</i><br><ol><li>new</li></ol>
novanm	<i>noun</i><br><ol><li>November</li></ol>
nwa	<i>adj</i><br><ol><li>black</li><li>dark</li></ol><br><i>noun</i><br><ol><li>nut</li></ol>
nwaj	<i>noun</i><br><ol><li>cloud</li></ol>
nwèl	<i>noun</i><br><ol><li>Christmas</li></ol>
nèf	<i>num</i><br><ol><li>nine</li></ol><br><i>adj</i><br><ol><li>(attributive) new</li></ol>
nèg	<i>noun</i><br><ol><li>guy, dude, man</li></ol>
nèj	<i>noun</i><br><ol><li>Snow.</li></ol>
nòmal	<i>adj</i><br><ol><li>normal</li></ol>
obeyi	<i>verb</i><br><ol><li>To obey</li></ol>
objè	<i>noun</i><br><ol><li>object</li></ol>
obsève	<i>verb</i><br><ol><li>To observe</li></ol>
ofisyèl	<i>adj</i><br><ol><li>official</li></ol>
okenn	<i>det</i><br><ol><li>no, not any</li></ol>
okipe	<i>verb</i><br><ol><li>To occupy</li></ol>
okontrè	<i>adv</i><br><ol><li>on the contrary, au contraire</li></ol>
oksidantal	<i>adj</i><br><ol><li>occidental</li></ol>
oksijèn	<i>noun</i><br><ol><li>oxygen</li></ol>
oktòb	<i>noun</i><br><ol><li>October</li></ol>
oma	<i>noun</i><br><ol><li>lobster</li></ol>
omwen	<i>adj</i><br><ol><li>at least</li></ol>
onon	<i>prep</i><br><ol><li>In the name of</li></ol>
onz	<i>num</i><br><ol><li>eleven</li></ol>
operasyon	<i>noun</i><br><ol><li>operation</li></ol>
orijin	<i>noun</i><br><ol><li>origin</li></ol>
oseyan	<i>noun</i><br><ol><li>ocean</li></ol>
osinon	<i>conj</i><br><ol><li>or, otherwise</li></ol>
oswa	<i>conj</i><br><ol><li>or</li></ol>
otaj	<i>noun</i><br><ol><li>hostage</li></ol>
otel	<i>noun</i><br><ol><li>hotel</li></ol>
otou	<i>prep</i><br><ol><li>around</li></ol>
otè	<i>noun</i><br><ol><li>author</li></ol>
ou|form w	<i>pron</i><br><ol><li>you (singular)</li></ol>
oubyen	<i>conj</i><br><ol><li>or</li></ol>
oungan	<i>noun</i><br><ol><li>(voodoo) priest, magician</li></ol>
oungfò	<i>noun</i><br><ol><li>hounfour (Vodou place of worship)</li></ol>
out	<i>noun</i><br><ol><li>August</li></ol>
pa	<i>adv</i><br><ol><li>not</li></ol>
paj	<i>noun</i><br><ol><li>page</li></ol>
pale	<i>verb</i><br><ol><li>to talk, to speak</li></ol>
palmis	<i>noun</i><br><ol><li>royal palm (Roystonea regia)</li></ol>
pami	<i>prep</i><br><ol><li>among</li></ol>
pandan	<i>prep</i><br><ol><li>during</li></ol>
panse	<i>verb</i><br><ol><li>think</li></ol>
panyol	<i>adj</i><br><ol><li>Spanish</li></ol><br><i>name</i><br><ol><li>Spanish (language)</li></ol>
paroître	<i>verb</i><br><ol><li>(Saint-Domingue) to know</li></ol>
parèt	<i>verb</i><br><ol><li>To appear</li></ol>
pase	<i>verb</i><br><ol><li>(transitive, intransitive) to pass</li><li>(transitive) to put</li><li>(transitive) to iron</li><li>(intransitive) to come to pass, to happen, to take place</li><li>(intransitive) to die</li></ol><br><i>prep</i><br><ol><li>than</li></ol>
paske	<i>conj</i><br><ol><li>because</li></ol>
pasyan	<i>noun</i><br><ol><li>patient</li></ol>
pasyans	<i>noun</i><br><ol><li>patience</li></ol>
pati	<i>noun</i><br><ol><li>part</li><li>party (as in a political party)</li></ol><br><i>verb</i><br><ol><li>leave, depart</li></ol>
patikil	<i>noun</i><br><ol><li>particle</li></ol>
patisipe	<i>verb</i><br><ol><li>participate</li></ol>
pawòl	<i>noun</i><br><ol><li>spoken word</li></ol>
peche	<i>noun</i><br><ol><li>(religion) sin</li></ol>
pen	<i>noun</i><br><ol><li>bread</li></ol>
perdi	<i>verb</i><br><ol><li>(Saint-Domingue) to lose</li></ol>
pete	<i>verb</i><br><ol><li>(transitive) to break</li><li>(transitive) to flatter, to fool</li><li>(intransitive) to burst, explode, break</li><li>(intransitive) to start (doing something)</li><li>(intransitive) to fart</li></ol>
petit monde	<i>noun</i><br><ol><li>(Saint-Domingue) a child</li></ol>
peyi	<i>noun</i><br><ol><li>country, nation</li></ol>
piblik	<i>noun</i><br><ol><li>public</li></ol>
pinga	<i>verb</i><br><ol><li>do not</li></ol>
pipi	<i>noun</i><br><ol><li>urine</li></ol>
pisans	<i>noun</i><br><ol><li>power, strength</li></ol>
pistach	<i>noun</i><br><ol><li>peanut</li></ol>
piti	<i>adj</i><br><ol><li>small</li></ol>
pla(n) pye	<i>noun</i><br><ol><li>sole</li></ol>
plaj	<i>noun</i><br><ol><li>beach (sandy place by the sea)</li></ol>
plant	<i>noun</i><br><ol><li>plant (organism)</li></ol>
plante	<i>verb</i><br><ol><li>To plant</li></ol>
planèt	<i>noun</i><br><ol><li>planet</li></ol>
plas	<i>noun</i><br><ol><li>place, space</li><li>position, job</li><li>plaza, square</li></ol>
plezi	<i>noun</i><br><ol><li>pleasure</li></ol>
plim	<i>noun</i><br><ol><li>feather</li></ol>
plis	<i>det</i><br><ol><li>more</li></ol>
plizyè	<i>det</i><br><ol><li>many, several</li></ol>
po	<i>noun</i><br><ol><li>(anatomy) skin</li></ol>
po bouch	<i>noun</i><br><ol><li>lip</li></ol>
politik	<i>noun</i><br><ol><li>politics</li></ol>
pompiye	<i>noun</i><br><ol><li>fireman</li></ol>
pon	<i>noun</i><br><ol><li>bridge</li></ol>
ponmad	<i>noun</i><br><ol><li>ponmad</li></ol>
ponyèt	<i>noun</i><br><ol><li>wrist</li></ol>
pope	<i>noun</i><br><ol><li>doll</li></ol>
potab	<i>adj</i><br><ol><li>potable</li></ol>
pote	<i>verb</i><br><ol><li>bring</li></ol>
pou	<i>prep</i><br><ol><li>for</li></ol><br><i>noun</i><br><ol><li>louse</li></ol>
poukisa	<i>adv</i><br><ol><li>why</li></ol>
poul	<i>noun</i><br><ol><li>chicken</li></ol>
pouldlo	<i>noun</i><br><ol><li>coot</li></ol>
poulmouye	<i>noun</i><br><ol><li>coward</li></ol>
poumon	<i>noun</i><br><ol><li>(anatomy) lung</li></ol>
pous	<i>noun</i><br><ol><li>thumb</li></ol>
pouse	<i>verb</i><br><ol><li>(of a plant) grow</li></ol>
pousyè	<i>noun</i><br><ol><li>dust</li></ol>
pouvwa	<i>noun</i><br><ol><li>power</li></ol>
pral	<i>adv</i><br><ol><li>Forms a near-future tense.</li></ol>
prale	<i>verb</i><br><ol><li>Contraction of pral ale.</li></ol>
pran	<i>verb</i><br><ol><li>take</li></ol>
preferans	<i>noun</i><br><ol><li>preference</li></ol>
prejije	<i>noun</i><br><ol><li>prejudice</li></ol>
premye	<i>adj</i><br><ol><li>first</li></ol>
prende	<i>verb</i><br><ol><li>(Saint-Domingue) to take</li></ol>
prentan	<i>noun</i><br><ol><li>spring (season of the year)</li></ol>
preparasyon	<i>noun</i><br><ol><li>preparation</li></ol>
prepare	<i>verb</i><br><ol><li>prepare</li></ol>
prevansyon	<i>noun</i><br><ol><li>prevention</li></ol>
prezidan	<i>noun</i><br><ol><li>president</li></ol>
pri	<i>noun</i><br><ol><li>price</li></ol>
prèske	<i>adv</i><br><ol><li>nearly</li><li>almost</li></ol>
prèt	<i>noun</i><br><ol><li>priest</li></ol>
puyer	<i>verb</i><br><ol><li>(Saint-Domingue) to support</li></ol>
pwa	<i>noun</i><br><ol><li>bean</li></ol>
pwa maldyòk	<i>noun</i><br><ol><li>jack bean (Canavalia ensiformis)</li></ol>
pwason	<i>noun</i><br><ol><li>fish</li></ol>
pwatray	<i>noun</i><br><ol><li>chest (of a horse)</li></ol>
pwatrin	<i>noun</i><br><ol><li>(anatomy) chest</li></ol>
pwent	<i>noun</i><br><ol><li>nib, tip</li></ol>
pwodui	<i>verb</i><br><ol><li>To produce</li></ol><br><i>noun</i><br><ol><li>product</li></ol>
pwofesyonèl	<i>noun</i><br><ol><li>professional</li></ol>
pwofite	<i>verb</i><br><ol><li>To profit</li></ol>
pwogrè	<i>noun</i><br><ol><li>progress</li></ol>
pwojè	<i>noun</i><br><ol><li>project</li></ol>
pwomèt	<i>verb</i><br><ol><li>to promise</li></ol>
pwoteje	<i>verb</i><br><ol><li>protect</li></ol>
pwoteksyon	<i>noun</i><br><ol><li>protection</li></ol>
pwòch	<i>adj</i><br><ol><li>near, nearby, close</li></ol>
pye	<i>noun</i><br><ol><li>(anatomy) foot</li><li>tree</li></ol>
pye kokoye	<i>noun</i><br><ol><li>coconut palm</li></ol>
pyebwa	<i>noun</i><br><ol><li>tree</li></ol>
pyèv	<i>noun</i><br><ol><li>octopus</li></ol>
pè	<i>verb</i><br><ol><li>To be afraid, to fear</li></ol>
pèdi	<i>verb</i><br><ol><li>lose</li></ol>
pèmisyon	<i>noun</i><br><ol><li>permission</li></ol>
pèmèt	<i>verb</i><br><ol><li>permit, allow</li></ol>
pèp	<i>noun</i><br><ol><li>a people</li></ol>
pèpèt	<i>noun</i><br><ol><li>fart</li></ol><br><i>verb</i><br><ol><li>to fart</li></ol>
pòch	<i>noun</i><br><ol><li>pocket</li></ol>
quichoy	<i>noun</i><br><ol><li>(Saint-Domingue) a thing</li></ol>
rad	<i>noun</i><br><ol><li>clothes</li></ol>
rakonte	<i>verb</i><br><ol><li>To recount</li></ol>
rasanble	<i>verb</i><br><ol><li>assemble</li><li>collect</li><li>gather</li></ol>
rasin	<i>noun</i><br><ol><li>root</li></ol>
rayi	<i>verb</i><br><ol><li>hate</li></ol>
rechèch	<i>noun</i><br><ol><li>research</li></ol>
referans	<i>noun</i><br><ol><li>reference</li></ol>
refigye	<i>noun</i><br><ol><li>refugee</li></ol>
refijye	<i>noun</i><br><ol><li>refugee</li></ol>
refize	<i>verb</i><br><ol><li>To decline</li><li>To refuse</li></ol>
reflèks	<i>noun</i><br><ol><li>reflex</li></ol>
refòm	<i>noun</i><br><ol><li>reform</li></ol>
reken	<i>noun</i><br><ol><li>shark</li></ol>
rekonèt|rekonnèt	<i>verb</i><br><ol><li>recognize</li></ol>
rele	<i>verb</i><br><ol><li>to be called</li><li>to call; to give something a name</li><li>to call, summon, beckon</li></ol>
relijyon	<i>noun</i><br><ol><li>religion</li></ol>
ren	<i>noun</i><br><ol><li>kidney</li></ol>
renmen	<i>verb</i><br><ol><li>like</li><li>love</li></ol>
rense	<i>verb</i><br><ol><li>To rinse</li></ol>
repiblik	<i>noun</i><br><ol><li>republic</li></ol>
repo	<i>noun</i><br><ol><li>rest</li></ol>
repons	<i>noun</i><br><ol><li>answer, response</li></ol>
reprann	<i>verb</i><br><ol><li>regain, take back</li></ol>
reptil	<i>noun</i><br><ol><li>reptile</li></ol>
resan	<i>adj</i><br><ol><li>recent</li></ol>
reservé	<i>verb</i><br><ol><li>(Saint-Domingue) to reserve</li></ol>
resif	<i>noun</i><br><ol><li>reef</li><li>(figuratively) obstacle</li></ol>
resous	<i>noun</i><br><ol><li>resource</li></ol>
restavèk	<i>noun</i><br><ol><li>restavec</li></ol>
rete	<i>verb</i><br><ol><li>to live, reside</li><li>to stay</li><li>(idiomatic) Wait a short while.</li></ol>
reve	<i>verb</i><br><ol><li>dream</li></ol>
revenan	<i>noun</i><br><ol><li>A ghost who returns to haunt the living.</li></ol>
reveye	<i>verb</i><br><ol><li>awaken</li></ol>
reyini	<i>verb</i><br><ol><li>bring together</li></ol>
reyinyon	<i>noun</i><br><ol><li>meeting</li></ol>
rezen	<i>noun</i><br><ol><li>grape</li></ol>
rezilta	<i>noun</i><br><ol><li>result</li></ol>
rezon	<i>noun</i><br><ol><li>reason, cause</li><li>reasoning (capacity for rational thinking)</li></ol>
rive	<i>verb</i><br><ol><li>happen</li></ol>
rivyè	<i>noun</i><br><ol><li>river</li></ol>
ron	<i>noun</i><br><ol><li>circle, ring</li></ol><br><i>adj</i><br><ol><li>round, circular</li></ol><br><i>adv</i><br><ol><li>sharp (of time)</li></ol>
rou	<i>noun</i><br><ol><li>wheel</li></ol>
rouj|wouj	<i>adj</i><br><ol><li>red</li></ol>
rouji	<i>verb</i><br><ol><li>(intransitive) to redden</li><li>(intransitive) to blush</li></ol>
rèn	<i>noun</i><br><ol><li>queen</li></ol>
rèv	<i>noun</i><br><ol><li>dream</li></ol>
sa	<i>det</i><br><ol><li>this</li><li>these</li><li>that</li><li>those</li></ol><br><i>pron</i><br><ol><li>(demonstrative) this</li><li>(demonstrative) these</li><li>(demonstrative) that</li><li>(demonstrative) those</li><li>(interrogative) what</li><li>(relative) what</li></ol>
sab	<i>noun</i><br><ol><li>sand</li></ol>
saliv	<i>noun</i><br><ol><li>saliva</li></ol>
samdi	<i>noun</i><br><ol><li>Saturday</li></ol>
san	<i>num</i><br><ol><li>hundred</li></ol><br><i>noun</i><br><ol><li>blood</li></ol>
sanble	<i>verb</i><br><ol><li>seem, appear</li><li>(transitive) look like</li></ol>
sann	<i>noun</i><br><ol><li>ash, cinder</li></ol>
sansi	<i>noun</i><br><ol><li>leech</li></ol>
sant	<i>noun</i><br><ol><li>centre</li><li>scent</li></ol>
sante	<i>noun</i><br><ol><li>health</li></ol>
santi	<i>verb</i><br><ol><li>to feel</li><li>(before reflexive pronoun) to feel (a certain way, an emotion)</li><li>to smell</li></ol>
santim	<i>noun</i><br><ol><li>centime</li></ol>
santiman	<i>noun</i><br><ol><li>feeling, sentiment</li></ol>
savé	<i>verb</i><br><ol><li>(Saint-Domingue) can, to be able</li></ol>
se	<i>verb</i><br><ol><li>to be</li><li>that is (compare French c'est)</li><li>it is (compare French c'est)</li></ol>
sechrès	<i>noun</i><br><ol><li>drought</li></ol>
segonn	<i>noun</i><br><ol><li>second</li></ol>
semèn	<i>noun</i><br><ol><li>week</li></ol>
senk	<i>num</i><br><ol><li>five</li></ol>
senkant	<i>num</i><br><ol><li>fifty</li></ol>
senp	<i>adj</i><br><ol><li>simple</li></ol>
senyen	<i>verb</i><br><ol><li>To bleed</li></ol>
sepandan	<i>conj</i><br><ol><li>however</li></ol>
septanm	<i>noun</i><br><ol><li>September</li></ol>
sere	<i>verb</i><br><ol><li>tighten, squeeze</li></ol><br><i>adj</i><br><ol><li>tight</li></ol>
seriz	<i>noun</i><br><ol><li>cherry (fruit)</li></ol>
sezon	<i>noun</i><br><ol><li>season</li></ol>
si	<i>conj</i><br><ol><li>if</li></ol>
sibi	<i>verb</i><br><ol><li>To undergo</li></ol>
siklòn	<i>noun</i><br><ol><li>cyclone, hurricane</li></ol>
sinema	<i>noun</i><br><ol><li>cinema</li></ol>
sipò	<i>noun</i><br><ol><li>support</li></ol>
sipòte	<i>verb</i><br><ol><li>support</li><li>tolerate</li></ol>
sis	<i>num</i><br><ol><li>six</li></ol>
sistèm solè	<i>noun</i><br><ol><li>solar system</li></ol>
sitta	<i>verb</i><br><ol><li>(Saint-Domingue) to sit</li></ol>
sityasyon	<i>noun</i><br><ol><li>situation</li></ol>
sitye	<i>verb</i><br><ol><li>to be located, situated</li></ol>
sitèlman	<i>adv</i><br><ol><li>so many</li><li>so, so much</li></ol>
siwo	<i>noun</i><br><ol><li>syrup</li></ol>
siwo myèl	<i>noun</i><br><ol><li>honey</li></ol>
sizo	<i>noun</i><br><ol><li>scissors</li></ol>
solèy	<i>noun</i><br><ol><li>sun</li></ol>
somé	<i>verb</i><br><ol><li>(Saint-Domingue) to knock out</li></ol>
sosyete	<i>noun</i><br><ol><li>society</li></ol>
soti	<i>verb</i><br><ol><li>leave, exit (used with nan = from)</li></ol>
sou	<i>prep</i><br><ol><li>on</li><li>about, concerning</li></ol>
soufri	<i>verb</i><br><ol><li>suffer</li></ol>
soulye	<i>noun</i><br><ol><li>shoe</li></ol>
souré	<i>verb</i><br><ol><li>(Saint-Domingue) to assure, to persuade</li></ol>
sous	<i>noun</i><br><ol><li>source</li></ol>
souvan	<i>adv</i><br><ol><li>often</li></ol>
sovaj	<i>adj</i><br><ol><li>wild</li></ol>
strikti	<i>noun</i><br><ol><li>structure</li></ol>
swa	<i>noun</i><br><ol><li>evening</li></ol>
swasant	<i>num</i><br><ol><li>sixty</li></ol>
swasantdis	<i>num</i><br><ol><li>seventy</li></ol>
swe	<i>verb</i><br><ol><li>sweat</li></ol>
swen	<i>noun</i><br><ol><li>care</li></ol>
syans	<i>noun</i><br><ol><li>science</li></ol>
syantifik	<i>adj</i><br><ol><li>scientific</li></ol>
syèl	<i>noun</i><br><ol><li>sky</li><li>heaven</li></ol>
sè	<i>noun</i><br><ol><li>sister</li></ol>
sèk	<i>noun</i><br><ol><li>circle</li></ol><br><i>adj</i><br><ol><li>dry</li></ol>
sèl	<i>adj</i><br><ol><li>alone</li><li>only</li></ol><br><i>noun</i><br><ol><li>salt</li></ol>
sèlman	<i>adv</i><br><ol><li>only</li></ol>
sèt	<i>num</i><br><ol><li>seven</li></ol>
sètadi	<i>adv</i><br><ol><li>that is to say</li></ol>
sèvi	<i>verb</i><br><ol><li>To serve</li></ol>
sèvitè	<i>noun</i><br><ol><li>servant</li></ol>
sèvo	<i>noun</i><br><ol><li>(anatomy) brain</li></ol>
sèvèl	<i>noun</i><br><ol><li>(anatomy) brain</li></ol>
sèz	<i>num</i><br><ol><li>sixteen</li></ol>
sòmey	<i>noun</i><br><ol><li>sleep</li></ol>
t'	<i>adv</i><br><ol><li>Contraction of te.</li></ol>
ta	<i>adv</i><br><ol><li>Indicates the conditional mood.</li></ol>
tab	<i>noun</i><br><ol><li>table</li></ol>
tache	<i>verb</i><br><ol><li>attach</li></ol>
tacher	<i>verb</i><br><ol><li>(Saint-Domingue) to attach</li></ol>
tan	<i>noun</i><br><ol><li>time</li><li>weather</li></ol>
tanbou	<i>noun</i><br><ol><li>drum</li></ol>
tandans	<i>noun</i><br><ol><li>tendency, trend</li></ol>
tande	<i>verb</i><br><ol><li>hear</li></ol>
tandon	<i>noun</i><br><ol><li>tendon</li></ol>
tankou	<i>adv</i><br><ol><li>like, as though</li></ol><br><i>prep</i><br><ol><li>like</li></ol>
tann	<i>verb</i><br><ol><li>wait</li></ol>
tanperati	<i>noun</i><br><ol><li>temperature</li></ol>
tante	<i>verb</i><br><ol><li>to attempt</li><li>to tempt</li></ol>
tapi	<i>noun</i><br><ol><li>carpet, rug</li></ol>
tche	<i>noun</i><br><ol><li>tail</li></ol>
tcheke	<i>verb</i><br><ol><li>check, verify</li></ol>
te	<i>adv</i><br><ol><li>Indicates the past or pluperfect tense.</li></ol>
teknoloji	<i>noun</i><br><ol><li>technology</li></ol>
televizyon	<i>noun</i><br><ol><li>television</li></ol>
teori|teyori	<i>noun</i><br><ol><li>theory</li></ol>
teritwa	<i>noun</i><br><ol><li>territory</li></ol>
tete	<i>noun</i><br><ol><li>teat, breast</li></ol>
ti	<i>adj</i><br><ol><li>little</li></ol>
tien ben	<i>verb</i><br><ol><li>(Saint-Domingue) to hold</li></ol>
tifi	<i>noun</i><br><ol><li>girl</li></ol>
tig	<i>noun</i><br><ol><li>tiger</li></ol>
timoun	<i>noun</i><br><ol><li>child</li></ol>
tini	<i>verb</i><br><ol><li>(Saint-Domingue) to hold</li></ol>
tire	<i>verb</i><br><ol><li>To shoot (hit with a bullet or arrow)</li></ol>
tonbe	<i>verb</i><br><ol><li>to fall, tumble, collapse</li><li>to sink, subside</li><li>(auxiliary) to start (followed by verb)</li></ol>
toujou	<i>adv</i><br><ol><li>always</li></ol>
toulejou	<i>adv</i><br><ol><li>daily, every day</li></ol>
toulède	<i>adv</i><br><ol><li>both</li></ol>
tounen	<i>verb</i><br><ol><li>return</li></ol>
toupatou	<i>adv</i><br><ol><li>everywhere</li></ol>
touswit	<i>adv</i><br><ol><li>immediately, right away</li></ol>
tout	<i>adj</i><br><ol><li>all</li></ol><br><i>adv</i><br><ol><li>all</li><li>every</li></ol>
tout plein	<i>adj</i><br><ol><li>(Saint-Domingue) many</li></ol><br><i>adv</i><br><ol><li>(Saint-Domingue) very</li></ol>
toutafè	<i>adv</i><br><ol><li>entirely, completely</li></ol>
touye	<i>verb</i><br><ol><li>kill</li></ol>
tradui	<i>verb</i><br><ol><li>translate</li></ol>
tranblemanntè|tranblemandtè|tranbleman detè	<i>noun</i><br><ol><li>earthquake</li></ol>
trannde	<i>num</i><br><ol><li>thirty-two</li></ol>
trannkat	<i>num</i><br><ol><li>thirty-four</li></ol>
trannsenk	<i>num</i><br><ol><li>thirty-five</li></ol>
trannsis	<i>num</i><br><ol><li>thirty-six</li></ol>
trannsèt	<i>num</i><br><ol><li>thirty-seven</li></ol>
tranntwa	<i>num</i><br><ol><li>thirty-three</li></ol>
trant	<i>num</i><br><ol><li>thirty</li></ol>
tranteyen	<i>num</i><br><ol><li>thirty-one</li></ol>
trantnèf	<i>num</i><br><ol><li>thirty-nine</li></ol>
trantuit	<i>num</i><br><ol><li>thirty-eight</li></ol>
travay	<i>noun</i><br><ol><li>work</li></ol><br><i>verb</i><br><ol><li>To work</li></ol>
tretman	<i>noun</i><br><ol><li>treatment</li></ol>
triyang	<i>noun</i><br><ol><li>triangle</li></ol>
troupo	<i>noun</i><br><ol><li>herd</li></ol>
trèt	<i>noun</i><br><ol><li>traitor</li></ol>
trèz	<i>num</i><br><ol><li>thirteen</li></ol>
tré ben	<i>adv</i><br><ol><li>(Saint-Domingue) very well</li></ol>
twa	<i>num</i><br><ol><li>three</li></ol>
twò	<i>adv</i><br><ol><li>too</li></ol>
tyè	<i>noun</i><br><ol><li>A third</li></ol>
tè	<i>noun</i><br><ol><li>Earth</li><li>ground</li></ol>
tèks	<i>noun</i><br><ol><li>text</li></ol>
tèt	<i>noun</i><br><ol><li>head</li><li>reflexive marker (myself, yourself, oneself, etc.)</li></ol>
tòti	<i>noun</i><br><ol><li>turtle</li></ol>
uit	<i>num</i><br><ol><li>eight</li></ol>
valè	<i>noun</i><br><ol><li>value</li></ol>
van	<i>noun</i><br><ol><li>wind</li></ol>
vancé	<i>verb</i><br><ol><li>(Saint-Domingue) to advance</li></ol>
vandredi	<i>noun</i><br><ol><li>Friday</li></ol>
vann	<i>verb</i><br><ol><li>To sell</li></ol>
vant	<i>noun</i><br><ol><li>(anatomy) belly, stomach</li></ol>
vapè	<i>noun</i><br><ol><li>steam; water vapor</li></ol>
ve	<i>noun</i><br><ol><li>worm</li></ol>
vejetalyen	<i>adj</i><br><ol><li>vegan</li></ol><br><i>noun</i><br><ol><li>vegan</li></ol>
vejetaryen	<i>adj</i><br><ol><li>vegetarian</li></ol><br><i>noun</i><br><ol><li>vegetarian</li></ol>
ven	<i>num</i><br><ol><li>twenty</li></ol>
venn	<i>noun</i><br><ol><li>vein</li></ol>
vennde	<i>num</i><br><ol><li>twenty-two</li></ol>
vennkat	<i>num</i><br><ol><li>twenty-four</li></ol>
vennsenk	<i>num</i><br><ol><li>twenty-five</li></ol>
vennsis	<i>num</i><br><ol><li>twenty-six</li></ol>
vennsèt	<i>num</i><br><ol><li>twenty-seven</li></ol>
venntwa	<i>num</i><br><ol><li>twenty-three</li></ol>
venteyen	<i>num</i><br><ol><li>twenty-one</li></ol>
ventnèf	<i>num</i><br><ol><li>twenty-nine</li></ol>
ventuit	<i>num</i><br><ol><li>twenty-eight</li></ol>
verite	<i>noun</i><br><ol><li>truth</li></ol>
verver	<i>noun</i><br><ol><li>In Haitian vodou, a geometric design traced or painted on the ground with a mix of corn flour and ash, as part of a ritual of summoning or communicating with a deity.</li></ol>
viktim	<i>noun</i><br><ol><li>victim</li></ol>
vil	<i>noun</i><br><ol><li>city</li></ol>
vinèg	<i>noun</i><br><ol><li>vinegar</li></ol>
vitès	<i>noun</i><br><ol><li>speed</li></ol>
viv	<i>verb</i><br><ol><li>to live</li></ol>
vivan	<i>adj</i><br><ol><li>living, alive</li></ol>
vizib	<i>adj</i><br><ol><li>visible</li></ol>
vle	<i>verb</i><br><ol><li>to want, will, wish</li></ol>
vle di	<i>verb</i><br><ol><li>to mean, signify</li></ol>
vlé	<i>verb</i><br><ol><li>(Saint-Domingue) to believe</li></ol>
vo	<i>verb</i><br><ol><li>To be worth</li></ol>
voir	<i>verb</i><br><ol><li>(Saint-Domingue) to see</li></ol>
volim	<i>noun</i><br><ol><li>volume</li></ol>
voryen	<i>noun</i><br><ol><li>good-for-nothing, scoundrel</li></ol>
voye	<i>verb</i><br><ol><li>send</li></ol>
vre	<i>adj</i><br><ol><li>true</li></ol>
vwa	<i>noun</i><br><ol><li>voice</li></ol>
vwayaj	<i>noun</i><br><ol><li>trip, travel</li></ol>
vwayaje	<i>verb</i><br><ol><li>travel</li></ol>
vwazen	<i>noun</i><br><ol><li>neighbor</li></ol>
vye	<i>adj</i><br><ol><li>old</li></ol>
vyolans	<i>noun</i><br><ol><li>violence</li></ol>
vyole	<i>verb</i><br><ol><li>To rape, sexually assault</li></ol>
vè	<i>noun</i><br><ol><li>worm</li><li>drinking glass</li></ol><br><i>adj</i><br><ol><li>green</li></ol>
vèsyon	<i>noun</i><br><ol><li>version</li></ol>
vèt	<i>adj</i><br><ol><li>green</li></ol>
vèvè	<i>noun</i><br><ol><li>veve (Vodou religious symbol)</li></ol>
vòlkan	<i>noun</i><br><ol><li>volcano</li></ol>
vòlè	<i>noun</i><br><ol><li>robber, thief</li></ol>
w	<i>pron</i><br><ol><li>Contraction of ou.</li></ol>
wa	<i>noun</i><br><ol><li>king</li></ol>
wanganègès	<i>noun</i><br><ol><li>hummingbird</li></ol>
wo	<i>adj</i><br><ol><li>high</li><li>tall</li></ol><br><i>adv</i><br><ol><li>high</li></ol>
wotè	<i>noun</i><br><ol><li>height</li></ol>
wowoli	<i>noun</i><br><ol><li>(botany) Sesamum orientale, sesame</li></ol>
woz	<i>adj</i><br><ol><li>pink</li></ol>
wè	<i>verb</i><br><ol><li>see</li></ol>
y	<i>pron</i><br><ol><li>Contraction of yo.</li></ol>
yo|form y	<i>article</i><br><ol><li>the</li></ol><br><i>pron</i><br><ol><li>they</li><li>them</li></ol>
yon	<i>article</i><br><ol><li>a, an; the indefinite article</li></ol>
yè	<i>adv</i><br><ol><li>yesterday</li></ol>
z'abitude	<i>noun</i><br><ol><li>(Saint-Domingue) a habit</li></ol>
z'action	<i>noun</i><br><ol><li>(Saint-Domingue) an action</li></ol>
z'afair	<i>noun</i><br><ol><li>(Saint-Domingue) a business</li></ol>
z'anana	<i>noun</i><br><ol><li>(Saint-Domingue) pineapple</li></ol>
z'atrape	<i>noun</i><br><ol><li>(Saint-Domingue) a trap</li></ol>
z'enfant	<i>noun</i><br><ol><li>(Saint-Domingue) a child</li></ol>
z'oignon	<i>noun</i><br><ol><li>(Saint-Domingue) an onion</li></ol>
z'orage	<i>noun</i><br><ol><li>(Saint-Domingue) an object, thing</li></ol>
z'oreille	<i>noun</i><br><ol><li>(Saint-Domingue) an ear</li></ol>
z'ouvrier	<i>noun</i><br><ol><li>(Saint-Domingue) a worker</li></ol>
z'yeu	<i>verb</i><br><ol><li>(Saint-Domingue) an eye</li></ol>
zafè	<i>noun</i><br><ol><li>belongings</li></ol>
zanj	<i>noun</i><br><ol><li>angel</li></ol>
zanmi	<i>noun</i><br><ol><li>friend</li></ol>
zannimo	<i>noun</i><br><ol><li>animal</li></ol>
zansèt	<i>noun</i><br><ol><li>ancestor</li></ol>
zariyen	<i>noun</i><br><ol><li>spider</li></ol>
ze	<i>noun</i><br><ol><li>egg</li></ol>
zepis	<i>noun</i><br><ol><li>spice (seasoning for food)</li></ol>
zetwal	<i>noun</i><br><ol><li>star</li></ol>
zewo	<i>num</i><br><ol><li>zero</li></ol>
zil	<i>noun</i><br><ol><li>island</li></ol>
zile	<i>noun</i><br><ol><li>island</li></ol>
zo	<i>noun</i><br><ol><li>bone</li></ol>
zomby	<i>noun</i><br><ol><li>(Saint-Domingue) a resurrected man</li></ol>
zong	<i>noun</i><br><ol><li>fingernail</li></ol>
zong pye	<i>noun</i><br><ol><li>toenail</li></ol>
zoranj	<i>noun</i><br><ol><li>orange (fruit)</li></ol>
zouragan	<i>noun</i><br><ol><li>(Saint-Doimingue) a hurricane</li></ol>
zouti	<i>noun</i><br><ol><li>tool</li></ol>
zwazo	<i>noun</i><br><ol><li>bird</li></ol>
zwazo mouch	<i>noun</i><br><ol><li>hummingbird</li></ol>
zye	<i>noun</i><br><ol><li>eye</li></ol>
zèb	<i>noun</i><br><ol><li>grass</li></ol>
zèl	<i>noun</i><br><ol><li>wing (of a bird or insect)</li></ol>
zèpòl	<i>noun</i><br><ol><li>shoulder</li></ol>
zòrèy	<i>noun</i><br><ol><li>ear (organ of hearing)</li></ol>
zòtèy	<i>noun</i><br><ol><li>toe (digit of the foot)</li></ol>
èd	<i>noun</i><br><ol><li>help</li></ol>
èske	<i>particle</i><br><ol><li>indicates a yes-no question</li></ol>
òdinatè	<i>noun</i><br><ol><li>computer</li></ol>
òganis	<i>noun</i><br><ol><li>organism</li></ol>
òganizasyon	<i>noun</i><br><ol><li>organization</li></ol>
ògàn	<i>noun</i><br><ol><li>organ (part of organism)</li></ol>
