A	<i>character</i><br><ol><li>The first letter of the Inari Sami alphabet, written in the Latin script.</li></ol>
Aanaar	<i>name</i><br><ol><li>Inari (a municipality of Lapland, Finland)</li></ol>
Avveel	<i>name</i><br><ol><li>Ivalo (a village in Finland)</li></ol>
Iänudâh	<i>name</i><br><ol><li>Enontekiö (a municipality of Lapland, Finland)</li></ol>
Kuovdâkiäinu	<i>name</i><br><ol><li>Kautokeino (a municipality of Finnmark, Norway)</li></ol>
Ruoššâ	<i>name</i><br><ol><li>Russia</li></ol>
Suomâ|Suoṃân|Suommân|Suomâst|Suomáin|Suommâd|Suoṃâ|Suoˈmâttáá	<i>name</i><br><ol><li>Finland (a country in Europe)</li></ol>
aassâđ|asâžep|áásus|ássoon|asâččih|aasah|assii|áásá|asâččáid|aasâšvetteđ|áássup|aasâim|asâvettee|ässeen|aasâm|aasâšvettee|aassâp|asâvetteđ|aasâi|aasâš|asâžává|ässeeh|aasii|asâččáim|aassim|aassâv|aasâ|asâžeen|ässeem|asâččijd|aassih|aasain|asâččij|aasaim|aassâm|ääsih|asâžeh|aasaid|asâččáin|asâččii|aasâid|áássus|asâččijm|asâččim|ässee	<i>verb</i><br><ol><li>to live, to dwell</li></ol>
aavis|aavisid|aavisttáá|aavisáin|aaviseh|aavisân|aavisist|aavisijttáá|aavisij|aavisijd|aavisáid|aavisin|aavisijn|aavisijguin	<i>noun</i><br><ol><li>newspaper</li></ol>
ahe|avveest|oṿijttáá|ovvijd|ooṿijd|ahheen|ovvijn|aṿe|ooṿijn|aṿettáá|aṿeh|oṿijguin|ahheed|oṿij|ooṿij|ahan	<i>noun</i><br><ol><li>age</li></ol>
aiccâđ|aiccâv|aaicâ|aaicah|áiccus|äicceh|aaicâš|äiccen|aicâččim|aiccaid|aiccaim|aaicâid|äiccem|aicâččih|aiccih|aicâččáid|aicâččijm|aicâččii|äicce|aiccim|aiccâvetteđ|áiccá|aaicâim|ááicus|aicâččáim|aicâžává|aicâččáin|aaicâi|aiccii|aicii|aiccâm|äiccih|aicâžeen|aicâžeh|aicâžep|aaicâm|aaicâšvetteđ|áiccon|aicâččij|aicâččijd|aiccâp|aiccâvettee|aaicâšvettee|áiccup|aiccain	<i>verb</i><br><ol><li>to perceive</li></ol>
ain	<i>adv</i><br><ol><li>always</li><li>still</li></ol>
alge|olgijn|algeh|olgij|algen|olgijd|oolgij|aalgan|algettáá|alged|oolgijn|olgijttáá|oolgijd|olgijguin|algeest	<i>noun</i><br><ol><li>boy</li><li>son</li></ol>
algâ|aalgâ|algâd|aalgâi|algain|algâi|aalgâin|algân|algâittáá|aalgah|algaid|aalgâst|aalgân|algâttáá|aalgâid|algâiguin	<i>noun</i><br><ol><li>start</li><li>beginning</li></ol>
almai|aˈlmai|almajân|almaa|almajin|almaah|almaittáá|almajid|almaiguin|almast|almaattáá|almain|almaid	<i>noun</i><br><ol><li>man</li></ol>
alme|ollijd|alleest|ooḷijd|ollijn|ooḷij|oḷijguin|almen|aḷettáá|oḷijttáá|aḷe|almed|aḷeh|oḷij|ooḷijn|aalman	<i>noun</i><br><ol><li>sky</li><li>heaven</li></ol>
anarâš|anarâšttáá|anarâšâittáá|anarâššáid|anarâššân|anarâššâd|anarâšah|anarâšâin|anarâšâiguin|anarâšâid|anarâššáin|anarâšâst|anarâšân|anarâšâi	<i>noun</i><br><ol><li>Inari Sami person</li></ol>
anarâškielâ|anarâškieláin|anarâškielâst|anarâškieḷân|anarâškieḷâ|anarâškiellân|anarâškieˈlâttáá|anarâškiellâd	<i>name</i><br><ol><li>Inari Sami language</li></ol>
arve|aarvan|ooṛij|oṛijttáá|arved|orrijn|arven|aṛettáá|aṛe|arreest|ooṛijn|aṛeh|orrijd|ooṛijd|oṛijguin|oṛij	<i>noun</i><br><ol><li>rain</li></ol>
ase	<i>noun</i><br><ol><li>fleshy, inner side of a skin</li></ol>
auto|autoh|autoid|autoin|auton|autost|autoiguin|autottáá|autoi|autod|avdo|autoittáá	<i>noun</i><br><ol><li>car</li></ol>
bussi|bussijttáá|bussid|bussih|bussittáá|bussijd|bussij|bussijn|bussiguin|bussin|bussist	<i>noun</i><br><ol><li>bus</li></ol>
caappâđ|caavâim|cavâžává|cavâččih|caappâm|cáppoon|cááppup|cavâččij|cavâččim|caavâš|cäppeen|cavâžep|cääpih|caappâp|cavâččii|caavain|cavâččáin|caappâv|cäppeem|capâvettee|cavâččáid|cavâččáim|caavah|cappii|cäppeeh|cavâžeen|cavâččijd|caavâm|cáávus|cáápá|caavaid|caappih|capâvetteđ|caavâšvettee|caavâšvetteđ|cäppee|cááppus|caappim|caavâid|cavâžeh|caavâi|caavii|caavâ|cavâččijm|caavaim	<i>verb</i><br><ol><li>to chop up, to cut up</li></ol>
cakkâđ|cákkon|cákkup|cahhaim|cahâččijd|cahâččii|cahii|cahâččih|caahâšvettee|caahâi|caahâm|cakkâp|caahâš|cäkke|cakkim|cakkâm|cahâžeen|cahâččim|cakkâvetteđ|cahâččáin|cááhus|cahâččij|cákká|cakkâv|cäkken|caahâim|caahah|cahâžává|cäkkih|cahâččáim|cahâžeh|cahâččáid|cákkus|cäkkem|caahâšvetteđ|caahâid|cakkih|caahâ|cäkkeh|cakkii|cakkâvettee|cahâččijm|cahâžep|cahhain|cahhaid	<i>verb</i><br><ol><li>to groan, to moan</li></ol>
ciccâ|ciicâ|ciicâid|ciicâst|ciccáid|cicâi|cicâittáá|ciccân|ciicah|ciicân|ciccáin|cicâiguin|ciccâd|ciicâin|cicâttáá|ciicâi	<i>noun</i><br><ol><li>fishnet dye</li></ol>
cissâđ	<i>verb</i><br><ol><li>to pee</li></ol>
civkkee|civkkei|civkkeid|civkkeeh|civkkest|civkken|civkkeittáá|civkkeettáá|civkked|civkkeiguin|civkkein	<i>noun</i><br><ol><li>pipit (bird)</li></ol>
coggâđ	<i>verb</i><br><ol><li>to prop up, to support</li></ol>
coohâđ|cooḥâđ	<i>verb</i><br><ol><li>to smoulder</li></ol>
cullâgyettiđ	<i>verb</i><br><ol><li>to whisper</li></ol>
cuoppâ|cuopˈpâd|cuopâ|cuopâi|cuopˈpáin|cuopâin|cuopân|cuoˈpâittáá|cuopˈpâ|cuopˈpáid|cuoˈpâttáá|cuopâid|cuoˈpâi|cuopah|cuopˈpân|cuopâst|cuoˈpâiguin	<i>noun</i><br><ol><li>fish meat</li></ol>
cuvnâđ	<i>verb</i><br><ol><li>to wake up (someone)</li></ol>
cuábui|cuobbui|cuobbuu|cuábujin|cuobbust|cuobbuid|cuobbun|cuobbud|cuobbuuttáá|cuobbuittáá|cuobbuuh|cuobbuin|cuábujid|cuobbuiguin	<i>noun</i><br><ol><li>frog</li></ol>
cuáŋuimáánu|cuáŋuimáánui|cuáŋuimáánust|cuáŋuimáánun|cuáŋuimáánnun|cuáŋuimáánnud|cuáŋuimánuittáá|cuáŋuimáánuin|cuáŋuimánuiguin|cuáŋuimánuttáá|cuáŋuimáánuid|cuáŋuimánui|cuáŋuimáánuh	<i>noun</i><br><ol><li>April</li></ol>
eelliđ	<i>verb</i><br><ol><li>to live</li></ol>
eeči|eejijd|eeččin|eejijn|eijijd|eeji|eejist|ejijttáá|eeččid|ejittáá|ejijguin|eejij|eijijn|ejij|iäčán|eejih	<i>noun</i><br><ol><li>father</li></ol>
ellee|elleid|elleeh|elled|ellen|elleittáá|ellest|elleettáá|elleiguin|ellei|ellein	<i>noun</i><br><ol><li>animal</li></ol>
elleekove	<i>noun</i><br><ol><li>movie</li></ol>
ettâ|eetâid|eetâi|ettáid|eetâin|etâi|ettâd|etâittáá|eetâst|etâiguin|eetân|ettáin|eetah|etâttáá|ettân|eetâ	<i>noun</i><br><ol><li>thing</li></ol>
euro|euroi|euroid|euroh|euroiguin|euroittáá|eurost|euron|eurod|evro|eurottáá|euroin	<i>noun</i><br><ol><li>euro (currency)</li></ol>
finnodâh|finnodâhttáá|finnodâhij|finnodâheh|finnodâhân|finnodâháid|finnodâháin|finnodâhijguin|finnodâhijn|finnodâhijd|finnodâhist|finnodâhijttáá|finnodâhin|finnodâhid	<i>noun</i><br><ol><li>company (business)</li></ol>
fááru|fáárrud|fáárrun|fááṛu|fáárust|fáruttáá|fááruin|fáruittáá|fárui|fááruid|fáruiguin|fáároid|fáároin|fáárui|fááruh|fááṛun	<i>noun</i><br><ol><li>group, party</li></ol>
haajâ|haaj̣â|haaijân|hajâttáá|haajâid|haajah|hajâi|haajáin|hajâiguin|hajâittáá|haaijâd|haajân|haajâst|haajáid|haajâin|haajâi	<i>noun</i><br><ol><li>smell, odour</li></ol>
hadde|hoodij|haadan|hodijttáá|hadettáá|hodijguin|hadden|hadeh|hadded|hodij|hoodijn|hoddijn|haddeest|hoddijd|hoodijd|hade	<i>noun</i><br><ol><li>price, cost, rate</li></ol>
hattâ|hatâi|haatâid|haatâ|haatâin|hattain|hatâttáá|hatâittáá|hattân|haatâi|hattaid|haatâst|hattâd|hatâiguin|haatah|haatân	<i>noun</i><br><ol><li>hat</li></ol>
hiävuš|hiäppušeh|hiäppušáid|hiävušin|hiäppušijttáá|hiävušid|hiäppušttáá|hiäppušin|hiäppušân|hiäppušáin|hiäppušijguin|hiäppuš|hiäppušid|hiäppušijd|hiäppušijn|hiäppušij|hiäppušist	<i>noun</i><br><ol><li>horse</li></ol>
huolâ|huolâi|huoláid|huoḷâ|huoˈlâttáá|huoˈlâittáá|huollâd|huoˈlâi|huoˈlâiguin|huoḷân|huollân|huolâid|huolâst|huoláin|huolah|huolâin	<i>noun</i><br><ol><li>worry, concern</li></ol>
iberdiđ	<i>verb</i><br><ol><li>to understand</li></ol>
ihe|iṿijttáá|ihheed|iiṿijd|iṿettáá|ihheen|iṿij|ivvijn|iiṿij|ivvijd|iṿeh|iiṿijn|ihán|iṿijguin|ivveest|iṿe	<i>noun</i><br><ol><li>year</li></ol>
iiđeed|iđedáin|iiđeedttáá|iđedijguin|iđedid|iđedân|iđedin|iđedijttáá|iđedeh|iđedijn|iđedáid|iđedij|iđedist|iđedijd	<i>noun</i><br><ol><li>morning</li></ol>
iiŋŋâđ	<i>verb</i><br><ol><li>to dry, dry out</li></ol>
ij|jieˈm|iäˈlus|eppee|eppeđ|iällus|iällup|jieˈh|iäˈvá|elleđ|ellee|iälˈloon|iällum|iä|ep|iän|ele	<i>verb</i><br><ol><li>not</li></ol>
ijjâ|ijjáid|iij̣ah|iij̣âst|iij̣âid|ij̣âi|ij̣âttáá|ijjâd|iij̣âi|iij̣ân|ij̣âiguin|ij̣âittáá|ijjân|iij̣â|ijjáin|iij̣âin	<i>noun</i><br><ol><li>night</li></ol>
illâ|illáid|iiḷâin|iḷâittáá|illâd|iiḷâid|iḷâiguin|iiḷâi|iḷâi|iḷâttáá|iiḷâst|iiḷân|illân|iiḷâ|iiḷah|illáin	<i>noun</i><br><ol><li>ember, glowing coal</li></ol>
ime|immeed|imijttáá|iimij|iimeest|imeh|iimijd|iṃán|iṃe|imettáá|immeen|imijguin|imij|iimijn	<i>noun</i><br><ol><li>wife of one's elder brother</li></ol>
irâttâs|irâttâssáid|irâttâssâd|irâttâssáin|irâttâsâid|irâttâsâi|irâttâsttáá|irâttâsâin|irâttâsah|irâttâsâst|irâttâsâittáá|irâttâsâiguin|irâttâssân|irâttâsân	<i>noun</i><br><ol><li>company (business)</li></ol>
iäláán|iäláneh|iälánijguin|iälánáin|iäláánttáá|iälánân|iälánij|iälánijd|iälánid|iälánijn|iälánist|iälánijttáá|iälánáid|iälánin	<i>noun</i><br><ol><li>organism</li></ol>
jaannâđ|jaannim|jännee|janâččáim|jääṇih|janâččáid|jaanâi|jaanâm|jaanâim|jänneeh|jaanah|jáánnus|jaanain|janâččijm|jaanâ|jaanâšvettee|janâččijd|jaanii|jannii|janâččih|jaanâš|jánnoon|jáánnup|jänneen|jáánus|jänneem|janâžeen|jaannâp|jaṇâvetteđ|jaanâid|janâžává|janâččáin|janâččij|jaanaid|jaannih|janâččii|jaanâšvetteđ|janâččim|jááṇá|janâžep|jaannâv|jaannâm|janâžeh|jaṇâvettee|jaanaim	<i>verb</i><br><ol><li>to shrink</li></ol>
jeggi|jeegij|jegijguin|jeegijd|jeggijn|jegij|jiägán|jeggin|jeggid|jeegijn|jegittáá|jeggijd|jeegih|jegijttáá|jeegist|jeegi	<i>noun</i><br><ol><li>bog</li></ol>
jielâ|jielâid|jielâttáá|jielâi|jieláin|jieḷâ|jielâiguin|jielân|jielâst|jielâd|jielah|jielâin|jielâittáá|jieláid	<i>noun</i><br><ol><li>breeze</li></ol>
jienâ|jienáin|jienáid|jieṇâ|jienâid|jienâst|jienâin|jiennâd|jieˈnâi|jieˈnâiguin|jieˈnâttáá|jienâi|jieˈnâittáá|jiennân|jieṇân|jienah	<i>noun</i><br><ol><li>voice</li><li>sound</li></ol>
jietânâs|jietânâssáin|jietânâsâid|jietânâsâst|jieˈtânâs|jietânâssâd|jietânâsttáá|jietânâssáid|jietânâsâin|jietânâsâi|jietânâsâittáá|jietânâsân|jietânâssân|jietânâsah|jietânâsâiguin	<i>noun</i><br><ol><li>giant</li></ol>
jieŋâ|jieŋâst|jieŋah|jieŋ̣ân|jieˈŋâiguin|jieˈŋâittáá|jieŋáin|jieŋáid|jieŋ̣â|jieˈŋâi|jieŋâin|jieŋâi|jieŋâid|jieˈŋâttáá|jieŋŋân|jieŋŋâd	<i>noun</i><br><ol><li>ice</li></ol>
jieŋâpaje|jieŋâpaajeest|jieŋâpajettáá|jieŋâpoojij|jieŋâpoojijn|jieŋâpojijttáá|jieŋâpojijguin|jieŋâpaijeed|jieŋâpaj̣an|jieŋâpojij|jieŋâpaj̣e|jieŋâpaijeen|jieŋâpajeh|jieŋâpoojijd	<i>noun</i><br><ol><li>ice age</li></ol>
jieŋŋâl	<i>adj</i><br><ol><li>deep</li></ol>
jollâ	<i>adj</i><br><ol><li>crazy</li></ol>
judo|judoin|judoiguin|judost|judottáá|judoittáá|judoi|judon|judoh|judod|judoid	<i>noun</i><br><ol><li>judo</li></ol>
juonâ|juonáin|juoˈnâittáá|juonáid|juoˈnâttáá|juoˈnâi|juonâin|juonâst|juoˈnâiguin|juoṇâ|juonnâd|juoṇân|juonnân|juonah|juonâi|juonâid	<i>noun</i><br><ol><li>plot, scheme</li></ol>
juovlah	<i>noun</i><br><ol><li>Christmas</li></ol>
juovâ|juoˈvâi|juoˈvâttáá|juovâi|juovâid|juoˈvâittáá|juovâst|juováid|juovâin|juováin|juovvân|juovvâd|juoṿân|juoṿâ|juoˈvâiguin|juovah	<i>noun</i><br><ol><li>boulder</li></ol>
juoŋŋâđ|juoˈŋâččij|juoŋâi|juoŋâ|juoŋŋih|juoŋŋâv|juoˈŋâččijd|juoŋáid|juoŋŋâm|jyeŋˈŋeeh|juoˈŋâžává|juoŋˈŋii|juoŋŋim|juoŋŋâp|juáŋŋus|juoŋâm|juoŋâim|juoˈŋâžep|jyeŋˈŋeen|jyeŋˈŋee|jyeŋˈŋeem|juoˈŋâččáim|juoˈŋâžeen|juáŋˈŋoon|juáŋŋup|juáŋus|juoˈŋâččih|juoˈŋâččii|juáŋ̣á|juoŋah|juoˈŋâččim|juoŋâšvettee|juoŋâšvetteđ|juoŋii|jyeŋ̣ih|juoŋáin|juoŋáim|juoˈŋâččáid|juoˈŋ̣âvetteđ|juoŋâš|juoˈŋâžeh|juoˈŋâččáin|juoŋâid|juoˈŋâččijm|juoˈŋ̣âvettee	<i>verb</i><br><ol><li>to become leaky</li></ol>
jussâ	<i>noun</i><br><ol><li>fart</li></ol>
juuhâ|juuṿâ|juṿâittáá|juṿâttáá|juuṿâid|juuṿâst|juuṿâin|juvváid|juṿâiguin|juuḥân|juvváin|juṿâi|juuṿâi|juuṿah|juuhân|juuḥâd	<i>noun</i><br><ol><li>river</li></ol>
juuhâđ|juuḥâđ	<i>verb</i><br><ol><li>to drink</li></ol>
juurdâ|jurdui|jurduuttáá|jurduin|jurdust|jurduid|jurduuh|juurdân|jurduittáá|juurdâd|jurduiguin|jurduu	<i>noun</i><br><ol><li>thought</li></ol>
juurrâđ	<i>verb</i><br><ol><li>to turn, to rotate</li></ol>
juŋŋâ|juuŋáid|juŋâi|juuŋâ|juŋâttáá|juuŋâst|juuŋâin|juŋâittáá|juŋŋân|juŋŋâd|juŋâiguin|juuŋah|juuŋâid|juuŋâi|juuŋ̣ân|juuŋáin	<i>noun</i><br><ol><li>lingonberry</li></ol>
já	<i>conj</i><br><ol><li>and</li></ol>
jävri|jáávrán|jaṿij|jaaṿijn|jääṿih|javvijn|jäṿittáá|jävrin|jävrid|jääṿist|javvijd|jaṿijguin|jaaṿijd|jaṿijttáá|jaaṿij|jääṿi	<i>noun</i><br><ol><li>lake</li></ol>
jäävvil|jáhálijd|jáháláin|jáhálijguin|jáhálijttáá|jáhálij|jáhálist|jáhháálttáá|jáhálin|jáhálijn|jáhálid|jáhálân|jävilid|jävilin|jáháláid|jáháleh|jáhháál	<i>noun</i><br><ol><li>lichen</li></ol>
kaarrâđ|kaarâš|kaṛâvetteđ|kaarâi|kaarii|kärreem|kärreeh|kaarâid|kaarâm|kaarâim|kaarâšvetteđ|kaṛâvettee|kááṛá|karâččih|kärreen|karâžep|karâžeh|kaaraim|káárus|karâččáid|kárroon|kaarrâv|karâččijm|karâččii|karâččim|kaarah|kaarâ|karrii|kaaraid|karâččáin|karâžává|káárrus|káárrup|kääṛih|kaarrâp|kaarrih|karâččij|karâččijd|karâččáim|kaarain|kaarrâm|karâžeen|kaarâšvettee|kaarrim|kärree	<i>verb</i><br><ol><li>to secure, to tie down</li></ol>
kaasi|kaasijguin|kaasin|kaasih|kaasij|kaasid|kaasijttáá|kaasist|kaasijn|kaasijd|kaasittáá	<i>noun</i><br><ol><li>cat</li></ol>
kaasâ	<i>noun</i><br><ol><li>lamp oil</li><li>paraffin</li></ol>
kaavpug	<i>noun</i><br><ol><li>town, city</li></ol>
kakkârâs|kakkârâsân|kakkârâseh|kakkârâsist|kakkârâsijttáá|kakkârâsin|kakkârâsáin|kakkârâsáid|kakkârâsid|kakkârâsij|kakkârâsijguin|kakkârâsijn|kakkârâsttáá|kakkârâsijd	<i>noun</i><br><ol><li>red-throated diver, Gavia stellata</li></ol>
kalâččeijee|kalâččeijeittáá|kalâččeijed|kalâččeijeiguin|kalâččeijein|kalâččeijeettáá|kalâččeijen|kalâččeijei|kalâččeijeeh|kalâččeijest|kalâččeijeid	<i>noun</i><br><ol><li>wader (bird)</li></ol>
kalâččiđ	<i>verb</i><br><ol><li>to wade around, to paddle (leasurely)</li></ol>
kandâ|kandâittáá|kandain|kandâd|kandâttáá|kaandân|kaandâin|kandâiguin|kaandâid|kaandâi|kandâi|kaandâst|kandaid|kaandâ|kandân|kaandah	<i>noun</i><br><ol><li>boy</li><li>son</li></ol>
kannu|kaaṇu|kaaṇuid|kaaṇust|kaṇui|kaaṇun|kaaṇuin|kaṇuittáá|kannun|kannoin|kaṇuiguin|kaaṇuh|kaṇuttáá|kannud|kannoid|kaaṇui	<i>noun</i><br><ol><li>jug, pitcher</li></ol>
kaččâđ|káččá|kačâččih|kaččaim|kaččâvetteđ|kaačah|kačâččii|kaččâp|kaččâv|kačâžep|kaččaid|kačâččim|kaačâim|kaačâid|kačâččáim|kaačâm|kačâžeen|käččem|kaačâš|kaččâm|kaččâvettee|kačâččij|káččup|kááčus|káččus|kaččii|kačâččáin|kaačâšvetteđ|kaččih|kačâččáid|kaččim|kačâččijd|kaččain|käččeh|kačii|kaačâšvettee|kaačâ|käčče|käččih|käččen|káččon|kačâččijm|kaačâi|kačâžeh|kačâžává	<i>verb</i><br><ol><li>to run</li></ol>
keeči|keeji|keejist|keejijn|keejij|keeččin|keeččid|keijijd|kejijttáá|keejih|kiäčán|kejijguin|keejijd|kejij|keijijn|kejittáá	<i>noun</i><br><ol><li>tip, end</li></ol>
ketki|keeđhijd|keđhijguin|keđhij|keeđhij|keeđhist|keđhijttáá|keeđhih|keeđhijn|keđhijn|ketkin|keeđhi|keđhittáá|kiätkán|ketkid|keđhijd	<i>noun</i><br><ol><li>wolverine</li></ol>
keččâđ	<i>verb</i><br><ol><li>to look at</li><li>to herd, to tend (animals)</li></ol>
keđgi|keeđgist|keđgittáá|keđgijguin|keđgijn|keeđgij|kiäđgán|keđgid|keeđgi|keđgijd|keđgij|keđgin|keđgijttáá|keeđgijn|keeđgijd|keeđgih	<i>noun</i><br><ol><li>stone</li></ol>
keŋŋuru	<i>noun</i><br><ol><li>kangaroo</li></ol>
kiehâ|kieṿah|kievˈváid|kieˈṿâiguin|kiehân|kieˈṿâi|kieṿâi|kieṿâid|kieṿâst|kieṿâin|kieḥâd|kieˈṿâittáá|kieṿâ|kieˈṿâttáá|kieḥân|kievˈváin	<i>noun</i><br><ol><li>cuckoo, Cuculus canorus</li></ol>
kieldâ|kieˈldâittáá|kieldân|kielˈdáin|kieldâst|kieldâid|kielˈdâ|kieldâin|kielˈdâd|kieˈldâiguin|kielˈdân|kielˈdáid|kieldah|kieldâi|kieˈldâttáá|kieˈldâi	<i>noun</i><br><ol><li>municipality</li></ol>
kielâ|kielah|kieˈlâiguin|kieˈlâttáá|kiellân|kielâin|kieláin|kielâst|kieláid|kieḷâ|kieḷân|kielâi|kieˈlâi|kieˈlâittáá|kielâ|kiellâd|kielâid	<i>noun</i><br><ol><li>language</li><li>trap, snare</li></ol>
kiepâ|kieppui|kieppuiguin|kieppuittáá|kieppuuh|kieppust|kiepâd|kieppuid|kieppuuttáá|kieppuin|kiepân|kieppuu	<i>noun</i><br><ol><li>soot</li></ol>
kiessâđ|kieˈsâžává|kieˈsâžeh|kiessih|kieˈsâvetteđ|kiesˈsii|kiesâš|kieˈsâžep|kiäsá|kiesáim|kiäsˈsoon|kiesáid|kieˈsâččáim|kiesâ|kiessim|kiesâid|kiesâim|kieˈsâččim|kieˈsâžeen|kiesii|kiessâv|kieˈsâččij|kieˈsâvettee|kiesáin|kieˈsâččih|kiesah|kieˈsâččijm|kiesâi|kiesˈseen|kiesâšvettee|kieˈsâččáid|kiesˈseeh|kiessâp|kiesˈsee|kiesâšvetteđ|kiesih|kieˈsâččijd|kieˈsâččáin|kiessâm|kiässup|kiäsus|kieˈsâččii|kiesˈseem|kiässus|kiesâm	<i>verb</i><br><ol><li>to wrap</li></ol>
kietâ|kieđáid|kieˈđâiguin|kieˈđâttáá|kieˈđâi|kiettân|kieđâst|kieđâin|kieđáin|kieđâid|kieˈđâittáá|kiettâd|kieđâi|kietân|kieđâ|kieđah	<i>noun</i><br><ol><li>hand</li></ol>
kiihâđ|kiiḥâđ	<i>verb</i><br><ol><li>to lek</li></ol>
kiijkár|kiijkárij|kiijkárist|kiijkárijttáá|kiijkárijd|kiijkárijguin|kiijkárijn|kiijkárân|kiijkáreh|kiijkárid|kiijkáráid|kiijkárttáá|kiijkárin|kiijkáráin	<i>noun</i><br><ol><li>binoculars</li></ol>
kiintâl	<i>noun</i><br><ol><li>candle (a light source)</li></ol>
kirahvi|kirahvijd|kirahvin|kirahvijn|kirahvih|kirahvittáá|kirahvijguin|kirahvijttáá|kirahvist|kirahvid|kirahvij	<i>noun</i><br><ol><li>giraffe</li></ol>
kirje|kiiṛijd|kiṛeh|kirjen|kirreest|kirrijd|kiirján|kiṛijguin|kirrijn|kiiṛij|kiṛettáá|kiiṛijn|kiṛijttáá|kirjed|kiṛij|kiṛe	<i>noun</i><br><ol><li>book</li></ol>
kirječällee|kirječällest|kirječällei|kirječällein|kirječälleid|kirječälled|kirječälleittáá|kirječälleettáá|kirječälleiguin|kirječälleeh|kirječällen	<i>noun</i><br><ol><li>writer, one who writes books</li></ol>
kissá|kissáást|kisá|kisáiguin|kissáid|kiisán|kissán|kissáin|kisái|kissád|kisáh|kisáin|kisáttáá|kisáittáá	<i>noun</i><br><ol><li>cat</li></ol>
kivkked	<i>adv</i><br><ol><li>suddenly</li></ol>
kiärun|kiärrunttáá|kiärunân|kiärunijd|kiärunáid|kiärunij|kiärunist|kiäruneh|kiärunin|kiärunijguin|kiärrun|kiärunáin|kiärunijttáá|kiärunijn|kiärunid	<i>noun</i><br><ol><li>ptarmigan, Lagopus mutus.</li></ol>
kiđđâ|kiiđâ|kiiđâin|kiđđâd|kiiđáin|kiđâittáá|kiiđâid|kiđâi|kiiđâi|kiđâiguin|kiđđân|kiđâttáá|kiiđâst|kiiđáid|kiiđ̣ân|kiiđah	<i>noun</i><br><ol><li>spring (season)</li></ol>
kobbâ|kobbâd|koobâi|koobân|koobâst|koobâin|kobâittáá|koobâ|kobbáin|koobah|kobbân|kobbáid|kobâiguin|kobâi|kobâttáá|koobâid	<i>noun</i><br><ol><li>white reindeer with white hooves</li></ol>
koijâdiđ	<i>verb</i><br><ol><li>to ask</li></ol>
kokkâ|kokkáid|kokkâd|kokâttáá|kokkáin|kokâittáá|kookâin|kookân|kookâid|kokâiguin|kokkân|kookah|kookâ|kookâst|kokâi|kookâi	<i>noun</i><br><ol><li>cook</li></ol>
kolle|kullijd|kuḷijttáá|kullijn|koḷeh|koḷe|kuuḷij|kolled|kuḷij|kuuḷijd|kuḷijguin|kuuḷijn|koḷettáá|kolleest|kooḷán|kollen	<i>noun</i><br><ol><li>gold</li></ol>
konnâ|kooṇâi|koṇâi|kooṇâid|konnáin|koṇâttáá|koṇâittáá|kooṇah|kooṇân|konnân|konnáid|konnâd|koṇâiguin|kooṇâ|kooṇâin|kooṇâst	<i>noun</i><br><ol><li>lichen</li></ol>
kooccâđ	<i>verb</i><br><ol><li>to brake with the hand or foot</li></ol>
kope|kovettáá|kuvijttáá|koṿe|kovveen|koppeen|kopán|kove|kuvijguin|kooveest|kuuvij|kuuvijd|koppeed|kuuvijn|koṿán|kovveed|kuvij|koveh	<i>noun</i><br><ol><li>trench, pit</li></ol>
koppâ|koopân|koppân|koopâin|koppáid|koopâi|koppáin|koppâd|koopâ|koopâid|koopah|kopâittáá|kopâi|kopâiguin|kopâttáá|koopâst	<i>noun</i><br><ol><li>cup</li></ol>
koskâ|koskân|koskâttáá|kooskâst|kooskâin|koskáin|kooskah|koskáid|kooskâid|koskâiguin|kooskâ|koskâi|koskâittáá|koskâd|kooskân	<i>noun</i><br><ol><li>middle, center</li><li>distance, gap</li></ol>
koskâvuotâ|koskâvuođâ|koskâvuotân|koskâvuođâiguin|koskâvuođâi|koskâvuođâittáá|koskâvuođâttáá|koskâvuođâid|koskâvuođah|koskâvuottân|koskâvuođáin|koskâvuođâst|koskâvuottâd|koskâvuođáid|koskâvuođâin	<i>noun</i><br><ol><li>relationship</li></ol>
kottarâš|kottarijttáá|kottariist|kottarâžžân|kottarijguin|kottaráid|kottarâžân|kottarâžžâd|kottarijd|kottariih|kottariittáá|kottarii|kottarij|kottarijn	<i>noun</i><br><ol><li>starling</li></ol>
kove|kovettáá|kuvijttáá|kovveen|koṿán|kooveest|kuuvij|kuuvijd|koṿe|kuuvijn|kuvijguin|kovveed|kuvij|koveh	<i>noun</i><br><ol><li>image, picture</li></ol>
kovjâ|kovjân|koṿâttáá|kovváin|koṿâittáá|kooṿâst|koovjân|kooṿâin|kovjâd|kooṿâ|kovváid|koṿâi|koṿâiguin|kooṿâi|kooṿâid|kooṿah	<i>noun</i><br><ol><li>dust</li></ol>
koččâđ	<i>verb</i><br><ol><li>to fall, to drop</li></ol>
kukke	<i>adj</i><br><ol><li>long</li></ol>
kulluđ	<i>verb</i><br><ol><li>to be heard</li></ol>
kulmâ	<i>num</i><br><ol><li>three</li></ol>
kumppi|kuˈmpijttáá|kumppijn|kuumpijn|kuumpih|kumppin|kuumpi|kuumpin|kuumpijd|kuumpist|kuˈmpittáá|kuˈmpij|kuˈmpijguin|kuumpij|kumppijd|kumppid	<i>noun</i><br><ol><li>wolf</li></ol>
kunnâ|kunnâd|kunâiguin|kuunáin|kuunâi|kuunâ|kunâi|kuunâst|kuunâid|kuunáid|kuuṇân|kuunâin|kunâittáá|kuunah|kunâttáá|kunnân	<i>noun</i><br><ol><li>ash (residue from burning)</li></ol>
kunâgâs|kunâgâsâst|kunâgâssâd|kunâgâssân|kunâgâsttáá|kunâgâsâid|kunâgâsâiguin|kunâgâsân|kunâgâsâittáá|kunâgâsâin|kunâgâsâi|kunâgâssáin|kunâgâssáid|kunâgâsah	<i>noun</i><br><ol><li>king</li></ol>
kuobžâ|kuobˈžân|kuobžân|kuobˈžáin|kuobžâin|kuobžah|kuoˈbžâiguin|kuoˈbžâttáá|kuobˈžâd|kuobžâi|kuoˈbžâi|kuobˈžâ|kuobžâst|kuoˈbžâittáá|kuobˈžáid|kuobžâid	<i>noun</i><br><ol><li>bear</li></ol>
kuocâ|kuosâid|kuosâin|kuosáin|kuosah|kuoˈsâi|kuosáid|kuoˈsâiguin|kuoˈsâittáá|kuoˈsâttáá|kuoccâd|kuosâst|kuosâi|kuosâ|kuocân|kuoccân	<i>adj</i><br><ol><li>rotten</li></ol>
kuojâ|kuojâttáá|kuojân|kuojâiguin|kuojâid|kuojáid|kuojâin|kuojáin|kuojâi|kuojâst|kuojâd|kuojâittáá|kuojah|kuoj̣â	<i>noun</i><br><ol><li>sedge</li></ol>
kuosâ|kuosâid|kuosâin|kuosáin|kuosah|kuoˈsâi|kuosáid|kuoˈsâiguin|kuoˈsâittáá|kuoˈsâttáá|kuossân|kuosâst|kuosâi|kuossâd|kuosân	<i>noun</i><br><ol><li>spruce</li></ol>
kuovâmáánu|kuovâmánuiguin|kuovâmáánnun|kuovâmánuittáá|kuovâmáánuh|kuovâmáánun|kuovâmánui|kuovâmáánuid|kuovâmáánnud|kuovâmáánuin|kuovâmáánust|kuovâmánuttáá|kuovâmáánui	<i>noun</i><br><ol><li>February</li></ol>
kurrâ|kuurâ|kurâittáá|kurâi|kurâiguin|kuurâin|kuuráin|kuurâi|kurâttáá|kuuṛân|kurrân|kuuráid|kuurâid|kurrâd|kuurâst|kuurah	
kurtte|kuurtij|kuurtán|kurtted|kurteh|kurte|kurttijd|kurtij|kurttijn|kurtteest|kuurtijn|kurtijguin|kurtijttáá|kurtten|kurtettáá|kuurtijd	<i>noun</i><br><ol><li>neck flesh of an animal</li></ol>
kussâ|kuusah|kussâd|kuusâin|kuusâi|kuusân|kussáin|kusâiguin|kuusâst|kusâttáá|kussáid|kuusâid|kusâittáá|kuusâ|kussân|kusâi	<i>noun</i><br><ol><li>cow</li></ol>
kutkâ|kuđháin|kuđhâittáá|kuutkân|kuuđhâi|kuđhâi|kuuđhâin|kuđháid|kuuđhâid|kuuđhah|kuuđhâ|kutkâd|kuđhâiguin|kuuđhâst|kutkân|kuđhâttáá	<i>noun</i><br><ol><li>ant</li></ol>
kuttâ	<i>num</i><br><ol><li>six</li></ol>
kuullâđ	<i>verb</i><br><ol><li>to hear</li></ol>
kuurrâđ	<i>verb</i><br><ol><li>to tie closed</li></ol>
kuussâđ	<i>verb</i><br><ol><li>to cough</li></ol>
kuuđđâđ	<i>verb</i><br><ol><li>to spawn</li></ol>
kuálkki	<i>adj</i><br><ol><li>calm</li></ol>
kuálástiđ	<i>verb</i><br><ol><li>to fish</li></ol>
kuárŋuđ|kuárˈŋuđ	<i>verb</i><br><ol><li>to rise, climb</li></ol>
kuáskim|kuáskimáid|kuáskimijguin|kuáskimist|kuáskimeh|kuáskimid|kuáskimijttáá|kuáskimin|kuáskimijd|kuáskimijn|kuáskimij|kuáskimân|kuáskimttáá|kuásˈkim|kuáskimáin	<i>noun</i><br><ol><li>eagle</li></ol>
kuáti|kuáđih|kođij|kuáttid|kođijttáá|kuáđist|koođij|kuáˈđittáá|koođijn|kođijguin|kuáttin|kuátán|kuáđi|koođijd	<i>noun</i><br><ol><li>tent, hut</li></ol>
kuávžur|kuávžurijttáá|kuávžurân|kuávžuráid|kuávžurijd|kuávžurttáá|kuávžurid|kuávžuráin|kuávžureh|kuávžurist|kuávžurijguin|kuávžurin|kuávžurijn|kuávžurij	<i>noun</i><br><ol><li>trout, Salmo trutta</li></ol>
kužžâ|kužâittáá|kuužah|kužžáid|kuužâid|kuužâst|kužžáin|kužâttáá|kuužân|kuužâ|kuužâin|kužâiguin|kuužâi|kužžân|kužžâd|kužâi	<i>noun</i><br><ol><li>urine</li></ol>
kyehti	<i>num</i><br><ol><li>two</li></ol>
kyeimi|kyeimid|kyeimih|kuáimán|kyeimittáá|kuoimijguin|kuoimijttáá|kyeimist|kuoimij|kuoimijd|kuoimijn|kyeimin	<i>noun</i><br><ol><li>companion, partner, comrade</li></ol>
kyeimikoskâvuotâ|kyeimikoskâvuođâ|kyeimikoskâvuođâiguin|kyeimikoskâvuođáin|kyeimikoskâvuođâttáá|kyeimikoskâvuottân|kyeimikoskâvuotân|kyeimikoskâvuođah|kyeimikoskâvuođâst|kyeimikoskâvuođâin|kyeimikoskâvuottâd|kyeimikoskâvuođáid|kyeimikoskâvuođâi|kyeimikoskâvuođâid|kyeimikoskâvuođâittáá	<i>noun</i><br><ol><li>intimate relationship</li></ol>
kyeli|kyeˈle|kuáḷán|kuoˈlijguin|kyellid|kyeleest|kuolijd|kuolijn|kyeˈlettáá|kuoˈlij|kyeḷi|kyeˈleh|kuolij|kyellin|kuoˈlijttáá	<i>noun</i><br><ol><li>fish</li></ol>
kyemi|kyemmin|kuomijguin|kyemmid|kuomijn|kyeṃi|kyeme|kuáṃán|kuomijttáá|kyemeest|kuomijd|kyemettáá|kyemeh|kuomij	<i>noun</i><br><ol><li>palate</li></ol>
kyessi|kuossijn|kyesi|kyesih|kuossijd|kuosijn|kuosijd|kyessin|kyessid|kuosijguin|kuásán|kyesittáá|kyesˈsi|kuosijttáá|kyesist|kuosij	<i>noun</i><br><ol><li>guest</li></ol>
káigá|kááigáh|káigáid|kááigái|káigái|kááigá|káigáittáá|káigáttáá|kááigáid|káigáin|káigán|káigáiguin|kááigán|káigád|kááigáin|kááigást	<i>noun</i><br><ol><li>stupid person, fool, idiot, moron, dumbass</li></ol>
káránâs|káránâssâd|káránâssáid|káránâsah|káránâsâittáá|káránâsâiguin|káránâsâid|káránâsttáá|káránâsân|káránâsâst|káránâssân|káránâsâin|káránâssáin|káránâsâi	<i>noun</i><br><ol><li>raven</li></ol>
kähtee|kähteettáá|kähteeh|kähteittáá|kähteiguin|kähtest|kähtein|kähted|kähtei|kähten|kähteid	<i>noun</i><br><ol><li>red-throated diver, Gavia stellata</li></ol>
kähvi|kaahvij|kaahvijd|kähvid|käähvi|kááhván|kähvittáá|kahvijttáá|kahvijn|käähvist|kahvijd|käähvih|kähvin|kaahvijn|kahvijguin|kahvij	<i>noun</i><br><ol><li>coffee</li></ol>
kälbi|kaalbijn|kälbid|kalbij|kalbijd|käälbist|kälbittáá|kaalbij|käälbih|kalbijn|kalbijttáá|kälbin|kaalbijd|käälbi|káálbán|kalbijguin	<i>noun</i><br><ol><li>calf</li></ol>
käskee|käskest|käskeid|käskeeh|käskeiguin|käskein|käsken|käsked|käskeittáá|käskeettáá|käskei	<i>noun</i><br><ol><li>nettle</li></ol>
käskiđ	<i>verb</i><br><ol><li>to bite</li></ol>
käälliđ	<i>verb</i><br><ol><li>to wade</li></ol>
käärbis|kárbáttáá|kárbást|kárbáiguin|kárbás|kárbáid|kárbáittáá|kárbá|kárbáin|kärbisid|kárbái|kärbisin|kárbáh	<i>noun</i><br><ol><li>boat</li></ol>
käävci	<i>num</i><br><ol><li>eight</li></ol>
laahâ|laaṿâi|lavvain|laahân|laaḥâd|laṿâi|laṿâittáá|lavvaid|laaṿâ|laṿâiguin|laaṿâid|laaḥân|laaṿah|laaṿâin|laaṿâst|laṿâttáá	<i>noun</i><br><ol><li>law, act, statute</li></ol>
laasâ|lasâttáá|laasaid|laasain|laassâd|laasah|lasâiguin|laasâst|lasâittáá|laassân|laasâid|laasân|lasâi|laasâin|laasâi	<i>noun</i><br><ol><li>window</li><li>glass</li></ol>
lajo|laj̣on|laj̣o|laijoon|lajoh|lajoin|lajottáá|lajoid|lajoittáá|laijood|lajoi|laajoost|lajoiguin	<i>noun</i><br><ol><li>lead (metal)</li></ol>
lasa|lasaid|lasan|lasain|lasai|lasad|lasaittáá|lasaiguin|lasaast|lasah|lasattáá	<i>noun</i><br><ol><li>doorpost</li></ol>
lase|lasan|loosijn|loosij|laseh|losijttáá|laaseest|lasettáá|loosijd|losij|lasseen|losijguin|lasseed	<i>noun</i><br><ol><li>addition, increase</li></ol>
leibi|leibijguin|leibin|leeibijn|leeibijd|leibijttáá|leibijn|leeibih|leibij|leeibist|leibittáá|liäibán|leibijd|leibid|leeibi|leeibij	<i>noun</i><br><ol><li>bread</li></ol>
lekkâ|leehâid|lehâttáá|lehâi|leekân|lehháid|lehháin|lekkâd|leehah|lehâiguin|leehâst|leehâi|leehâin|leehâ|lehâittáá|lekkân	<i>noun</i><br><ol><li>ink</li></ol>
leđe	<i>verb</i><br><ol><li>to be</li></ol>
lieđikovjâ|lieđikoovjân|lieđikoṿâttáá|lieđikooṿah|lieđikooṿâst|lieđikovváid|lieđikovjâd|lieđikoṿâi|lieđikooṿâid|lieđikovváin|lieđikoṿâiguin|lieđikoṿâittáá|lieđikovjân|lieđikooṿâi|lieđikooṿâ|lieđikooṿâin	<i>noun</i><br><ol><li>pollen</li></ol>
lijmá|lijjáid|liijmán|lijjáin|liij̣áid|lij̣áttáá|lijmád|liij̣áh|liij̣áin|lij̣áittáá|lij̣ái|liij̣ái|liij̣ást|lij̣áiguin|liij̣á|lijmán	<i>noun</i><br><ol><li>glue</li></ol>
lodde|luddijn|loodán|luudijn|lodeh|lode|luddijd|ludijguin|loddeest|luudij|ludij|lodettáá|ludijttáá|luudijd|lodden|lodded	<i>noun</i><br><ol><li>bird</li></ol>
lonnjâ|lonjâiguin|lonjáid|loonjâin|lonjáin|loonjah|lonnjâd|loonjâst|lonjâttáá|loonjâid|lonjâittáá|loonjâi|lonnjân|lonjâi|looṇjân|loonjâ	
loommâđ	<i>verb</i><br><ol><li>to hide, to lurk</li></ol>
lope|loppeen|looveest|luuvijn|love|lopán|luvijguin|lovettáá|luuvij|luvijttáá|luvij|luuvijd|loppeed|loveh	<i>noun</i><br><ol><li>promise</li></ol>
lopediđ	<i>verb</i><br><ol><li>to promise</li></ol>
loppâ|loopâin|lopâi|loopâid|loopâi|loppáid|loppân|loppáin|lopâittáá|lopâiguin|lopâttáá|loopah|loppâd|loopâst|loopâ|loopân	<i>noun</i><br><ol><li>end</li></ol>
love	<i>num</i><br><ol><li>ten</li></ol>
lukkâ|luuhah|luhâiguin|luhâttáá|luhháid|luuhâin|luuhâ|lukkâ|lukkân|luukân|luhháin|lukkâd|luuhâid|luhâi|luuhâst|luuhâi|luhâittáá	<i>noun</i><br><ol><li>lock</li></ol>
lummo|lummoost|lumoittáá|lummoin|lumoin|lumoiguin|lummod|lumottáá|lumoi|luumon|lumo|lumoh|lummon|lummoid	<i>noun</i><br><ol><li>pocket</li></ol>
luokâ|luokáin|luokâiguin|luokah|luokâin|luokâid|luokâi|luokâst|luokân|luokâd|luokâittáá|luokáid|luokâttáá	<i>noun</i><br><ol><li>shaft bow</li></ol>
luosâ|luosâid|luosáid|luoˈsâi|luosâin|luosân|luoˈsâittáá|luossân|luosâi|luosáin|luossâd|luoˈsâiguin|luoˈsâttáá|luosah|luosâst	<i>noun</i><br><ol><li>salmon</li></ol>
luođâ|luođâid|luođ̣â|luođâst|luođđâd|luođâin|luođáin|luoˈđâi|luoˈđâttáá|luoˈđâittáá|luođđân|luoˈđâiguin|luođâi|luođ̣ân|luođáid|luođah	<i>noun</i><br><ol><li>ball</li><li>weight, plummet</li></ol>
lussâd	<i>adj</i><br><ol><li>heavy</li></ol>
luuhâđ|luuḥâđ	<i>verb</i><br><ol><li>to read</li><li>to count</li></ol>
luvdá|luuvdái|luuvdáin|luuvdást|luuvdán|luvdáin|luvdáittáá|luvdáid|luuvdá|luuvdáid|luvdán|luvdád|luvdáiguin|luuvdáh|luvdáttáá|luvdái	<i>noun</i><br><ol><li>broom</li></ol>
luákká|luáháin|luáháid|luáhást|luákˈkád|luáhˈháid|luáháh|luákˈká|luáhái|luáhá|luáˈháiguin|luáhˈháin|luáˈháttáá|luákˈkán|luáˈhái|luákán|luáˈháittáá	<i>noun</i><br><ol><li>slope</li><li>grade</li></ol>
luččâ|luujáid|luujáin|lujâiguin|luujâi|lujâttáá|luujâ|luujâst|lujâi|luččân|luujâid|luujah|lujâittáá|luučân|luujâin|luččâd	<i>noun</i><br><ol><li>diarrhea</li></ol>
lyeme|luámánid|luámánân|luámáneh|luámánijguin|lyemeen|luámánáin|lyeˈme|luámánijttáá|luámánin|luámánij|luámmán|luámánist|luámmánttáá|luámánáid|luámánijn|luámánijd|lyemeed	<i>noun</i><br><ol><li>cloudberry, Rubus chamaemorus</li></ol>
lyepi|luovijd|lyeve|luovijn|lyevettáá|luápán|lyeppid|lyeveest|lyeppin|luovijttáá|lyeveh|luovijguin|luovij	<i>noun</i><br><ol><li>shoulder of an animal</li></ol>
lággá|láágáh|láágáin|láágán|lágáittáá|lággád|lágáiguin|lággáid|lággáin|láágást|láágá|láágáid|lágáttáá|lágái|lággán|láágái	<i>noun</i><br><ol><li>small intestine</li></ol>
lääbis|lábbá|lábbáittáá|lábbáiguin|lábbáh|lábbái|lábbáid|lábbáttáá|lábáttáá|läbisin|läbisid|lábbás|lábbást|lábbáin	<i>noun</i><br><ol><li>lamb</li></ol>
maahâ|maaṿâi|maaṿah|maṿâttáá|maahân|maaṿâst|maaṿâin|maṿâiguin|maaṿâ|mavvaid|maaḥâd|mavvain|maaṿâid|maṿâittáá|maaḥân|maṿâi	<i>noun</i><br><ol><li>brother-in-law</li></ol>
maailm|maailmân|maailmin|maailmijn|maailmijguin|maailmij|maailmáin|maailmijttáá|maailmeh|maailmáid|maailmid|maailmttáá|maailmijd|maailmist	<i>noun</i><br><ol><li>world</li></ol>
maaššâđ	<i>verb</i><br><ol><li>to have patience (to do something)</li></ol>
maccâđ|maccâv|maccim|maccâvetteđ|macâččii|macâččij|macâččáid|macâččijd|maccâvettee|maccii|maacâš|maacâšvetteđ|máccá|macâžává|máccus|macâččijm|máccon|máácus|máccup|macâččáin|mäccih|macâžeen|maccaim|maccâm|mäcceh|maccain|macâččih|maacâm|macâččáim|maccâp|macâžep|maacâšvettee|macâžeh|maccaid|mäccen|macâččim|macii|mäccem|mäcce|maacâim|maacâi|maacah|maacâid|maccih|maacâ	<i>verb</i><br><ol><li>to return, to come back</li></ol>
mane|maṇan|moonijd|maaneest|manneen|manneed|monijguin|moonijn|moonij|maṇe|monij|monijttáá|manettáá|maneh	<i>noun</i><br><ol><li>egg</li></ol>
manje|maṇje	<i>noun</i><br><ol><li>daughter-in-law</li></ol>
meerâ|meeráid|meerâin|meeṛân|merâttáá|meeṛâ|meerrân|merâittáá|meerrâd|merâiguin|meerâst|meerah|meeráin|meerâi|meerâid|merâi	<i>noun</i><br><ol><li>sea</li></ol>
merâkuáskim|merâkuáskimijguin|merâkuáskimijn|merâkuáskimáin|merâkuáskimân|merâkuáskimttáá|merâkuáskimijd|merâkuáskimáid|merâkuáskimij|merâkuáskimin|merâkuáskimid|merâkuáskimijttáá|merâkuáskimeh|merâkuáskimist	<i>noun</i><br><ol><li>white-tailed eagle</li></ol>
miekki|miekˈkin|miehist|miehˈhijn|mieˈhijttáá|miäkán|miekˈki|mieˈhij|miehijn|mieˈhittáá|miehij|miehˈhijd|miehi|miehijd|mieˈhijguin|miehih|miekˈkid	<i>noun</i><br><ol><li>sword</li></ol>
mielkki|mielhijd|mielˈkkid|mielhij|mielhijn|mieˈlhijguin|mieˈlhijttáá|mielˈhijn|mielhi|mielˈhijd|mielˈkkin|mieˈlhittáá|mielˈkki|mieˈlhij|miälkán|mielhist|mielhih	<i>noun</i><br><ol><li>milk</li></ol>
mielâ|mielâst|mielâin|mielâttáá|mielâi|mieláin|mielâid|mielah|mieláid|mielâittáá|mielân|mielâiguin|mielâd|mieḷâ	<i>noun</i><br><ol><li>mind</li></ol>
mietipieggâ|mietipiegˈgáin|mietipiegah|mietipiegân|mietipiegâin|mietipiegâst|mietipiegˈgân|mietipieˈgâittáá|mietipiegˈgáid|mietipieˈgâttáá|mietipieˈgâiguin|mietipiegˈgâd|mietipieˈgâi|mietipiegˈgâ|mietipiegâid|mietipiegâi|mietipiegâ	<i>noun</i><br><ol><li>tailwind</li></ol>
mietâ|mieˈđâttáá|mietân|mieđâst|miettân|mieđâi|mieđáid|mieˈđâittáá|mieđâin|mieđâ|miettâd|mieđáin|mieđâid|mieˈđâiguin|mieđah|mieˈđâi	<i>noun</i><br><ol><li>honey</li></ol>
millo|milo|milloost|milloid|miloiguin|miloh|miilon|millon|miloittáá|miloi|milottáá|millod|milloin|miloin	<i>noun</i><br><ol><li>mill</li></ol>
minister|ministerttáá|ministerijttáá|ministeráid|ministerin|ministerijguin|ministerid|ministeráin|ministereh|ministerijn|ministerijd|ministerân|ministerist|ministerij	<i>noun</i><br><ol><li>minister (politician)</li></ol>
mirkkâ|mirhâttáá|miirhâi|mirhâiguin|mirkkâd|mirháid|miirhâ|miirhâid|miirhah|mirháin|mirkkân|miirhâin|miirhâst|mirhâittáá|mirhâi|miirkân	<i>noun</i><br><ol><li>poison</li></ol>
mittediđ	<i>verb</i><br><ol><li>(transitive) to measure</li></ol>
mitto|mito|mitoi|mitoiguin|mitoittáá|mittod|mitottáá|mittoost|mitoin|mitton|mittoid|miiton|mittoin|mitoh	<i>noun</i><br><ol><li>measure</li></ol>
miähástâh|miähástuvâin|miähástâhhân|miähástuvah|miähástâhhâd|miähástuvâiguin|miähástâhân|miähástuv|miähástuvâst|miähástuvâid|miähástuvttáá|miähástuvâi|miäˈhástâh|miähástuvâittáá|miähástuvváin|miähástuvváid	<i>noun</i><br><ol><li>common snipe</li></ol>
miärkká|miärˈkká|miärháh|miärhá|miärkkán|miärháiguin|miärháittáá|miärkkád|miärháid|miärkán|miärhái|miärháin|miärhást|miärháttáá	<i>noun</i><br><ol><li>fog, mist</li></ol>
miästáđ|miäsˈtáđ	<i>verb</i><br><ol><li>to decapitate</li><li>to execute</li></ol>
miäštár|miäštárin|miäštárân|miäšˈtár|miäštárij|miäštáráin|miäštárid|miäštáráid|miäštárijd|miäštárijn|miäštárttáá|miäštárist|miäštáreh|miäštárijttáá|miäštárijguin	<i>noun</i><br><ol><li>master</li></ol>
mokke|muuhijd|muhij|mohheest|moheh|muhhijd|mookán|muhhijn|mohettáá|muuhijn|mokked|muhijttáá|mokken|mohe|muuhij|muhijguin	<i>noun</i><br><ol><li>bend, curve</li><li>trip, journey</li></ol>
mollâ|moolah|mollâd|molâiguin|moolâid|molâttáá|molâittáá|mooláid|mooḷân|moolâin|mooláin|mollân|moolâ|moolâst|molâi|moolâi	<i>noun</i><br><ol><li>target</li></ol>
moonnâđ	<i>verb</i><br><ol><li>to go</li></ol>
mote|muđijguin|muuđijd|mođeh|motteed|motán|motteen|muđij|moođeest|mođe|muuđijn|mođettáá|muuđij|muđijttáá	<i>noun</i><br><ol><li>mud</li></ol>
mun	<i>pron</i><br><ol><li>I</li></ol>
muorâ|muoˈrâittáá|muoṛâ|muoˈrâttáá|muorrâd|muorâi|muorâin|muoˈrâiguin|muoṛân|muorâst|muorrân|muorâid|muoˈrâi|muoráin|muoráid|muorah	<i>noun</i><br><ol><li>tree</li></ol>
muullađ	<i>verb</i><br><ol><li>to pass (someone) without noticing them</li></ol>
myerji|muorˈrijn|myeˈṛittáá|myeṛi|muoṛij|myerˈji|muoˈṛijttáá|muoṛijd|myeṛih|muoṛijn|muorˈrijd|myerˈjid|muoˈṛij|myerˈjin|muoˈṛijguin|muárján|myeṛist	<i>noun</i><br><ol><li>berry</li></ol>
myettiđ|myetˈtiđ	<i>verb</i><br><ol><li>to snow</li></ol>
máánu|mánuiguin|mánuttáá|mánuittáá|mánui|máánnud|máánui|máánust|máánuin|máánnun|mááṇu|máánuh|mááṇun|máánuid	<i>noun</i><br><ol><li>moon</li><li>month</li></ol>
máátu|mátuittáá|máttuh|máttoid|mátuttáá|máttud|máátust|máátun|mátui|máttun|máátuin|máttu|mátuiguin|máttoin|máttuid	<i>noun</i><br><ol><li>worm</li></ol>
määli|määḷi	<i>noun</i><br><ol><li>soup</li></ol>
naa	<i>intj</i><br><ol><li>yes</li></ol>
naallâđ|naalâid|nalâččih|nalâččii|nalâččijm|nalâččáim|naalaid|nalâččáin|naalâšvettee|nalâžeh|naalah|náállus|naalâi|naalii|naallâp|náállup|nalâččim|nääḷih|nááḷá|naallih|nalâžeen|nalâžává|nalâččijd|naalâš|naallim|naḷâvettee|nálloon|naalâm|naalâ|nalâččij|nälleen|nällee|náálus|naḷâvetteđ|nalâččáid|nallii|nälleeh|naallâv|naalâšvetteđ|naallâm|naalain|naalâim|nälleem|nalâžep|naalaim	<i>verb</i><br><ol><li>to cut off a reindeer's antlers</li></ol>
nabdeđ	<i>verb</i><br><ol><li>to name</li></ol>
nanos	<i>adj</i><br><ol><li>strong</li></ol>
neeti	<i>noun</i><br><ol><li>pine marten, Martes martes</li><li>marten in general, any species of Martes</li></ol>
nelgi|nelgijd|nelgijttáá|nelgid|neelgih|nelgij|neelgist|nelgittáá|neelgi|niälgán|nelgijguin|nelgijn|neelgij|nelgin|neelgijn|neelgijd	<i>noun</i><br><ol><li>hunger</li></ol>
nelji	<i>num</i><br><ol><li>four</li></ol>
nieidâ|nieidâst|nieidâid|nieˈidâiguin|nieˈidâttáá|nieˈidâittáá|nieidân|nieiˈdâd|nieiˈdân|nieidâi|nieiˈdâ|nieiˈdáid|nieiˈdáin|nieidah|nieˈidâi|nieidâin	<i>noun</i><br><ol><li>girl</li></ol>
nierâ|nierâi|nierâid|nierâst|nieˈrâttáá|nieráid|nieráin|nieˈrâiguin|nierrân|nierrâd|nieṛân|nieˈrâi|nieṛâ|nierâin|nierah|nieˈrâittáá	<i>noun</i><br><ol><li>cheek</li></ol>
nievdâđ|nievˈdâđ	<i>verb</i><br><ol><li>to dream</li></ol>
nijtto	<i>noun</i><br><ol><li>meadow</li></ol>
nissoon|nisonin|nisonijd|nisonijguin|nissoonttáá|nisonáid|nisonijn|nisoneh|nisonij|nisonist|nisonid|nisonijttáá|nisonáin|nisonân	<i>noun</i><br><ol><li>woman</li></ol>
njaahâđ|njaaḥâđ	<i>verb</i><br><ol><li>to sneak, to creep</li></ol>
njaalâ|njaalaid|njalâttáá|njalâiguin|njaallân|njaalain|njaaḷâ|njaallâd|njalâi|njaalah|njaalâi|njaalâin|njaalâst|njaalâid|njalâittáá|njaaḷân	<i>noun</i><br><ol><li>arctic fox</li></ol>
njiellâđ|njielâ|njiellâv|njielˈleeh|njielâš|njieˈlâččijd|njieˈlâččii|njieˈlâččim|njieḷih|njieˈlâžep|njieˈlâžeh|njieláin|njiälus|njieˈlâččáin|njielˈlee|njiellim|njieˈlâččáid|njiellâm|njielii|njieláim|njielˈleem|njieˈlâččáim|njieláid|njielˈlii|njielâi|njieˈlâččijm|njieˈḷâvettee|njielah|njiäḷá|njiällup|njielâim|njielâid|njieˈlâžeen|njiellâp|njielâšvetteđ|njiälˈloon|njiällus|njieˈlâččij|njielâšvettee|njieˈlâččih|njielâm|njieˈlâžává|njieˈḷâvetteđ|njielˈleen|njiellih	<i>verb</i><br><ol><li>to swallow</li></ol>
njihânjâš|njihânjâššáin|njihânjâššân|njihânjâšâiguin|njihânjâššâd|njihânjâšâid|njihânjâšah|njihânjâššáid|njihânjâšân|njihânjâšâin|njihânjâšâittáá|njihânjâšâi|njihânjâšttáá|njihânjâšâst	<i>noun</i><br><ol><li>hiccup</li></ol>
njirro	<i>noun</i><br><ol><li>female reindeer calf</li></ol>
njollâ|njooḷâin|njoḷâi|njooḷâid|njoḷâttáá|njollâd|njoḷâiguin|njooḷâ|njoḷâittáá|njollân|njooḷân|njooḷah|njolláid|njolláin|njooḷâi|njooḷâst	
njoollâđ	<i>verb</i><br><ol><li>to recede</li><li>to fall off</li></ol>
njoommâđ	<i>verb</i><br><ol><li>to suck</li></ol>
njuhčâ|njuvčâi|njuvččáin|njuuvčah|njuuvčâ|njuvčâiguin|njuhčân|njuuvčâin|njuhčâd|njuuvčâid|njuuvčâi|njuuvčâst|njuvčâittáá|njuvččáid|njuuhčân|njuvčâttáá	<i>noun</i><br><ol><li>swan</li></ol>
njuhčâmáánu|njuhčâmáánui|njuhčâmánuittáá|njuhčâmáánnun|njuhčâmánuttáá|njuhčâmánui|njuhčâmáánun|njuhčâmáánuin|njuhčâmáánuh|njuhčâmáánnud|njuhčâmánuiguin|njuhčâmáánuid|njuhčâmáánust	<i>noun</i><br><ol><li>March</li></ol>
njulččel	<i>adj</i><br><ol><li>slimy</li></ol>
njune|njuṇe|njunijguin|njunijttáá|njuunijn|njuunij|njunneed|njunettáá|njunij|njunneen|njuṇán|njuneh|njuunijd|njuuneest	<i>noun</i><br><ol><li>nose</li><li>snout</li></ol>
njuolâ|njuolâst|njuollân|njuolah|njuolâi|njuoláin|njuolâin|njuolâid|njuoˈlâittáá|njuoˈlâiguin|njuoˈlâi|njuoḷâ|njuoḷân|njuollâd|njuoˈlâttáá|njuoláid	<i>noun</i><br><ol><li>arrow</li></ol>
njuovvâđ|njuoˈvâččijd|njuovâid|njuoˈvâččim|njuávvup|njuoˈvâččij|njuovâšvettee|njuoˈṿâvettee|njyevˈveem|njuoˈvâžep|njuovâš|njuovii|njuávˈvoon|njuováid|njuovâšvetteđ|njuáṿá|njyevˈveeh|njuováin|njuovvâm|njuoˈvâččáin|njyevˈvee|njyeṿih|njuoˈvâččii|njuávus|njuovah|njuovvâv|njuoˈvâččijm|njuovâi|njuovvih|njuoˈvâžeh|njuovâim|njuovâ|njuoˈṿâvetteđ|njuoˈvâččih|njuovˈvii|njuovvim|njuováim|njuovvâp|njyevˈveen|njuoˈvâččáim|njuovâm|njuávvus|njuoˈvâžává|njuoˈvâččáid|njuoˈvâžeen	<i>verb</i><br><ol><li>to skin</li></ol>
njuáci	<i>adj</i><br><ol><li>slow</li></ol>
njuálluđ	<i>verb</i><br><ol><li>to lick</li></ol>
njuámmil|njuámmilijttáá|njuámmilijn|njuámmilijd|njuámmilist|njuámmilij|njuámmiláid|njuámmilin|njuámmiláin|njuámmilttáá|njuámmilid|njuámmilijguin|njuámmileh|njuámmilân	<i>noun</i><br><ol><li>hare</li></ol>
njuárustiđ|njuáˈrustiđ	<i>verb</i><br><ol><li>to throw a lasso</li><li>to catch (reindeer) with a lasso</li></ol>
njuáržu|njuárˈžun|njuárˈžoin|njuáˈržuttáá|njuáržun|njuárˈžud|njuáržuh|njuáržust|njuáˈržuittáá|njuáˈržui|njuárˈžu|njuáržuin|njuáržuid|njuáržui|njuáˈržuiguin|njuárˈžoid	<i>noun</i><br><ol><li>campfire, open fire</li></ol>
njälmi|njallijn|njaaḷijn|njälmin|njaḷijttáá|njaḷij|njääḷih|njaaḷijd|njääḷi|njaaḷij|njääḷist|njälmid|njaḷijguin|njäḷittáá|njáálmán|njallijd	<i>noun</i><br><ol><li>mouth</li></ol>
njäähi|njääṿist|njääṿih|njaaṿijd|njaṿij|njavvijn|njaṿijttáá|njavvijd|njääḥid|njaaṿij|njaaṿijn|njááhán|njääṿi|njääḥin|njäṿittáá|njaṿijguin	<i>noun</i><br><ol><li>burbot</li></ol>
nohádiđ	<i>verb</i><br><ol><li>to fall asleep</li></ol>
nommâ|nommân|nomâittáá|nomâttáá|nomâi|noomáid|noomâid|noomáin|nomâiguin|noomâi|nommâd|nooṃân|noomâ|noomâst|noomah|noomâin	<i>noun</i><br><ol><li>name</li></ol>
nukkâđ	<i>verb</i><br><ol><li>to doze off</li></ol>
nuollâđ|nuolâid|nuoˈlâččijd|nyeḷih|nuoláid|nuoˈlâžeen|nyelˈlee|nuoˈlâžeh|nuoláim|nuoˈlâččáin|nuolâm|nuolâi|nuolâšvetteđ|nuolii|nuolah|nuoˈlâžep|nuoˈlâččii|nuolˈlii|nuollâv|nuoˈḷâvettee|nuolâim|nuálus|nuoˈlâččij|nyelˈleen|nuoˈlâččijm|nyelˈleem|nuolâš|nuollâp|nuoláin|nyelˈleeh|nuoˈlâžává|nuollih|nuolâ|nuolâšvettee|nuoˈlâččáid|nuoˈḷâvetteđ|nuállus|nuáḷá|nuollâm|nuollim|nuoˈlâččih|nuoˈlâččáim|nuálˈloon|nuoˈlâččim|nuállup	<i>verb</i><br><ol><li>to take off (clothes)</li><li>to unwrap</li><li>to untie</li></ol>
nuuhâđ|nuuḥâđ	<i>verb</i><br><ol><li>to end, to come to an end, to finish</li><li>to expire</li></ol>
ohtâ	<i>num</i><br><ol><li>one</li></ol>
okko|ohoin|ohoi|ohoiguin|ohhoid|ohoid|ohoittáá|okkod|ookon|ohhoin|oho|ohoh|ohottáá|okkon|ohhoost	<i>noun</i><br><ol><li>week</li></ol>
ollâopâttâh|ollâopâttuvâin|ollâopâttuv|ollâopâttuvâittáá|ollâopâttâhhâd|ollâopâttâhân|ollâopâttuvâiguin|ollâopâttuvâi|ollâopâttâhhân|ollâopâttuvâid|ollâopâttuvváin|ollâopâttuvttáá|ollâopâttuvâst|ollâopâttuvah|ollâopâttuvváid	<i>noun</i><br><ol><li>university</li></ol>
olmooš|ulmuuh|ulmuu|olmožid|ulmuittáá|ulmui|ulmust|ulmuin|ulmuiguin|ulmuid|olmožin|ulmuuttáá	<i>noun</i><br><ol><li>human</li></ol>
onne	<i>adv</i><br><ol><li>today</li></ol>
oovce	<i>num</i><br><ol><li>nine</li></ol>
oppeet	<i>adv</i><br><ol><li>again</li></ol>
oppuu|oppuuttáá|oppun|oppuiguin|oppuittáá|oppust|oppuid|oppud|oppuuh|oppui|oppuin	<i>noun</i><br><ol><li>eagle owl</li></ol>
oppâ|oopâid|oppân|oopâi|oopân|opâi|oopâin|oopah|oopâst|oppâd|oppáid|opâittáá|oppáin|opâttáá|opâiguin|oopâ	<i>noun</i><br><ol><li>higher education</li><li>study</li></ol>
oppâđ	<i>verb</i><br><ol><li>to learn</li></ol>
opâttâh|opâttâhhân|opâttâhân|opâttâhhâd|opâttuvâi|opâttuvváin|opâttuvâst|opâttuvâid|opâttuvah|opâttuvâiguin|opâttuvâittáá|opâttuvttáá|opâttuvâin|opâttuvváid|opâttuv	<i>noun</i><br><ol><li>educational institute</li></ol>
orrâ|orrân|ooráid|orâi|orâiguin|orâttáá|oorâst|oorâid|orâittáá|oorâin|oorah|orrâd|oorâi|ooṛân|oorâ|ooráin	<i>noun</i><br><ol><li>line, rope</li></ol>
paaijâđ|pajâččijd|paajain|päijeen|päijeeh|paaijih|paajâim|páijoon|paaijâp|paj̣âvetteđ|paaijâv|paajaim|pajâžeen|pajâččáin|pajâččih|päijee|pááj̣á|paajâid|paajâš|páájus|paaijim|paj̣âvettee|paajâšvettee|pajâžeh|paajii|paajâi|paajaid|paajah|paajâm|pajâžává|pajâččim|pajâččijm|pajâžep|pajâččii|paajâšvetteđ|päijeem|pajâččij|paajâ|pajâččáim|pääj̣ih|paijii|pááijus|paaijâm|pááijup|pajâččáid	
paajâ|paajâst|paajâin|paajáin|pajâiguin|paajâi|paajáid|pajâi|pajâttáá|paajah|pajâittáá|paaijâd|paaj̣â|paaijân|paajâid|paajân	
paarâ|paarrâst|paarâin|paarrâd|paarah|paarâid|parâi|paaṛâ|paaráin|parâittáá|parâttáá|parâiguin|paaráid|paarân	<i>noun</i><br><ol><li>couple, pair</li></ol>
paccâđ|päcce|päccem|páccá|pacâččijm|paccain|paccaid|pacâččáin|pacâččijd|paacah|paacâ|paccâm|paccâvettee|paccih|päcceh|pacâččáid|páácus|paacâšvettee|pacâččih|pacâžep|paacâšvetteđ|páccus|paccâvetteđ|paccaim|paacâim|paacâm|pacii|paccim|páccup|paacâš|päccen|paccâp|paccii|pacâččii|pacâžává|paacâid|paccâv|pacâžeen|pacâččij|paacâi|páccon|pacâžeh|päccih|pacâččim|pacâččáim	<i>verb</i><br><ol><li>to go off, to spring (of a mechanism)</li></ol>
paje|pojijguin|poojijn|paajeest|pojijttáá|pajeh|poojij|paj̣an|paijeen|poojijd|paj̣e|paijeed|pajettáá|pojij	<i>noun</i><br><ol><li>period (of time)</li><li>age, era</li></ol>
pappâ|paapah|pappain|pappâd|pappân|paapâ|papâttáá|paapâst|papâittáá|papâi|papâiguin|paapâid|paapân|paapâin|paapâi|pappaid	<i>noun</i><br><ol><li>priest</li></ol>
pargo|paˈrgottáá|paargon|pargoid|pargon|pargoost|paˈrgoi|pargod|pargoin|paˈrgoh|paˈrgo|pargoiguin|pargoittáá	<i>noun</i><br><ol><li>act, deed</li><li>work</li><li>labour</li></ol>
parâkoskâvuotâ|parâkoskâvuotân|parâkoskâvuođâittáá|parâkoskâvuođáin|parâkoskâvuođâ|parâkoskâvuottân|parâkoskâvuottâd|parâkoskâvuođah|parâkoskâvuođâi|parâkoskâvuođâst|parâkoskâvuođáid|parâkoskâvuođâin|parâkoskâvuođâiguin|parâkoskâvuođâid|parâkoskâvuođâttáá	<i>noun</i><br><ol><li>intimate relationship</li></ol>
peeci|peesi|peesist|peeccid|pessijd|peesijn|pesij|peesih|pesijttáá|peesijd|pessijn|peesij|piäcán|peeccin|pesijguin|pesittáá	<i>noun</i><br><ol><li>pine</li></ol>
peenuv|pennuuh|penuvin|penuvid|pennuittáá|pennuuttáá|pennui|pennuu|pennust|pennuiguin|pennuid|pennuin	<i>noun</i><br><ol><li>dog</li></ol>
peerâ|perruin|perruittáá|perruu|perruiguin|perruuttáá|perruuh|perrust|peerân|peerâd|perruid|perrui	<i>noun</i><br><ol><li>family</li></ol>
peessâđ|peesáid|peesâid|pesâččijd|pesâččij|peessâv|peessâp|piäsus|peesah|pesâččáim|pesâččijm|pesâččáin|piässus|peesâm|peesâ|pessii|piäsˈsoon|peesii|pesâvettee|piässup|pesâččáid|pesseen|pesâžává|pesâžep|peesâšvetteđ|peesâi|pesseeh|pesâžeh|pesâččih|peesâšvettee|piäsá|pesâžeen|peesâš|peesáin|peesih|peessâm|pessee|peessih|peesâim|pesâččim|peessim|peesáim|pesseem|pesâvetteđ|pesâččii	
pieggâ|piegah|piegâ|piegâi|pieˈgâttáá|piegˈgân|piegâst|piegâid|piegân|pieˈgâittáá|pieˈgâi|piegˈgáid|piegˈgâ|piegˈgâd|pieˈgâiguin|piegâin|piegˈgáin	<i>noun</i><br><ol><li>wind</li><li>draft (of air)</li></ol>
piehâin|piehânjeh|piehânjijttáá|piehânjáid|piehânjist|piehânjij|piehânjân|piehânjijn|piehânjijd|piehânjin|piehâinttáá|piehânjid|piehânjáin|piehânjijguin	<i>noun</i><br><ol><li>rough-legged buzzard, Buteo lagopus</li></ol>
pieijâđ|piejâm|pieijâm|pieijâv|piejah|piejâšvetteđ|piäiˈjoon|piejáin|piejâid|pieˈjâžep|piäijus|pieiˈjeem|pieˈj̣âvettee|pieijih|piejâ|pieˈjâžeen|pieiˈjeen|piejáim|pieˈjâččáim|piäj̣á|pieijim|pieˈj̣âvetteđ|piejii|piejáid|pieijâp|pieiˈjii|piejâš|piej̣ih|pieˈjâččim|pieˈjâččijm|piäjus|pieˈjâččii|pieˈjâččijd|pieiˈjeeh|piejâi|piäijup|pieˈjâččij|pieˈjâččáid|pieiˈjee|piejâim|pieˈjâččáin|pieˈjâžává|pieˈjâččih|pieˈjâžeh|piejâšvettee	<i>verb</i><br><ol><li>to place, to set</li></ol>
pijgá|pijgáittáá|piijgái|pijgáttáá|piijgáh|piijgán|pijgáid|piijgást|pijgán|pijgáiguin|pijgái|pijgáin|piijgá|piijgáin|piijgáid|pijgád	<i>noun</i><br><ol><li>maid (servant)</li></ol>
pikkâ|piihah|piihâ|piikân|pihâi|pihháid|piihâst|piihâid|piihâin|pihâttáá|pihâittáá|pihâiguin|piihâi|pikkâd|pikkân|pihháin	<i>noun</i><br><ol><li>tar</li></ol>
pino|pinoi|pinoittáá|pinoh|piṇo|pinoin|pinnoon|piṇon|pinottáá|piinoost|pinnood|pinoid|pinoiguin	
pirrâ	<i>adv</i><br><ol><li>around</li></ol>
pittá|pitái|pitáttáá|pittáid|pittád|piitán|pittán|pitáiguin|pittáin|pitáin|pitáittáá|pitá|pittáást|pitáh	<i>noun</i><br><ol><li>piece, bit</li></ol>
pittâ|piitâ|pittáid|pitâittáá|pittân|pitâttáá|pittâd|piitâst|pitâiguin|piitâid|pittáin|piitân|piitah|piitâin|piitâi|pitâi	
poccee|poccei|pocced|poccest|pocceid|poccein|pocceeh|pocceiguin|pocceettáá|pocceittáá|poccen	<i>noun</i><br><ol><li>pipe</li><li>tube</li><li>chimney</li></ol>
polssâ|polssáin|poolsâst|polssân|polsâi|polsâittáá|poolsâid|poolsah|poolsâin|polsâiguin|poolsân|polsâttáá|poolsâ|poolsâi|polssáid|polssâd	<i>noun</i><br><ol><li>tussock</li></ol>
poollâđ	<i>verb</i><br><ol><li>to fear, to be afraid of</li></ol>
poossâđ	<i>verb</i><br><ol><li>to wash</li></ol>
pottâ|pottâd|pođâiguin|poođáin|poođâi|poođâid|poođáid|pođâttáá|pottân|poođâ|poođah|pootân|pođâi|poođâst|poođâin|pođâittáá	<i>noun</i><br><ol><li>butt, arse</li></ol>
poččâ	<i>adj</i><br><ol><li>bad of taste or smell, bitter</li></ol>
prinssâ|prinsâttáá|priinsâ|prinsâi|prinsâittáá|prinsâiguin|priinsâin|prinssân|prinssâd|prinssáid|priinsah|priinsâst|priinsâid|priinsâi|priinsân|prinssáin	<i>noun</i><br><ol><li>prince</li></ol>
pulkke|pulhijd|pulhe|puulhijd|pulheest|pulhijn|puulhij|pulheh|pulhijguin|pulhijttáá|pulhij|puulkán|pulhettáá|pulkked|puulhijn|pulkken	
puoccâđ|puoˈcâvettee|puoˈsâččih|puosâ|puoccâv|puoˈsâžeen|puoˈsâžep|puoˈsâččáid|puásus|puácˈcoon|puosâm|pyecˈceeh|pyecˈceen|puoccih|puoˈsâččim|puosáim|puocˈcii|puosâšvettee|pyecˈcee|puoˈsâččii|puosâid|puoccâm|puáccup|puosâi|puosáin|puáccus|puosii|puoˈsâžeh|puosâš|puoˈsâččijm|puácá|puosâšvetteđ|puoccim|pyecih|puoˈsâččij|puosah|puoˈsâččáim|puoˈsâččáin|puoccâp|puosáid|puoˈcâvetteđ|puoˈsâžává|pyecˈceem|puosâim|puoˈsâččijd	<i>verb</i><br><ol><li>to be ill/sick</li></ol>
puočâ|puojâin|puojáin|puojâittáá|puojah|puojâ|puojâst|puojâiguin|puoččân|puoččâd|puojâi|puočân|puojáid|puojâttáá|puojâid	<i>noun</i><br><ol><li>penis</li></ol>
purssâ|puursâ|puursâin|purssân|purssáin|puursah|puursân|pursâittáá|purssâd|pursâi|pursâiguin|puursâid|pursâttáá|purssáid|puursâst|puursâi	<i>noun</i><br><ol><li>purse</li></ol>
puunnjâđ	<i>verb</i><br><ol><li>to twist</li></ol>
puurrâđ	<i>verb</i><br><ol><li>to eat</li></ol>
puáris	<i>adj</i><br><ol><li>old</li></ol>
puásui|poccust|puásujin|poccui|poccud|puásujid|poccuu|poccuuh|poccuittáá|poccun|poccuiguin|poccuuttáá|poccuid|poccuin	<i>noun</i><br><ol><li>reindeer</li></ol>
puško|puškottáá|puuškon|puškoiguin|puškoin|puškoh|puškoid|puškoittáá|puškon|puškod|puškoost|puškoi	<i>noun</i><br><ol><li>pike (fish)</li></ol>
pyereh juovlah	<i>phrase</i><br><ol><li>merry Christmas</li></ol>
pyeri|pyeṛi	<i>adj</i><br><ol><li>good</li></ol>
pyerá|pyerái|pyeráittáá|pyerád|pyeráttáá|pyeráin|pyerást|pyeráh|pyeráiguin|pyerán|pyeráid	<i>noun</i><br><ol><li>bicycle</li></ol>
pállu|pááḷust|pállud|pááḷu|páḷuiguin|pálloid|páḷuittáá|páḷuttáá|pááḷuh|pááḷuin|pááḷui|pálloin|pállun|pááḷuid|pááḷun|páḷui	<i>noun</i><br><ol><li>ball (round object)</li></ol>
páárnáš|párnáittáá|párnážân|párnáá|párnááttáá|párnáid|páárnážân|párnái|páárnážin|párnáiguin|párnááh|párnážid|párnážin|páárnážid|párnáin|párnáást	<i>noun</i><br><ol><li>child</li></ol>
pärni|paaṛijd|parrijd|pääṛi|páárnán|pääṛist|paṛij|paaṛijn|parrijn|paṛijguin|päṛittáá|paṛijttáá|pärnin|pääṛih|pärnid|paaṛij	<i>noun</i><br><ol><li>child, son, boy</li></ol>
pääni|pááṇán|päänih|paanij|pänittáá|paanijd|pääṇi|panij|panijguin|panijttáá|päännid|päännin|päänist|paanijn	<i>noun</i><br><ol><li>tooth</li></ol>
raaijâđ|rajâččáin|rajâččáid|rajâččijd|raajâš|raajâšvettee|rááj̣á|rajâžává|raajaim|räijeem|rajâžeen|raj̣âvetteđ|rajâččáim|raijii|raajah|räijee|raaijâm|rááijup|raajain|rajâččijm|raj̣âvettee|raajâid|rajâččih|raaijim|raaijâv|rajâččii|raaijih|raajâm|rajâččij|ráijoon|räijeeh|raajâi|raajii|raaijâp|raajâim|rááijus|rajâžep|raajâšvetteđ|rajâččim|raajaid|raajâ|rääj̣ih|rajâžeh|räijeen|ráájus	
rađe|roođij|roođijd|raađeest|rađ̣e|rađeh|rođij|rađettáá|roođijn|rođijttáá|rađđeen|rođijguin|rađđeed|rađ̣an	<i>noun</i><br><ol><li>winter road</li></ol>
registeeriđ	<i>verb</i><br><ol><li>to register</li></ol>
register	<i>noun</i><br><ol><li>register, registry</li></ol>
registeristiđ	<i>verb</i><br><ol><li>to register</li></ol>
registeristum kyeimikoskâvuotâ	<i>noun</i><br><ol><li>registered partnership, civil partnership</li></ol>
rettâ|retâittáá|reetâid|reetâin|retâi|rettân|reetâst|reetâ|rettáid|reetâi|rettâd|retâiguin|reetah|reetân|retâttáá|rettáin	<i>noun</i><br><ol><li>delicacy</li></ol>
riehâ|rieṿâid|rieṿâi|rieḥâd|rieḥân|rieṿâ|rieṿâin|rieṿah|rieˈṿâttáá|rieˈṿâi|rievˈváin|rieˈṿâiguin|rievˈváid|rieˈṿâittáá|rieṿâst|riehân	<i>noun</i><br><ol><li>horse-drawn sleigh</li></ol>
riihâ|riihâid|rihâi|riihâi|riiháid|riiháin|riihah|riihân|rihâiguin|riihâin|rihâttáá|riihâd|riihâst|rihâittáá	<i>noun</i><br><ol><li>barn</li></ol>
rijjâ	<i>adj</i><br><ol><li>free of charge</li></ol>
rikkâ	<i>noun</i><br><ol><li>sulfur</li></ol>
rine|riinijn|rinijttáá|riṇán|rinijguin|rinneen|rineh|rinettáá|riinijd|rinneed|riinij|riineest|riṇe|rinij	<i>noun</i><br><ol><li>snow or rime that collects on trees and structures</li></ol>
rippâ|riipâin|ripâttáá|ripâittáá|riipâid|riipâst|riipân|riipâ|riipâi|rippáin|ripâiguin|ripâi|rippáid|rippâd|riipah|rippâ|rippân	<i>noun</i><br><ol><li>mote</li><li>dinner</li></ol>
ripá|riváin|riváttáá|rivá|riváittáá|rippáán|rivái|riváid|rippáád|riiváást|ripán|riváiguin|riváh	<i>noun</i><br><ol><li>handle</li></ol>
risse|rissijd|riisij|riseh|risijguin|rissed|riisán|rissijn|risij|risseest|rissen|risijttáá|riisijd|rise|risettáá|riisijn	<i>noun</i><br><ol><li>stick, twig</li></ol>
riävská|riävˈskán|riävskán|riäˈvskáiguin|riävskáid|riävˈská|riävskái|riävˈskáid|riävskást|riävskáin|riävˈskáin|riäˈvskái|riäˈvskáttáá|riäˈvskáittáá|riävskáh|riävˈskád	<i>noun</i><br><ol><li>willow grouse, Lagopus lagopus</li></ol>
rokkâđ	
ronno	<i>noun</i><br><ol><li>female reindeer who has lost her calf or has not had a calf this year</li></ol>
roohâđ|rooḥâđ	<i>verb</i><br><ol><li>to be in heat (of a reindeer)</li></ol>
roossâđ	<i>verb</i><br><ol><li>to be busy with</li></ol>
roottâđ	
roto|rođoiguin|rođoi|rođo|rođoid|rottoon|rođoh|roođoost|rođottáá|rođoin|rottood|rođoittáá|roton	<i>noun</i><br><ol><li>grove</li></ol>
rullâ|ruuḷâin|ruuḷâst|rulláid|rulláin|ruuḷah|ruuḷâ|ruḷâiguin|rullân|ruuḷâid|ruḷâittáá|ruḷâi|ruuḷâi|ruḷâttáá|rullâd|ruuḷân	
ruojâ|ruojâin|ruojáin|ruojâid|ruojah|ruojâittáá|ruojâst|ruojâttáá|ruojâi|ruojâd|ruojân|ruojáid|ruoj̣â|ruojâiguin	<i>noun</i><br><ol><li>noise, racket</li></ol>
ruoppâđ|ruoˈvâžep|ruováim|ruováid|ruopˈpii|ruoppih|ruoppâv|ruoˈvâččijd|ruáppup|ruoˈvâččijm|ruoˈvâžává|ryepˈpeeh|ruoˈvâččii|ruovâ|ruoˈvâččim|ruovâm|ryepih|ruápá|ruovâi|ryepˈpee|ruoˈvâččáid|ruoˈvâččáim|ruoppim|ruováin|ruávus|ruovâim|ruovâš|ryepˈpeen|ruoˈvâžeen|ruoppâp|ruoˈvâžeh|ruovah|ruáppus|ruovâid|ruápˈpoon|ruoˈvâččij|ruoˈvâččáin|ruovâšvetteđ|ruoˈpâvettee|ruoˈpâvetteđ|ryepˈpeem|ruovii|ruoˈvâččih|ruovâšvettee|ruoppâm	<i>verb</i><br><ol><li>to scratch (with nails)</li></ol>
ruossâđ|ruossâm|ryesˈseeh|ruoˈsâččáim|ruosâid|ruásus|ryesˈseen|ruosah|ruoˈsâvettee|ruásá|ruoˈsâččijd|ruosáim|ryesih|ruosâim|ruossim|ruosâm|ruosâ|ruosˈsii|ruoˈsâččih|ruoˈsâvetteđ|ruássus|ruásˈsoon|ruosâš|ryesˈsee|ruosâšvetteđ|ruoˈsâžeh|ruoˈsâččij|ruoˈsâččáid|ryesˈseem|ruoˈsâččii|ruoˈsâžep|ruossâv|ruoˈsâžává|ruosáin|ruoˈsâžeen|ruássup|ruosâi|ruossih|ruosâšvettee|ruossâp|ruosáid|ruoˈsâččim|ruoˈsâččijm|ruosii|ruoˈsâččáin	<i>verb</i><br><ol><li>to stumble</li></ol>
ruottâđ|ruotˈtâđ	<i>verb</i><br><ol><li>to gallop</li></ol>
ruotâs|ruottâsij|ruottâsin|ruottâsid|ruottâsân|ruottâsijd|ruottâsttáá|ruottâsáin|ruottâsijttáá|ruottâsijn|ruottâsijguin|ruottâsáid|ruottâsist|ruottâs|ruottâseh	<i>noun</i><br><ol><li>root</li></ol>
ruođâ	<i>noun</i><br><ol><li>rib</li></ol>
ruoŋâ|ruoˈŋâiguin|ruoˈŋâittáá|ruoŋah|ruoˈŋâttáá|ruoŋŋâd|ruoŋáid|ruoŋ̣ân|ruoŋ̣â|ruoŋâst|ruoŋâin|ruoŋâi|ruoˈŋâi|ruoŋâid|ruoŋáin|ruoŋŋân	<i>noun</i><br><ol><li>conditions with relatively little snow</li></ol>
ruttâ|ruuđáin|ruuđâin|ruuđâid|ruuđáid|ruuđâ|ruuđah|ruđâi|ruđâittáá|ruttân|ruuđâi|ruutân|ruđâiguin|ruuđâst|ruttâd|ruđâttáá	<i>noun</i><br><ol><li>money</li></ol>
ruttâminister|ruttâministereh|ruttâministerân|ruttâministeráid|ruttâministeráin|ruttâministerijttáá|ruttâministerin|ruttâministerttáá|ruttâministerij|ruttâministerist|ruttâministerijguin|ruttâministerid|ruttâministerijd|ruttâministerijn	<i>noun</i><br><ol><li>minister of finance</li></ol>
ruáhu|ruáˈṿui|ruáṿuin|ruáṿui|ruáˈṿuittáá|ruávˈvoin|ruáḥun|ruáḥud|ruáhun|ruáṿuid|ruáṿu|ruáṿuh|ruáˈṿuttáá|ruávˈvoid|ruáˈṿuiguin|ruáṿust	<i>noun</i><br><ol><li>reed</li></ol>
ruánnáđ	<i>verb</i><br><ol><li>to be green</li></ol>
ruápsáđ	<i>verb</i><br><ol><li>to be reddish</li></ol>
rähistiđ	<i>verb</i><br><ol><li>to love</li></ol>
saahâ|saaṿah|savvain|saṿâi|saaṿâi|saaḥân|saaṿâst|saṿâiguin|saṿâttáá|saaṿâ|saaṿâid|saṿâittáá|saaḥâd|savvaid|saahân|saaṿâin	<i>noun</i><br><ol><li>speech</li><li>message</li></ol>
saanjâ|sanjâittáá|saanjáid|saanjáin|sanjâttáá|sanjâi|saanjâid|saanjâst|sanjâiguin|saanjâd|saanjâi|saanjân|saanjâin|saaṇjâ|saanjah	<i>noun</i><br><ol><li>old unusable net</li></ol>
saarrâđ|sarâččih|saaraim|sarâččim|saarâi|saarâš|saṛâvetteđ|sarâžep|saarrâm|sáárus|sarâččáim|saarâšvettee|saarâid|saarrâv|sarâččijm|sáárrup|saṛâvettee|sárroon|saarrih|saarain|särree|sarâžeen|sarâččij|saarii|saarrim|sarâččijd|sarrii|sarâččii|saarâ|saarah|särreeh|saarâim|sarâžeh|saarâšvetteđ|sarâččáid|sarâččáin|särreen|saaraid|sáárrus|saarrâp|sááṛá|särreem|saarâm|sarâžává|sääṛih	<i>verb</i><br><ol><li>to split</li></ol>
saasâ|saasâst|sasâiguin|saasaid|saassân|saassâd|saasain|saasah|sasâi|sasâttáá|sasâittáá|saasân|saasâin|saasâi|saasâid	<i>noun</i><br><ol><li>future relative</li></ol>
saaččâđ	<i>verb</i><br><ol><li>to push, to shove</li></ol>
saađđâđ|sááđđup|sađâččijd|sađâččii|sađâččij|sääđ̣ih|saađaid|saađđâv|sađ̣âvettee|sađ̣âvetteđ|sađâččáid|sađâččijm|sááđus|saađah|sađâččáim|säđđeem|sađđii|säđđeeh|sááđđus|saađâšvettee|saađđâm|sađâžeh|sađâžep|säđđeen|sađâžává|saađii|säđđee|sáđđoon|saađâm|saađđim|saađâ|sađâččáin|sađâččim|saađâi|saađâim|saađâšvetteđ|sađâžeen|saađâš|saađâid|saađain|saađđâp|sađâččih|saađđih|saađaim|sááđ̣á	<i>verb</i><br><ol><li>to pant</li></ol>
saje|sajeh|sajettáá|soojijn|soojijd|saijeen|saj̣an|soojij|sojijttáá|saijeed|saj̣e|sojij|sojijguin|saajeest	<i>noun</i><br><ol><li>place</li><li>space</li></ol>
sare|saṛe|saareest|saṛan|soorijn|sarettáá|sarreen|sorijttáá|soorij|sorij|sorijguin|sarreed|sareh|soorijd	<i>noun</i><br><ol><li>bilberry</li></ol>
savzâ|savzâittáá|savzâttáá|saavzâi|savzâi|saavzân|savzain|saavzâin|saavzâ|savzaid|saavzâst|savzâd|savzân|savzâiguin|saavzâid|saavzah	<i>noun</i><br><ol><li>sheep</li></ol>
sekkâ|sekkân|sehâi|seehâst|seehâid|seehâin|sehâittáá|seehâ|sehâiguin|sehâttáá|sekkâd|sehháid|seekân|seehah|seehâi|sehháin	<i>noun</i><br><ol><li>sack</li></ol>
servi|seṛijttáá|servin|seṛittáá|seṛij|seeṛij|seṛijguin|seeṛijn|seeṛi|siärván|serrijd|seeṛijd|seeṛih|seeṛist|serrijn|servid	<i>noun</i><br><ol><li>association</li></ol>
siejâ|siejâin|siejáid|siejâi|siejâid|siejah|sieijâd|siej̣â|siejáin|siejâst|siejâiguin|sieijân|siejâittáá|siejân|siejâttáá	<i>noun</i><br><ol><li>pus</li></ol>
sieppâ|siepâid|siepâst|siepˈpáin|siepˈpâd|sieˈpâttáá|siepâi|sieˈpâi|siepâin|siepah|siepˈpáid|siepˈpân|sieˈpâiguin|siepˈpâ|siepâ|siepân|sieˈpâittáá	<i>noun</i><br><ol><li>pubic hair</li></ol>
sieđgâ|sieđˈgâd|sieˈđgâttáá|sieˈđgâi|sieđgân|sieđˈgáid|sieđˈgáin|sieˈđgâittáá|sieđˈgâ|sieđgâi|sieđgah|sieđˈgân|sieđgâin|sieˈđgâiguin|sieđgâst|sieđgâid	<i>noun</i><br><ol><li>willow</li></ol>
sieđgâcivkkee|sieđgâcivkkei|sieđgâcivkkein|sieđgâcivkkeettáá|sieđgâcivkkeeh|sieđgâcivkked|sieđgâcivkkeittáá|sieđgâcivkkeid|sieđgâcivkkest|sieđgâcivkkeiguin|sieđgâcivkken	<i>noun</i><br><ol><li>red-throated pipit, Anthus cervinus</li></ol>
sino|sinoin|sinoh|siṇon|siṇo|sinottáá|sinnoon|sinnood|sinoid|siinoost|sinoi|sinoittáá|sinoiguin	<i>noun</i><br><ol><li>short grass</li></ol>
siäiludâs|siäiludâsttáá|siäiludâsij|siäiludâseh|siäiludâsijd|siäiludâsijguin|siäiludâsáin|siäiludâsin|siäiludâsid|siäiludâsijttáá|siäiludâsáid|siäiludâsist|siäiludâsijn|siäiludâsân	<i>noun</i><br><ol><li>canned food</li></ol>
siäiluđ	<i>verb</i><br><ol><li>to remain</li><li>to be preserved</li></ol>
siäsá|siäsást|siässáin|siäsáiguin|siäsán|siässáid|siäsád|siäsáttáá|siäsáittáá|siäsái|siäsáin|siäsáh|siäsáid	<i>noun</i><br><ol><li>paternal aunt</li></ol>
smakkâ|smakâiguin|smakâttáá|smaakâi|smaakân|smakâittáá|smaakâid|smaakâst|smakkáin|smakkân|smakkáid|smaakah|smaakâ|smakâi|smaakâin|smakkâd	<i>noun</i><br><ol><li>taste, flavour</li></ol>
sollâ|soolâin|soolah|soolâi|sooláid|sooláin|solâttáá|solâi|sooḷân|soolâst|solâittáá|sollân|sollâd|soolâid|soolâ|solâiguin	<i>noun</i><br><ol><li>fathom</li></ol>
somo|soṃo	<i>noun</i><br><ol><li>fog</li></ol>
soohađ|sooḥâđ	<i>verb</i><br><ol><li>to pant</li></ol>
sooppâđ	<i>verb</i><br><ol><li>to make an agreement</li></ol>
sooŋŋâđ	<i>verb</i><br><ol><li>to thaw, to become ice-free</li></ol>
soppâ|soopâid|soppâd|sopâttáá|soopâi|soppáid|soopân|soopâ|sopâi|soopâst|soopâin|soopah|sopâiguin|sopâittáá|soppân|soppáin	<i>noun</i><br><ol><li>corner, nook</li></ol>
sorvâ|sorvâd|soorvân|soṛâittáá|sooṛâi|sooṛâst|sooṛâid|sorráin|sooṛâin|soṛâiguin|sorvân|sooṛah|soṛâi|soṛâttáá|sooṛâ|sorráid	<i>noun</i><br><ol><li>elk, moose, Alces alces</li></ol>
spaanjâ|spanjâiguin|spaanjah|spaanjâi|spaanjâin|spaanjáin|spanjâttáá|spanjâi|spaanjân|spanjâittáá|spaanjâd|spaanjâst|spaaṇjâ|spaanjáid|spaanjâid	<i>noun</i><br><ol><li>can, jug</li></ol>
spellâ|speeḷah|spellâd|spelláin|spellân|speḷâiguin|speḷâittáá|speeḷâi|speeḷân|speeḷâst|speeḷâid|speeḷâin|speḷâi|speeḷâ|speḷâttáá|spelláid	<i>noun</i><br><ol><li>playing card</li></ol>
stirccođ	<i>verb</i><br><ol><li>to sizzle</li><li>to spurt</li></ol>
stoohâ|stovváin|stovváid|stoṿâittáá|stooḥâd|stooṿâin|stooṿâst|stooṿâi|stoṿâiguin|stooṿâid|stooḥân|stoṿâi|stoohân|stoṿâttáá|stooṿah|stooṿâ	<i>noun</i><br><ol><li>noise, racket</li></ol>
stukkâ|stuukâ|stukkáin|stuukân|stuukâi|stukkáid|stukâittáá|stuukah|stukâiguin|stukkâd|stukkân|stuukâst|stuukâin|stuukâid|stukâi|stukâttáá	<i>noun</i><br><ol><li>forebeam</li></ol>
stuorrâ vuonjâč	<i>noun</i><br><ol><li>mallard, Anas platyrhynchos</li></ol>
stáálu|stááluh|stáálust|stááḷu|stááloid|stááḷun|stáluiguin|stáállud|stáluittáá|stáállun|stááloin|stááluin|stááluid|stálui|stáluttáá|stáálui	<i>noun</i><br><ol><li>(mythology) stallo, troll</li></ol>
suijâ|suijâd|suijân|suujân|sujâiguin|sujâittáá|suujâin|suujáid|sujâttáá|sujâi|suujah|suujâ|suujâst|suujâid|suujâi|suujáin	<i>noun</i><br><ol><li>fault</li><li>reason, cause</li></ol>
sukkâr|sukkâreh|sukkâráid|sukkârij|sukkârân|sukkârijttáá|sukkârijd|sukkârijguin|sukkârin|sukkârijn|sukkârid|sukkâráin|sukkârist|sukkârttáá	<i>noun</i><br><ol><li>sugar</li></ol>
sullâ|sullân|suulâin|suuláin|sullâd|sulâittáá|suulâi|suuláid|sulâiguin|sulâi|sulâttáá|suulâ|suuḷân|suulâid|suulâst|suulah	<i>noun</i><br><ol><li>direction</li></ol>
sun	<i>pron</i><br><ol><li>he, she, it</li></ol>
suonâ|suonáid|suonâi|suonáin|suonâid|suoṇân|suonnân|suoˈnâiguin|suoˈnâttáá|suoˈnâittáá|suoˈnâi|suonâin|suoṇâ|suonah|suonnâd|suonâst	<i>noun</i><br><ol><li>vein (in a leaf)</li><li>vein, blood vessel</li><li>tendon, sinew</li></ol>
suosâ|suosáid|suosâst|suosâi|suosâttáá|suossân|suosân|suosâiguin|suosâin|suosâid|suosáin|suosah|suossâd|suosâittáá	<i>noun</i><br><ol><li>frazil ice</li></ol>
suovâ|suovâi|suovvân|suovâid|suovvâd|suoṿâ|suováin|suováid|suovâst|suoˈvâiguin|suoˈvâittáá|suovah|suoˈvâi|suoṿân|suovâin|suoˈvâttáá	<i>noun</i><br><ol><li>smoke</li></ol>
suođđâđ|syeđ̣ih|syeđˈđee|suoˈđâžeen|suođđim|suođâ|suođáin|suođáim|suáđđup|suoˈđâččáid|suoˈđâččijd|suođđâv|suođđih|suoˈđâžep|suođâš|suođđâp|suođâm|suoˈđâččim|suáđ̣á|suáđđus|suođâi|suáđus|suođˈđii|suođah|suoˈđ̣âvetteđ|suáđˈđoon|suoˈđâččih|suoˈđâččij|suoˈđâččáim|suođâšvettee|suoˈđâččii|suođii|syeđˈđeem|syeđˈđeeh|suoˈđâžává|suođáid|suoˈđ̣âvettee|suoˈđâččáin|suoˈđâžeh|suođâim|suoˈđâččijm|suođâid|syeđˈđeen|suođđâm|suođâšvetteđ	<i>verb</i><br><ol><li>to not be airtight</li></ol>
supe|suuvijn|suppeen|suveh|suvijguin|suuveest|suvijttáá|suuvij|suve|suuvijd|suvij|suvettáá|suppeed|supán	<i>noun</i><br><ol><li>aspen</li></ol>
suttâđ	<i>verb</i><br><ol><li>to become angry</li></ol>
suuhâ|suuḥâd|suṿâi|suuṿâ|suvváid|suṿâiguin|suuṿâid|suuḥân|suuṿah|suuhân|suvváin|suṿâittáá|suuṿâi|suuṿâst|suṿâttáá|suuṿâin	<i>noun</i><br><ol><li>kin, family</li></ol>
suuhâđ|suuḥâđ	<i>verb</i><br><ol><li>to row</li></ol>
suuijâđ	<i>verb</i><br><ol><li>to bend, to become bent</li></ol>
suuppâđ	<i>verb</i><br><ol><li>to gnaw</li></ol>
suáhi|sooṿij|sovvijd|soṿijguin|suáḥid|sooṿijn|suáḥin|sovvijn|suáṿih|suáˈṿittáá|soṿijttáá|suáṿi|soṿij|suáhán|suáṿist|sooṿijd	<i>noun</i><br><ol><li>birch</li></ol>
suálui	<i>noun</i><br><ol><li>island</li></ol>
sáárnuđ	<i>verb</i><br><ol><li>to speak</li></ol>
säplig|säpligijttáá|säpligijd|säpligáin|säpligin|säpligijguin|säpligeh|säpligân|säpligijn|säpligist|säpligáid|säpligij|säpligttáá|säpligid	<i>noun</i><br><ol><li>mouse</li><li>computer mouse</li></ol>
taammâđ|tämmee|taammâp|taamâ|taamii|tamâččáim|táámmup|taamaid|taṃâvettee|taammâm|tamâččijm|tämmeem|taamâi|tamâččim|tamâččáin|tämmeeh|taamâid|tamâččih|támmoon|taamâš|taamâšvetteđ|táámmus|taamâm|tääṃih|taamain|tamâžeh|taamaim|tamâžeen|tááṃá|tamâččij|tämmeen|taammâv|tamâžává|taamâšvettee|tamâččáid|taamâim|taammim|tammii|táámus|taammih|taamah|tamâččii|tamâžep|taṃâvetteđ|tamâččijd	<i>verb</i><br><ol><li>to tame</li></ol>
taho|tavo|taṿo|tahon|tavvoost|tahhoon|taṿoiguin|tahhood|taṿoi|taṿoid|tavvoid|taṿoin|taṿottáá|taṿoittáá|taṿoh|tavvoin	<i>noun</i><br><ol><li>act, deed</li><li>achievement</li></ol>
takkâ	<i>intj</i><br><ol><li>thanks, thank you</li></ol>
tame|tomijguin|toomij|tamettáá|tameh|tammeen|tomij|toomijd|taṃe|toomijn|taameest|taṃan|tammeed|tomijttáá	<i>noun</i><br><ol><li>glue</li></ol>
tane|toonij|tanettáá|tonijguin|tonij|tanneen|toonijn|taaneest|tonijttáá|taṇe|tanneed|taneh|toonijd|taṇan	<i>noun</i><br><ol><li>tin (metal)</li></ol>
tatti|taati|tattijn|taatij|taatin|tatittáá|taatijd|taatist|taatijn|tattijd|tatijttáá|tatij|taatih|tattid|tattin|tatijguin	<i>noun</i><br><ol><li>bolete</li></ol>
teejâ|teeijâd|teejân|teeijân|teejâin|teej̣â|tejâttáá|tejâittáá|teejah|teejâi|teejáid|teejáin|tejâiguin|tejâi|teejâid|teejâst	<i>noun</i><br><ol><li>tea</li></ol>
tehálâš	<i>adj</i><br><ol><li>important</li></ol>
tievâs	<i>adj</i><br><ol><li>full</li></ol>
tikke|tikken|tihijguin|tihijttáá|tiikán|tikked|tihe|tiihijn|tihij|tiihij|tihhijn|tihettáá|tiihijd|tihhijd|tihheest|tiheh	<i>noun</i><br><ol><li>louse</li></ol>
tiljá|tiljáittáá|tiljád|tiljáh|tiljáin|tilján|tiljái|tiljáiguin|tiljáást|tiljáttáá|tiilján|tiljáid	
tivre|tiṿij|tiiṿijd|tiṿijttáá|tiṿettáá|tiṿe|tiṿeh|tiṿijguin|tiiṿijn|tivvijn|tiiṿij|tivren|tivred|tiivrán|tivvijd|tivveest	<i>noun</i><br><ol><li>insect</li></ol>
tiŋŋâ|tiŋŋân|tiiŋâ|tiŋâiguin|tiŋâi|tiiŋáin|tiŋŋâd|tiiŋâid|tiiŋâin|tiiŋ̣ân|tiiŋáid|tiŋâittáá|tiŋâttáá|tiiŋâst|tiiŋah|tiiŋâi	<i>noun</i><br><ol><li>pumice</li></ol>
toohâđ|tooḥâđ	<i>verb</i><br><ol><li>to do</li></ol>
toollâđ	<i>verb</i><br><ol><li>to hold</li></ol>
toommâđ	<i>verb</i><br><ol><li>to hurry</li></ol>
toppâđ	<i>verb</i><br><ol><li>to close, to close off</li></ol>
tullâ|tuuláid|tuulâst|tuuláin|tuulah|tuulâi|tuulâid|tuulâin|tulâiguin|tulâttáá|tuulâ|tulâi|tullâd|tuuḷân|tulâittáá|tullân	<i>noun</i><br><ol><li>fire</li></ol>
tun	<i>pron</i><br><ol><li>you (singular)</li></ol>
tuodâr	<i>noun</i><br><ol><li>fell (mountain)</li><li>tundra, mountain tract</li></ol>
tuomâ|tuomah|tuomáin|tuoˈmâittáá|tuommâd|tuomáid|tuomâi|tuoṃân|tuomâst|tuommân|tuoˈmâiguin|tuoˈmâttáá|tuomâid|tuoṃâ|tuoˈmâi|tuomâin	<i>noun</i><br><ol><li>bird cherry</li></ol>
tuoppâđ|tuovâm|tuoppâp|tuoppâm|tuovâi|tuovâim|tuovâšvettee|tyepˈpeem|tuovah|tuopˈpii|tuoˈvâžeh|tuoˈvâččáim|tuoppâv|tuoˈvâččijm|tuoˈvâžep|tuovâšvetteđ|tuoˈvâččijd|tuovâid|tuovâ|tuováid|tuoˈvâččáid|tuápá|tyepˈpee|tuováin|tuoppih|tuoˈvâččih|tuoˈpâvettee|tyepˈpeen|tuápˈpoon|tyepih|tuoˈvâččij|tyepˈpeeh|tuoˈvâžeen|tuovâš|tuoˈpâvetteđ|tuoˈvâččáin|tuovii|tuoˈvâččim|tuáppus|tuoˈvâžává|tuováim|tuáppup|tuoˈvâččii|tuoppim|tuávus	<i>verb</i><br><ol><li>to pull in</li></ol>
tuorrâđ|tuorii|tuorâ|tuárrup|tuorˈrii|tuoˈrâččim|tuárus|tuoˈrâččáim|tuorâšvetteđ|tuoˈrâččijd|tuoˈrâžeen|tuoˈrâččih|tyerˈreen|tuoˈrâččáid|tuáṛá|tyerˈreem|tuorâšvettee|tuoˈrâččáin|tuoˈrâžává|tuárˈroon|tyerˈree|tuoráim|tuorâid|tuoˈrâččij|tyerˈreeh|tuoˈrâččii|tuorrim|tuorâim|tuoˈṛâvettee|tuorrâv|tuoˈrâččijm|tuorrih|tuoˈṛâvetteđ|tuoráin|tuoˈrâžeh|tuorah|tuorrâp|tuárrus|tuorrâm|tuorâi|tuorâm|tuorâš|tuoráid|tuoˈrâžep|tyeṛih	
tuossâđ|tuossâv|tuásˈsoon|tuoˈsâvettee|tuosâim|tuosâšvetteđ|tuássus|tuoˈsâžep|tuosâi|tuásá|tuosâ|tyesˈseeh|tyesˈseem|tuossih|tuosáid|tuossim|tuoˈsâččijm|tuoˈsâžeh|tuossâm|tuosáim|tuosâid|tuásus|tuoˈsâččáid|tuossâp|tuoˈsâččim|tuosah|tuoˈsâččij|tuoˈsâžeen|tuoˈsâžává|tuássup|tuoˈsâččii|tuoˈsâččáin|tuosâšvettee|tyesˈsee|tuosáin|tuosˈsii|tuoˈsâččijd|tuoˈsâččih|tuosâm|tuoˈsâččáim|tuoˈsâvetteđ|tyesˈseen|tyesih|tuosii|tuosâš	<i>verb</i><br><ol><li>to illuminate, to shine light on</li></ol>
tuotâ|tuotân|tuođâin|tuottâd|tuođâst|tuođah|tuođáid|tuoˈđâittáá|tuoˈđâiguin|tuođâi|tuottân|tuođâid|tuoˈđâi|tuođâ|tuoˈđâttáá|tuođáin	<i>adj</i><br><ol><li>true</li></ol>
tuppâ|tuupah|tuupâin|tuppân|tuupâid|tuupân|tuppáin|tupâi|tupâittáá|tupâttáá|tuppâd|tuupâi|tuppáid|tupâiguin|tuupâst|tuupâ	<i>noun</i><br><ol><li>sheath</li></ol>
tuuppađ	<i>verb</i><br><ol><li>to stick (of snow)</li></ol>
tuáršu|tuáršoid|tuáršoin|tuáršuttáá|tuáršuittáá|tuáršud|tuáršui|tuárˈšu|tuáršuin|tuáršuid|tuáršuiguin|tuáršuh|tuáršust|tuáršun	<i>noun</i><br><ol><li>mallard, Anas platyrhynchos</li></ol>
tyeji|tuojijd|tuoijijn|tuojijn|tyejeest|tuojij|tyejeh|tuojijguin|tyejettáá|tyej̣i|tuáján|tuoijijd|tyeijin|tyeijid|tuojijttáá|tyeje	<i>noun</i><br><ol><li>duodji (Sami handicraft)</li></ol>
táálu|tááḷu	<i>noun</i><br><ol><li>house</li></ol>
täigi|taigijd|taaigij|taaigijd|taigijn|tääigi|tääigih|täigin|taaigijn|taigijguin|tááigán|täigittáá|täigid|taigijttáá|tääigist|taigij	<i>noun</i><br><ol><li>dough</li></ol>
uccâ	<i>noun</i><br><ol><li>cleavage</li></ol>
uhkediđ	<i>verb</i><br><ol><li>to threaten</li></ol>
unnuđ	<i>verb</i><br><ol><li>to allow</li><li>to permit</li></ol>
upseer|upseerijguin|upseeráid|upseerttáá|upseerijd|upseerist|upseereh|upseerijn|upseeráin|upseerijttáá|upseerid|upseerij|upseerân|upseerin	<i>noun</i><br><ol><li>military officer</li></ol>
uuccâđ	<i>verb</i><br><ol><li>to seek, to search</li></ol>
uuđâs	<i>adj</i><br><ol><li>new</li></ol>
uábbi|uábán|uábist|uáˈbittáá|obij|uábˈbin|oobijn|oobij|obbijn|oobijd|obbijd|uábih|obijguin|obijttáá|uábˈbid|uábˈbi|uábi	<i>noun</i><br><ol><li>sister</li></ol>
uámi|uáˈṃi|uáṃi	<i>adj</i><br><ol><li>own</li><li>old (of objects)</li></ol>
uánih	<i>adj</i><br><ol><li>short</li></ol>
uárree|uárrest|uárˈree|uárreid|uárreittáá|uárred|uárrein|uárreettáá|uárreeh|uárrei|uárreiguin|uárren	<i>noun</i><br><ol><li>squirrel</li></ol>
uástiđ|uásˈtiđ	<i>verb</i><br><ol><li>to buy</li></ol>
uáđđiđ	<i>verb</i><br><ol><li>to sleep</li></ol>
uđđâihe|uđđâivijttáá|uđđâivijguin|uđđâivveest|uđđâivij|uđđâiivijn|uđđâivvijd|uđđâiivij|uđđâivettáá|uđđâiveh|uđđâihán|uđđâihheed|uđđâiivijd|uđđâihheen|uđđâivvijn|uđđâive	<i>noun</i><br><ol><li>new year</li></ol>
uđđâivemáánu|uđđâivemáánun|uđđâivemáánuid|uđđâivemánuiguin|uđđâivemáánui|uđđâivemánui|uđđâivemánuttáá|uđđâivemánuittáá|uđđâivemáánuin|uđđâivemáánust|uđđâivemáánuh|uđđâivemáánnun|uđđâivemáánnud	<i>noun</i><br><ol><li>January</li></ol>
vaalâ|vaalâid|vaalah|vaalâst|vaallân|valâi|vaalain|vaalaid|valâittáá|vaallâd|vaaḷân|valâiguin|valâttáá|vaalâin|vaaḷâ|vaalâi	<i>noun</i><br><ol><li>noise</li></ol>
vaarâ|vaarrâd|varâi|vaaraid|vaarâi|varâiguin|varâittáá|vaarah|vaaṛân|vaarain|vaarrân|vaarâin|vaarâst|vaaṛâ|varâttáá|vaarâid	<i>noun</i><br><ol><li>danger</li></ol>
vaccâ|vacâi|vaacâ|vaacâin|vaccain|vaccaid|vaacah|vaacâst|vacâttáá|vaccâd|vacâittáá|vaccân|vaacâid|vaacân|vacâiguin|vaacâi	<i>noun</i><br><ol><li>mitten</li></ol>
vahe|voṿijguin|vahheed|voṿij|vooṿij|vahan|vavveest|voṿijttáá|vooṿijn|vahheen|vaṿeh|vaṿe|vovvijd|vaṿettáá|vooṿijd|vovvijn	<i>noun</i><br><ol><li>fault, error, mistake</li></ol>
vaje|vaijeen|vojijttáá|voojijd|vaj̣an|vojij|voojij|vaajeest|vajettáá|vaj̣e|vajeh|vojijguin|voojijn|vaijeed	<i>noun</i><br><ol><li>hate, anger</li></ol>
vajâldiđ	<i>verb</i><br><ol><li>to wander</li></ol>
varbusâš|varbusiittáá|varbusâžân|varbusii|varbusiih|varbusij|varbusijn|varbusijttáá|varbusâžžâd|varbusijd|varbusiist|varbusijguin|varbusâžžân|varbusáid	<i>noun</i><br><ol><li>sparrow, Passer domesticus</li></ol>
vašo|vaššoon|vašoi|vašoin|vašottáá|vašoh|vašoittáá|vašoid|vaššood|vašon|vaššoost|vašoiguin	<i>noun</i><br><ol><li>strong, cold wind</li></ol>
veelâ|veeḷâ|veeláid|veelah|veelâid|veeláin|velâttáá|velâittáá|veellân|velâi|veelâi|veeḷân|veellâd|veelâin|velâiguin|veelâst	<i>noun</i><br><ol><li>distinction, difference</li></ol>
veepsis|viäpsáh|viäpsást|viäpsáittáá|viäpsáid|viäpsáttáá|viäpsá|vepsisid|viäpsáiguin|vepsisin|viäpsás|viäpsái|viäpsáin	<i>noun</i><br><ol><li>wasp</li></ol>
veerrâđ|veerrâm|viärus|verâččim|viärrus|veṛâvetteđ|verâččáid|veerah|veerâ|veeráin|verâžeen|verreem|verâžává|verreen|verâččijm|veerâid|veerii|veeráim|veeráid|verâččáin|verâččii|veerâm|veerâš|verâččáim|verâččijd|verâččij|veerrih|veeṛih|veerâim|viärrup|veerâi|veṛâvettee|veerrâp|verrii|viäṛá|verâččih|veerrim|viärˈroon|veerâšvettee|verâžeh|veerâšvetteđ|verreeh|verâžep|verree|veerrâv	<i>verb</i><br><ol><li>to carve, to cut</li></ol>
viehâ|vieˈṿâiguin|vieˈṿâttáá|vieṿâ|vieṿâst|vievˈváin|vieṿâid|vieḥâd|vieˈṿâi|vieˈṿâittáá|vievˈváid|vieṿâin|vieṿâi|vieḥân|vieṿah|viehân	<i>noun</i><br><ol><li>people</li><li>crew</li></ol>
vielgâd|vielˈgâd	<i>adj</i><br><ol><li>white</li></ol>
vierccâ|viercâ|vieˈrcâiguin|viercah|viercân|viercâin|vieˈrcâttáá|vieˈrcâittáá|viercâi|vierˈccáid|vierˈccâd|vierˈccâ|vierˈccân|viercâst|vierˈccáin|vieˈrcâi|viercâid	<i>noun</i><br><ol><li>ram (male sheep)</li></ol>
vierrâđ|vierâ|vierrih|viärus|viärrus|vieˈrâččij|vierˈreen|vierâi|vieˈṛâvettee|vierâšvetteđ|vierrâp|vierrim|vierâid|vieˈrâžeh|vierii|vierâšvettee|vierrâv|vieˈrâččáid|vieráim|vieˈrâččáin|vierrâm|vieráid|vieˈrâččii|vierâim|vierˈree|vieráin|vieˈṛâvetteđ|vieˈrâžeen|vieṛih|vierˈrii|vieˈrâččijd|vieˈrâččijm|viärrup|vieˈrâžep|vieˈrâččih|vierˈreem|vieˈrâžává|viäṛá|vieˈrâččáim|vierah|vierâm|vierˈreeh|viärˈroon|vierâš|vieˈrâččim	<i>verb</i><br><ol><li>to roll</li></ol>
viessâđ|viessâm|vieˈsâvettee|vieˈsâččáim|viesâšvetteđ|viesâi|viesâ|vieˈsâččih|vieˈsâžeen|viessim|viäsus|viesah|vieˈsâččáin|viesáin|viesáid|viässus|viesii|vieˈsâžeh|vieˈsâččii|viessih|viessâv|viesˈseen|viesâim|vieˈsâččim|viesâm|viäsá|vieˈsâččijm|viesáim|viesˈsii|vieˈsâžep|viessâp|viesˈseeh|vieˈsâččij|viesâš|vieˈsâžává|vieˈsâččijd|vieˈsâččáid|viesâid|viesˈseem|vieˈsâvetteđ|viässup|viesâšvettee|viäsˈsoon|viesih|viesˈsee	<i>verb</i><br><ol><li>to die, to perish</li></ol>
viijmâg	<i>adv</i><br><ol><li>finally</li></ol>
viirrâđ	<i>verb</i><br><ol><li>to fall over</li><li>to collapse</li></ol>
viiššâđ	<i>verb</i><br><ol><li>to bother, to consider worth the effort</li></ol>
viljâ|viḷâiguin|viiḷâst|viḷâttáá|viiḷâid|viḷâittáá|viljâd|viḷâi|viljân|viiḷah|villáin|villáid|viiḷâi|viiḷâ|viiḷâin|viiljân	<i>noun</i><br><ol><li>brother</li></ol>
vine|vineh|viinijn|vinneed|viinij|viinijd|vinijguin|vinneen|viineest|viṇe|vinij|vinettáá|vinijttáá|viṇán	
viste|visteh|visteest|viistijd|viistij|vistettáá|vistijttáá|visted|visten|vistijd|viistán|vistij|viistijn|vistijguin|vistijn	<i>noun</i><br><ol><li>house, residence, dwelling</li><li>room</li></ol>
vittâ	<i>num</i><br><ol><li>five</li></ol>
vivvâ|viṿâttáá|vivváid|viiṿân|viiṿâst|viiṿâin|viṿâittáá|vivváin|viṿâi|viṿâiguin|viiṿâi|vivvân|viiṿâ|viiṿâid|vivvâd|viiṿah	<i>noun</i><br><ol><li>son-in-law</li></ol>
viärju|viärˈroid|viäṛuh|viäṛui|viäˈṛuittáá|viärˈjun|viäṛuid|viäṛuin|viärˈjud|viärjun|viärˈroin|viäˈṛui|viäṛu|viäˈṛuttáá|viäˈṛuiguin|viärˈju|viäṛust	<i>noun</i><br><ol><li>weapon</li></ol>
viäru|viäˈruttáá|viäruid|viärust|viäroid|viärrun|viäˈruittáá|viäˈruiguin|viäṛun|viäroin|viäruh|viäruin|viäṛu|viärui|viärrud|viäˈrui	<i>noun</i><br><ol><li>tax</li></ol>
viäđŋásâš|viäđŋásâžân|viäđŋásâžžân|viäđŋásijn|viäđŋásiist|viäđŋásijguin|viäđŋásii|viäđŋásáid|viäđŋásâžžâd|viäđŋásij|viäđŋásijd|viäđŋásijttáá|viäđŋásiittáá|viäđŋásiih|viäđˈŋâsâš	<i>noun</i><br><ol><li>shrew</li></ol>
voccâ|vocâiguin|vocâi|voocâst|voocah|voocân|voccáid|vocâittáá|voccân|voccáin|voocâid|vocâttáá|voocâin|voocâi|voccâd|voocâ	<i>noun</i><br><ol><li>freshly-fallen snow</li></ol>
vooijâđ	<i>verb</i><br><ol><li>to cut (cloth, leather)</li></ol>
voonnâđ	<i>verb</i><br><ol><li>to stretch, to become stretched</li></ol>
vorrâ|voorâin|vorrân|vooráid|voorâst|vorâiguin|voorâid|voorah|voorâi|vooṛân|vooráin|vorâttáá|vorâittáá|vorrâd|vorâi|voorâ	<i>noun</i><br><ol><li>blood</li></ol>
vođđâ|voođ̣âi|voođ̣â|vođđáin|vođ̣âiguin|vođ̣âittáá|vođđáid|voođ̣ân|voođ̣âst|voođ̣âin|voođ̣ah|vođđân|vođđâd|vođ̣âttáá|vođ̣âi|voođ̣âid	
vuoijâđ|vuoˈjâžeh|vuojáid|vuoijâp|vuájus|vuoˈjâččijd|vyej̣ih|vuoˈj̣âvetteđ|vuoiˈjii|vuoˈjâččáid|vuojâid|vyeiˈjeem|vuojah|vuáj̣á|vyeiˈjeeh|vuoˈjâččim|vuoˈjâččii|vuojâšvettee|vuoijâm|vuojâ|vuojâim|vuoijih|vuoˈjâččáin|vuoˈjâččáim|vuoijim|vyeiˈjeen|vuoˈjâččih|vuoˈj̣âvettee|vuoijâv|vuojâm|vuojâi|vuoˈjâžeen|vuojáim|vyeiˈjee|vuojâš|vuoˈjâžep|vuoˈjâččij|vuoˈjâžává|vuojii|vuáijup|vuojáin|vuojâšvetteđ|vuáijus|vuáiˈjoon|vuoˈjâččijm	<i>verb</i><br><ol><li>to swim</li></ol>
vuojâ|vuojân|vuojâid|vuoj̣â|vuojâst|vuojáid|vuojah|vuojáin|vuojâi|vuojâttáá|vuoijâd|vuojâittáá|vuoijân|vuojâin|vuojâiguin	<i>noun</i><br><ol><li>butter</li></ol>
vuollâđ|vuoˈḷâvettee|vuoˈlâččáin|vuálˈloon|vuolâi|vuolˈlii|vuollâp|vuolâšvettee|vuolah|vuállus|vuoˈlâččih|vuáḷá|vuolâšvetteđ|vuolâm|vyelˈlee|vuoˈḷâvetteđ|vuoˈlâččáim|vuolâš|vuolii|vuollâv|vuálus|vyelˈleen|vuollim|vuoˈlâžeh|vuollâm|vuolâid|vyelˈleeh|vuoˈlâžep|vuoláid|vuoˈlâččii|vuoláim|vuolâ|vuoˈlâččáid|vuolâim|vuoˈlâččij|vuoˈlâččijd|vyeḷih|vuoˈlâžává|vyelˈleem|vuollih|vuállup|vuoˈlâččijm|vuoláin|vuoˈlâžeen|vuoˈlâččim	<i>verb</i><br><ol><li>to carve</li></ol>
vuonâ|vuoˈnâi|vuoṇâ|vuonâin|vuoˈnâttáá|vuonáin|vuonâst|vuonah|vuoˈnâiguin|vuonáid|vuoˈnâittáá|vuonnân|vuonâid|vuonâi|vuonnâd|vuoṇân	<i>noun</i><br><ol><li>fjord</li></ol>
vuoppâ|vuopâ|vuopˈpâ|vuopˈpáid|vuopˈpâd|vuoˈpâittáá|vuoˈpâiguin|vuopân|vuopâid|vuopah|vuopâi|vuopˈpân|vuopâin|vuoˈpâi|vuoˈpâttáá|vuopâst|vuopˈpáin	<i>noun</i><br><ol><li>father-in-law</li></ol>
vuoptâ|vuoptah|vuoptâst|vuoˈptâttáá|vuopˈtâd|vuoˈptâiguin|vuoˈptâittáá|vuoˈptâi|vuopˈtáid|vuopˈtân|vuopˈtáin|vuoptâid|vuoptân|vuoptâin|vuopˈtâ|vuoptâi	<i>noun</i><br><ol><li>hair</li></ol>
vuorrâđ|vuorâi|vyerˈreeh|vuoˈrâččáim|vuoˈrâččáin|vuoˈrâččih|vuorii|vuorâid|vuorâšvettee|vuárus|vuorrim|vuoˈṛâvettee|vuoˈrâččijd|vuorah|vuorâim|vuoˈrâččii|vuorâm|vyerˈreen|vuorrâv|vuoˈrâččim|vuoˈrâžeen|vuorrâp|vuoráid|vuorrih|vuárrup|vyerˈreem|vuárˈroon|vuoˈrâžeh|vyerˈree|vuorâ|vuorâš|vuoˈṛâvetteđ|vuoráin|vuorâšvetteđ|vuoˈrâččáid|vuoˈrâžep|vuáṛá|vuoráim|vuárrus|vuorˈrii|vuoˈrâččijm|vuorrâm|vuoˈrâččij|vuoˈrâžává|vyeṛih	<i>verb</i><br><ol><li>to be confused (of a reindeer)</li><li>to play (of a cat or dog)</li></ol>
vuorâš|vuorâččid|vuorrâš|vuorâčijd|vuorâččijttáá|vuorrâšttáá|vuorâčân|vuorâčist|vuorâčijttáá|vuorâčij|vuorâčijn|vuorâččin|vuorâččijguin|vuorâčáid|vuorâčijguin|vuorâččij|vuorâččân|vuorâčeh|vuorâččist|vuorâččijn|vuorâččáid|vuorâččáin|vuorâččeh|vuorâččijd|vuorâčáin	<i>noun</i><br><ol><li>crow</li></ol>
vuosah|vuosâin|vuosâid|vuosáid|vuosâiguin|vuosâittáá|vuosâi	<i>noun</i><br><ol><li>afterbirth</li></ol>
vuossargâ|vuossargân|vuossargâi|vuossaargân|vuossaargâ|vuossaargah|vuossaargâst|vuossaargâin|vuossargâd|vuossargaid|vuossargâttáá|vuossaargâi|vuossargain|vuossargâittáá|vuossaargâid|vuossargâiguin	<i>noun</i><br><ol><li>Monday</li></ol>
vuásku|vuáskun|vuáskud|vuáskunân|vuáskunij|vuáskunttáá|vuáskunijd|vuáskunist|vuáskunijn|vuáskunijttáá|vuáskunáid|vuáskuneh|vuáskunáin|vuáskunijguin	<i>noun</i><br><ol><li>perch (fish)</li></ol>
vuástá|vuáˈstái|vuástáid|vuástán|vuástást|vuásˈtád|vuástáh|vuástáin|vuáˈstáittáá|vuástái|vuásˈtá|vuásˈtáin|vuásˈtán|vuáˈstáttáá|vuásˈtáid|vuáˈstáiguin	<i>noun</i><br><ol><li>cheese</li></ol>
vyeksiđ|vyekˈsiđ	<i>verb</i><br><ol><li>to vomit</li></ol>
váimu|váijoid|vááj̣uin|vááj̣u|vááj̣ui|vááj̣uid|vááj̣uh|váijoin|váj̣uttáá|váimun|váimud|váj̣ui|váj̣uiguin|váj̣uittáá|vááj̣ust|vááimun	<i>noun</i><br><ol><li>heart (organ)</li></ol>
váimusuonâ|váimusuonâst|váimusuonah|váimusuoṇân|váimusuoˈnâttáá|váimusuonnân|váimusuoṇâ|váimusuoˈnâiguin|váimusuonâin|váimusuonâid|váimusuoˈnâi|váimusuonáin|váimusuoˈnâittáá|váimusuonáid|váimusuonnâd|váimusuonâi	<i>noun</i><br><ol><li>artery</li></ol>
válduváimusuonâ|válduváimusuonáid|válduváimusuoˈnâiguin|válduváimusuonâi|válduváimusuonâin|válduváimusuonâid|válduváimusuoˈnâi|válduváimusuonah|válduváimusuoṇâ|válduváimusuonâst|válduváimusuoˈnâittáá|válduváimusuonáin|válduváimusuoṇân|válduváimusuonnâd|válduváimusuonnân|válduváimusuoˈnâttáá	<i>noun</i><br><ol><li>coronary artery</li></ol>
válkká|válkkán|váálkán|válháin|váálhái|váálhást|válháittáá|váálháid|válháiguin|váálhá|válkkád|váálháin|válhái|váálháh|válháid|válháttáá	
áimu|ááj̣uh|ááj̣u|áimud|ááj̣uid|ááj̣ust|áimun|áj̣uttáá|áj̣uittáá|áj̣ui|áijoid|ááj̣uin|áj̣uiguin|ááj̣ui|ááimun|áijoin	<i>noun</i><br><ol><li>air</li></ol>
áinoo	<i>adj</i><br><ol><li>only</li></ol>
áiru|ááj̣uh|ááj̣u|ááirun|ááj̣uid|ááj̣ust|áj̣uttáá|áirun|áj̣ui|áijoid|áirud|ááj̣uin|áj̣uiguin|ááj̣ui|áj̣uittáá|áijoin	<i>noun</i><br><ol><li>oar</li></ol>
ákku|áhuiguin|áákun|ááhuin|áhuittáá|ákkud|áhui|áhuttáá|ááhuh|áhhoin|ákkun|ááhui|ááhuid|áhhoid|ááhust|ááhu	<i>noun</i><br><ol><li>grandmother</li></ol>
ákšu|ákšoid|áákšust|ákšui|ákšuittáá|áákšuid|áákšu|ákšun|áákšun|áákšuh|ákšuttáá|ákšud|áákšuin|ákšoin|áákšui|ákšuiguin	<i>noun</i><br><ol><li>axe</li></ol>
ármu|áármun|árroin|ááṛuin|ááṛui|ááṛu|ááṛuid|árroid|áṛui|ááṛust|áṛuiguin|áṛuttáá|ármud|áṛuittáá|ármun|ááṛuh	<i>noun</i><br><ol><li>mercy</li></ol>
äijih|äijihijn|äijihijd|äijihijttáá|äijihân|äijihid|äijihij|äijihist|äijihin|äijiháin|äijiheh|äijihttáá|äijihijguin|äijiháid	<i>noun</i><br><ol><li>grandfather</li></ol>
älkkee	<i>adj</i><br><ol><li>easy</li></ol>
äänhis	<i>adj</i><br><ol><li>greedy</li></ol>
čaahâđ|čaaḥâđ	<i>verb</i><br><ol><li>to fit</li></ol>
čaaŋŋâđ|čaaŋŋih|čaaŋâšvetteđ|čaŋâžeen|čaaŋâš|čááŋus|čaŋâččij|čaŋâččáid|čaaŋâi|čaaŋŋâp|čaŋ̣âvettee|čááŋŋup|čaŋâžává|čááŋ̣á|čäŋŋeen|čaaŋâid|čaaŋaim|čääŋ̣ih|čaŋâžep|čaŋâččijm|čaŋâččáin|čaŋâžeh|čaŋâččim|čaŋâččih|čaŋâččáim|čäŋŋeeh|čaaŋŋâm|čaŋŋii|čaŋâččijd|čaaŋii|čaaŋain|čaŋ̣âvetteđ|čaŋâččii|čaaŋah|čaaŋŋim|čäŋŋee|čaaŋaid|čaaŋâim|čaaŋŋâv|čáŋŋoon|čaaŋâm|čaaŋâšvettee|čäŋŋeem|čaaŋâ|čááŋŋus	<i>verb</i><br><ol><li>to crawl inside</li></ol>
čalme|čaḷeh|čoḷij|čollijd|čalleest|čoḷijttáá|čaalman|čollijn|čoḷijguin|čooḷij|čaḷettáá|čooḷijd|čaḷe|čooḷijn|čalmed|čalmen	<i>noun</i><br><ol><li>eye</li></ol>
čeeci|čessijn|česijttáá|čeesij|čeeccin|čeesi|česittáá|čeeccid|čeesijn|čeesijd|čeesih|čiäcán|česij|česijguin|čeesist	<i>noun</i><br><ol><li>paternal uncle</li></ol>
čerrih|čerrihttáá|čerrihijguin|čerrihijttáá|čerriháid|čerrihijn|čerrihijd|čerrihin|čerriheh|čerrihist|čerriháin|čerrihân|čerrihij|čerrihid	<i>noun</i><br><ol><li>tern</li><li>arctic tern, Sterna paradisaea</li></ol>
čiehâ|čieˈṿâiguin|čieˈṿâi|čieṿâid|čievˈváid|čieṿâin|čieṿah|čieḥâd|čievˈváin|čieˈṿâittáá|čieḥân|čieṿâ|čieṿâst|čiehân|čieˈṿâttáá|čieṿâi	<i>noun</i><br><ol><li>corner</li></ol>
čiehâđ|čieḥâđ	<i>verb</i><br><ol><li>to hide, to conceal</li></ol>
čieppâđ|čiepˈpâđ	<i>verb</i><br><ol><li>to sink</li></ol>
čieskâđ|čiäsˈkup|čiäsˈkon|čieskâšvetteđ|čieskâi|čieˈskâččáim|čieˈskâččáin|čiäsˈká|čieˈskâžeen|čieskâm|čieˈskâččim|čiesˈkâvettee|čieˈskâččijd|čieˈskâččáid|čiesˈkim|čiesˈkáid|čiäsˈkus|čieskâid|čieˈskâžává|čiesˈkem|čiesˈke|čiesˈkâvetteđ|čieskâ|čiesˈkih|čiäskus|čiesˈkâv|čieˈskâččih|čiesˈken|čieˈskii|čieskâšvettee|čieˈskâččii|čiesˈkeh|čieˈskâžeh|čieskah|čieˈskâččijm|čiesˈkáim|čiesˈkâp|čieˈskâččij|čieskâš|čieskâim|čiesˈkâđ|čieˈskâžep|čiesˈkáin|čiesˈkâm|čiesˈkii	<i>verb</i><br><ol><li>to split, to cleave</li></ol>
čillâ|čiiḷâ|čiiḷâin|čiiḷâi|čiiḷah|čiiḷâid|čilláin|čiḷâiguin|čillân|čiḷâittáá|čilláid|čillâd|čiiḷân|čiḷâi|čiḷâttáá|čiiḷâst	
čimmâ|čiimâi|čiimah|čiimâst|čiimâin|čimmân|čimâiguin|čiimâ|čimâttáá|čimmâd|čimâittáá|čimâi|čiimáin|čiimâid|čiimáid|čiiṃân	
čiähá|čiäṿáin|čiäḥán|čiäṿáid|čiäṿáh|čiäṿást|čiäˈṿáiguin|čiäˈṿáttáá|čiäṿá|čiähán|čiäḥád|čiävˈváid|čiävˈváin|čiäˈṿái|čiäˈṿáittáá|čiäṿái	<i>noun</i><br><ol><li>hoard, cache</li><li>hiding place</li></ol>
čiärruđ	<i>verb</i><br><ol><li>to cry</li></ol>
čiččâm	<i>num</i><br><ol><li>seven</li></ol>
čiđđâ|čiiđ̣ân|čiiđah|čiđâiguin|čiiđâi|čiđâttáá|čiiđâ|čiđâi|čiiđâid|čiiđâin|čiiđáin|čiđâittáá|čiđđâd|čiđđân|čiiđáid|čiiđâst	<i>noun</i><br><ol><li>coal</li></ol>
čohčâ|čoovčâ|čovčâi|čoovčâi|čoovčah|čoohčân|čohčân|čovčâittáá|čoovčâst|čovččáid|čoovčâid|čovčâttáá|čoovčâin|čohčâd|čovččáin|čovčâiguin	<i>noun</i><br><ol><li>autumn, fall</li></ol>
čohčâmáánu|čohčâmánui|čohčâmáánui|čohčâmáánuin|čohčâmáánuid|čohčâmánuiguin|čohčâmáánun|čohčâmáánnun|čohčâmánuttáá|čohčâmáánuh|čohčâmánuittáá|čohčâmáánust|čohčâmáánnud	<i>noun</i><br><ol><li>September</li></ol>
čokkáđ	<i>verb</i><br><ol><li>to sit</li></ol>
čoollâđ	<i>verb</i><br><ol><li>to rub dead skin off the antlers</li></ol>
čoonnâđ	<i>verb</i><br><ol><li>to bind, to tie</li></ol>
čoro|čoroin|čoroi|čoroiguin|čorottáá|čoṛo|čoṛon|čoroh|čoroittáá|čorroon|čoroid|čorrood|čooroost	
čuhčá|čuhčán|čuuvčá|čuuvčái|čuvččáin|čuvčáttáá|čuhčád|čuuvčáin|čuvčáittáá|čuuvčáh|čuvčái|čuuvčáid|čuuhčán|čuvčáiguin|čuuvčást|čuvčáh|čuvččáid	<i>noun</i><br><ol><li>capercaillie</li></ol>
čummâ|čuuṃah|čuuṃâi|čuṃâittáá|čuuṃâ|čuṃâiguin|čuṃâttáá|čuuṃâin|čummâd|čuuṃân|čuuṃâid|čuṃâi|čuuṃâst|čummân|čummáin|čummáid	<i>noun</i><br><ol><li>pile</li></ol>
čuoijâđ|čuoijâm|čuoijim|čyeiˈjeem|čuoˈjâžeen|čuojah|čuoˈj̣âvettee|čuoˈjâččii|čuoˈjâččáin|čuojii|čuájus|čuoˈjâžep|čuoijâp|čuoˈjâččijm|čuoˈjâžává|čuojâm|čuáijus|čuoˈjâččijd|čuojâš|čuojâim|čuoijih|čuojáim|čuojáid|čyej̣ih|čuoˈjâččáim|čuojâid|čyeiˈjeeh|čuojâ|čuoˈjâččij|čuojâšvetteđ|čyeiˈjeen|čuoiˈjii|čuoˈjâččáid|čuoˈjâžeh|čuojâšvettee|čuáj̣á|čuojâi|čuoijâv|čuojáin|čuoˈjâččih|čuáiˈjoon|čuoˈj̣âvetteđ|čuoˈjâččim|čuáijup|čyeiˈjee	<i>verb</i><br><ol><li>to sound, to make a sound</li></ol>
čuollâđ|čuolah|čuollâp|čyelˈleeh|čuoˈlâččijd|čyelˈleen|čuolâšvetteđ|čuolâid|čuoˈlâččáid|čuolâ|čuoˈḷâvetteđ|čuollim|čuollâm|čuollâv|čuollih|čuoˈlâččáin|čuálus|čuoˈlâžep|čuoláim|čuolâš|čuoˈlâžeen|čuolˈlii|čyeḷih|čuáḷá|čuoˈlâččijm|čuoˈlâččim|čuoˈlâččáim|čuoˈlâččii|čuoˈlâččij|čuolâim|čuolâi|čuoˈlâžeh|čuoláid|čuoˈlâžává|čuoláin|čuolii|čuolâm|čuálˈloon|čuállus|čyelˈleem|čuolâšvettee|čuállup|čuoˈlâččih|čuoˈḷâvettee|čyelˈlee	<i>verb</i><br><ol><li>to chop</li></ol>
čuomâ|čuomâid|čuoˈmâi|čuoˈmâittáá|čuoṃân|čuomâi|čuoˈmâiguin|čuoˈmâttáá|čuommâd|čuomáid|čuoṃâ|čuomâin|čuommân|čuomâst|čuomáin|čuomah	<i>noun</i><br><ol><li>fish skin</li></ol>
čuoppâđ|čuopˈpâđ	<i>verb</i><br><ol><li>to cut</li></ol>
čuppâ|čuupân|čupâttáá|čuupâst|čuppân|čuppâd|čuupâi|čuupâin|čupâittáá|čuupah|čuupâid|čuppáid|čuupâ|čuppáin|čupâi|čupâiguin	
čuuhâđ|čuuḥâđ	<i>verb</i><br><ol><li>to sharpen</li></ol>
čuážžuđ|čuážˈžuđ	<i>verb</i><br><ol><li>to stand</li></ol>
čuđe|čuuđij|čuđđeed|čuuđijd|čuđ̣án|čuuđeest|čuđijttáá|čuđettáá|čuđijguin|čuđ̣e|čuđđeen|čuđij|čuđeh|čuuđijn	<i>noun</i><br><ol><li>foe, fiend</li></ol>
čááná|čááṇá|čáánáid|čánáittáá|čáánást|čánái|čáánáin|čánáiguin|čáánnán|čáánáh|čánáttáá|čáánái|čááṇán|čáánnád	<i>noun</i><br><ol><li>polypore</li></ol>
čällee|čällen|čälled|čälleeh|čälleid|čällein|čälleettáá|čällest|čälleittáá|čälleiguin|čällei	<i>noun</i><br><ol><li>writer</li><li>bookkeeper</li><li>secretary</li></ol>
čääci|čääccid|čääsist|čäsittáá|časijttáá|časij|čääsih|čassijn|čaasijd|čaasij|čaasijn|časijguin|čáácán|čääccin|čääsi|čassijd	<i>noun</i><br><ol><li>water</li></ol>
čäälliđ	<i>verb</i><br><ol><li>to write</li></ol>
ŋ|Ŋ	<i>character</i><br><ol><li>The eighteenth letter of the Inari Sami alphabet, written in the Latin script.</li></ol>
šaddo|šadoh|šado|šadoi|šaddoid|šadoin|šaddod|šaddoin|šadoittáá|šaddon|šadoiguin|šadottáá|šaadon|šaddoost	<i>noun</i><br><ol><li>plant</li></ol>
šaddoviste|šaddovistijguin|šaddoviistán|šaddovistij|šaddovisteh|šaddovistijn|šaddovistijttáá|šaddoviistijd|šaddovistijd|šaddoviistijn|šaddovisteest|šaddovisten|šaddovisted|šaddovistettáá|šaddoviistij	<i>noun</i><br><ol><li>greenhouse</li></ol>
šiettâđ|šietˈtâđ	
šiev	
škovlâ|škoṿâi|škovváid|škovváin|škoṿâttáá|škooṿâst|škovlân|škooṿâ|škoovlân|škoṿâittáá|škooṿâid|škooṿâin|škooṿah|škooṿâi|škoṿâiguin|škovlâd	<i>noun</i><br><ol><li>school</li></ol>
šlaajâ|šlaajâin|šlaajáin|šlaaijâd|šlajâittáá|šlaajâid|šlajâi|šlaajâi|šlajâiguin|šlaajâst|šlaaj̣â|šlajâttáá|šlaajáid|šlaaijân|šlaajah|šlaajân	<i>noun</i><br><ol><li>kind, sort, race</li></ol>
šnukármistiđ	<i>verb</i><br><ol><li>to fall headlong</li></ol>
šovkkâd	<i>adj</i><br><ol><li>pale</li></ol>
šyehkiđ|šyehˈkiđ	<i>verb</i><br><ol><li>to sigh (repeatedly)</li><li>to pant (of a tired reindeer)</li></ol>
ž|Ž	<i>character</i><br><ol><li>The twenty-ninth letter of the Inari Sami alphabet, written in the Latin script.</li></ol>
