A	<i>character</i><br><ol><li>The first letter of the Inupiaq alphabet, written in the Latin script.</li></ol>
Amiġaiqsivik	<i>name</i><br><ol><li>August (lit. caribou moulting time)</li></ol>
Kisaġvik	<i>name</i><br><ol><li>Anchorage, Alaska</li></ol>
Naluaġmiu|Naluaġmiuk|Naluaġmiut	<i>name</i><br><ol><li>white person</li></ol>
Naluaġmiuyaaq|Naluaġmiuyaak|Naluaġmiuyaat	<i>name</i><br><ol><li>half white person</li></ol>
Tanik|Tannak|Tanŋit	<i>name</i><br><ol><li>white person</li></ol>
Tinaaq|Tinaat|Tinaak	<i>name</i><br><ol><li>Athabascan, Dene, Native American, American Indian</li></ol>
Tinaaġmiu|Tinaaġmiut|Tinaaġmiuk	<i>name</i><br><ol><li>Athabascan, Dene, Native American, American Indian</li></ol>
Tiŋmirrat Tatqiat	<i>name</i><br><ol><li>month of April (lit. month of the geese)</li></ol>
Tiŋŋivik	<i>name</i><br><ol><li>August (lit. the time to fly away)</li></ol>
a	<i>intj</i><br><ol><li>listen, hark</li><li>oops (used to acknowledge an error)</li><li>oh (used to express surprise)</li></ol>
aa	<i>intj</i><br><ol><li>yes, I know</li><li>I agree: expresses listener's agreement with storyteller or speaker</li><li>expresses exasperation, criticism or dismay over what another person does or says, said in breathy voice</li><li>expression of surprise or awe</li></ol>
aapa	<i>noun</i><br><ol><li>father</li></ol>
aapu|aapuk|aaput	<i>noun</i><br><ol><li>apple</li></ol>
aapuq|aapuk|aaput	<i>noun</i><br><ol><li>apple</li></ol>
aaquaksraatchiaq|aaquaksraatchiat|aaquaksraatchiak	<i>noun</i><br><ol><li>old woman</li></ol>
aasii	<i>particle</i><br><ol><li>and so, and then</li></ol>
aasiiñ	<i>particle</i><br><ol><li>and so, and then</li></ol>
aasriiñ	<i>particle</i><br><ol><li>and so, and then</li></ol>
aasrivak|aasrivaak|aasrivaich	<i>noun</i><br><ol><li>spider</li></ol>
aaġlu|aaġluk|aaġlut	<i>noun</i><br><ol><li>killer whale, orca</li></ol>
agaayyuliqsi|agaayyuliqsik|agaayyuliqsit	<i>noun</i><br><ol><li>pastor, missionary</li></ol>
agga	<i>det</i><br><ol><li>across there [visible, covering a large area or in motion]</li></ol>
aglaan	<i>conj</i><br><ol><li>up to, as far as</li><li>but, however</li></ol>
aglagviksraq|aglagviksrat|aglagviksrak	<i>noun</i><br><ol><li>writing paper, writing material</li></ol>
aglaun|aglautit|aglautik	<i>noun</i><br><ol><li>pencil, pen</li></ol>
agliutraq|agliutrak|agliutrat	<i>noun</i><br><ol><li>picture</li></ol>
agviq|agvigich|agvak	<i>noun</i><br><ol><li>bowhead whale</li></ol>
aippaani	<i>adv</i><br><ol><li>in the distant memorable past, long ago</li></ol>
aippaavak	<i>adv</i><br><ol><li>distant memorable past</li></ol>
aiviq|aivvak|aivġich	<i>noun</i><br><ol><li>walrus</li></ol>
aiviqiak	<i>noun</i><br><ol><li>pectoral sandpiper (Calidris melanotos)</li></ol>
akiani	<i>adv</i><br><ol><li>directly across</li></ol>
akimiakipiaqpakpiŋatchaq	<i>num</i><br><ol><li>153.6 trillion</li></ol>
akimiaq	<i>num</i><br><ol><li>fifteen</li></ol>
akimiaq atausiq	<i>num</i><br><ol><li>sixteen</li></ol>
akimiaq malġuk	<i>num</i><br><ol><li>seventeen</li></ol>
akimiaq piŋasut	<i>num</i><br><ol><li>eighteen</li></ol>
akimiaġutaiḷaq	<i>num</i><br><ol><li>fourteen</li></ol>
akisi|akisik|akisit	<i>noun</i><br><ol><li>pillow</li></ol>
akiñ|akisik|akisit	<i>noun</i><br><ol><li>pillow</li></ol>
akiḷiun|akiḷiutit|akiḷiutik	<i>noun</i><br><ol><li>wage, price, payment</li></ol>
akkak|akkat|akkaak	<i>noun</i><br><ol><li>father's brother, uncle</li></ol>
akku	<i>adv</i><br><ol><li>a short while ago</li></ol>
akkusraaġruk	<i>adv</i><br><ol><li>a long while ago</li></ol>
akunġani	<i>adv</i><br><ol><li>located within something</li></ol>
akunġatni	<i>adv</i><br><ol><li>located among</li></ol>
akutuqpalik|akutuqpallak|akutuqpalgich	<i>noun</i><br><ol><li>leaf</li></ol>
akła|akłak|akłat	<i>noun</i><br><ol><li>brown bear, grizzly bear</li></ol>
akłaq|akłak|akłat	<i>noun</i><br><ol><li>brown bear, grizzly bear</li></ol>
alla|allat|allak	<i>particle</i><br><ol><li>another one, different one</li></ol>
aluk|aluit	<i>noun</i><br><ol><li>berry (North Slope, Coastal)</li></ol>
aluutaq|aluutat|aluutak	<i>noun</i><br><ol><li>northern shoveler (Spatula clypeata)</li><li>spoon</li></ol>
alġaqsruun|alġaqsruutik|alġaqsruutit	<i>noun</i><br><ol><li>advice</li></ol>
amaġuq|amaqqut|amaqquk	<i>noun</i><br><ol><li>wolf</li></ol>
amiġaq|amiqqak|amiqqat	<i>noun</i><br><ol><li>bark</li></ol>
amiḷiġaq|amiḷiqqak|amiḷiqqat	<i>noun</i><br><ol><li>ulna, tibia</li></ol>
anuġi	<i>noun</i><br><ol><li>wind</li></ol>
apiqsruun|tapiqsruutit|apiqsruutik	<i>noun</i><br><ol><li>question</li></ol>
apqun|apqutik|apqutit	<i>noun</i><br><ol><li>path, road, way</li></ol>
apun|aputik|aputit	<i>noun</i><br><ol><li>snow (on the ground)</li></ol>
aqargigiaq|aqargigiat|aqargigiak	<i>noun</i><br><ol><li>Sabine's gull, Xema sabini</li></ol>
aqargiq|aqargich|aqargik	<i>noun</i><br><ol><li>ptarmigan</li></ol>
aqpik|aqpiik|aqpiit	<i>noun</i><br><ol><li>salmonberry, cloudberry</li></ol>
aqsraaq|aqsraat|aqsraak	<i>noun</i><br><ol><li>ball (Malimiut)</li></ol>
aqsraaqti|aqsraaqtit|aqsraaqtik	<i>noun</i><br><ol><li>basketball player</li></ol>
aqu	<i>noun</i><br><ol><li>stern</li><li>beaver</li></ol>
aquani|aquatni|aquakni	<i>adv</i><br><ol><li>behind it</li></ol>
aquti|aqutik|aqutit	<i>noun</i><br><ol><li>ship's pilot, tillerman</li></ol>
argak|argaich	<i>noun</i><br><ol><li>hand</li></ol>
asiaq|asiak|asiat	<i>noun</i><br><ol><li>berry (North Slope, Coastal)</li></ol>
asriaq|asriat|asriak	<i>noun</i><br><ol><li>berry (Kobuk)</li></ol>
asriavik|asriaviik|asriaviich	<i>noun</i><br><ol><li>blueberry, Vaccinium uliginosum</li><li>crowberry, Empetrum nigrum (Tikiġaq)</li></ol>
ataa	<i>noun</i><br><ol><li>its underside, ventral area, the area under something</li></ol>
ataani|ataatni|ataakni	<i>adv</i><br><ol><li>located under it</li></ol>
ataramik	<i>adv</i><br><ol><li>always</li></ol>
atausiq	<i>num</i><br><ol><li>one</li></ol>
atausriq	<i>num</i><br><ol><li>one</li></ol>
atchak|atchaak|atchaat	<i>noun</i><br><ol><li>aunt, father's sister</li></ol>
atigi	<i>noun</i><br><ol><li>pullover parka</li></ol>
atigit	<i>noun</i><br><ol><li>pullover parka</li></ol>
atikłuk|atikłuich|atikłuuk	<i>noun</i><br><ol><li>parka cover, shirt</li></ol>
atimni	<i>adv</i><br><ol><li>located under me</li></ol>
atipni	<i>adv</i><br><ol><li>located under you</li></ol>
atla|atlak|atlat	<i>particle</i><br><ol><li>another one, different one</li></ol>
atniutaq	<i>noun</i><br><ol><li>a pain that does not go away immediately</li></ol>
atniġñaq	<i>noun</i><br><ol><li>pain</li></ol>
auksruaq|auksruak|auksruat	<i>noun</i><br><ol><li>phalarope</li></ol>
auyugaqtuaq	<i>noun</i><br><ol><li>leprosy</li><li>incurable disease</li></ol>
aviññaurayuuq|aviññaurayuuk|aviññaurayuut	<i>noun</i><br><ol><li>beetle</li></ol>
ayak	<i>noun</i><br><ol><li>post, pillar</li><li>A harpoon used for whaling.</li></ol>
ayaġruksaaq|ayaġruksaak|ayaġruksaat	<i>noun</i><br><ol><li>aunt, mother's sister</li></ol>
ayuktaq|ayuktak|ayuktat	<i>noun</i><br><ol><li>ball (North Slope)</li></ol>
aġnalluataq|aġnalluatat|aġnalluatak	<i>noun</i><br><ol><li>a good woman</li></ol>
aġnaq|aġnak|aġnat	<i>noun</i><br><ol><li>woman</li></ol>
aġra	<i>noun</i><br><ol><li>ash</li></ol>
aġvak|aġvaich|aġvaak	<i>noun</i><br><ol><li>palm of hand</li></ol>
aġviq|aġviġich|aġvaich|aġvak|aġvaak	<i>noun</i><br><ol><li>bowhead whale</li></ol>
aġviġluaq|aġviġluat|aġviġluak	<i>noun</i><br><ol><li>gray whale</li></ol>
ałła|ałłat|ałłak	<i>particle</i><br><ol><li>another one, different one</li></ol>
aŋaayyuliqsi|aŋaayyuliqsit|aŋaayyuliqsik	<i>noun</i><br><ol><li>pastor, missionary</li></ol>
aŋatchiaq|aŋatchiak|aŋatchiat	<i>noun</i><br><ol><li>mother's brother, uncle</li></ol>
aŋatkuq|aŋatkuk|aŋatkut	<i>noun</i><br><ol><li>shaman</li></ol>
aŋayuqaak	<i>noun</i><br><ol><li>parents</li></ol>
aŋun|aŋutit|aŋutik	<i>noun</i><br><ol><li>man</li></ol>
aŋuun|aŋuutik|aŋuutit	<i>noun</i><br><ol><li>paddle, propeller, fin</li></ol>
aŋuyautairrun	<i>noun</i><br><ol><li>peace</li></ol>
aŋuyautnaq|aŋuyautnat|aŋuyautnak	<i>noun</i><br><ol><li>an abandoned person or thing</li></ol>
aŋuyałiq	<i>noun</i><br><ol><li>war</li></ol>
aŋuyyiuqtit	<i>noun</i><br><ol><li>army, an army of soldiers</li></ol>
chaiyu	<i>noun</i><br><ol><li>tea (Qawiaraq)</li></ol>
iblin	<i>pron</i><br><ol><li>you</li></ol>
igaliq|igallak|igalġich	<i>noun</i><br><ol><li>window</li></ol>
iggiaq	<i>noun</i><br><ol><li>throat</li></ol>
igitaq|igitak|igitat	<i>noun</i><br><ol><li>an abandoned person or thing</li></ol>
iglaaq|iglaak|iglaat	<i>noun</i><br><ol><li>visitor, guest</li></ol>
iglu|iglut|igluk	<i>noun</i><br><ol><li>house (North Slope)</li><li>beaver dam (Malimiut, Seward Peninsula)</li></ol>
igniqauqtuq	<i>noun</i><br><ol><li>Steller's eider, Polysticta stelleri</li></ol>
ii	<i>intj</i><br><ol><li>yes</li></ol>
iiraġaq|iiraqqak|iiraqqat	<i>noun</i><br><ol><li>pill</li></ol>
iki	<i>noun</i><br><ol><li>wound</li></ol>
ikik|ikiich|ikkik	<i>noun</i><br><ol><li>vertebra</li><li>block of wood</li></ol>
ikiniq	<i>noun</i><br><ol><li>wound</li></ol>
iknisaiḷaq|iknisaiḷak|iknisaiḷat	<i>noun</i><br><ol><li>boreal chickadee (Poecile hudsonicus)</li></ol>
ikpaksraq	<i>adv</i><br><ol><li>yesterday</li></ol>
iksriktaayuuq|iksriktaayuich|iksriktaayuuk	<i>noun</i><br><ol><li>yellow wagtail</li></ol>
ikña|ichigua|ichiguak	<i>det</i><br><ol><li>the one across there [visible, in a limited area or not in motion]</li></ol>
ikłiġvik|ikłiġviich|ikłiġviik	<i>noun</i><br><ol><li>red fox sparrow (Passerella iliaca)</li></ol>
iluqaan|iluqaaknik|iluqaitñik	<i>pron</i><br><ol><li>all of it or the whole thing</li></ol>
iluqaitñik	<i>pron</i><br><ol><li>all of the things</li></ol>
iluqatiŋ	<i>pron</i><br><ol><li>all of them</li></ol>
ilvich|iliptiknik|ilipkun|ilipnik|ilipsigun|ilipsini|ilipni|ilipniñ|ilipsitñik|ilipsi|ilipsitniñ|iliptikkun|iliptun|ilipsitnun|ilipsisun|iliptiknun|uvamnun|iliptikni|iliptikniñ|iliptitnun|iliptik|uvaptiknun|iliptiktun|ilipnun|iliptitun	<i>pron</i><br><ol><li>you</li></ol>
ilvin	<i>pron</i><br><ol><li>you</li></ol>
ilvit	<i>pron</i><br><ol><li>you</li></ol>
ilviñ|ilivsi|ilivsik	<i>pron</i><br><ol><li>you</li></ol>
imaksraq|imaksrat|imaksraak	<i>noun</i><br><ol><li>yeast</li></ol>
imaġniq|imaġniġich|imaġnaak	<i>noun</i><br><ol><li>puddle</li><li>wet spot, water on tundra</li></ol>
imiq|imġich|immak	<i>noun</i><br><ol><li>drinking water</li><li>alcohol</li><li>any potable beverage</li></ol>
imiqaġvik|imiqaġviik|imiqaġviich	<i>noun</i><br><ol><li>water container</li></ol>
immiñiq|immiññak|immiñġich	<i>noun</i><br><ol><li>puddle</li><li>wet spot, water on tundra</li></ol>
ipiutaq|ipiutat|ipiutak	<i>noun</i><br><ol><li>umbilical cord</li></ol>
ipiġautaq|ipiġautat|ipiġautak	<i>noun</i><br><ol><li>ax, axe</li></ol>
ipnaiq|ipnaik|ipnaich	<i>noun</i><br><ol><li>Dall sheep, Ovis dalli</li></ol>
ippaksraq	<i>adv</i><br><ol><li>yesterday</li></ol>
iqaluk|iqaluit|iqalluk	<i>noun</i><br><ol><li>fish</li></ol>
iraiyayuuq|iraiyayuuk|iraiyayuut	<i>noun</i><br><ol><li>great grey shrike, Lanius excubitor</li></ol>
iri|irrak|irrit	<i>noun</i><br><ol><li>(anatomy) eye</li></ol>
isaġulik	<i>noun</i><br><ol><li>angel</li></ol>
isiŋuatchauraq|isiŋuatchaurak|isiŋuatchaurat	<i>noun</i><br><ol><li>male whale</li></ol>
israġulik|israġulġich|israġullak	<i>noun</i><br><ol><li>angel</li></ol>
israġuq|israqqut|israqquk	<i>noun</i><br><ol><li>wing</li></ol>
itcha	<i>det</i><br><ol><li>across there (visible, in a limited area or not in motion)</li></ol>
itchaksrat	<i>num</i><br><ol><li>six</li></ol>
itiq|itqit|itqich|ittak	<i>noun</i><br><ol><li>anus</li></ol>
itiġiaq|itiġiat|itiġiak	<i>noun</i><br><ol><li>weasel</li></ol>
itiġuq|itiqqut|itiqquk	<i>noun</i><br><ol><li>urine (Kobuk)</li><li>sour urine (North Slope)</li></ol>
ivgun|ivgutit|ivgutik	<i>noun</i><br><ol><li>towel, paper towel</li></ol>
ivruqsiñ|ivruqsisit|ivruqsisik	<i>noun</i><br><ol><li>pick axe</li></ol>
iyaġak|iyaqqak|iyaġaich	<i>noun</i><br><ol><li>stone, rock</li></ol>
iyyaġriq|iyyaġrich|iyyaġrik	<i>noun</i><br><ol><li>black bear</li></ol>
iñuiññaq	<i>num</i><br><ol><li>twenty</li></ol>
iñuiññaġutaiḷaq	<i>num</i><br><ol><li>nineteen</li></ol>
iñuuqan|iñuuqatit|iñuuqatik	<i>noun</i><br><ol><li>person who is born in the same year as self or others</li></ol>
iġñiq|iġñiġich|iġñak	<i>noun</i><br><ol><li>son</li></ol>
iġġuġviuraq|iġġuġviurak|iġġuġviurat	<i>noun</i><br><ol><li>wash basin</li></ol>
iłhuaġniq|iłhuaġniġich|iłhuaġnaak	<i>noun</i><br><ol><li>rainbow smelt (Osmerus mordax)</li></ol>
iłuiḷḷiułiq	<i>noun</i><br><ol><li>affliction, agony</li></ol>
iŋiulik|iŋiullak|iŋiulgich	<i>noun</i><br><ol><li>a big wave, swell</li></ol>
iŋutuk	<i>noun</i><br><ol><li>young female whale [choice whale, soft muktuk]</li></ol>
iŋutuvak|iŋutuvvak|iŋutuvaich	<i>noun</i><br><ol><li>large whale with rolled blubber on the back</li></ol>
iḷalulasraaq|iḷalulasraak|iḷalulasraat	<i>noun</i><br><ol><li>whirlwind</li></ol>
iḷaqan|iḷaqatik|iḷaqatit	<i>noun</i><br><ol><li>spouse</li></ol>
iḷaqataiqsuaq|iḷaqataiqsuak|iḷaqataiqsuat	<i>noun</i><br><ol><li>widow, widower</li></ol>
iḷaqatnigutlaiḷaq|iḷaqatnigutlaiḷat|iḷaqatnigutlaiḷak	<i>noun</i><br><ol><li>bachelor, spinster</li></ol>
iḷaviñiq|iḷaviñġich|iḷaviññak	<i>noun</i><br><ol><li>back</li></ol>
iḷu	<i>noun</i><br><ol><li>the contents of the abdominal cavity</li></ol>
iḷuqutam panaŋa|iḷuqutam panaŋi	<i>noun</i><br><ol><li>porcupine quill</li></ol>
kakkitvik|kakkitviik|kakkitviich	<i>noun</i><br><ol><li>pincushion</li></ol>
kaliikkaq|kaliikkaich|kaliikkaak	<i>noun</i><br><ol><li>paper</li></ol>
kamikłuuk|kamikłuich	<i>noun</i><br><ol><li>pants, trousers</li></ol>
kanaknaq	<i>noun</i><br><ol><li>west wind</li></ol>
kanuŋŋiq|kanuŋŋich|kanuŋŋiik	<i>noun</i><br><ol><li>diamond willow</li></ol>
katchi|katchik|katchich	<i>noun</i><br><ol><li>wall</li></ol>
katchiq|katchik|katchiik|katchich	<i>noun</i><br><ol><li>wall</li></ol>
kauk|kaugich	<i>noun</i><br><ol><li>walrus skin [for food]</li></ol>
kavlaq|kavlak|kavlat	<i>noun</i><br><ol><li>bearberry</li></ol>
kia	<i>pron</i><br><ol><li>whose</li></ol>
kigun|kigutik|kigutit	<i>noun</i><br><ol><li>tooth</li></ol>
kiksrat	<i>noun</i><br><ol><li>a path cut through bush or trees</li></ol>
kiktuqsralik|kiktuqsralgich|kiktuqsrallak	<i>noun</i><br><ol><li>ant</li></ol>
kilgun|kilgutik|kilgutit	<i>noun</i><br><ol><li>warning, that which has been told, a message of forewarning</li></ol>
killalik|killalgich|killallak	<i>noun</i><br><ol><li>white-winged scoter, Melanitta deglandi</li></ol>
kiluani|kiluakni|kiluatni	<i>adv</i><br><ol><li>behind it (a house, tent, building structure)</li></ol>
kiluussaq|kiluussat|kiluussak	<i>noun</i><br><ol><li>padlock</li></ol>
kimmigñaq	<i>noun</i><br><ol><li>lingonberry, Vaccinium vitis-idaea</li></ol>
kipniqutaq|kipniqutak|kipniqutat	<i>noun</i><br><ol><li>block of wood</li></ol>
kisaq|kisak|kisat	<i>noun</i><br><ol><li>anchor</li></ol>
kisum	<i>pron</i><br><ol><li>whose</li></ol>
kivaknaq	<i>noun</i><br><ol><li>east wind</li></ol>
kiyipigaq|kiyipikkat|kiyipikkak	<i>noun</i><br><ol><li>backbone, spinal column</li></ol>
kiña|kisuk|kisut	<i>pron</i><br><ol><li>who</li></ol>
kiñaliqaa	<i>adv</i><br><ol><li>anyone, any person</li></ol>
kiñapayaaq	<i>adv</i><br><ol><li>anyone, any person</li></ol>
kiŋmayuk|kiŋmayuich|kiŋmayuuk	<i>noun</i><br><ol><li>beetle</li></ol>
kiḷḷiġruaq	<i>noun</i><br><ol><li>leprosy</li><li>impetigo</li><li>bad sore</li></ol>
kumak|kumaich|kumaak	<i>noun</i><br><ol><li>louse</li></ol>
kuniaq|kuniat|kuniak	<i>noun</i><br><ol><li>pig</li></ol>
kuugaatchiaq|kuugaatchiak|kuugaatchiat	<i>noun</i><br><ol><li>rivulet, brook</li></ol>
kuuk|kurrak|kuugich	<i>noun</i><br><ol><li>river</li></ol>
kuukpiaq	<i>noun</i><br><ol><li>coffee</li></ol>
kuukukiaq|kuukukiak|kuukukiat	<i>noun</i><br><ol><li>common snipe, Gallinago gallinago</li></ol>
kuuppiaq	<i>noun</i><br><ol><li>coffee</li></ol>
kuutchiñaak	<i>noun</i><br><ol><li>pelvic girdle</li></ol>
livilivillaqpak|livilivillaqpaich|livilivillaqpaak	<i>noun</i><br><ol><li>semipalmated sandpiper, Calidris pusilla</li></ol>
livilivillauraq|livilivillaurak|livilivillaurat	<i>noun</i><br><ol><li>least sandpiper, Calidris minutilla</li></ol>
maani	<i>adv</i><br><ol><li>around here</li></ol>
makpiġñiq|makpiġñiġich|makpiġñaak	<i>noun</i><br><ol><li>page, sheet of paper</li></ol>
maktak|maktaak|maktaich	<i>noun</i><br><ol><li>whale skin with blubber, muktuk</li></ol>
malġi|malġich|malġik	<i>noun</i><br><ol><li>Pacific loon, Gavia pacifica</li></ol>
malġuk	<i>num</i><br><ol><li>two</li></ol>
mamitaksraq|mamitaksrat|mamitaksrak	<i>noun</i><br><ol><li>bandage</li></ol>
mammaun|mammautik|mammautit	<i>noun</i><br><ol><li>udder</li></ol>
mapsaq	<i>noun</i><br><ol><li>pancreas</li></ol>
marrumani|makunani|makuŋnaŋni	<i>adv</i><br><ol><li>this one [boat, river, train, airplane, area without confines, or a person who is not aware of activity around him, lengthy or in motion, visible]</li></ol>
misiqqaaqauraq|misiqqaaqaurat|misiqqaaqaurak	<i>noun</i><br><ol><li>black-capped chickadee (Poecile atricapillus)</li></ol>
mitqutaiḷaq|mitqutaiḷat|mitqutaiḷak	<i>noun</i><br><ol><li>arctic tern, Sterna paradisaea</li></ol>
miñulġun|miñulġutik|miñulġutit	<i>noun</i><br><ol><li>paint</li></ol>
miġaruuraq|miġaruurat|miġaruurak	<i>noun</i><br><ol><li>baby, infant</li></ol>
miġiaq	<i>noun</i><br><ol><li>vomit</li></ol>
mumitchiaq|mumitchiat|mumitchiak	<i>noun</i><br><ol><li>upper leg, drumstick</li></ol>
naami	<i>pron</i><br><ol><li>where</li></ol>
naarrak	<i>noun</i><br><ol><li>abdomen</li></ol>
nagruk|nagruich|nagruuk	<i>noun</i><br><ol><li>antler, horn</li></ol>
nagrulik|nagrulgich|nagrullak	<i>noun</i><br><ol><li>horned lark (Eremophila alpestris)</li></ol>
nakaaq|nakaat|nakaak	<i>noun</i><br><ol><li>water weed</li></ol>
nakasruk|nakasruich|nakasruuk	<i>noun</i><br><ol><li>bladder</li></ol>
nakasuk|nakasuit|nakasuuk	<i>noun</i><br><ol><li>bladder</li></ol>
nakiñ	<i>pron</i><br><ol><li>where from</li></ol>
naliak	<i>pron</i><br><ol><li>which one of these two</li></ol>
naliat	<i>pron</i><br><ol><li>which one of these (three or more)</li></ol>
nalliak	<i>pron</i><br><ol><li>which one of these two</li></ol>
nalliat	<i>pron</i><br><ol><li>which one of these (three or more)</li></ol>
naluaq|naluat|naluak	<i>noun</i><br><ol><li>bleached seal-skin</li></ol>
nani	<i>pron</i><br><ol><li>where</li></ol>
naniq	<i>noun</i><br><ol><li>lightsource, source of light</li><li>naniq: A traditional oil lamp of the Inupiat</li></ol>
nanuq|nannut|aluit|nannuk	<i>noun</i><br><ol><li>polar bear</li></ol>
napaaqtum aqargiq|napaaqtum aqargich|napaaqtum aqargik	<i>noun</i><br><ol><li>Hudsonian spruce grouse, Falcipennis canadensis</li></ol>
napmun	<i>pron</i><br><ol><li>where to</li></ol>
narvaq|narvak|narvat	<i>noun</i><br><ol><li>lake</li></ol>
nasralik|nasrallak|nasralgich	<i>noun</i><br><ol><li>parka cover</li></ol>
natmagvik|natmagviich|natmagviik	<i>noun</i><br><ol><li>a camping pack, backpack as of canvas, nylon or sealskin</li><li>a packsack</li></ol>
natmak	<i>noun</i><br><ol><li>a load carried on the back</li></ol>
naukun	<i>pron</i><br><ol><li>by which way, how</li></ol>
nauyaq|nauyat|nauyak	<i>noun</i><br><ol><li>seagull</li></ol>
nauyavasrugruk|nauyavasrugruuk|nauyavasrugruich	<i>noun</i><br><ol><li>glaucous gull, Larus hyperboreus</li></ol>
nauŋ	<i>pron</i><br><ol><li>where</li></ol>
nayaŋŋaaq|nayaŋŋaak|nayaŋŋaat	<i>noun</i><br><ol><li>common scoter, Melanitta nigra</li></ol>
naġiaq|naġiat|naġiak	<i>noun</i><br><ol><li>bait</li></ol>
naŋinnaq	<i>verb</i><br><ol><li>to be annoying</li></ol>
nigatchiaq|nigatchiak|nigatchiat	<i>noun</i><br><ol><li>snare (for small game)</li><li>rainbow</li></ol>
nigiqpaq	<i>noun</i><br><ol><li>north, northwesterly wind</li></ol>
niiqpaq	<i>noun</i><br><ol><li>north, northwesterly wind</li></ol>
niliġnaq|niliġnak|niliġnat	<i>noun</i><br><ol><li>bean</li></ol>
nipi|nipik|nipit	<i>noun</i><br><ol><li>voice, sound</li></ol>
niqi|niqit|niqik	<i>noun</i><br><ol><li>food, meat</li></ol>
niu	<i>noun</i><br><ol><li>leg</li></ol>
niutuiyiq	<i>noun</i><br><ol><li>lynx</li></ol>
niviaqsiaq|niviaqsiat|niviaqsiak	<i>noun</i><br><ol><li>young, unmarried girl, miss</li></ol>
niġġaaġruk	<i>noun</i><br><ol><li>north wind</li></ol>
niġḷiktaaq|Nunamiut|niġḷiktaat|niġḷiktaak	<i>noun</i><br><ol><li>uvula</li></ol>
nukavlauluk	<i>noun</i><br><ol><li>a large walrus bull</li></ol>
nukavlu	<i>noun</i><br><ol><li>a large walrus bull</li></ol>
nukuutchiqiq|nukuutchiqich|nukuutchiqik	<i>noun</i><br><ol><li>belted kingfisher (Megaceryle alcyon)</li></ol>
nuliaq|nuliat|nuliak	<i>noun</i><br><ol><li>wife</li></ol>
nuliaġutlaiḷaq|nuliaġutlaiḷat|nuliaġutlaiḷak	<i>noun</i><br><ol><li>bachelor</li></ol>
nuliiqsuaq|nuliiqsuak|nuliiqsuat	<i>noun</i><br><ol><li>widower</li></ol>
nunavak|nunavaich|nunavaak	<i>noun</i><br><ol><li>an walrus on the ice</li></ol>
nunaŋiak|nunaŋiagich	<i>noun</i><br><ol><li>alder tree, alder bark</li><li>rust-colored dye from alder bark</li></ol>
nutaaq|nutaat|nutaqqat|nutaqqak	<i>noun</i><br><ol><li>young person, new thing</li></ol>
nuŋŋaqtuaġruk|nuŋŋaqtuaġruich|nuŋŋaqtuaġruuk	<i>noun</i><br><ol><li>white-crowned sparrow (Zonotrichia leucophrys)</li></ol>
paannaq|paatnat|paatnaak|Slope	<i>noun</i><br><ol><li>partner</li></ol>
paatnaq|paatnat|paatnaak	<i>noun</i><br><ol><li>partner</li></ol>
paaŋuutik	<i>noun</i><br><ol><li>a double-bladed paddle</li></ol>
pagga	<i>det</i><br><ol><li>up there above (and behind speaker), away from shore, landwards, mountainwards (visible, in motion or covers a large area)</li></ol>
paipiuraq|paipiurak|paipurat	<i>noun</i><br><ol><li>baby, infant</li></ol>
paisugruk	<i>noun</i><br><ol><li>red-breasted merganser, Mergus serrator</li></ol>
pakimna	<i>det</i><br><ol><li>that one up there on the roof (not visible)</li></ol>
palliksraq|palliksrat|palliksrak	<i>noun</i><br><ol><li>pussy willow</li></ol>
paluqtaq|paluktat|paluktak	<i>noun</i><br><ol><li>beaver (Seward Peninsula)</li></ol>
pamani	<i>adv</i><br><ol><li>located back there in an area (not visible)</li></ol>
pamma	<i>det</i><br><ol><li>back there behind, landwards, mountainwards [not visible]</li></ol>
papa|papat|papak	<i>noun</i><br><ol><li>pepper</li></ol>
pauna	<i>det</i><br><ol><li>by way of up there</li></ol>
paunġaq	<i>noun</i><br><ol><li>black crowberry, Empetrum nigrum</li></ol>
pauŋa	<i>det</i><br><ol><li>towards up there</li></ol>
pavani	<i>adv</i><br><ol><li>located back there [in a large visible area]</li></ol>
paġlan|paġlatik|paġlatit	<i>noun</i><br><ol><li>greeting, welcome</li></ol>
pałuqtaq|pałuktat|pałuktak	<i>noun</i><br><ol><li>beaver</li></ol>
pikka	<i>det</i><br><ol><li>up there, above (visible, not in motion)</li></ol>
pikuk|pikuich|pikkuk	<i>noun</i><br><ol><li>one of the long vertebra near neck</li></ol>
pisruktuaq|pisruktuak|pisruktuat	<i>noun</i><br><ol><li>black or brown bear (Kobuk)</li></ol>
pitcha	<i>det</i><br><ol><li>up there, above (visible, not in motion)</li></ol>
piŋasut	<i>num</i><br><ol><li>three</li></ol>
puttun|puttutik|puttutit	<i>noun</i><br><ol><li>piercing tool</li></ol>
putuguqsiuġayuk|putuguqsiuġayyuk|putuguqsiuġayuich	<i>noun</i><br><ol><li>stag beetle</li></ol>
puukataq|puukatat|puukatak	<i>noun</i><br><ol><li>bag</li></ol>
puviaqtuuq|puviaqtuuk|puviaqtuut	<i>noun</i><br><ol><li>pectoral sandpiper, Calidris melanotos</li></ol>
puviaqtuuyaaq|puviaqtuuyaat|puviaqtuuyaak	<i>noun</i><br><ol><li>Baird's sandpiper, Calidris bairdii</li></ol>
puviġaaq|puviġaat|puviġaak	<i>noun</i><br><ol><li>balloon</li></ol>
puvlaksaun	<i>noun</i><br><ol><li>baking powder</li></ol>
qaaŋianiktuaq	<i>adv</i><br><ol><li>in the past</li></ol>
qaksrugaun|qaksrugautik|qaksrugautit	<i>noun</i><br><ol><li>woman's belt</li></ol>
qakugu	<i>pron</i><br><ol><li>when [in future]</li></ol>
qakugupayaaq	<i>adv</i><br><ol><li>any time</li></ol>
qalasiq	<i>noun</i><br><ol><li>umbilicus, navel</li></ol>
qalasriq|qalasriich|qalasriik	<i>noun</i><br><ol><li>umbilicus, navel</li></ol>
qalugruaq|qalugruak|qalugruich	<i>noun</i><br><ol><li>salmon, humpback salmon</li></ol>
qalukpik|qalukpiik|qalukpiich	<i>noun</i><br><ol><li>trout</li></ol>
qalupiaq|qalupiak|qalupiat	<i>noun</i><br><ol><li>whitefish</li></ol>
qamma	<i>det</i><br><ol><li>upriver, inside (further from entrance than speaker)</li></ol>
qaniq	<i>noun</i><br><ol><li>mouth</li></ol>
qanuq	<i>adv</i><br><ol><li>(interrogative) how</li></ol>
qapvik|qapviik|qapviich	<i>noun</i><br><ol><li>wolverine</li></ol>
qaqqiaq|qaqqiak|qaqqiat	<i>noun</i><br><ol><li>yeast bread</li></ol>
qaqqulaaq|qaqqulaat|qaqqulaak	<i>noun</i><br><ol><li>pilot bread</li></ol>
qaqquliktaq|qaqquliktat|qaqquliktaak	<i>noun</i><br><ol><li>pilot bread</li></ol>
qaqsrauq|qaqsrauk|qaqsraut	<i>noun</i><br><ol><li>red-throated loon, Gavia stellata</li></ol>
qasrigiaq|qasrigiak|qasrigiat	<i>noun</i><br><ol><li>spotted seal (Phoca largha)</li><li>harbour seal (Phoca vitulina)</li></ol>
qatiqtaaq|qatiqtaat|qatiqtaak	<i>noun</i><br><ol><li>something white</li></ol>
qattaq|qattak|qattat	<i>noun</i><br><ol><li>water container, bucket</li></ol>
qattaġniq|qattaġniġich|qattaġnaak	<i>noun</i><br><ol><li>valley, pass</li></ol>
qattaġruk|qattaġruich|qattaġruuk	<i>noun</i><br><ol><li>barrell</li></ol>
qaumaniq|qaumannak|qaumanġich	<i>noun</i><br><ol><li>a beam or ray of light</li></ol>
qavvik|qavviik|qavviit|Slope	<i>noun</i><br><ol><li>wolverine</li></ol>
qayaq|qayyak|qayyat	<i>noun</i><br><ol><li>kayak, skin-canoe</li></ol>
qayaġulik|qayaġullak|qayaġulgich	<i>noun</i><br><ol><li>(Kobuk) ringed seal, Pusa hispida</li></ol>
qayyiiġun|qayyiiġutit|qayyiiġutik	<i>noun</i><br><ol><li>northern phalarope</li></ol>
qaġruq|qaġruk|qaġrut	<i>noun</i><br><ol><li>arrow</li><li>shell, bullet</li></ol>
qaġruqaġvik|qaġruqaġviik|qaġruqaġviich	<i>noun</i><br><ol><li>ammunition case</li></ol>
qaġrut	<i>noun</i><br><ol><li>ammunition</li></ol>
qaŋaimña	<i>det</i><br><ol><li>recent past, at a particular time</li></ol>
qianaratuuq|qianaratuut|qianaratuuk	<i>noun</i><br><ol><li>golden-crowned sparrow (Zonotrichia atricapilla)</li></ol>
qigiqtaq	<i>noun</i><br><ol><li>island</li></ol>
qikiqtaq|qikiqtak|qikiqtat	<i>noun</i><br><ol><li>island</li></ol>
qikiqtaġruk|qikiqtaġruuk|qikiqtaġruit	<i>noun</i><br><ol><li>peninsula</li></ol>
qilamik	<i>adv</i><br><ol><li>quickly, immediately</li></ol>
qimmiq|qimmit|qimmik	<i>noun</i><br><ol><li>dog</li></ol>
qipmiq|qipmich|qipmik	<i>noun</i><br><ol><li>dog</li></ol>
qiruk|qiruuk|qiruich	<i>noun</i><br><ol><li>wood</li></ol>
qiñiġaaq|agliutrak|agliutrat	<i>noun</i><br><ol><li>picture</li></ol>
qiñuiññaq	<i>noun</i><br><ol><li>peace</li><li>humility, modesty, humbleness</li></ol>
qiḷagaq|qiḷagak|qiḷagat	<i>noun</i><br><ol><li>palate</li></ol>
qiḷġich	<i>noun</i><br><ol><li>basket sled</li></ol>
qiḷġun|qiḷġutit|qiḷġutik	<i>noun</i><br><ol><li>upper lashing</li></ol>
quaġaq|quaqqat|quaqqak	<i>noun</i><br><ol><li>sourdock, Arctic dock (Rumex arcticus)</li></ol>
qugruk	<i>noun</i><br><ol><li>swan</li></ol>
quliik	<i>noun</i><br><ol><li>upper back of human body</li></ol>
qulit	<i>num</i><br><ol><li>ten</li></ol>
qulit atausiq	<i>num</i><br><ol><li>eleven</li></ol>
qulit malġuk	<i>num</i><br><ol><li>twelve</li></ol>
qulit piŋasut	<i>num</i><br><ol><li>thirteen</li></ol>
quliŋŋuġutaiḷaq	<i>num</i><br><ol><li>nine</li></ol>
qullimġaat	<i>noun</i><br><ol><li>upper teeth</li></ol>
qulliq|qulliich|qulliik	<i>noun</i><br><ol><li>uppermost one, top one</li></ol>
qumak|qumaak|qumaich	<i>noun</i><br><ol><li>tapeworm, parasitic worm</li></ol>
qupitchuŋaq|qupitchuŋaak|qupitchuŋat	<i>noun</i><br><ol><li>a quarter piece, a quarter dollar</li></ol>
quqsuqtaaq	<i>adj</i><br><ol><li>yellow</li></ol>
qusrkhaaq|qusrkhaat|qusrkhaak	<i>noun</i><br><ol><li>arctic fox, Vulpes lagopus</li></ol>
quġluqtaq|quġluqtat|quġluqtak	<i>noun</i><br><ol><li>waterfall</li></ol>
saatqun|saatqutik|saatqutit	<i>noun</i><br><ol><li>net sinker</li></ol>
saayu	<i>noun</i><br><ol><li>tea (Bering Straits)</li></ol>
saigu	<i>noun</i><br><ol><li>tea</li></ol>
saiyu	<i>noun</i><br><ol><li>tea</li></ol>
saniġaq|saniġat|saniġak	<i>noun</i><br><ol><li>side</li></ol>
saqalataayiq|saqalataayik|saqalataayich	<i>noun</i><br><ol><li>red squirrel</li></ol>
sautaaq|sautaat|sautaak	<i>noun</i><br><ol><li>anchor of a trap or snare</li></ol>
savakti|savaktit|savaktik	<i>noun</i><br><ol><li>worker</li></ol>
savaktilluataq|savaktilluatak|savaktilluatat	<i>noun</i><br><ol><li>a good worker</li></ol>
savik|saviich|savvik	<i>noun</i><br><ol><li>knife</li></ol>
siiġñaiyaun	<i>noun</i><br><ol><li>back</li></ol>
sikaakuvik|sikaakuviik|sikaakuvich	<i>noun</i><br><ol><li>ashtray</li></ol>
siksrik|siksrigich|siksriik	<i>noun</i><br><ol><li>ground squirrel</li></ol>
sila	<i>noun</i><br><ol><li>air, atmosphere, weather</li></ol>
siqiñiq	<i>noun</i><br><ol><li>sun</li><li>sun's reflection in the water (Bering Straits)</li></ol>
sisuaq|sisurrat|sisurrak	<i>noun</i><br><ol><li>beluga whale</li></ol>
siulik|siullak|siulgich	<i>noun</i><br><ol><li>pike</li></ol>
siuttuvak|siuttuvaak|siuttuvaich	<i>noun</i><br><ol><li>whimbrel</li></ol>
sivuani|sivuatni|sivuakni	<i>adv</i><br><ol><li>before it, in the past, before this time</li><li>in front of it</li></ol>
siyyukpaligauraq|siyyukpaligaurak|siyyukpaligaurat	<i>noun</i><br><ol><li>dunlin, red-backed sandpiper, Calidris alpina</li></ol>
siyyuuk|siyyuich	<i>noun</i><br><ol><li>beak, bill</li></ol>
siñigviich	<i>noun</i><br><ol><li>bed</li></ol>
siġḷuaq|siġḷuak|siġḷuat	<i>noun</i><br><ol><li>ice cellar, underground cache, cold storage</li></ol>
siŋutluluuq|siŋutluluut|siŋutluluuk	<i>noun</i><br><ol><li>varied thrush</li></ol>
siḷa	<i>noun</i><br><ol><li>air, atmosphere, weather, outside</li></ol>
siḷaavyak|siḷaavyaak|siḷaavyaich	<i>noun</i><br><ol><li>pancake, flapjack</li></ol>
siḷaluksiugauraq|siḷaluksiugaurat|siḷaluksiugaurak	<i>noun</i><br><ol><li>myrtle warbler</li></ol>
su	<i>pron</i><br><ol><li>what</li></ol>
sua	<i>pron</i><br><ol><li>what</li></ol>
suapayaaq	<i>adv</i><br><ol><li>anything</li></ol>
sukman	<i>pron</i><br><ol><li>why</li></ol>
suli	<i>particle</i><br><ol><li>also</li><li>still</li><li>furthermore</li></ol>
suluktatchialik|suluktatchiallak|suluktatchialgich	<i>noun</i><br><ol><li>Bohemian waxwing bird (lit. with pretty wing feathers)</li></ol>
sumi	<i>pron</i><br><ol><li>where, at what</li></ol>
sumipayaaq	<i>adv</i><br><ol><li>any time, any place, anywhere</li></ol>
sumiñ	<i>pron</i><br><ol><li>where from</li></ol>
summan	<i>pron</i><br><ol><li>why</li></ol>
sumun	<i>pron</i><br><ol><li>where to</li></ol>
suna	<i>pron</i><br><ol><li>what</li></ol>
sunapayaaq	<i>adv</i><br><ol><li>anything</li></ol>
supman	<i>pron</i><br><ol><li>why</li></ol>
suqqaq	<i>noun</i><br><ol><li>baleen</li></ol>
suvaata	<i>pron</i><br><ol><li>why</li></ol>
suġliq|suġlik|suġliġich	<i>noun</i><br><ol><li>horned grebe, Podiceps auritus</li></ol>
suġlitchauraq|suġlitchaurak|suġlitchaurat	<i>noun</i><br><ol><li>red-necked grebe, Podiceps grisegena</li></ol>
suġruich	<i>noun</i><br><ol><li>a group of fighters, war party</li></ol>
suŋaqpaluk	<i>adj</i><br><ol><li>yellow</li></ol>
suŋaqpaluktuŋiq|suŋaqpaluktuŋich|suŋaqpaluktuŋik	<i>noun</i><br><ol><li>arctic warbler, yellow warbler</li></ol>
suŋauraq|suŋaurat|suŋaurak	<i>noun</i><br><ol><li>bead</li></ol>
taata	<i>noun</i><br><ol><li>father</li></ol>
taatchiŋiq|taatchiŋich|taatchiŋik	<i>noun</i><br><ol><li>loon, Gavia immer</li></ol>
taaŋŋaq|taaŋŋaich|taaŋŋaak	<i>noun</i><br><ol><li>alcohol, intoxicating beverage</li></ol>
taglu|taglut|tagluk	<i>noun</i><br><ol><li>snowshoe</li></ol>
takku	<i>conj</i><br><ol><li>because</li></ol>
taliq|tallik|tallich	<i>noun</i><br><ol><li>arm</li></ol>
tallimat	<i>num</i><br><ol><li>five</li></ol>
tallimat malġuk	<i>num</i><br><ol><li>seven</li></ol>
tallimat piŋasut	<i>num</i><br><ol><li>eight</li></ol>
tapsiñiq	<i>noun</i><br><ol><li>waist</li><li>small of back, lumbar curve</li></ol>
taqaqpak|taqaqpaak|taqaqpaich	<i>noun</i><br><ol><li>artery</li></ol>
tatirgaq|tatirgaich|tatirgaak	<i>noun</i><br><ol><li>Lesser sandhill crane, Grus canadensis</li></ol>
tavsiñiq	<i>noun</i><br><ol><li>waist</li></ol>
tayaġnaun|tayaġnautik|tayaġnautit	<i>noun</i><br><ol><li>wrist</li></ol>
tayaġniq	<i>noun</i><br><ol><li>wrist</li></ol>
taġium siñaa	<i>noun</i><br><ol><li>beach</li></ol>
tiguaq|tiguak|tiguat	<i>noun</i><br><ol><li>an adopted child or person</li></ol>
tikiġaq	<i>noun</i><br><ol><li>forest</li><li>thicket</li></ol>
tiniikaq|tiniikat|tiniikak	<i>name</i><br><ol><li>moose</li></ol>
tinnik|tinniich|tinniik	<i>noun</i><br><ol><li>bearberry</li></ol>
tiġiaq|tiġiat|tiġiak	<i>noun</i><br><ol><li>weasel</li></ol>
tiġiganniaq|tiġiganniak|tiġiganniat	<i>noun</i><br><ol><li>arctic fox, Vulpes lagopus</li></ol>
tiŋmiaqpauraq|tiŋmiaqpaurak|tiŋmiaqpaurat	<i>noun</i><br><ol><li>wheatear</li></ol>
tiŋmisuugauraq|tiŋmisuugaurat|tiŋmisuugaurak	<i>noun</i><br><ol><li>a small plane</li></ol>
tiŋmisuun|tiŋmisuutik|tiŋmisuutit	<i>noun</i><br><ol><li>airplane</li></ol>
tiŋmisuutiqpak|tiŋmisuutiqpaich|tiŋmisuutiqpaak	<i>noun</i><br><ol><li>jet</li></ol>
tlpigiksaun|tipigiksautit|tipigiksautik	<i>noun</i><br><ol><li>perfume, incense</li></ol>
tulugaġnaq|tulugaġnat|tuluqaġnak	<i>noun</i><br><ol><li>bank swallow, Riparia riparia</li></ol>
tulugaġnauraq|tulugaġnaurak|tulugaġnaurat	<i>noun</i><br><ol><li>barn swallow (Hirundo rustica)</li></ol>
tulukkam asriaŋa	<i>noun</i><br><ol><li>any berry inedible for humans, e.g. juniper berry, soapberry, highbush cranberry</li></ol>
tunu|tunuk|tunut	<i>noun</i><br><ol><li>back</li></ol>
tunuani|tunuatni|tunuakni	<i>adv</i><br><ol><li>on a person's back; at the back of</li></ol>
tuqłuk|tuqłuich|tuqłuuk	<i>noun</i><br><ol><li>windpipe, trachea</li></ol>
tuttuqłuk|tuttuqłuit|tuttuqłuuk	<i>noun</i><br><ol><li>pig</li></ol>
tuttuvak|tuttuvaak|tuttuvait	<i>name</i><br><ol><li>moose</li></ol>
tuunġaaġruk|tuunġaaġruuk|tuunġaaġruich	<i>noun</i><br><ol><li>surf scoter, Melanitta perspicillata</li></ol>
tuutlik|tuutliik|tuutligich	<i>noun</i><br><ol><li>yellow-billed loon, Gavia adamsii</li></ol>
tuuyuq|tuuyuk|tuuyut	<i>noun</i><br><ol><li>downy woodpecker</li></ol>
tuuyuqpak|tuuyuqpaich|tuuyuqpaak	<i>noun</i><br><ol><li>Alaska three-toed woodpecker, hairy woodpecker</li></ol>
ublaaq|ublaak|ublaat	<i>noun</i><br><ol><li>morning</li></ol>
ubluq|uvlut|uvluk	<i>noun</i><br><ol><li>day, daylight</li></ol>
uggiihiq|uggiihich|uggiihik	<i>noun</i><br><ol><li>baldpate duck</li></ol>
ugruk|ugruich|ugruuk	<i>noun</i><br><ol><li>bearded seal (Erignathus barbatus)</li></ol>
ugruŋnaq|ugruŋnat|ugruŋnak	<i>noun</i><br><ol><li>shrew</li></ol>
uiḷigaġnaaq|uiḷigaġnaat|uiḷigaġnaak	<i>noun</i><br><ol><li>widow</li></ol>
uiḷġaġniq|uiḷigaġnit|uiḷigaġnik	<i>noun</i><br><ol><li>widow</li></ol>
ukialliq|ukiallik|ukiallich	<i>noun</i><br><ol><li>autumn skin</li></ol>
ukiulliq|ukiulliik|ukiullich	<i>noun</i><br><ol><li>winter skin</li></ol>
ukiupak	<i>noun</i><br><ol><li>all winter, this winter, this year</li></ol>
ukiuq|ukiut|ugiuq|ugiut|ukiuk|ugiuk	<i>noun</i><br><ol><li>winter, year</li></ol>
ukiuvak	<i>noun</i><br><ol><li>all winter, this winter, this year</li></ol>
ulimaun|ulimautik|ulimautit	<i>noun</i><br><ol><li>adze</li></ol>
umŋich	<i>noun</i><br><ol><li>beard</li></ol>
uniat	<i>noun</i><br><ol><li>dogsled</li></ol>
unnugman	<i>adv</i><br><ol><li>yesterday (North Slope)</li></ol>
uqauraq|uqaurak|uqaurat	<i>noun</i><br><ol><li>uvula</li></ol>
uqpik|uqpiich|uqpiik	<i>noun</i><br><ol><li>willow</li></ol>
uqpiŋñaq|uqpiŋñaak|uqpiŋñat	<i>noun</i><br><ol><li>highbush cranberry plant, Viburnum edule</li></ol>
uqquutaq|uqquutak|uqquutat	<i>noun</i><br><ol><li>windbreak</li></ol>
uqsi|uqsiik|uqsiich	<i>noun</i><br><ol><li>appendix</li></ol>
uqsruq|uqsruk|uqsrut	<i>noun</i><br><ol><li>oil</li><li>seal oil</li></ol>
urgiiḷiq	<i>noun</i><br><ol><li>birch</li></ol>
urrakusraun|urrakusrautik|urrakusrautit	<i>noun</i><br><ol><li>parable, example, demonstration</li></ol>
usiŋuatchiaq|usiŋuatchiat|usiŋuatchiak	<i>noun</i><br><ol><li>medium-sized whale</li></ol>
usruk	<i>noun</i><br><ol><li>penis</li></ol>
usuk	<i>noun</i><br><ol><li>penis</li></ol>
utchuk	<i>noun</i><br><ol><li>vulva</li></ol>
utuqqanaaq|utuqqanaat|utuqqanaak	<i>noun</i><br><ol><li>elder, old person</li></ol>
utŋuq|utŋut|utŋuk	<i>noun</i><br><ol><li>wart</li></ol>
uuktuun|uuktuutik|uuktutit	<i>noun</i><br><ol><li>pattern, measurement</li><li>example, parable</li><li>ruler</li><li>survey</li></ol>
uumani|ukunani|ukuŋnaŋni	<i>adv</i><br><ol><li>this one [e.g. box, chair, confined area or person who is aware of activity around him not in motion, visible]</li></ol>
uumman|uummatit|uummatik	<i>noun</i><br><ol><li>heart</li></ol>
uummaq	<i>noun</i><br><ol><li>forest</li><li>green wood</li></ol>
uvaŋa|uvamnun|uvaptikkun|uvaptitun|uvapkun|uvaptikniñ|uvaptiktun|uvaptun|uvaguk|uvamni|uvaptiknik|uvaptikni|uvaptiknun|uvagut|uvamniñ|uvaptigun|uvamnik	<i>pron</i><br><ol><li>I, me</li></ol>
uviññuaġayuk|uviññuaġayuich|uviññuaġayuuk	<i>noun</i><br><ol><li>black scoter, Melanitta americana</li></ol>
uvlaaq|uvlaak|uvlaat	<i>noun</i><br><ol><li>morning</li></ol>
uvluq|uvlut|uvluk	<i>noun</i><br><ol><li>day, daylight</li></ol>
uvluġiaq|uvluġiak|uvluġirrat	<i>noun</i><br><ol><li>star</li></ol>
uŋallaq	<i>noun</i><br><ol><li>south wind</li></ol>
𝋀	<i>num</i><br><ol><li>The digit 0 (kisitchisaġvik) in Kaktovik script</li></ol>
𝋁	<i>num</i><br><ol><li>The digit 1 (atausiq) in Kaktovik script</li></ol>
𝋂	<i>num</i><br><ol><li>The digit 2 (malġuk) in Kaktovik script</li></ol>
𝋃	<i>num</i><br><ol><li>The digit 3 (piŋasut) in Kaktovik script</li></ol>
𝋄	<i>num</i><br><ol><li>The digit 4 (sisamat) in Kaktovik script</li></ol>
𝋅	<i>num</i><br><ol><li>The digit 5 (tallimat) in Kaktovik script</li></ol>
𝋆	<i>num</i><br><ol><li>The digit 6 (itchaksrat) in Kaktovik script</li></ol>
𝋇	<i>num</i><br><ol><li>The digit 7 (tallimat malġuk) in Kaktovik script</li></ol>
𝋈	<i>num</i><br><ol><li>The digit 8 (tallimat piŋasut) in Kaktovik script</li></ol>
𝋉	<i>num</i><br><ol><li>The digit 9 (quliŋŋuġutaiḷaq) in Kaktovik script</li></ol>
𝋊	<i>num</i><br><ol><li>The digit 10 (qulit) in Kaktovik script</li></ol>
𝋋	<i>num</i><br><ol><li>The digit 11 (qulit atausiq) in Kaktovik script</li></ol>
𝋌	<i>num</i><br><ol><li>The digit 12 (qulit malġuk) in Kaktovik script</li></ol>
𝋍	<i>num</i><br><ol><li>The digit 13 (qulit piŋasut) in Kaktovik script</li></ol>
𝋎	<i>num</i><br><ol><li>The digit 14 (akimiaġutaiḷaq) in Kaktovik script</li></ol>
𝋏	<i>num</i><br><ol><li>The digit 15 (akimiaq) in Kaktovik script</li></ol>
𝋐	<i>num</i><br><ol><li>The digit 16 (akimiaq atausiq) in Kaktovik script</li></ol>
𝋑	<i>num</i><br><ol><li>The digit 17 (akimiaq malġuk) in Kaktovik script</li></ol>
𝋒	<i>num</i><br><ol><li>The digit 18 (akimiaq piŋasut) in Kaktovik script</li></ol>
𝋓	<i>num</i><br><ol><li>The digit 19 (iñuiññaġutaiḷaq) in Kaktovik script</li></ol>
