ᄀᆞᄁᆞᆺ|gawkkawt	<i>adv</i><br><ol><li>just then</li><li>a short time ago</li></ol>
ᄀᆞᆨ다기|gawkdagi	<i>noun</i><br><ol><li>mosquito</li></ol>
ᄀᆞᆫ장|gawnjang	<i>noun</i><br><ol><li>soy sauce</li></ol>
ᄀᆞᆮ다|gawtda	<i>verb</i><br><ol><li>to speak, to say</li></ol>
ᄀᆞᆯ개비|gawlgaebi	<i>noun</i><br><ol><li>frog</li></ol>
ᄀᆞᆷ다|gawmda	<i>verb</i><br><ol><li>to wash oneself, to bathe</li></ol>
ᄀᆞᆸ	<i>noun</i><br><ol><li>layer; fold</li><li>portion; allotment</li><li>divide; especially a cosmic divide, such as that between heaven and earth or the living and the dead</li><li>limit; end</li><li>discernment</li><li>sorting out; categorization</li></ol>
ᄀᆞᆺ바위|gawtbawi	<i>noun</i><br><ol><li>the edge of a round object</li></ol>
ᄀᆞᆺ사|gawtsa	<i>adv</i><br><ol><li>just then</li></ol>
ᄀᆞ끔|gawkkeum	<i>adv</i><br><ol><li>sometimes</li></ol>
ᄀᆞ득|gawdeuk	<i>adv</i><br><ol><li>full; fully</li></ol>
ᄀᆞ득다|gawdeukda	<i>adj</i><br><ol><li>to be full</li></ol>
ᄀᆞ로쓰기|gawrosseugi	<i>noun</i><br><ol><li>horizontal writing</li></ol>
ᄀᆞ르|gawreu	<i>noun</i><br><ol><li>meal, flour (of wheat, etc.); powder</li></ol>
ᄀᆞ를|gawreul	<i>noun</i><br><ol><li>powder</li><li>flour</li></ol>
ᄀᆞ리|gawri	<i>noun</i><br><ol><li>time</li><li>an occasion; the time when...</li></ol>
ᄀᆞ맹이|gawmaeng'i	<i>noun</i><br><ol><li>heat haze</li></ol>
ᄀᆞ새|gawsae	<i>noun</i><br><ol><li>scissors</li></ol>
ᄀᆞ을|gaweul	<i>noun</i><br><ol><li>autumn; fall</li></ol>
ᄀᆞ져들이다|gajyeodeulida	<i>verb</i><br><ol><li>To bring in</li></ol>
ᄀᆞ트다|gawteuda	<i>adj</i><br><ol><li>(to be) the same</li><li>(to be) similar</li></ol>
ᄁᆞ늘다|kkawneulda	<i>adj</i><br><ol><li>thin, slender (of something long and thin, like a thread or a stick)</li></ol>
ᄂᆞᄆᆞᆯ|nawmawl	<i>noun</i><br><ol><li>greens, namul, herbs</li></ol>
ᄂᆞᄆᆞᆯ국|nawmawlguk	<i>noun</i><br><ol><li>vegetable soup</li></ol>
ᄂᆞᆷ삐|nawmppi	<i>noun</i><br><ol><li>Korean radish, a variety of daikon.</li></ol>
ᄂᆞᆺ빗|nawtbit	<i>noun</i><br><ol><li>an expression of feeling, especially a facial expression</li></ol>
ᄂᆞ시|nawsi	<i>adv</i><br><ol><li>(denoting a conclusion of an event)</li></ol>
ᄂᆞ실다|nawsilda	<i>verb</i><br><ol><li>to sharpen the blade of a knife, sickle, or a tool.</li></ol>
ᄂᆞ잡다|nawjapda	<i>adj</i><br><ol><li>to be low</li></ol>
ᄃᆞᆨ|dawk	<i>noun</i><br><ol><li>fowl, chicken</li></ol>
ᄃᆞᆫ물장의|dawnmuljang-ui	<i>noun</i><br><ol><li>The Japanese eel, Anguilla japonica</li></ol>
ᄃᆞᆯ|dawl	<i>noun</i><br><ol><li>moon</li><li>month</li></ol>
ᄃᆞᆯ뱅이|dawlbaeng'i	<i>noun</i><br><ol><li>snail</li></ol>
ᄃᆞᆺᄃᆞᆺᄒᆞ다|dawtdawthawda	<i>adj</i><br><ol><li>(to be) warm</li></ol>
ᄃᆞᆼ그다|dawnggeuda	<i>verb</i><br><ol><li>to dip; to soak</li></ol>
ᄃᆞ람지|dawramji	<i>noun</i><br><ol><li>bat</li></ol>
ᄃᆞ스다|dawseuda	<i>adj</i><br><ol><li>(to be) warm</li></ol>
ᄄᆞᆯ|ttawl	<i>noun</i><br><ol><li>daughter</li></ol>
ᄄᆞᆷ|ttawm	<i>noun</i><br><ol><li>sweat</li></ol>
ᄄᆞ뜻ᄒᆞ다|ttawtteuthawda	<i>adj</i><br><ol><li>(to be) warm</li></ol>
ᄆᆞᆫ딱|mawnttak	<i>adv</i><br><ol><li>all, wholly</li><li>altogether</li></ol>
ᄆᆞᆯ|mawl	<i>noun</i><br><ol><li>horse</li><li>gulfweed (Sargassum fulvellum)</li></ol>
ᄆᆞᆯ랑ᄆᆞᆯ랑ᄒᆞ다|mawllangmawllanghawda	<i>adj</i><br><ol><li>gentle</li></ol>
ᄆᆞ르다|mawreuda	<i>verb</i><br><ol><li>to dry</li><li>to cut (with scissors)</li></ol>
ᄆᆞ슬|mawseul	<i>noun</i><br><ol><li>village</li></ol>
ᄆᆞ슴|mawseum	<i>noun</i><br><ol><li>mind; heart</li></ol>
ᄆᆞ실|mawsil	<i>noun</i><br><ol><li>village, hamlet, settlement</li></ol>
ᄆᆞ츰내|mawcheumnae	<i>adv</i><br><ol><li>finally; in the end</li></ol>
ᄇᆞᆮ|bawt	<i>noun</i><br><ol><li>(anatomy) womb</li></ol>
ᄇᆞᆯ끈|bawlkkeun	<i>adv</i><br><ol><li>tightly</li><li>firmly</li></ol>
ᄇᆞᆯ써|bawlsseo	<i>adv</i><br><ol><li>already</li></ol>
ᄇᆞᆰ다|bawkda	<i>adj</i><br><ol><li>(to be) bright</li><li>to be light</li></ol>
ᄇᆞ레다|bawreda	<i>verb</i><br><ol><li>to see; look at</li></ol>
ᄇᆞ름|bawreum	<i>noun</i><br><ol><li>wind, air, draft</li><li>wall</li></ol>
ᄈᆞᆯ다|ppawlda	<i>verb</i><br><ol><li>to suck</li><li>to wash</li></ol>
ᄈᆞᆯ레ᄒᆞ다|ppawllehawda	<i>verb</i><br><ol><li>to do the laundry</li></ol>
ᄈᆞᆯ르다|ppawlleuda	<i>adj</i><br><ol><li>(to be) fast, quick</li></ol>
ᄉᆞ|saw	<i>num</i><br><ol><li>four</li></ol>
ᄉᆞᆯ루다|ᄉᆞᆯ루완|ᄉᆞᆯ루난|sawlluda|ᄉᆞᆯ루왕	<i>verb</i><br><ol><li>(transitive or intransitive, humble) to speak, to say, to tell something to a superior</li></ol>
ᄉᆞᆯ므다|sawlmeuda	<i>verb</i><br><ol><li>to boil; to cook</li></ol>
ᄉᆞᆼ키|sawngki	<i>noun</i><br><ol><li>(eastern Seogwipo) vegetables; greens</li></ol>
ᄉᆞ랑|sawrang	<i>noun</i><br><ol><li>love</li></ol>
ᄉᆞ수매|sawsumae	<i>noun</i><br><ol><li>a four year-old horse</li></ol>
ᄉᆞ시|sawsi	<i>noun</i><br><ol><li>neighborhood</li></ol>
ᄉᆞ실|sawsil	<i>noun</i><br><ol><li>fact</li></ol>
ᄉᆞ십|sawsip	<i>num</i><br><ol><li>forty</li></ol>
ᄉᆞ용ᄒᆞ다|sawyonghawda	<i>verb</i><br><ol><li>to use</li><li>to utilize</li><li>to employ</li></ol>
ᄉᆞ월|sawwol	<i>noun</i><br><ol><li>April</li></ol>
ᄉᆞ을|saw-eul	<i>noun</i><br><ol><li>three days</li></ol>
ᄉᆞ이|sawi	<i>noun</i><br><ol><li>relationship, space between</li></ol>
ᄉᆞ춘|sawchun	<i>noun</i><br><ol><li>cousin (male or female)</li></ol>
ᄉᆞ투리|sawturi	<i>noun</i><br><ol><li>(linguistics) dialect (variety of a language)</li></ol>
ᄉᆞ훼|sawhwe	<i>noun</i><br><ol><li>moderation of a meeting or ceremony</li><li>moderator</li></ol>
ᄊᆞᆯ|ssawl	<i>noun</i><br><ol><li>rice</li></ol>
ᄊᆞᆯ칩|ssawlchip	<i>noun</i><br><ol><li>rice shop (a shop that sells rice)</li></ol>
ᄊᆞᆱ다|ssawmda	<i>verb</i><br><ol><li>to boil; to cook</li></ol>
ᄋᆞ|aw	<i>noun</i><br><ol><li>the name of the jamo ㆍ</li></ol><br><i>intj</i><br><ol><li>(informal) yes</li></ol>
ᄋᆞᆼ진ᄋᆞᆼ진|awngjin-awngjin	<i>adv</i><br><ol><li>grumbling</li></ol><br><i>noun</i><br><ol><li>(of a baby or a child) while crying loudly</li></ol>
ᄋᆞ동|awdong	<i>noun</i><br><ol><li>child</li></ol>
ᄋᆞ요|awyo	<i>intj</i><br><ol><li>oh my!</li></ol>
ᄋᆢᄃᆞᆸ|yawdawp	<i>num</i><br><ol><li>eight</li></ol>
ᄋᆢᄉᆞᆺ|yawsawt	<i>num</i><br><ol><li>six</li></ol>
ᄋᆢᆯ매|yawlmae	<i>noun</i><br><ol><li>fruit</li></ol>
ᄋᆢᆺ|yawt	<i>det</i><br><ol><li>six</li></ol>
ᄋᆢᆺ쉐|yawtswe	<i>noun</i><br><ol><li>six days</li></ol>
ᄋᆢᇁ|yawp	<i>noun</i><br><ol><li>beside</li><li>alongside</li><li>side</li></ol>
ᄋᆢ드레|yawdeure	<i>noun</i><br><ol><li>eight days</li></ol>
ᄋᆢ든|yawdeun	<i>num</i><br><ol><li>eighty</li></ol>
ᄋᆢ라|yawra	<i>adv</i><br><ol><li>several, various</li></ol>
ᄋᆢ라분|yawrabun	<i>noun</i><br><ol><li>(addressing a group of people) ladies and gentlemen; everybody</li><li>(polite, in the plural) you; everybody</li></ol>
ᄋᆢ름|yawreum	<i>noun</i><br><ol><li>summer</li></ol>
ᄌᆞᄉᆞᆨ|jawsawk	<i>noun</i><br><ol><li>a child</li></ol>
ᄌᆞᄉᆞᆯ|jawsawl	<i>noun</i><br><ol><li>(anatomy) labia minora</li></ol>
ᄌᆞᆫ가시|jawngasi	<i>noun</i><br><ol><li>small bones</li></ol>
ᄌᆞᆷ자다|jawmjada	<i>verb</i><br><ol><li>to sleep</li></ol>
ᄌᆞᆺ|jawt	<i>noun</i><br><ol><li>milk (of mammals)</li></ol>
ᄌᆞ게움타다|jawge'umtada	<i>verb</i><br><ol><li>to tickle</li></ol>
ᄌᆞ미|jawmi	<i>noun</i><br><ol><li>fun; enjoyment</li></ol>
ᄌᆞ미지다|jawmijida	<i>adj</i><br><ol><li>(to be) interesting</li></ol>
ᄌᆞ봄|jawbom	<i>noun</i><br><ol><li>chopsticks</li></ol>
ᄌᆞ손|jawson	<i>noun</i><br><ol><li>descendant</li><li>offspring</li></ol>
ᄌᆞ심히|jawsimhi	<i>adv</i><br><ol><li>in detail</li></ol>
ᄌᆞ영거|jawyeonggeo	<i>noun</i><br><ol><li>(rare) bicycle</li></ol>
ᄌᆞ오침|jawochim	<i>noun</i><br><ol><li>compass</li></ol>
ᄌᆞ주|jawju	<i>adv</i><br><ol><li>often</li></ol>
ᄍᆞᆸ지롱ᄒᆞ다|jjawpjironghawda	<i>adj</i><br><ol><li>to be a bit salty</li></ol>
ᄎᆞᄎᆞ|chawchaw	<i>adv</i><br><ol><li>gradually</li></ol>
ᄎᆞᆯ레|chawlle	<i>noun</i><br><ol><li>side dish</li></ol>
ᄎᆞᆷ|chawm	<i>adv</i><br><ol><li>really; truth</li></ol>
ᄎᆞᆷ웨|chawmwe	<i>noun</i><br><ol><li>the Korean melon, (Cucumis melo Makuwa Group) or its fruit.</li></ol>
ᄎᆞᆷ지름|chawmjireum	<i>noun</i><br><ol><li>sesame oil</li></ol>
ᄎᆞ츰ᄎᆞ츰|chawcheumchawcheum	<i>adv</i><br><ol><li>gradually</li></ol>
ᄏᆞᄏᆞᆯ|kawkawl	<i>adv</i><br><ol><li>all</li></ol>
ᄏᆞᆷᄏᆞᆷᄒᆞ다|kawmkawmhawda	<i>adj</i><br><ol><li>pitch-dark</li></ol>
ᄐᆞᆸ|tawp	<i>noun</i><br><ol><li>a piece (of an object)</li></ol>
ᄑᆞᆯ|pawl	<i>noun</i><br><ol><li>arm</li></ol>
ᄑᆞᆯ둑거리|pawldukgeori	<i>noun</i><br><ol><li>bracelet, bangle</li></ol>
ᄑᆞᆯ뚝|pawlttuk	<i>noun</i><br><ol><li>(anatomy) forearm</li></ol>
ᄑᆞᆺ|pawt	<i>noun</i><br><ol><li>the red bean or azuki bean, Vigna angularis.</li></ol>
ᄒᆞᄊᆞᆯ|hawssawl	<i>adv</i><br><ol><li>a little; some</li></ol>
ᄒᆞᆨ교|ᄒᆞᆨ게|hawkgyo|hawkge	<i>noun</i><br><ol><li>school</li></ol>
ᄒᆞᆨ교마당|hawkgyomadang	<i>noun</i><br><ol><li>playground; schoolyard</li></ol>
ᄒᆞᆫ|hawn	<i>det</i><br><ol><li>one</li></ol>
ᄒᆞᆫ저|hawnjeo	<i>adv</i><br><ol><li>quickly</li></ol>
ᄒᆞᆫ저옵서예|hawnheo-opseoye	<i>intj</i><br><ol><li>welcome (greeting given upon someone's arrival)</li></ol>
ᄒᆞᆫ펜|hawnpen	<i>adv</i><br><ol><li>on the other hand, side</li></ol>
ᄒᆞᆷ치|hawmchi	<i>adv</i><br><ol><li>together; all together</li><li>along with</li><li>at once</li></ol>
ᄒᆞ꼼|hawkkom	<i>adv</i><br><ol><li>a little; a bit</li></ol>
ᄒᆞ나|hawna	<i>num</i><br><ol><li>(parts of Jeju City, most of Seogwipo) one</li></ol>
ᄒᆞ다|ᄒᆞ영|헨|ᄒᆞ난|헹|ᄒᆞ연|hawda	<i>verb</i><br><ol><li>(transitive) to do; used to vaguely refer to almost any action.</li><li>(after an indirect quotation) to say (that)</li><li>(transitive) to call, name</li><li>(after an ideophone or onomatopoeia) to go; to act according to the ideophone; to make the sound of the onomatopoeia</li><li>Used as a light verb to allow nouns and noun-like forms to function as active verbs. The verb itself has little to no real meaning. The noun functions as a direct object of the verb, being able to take particles such as the accusative case marker 을 or the topic marker 은.</li><li>Used as a light verb to allow nouns and noun-like forms to function as adjectives. The verb itself has little to no real meaning. The noun can be separated by the topic marker 은.</li><li>After certain roots, fully suffixed to form an inseparable verb or adjective.</li><li>Used as a neutral verb after suffixes expressing intent or that something is about to happen.</li><li>See 게 ᄒᆞ다 (-ge hawda, “to make; to cause to do; (forms the causative)”).</li><li>See 게시리 ᄒᆞ다 (-gesiri hawda, “to make; to cause to do; (forms the causative)”).</li><li>See 으렌 ᄒᆞ다 (-euren hawda, “to make; to cause to do; (forms the causative)”).</li><li>See 어사 ᄒᆞ다 (-eosa hawda, “have to; must; should”).</li><li>See 엇어사 ᄒᆞ다 (-eoseosa hawda, “should have; (shows regret)”).</li><li>see ᄒᆞ고 (-hawgo, “and, with”).</li><li>see ᄒᆞ곡 (-hawgok, “and, with”).</li></ol><br><i>adj</i><br><ol><li>used after 구정 (-gujeong) to want, be desirous of</li></ol>
ᄒᆞ를|hawreul	<i>noun</i><br><ol><li>a day, 24 hours</li><li>daytime</li></ol>
ᄒᆞ를밤|hawreulbam	<i>noun</i><br><ol><li>one night</li></ol>
ᆢ|yaw	<i>character</i><br><ol><li>The Jeju letter, ᄋᆢ (yaw)</li></ol>
ㅂ|b	<i>character</i><br><ol><li>The Jeju consonant, ㅂ.</li></ol>
ㅅ|ㅅ (s)	<i>character</i><br><ol><li>The Jeju letter, ㅅ.</li></ol>
ㅐ|ae	<i>character</i><br><ol><li>The Jeju vowel, 애</li></ol>
ㅢ|ui	<i>character</i><br><ol><li>The Jeju vowel, 의</li></ol>
ㆍ|aw	<i>character</i><br><ol><li>The Jeju vowel, ㆍ</li></ol>
가끄다|gakkeuda	<i>verb</i><br><ol><li>to crop</li><li>to cut</li><li>to sharpen</li><li>to shave</li><li>to shear</li></ol>
가달|gadal	<i>noun</i><br><ol><li>leg</li></ol>
가름|gareum	<i>noun</i><br><ol><li>neighborhood</li></ol>
가리|gari	<i>noun</i><br><ol><li>time</li><li>an occasion; the time when...</li><li>opportunity</li></ol>
가림|garim	<i>noun</i><br><ol><li>mass of noodles</li></ol><br><i>counter</i><br><ol><li>mass of noodles</li></ol>
가메|game	<i>noun</i><br><ol><li>kiln; oven</li><li>cauldron</li><li>kettle</li></ol>
가문잔치|gamunjanchi	<i>noun</i><br><ol><li>A feast where close relatives gather on the day before the wedding ceremony.</li></ol>
가벱다|gabepda	<i>adj</i><br><ol><li>(to be) light (not heavy)</li></ol>
가부간|gabugan	<i>noun</i><br><ol><li>a household; a family</li></ol>
가사|gasa	<i>noun</i><br><ol><li>umbrella</li></ol>
가스승ᄒᆞ다|gaseuseunghawda	<i>adj</i><br><ol><li>to be weak</li><li>to be dull</li><li>to be dry and rough</li></ol>
가시|gasi	<i>noun</i><br><ol><li>maggot</li><li>fishbone</li><li>thorn</li></ol>
가시아방|gasiabang	<i>noun</i><br><ol><li>father-in-law (of a man)</li></ol>
가싸|gassa	<i>adv</i><br><ol><li>just now; a moment ago</li></ol><br><i>noun</i><br><ol><li>just now; the recent past</li></ol>
가온데|gaonde	<i>noun</i><br><ol><li>center; the middle</li></ol>
가웃|gaut	<i>noun</i><br><ol><li>half</li></ol>
가의|gaui	<i>pron</i><br><ol><li>(sometimes proscribed) that kid; he or she (a person who is not present)</li></ol>
가이|gai	<i>pron</i><br><ol><li>that kid; he or she (a person who is not present)</li></ol>
가재이|gajaei	<i>noun</i><br><ol><li>branch</li></ol>
가죽감티|gajukgamti	
가차이|gachai	<i>adv</i><br><ol><li>closely; close together</li><li>near</li></ol>
가풀|kapul	<i>noun</i><br><ol><li>glue</li><li>plastic</li><li>vinyl</li></ol>
각시|gaksi	<i>noun</i><br><ol><li>wife</li></ol>
간ᄊᆞᆷ|ganssawm	<i>noun</i><br><ol><li>(anatomy) The diaphragm.</li></ol>
간상부리다|gansangburida	<i>verb</i><br><ol><li>to do tricky stuff</li></ol>
감저|gamjeo|관	<i>noun</i><br><ol><li>sweet potato, Ipomoea batatas</li></ol>
갑실|gapsil	<i>noun</i><br><ol><li>A thread made from a horse's belly.</li></ol>
갑옷|gabot	<i>noun</i><br><ol><li>armor</li></ol>
갓|gat	<i>noun</i><br><ol><li>wife</li><li>woman</li></ol>
강|gang	<i>noun</i><br><ol><li>river</li></ol>
강낭대죽|gangnangdaejuk	<i>noun</i><br><ol><li>maize; corn (US)</li></ol>
강생이|gangsaeng'i	<i>noun</i><br><ol><li>puppy</li></ol>
강월동|gang-woldong	
개ᄀᆞᆺ|gaegawt	<i>noun</i><br><ol><li>shore</li></ol>
갱규|gaenggyu	<i>noun</i><br><ol><li>a trick</li></ol>
갱규부리다|gaenggyuburida	<i>verb</i><br><ol><li>to mislead others with a lie and a bad trick</li></ol>
거끄다|geokkeuda	<i>verb</i><br><ol><li>to break</li></ol>
거리|geori	<i>counter</i><br><ol><li>house</li></ol><br><i>noun</i><br><ol><li>distance</li><li>street</li></ol>
거무룽ᄒᆞ다|geomurunghawda	<i>adj</i><br><ol><li>(to be) dark-colored</li></ol>
거북|geobuk	<i>noun</i><br><ol><li>tortoise. turtle</li></ol>
거여미|마리|geoyeomi	<i>noun</i><br><ol><li>spider</li></ol>
거의|geoui	<i>adv</i><br><ol><li>almost, nearly</li></ol>
거짓거|geojitgeo	<i>noun</i><br><ol><li>fake</li></ol>
검다|geomda	<i>adj</i><br><ol><li>(to be) black</li></ol>
검질|geomjil	<i>noun</i><br><ol><li>nori</li></ol>
겁자|geopja	<i>noun</i><br><ol><li>(derogatory) coward, poltroon</li></ol>
것멕이다|geonmegida	<i>verb</i><br><ol><li>To feed livestock</li></ol>
게게ᄒᆞ다|gegehawda	<i>verb</i><br><ol><li>to make a loud noise</li></ol>
게메|geme	<i>intj</i><br><ol><li>well; not sure</li></ol>
게메게|gemege	<i>intj</i><br><ol><li>well; not sure</li></ol>
게시다|gesida	<i>verb</i><br><ol><li>(honorific) honorific of 시다 (sida) to stay</li></ol>
겡|geng	<i>noun</i><br><ol><li>soup (for memorial service)</li></ol>
겨을|gyeo'eul	<i>noun</i><br><ol><li>winter</li></ol>
격납고|gyeoknapgo	<i>noun</i><br><ol><li>hangar</li></ol>
결국|gyeolguk	<i>adv</i><br><ol><li>after all, in the end</li></ol>
경|gyeong	<i>adv</i><br><ol><li>(not) so much</li><li>like that; so</li></ol>
경ᄒᆞ다|경ᄒᆞ난|경헹|경ᄒᆞ영|gyeonghawda|경ᄒᆞ연|경헨	<i>adj</i><br><ol><li>(to be) like that</li></ol><br><i>verb</i><br><ol><li>to do so</li></ol>
계메|gyeme	<i>intj</i><br><ol><li>let me see</li><li>well</li></ol>
계훽|gyehwek	<i>noun</i><br><ol><li>a plan</li></ol>
고고리|gogori	<i>noun</i><br><ol><li>ear of grain</li></ol>
고낭귀국|gonanggwiguk	<i>noun</i><br><ol><li>A soup made by adding chicken and soybean paste.</li></ol>
고냉이|gonaeng'i	<i>noun</i><br><ol><li>cat</li><li>kitten</li></ol>
고당|godang	<i>noun</i><br><ol><li>place</li></ol>
고랑내|gorangnae	<i>noun</i><br><ol><li>a foul odor, a stench</li></ol>
고랑챙이|gorangchaeng'i	<i>noun</i><br><ol><li>valley, vale, ravine</li></ol>
고레사니|goresani	<i>noun</i><br><ol><li>whale</li></ol>
고맙다|gomapda	<i>adj</i><br><ol><li>to be thankful; to be grateful</li></ol>
고맙수다|gomapsuda	<i>intj</i><br><ol><li>thank you</li></ol>
고망|gomang	<i>noun</i><br><ol><li>hole, aperture</li></ol>
고소리술|gosorisul	
고와리|gowari	<i>noun</i><br><ol><li>bracken, fernbrake (Pteridium aquilinum)</li><li>bracken fiddlehead, used as a culinary vegetable</li></ol>
고장|gojang	<i>noun</i><br><ol><li>(botany) flower; flowering plant</li></ol>
고쩌|gojjeo	<i>adv</i><br><ol><li>again, once more</li></ol>
곡지|gokji	<i>counter</i><br><ol><li>song</li></ol>
곤밥|gonbam	<i>noun</i><br><ol><li>cooked, nonglutinous rice</li></ol>
골히|gorhi	<i>noun</i><br><ol><li>ring; loop</li></ol>
공거리|gonggeori	<i>noun</i><br><ol><li>concrete</li></ol>
공고리|gonggori	<i>noun</i><br><ol><li>concrete</li></ol>
공븨|gongbui	<i>noun</i><br><ol><li>study, learning</li></ol>
공븨ᄒᆞ다|공븨헹|gongbuihawda|공븨ᄒᆞ난|공븨ᄒᆞ연|공븨헨|공븨ᄒᆞ영	<i>verb</i><br><ol><li>(transitive or intransitive) to study</li></ol>
공장|gongjang	<i>noun</i><br><ol><li>factory</li></ol>
공주|gongju	<i>noun</i><br><ol><li>princess</li></ol>
공쥥이|gongjwing'i	<i>noun</i><br><ol><li>cricket (insect)</li></ol>
과랑과랑|gwaranggwarang	<i>adv</i><br><ol><li>blazingly</li></ol>
관광객|gwangwanggaek	<i>noun</i><br><ol><li>tourist, sightseer, traveler</li></ol>
괄락괄락|gwallakgwallak	<i>noun</i><br><ol><li>(onomatopoeia) gulping</li></ol>
광|gwang	<i>noun</i><br><ol><li>lunatic; nutcase</li></ol>
괙괙|gwaekgwaek	<i>noun</i><br><ol><li>oink, the sound of a pig.</li></ol>
구경꾼|gugyeongkkun	<i>noun</i><br><ol><li>onlooker; spectator</li></ol>
구덕|gudeok	<i>noun</i><br><ol><li>basket</li></ol>
구둘|gudul	<i>noun</i><br><ol><li>room</li></ol>
구들|gudeul	<i>noun</i><br><ol><li>room</li></ol>
구수매|gusumae	<i>noun</i><br><ol><li>a nine year-old horse</li></ol>
구월|guwol	<i>noun</i><br><ol><li>September</li></ol>
구쟁이|gujaeng'i	<i>noun</i><br><ol><li>the turban snail, Turbo cornutus</li></ol>
국쉬|gukswi	<i>noun</i><br><ol><li>noodle (string or strip of pasta)</li></ol>
군ᄉᆞ|gunsaw	<i>noun</i><br><ol><li>worker</li><li>soldier</li></ol>
굴래꽝이|gullaekkwang'i	<i>noun</i><br><ol><li>(anatomy) mouth</li></ol>
굴레|gulle	<i>noun</i><br><ol><li>(colloquial) mouth</li></ol>
굴메|gulme	<i>noun</i><br><ol><li>shadow</li></ol>
굴묵낭|gunmungnang	<i>noun</i><br><ol><li>the zelkova tree, Zelkova serrata</li></ol>
굼기|gumgi	<i>noun</i><br><ol><li>hole; cavity</li></ol>
굼벵이|gumbeng'i	<i>noun</i><br><ol><li>cicada larva</li></ol>
굼부리|gumburi	<i>noun</i><br><ol><li>crater</li></ol>
굽|gup	<i>noun</i><br><ol><li>trunk, stump</li></ol>
굽다|gupda	<i>verb</i><br><ol><li>to roast</li></ol>
굿|gut	<i>noun</i><br><ol><li>kut (shamanistic ritual)</li></ol>
궁기|gunggi	<i>noun</i><br><ol><li>hole, opening</li></ol>
궂다|gutda	<i>adj</i><br><ol><li>to be bad</li><li>to be disgusting, unpleasant</li><li>to be irksome</li></ol>
궂어라ᄒᆞ다|gujeorahawda	<i>verb</i><br><ol><li>to hate; to dislike</li></ol>
권작|gwonjak	<i>noun</i><br><ol><li>acrobatics, somerset, tumbling</li></ol>
궤|gwe	<i>noun</i><br><ol><li>cat</li></ol>
궤기|gwegi	<i>noun</i><br><ol><li>meat</li><li>fish</li></ol>
궤다|궨|gweda|궤영|궤난|궤연|궹	<i>verb</i><br><ol><li>(transitive) to prop up</li><li>(transitive) to pile up, arrange in a pile</li><li>(intransitive) to pool, for water to gather up</li><li>(intransitive) (of alcohol, sauce) to bubble up when fermented</li><li>(transitive) to love</li><li>(intransitive) (of people or insects) to be infested with, to swarm</li><li>(intransitive) to boil</li></ol>
궤팡|gwepang	<i>noun</i><br><ol><li>warehouse</li></ol>
궨당|gwendang	<i>noun</i><br><ol><li>relatives</li></ol>
궵다|gwepda	<i>adj</i><br><ol><li>(to be) cute</li></ol>
귀정|gwijeong	<i>noun</i><br><ol><li>small hill</li></ol>
귓자락|gwitjarak	<i>noun</i><br><ol><li>earlobe</li></ol>
그|geu	<i>det</i><br><ol><li>(demonstrative) that</li></ol>
그깽이|geukkaeng'i	<i>noun</i><br><ol><li>end; conclusion</li></ol>
그디|geudi	<i>pron</i><br><ol><li>there</li></ol>
그르후제|geureuhuje	<i>adv</i><br><ol><li>someday</li></ol>
그슬|geuseul	<i>noun</i><br><ol><li>autumn; fall</li></ol>
그지게|geujige	<i>noun</i><br><ol><li>the day before yesterday</li></ol>
그척|geucheok	<i>noun</i><br><ol><li>sign</li><li>indication</li></ol>
글ᄌᆞ|geuljaw	<i>noun</i><br><ol><li>A letter or character of a writing system.</li></ol>
금|geum	<i>noun</i><br><ol><li>gold</li><li>price</li></ol>
금승|geumseung	<i>noun</i><br><ol><li>a yearling (one-year old)</li></ol>
금승매|geumseungmae	<i>noun</i><br><ol><li>a one-year-old horse</li></ol>
기|gi	<i>intj</i><br><ol><li>(casual) really?</li></ol>
기ᄑᆞᆷ|gipawm	<i>noun</i><br><ol><li>(Seogwipo) oil</li></ol>
기곙이|gigyeng'i	<i>noun</i><br><ol><li>machine</li></ol>
기렵다|giryeopda	<i>adj</i><br><ol><li>to be dear, beloved</li><li>to be longed for, to be missed</li></ol>
기실|gisil	<i>noun</i><br><ol><li>energy, vigor</li></ol>
기여이|giyeoi	<i>adv</i><br><ol><li>certainly</li><li>without fail</li></ol>
기영|giyeong	<i>adv</i><br><ol><li>like that</li></ol>
김뀌|kimkkwi	<i>noun</i><br><ol><li>kimchi</li></ol>
김끼|gimkki	<i>noun</i><br><ol><li>kimchi, a dish made with fermented, seasoned vegetables</li></ol>
김장|gimjang	<i>noun</i><br><ol><li>soy sauce</li></ol>
깅이|ging'i	<i>noun</i><br><ol><li>(Jeju City) crab</li></ol>
까닥|kkadak	<i>noun</i><br><ol><li>reason, cause</li></ol>
까망ᄒᆞ다|kkamanghawda	<i>adj</i><br><ol><li>(to be) deep black</li></ol>
깍|kkak	<i>noun</i><br><ol><li>edge</li><li>bottom; last; end</li></ol>
깍녹|kkangnok	<i>noun</i><br><ol><li>deer</li></ol>
깝|kkap	<i>noun</i><br><ol><li>price</li><li>value</li></ol>
깨격|kkaegyeok	<i>noun</i><br><ol><li>monetary price</li></ol>
깨붑다|kkaebupda	<i>adj</i><br><ol><li>(to be) light (not heavy)</li></ol>
꺼멍ᄒᆞ다|kkeomeonghawda	<i>adj</i><br><ol><li>(to be) very black</li></ol>
께다|kkeda	<i>verb</i><br><ol><li>to break; to smash; to shatter, to crack</li></ol>
꼿|kkot	<i>noun</i><br><ol><li>flower; flowering plant</li></ol>
꼿밧|kkotbat	<i>noun</i><br><ol><li>flower garden</li></ol>
꽝|kkwang	<i>noun</i><br><ol><li>bone</li></ol>
꿈|kkum	<i>noun</i><br><ol><li>dream</li></ol>
끌르다|kkeulleuda	<i>verb</i><br><ol><li>to boil (something)</li><li>to take off, undo</li></ol>
나|na	<i>pron</i><br><ol><li>I, the first-person singular pronoun</li></ol><br><i>noun</i><br><ol><li>age</li></ol>
나그네|nageune	<i>noun</i><br><ol><li>(honorific) shaman, priest of the traditional religion</li></ol>
나끄다|nakkeuda	<i>noun</i><br><ol><li>to fish</li></ol>
나놔다|nanwada	<i>verb</i><br><ol><li>to divide (into pieces); to split up</li><li>(mathematics) to divide</li><li>to share</li></ol>
나데읏다|nadeeutda	<i>adj</i><br><ol><li>to be weak and without energy</li></ol>
나라|nara	<i>noun</i><br><ol><li>country, nation, kingdom</li></ol>
나록|narok	<i>noun</i><br><ol><li>rice plant</li></ol>
나시다|nasida	<i>adj</i><br><ol><li>to be sharp, pointed</li></ol>
나이|nai	<i>noun</i><br><ol><li>age of a person or other living thing</li></ol>
나흘|naheul	<i>noun</i><br><ol><li>four days</li></ol>
날ᄍᆞ|naljjaw	<i>noun</i><br><ol><li>date, days</li></ol>
날날이|nallari	<i>adv</i><br><ol><li>day by day</li></ol>
날씨|nalssi	<i>noun</i><br><ol><li>weather</li></ol>
날쿠시|nalkusi	<i>noun</i><br><ol><li>A sign of bad weather</li></ol>
남녜|namnye	<i>noun</i><br><ol><li>men and women</li><li>male and female</li></ol>
남비|nambi	<i>noun</i><br><ol><li>a cooking pot</li></ol>
남인가장|namingajang	<i>noun</i><br><ol><li>patriarch</li></ol>
낫|nat	<i>noun</i><br><ol><li>daytime; noon</li></ol>
낭|nang	<i>noun</i><br><ol><li>tree</li></ol>
낮후제|nachuje	<i>noun</i><br><ol><li>p.m.</li><li>afternoon</li></ol>
내낭|naenang	<i>adv</i><br><ol><li>throughout, through, all the time</li></ol>
내치다|naechida	<i>verb</i><br><ol><li>To disgorge, discharge, regurgitate, spew, throw up, vomit</li></ol>
냄편|naempyeon	<i>noun</i><br><ol><li>husband</li></ol>
냉장고|naengjanggo	<i>noun</i><br><ol><li>refrigerator, fridge</li></ol>
너내|neonae	<i>pron</i><br><ol><li>second-person plural pronoun; you</li></ol>
넙다|neopda	<i>adj</i><br><ol><li>(to be) wide</li></ol>
넛하르방|neothareubang	<i>noun</i><br><ol><li>Father's loyalty</li></ol>
네|ne	<i>det</i><br><ol><li>four</li></ol><br><i>noun</i><br><ol><li>smoke</li></ol>
넷|net	<i>num</i><br><ol><li>four</li></ol>
넹기다|nenggida	<i>verb</i><br><ol><li>to pass, pass over, tide over</li></ol>
노끄다|nokkeuda	<i>adj</i><br><ol><li>to be high, tall, lofty</li></ol>
노대|nodae	<i>noun</i><br><ol><li>wave</li></ol>
노랑ᄒᆞ다|noranghawda	<i>adj</i><br><ol><li>(to be) yellow</li></ol>
노렴|noryeom	<i>noun</i><br><ol><li>anger, indignation</li></ol>
노리|nori	<i>noun</i><br><ol><li>roe deer (Capreolus pygargus)</li></ol>
노린재|norinjae	<i>noun</i><br><ol><li>shield bug</li></ol>
노릿노릿ᄒᆞ다|norinnorithawda	<i>adj</i><br><ol><li>(to be) gold; golden</li></ol>
노프다|nopeuda	<i>adj</i><br><ol><li>to be high, tall, lofty</li></ol>
노피|nopi	<i>noun</i><br><ol><li>height</li></ol>
녹대|nokdae	<i>noun</i><br><ol><li>bridle; halter</li></ol>
놀|nol	<i>noun</i><br><ol><li>wave</li><li>twilight</li></ol>
놀다|nolda	<i>verb</i><br><ol><li>to play, to frolic</li></ol>
놀래|놀레|nolle|nollae	<i>noun</i><br><ol><li>song</li></ol>
놀이개|norigae	<i>noun</i><br><ol><li>play; game; pastime; amusement</li></ol>
놋쒜|notsswe	<i>noun</i><br><ol><li>brass</li></ol>
누게|nuge	<i>pron</i><br><ol><li>who</li><li>someone</li></ol>
누님|nunim	<i>noun</i><br><ol><li>older sister of a male</li></ol>
누의|nuui	<i>noun</i><br><ol><li>sister</li></ol>
눌레기땅|nullegittang	<i>noun</i><br><ol><li>clay</li></ol>
느|neu	<i>pron</i><br><ol><li>second-person singular pronoun; you (informal)</li></ol>
느릇|neureut	<i>noun</i><br><ol><li>declivity, downhill, slope</li></ol>
느리다|neurida	<i>adj</i><br><ol><li>to be slow</li></ol>
늣|neut	<i>noun</i><br><ol><li>moss</li></ol>
늬|nui	<i>noun</i><br><ol><li>lice</li><li>teeth</li></ol>
늬귀|nuigwi	<i>noun</i><br><ol><li>rectangle, quadrangle, square</li></ol>
늿|nuit	<i>num</i><br><ol><li>four</li></ol>
니께미|nikkemi	<i>noun</i><br><ol><li>acne</li></ol>
니향|nihyang	<i>adv</i><br><ol><li>always, forever</li></ol>
님금|nimgeum	<i>noun</i><br><ol><li>king</li></ol>
다|da	<i>adv</i><br><ol><li>everything, all</li></ol>
다ᄉᆞᆺ|dasawt	<i>num</i><br><ol><li>five</li></ol>
다간|dagan	<i>noun</i><br><ol><li>two years of age (for livestock animals)</li></ol>
다리다|darida	<i>verb</i><br><ol><li>to iron</li><li>to press</li></ol>
다리웨|dariwe	<i>noun</i><br><ol><li>flatiron, iron</li></ol>
다믄|dameun	<i>adv</i><br><ol><li>only</li></ol>
다히다|dahida	<i>verb</i><br><ol><li>(intransitive) to wear down</li></ol>
닥닥|dakdaK	<i>intj</i><br><ol><li>knock-knock (verbal knocking sound)</li></ol>
닷|dat	<i>det</i><br><ol><li>five</li></ol>
닷세|datse	<i>noun</i><br><ol><li>five days</li></ol>
당신|dangsin	<i>pron</i><br><ol><li>second person singular plain (non-polite) pronoun; you</li></ol>
당신덜|dangsindeol	<i>pron</i><br><ol><li>you (plural)</li></ol>
대국|daeguk	<i>noun</i><br><ol><li>big country, major power</li></ol><br><i>name</i><br><ol><li>China</li></ol>
대비|taebi	<i>noun</i><br><ol><li>socks</li></ol>
대오리|dae'ori	<i>noun</i><br><ol><li>oat</li></ol>
대풍|daepung	<i>noun</i><br><ol><li>a typhoon</li></ol>
더듸다|deoduida	<i>adj</i><br><ol><li>to be slow</li></ol>
덜기|deolgi	<i>noun</i><br><ol><li>berry (fruit)</li></ol>
덥다|deopda	<i>adj</i><br><ol><li>(to be) hot, warm</li></ol>
덩드렁마께|deongdeureongmakke	<i>noun</i><br><ol><li>a club, a bat</li></ol>
도|do	<i>noun</i><br><ol><li>entrance</li><li>(chiefly in compounds) god, deity</li></ol>
도곰|dogom	<i>noun</i><br><ol><li>a wool mat under a saddle</li></ol>
도데|dode	<i>noun</i><br><ol><li>a traditional lighthouse</li></ol>
도새기|dosaegi	<i>noun</i><br><ol><li>pig</li></ol>
도왜다|dowaeda	<i>verb</i><br><ol><li>(transitive) to help; to contribute</li></ol>
독ᄆᆞᄅᆞᆸ|dokmawrawp	<i>noun</i><br><ol><li>knee</li></ol>
돔베|dombe	<i>noun</i><br><ol><li>chopping board</li></ol>
돗|dot	<i>noun</i><br><ol><li>pig</li></ol>
동고리|donggori	<i>noun</i><br><ol><li>candy (piece of candy)</li></ol>
동골동골|donggoldonggol	<i>noun</i><br><ol><li>(of a small object) round</li></ol>
동곳|donggot	<i>noun</i><br><ol><li>icicle</li></ol>
동공ᄄᆞᆯ|donggongttawl	<i>noun</i><br><ol><li>beloved daughter</li></ol>
동공아ᄃᆞᆯ|donggong'adawl	<i>noun</i><br><ol><li>beloved son</li></ol>
동공아덜|donggong'adeol	<i>noun</i><br><ol><li>beloved son</li></ol>
동모|dongmo	<i>noun</i><br><ol><li>friend</li></ol>
동산|dongsan	<i>noun</i><br><ol><li>knoll, hill</li></ol>
동셍|dongseng	<i>noun</i><br><ol><li>younger sibling (brother or sister)</li></ol>
두|du	<i>num</i><br><ol><li>two</li></ol>
두게|duge	<i>num</i><br><ol><li>two</li></ol>
두께|dukke	<i>noun</i><br><ol><li>lid</li></ol>
두덥다|dudeopda	<i>adj</i><br><ol><li>(to be) thick</li></ol>
두루붕이|durubung'i	<i>noun</i><br><ol><li>fool, idiot</li></ol>
두리다|durida	<i>verb</i><br><ol><li>(derogatory) to go crazy, to become insane</li></ol>
둘|dul	<i>num</i><br><ol><li>two</li></ol>
둠비|dumbi	<i>noun</i><br><ol><li>tofu, bean curd</li></ol>
뒹글다|dwinggeulda	<i>adj</i><br><ol><li>to be round, circular</li></ol>
드르|deureu	<i>noun</i><br><ol><li>meadow</li></ol>
드르쓰다|deureusseuda	<i>verb</i><br><ol><li>to drink</li></ol>
들랑들랑|deullangdeullang	<i>adv</i><br><ol><li>(onomatopoeia) The sound of jingling.</li></ol>
들렁놕들렁놕ᄒᆞ다|deulleongnwakdeulleongnwakhawda	<i>verb</i><br><ol><li>to pick up and release things</li></ol>
들르다|deulleuda	<i>verb</i><br><ol><li>(transitive) to hold</li></ol>
따|tta	<i>noun</i><br><ol><li>earth (as opposed to the sky or heaven)</li><li>land (as opposed to the sea or ocean), ground, soil, estate</li></ol>
때|ttae	<i>noun</i><br><ol><li>time; hour</li><li>meal</li></ol>
떨다|tteolda	<i>verb</i><br><ol><li>to tremble</li></ol>
떼역|tteyeok	<i>noun</i><br><ol><li>lawn</li></ol>
또|tto	<i>adv</i><br><ol><li>also</li><li>again</li></ol>
또까또까|ttokkattokka	<i>adv</i><br><ol><li>sound of heart beating: pit-a-pat</li></ol>
똥|ttong	<i>noun</i><br><ol><li>stool, feces</li></ol>
똥버렝이|ttongbeoreng'i	<i>noun</i><br><ol><li>maggot</li></ol>
뜨다|tteuda	<i>verb</i><br><ol><li>to drift</li><li>to float</li></ol>
뜬 쉐가 울 넘나|tteun swe-ga ul neomna	<i>proverb</i><br><ol><li>appearances are deceptive, you can't judge a book by its cover</li></ol>
뜰리다|tteullida	<i>verb</i><br><ol><li>to become turned, twisted</li><li>to become wrong</li></ol>
마ᄇᆞ름|mabawreum	<i>noun</i><br><ol><li>south wind</li></ol>
마눌|manul	<i>noun</i><br><ol><li>garlic</li></ol>
마당|madang	<i>noun</i><br><ol><li>A yard.</li></ol>
마시다|masida	<i>verb</i><br><ol><li>to drink</li></ol>
마은|ma'eun	<i>num</i><br><ol><li>forty</li></ol>
마트다|mateuda	<i>verb</i><br><ol><li>(transitive) to smell</li></ol>
만뒤떡|mandwitteok	<i>noun</i><br><ol><li>mandu, a form of dumpling in Korean cuisine</li></ol>
만들다|mandeulda	<i>verb</i><br><ol><li>to make</li></ol>
말|mal	<i>noun</i><br><ol><li>word</li><li>speech</li><li>language</li></ol>
말매이|malmaei	<i>noun</i><br><ol><li>lily (plant)</li></ol>
말축|malchuk	<i>noun</i><br><ol><li>grasshopper</li><li>wart</li></ol>
맛싯다|matsitda	<i>adj</i><br><ol><li>delicious</li></ol>
맛엇다|madeotda	<i>adj</i><br><ol><li>to be tasteless, not tasty</li></ol>
맞다|matda	<i>verb</i><br><ol><li>to hit</li><li>to strike</li></ol>
매비|maebi	<i>noun</i><br><ol><li>brother-in-law (younger sister's husband)</li></ol>
맹길다|maenggilda	<i>verb</i><br><ol><li>to make</li></ol>
머력|meoryeok	<i>noun</i><br><ol><li>hair</li></ol>
먹다|meokda	<i>verb</i><br><ol><li>to eat, to drink</li><li>to join</li></ol>
멋싯다|meotsitda	<i>adj</i><br><ol><li>wonderful, nice, cool</li><li>good-looking, handsome, attractive</li></ol>
메께라|mekkera	<i>intj</i><br><ol><li>An expression of shock and amazement by someone's words or actions.</li></ol>
메날|menal	<i>adv</i><br><ol><li>daily, every day</li></ol>
메누리|menuri	<i>noun</i><br><ol><li>daughter-in-law</li></ol>
메역바당|meyeokbadang	<i>noun</i><br><ol><li>A place where seaweed grows</li></ol>
메웁다|me'upda	<i>adj</i><br><ol><li>(to be) spicy, hot (usually of food)</li></ol>
메치|mechi	<i>noun</i><br><ol><li>the appearance of a person</li><li>surface appearance in general</li><li>aspect of a matter</li></ol>
멕이다|megida	<i>verb</i><br><ol><li>to feed something, to cause to eat</li></ol>
멘헤|menhe	<i>noun</i><br><ol><li>cotton</li></ol>
멜위|merwi	<i>noun</i><br><ol><li>cranefly larva</li></ol>
멧|met	<i>det</i><br><ol><li>how many</li><li>which number</li><li>some</li></ol>
멧 시우꽈	<i>phrase</i><br><ol><li>(polite, formal) What time is it?</li></ol>
멩글다|멩글안|menggeulda|멩글앙|멩그난	<i>verb</i><br><ol><li>(transitive) to make, construct</li></ol>
멩령|mengnyeong	<i>noun</i><br><ol><li>order, command</li></ol>
멩질|mengjil	<i>noun</i><br><ol><li>seasonal festival</li><li>holiday</li></ol>
모냥|monyang	<i>noun</i><br><ol><li>shape; surface appearance</li></ol>
모도|modo	<i>adv</i><br><ol><li>altogether</li></ol>
모살|mosal	<i>noun</i><br><ol><li>sand</li></ol>
모시딱|mosittak	<i>adv</i><br><ol><li>altogether</li></ol>
목솜|moksom	<i>noun</i><br><ol><li>life</li></ol>
목수권|moksugwon	<i>noun</i><br><ol><li>scarf, muffler</li></ol>
몰레|molle	<i>noun</i><br><ol><li>sand</li></ol>
몸짐|momjim	<i>noun</i><br><ol><li>body temperature</li></ol>
무끄다|mukkeuda	<i>verb</i><br><ol><li>to tie up; to bind</li></ol>
무사|musa	<i>adv</i><br><ol><li>why</li></ol>
무스것|meuseugeot	<i>pron</i><br><ol><li>(interrogative) what</li></ol>
무시다|musida	<i>adj</i><br><ol><li>to be worried or afraid of something</li><li>to be worrisome or fearsome</li></ol>
무신거|musin-geo	<i>pron</i><br><ol><li>(interrogative) what</li></ol>
문세|munse	<i>noun</i><br><ol><li>document</li></ol>
묻다|mutda	<i>verb</i><br><ol><li>to be scattered, sown</li><li>to be constructed</li></ol>
물|mul	<i>noun</i><br><ol><li>water</li></ol>
물궤기|mulgwegi	<i>noun</i><br><ol><li>fish (animal)</li></ol>
물알|mural	<i>noun</i><br><ol><li>underwater</li></ol>
물웨|murwe	<i>noun</i><br><ol><li>cucumber</li></ol>
미|mi	<i>noun</i><br><ol><li>guy</li></ol>
미국나팔꽃|migungnapalkkot	<i>noun</i><br><ol><li>(botany) Campsis grandiflora (Chinese trumpet vine)</li><li>(botany) the flower of the Campsis grandiflora</li></ol>
미깡|mikkang	<i>noun</i><br><ol><li>mandarin orange</li><li>tangerine</li></ol>
미녕실|minyeongsil	<i>noun</i><br><ol><li>cotton thread</li></ol>
미리|miri	<i>noun</i><br><ol><li>dragon</li></ol>
미리내|mirinae	<i>name</i><br><ol><li>the Milky Way</li><li>the Galaxy</li></ol>
미리헤치|mirihechi	<i>noun</i><br><ol><li>(astrology) The year of the dragon, the fifth year in the cycle of twelve years under the lunar calendar.</li></ol>
미안ᄒᆞ다|mianhawda	<i>adj</i><br><ol><li>to be sorry</li></ol><br><i>intj</i><br><ol><li>I'm sorry (Addressing a person of equal or lower status)</li></ol>
미여이ᄒᆞ다|miyeoihawda	<i>verb</i><br><ol><li>to hate, to dislike</li></ol>
미워ᄒᆞ다|miwohawda	<i>verb</i><br><ol><li>to hate, to dislike</li></ol>
밀ᄏᆞ를|milkawreul	<i>noun</i><br><ol><li>flour</li></ol>
바ᄅᆞᆺ구덕|barawtgudeok	<i>noun</i><br><ol><li>A basket of fish or seafood</li></ol>
바꼇|bakkyeot	<i>noun</i><br><ol><li>outside</li><li>exterior</li></ol>
바농|banong	<i>noun</i><br><ol><li>needle</li></ol>
바당|와당|wadang|badang	<i>noun</i><br><ol><li>sea, ocean</li></ol>
바당ᄇᆞ름|badangbawreum	<i>noun</i><br><ol><li>sea breeze</li></ol>
바를|bareul	<i>noun</i><br><ol><li>(Seogwipo) sea</li></ol>
바지|baji	<i>noun</i><br><ol><li>pants, trousers</li></ol>
바툼|batum	<i>noun</i><br><ol><li>support, pad, mat, saucer</li><li>a consonant or consonant cluster in the final position of hangeul orthography.</li></ol>
박긔|bakgui	<i>noun</i><br><ol><li>land</li></ol>
박화|bakhwa	<i>noun</i><br><ol><li>mint</li></ol>
반ᄃᆞᆯ|bandawl	<i>noun</i><br><ol><li>Half-moon</li></ol>
반갑다|bangapda	<i>adj</i><br><ol><li>(to be) glad</li><li>(to be) happy</li></ol>
반착|banchak	<i>noun</i><br><ol><li>half</li></ol>
발|bal	<i>noun</i><br><ol><li>foot (of a human or animal)</li></ol>
발강ᄒᆞ다|발강헹|balganghawda|발강헨|발강ᄒᆞ난|발강ᄒᆞ연|발강ᄒᆞ영	<i>adj</i><br><ol><li>(to be) red</li></ol>
발락|ballak	<i>adv</i><br><ol><li>fully, to the full, thoroughly</li></ol>
발멩|balmeng	<i>noun</i><br><ol><li>invention</li></ol>
밤낫|bamnat	<i>noun</i><br><ol><li>day and night</li></ol>
밥ᄒᆞ다|baphawda	<i>verb</i><br><ol><li>to cook rice</li></ol>
밥체시|bapchesi	<i>noun</i><br><ol><li>A person who eats a lot of rice</li></ol>
밧|bat	<i>noun</i><br><ol><li>field, dry land for crops.</li></ol>
방|bang	<i>noun</i><br><ol><li>seed hole (a place for seeds)</li></ol>
방둥이|bangdung'i	<i>noun</i><br><ol><li>toy</li></ol>
방뒤|bangdwi	<i>noun</i><br><ol><li>toy</li></ol>
배치|baechi	<i>noun</i><br><ol><li>cabbage</li></ol>
버데가다|beodegada	<i>verb</i><br><ol><li>to go out with friends</li></ol>
버렝이|beoreng'i|beorweng'i|버뤵이	<i>noun</i><br><ol><li>bug, insect (any small arthropod such as insects, spiders, etc.)</li><li>maggot</li></ol>
버부와리|beobuwari	<i>noun</i><br><ol><li>(derogatory) A person whose pronunciation is incorrect when speaking.</li></ol>
버염|beoyeom	<i>noun</i><br><ol><li>snake; serpent</li></ol>
벗|beot|멩	<i>noun</i><br><ol><li>friend, companion</li></ol>
베|be	<i>noun</i><br><ol><li>stomach</li><li>ship, boat, vessel</li><li>pear</li><li>times as much</li></ol>
베고프다|begopeuda	<i>adj</i><br><ol><li>(to be) hungry</li></ol>
베낭|benang	<i>noun</i><br><ol><li>pear tree</li></ol>
베염|beyeom	<i>noun</i><br><ol><li>snake, serpent</li></ol>
베와주다|베와줜|베와줭|베와주엉|베와주언|bewajuda|베와주난	<i>verb</i><br><ol><li>to teach</li></ol>
베조개|bejogae	<i>noun</i><br><ol><li>Manila clam, Tapes philippinarum (edible clams; often cooked with rice congees in Korea)</li></ol>
베치|bechi|페기	<i>noun</i><br><ol><li>napa cabbage</li></ol>
벡|白|百|bek|벡—	<i>num</i><br><ol><li>hundred</li></ol><br><i>noun</i><br><ol><li>white (used solely in compounds)</li></ol><br><i>prefix</i><br><ol><li>white</li></ol>
벤소|benso	<i>noun</i><br><ol><li>toilet</li></ol>
벤호사|benhosa	<i>noun</i><br><ol><li>lawyer, solicitor, counsel, attorney, barrister</li></ol>
벨|bel	<i>noun</i><br><ol><li>star</li></ol>
벨멩|belmeng	<i>noun</i><br><ol><li>alias, nickname</li></ol>
벨장게|beljangge	<i>noun</i><br><ol><li>shooting star, meteor</li></ol>
벵|beng	<i>noun</i><br><ol><li>bottle</li></ol>
벵완|beng'wan	<i>noun</i><br><ol><li>a hospital</li><li>(by extension) any facility for healing or treatment of people, animals, or things</li><li>(South Korean law) a medical facility capable of handling 30 or more patients at a time</li></ol>
보곰지|bogomji	<i>noun</i><br><ol><li>purse</li></ol>
보뎅이|bodeng'i	<i>noun</i><br><ol><li>(vulgar) vagina, pussy</li></ol>
보드랍다|bodeurapda	<i>adj</i><br><ol><li>(to be) soft</li></ol>
보롬날|boromnal	<i>noun</i><br><ol><li>the fifteenth day of the lunar month</li></ol>
보리클|borikeul	<i>noun</i><br><ol><li>A farm equipment to reduce barley grains</li></ol>
복성게|bokseongge	<i>noun</i><br><ol><li>peach</li></ol>
복송|boksong	<i>noun</i><br><ol><li>peach (fruit)</li></ol>
봄|bom	<i>noun</i><br><ol><li>spring, springtime</li></ol>
봅서|bopseo	<i>phrase</i><br><ol><li>Hello</li><li>Good morning</li><li>Good afternoon</li><li>Good evening</li></ol>
봉그다|bonggeuda	<i>verb</i><br><ol><li>to pick up</li></ol>
부루|buru	<i>noun</i><br><ol><li>lettuce</li></ol>
부름씨|bureumssi	<i>noun</i><br><ol><li>errand</li></ol>
부름씨ᄒᆞ다|bureumssihawda	<i>verb</i><br><ol><li>to go on an errand</li></ol>
부름씨꾼|bureumssikkun	<i>noun</i><br><ol><li>messenger</li></ol>
부섭|buseop	<i>noun</i><br><ol><li>kitchen</li></ol>
북|buk	<i>noun</i><br><ol><li>a generic term meaning drum</li><li>a traditional Korean double-headed barrel-shaped drum, played with one hand and one stick, and used in Korean folk music</li></ol>
불껑|bulkkeong	<i>noun</i><br><ol><li>ash</li></ol>
불초다|bulchoda	<i>verb</i><br><ol><li>to roast</li></ol>
불환디|burhwandi	<i>noun</i><br><ol><li>firefly</li></ol>
붉은알|bulgeunal	<i>noun</i><br><ol><li>yolk</li></ol>
브랜드|beuraendeu	<i>noun</i><br><ol><li>brand</li></ol>
비께|bikke	<i>noun</i><br><ol><li>carpet shark, wobbegong</li></ol>
비낌|bikkim	<i>noun</i><br><ol><li>an oblique stroke of a letter in writing</li></ol>
비들귀|bideulgwi	<i>noun</i><br><ol><li>pigeon, dove</li></ol>
비르|bireu	<i>noun</i><br><ol><li>beer</li></ol>
비바리|bibari	<i>noun</i><br><ol><li>An unmarried woman</li></ol>
비치다|bichida	<i>verb</i><br><ol><li>to lay, put</li></ol>
비헹기|bihenggi	<i>noun</i><br><ol><li>airplane</li></ol>
빈내|binnae	<i>noun</i><br><ol><li>hairpin (often decorative)</li></ol>
빗|bit	<i>noun</i><br><ol><li>light</li></ol>
빙애기|bing-aegi	<i>noun</i><br><ol><li>chick</li></ol>
빚채|pitchae	<i>noun</i><br><ol><li>debt</li></ol>
빠쓰|ppasseu	<i>noun</i><br><ol><li>bus</li></ol>
빨강ᄒᆞ다|빨강ᄒᆞ영|빨강헹|빨강ᄒᆞ연|ppalganghawda|빨강ᄒᆞ난|빨강헨	<i>adj</i><br><ol><li>(uncommon) (to be) brightly deep red</li></ol>
뺑이|ppaeng'i	<i>noun</i><br><ol><li>drawer</li></ol>
뽕|ppong	<i>noun</i><br><ol><li>form, shape</li></ol>
뽕끄랑ᄒᆞ다|ppongkkeuranghawda	<i>adj</i><br><ol><li>to be full</li></ol>
뿔새위|ppulsaewi	<i>noun</i><br><ol><li>crayfish</li></ol>
뿕다|ppukda	<i>adj</i><br><ol><li>(to be) red</li></ol>
삐얌|ppiyam	<i>noun</i><br><ol><li>cheek</li></ol>
사ᄅᆞᆷ|sarawm	<i>noun</i><br><ol><li>human; person; people</li></ol>
사과|sagwa	<i>noun</i><br><ol><li>apple</li></ol>
사구다|saguda	<i>verb</i><br><ol><li>to go out with, date</li><li>to make a friend</li></ol>
사귀|sagwi	<i>noun</i><br><ol><li>demon; imp</li></ol>
사농개|sanonggae	<i>noun</i><br><ol><li>hound (dog)</li></ol>
사름|sareum	<i>noun</i><br><ol><li>person, people, human</li></ol>
사름수질|sareumsujil	<i>noun</i><br><ol><li>A kind of Korean dessert made with sugar, rice, and powdered beans.</li></ol>
사진끼|sajinkki	<i>noun</i><br><ol><li>camera</li></ol>
사포|sapo	<i>noun</i><br><ol><li>hat</li></ol>
사훼|sahwe	<i>noun</i><br><ol><li>society</li></ol>
사흘|saheul	<i>noun</i><br><ol><li>three days</li></ol>
산|san	<i>noun</i><br><ol><li>mountain</li><li>tomb</li></ol>
산뒈야지|sandweyaji	<i>noun</i><br><ol><li>wild boar</li></ol>
산물|sanmul	<i>noun</i><br><ol><li>orange</li></ol>
삼|sam	<i>num</i><br><ol><li>three</li><li>third</li></ol>
삼돌|samdol	<i>noun</i><br><ol><li>(geometry) triangle</li></ol>
삼수매|samsumae	<i>noun</i><br><ol><li>a three year-old horse</li></ol>
삼쉬매|samswimae	<i>noun</i><br><ol><li>a three year-old horse</li></ol>
삼십|samsip	<i>num</i><br><ol><li>thirty</li></ol>
삼월|samwol	<i>noun</i><br><ol><li>March</li></ol>
상군|sanggun	<i>noun</i><br><ol><li>A female diver who can hold her breath for a long time while diving and is good at seafood picking.</li></ol>
상이|sang'i	<i>noun</i><br><ol><li>bird</li></ol>
새각시|saegaksi	<i>noun</i><br><ol><li>bride</li></ol>
새끼손가랑|saekkisongarang	<i>noun</i><br><ol><li>little finger, pinkie finger</li></ol>
새베|saebe	<i>noun</i><br><ol><li>dawn; daybreak</li></ol>
새벡|saebek	<i>noun</i><br><ol><li>dawn; daybreak; cockcrow (also used to indicate time of the day, approximately from 1:00 a.m. to 3:00 a.m.)</li></ol>
새위|sawi|사위|saewi	<i>noun</i><br><ol><li>shrimp, prawn</li></ol>
새헤|saehe	<i>noun</i><br><ol><li>new year</li></ol>
색깔|saekkkal	<i>noun</i><br><ol><li>color</li></ol>
생이|saeng'i	<i>noun</i><br><ol><li>bird</li></ol>
서늉|seonyung	<i>noun</i><br><ol><li>sight</li></ol>
서답ᄒᆞ다|seodaphawda	<i>verb</i><br><ol><li>to wash, do laundry</li></ol>
서답비누|seodapbinu	<i>noun</i><br><ol><li>laundry soap</li></ol>
서울|seoul	<i>noun</i><br><ol><li>capital</li></ol><br><i>name</i><br><ol><li>Seoul (the capital city of South Korea)</li></ol>
서월|seowol	<i>noun</i><br><ol><li>(Seogwipo) capital</li></ol><br><i>name</i><br><ol><li>(Seogwipo) Seoul (the capital city of South Korea)</li></ol>
서을|seo'eul	<i>noun</i><br><ol><li>Korean New Year (same as Chinese New Year)</li></ol>
석유지름|seogyujireum	<i>noun</i><br><ol><li>oil, petroleum</li></ol>
선승|seonseung	<i>noun</i><br><ol><li>teacher</li></ol>
선싕|seonsuing	<i>noun</i><br><ol><li>teacher</li></ol>
선풍기|seonpunggi	<i>noun</i><br><ol><li>electric fan</li></ol>
섣ᄃᆞᆯ|seotdawl	<i>noun</i><br><ol><li>December</li><li>the twelfth month of the lunar calendar</li></ol>
설룬|seollun	<i>num</i><br><ol><li>thirty</li></ol>
섬|seom	<i>noun</i><br><ol><li>island</li></ol>
섭|seop	<i>noun</i><br><ol><li>leaf</li></ol>
성|seong	<i>noun</i><br><ol><li>older brother (of a male)</li><li>older sister (of a male)</li></ol>
성님|seongnim	<i>noun</i><br><ol><li>honorific of 성 (seong, “older brother of a male”)</li></ol>
성아시|seong'asi	<i>noun</i><br><ol><li>brothers</li></ol>
성제|seongje	<i>noun</i><br><ol><li>brothers</li></ol>
성하르방|seonghareubang	<i>noun</i><br><ol><li>paternal grandfather</li></ol>
세|se	<i>noun</i><br><ol><li>(seamen's) east, east wind</li></ol><br><i>det</i><br><ol><li>new</li></ol>
세경넙은드르|segyeongneobeundeureu	<i>noun</i><br><ol><li>An open field in all directions.</li></ol>
세상|sesang	<i>noun</i><br><ol><li>world</li></ol>
세염|seyeom	<i>noun</i><br><ol><li>counting</li></ol>
세파랑ᄒᆞ다|separanghawda	<i>adj</i><br><ol><li>deep blue</li><li>very young</li><li>deadly pale</li><li>very sharp</li></ol>
셋|set	<i>num</i><br><ol><li>three</li></ol>
셍|seng	<i>noun</i><br><ol><li>shape</li></ol>
셍ᄉᆞ|sengsaw	<i>noun</i><br><ol><li>life-and-death</li></ol>
셍강|senggang	<i>noun</i><br><ol><li>ginger (plant)</li></ol>
셍일날|seng'illal	<i>noun</i><br><ol><li>birthday</li></ol>
소곱|sogop	<i>noun</i><br><ol><li>the inside; especially that which is underneath or within a covering</li><li>content</li></ol>
소나이|sonai	<i>noun</i><br><ol><li>man (adult male human)</li><li>husband</li></ol>
소내아의|sonaeaui	<i>noun</i><br><ol><li>boy</li></ol>
소리|sori	<i>noun</i><br><ol><li>sound</li><li>song</li></ol>
소왕벌|sowangbeol	<i>noun</i><br><ol><li>any wasp or hornet in the family Vespidae</li></ol>
손지|sonji	<i>noun</i><br><ol><li>grandson</li></ol>
솟|sot	<i>noun</i><br><ol><li>(iron) pot, kettle, cauldron</li></ol>
송키|songki	<i>noun</i><br><ol><li>vegetables, greens</li></ol>
수구룩ᄒᆞ다|sugurukhawda	<i>adj</i><br><ol><li>To be very good</li></ol>
수물|sumul	<i>num</i><br><ol><li>twenty</li></ol>
수웨|suwe	<i>noun</i><br><ol><li>Korean blood sausage</li></ol>
순네|sunne	<i>noun</i><br><ol><li>mimicry</li></ol>
술칩|sulchip	<i>noun</i><br><ol><li>bar, pub</li></ol>
술펭|sulpeng	<i>noun</i><br><ol><li>liquor bottle</li></ol>
쉐|swe	<i>noun</i><br><ol><li>cow</li></ol>
쉐멍에|swemeong'e	<i>noun</i><br><ol><li>yoke</li></ol>
쉣ᄇᆞ름|swetbawreum	<i>noun</i><br><ol><li>whistle</li></ol>
쉬다|swida	<i>verb</i><br><ol><li>to be hoarse</li><li>to breathe</li></ol>
쉬염|swiyeom	<i>noun</i><br><ol><li>(facial hair) mustache, beard, whiskers</li></ol>
쉰|swin	<i>num</i><br><ol><li>fifty</li></ol>
스믈스믈|seumeulseumeul	<i>noun</i><br><ol><li>(of an insect) itchy, creepy-crawly</li></ol>
시갠|sigaen	<i>noun</i><br><ol><li>time</li><li>hour</li></ol>
시금초|sigeumcho	<i>noun</i><br><ol><li>spinach</li></ol>
시께테물|sikketemul	<i>noun</i><br><ol><li>leftover food after a rite</li></ol>
시다|sida	<i>verb</i><br><ol><li>to be (in a place); to exist</li><li>to have</li></ol>
시리|siri	<i>noun</i><br><ol><li>steamer (used to cook rice)</li></ol>
시물|simul	<i>num</i><br><ol><li>twenty</li></ol>
시믈|simeul	<i>num</i><br><ol><li>twenty</li></ol>
시상|sisang	<i>noun</i><br><ol><li>world</li></ol>
시시리실피|sisirisilpi	<i>adv</i><br><ol><li>very much</li></ol>
시왕맞이|siwangmaji	<i>noun</i><br><ol><li>(shamanism) a ritual performed in honor of the ten kings of the underworld.</li></ol>
시월|siwol	<i>noun</i><br><ol><li>October</li></ol>
시절|sijeol	<i>noun</i><br><ol><li>a period of time</li><li>a time of life; a season</li></ol>
시철|sicheol	<i>noun</i><br><ol><li>a period of time</li><li>a time of life; a season</li></ol>
식게|sikge	<i>noun</i><br><ol><li>sacrificial rites in honor of an ancestor or god.</li></ol>
실|sil	<i>noun</i><br><ol><li>thread</li></ol>
실기ᄒᆞ다|silgihawda	<i>verb</i><br><ol><li>to squash</li></ol>
실피|silpi	<i>adv</i><br><ol><li>to one's heart's content, heartily</li></ol>
심|sim	<i>noun</i><br><ol><li>strength; power</li></ol>
심다|simda	<i>verb</i><br><ol><li>to catch; to hold; to grasp; to grip</li><li>to seize</li><li>to plant</li></ol>
심바람ᄒᆞ다|simbaramhawda	<i>verb</i><br><ol><li>to run an errand</li></ol>
심방|simbang	<i>noun</i><br><ol><li>shaman; initiated priest of the indigenous religion of Jeju Island</li></ol>
십관|sipgwan	<i>noun</i><br><ol><li>habit</li></ol>
십수매|sipsumae	<i>noun</i><br><ol><li>a ten year-old horse</li></ol>
십일월|sibirwol	<i>noun</i><br><ol><li>November</li></ol>
싯|sit	<i>num</i><br><ol><li>(parts of Jeju City, most of Seogwipo) three</li></ol>
싯다|sitda	<i>verb</i><br><ol><li>to be (in a place); to exist</li><li>to have</li><li>to wash</li></ol>
싱각|singgak	<i>noun</i><br><ol><li>idea; thought</li></ol>
싱싱ᄒᆞ다|singsinghawda	<i>adj</i><br><ol><li>fresh</li></ol>
싸무랍다|ssamurapda	<i>adj</i><br><ol><li>to be harsh, wild</li></ol>
싸분|ssabun	<i>noun</i><br><ol><li>soap</li></ol>
쎄다|sseda	<i>adj</i><br><ol><li>(to be) strong</li></ol>
쏨씨|ssomssi	<i>noun</i><br><ol><li>skill</li><li>workmanship</li></ol>
쏭쏭쏭쏭|ssongssongssongssong	<i>adv</i><br><ol><li>calmly</li><li>soundly</li></ol>
쒜|sswe	<i>noun</i><br><ol><li>iron</li></ol>
쒜낙마|sswenangma	<i>noun</i><br><ol><li>East Asian rainy season between spring and summer</li></ol>
쒜우다|ssweuda	<i>verb</i><br><ol><li>to expose oneself; to air oneself</li></ol>
씨동승|ssidongseung	<i>noun</i><br><ol><li>brother-in-law (younger brother of one's husband)</li></ol>
씨롬|ssirom	<i>noun</i><br><ol><li>wrestling</li><li>Ssireum, traditional Korean wrestling</li></ol>
씨아방|ssiabang	<i>noun</i><br><ol><li>father-in-law (husband's father)</li></ol>
씨아주방|ssiajubang	<i>noun</i><br><ol><li>brother-in-law (brother of one's husband)</li></ol>
씨어멍|ssieomeong	<i>noun</i><br><ol><li>mother-in-law (husband's mother)</li></ol>
아귀ᄐᆞᆨ|agwitawk	<i>noun</i><br><ol><li>chin</li></ol>
아깝다|akkapda	<i>adj</i><br><ol><li>(to be) cute</li></ol>
아끼다|akkida	<i>verb</i><br><ol><li>to take care</li></ol>
아덜|adeol	<i>noun</i><br><ol><li>son</li></ol>
아루미|arumi	<i>noun</i><br><ol><li>aluminum</li></ol>
아명ᄒᆞ다|amyeonghawda	<i>adj</i><br><ol><li>unspecific (as in being in an undefined, unspecific, or unimportant situation)</li><li>careless (as in doing something in a careless manner or on a whim)</li></ol>
아방|abang	<i>noun</i><br><ol><li>father</li></ol>
아벰|abem	<i>noun</i><br><ol><li>(honorific) father</li></ol>
아시예|asiye	<i>adv</i><br><ol><li>Altogether; entirely.</li><li>From the beginning; throughout.</li></ol>
아옵|aop	<i>num</i><br><ol><li>(parts of Jeju City, most of Seogwipo) nine</li></ol>
아옹|aong	<i>noun</i><br><ol><li>meow, miaow, the sound of a cat</li></ol>
아은|a'eun	<i>num</i><br><ol><li>ninety</li></ol>
아의|aui	<i>noun</i><br><ol><li>child</li></ol>
아이다|aida	<i>adj</i><br><ol><li>to be not (something)</li></ol>
아장|ajang	<i>noun</i><br><ol><li>daughter-in-law</li></ol>
아접씨|ajeopssi	<i>noun</i><br><ol><li>middle-aged elder male</li><li>uncle</li></ol>
아주방|ajubang	<i>noun</i><br><ol><li>middle-aged older male</li><li>uncle</li><li>mister, gentleman</li></ol>
아홉|ahop	<i>num</i><br><ol><li>nine</li></ol>
아흐레|aheure	<i>noun</i><br><ol><li>nine days</li></ol>
악귀|akgwi	<i>noun</i><br><ol><li>instrument; musical instrument</li></ol>
악매|akmae	<i>noun</i><br><ol><li>a demon; a devil; a fiend</li></ol>
안침|anchim	<i>noun</i><br><ol><li>underwear, undergarment</li></ol>
알|al	<i>noun</i><br><ol><li>below, bottom</li></ol>
알칭|alching	<i>noun</i><br><ol><li>downstairs</li></ol>
암벵|ambeng	<i>noun</i><br><ol><li>cancer (illness)</li></ol>
암컷|amkeot	<i>noun</i><br><ol><li>female</li></ol>
앞|ap	<i>noun</i><br><ol><li>fore, front</li></ol>
애기|aegi	<i>noun</i><br><ol><li>baby, infant</li></ol>
애옥|aeok	<i>noun</i><br><ol><li>pus</li></ol>
야단치다|yadanchida	<i>verb</i><br><ol><li>to scold</li></ol>
야의|yaui	<i>pron</i><br><ol><li>(sometimes proscribed) this kid; he or she</li></ol>
야이|yai	<i>pron</i><br><ol><li>this kid; he or she or you</li></ol>
야적|yajeok	<i>noun</i><br><ol><li>morning</li></ol>
야칸|yakan	<i>adv</i><br><ol><li>in any case, anyway, anyhow, at any rate</li></ol>
약방|yakbang	<i>noun</i><br><ol><li>pharmacy, drugstore</li></ol>
얄룹다|yallupda	<i>adj</i><br><ol><li>(to be) thin</li></ol>
양|ᄆᆞ리|yang	<i>intj</i><br><ol><li>yes</li></ol><br><i>noun</i><br><ol><li>sheep</li><li>goat</li></ol>
양착|yangchak	<i>noun</i><br><ol><li>both sides; both parties</li><li>both sides, either side</li></ol>
얘펜|yaepen	<i>noun</i><br><ol><li>opium</li></ol>
어ᄀᆞ라|eogawra	<i>adv</i><br><ol><li>soon</li></ol>
어껭이|eokkeng'i	<i>noun</i><br><ol><li>shoulders</li></ol>
어느제|eoneuje	<i>pron</i><br><ol><li>when</li></ol>
어덕|eodeok	<i>noun</i><br><ol><li>A sea where stones are placed in between the inland sea and the offing</li></ol>
어드|eodeu	<i>pron</i><br><ol><li>(interrogative, indeterminate) where</li></ol>
어러러|eoreoreo	<i>intj</i><br><ol><li>hup!</li></ol>
어멍|eomeong	<i>noun</i><br><ol><li>mother</li></ol>
어멤|eomem	<i>noun</i><br><ol><li>(honorific) mother</li></ol>
어스럼|eoseureom	<i>noun</i><br><ol><li>evening twilight; dusk</li></ol>
어스럼새벨|eoseureomsaebel	<i>name</i><br><ol><li>Venus (planet)</li></ol>
어시|eosi	<i>noun</i><br><ol><li>parent; parents</li></ol>
어시닮다|eosidamda	
얼금심금|eolgeumsimgeum	<i>adv</i><br><ol><li>sluggishly</li></ol>
얼다|eolda	<i>adj</i><br><ol><li>to be cold</li></ol><br><i>verb</i><br><ol><li>to freeze</li></ol>
얼망얼망|eolmang'eolmang	<i>adv</i><br><ol><li>flickeringly</li><li>waveringly</li></ol>
엄벙덤벙|eombeongdeombeong	<i>adv</i><br><ol><li>carelessly, thoughtlessly</li></ol>
엇다|eotda	<i>adj</i><br><ol><li>to have none; (to be) lacking; (to be) nonexistent</li></ol>
에비ᄄᆞᆯ|ebittawl	<i>noun</i><br><ol><li>father and daughter</li></ol>
에비아ᄃᆞᆯ|ebiadawl	<i>noun</i><br><ol><li>father and son</li></ol>
에어컨|eeokeon	<i>noun</i><br><ol><li>air conditioner</li></ol>
엥그리다|enggeurida	<i>verb</i><br><ol><li>to scribble</li></ol>
여시|yeosi	<i>noun</i><br><ol><li>fox, vixen</li></ol>
여이다|yeoida	<i>adj</i><br><ol><li>thirsty</li></ol>
여재|yeojae	<i>noun</i><br><ol><li>woman; girl; lady; female</li></ol>
여조케|yeojoke	<i>noun</i><br><ol><li>niece</li></ol>
여헹|yeoheng	<i>noun</i><br><ol><li>travel</li><li>journey, trip, voyage</li></ol>
역ᄉᆞ|yeoksaw	<i>noun</i><br><ol><li>history</li></ol>
역세|yeokse	<i>noun</i><br><ol><li>history</li></ol>
연기|yeongi	<i>noun</i><br><ol><li>contact, connection, liaison</li></ol>
열|yeol	<i>num</i><br><ol><li>ten</li></ol>
열쒜	<i>noun</i><br><ol><li>key</li></ol>
열흘|yeolheul	<i>noun</i><br><ol><li>ten days</li></ol>
영등ᄃᆞᆯ|yeongdeungdawl	<i>noun</i><br><ol><li>February</li></ol>
예관|yegwan	<i>noun</i><br><ol><li>inn, motel, hotel</li></ol>
예놈|yenom	<i>noun</i><br><ol><li>(derogatory) a Jap</li></ol>
예다|yeda	<i>verb</i><br><ol><li>to go</li></ol>
예숙제낄락|yesukjekkillak	<i>noun</i><br><ol><li>quiz</li><li>riddle</li></ol>
예순|yesun	<i>num</i><br><ol><li>sixty</li></ol>
예쉰|yeswin	<i>num</i><br><ol><li>sixty</li></ol>
예점|yejeom	<i>noun</i><br><ol><li>average; ordinary; usual; normal; regular; general; common</li><li>being temporary</li></ol>
예펜|yepen	<i>noun</i><br><ol><li>opium</li></ol>
옛날|yennal	<i>noun</i><br><ol><li>ancient times</li><li>long ago; once upon a time</li></ol>
오널|oneol	<i>noun</i><br><ol><li>today; this day</li></ol><br><i>adv</i><br><ol><li>today</li></ol>
오니|oni	<i>noun</i><br><ol><li>(Jeju City) cucumber</li></ol>
오라방|orabang	<i>noun</i><br><ol><li>brother (of a female)</li></ol>
오름|oreum	<i>noun</i><br><ol><li>mountain</li></ol>
오메기술|omegisul	<i>noun</i><br><ol><li>millet wine</li></ol>
오수매|osumae	<i>noun</i><br><ol><li>a five year-old horse</li></ol>
오월|owol	<i>noun</i><br><ol><li>May</li></ol>
오족|ojok	<i>adv</i><br><ol><li>how</li></ol>
온앵|on-aeng	<i>noun</i><br><ol><li>a ginkgo fruit</li></ol>
올흐다|orheuda	<i>adj</i><br><ol><li>to be right, true, correct</li></ol>
올히|orhi	<i>noun</i><br><ol><li>the current year; this year</li><li>duck</li></ol>
옳다|olta	<i>adj</i><br><ol><li>to be right, true, correct</li></ol>
옴막옴막|ommagommak	<i>noun</i><br><ol><li>(of a person or animal) continuously putting food inside one's mouth and eating it</li><li>being concave in several places</li></ol>
옺|ot	<i>noun</i><br><ol><li>(Seogwipo) cucumber</li></ol>
와|wa	<i>intj</i><br><ol><li>An expression of surprise or amazement.</li></ol>
왁왁ᄒᆞ다|wagwakhawda	<i>adj</i><br><ol><li>pitch-dark</li></ol>
왕상개염지|wangsanggaeyeomji	<i>noun</i><br><ol><li>an ant with wings</li></ol>
왕할망|wanghalmang	<i>noun</i><br><ol><li>father of one's great-grandmother</li></ol>
왜ᄀᆞᆫ장|waegawnjang	<i>noun</i><br><ol><li>Japanese soy sauce</li></ol>
왜국|Waeguk	<i>name</i><br><ol><li>(obsolete) Japan</li></ol>
왜얏|waeyat	<i>noun</i><br><ol><li>plum (fruit)</li></ol>
요왕|yowang	<i>name</i><br><ol><li>(mythology) Dragon King (the god of water and weather)</li></ol>
요자기|yojagi	<i>adv</i><br><ol><li>recently</li><li>these days</li></ol>
우|u	<i>noun</i><br><ol><li>above, upper, upside, top</li></ol>
우리|uri	<i>pron</i><br><ol><li>we, us</li><li>our</li><li>(when referring to one's own family members) my</li></ol>
우리나라|urinara	<i>noun</i><br><ol><li>Korea</li></ol>
우투|utu	<i>noun</i><br><ol><li>overcoat</li></ol>
울|ul	<i>noun</i><br><ol><li>above, upper, up</li></ol>
웃드르|utduru	<i>noun</i><br><ol><li>A mountainous area</li><li>A village or field close to Mount Halla</li></ol>
워립|worip	<i>noun</i><br><ol><li>A cow that was born and raised naturally in the mountains.</li></ol>
원셍이|wonseng'i	<i>noun</i><br><ol><li>monkey, ape</li></ol>
웡웡|wongwong	<i>noun</i><br><ol><li>woof, bow-wow; the sound of a dog</li></ol>
웨곳ᄊᆞᆯ|wegotssawl	<i>noun</i><br><ol><li>white rice without mixed grains</li></ol>
웨국|weguk	<i>name</i><br><ol><li>(derogatory) Japan</li><li>foreign country</li></ol>
웨다|weda	<i>adj</i><br><ol><li>to be wrong, incorrect</li></ol>
웨하르방|wehareubang	<i>noun</i><br><ol><li>maternal grandfather</li></ol>
웲기다|wemgida	<i>verb</i><br><ol><li>to move (something), have moved</li><li>to translate (other language into mother tongue)</li><li>to transfuse</li><li>to change a job</li><li>to give a disease to</li></ol>
웽이|weng'i	<i>noun</i><br><ol><li>mouse, rat</li></ol>
위염|wiyeom	<i>noun</i><br><ol><li>danger</li></ol>
유ᄒᆞᆨ|yuhawk	<i>noun</i><br><ol><li>Confucianism</li></ol>
유월|yuwol	<i>noun</i><br><ol><li>June</li></ol>
육수매|yuksumae	<i>noun</i><br><ol><li>a six year-old horse</li></ol>
육지|yukji	<i>noun</i><br><ol><li>(dry) land; shore</li></ol><br><i>name</i><br><ol><li>Korean Peninsula</li></ol>
으남지다|eunamjida	<i>adj</i><br><ol><li>to be misty; foggy</li></ol>
으룬|eurun	<i>noun</i><br><ol><li>grownup, adult, elder, senior</li></ol>
음막ᄒᆞ다|eummakhawda	<i>verb</i><br><ol><li>to swallow quickly</li></ol>
음묵|eummuk	<i>noun</i><br><ol><li>(anatomy) vagina</li></ol>
읏다|eutda	<i>adj</i><br><ol><li>to have none; (to be) lacking; (to be) nonexistent</li></ol>
의염의염|uiyeomuiyeom	<i>adv</i><br><ol><li>every nook and corner, everywhere</li></ol>
이|i	<i>num</i><br><ol><li>two</li></ol><br><i>det</i><br><ol><li>this</li></ol>
이ᄉᆞ|isaw	<i>noun</i><br><ol><li>moving (from one residence to another)</li></ol>
이ᄉᆞᆺ밥|isawtbap	<i>noun</i><br><ol><li>food given by a person who has moved to greet neighbors.</li></ol>
이까|ikka	
이녁|inyeok	<i>pron</i><br><ol><li>oneself; self</li><li>second-person singular pronoun; you</li></ol>
이디|idi	<i>pron</i><br><ol><li>here</li></ol>
이디저디|idijeodi	<i>adv</i><br><ol><li>here and there, everywhere</li></ol>
이땅|ittang	<i>adv</i><br><ol><li>a short time later</li><li>after a while</li><li>sometimes</li></ol>
이로후제|irohuje	<i>noun</i><br><ol><li>the time following a given point in time; thenceforth</li></ol>
이멩이|imeng'i	<i>noun</i><br><ol><li>forehead</li></ol>
이수매|isumae	<i>noun</i><br><ol><li>a two-year-old horse</li></ol>
이시다|isida	<i>verb</i><br><ol><li>to be (in a place); to exist</li><li>to have</li></ol>
이왁|iwak	<i>noun</i><br><ol><li>narrative, story</li><li>tale</li><li>talk</li></ol>
이월|iwol	<i>noun</i><br><ol><li>February</li></ol>
이틀|iteul	<i>noun</i><br><ol><li>two days</li></ol>
인ᄉᆞᆷ|insawm	<i>noun</i><br><ol><li>ginseng (any of several plants, of the genus Panax)</li></ol>
인간|in-gan	<i>noun</i><br><ol><li>man</li><li>humanity</li></ol>
인측|incheuk	<i>noun</i><br><ol><li>early</li><li>soon</li></ol>
인칙이|inchigi	<i>noun</i><br><ol><li>early</li><li>soon</li></ol>
일|il	<i>noun</i><br><ol><li>work, job</li><li>business</li><li>matter, affair, concern</li></ol><br><i>num</i><br><ol><li>one</li></ol>
일곱|ilgop	<i>num</i><br><ol><li>seven</li></ol>
일끔|ilkkeum	<i>adv</i><br><ol><li>all, everything</li></ol>
일롬|illom	<i>noun</i><br><ol><li>name (A word used to refer to or address an animal, object, phenomenon, etc., to distinguish it from others.)</li><li>name; given name</li><li>name; full name</li><li>name; identify</li><li>fame</li><li>nickname</li></ol>
일뤠|illwe	<i>noun</i><br><ol><li>seven days</li></ol>
일르다|illeuda	<i>adj</i><br><ol><li>(to be) early</li></ol>
일본|ilbon	<i>name</i><br><ol><li>Japan</li></ol>
일월|irwol	<i>noun</i><br><ol><li>January</li></ol>
일천|ilcheon	<i>det</i><br><ol><li>all; every; all kinds of</li></ol>
일홈|irhom	<i>noun</i><br><ol><li>name (a word used to refer to or address an animal, object, phenomenon, etc., to distinguish it from others)</li><li>given name</li><li>full name</li><li>identity</li><li>fame</li><li>nickname</li></ol>
일흔|irheun	<i>num</i><br><ol><li>seventy</li></ol>
입중|ipjung	<i>noun</i><br><ol><li>philtrum</li></ol>
자륜거|jaryungeo	<i>noun</i><br><ol><li>bicycle</li></ol>
자리|jari	<i>noun</i><br><ol><li>pair</li></ol>
자의|jaui	<i>pron</i><br><ol><li>that kid; he or she</li></ol>
자이|jai	<i>pron</i><br><ol><li>that kid; he or she</li></ol>
자치|jachi	<i>noun</i><br><ol><li>cockroach</li></ol>
작반|jakban	<i>noun</i><br><ol><li>board, plank</li></ol>
잔치|janchi	<i>noun</i><br><ol><li>feast; party</li></ol>
잣|jat	<i>noun</i><br><ol><li>long stone wall</li></ol>
장게|jangge	<i>noun</i><br><ol><li>marriage</li></ol>
장게들다|janggedeulda	<i>verb</i><br><ol><li>to marry, to get married</li></ol>
장그르헤|janggeureuhe	<i>noun</i><br><ol><li>last year; the year before</li></ol>
저|jeo	<i>pron</i><br><ol><li>(determiner) that</li></ol>
저디|jeodi	<i>pron</i><br><ol><li>over there</li></ol>
저을|jeo'eul	<i>noun</i><br><ol><li>winter</li></ol>
전상|jeonsang	<i>noun</i><br><ol><li>fortune; destiny; said to be governed by the goddess Samgong</li><li>human activity; livelihood; said to be governed by the goddess Samgong</li><li>attitude</li></ol>
절|jeol	<i>noun</i><br><ol><li>wave</li></ol>
절코|jeolko	<i>adv</i><br><ol><li>never</li><li>(not) at all</li></ol>
절혼|jeorhon	<i>noun</i><br><ol><li>marriage</li></ol>
젊다|jeomda	<i>adj</i><br><ol><li>young; youthful</li></ol>
정|jeong	<i>noun</i><br><ol><li>sutra</li></ol>
정싕|jeongsuing	<i>noun</i><br><ol><li>prime minister</li></ol>
정월|jeong'wol	<i>noun</i><br><ol><li>January</li></ol>
정지|jeongji	<i>noun</i><br><ol><li>kitchen</li></ol>
제벱|jebep	<i>adv</i><br><ol><li>pretty, fairly, quite, considerably</li></ol>
제비생이|jebisaeng'i	<i>noun</i><br><ol><li>swallow</li></ol>
제우|je'u	<i>adv</i><br><ol><li>barely</li></ol>
제주|jeju	<i>noun</i><br><ol><li>art, capacity, talent</li></ol><br><i>name</i><br><ol><li>Jeju (island, province and its capital in South Korea)</li></ol>
제주도|Jejudo	<i>name</i><br><ol><li>Jeju province</li><li>Jeju island</li></ol>
제주말|jejumal	<i>noun</i><br><ol><li>the Jeju language</li></ol>
제주사름|jejusareum	<i>noun</i><br><ol><li>Jeju people</li></ol>
제줏말|jejunmal	<i>noun</i><br><ol><li>the Jeju language</li></ol>
제집|jejip	<i>noun</i><br><ol><li>(Seogwipo, offensive or archaic) woman, girl</li><li>(Seogwipo, offensive or archaic) wife</li></ol>
젯|jet	<i>noun</i><br><ol><li>milk (of mammals)</li></ol>
젯가락|jetgarak	<i>noun</i><br><ol><li>chopsticks</li></ol>
젱|jeng	<i>noun</i><br><ol><li>kkwaenggwari (a small brass gong used in Korean folk music)</li></ol>
졍찰|jyeongchal	<i>noun</i><br><ol><li>police</li><li>a police officer</li></ol>
조고만ᄒᆞ다|jogomanhawda	<i>adj</i><br><ol><li>(to be) tiny</li></ol>
조랑내|jorangnae	<i>noun</i><br><ol><li>small downtown</li></ol>
조선|joseon	<i>name</i><br><ol><li>(historical) Joseon</li><li>(rare) Korea</li><li>(rare) North Korea</li></ol>
조선ᄀᆞᆫ장|joseongawnjang	<i>noun</i><br><ol><li>Korean soy sauce</li></ol>
조선시대|joseonsidae	<i>name</i><br><ol><li>(historical) Joseon, an old dynasty on the Korean peninsula (1392 CE – 1897 CE)</li></ol>
조용ᄒᆞ다|joyonghawda	<i>adj</i><br><ol><li>calm, quiet</li></ol>
조쟁이|jojaeng'i	<i>noun</i><br><ol><li>(vulgar) penis, dick, cock</li></ol>
족다|jokda	<i>adj</i><br><ol><li>(to be) small</li><li>little</li><li>few</li></ol>
족은아방|jogeun-abang	<i>noun</i><br><ol><li>paternal uncle (father's married younger brother)</li></ol>
족은어멍|jogeun-eomeong	<i>noun</i><br><ol><li>maternal uncle (mother's married younger brother)</li></ol>
졸바로|jolbaro	<i>adv</i><br><ol><li>straight, upright</li></ol>
종이|jong'i	<i>noun</i><br><ol><li>paper</li></ol>
좋다|johta	<i>adj</i><br><ol><li>to be good</li><li>to be amiable</li></ol><br><i>verb</i><br><ol><li>to recover</li></ol>
좋아ᄒᆞ다|joahawda	<i>verb</i><br><ol><li>to like something or someone; to prefer</li></ol>
주리|juri	<i>noun</i><br><ol><li>change (money given back when a customer hands over more than the exact price of an item)</li></ol>
주연|juyeon	<i>noun</i><br><ol><li>master, owner</li></ol>
주인공|ju-in-gong	<i>noun</i><br><ol><li>protagonist, leading character, hero, heroine</li></ol>
줄ᄃᆞᆼ길락|juldawnggillak	<i>noun</i><br><ol><li>tug of war</li></ol>
줌칫|jumchit	<i>adv</i><br><ol><li>abruptly; suddenly</li></ol>
줏다|jutda	<i>verb</i><br><ol><li>to gather up; to pick up</li></ol>
줴께|jwekke	<i>noun</i><br><ol><li>vest, waistcoat</li></ol>
쥉이|jweng'i	<i>noun</i><br><ol><li>mouse, rat</li></ol>
쥉이헤치|jweng'ihechi	<i>noun</i><br><ol><li>(astrology) The year of the rat</li></ol>
지|ji	<i>pron</i><br><ol><li>you (formal)</li></ol>
지갑|jigap	<i>noun</i><br><ol><li>purse</li></ol>
지둥|jidung	<i>noun</i><br><ol><li>pillar, column, post</li></ol>
지드리다|jideurida	<i>verb</i><br><ol><li>(transitive) to wait for, to await</li></ol>
지름|jireum	<i>noun</i><br><ol><li>(Jeju City) oil</li></ol>
지쁘다|jippeuda	<i>adj</i><br><ol><li>(to be) glad</li></ol>
지슬|jiseul	<i>noun</i><br><ol><li>potato</li></ol>
지주|jiju	<i>name</i><br><ol><li>(Seogwipo) Jeju (an island and province of South Korea)</li></ol>
지집|jijip	<i>noun</i><br><ol><li>(disrespectful or archaic) woman, girl</li><li>(disrespectful or archaic) wife</li></ol>
지집아의|jijibaui	<i>noun</i><br><ol><li>girl</li></ol>
지침|jichim	<i>noun</i><br><ol><li>cough</li></ol>
지프다|jipeuda	<i>adj</i><br><ol><li>To be deep</li></ol>
지피|jipi	<i>adv</i><br><ol><li>deeply; profoundly</li></ol><br><i>noun</i><br><ol><li>depth</li></ol>
질겁다|jilgeopda	<i>adj</i><br><ol><li>(to be) happy</li></ol>
질다|jilda	<i>adj</i><br><ol><li>to be long</li><li>damp</li></ol>
질헤늙다|jirheneukda	<i>verb</i><br><ol><li>To be very old for the age</li></ol>
짐끼|jimkki	<i>noun</i><br><ol><li>kimchi</li></ol>
짐셍|jimseng	<i>noun</i><br><ol><li>beast, animal</li></ol>
짐승|jimseung	<i>noun</i><br><ol><li>beast, animal</li></ol>
집|jip	<i>noun</i><br><ol><li>house</li><li>nest</li></ol>
집가제|jipgaje	<i>noun</i><br><ol><li>eaves</li></ol>
짜르다|jjareuda	<i>adj</i><br><ol><li>(to be) short</li></ol>
찝|jjip	<i>noun</i><br><ol><li>straw</li></ol>
찰락찰락|challakchallak	<i>adv</i><br><ol><li>(onomatopoeia) The sound of clattering.</li></ol>
참웨|chamwe	<i>noun</i><br><ol><li>the Korean melon, (Cucumis melo Makuwa Group) or its fruit.</li></ol>
채|chae	<i>noun</i><br><ol><li>car</li></ol><br><i>counter</i><br><ol><li>houses</li></ol>
처왐|cheowam	<i>noun</i><br><ol><li>the first time</li></ol>
천ᄌᆞ국|Cheonjawguk	<i>name</i><br><ol><li>China</li></ol>
천지만지|cheonjimanji	<i>adv</i><br><ol><li>very, greatly</li></ol>
천징|cheonjing	<i>noun</i><br><ol><li>(medicine) asthma</li></ol>
체소|cheso	<i>noun</i><br><ol><li>vegetables; greens</li></ol>
첵|chek	<i>noun</i><br><ol><li>book</li></ol>
쳇|chet	<i>noun</i><br><ol><li>first; initial</li></ol>
초싱ᄃᆞᆯ|chosingdawl	<i>noun</i><br><ol><li>crescent, new moon</li></ol>
총뽀롱이|chongpporong'i	<i>noun</i><br><ol><li>bullet; shot</li></ol>
축하헴수다|chukhahemsuda	<i>intj</i><br><ol><li>congratulations!</li></ol>
췌|chwe	<i>noun</i><br><ol><li>candle</li></ol>
치다|chida	<i>verb</i><br><ol><li>to steam</li></ol>
칙간|chikgan	<i>noun</i><br><ol><li>toilet</li></ol>
친귀|chin-gwi	<i>noun</i><br><ol><li>friend</li></ol>
칠뤌|chillwol	<i>noun</i><br><ol><li>July</li></ol>
칠수매|chilsumae	<i>noun</i><br><ol><li>a seven year-old horse</li></ol>
칠월|chirwol	<i>noun</i><br><ol><li>July</li></ol>
칭계|chinggye	<i>noun</i><br><ol><li>stairs, staircase, stairway</li></ol>
콘도|kondo	<i>noun</i><br><ol><li>condominium</li></ol>
콥|kop	<i>noun</i><br><ol><li>beef oil</li></ol>
콥대산이|kopdaesani	<i>noun</i><br><ol><li>garlic</li></ol>
콩ᄑᆞᆺ|kongpawt	<i>noun</i><br><ol><li>(anatomy) kidney</li></ol>
쿠세|kuse	<i>noun</i><br><ol><li>habit</li></ol>
쿨|kul	<i>noun</i><br><ol><li>grass</li></ol>
퀘끼리|kwe-kkiri	<i>noun</i><br><ol><li>(zoology) elephant</li></ol>
퀴다|kwida	<i>verb</i><br><ol><li>to jump</li></ol>
큰아방|keunabang	<i>noun</i><br><ol><li>paternal uncle (father's older brother)</li></ol>
큰어멍|keuneomeong	<i>noun</i><br><ol><li>maternal uncle (mother's older brother)</li></ol>
키로|kiro	<i>noun</i><br><ol><li>kilo</li><li>kilometer</li></ol>
타글락타글락|tageullaktageullak	<i>adv</i><br><ol><li>(onomatopoeia) The sound of rattling.</li></ol>
타다|타난|탄|탕|tada	<i>verb</i><br><ol><li>to ride (horse, bicycle, etc.), to get on (bus, car, etc.)</li></ol>
탐라|Tamna	<i>name</i><br><ol><li>Tamna (ancient Korean kingdom who ruled Jeju Island)</li></ol>
탐라국|tamnaguk	<i>name</i><br><ol><li>Tamna (ancient Korean kingdom which ruled Jeju Island)</li></ol>
텔레비전|tellebijeon	<i>noun</i><br><ol><li>television</li></ol>
통시|tongsi	<i>noun</i><br><ol><li>toilet</li></ol>
통쒜|tongsswe	<i>noun</i><br><ol><li>lock, padlock</li></ol>
퉤꼐|twekkye	<i>noun</i><br><ol><li>hare, rabbit, coney, bunny</li></ol>
퉤끼|twekki	<i>noun</i><br><ol><li>hare, rabbit, coney, bunny</li></ol>
튼나다|teunnada	<i>verb</i><br><ol><li>to rise, arise</li><li>to bring back one's memories, to recall, come to remembrance, recur in the mind (memory)</li><li>to show a certain expression on one's face</li></ol>
튼봉ᄉᆞ|teunbongsaw	<i>noun</i><br><ol><li>(derogatory) blind fool</li></ol>
팔수매|palsumae	<i>noun</i><br><ol><li>an eight year-old horse</li></ol>
팔월|parwol	<i>noun</i><br><ol><li>August</li></ol>
퍼렁ᄒᆞ다|peoreonghawda	<i>adj</i><br><ol><li>(to be) dark blue</li></ol>
펀|peon	<i>counter</i><br><ol><li>times</li></ol>
펜안ᄒᆞ다|pen-anhawda	<i>adj</i><br><ol><li>comfortable, relaxed, easy, calm</li></ol>
펜안ᄒᆞ우꽈|pen-anhawukkwa	<i>intj</i><br><ol><li>How are you?</li><li>Hello!</li></ol>
펜지|penji	<i>noun</i><br><ol><li>(postal) letter</li></ol>
펭승|pengseung	<i>noun</i><br><ol><li>one's entire life, lifetime</li></ol>
펭지|pengji	<i>noun</i><br><ol><li>flatland</li></ol>
푼체|punche	<i>name</i><br><ol><li>Buddha</li></ol><br><i>noun</i><br><ol><li>fan</li></ol>
풍력단지|pungnyeokdanji	<i>noun</i><br><ol><li>wind power plant</li></ol>
하늘님|haneullim	<i>noun</i><br><ol><li>God</li></ol>
하니ᄇᆞ름|hanibawreum	<i>noun</i><br><ol><li>north wind</li></ol>
하다|hada	<i>adj</i><br><ol><li>to be many</li></ol>
하르바님|hareubanim	<i>noun</i><br><ol><li>(honorific) grandfather</li></ol>
하르방|hareubang	<i>noun</i><br><ol><li>grandfather; elderly male</li></ol>
하를|hareul	<i>noun</i><br><ol><li>a day, 24 hours</li><li>daytime</li></ol>
하시|hasi	<i>noun</i><br><ol><li>chopsticks</li></ol>
하위염ᄒᆞ다|hawiyeomhawda	<i>verb</i><br><ol><li>to yawn</li></ol>
한ᄌᆞ|hanjaw	<i>noun</i><br><ol><li>Chinese character; Han character</li></ol>
한국|hanguk	<i>name</i><br><ol><li>Korea</li><li>South Korea</li></ol>
한국말|hangungmal	<i>noun</i><br><ol><li>the Korean language</li></ol>
한국사름|hanguksareum	<i>noun</i><br><ol><li>Korean people</li></ol>
한라산|hallasan	<i>name</i><br><ol><li>Mount Halla, Hallasan (a mountain in Jeju, South Korea)</li></ol>
할망|halmang	<i>noun</i><br><ol><li>grandmother</li></ol>
할이|hari	<i>noun</i><br><ol><li>(finance) discount, reduction</li></ol>
함박눈|hambangnun	<i>noun</i><br><ol><li>large snowflakes</li></ol>
항고지|hanggoji	<i>noun</i><br><ol><li>rainbow</li></ol>
해섬|haeseom	<i>noun</i><br><ol><li>sea cucumber</li></ol>
햇빗|haetbit	<i>noun</i><br><ol><li>sunshine</li><li>sunlight</li></ol>
헙개미|heopgaemi	<i>noun</i><br><ol><li>bran</li></ol>
헤|he	<i>noun</i><br><ol><li>sea</li><li>sun</li></ol>
헤양ᄒᆞ다|heyanghawda	<i>adj</i><br><ol><li>(to be) pure white</li></ol>
헤치|hechi	<i>noun</i><br><ol><li>Chinese zodiac sign</li></ol>
호나|hona	<i>num</i><br><ol><li>one</li></ol>
호렝이|horeng'i	<i>noun</i><br><ol><li>tiger</li></ol>
홀아방|horabang	<i>noun</i><br><ol><li>widower (a man whose wife has died and who has not remarried)</li></ol>
홀어멍|horeomeong	<i>noun</i><br><ol><li>widow (a woman whose husband has died and who has not remarried)</li></ol>
홍압|hong'ap	<i>noun</i><br><ol><li>mussel (shellfish)</li></ol>
환재|hwanjae	<i>noun</i><br><ol><li>a medical patient</li></ol>
활동사진|hwaldongsajin	<i>noun</i><br><ol><li>a movie</li></ol>
황고지|hwanggoji	<i>noun</i><br><ol><li>rainbow</li></ol>
홰|hwae	<i>noun</i><br><ol><li>fire, flame</li></ol>
훍다|hukda	<i>adj</i><br><ol><li>(to be) thick</li></ol>
훤씬|hwonssin	<i>adv</i><br><ol><li>much more or less (than normal); a lot; long (before or after); far more</li></ol>
흑|heuk	<i>noun</i><br><ol><li>earth</li><li>soil</li></ol>
흑벡|heukbeng	<i>noun</i><br><ol><li>earthen soil</li></ol>
흘르다|heulleuda	<i>verb</i><br><ol><li>to flow with, or spill</li></ol>
히망|himang	<i>noun</i><br><ol><li>hope, wish</li></ol>
히엄|hieom	<i>noun</i><br><ol><li>(sports) swimming</li></ol>
