ಀ	<i>character</i><br><ol><li>chandrabindu (a nasal vowel diacritic of the Old kannada script)</li></ol>
ಁ	<i>character</i><br><ol><li>chandrabindu (a nasal vowel diacritic of the Old Kannada script)</li></ol>
ಂ	<i>character</i><br><ol><li>anusvara</li></ol>
಄	<i>symbol</i><br><ol><li>Used to write before writing a poem in olden times.</li></ol>
ಅ|a	<i>character</i><br><ol><li>The first vowel of the Kannada alphabet.</li></ol><br><i>noun</i><br><ol><li>Vishnu, a Hindu god in AUM.</li></ol><br><i>prefix</i><br><ol><li>un-</li><li>remote demonstrative base</li></ol><br><i>suffix</i><br><ol><li>of</li></ol><br><i>intj</i><br><ol><li>A vocative particle; o, oh</li><li>An interjection of pity; ah</li></ol><br><i>pron</i><br><ol><li>a pronominal base (Used in olden times while writing a poem)</li></ol>
ಅಂಕ|aṅka	<i>noun</i><br><ol><li>number, numeral</li><li>mark, spot</li><li>valuation (numerically)</li><li>point (score in a game)</li></ol>
ಅಂಕಣ|aṅkaṇa	<i>noun</i><br><ol><li>The place between two pillars in a house.</li></ol>
ಅಂಗ|anga|ಅಂಗವು|ಅಂಗಕ್ಕೆ|ಅಂಗಗಳಿಂದ|ಅಂಗದ|ಅಂಗದಿಂದ|ಅಂಗಗಳಿಗೆ|ಅಂಗಗಳನ್ನು|ಅಂಗಗಳು|ಅಂಗವನ್ನು|ಅಂಗಗಳ	<i>noun</i><br><ol><li>component</li></ol>
ಅಂಗಡಿ|ಅಂಗಡಿಗಳನ್ನು|ಅಂಗಡಿಗಳ|ಅಂಗಡಿಯು|ಅಂಗಡಿಯ|aṅgaḍi|ಅಂಗಡಿಗೆ|ಅಂಗಡಿಗಳಿಗೆ|ಅಂಗಡಿಯನ್ನು|ಅಂಗಡಿಗಳು|ಅಂಗಡಿಯಿಂದ|ಅಂಗಡಿಗಳಿಂದ	<i>noun</i><br><ol><li>store, shop</li></ol>
ಅಂಗಾಲು|aṅgālu	<i>noun</i><br><ol><li>sole of leg</li></ol>
ಅಂಗೈ|aṅgai	<i>noun</i><br><ol><li>palm</li></ol>
ಅಂಟಂಟಾದ|aṇṭaṇṭāda	<i>adj</i><br><ol><li>glutinous, adhesive</li></ol>
ಅಂಟಾದ|aṇṭāda	<i>adj</i><br><ol><li>glutinous, adhesive</li></ol>
ಅಂಟು|ಅಂಟಿದನು|ಅಂಟುಿಯಾನು|ಅಂಟುುತ್ತೇವೆ|ಅಂಟುಿಯಾರು|ಅಂಟೀಯೆ|ಅಂಟುಗಳಿಗೆ|ಅಂಟುುವೆನು|ಅಂಟುುತ್ತೇನೆ|ಅಂಟುಿಯೇವು|ಅಂಟಿಗೆ|ಅಂಟುಗಳನ್ನು|ಅಂಟಿದರೆ|ಅಂಟಿದೆ|ಅಂಟುುವನು|ಅಂಟುಲು|ಅಂಟುುವಳು|ಅಂಟುುವರು|ಅಂಟುಳು|ಅಂಟುುತ್ತಾನೆ|ಅಂಟಿದರು|ಅಂಟುದ|ಅಂಟಿದ|ಅಂಟುಗಳು|ಅಂಟುೆನು|ಅಂಟಿದುವು|ಅಂಟುುವಿರಿ|ಅಂಟಿದಿರಿ|ಅಂಟುೆ|ಅಂಟುರು|ಅಂಟುನು|aṇṭu|ಅಂಟುುತ್ತೀರಿ|ಅಂಟುುವ|ಅಂಟುುವುವು|ಅಂಟುವು|ಅಂಟುುತ್ತವೆ|ಅಂಟ|ಅಂಟಿದಿ|ಅಂಟುುತ್ತಾರೆ|ಅಂಟುುವೆವು|ಅಂಟುೀರಿ|ಅಂಟುಲಿಕ್ಕೆ|ಅಂಟುಗಳಿಂದ|ಅಂಟಿನಿಂದ|ಅಂಟುೀತು|ಅಂಟುುವಾ|ಅಂಟುಗಳ|ಅಂಟುೆವು|ಅಂಟುುತ್ತ|ಅಂಟುುತ್ತಾಳೆ|ಅಂಟನ್ನು|ಅಂಟುುವೆ|ಅಂಟಿನ|ಅಂಟುಿರಿ|ಅಂಟುೋಣ|ಅಂಟುರಿ|ಅಂಟುಿಯಾಳು|ಅಂಟುುವಿ|ಅಂಟುದೆ|ಅಂಟುುತ್ತದೆ|ಅಂಟಯೇನು|ಅಂಟುು|ಅಂಟಿದೆವು|ಅಂಟುುವುದು|ಅಂಟುುತ್ತೀಯೆ|ಅಂಟಿದೆನು|ಅಂಟತು|ಅಂಟುದು|ಅಂಟುಲಿ|ಅಂಟಿದಳು|ಅಂಟುುತ್ತೀ|ಅಂಟುಿಯಾವು	<i>noun</i><br><ol><li>glue, adhesive</li></ol><br><i>verb</i><br><ol><li>To stick, to be sticking</li></ol>
ಅಂಟುವ|aṇṭuva	<i>adj</i><br><ol><li>glutinous, adhesive</li></ol>
ಅಂತಃಕರಣ|ಅಂತಃಕರಣಗಳು|ಅಂತಃಕರಣಕ್ಕೆ|ಅಂತಃಕರಣದ|ಅಂತಃಕರಣಗಳ|ಅಂತಃಕರಣವನ್ನು|ಅಂತಃಕರಣವು|ಅಂತಃಕರಣಗಳಿಂದ|antaḥkaraṇa|ಅಂತಃಕರಣದಿಂದ|ಅಂತಃಕರಣಗಳಿಗೆ|ಅಂತಃಕರಣಗಳನ್ನು	<i>noun</i><br><ol><li>heart, mind</li><li>conscience</li></ol>
ಅಂತಃಕಲಹ|ಅಂತಃಕಲಹದ|ಅಂತಃಕಲಹಗಳ|ಅಂತಃಕಲಹಗಳಿಂದ|ಅಂತಃಕಲಹಗಳಿಗೆ|ಅಂತಃಕಲಹವನ್ನು|ಅಂತಃಕಲಹಕ್ಕೆ|antaḥkalaha|ಅಂತಃಕಲಹದಿಂದ|ಅಂತಃಕಲಹಗಳು|ಅಂತಃಕಲಹವು|ಅಂತಃಕಲಹಗಳನ್ನು	<i>noun</i><br><ol><li>internal struggle</li></ol>
ಅಂದಾಜು|ಅಂದಾಜುಗಳಿಂದ|ಅಂದಾಜಿಗೆ|ಅಂದಾಜನ್ನು|ಅಂದಾಜುಗಳಿಗೆ|ಅಂದಾಜುಗಳ|andāju|ಅಂದಾಜುಗಳು|ಅಂದಾಜುಗಳನ್ನು|ಅಂದಾಜಿನಿಂದ|ಅಂದಾಜಿನ	<i>noun</i><br><ol><li>estimate, approximation</li></ol>
ಅಂವ|aṃva|Havyaka	<i>pron</i><br><ol><li>he</li><li>that one, that person</li></ol>
ಅಂಶ|aṃśa	<i>noun</i><br><ol><li>part, portion</li></ol>
ಅಂಶಿಕ|aṃśika	<i>noun</i><br><ol><li>part, element, component</li></ol><br><i>adj</i><br><ol><li>(with a prefixed noun) pertaining to, belonging to, coming from</li></ol>
ಅಕಚ|akaca	<i>noun</i><br><ol><li>the planet of kēthu</li></ol><br><i>adj</i><br><ol><li>being bold</li></ol>
ಅಕಟ|akaṭa	<i>adj</i><br><ol><li>being surprised</li></ol>
ಅಕರಣಿ|akaraṇi	<i>noun</i><br><ol><li>defeat</li></ol>
ಅಕ್ಕ|akka	<i>noun</i><br><ol><li>elder sister</li></ol>
ಅಕ್ಕಲು|akkalu	<i>noun</i><br><ol><li>understanding, good sense, wisdom, intellect</li></ol>
ಅಕ್ಷರ|akṣara	<i>noun</i><br><ol><li>letter, character (of an alphabet)</li></ol>
ಅಗ್ನಿ|ಅಗ್ನಿಗಳನ್ನು|ಅಗ್ನಿಯನ್ನು|agni|ಅಗ್ನಿಗಳಿಂದ|ಅಗ್ನಿಗಳಿಗೆ|ಅಗ್ನಿಯರು|ಅಗ್ನಿಗಳ|ಅಗ್ನಿಯಿಂದ|ಅಗ್ನಿಯರಿಂದ|ಅಗ್ನಿಯ|ಅಗ್ನಿಯರಿಗೆ|ಅಗ್ನಿಯರ|ಅಗ್ನಿಗೆ|ಅಗ್ನಿಯು|ಅಗ್ನಿಯರನ್ನು|ಅಗ್ನಿಗಳು	<i>name</i><br><ol><li>Agni, a Hindu deity of fire in Advaita Vedanta</li></ol><br><i>noun</i><br><ol><li>fire (oxidization reaction)</li></ol>
ಅಗ್ನಿಪರ್ವತ|ಅಗ್ನಿಪರ್ವತವು|ಅಗ್ನಿಪರ್ವತದಿಂದ|ಅಗ್ನಿಪರ್ವತಗಳಿಗೆ|ಅಗ್ನಿಪರ್ವತಗಳ|ಅಗ್ನಿಪರ್ವತಗಳು|ಅಗ್ನಿಪರ್ವತದ|ಅಗ್ನಿಪರ್ವತಕ್ಕೆ|ಅಗ್ನಿಪರ್ವತವನ್ನು|ಅಗ್ನಿಪರ್ವತಗಳನ್ನು|agniparvata|ಅಗ್ನಿಪರ್ವತಗಳಿಂದ	<i>noun</i><br><ol><li>(geology) volcano</li></ol>
ಅಘನಾಶಿನಿ|aghanāśini	<i>name</i><br><ol><li>A river in Karnataka, India</li><li>A village in Karnataka, India, located on the banks of the aforementioned river</li></ol>
ಅಜ್ಜ|ajja	<i>noun</i><br><ol><li>a grandfather</li></ol>
ಅಟಕಾವು|aṭakāvu	<i>noun</i><br><ol><li>opposition</li><li>hindrance, obstruction, impediment</li></ol>
ಅಟ್ಟಂಗಡಿ|aṭṭaṅgaḍi	<i>noun</i><br><ol><li>bakery</li></ol>
ಅಟ್ಟಟ್ಟಿ|aṭṭaṭṭi	<i>noun</i><br><ol><li>precursor</li></ol>
ಅಟ್ಟಣಿಗೆ|aṭṭaṇige	<i>noun</i><br><ol><li>cradle</li><li>rack</li><li>stand</li></ol>
ಅಟ್ಟಿಗ|aṭṭiga	<i>noun</i><br><ol><li>follower</li><li>satellite</li></ol>
ಅಡವಿ|aḍavi	<i>noun</i><br><ol><li>forest (dense collection of trees)</li></ol>
ಅಡುಸು|aḍusu	<i>noun</i><br><ol><li>(mineralogy) clay</li></ol>
ಅಣೆಕಟ್ಟು|aṇekaṭṭu	<i>noun</i><br><ol><li>anicut dam, a type of small head dam</li></ol>
ಅಣ್ಣ|aṇṇa	<i>noun</i><br><ol><li>elder brother.</li></ol>
ಅಥವಾ|athavā	<i>conj</i><br><ol><li>or</li></ol>
ಅದು|ಅವಳಲ್ಲಿ|ಅವಳಿಗೆ|avanu|ಅವಳು|ಅವನಲ್ಲಿಗೆ|ಅದರಿಂದ|ಅವಳಲ್ಲಿಂದ|avaru|ಅವನಿಗೆ|ಅವರಿಂದ|ಅವನಲ್ಲಿ|ಅದಕ್ಕೆ|ಅವರಲ್ಲಿಗೆ|ಅದನ್ನು|ಅವನಲ್ಲಿಂದ|avaḷu|ಅವರು|ಅವರಿಗೆ|ಅವನಿಂದ|ಅದರ|ಅವರ|ಅದರಲ್ಲಿಗೆ|ಅವಳಲ್ಲಿಗೆ|ಅದು|ಅದರಲ್ಲಿ|ಅವರಲ್ಲಿ|ಅವಳನ್ನು|ಅವನ|ಅವಳ|ಅವಳಿಂದ|ಅವರನ್ನು|ಅವನು|adu|ಅವರಲ್ಲಿಂದ|ಅವನನ್ನು	<i>pron</i><br><ol><li>(neuter) that</li><li>(that thing) it</li><li>(Havyaka) she</li></ol>
ಅನಂತ|ananta	<i>adj</i><br><ol><li>infinite, boundless, unlimited, without end, endless</li></ol>
ಅನಾನಸ್|anānas	<i>noun</i><br><ol><li>pineapple (plant and fruit)</li></ol>
ಅನುಭವ|ಅನುಭವಗಳಿಂದ|ಅನುಭವವನ್ನು|ಅನುಭವದಿಂದ|ಅನುಭವದ|ಅನುಭವಗಳಿಗೆ|anubhava|ಅನುಭವವು|ಅನುಭವಕ್ಕೆ|ಅನುಭವಗಳ|ಅನುಭವಗಳನ್ನು|ಅನುಭವಗಳು	<i>noun</i><br><ol><li>experience</li></ol>
ಅನುಭವಿಸು|anubhavisu	<i>verb</i><br><ol><li>to suffer, to experience agony, pain, hardship</li><li>to enjoy, to experience pleasure, joy</li></ol>
ಅನ್ನ|anna	<i>noun</i><br><ol><li>boiled rice</li><li>food in general</li></ol>
ಅನ್ಯ|anya	<i>adj</i><br><ol><li>other, different</li></ol>
ಅನ್ಯಥಾ|anyathā	<i>adv</i><br><ol><li>(formal, literary) otherwise, or else</li></ol>
ಅಪೂಟ್|apūṭ	<i>adv</i><br><ol><li>(regional) absolutely</li></ol>
ಅಪ್ಪ|appa	<i>noun</i><br><ol><li>father</li></ol>
ಅಪ್ಸರೆ|apsare	<i>noun</i><br><ol><li>(Hinduism) an apsara; a female spirit of the clouds and waters</li></ol>
ಅಬ್ಬರ|abbara	<i>noun</i><br><ol><li>noise, din, roar</li><li>storm, thunder</li></ol>
ಅಬ್ಬಿ|abbi	<i>noun</i><br><ol><li>(geography) waterfall, cascade</li></ol>
ಅಬ್ಬೆ|abbe	<i>noun</i><br><ol><li>(Havyaka) a mother</li></ol>
ಅಭ್ಯಾಸ|abhyāsa|ಅಭ್ಯಾಸಗಳನ್ನು|ಅಭ್ಯಾಸವನ್ನು|ಅಭ್ಯಾಸದ|ಅಭ್ಯಾಸಗಳು|ಅಭ್ಯಾಸಗಳಿಂದ|ಅಭ್ಯಾಸಕ್ಕೆ|ಅಭ್ಯಾಸಗಳ|ಅಭ್ಯಾಸಗಳಿಗೆ|ಅಭ್ಯಾಸವು|ಅಭ್ಯಾಸದಿಂದ	<i>noun</i><br><ol><li>practice</li></ol>
ಅಮ್ಮ|amma	<i>noun</i><br><ol><li>mother</li></ol>
ಅರಣ್ಯ|araṇya	<i>noun</i><br><ol><li>forest (dense collection of trees)</li></ol>
ಅರಮನೆ|aramane	<i>noun</i><br><ol><li>a palace</li></ol>
ಅರಸ|arasa	<i>noun</i><br><ol><li>a king</li></ol>
ಅರಸಿನ|arasina	<i>noun</i><br><ol><li>turmeric</li></ol>
ಅರಸು|arasu	<i>noun</i><br><ol><li>a king</li></ol>
ಅರಿಮೆ|arime	<i>noun</i><br><ol><li>science</li></ol>
ಅರಿಲ್ಸುತ್ತುಗ|arilsuttuga	<i>noun</i><br><ol><li>(astronomy) planet</li></ol>
ಅರ್ಧ|ardha	<i>adj</i><br><ol><li>half</li></ol>
ಅರ್ಶಸ್ಸು|arśassu	<i>noun</i><br><ol><li>piles, haemorrhoids</li></ol>
ಅಲಾಸ್ಕ|alāska	<i>name</i><br><ol><li>Alaska (a state of the United States)</li></ol>
ಅಳು|aḷu	<i>verb</i><br><ol><li>to weep, cry</li></ol>
ಅಳುಪು|aḷupu	<i>noun</i><br><ol><li>addict</li></ol>
ಅವಧಿ|avadhi	<i>noun</i><br><ol><li>duration, period</li></ol>
ಅವನು|ಅವಳಲ್ಲಿ|ಅವಳಿಗೆ|avanu|ಅವಳು|ಅವನಲ್ಲಿಗೆ|ಅದರಿಂದ|ಅವಳಲ್ಲಿಂದ|avaru|ಅವನಿಗೆ|ಅವರಿಂದ|ಅವನಲ್ಲಿ|ಅದಕ್ಕೆ|ಅವರಲ್ಲಿಗೆ|ಅದನ್ನು|ಅವನಲ್ಲಿಂದ|avaḷu|ಅವರು|ಅವನಿಂದ|ಅವರಿಗೆ|ಅದು|ಅದರ|ಅವರ|ಅವಳಲ್ಲಿಗೆ|ಅದರಲ್ಲಿಗೆ|ಅದರಲ್ಲಿ|ಅವರಲ್ಲಿ|ಅವಳನ್ನು|ಅವನ|ಅವಳ|ಅವಳಿಂದ|ಅವರನ್ನು|ಅವನು|adu|ಅವರಲ್ಲಿಂದ|ಅವನನ್ನು	<i>pron</i><br><ol><li>(that person) he</li><li>(masculine) that</li></ol>
ಅವರು|ಅವಳಲ್ಲಿ|ಅವಳಿಗೆ|avanu|ಅವಳು|ಅವನಲ್ಲಿಗೆ|ಅದರಿಂದ|ಅವಳಲ್ಲಿಂದ|avaru|ಅವನಿಗೆ|ಅವರಿಂದ|ಅವನಲ್ಲಿ|ಅದಕ್ಕೆ|ಅವರಲ್ಲಿಗೆ|ಅದನ್ನು|ಅವನಲ್ಲಿಂದ|avaḷu|ಅವರು|ಅವನಿಂದ|ಅವರಿಗೆ|ಅದು|ಅದರ|ಅವರ|ಅವಳಲ್ಲಿಗೆ|ಅದರಲ್ಲಿಗೆ|ಅದರಲ್ಲಿ|ಅವರಲ್ಲಿ|ಅವಳನ್ನು|ಅವನ|ಅವಳ|ಅವಳಿಂದ|ಅವರನ್ನು|ಅವನು|adu|ಅವರಲ್ಲಿಂದ|ಅವನನ್ನು	<i>pron</i><br><ol><li>(masculine and feminine) those</li><li>(those people) they</li></ol>
ಅವಳು|ಅವಳಲ್ಲಿ|ಅವಳಿಗೆ|avanu|ಅವಳು|ಅವನಲ್ಲಿಗೆ|ಅದರಿಂದ|ಅವಳಲ್ಲಿಂದ|avaru|ಅವನಿಗೆ|ಅವರಿಂದ|ಅವನಲ್ಲಿ|ಅದಕ್ಕೆ|ಅವರಲ್ಲಿಗೆ|ಅದನ್ನು|ಅವನಲ್ಲಿಂದ|avaḷu|ಅವರು|ಅವನಿಂದ|ಅವರಿಗೆ|ಅದು|ಅದರ|ಅವರ|ಅವಳಲ್ಲಿಗೆ|ಅದರಲ್ಲಿಗೆ|ಅದರಲ್ಲಿ|ಅವರಲ್ಲಿ|ಅವಳನ್ನು|ಅವನ|ಅವಳ|ಅವಳಿಂದ|ಅವರನ್ನು|ಅವನು|adu|ಅವರಲ್ಲಿಂದ|ಅವನನ್ನು	<i>pron</i><br><ol><li>(feminine) that</li><li>(that person) she</li></ol>
ಅವು|avu	<i>pron</i><br><ol><li>(neuter) those</li><li>(those things) they</li></ol>
ಅವುಗಳು|avugaḷu	<i>pron</i><br><ol><li>(neuter) those</li><li>(those things) they</li></ol>
ಅಶ್ರು|aśru	<i>noun</i><br><ol><li>(formal, literary) tear</li></ol>
ಅಶ್ವ|aśva	<i>noun</i><br><ol><li>(rare, literary, formal) a horse</li></ol>
ಅಷ್ಟಮ|aṣṭama	<i>adj</i><br><ol><li>(literary) eighth</li></ol>
ಅಸಹ್ಯ|asahya	<i>adj</i><br><ol><li>disgusting, causing revulsion</li></ol>
ಅಸಿಟೋನ್|asiṭōn	<i>noun</i><br><ol><li>acetone</li></ol>
ಅಸ್ಥಿ|asthi	<i>noun</i><br><ol><li>(literary or in compounds) bone</li></ol>
ಅಸ್ಸಾಮೀಸ್|assāmīs	<i>name</i><br><ol><li>Assamese (language)</li></ol>
ಅಸ್ಸೋಸಿಯೆಷನ್ ಫುಟ್‌ಬಾಲ್|ಅಸ್ಸೋಸಿಯೆಷನ್ ಫುಟ್ಬಾಲ್|assōsiyeṣan phuṭbāl	<i>noun</i><br><ol><li>association football (in Britain)</li></ol>
ಆ|ā	<i>character</i><br><ol><li>The second vowel of the Kannada alphabet.</li></ol><br><i>det</i><br><ol><li>that, those</li></ol>
ಆಂಗ್ಲ|āṅgla	<i>adj</i><br><ol><li>(uncommon) English; of or pertaining to England</li></ol><br><i>name</i><br><ol><li>the English language</li></ol>
ಆಂಧ್ರ ಪ್ರದೇಶ|Ā̃dhra Pradēśa	<i>name</i><br><ol><li>Andhra Pradesh</li></ol>
ಆಕಾಶ|ākāśa	<i>noun</i><br><ol><li>the sky</li></ol>
ಆಕ್ರೋಶ|ākrōśa	<i>noun</i><br><ol><li>indignation, outrage, resentment</li></ol>
ಆಗಮಿಸು|ಆಗಮಿಸುೋಣ (āgamisuೋṇa)|ಆಗಮಿಸಿದೆನು|ಆಗಮಿಸತು|ಆಗಮಿಸುದೆ|ಆಗಮಿಸುುವೆನು (āgamisuುvenu)|ಆಗಮಿಸುುವಿರಿ (āgamisuುviri)|ಆಗಮಿಸಿದಿ|āgamisu|ಆಗಮಿಸುಿಯಾನು (āgamisuಿyānu)|ಆಗಮಿಸುುತ್ತೇವೆ (āgamisuುttēve)|ಆಗಮಿಸಿದ|ಆಗಮಿಸುುತ್ತೀರಿ (āgamisuುttīri)|ಆಗಮಿಸುುವುವು (āgamisuುvuvu)|ಆಗಮಿಸಿದುವು|ಆಗಮಿಸುುವುದು (āgamisuುvudu)|ಆಗಮಿಸುನು|ಆಗಮಿಸುುತ್ತಾನೆ (āgamisuುttāne)|ಆಗಮಿಸುುತ್ತಾರೆ (āgamisuುttāre)|ಆಗಮಿಸುಿಯಾವು (āgamisuಿyāvu)|ಆಗಮಿಸುುವೆವು (āgamisuುvevu)|ಆಗಮಿಸುವು|ಆಗಮಿಸುೀರಿ (āgamisuೀri)|ಆಗಮಿಸುೆ (āgamisuೆ)|ಆಗಮಿಸುುತ್ತವೆ (āgamisuುttave)|ಆಗಮಿಸುುವಿ (āgamisuುvi)|ಆಗಮಿಸೀಯೆ|ಆಗಮಿಸುಿಯಾಳು (āgamisuಿyāḷu)|ಆಗಮಿಸುಲು|ಆಗಮಿಸಿದಳು|ಆಗಮಿಸಿದಿರಿ|ಆಗಮಿಸುುವ (āgamisuುva)|ಆಗಮಿಸಿದೆ|ಆಗಮಿಸುುವನು (āgamisuುvanu)|ಆಗಮಿಸುಲಿಕ್ಕೆ|ಆಗಮಿಸಿದರು|ಆಗಮಿಸುೆನು (āgamisuೆnu)|ಆಗಮಿಸುದು|ಆಗಮಿಸುಿರಿ (āgamisuಿri)|ಆಗಮಿಸುರು|ಆಗಮಿಸ|ಆಗಮಿಸುಳು|ಆಗಮಿಸುೆವು (āgamisuೆvu)|ಆಗಮಿಸುುತ್ತ (āgamisuುtta)|ಆಗಮಿಸುು (āgamisuು)|ಆಗಮಿಸಯೇನು|ಆಗಮಿಸುಿಯೇವು (āgamisuಿyēvu)|ಆಗಮಿಸಿದರೆ|ಆಗಮಿಸಿದನು|ಆಗಮಿಸುರಿ|ಆಗಮಿಸುಲಿ|ಆಗಮಿಸುದ|ಆಗಮಿಸುುತ್ತೀಯೆ (āgamisuುttīye)|ಆಗಮಿಸುುತ್ತೇನೆ (āgamisuುttēne)|ಆಗಮಿಸುುತ್ತಾಳೆ (āgamisuುttāḷe)|ಆಗಮಿಸುುವೆ (āgamisuುve)|ಆಗಮಿಸುುವರು (āgamisuುvaru)|ಆಗಮಿಸುುತ್ತೀ (āgamisuುttī)|ಆಗಮಿಸಿದೆವು|ಆಗಮಿಸುೀತು (āgamisuೀtu)|ಆಗಮಿಸುುತ್ತದೆ (āgamisuುttade)|ಆಗಮಿಸುಿಯಾರು (āgamisuಿyāru)|ಆಗಮಿಸುುವಾ (āgamisuುvā)|ಆಗಮಿಸುುವಳು (āgamisuುvaḷu)	<i>verb</i><br><ol><li>To arrive</li></ol>
ಆಗಸ|āgasa	<i>noun</i><br><ol><li>sky</li></ol>
ಆಗು|ಆಗುವಿ|ಆಗುವುದು|ಆಗದು|ಆಗುತ್ತೇನೆ|ಆಗುತ್ತದೆ|ಆದುವು|ಆಗುವನು|ಆದನು|ಆಗುತ್ತಾರೆ|ಆಗಿಯಾವು|ಆದರು|ಆಗಳು|ಆಗರು|ಆಗುತ್ತಾಳೆ|ಆಗುತ್ತೇವೆ|ಆಗೆನು|ಆಗವು|ಆಗುವರು|ಆಗೆ|ಆಗೆವು|ಆಗುತ್ತೀ|ಆಗಿಯೇನು|āgu|ಆಗುವೆನು|ಆದೆನು|ಆಗೀತು|ಆಗುತ್ತಾನೆ|ಆಯಿತು|ಆದಿರಿ|ಆಗುತ್ತೀರಿ|ಆಗುತ್ತವೆ|ಆಗುವಳು|ಆಗಿಯೇವು|ಆಗರಿ|ಆದಳು|ಆದೆವು|ಆಗಿಯಾರು|ಆಗುವಿರಿ|ಆಗನು|ಆಗುವೆವು|ಆಗೀರಿ|ಆಗಿಯಾಳು|ಆಗೀಯೆ|ಆಗಿಯಾನು|ಆದೆ|ಆಗುವುವು	<i>verb</i><br><ol><li>To happen</li><li>To be finished</li></ol>
ಆಚರಿಸು|ācarisu	<i>verb</i><br><ol><li>to perform, carry out, observe a ritual</li></ol>
ಆಡು|āḍu	<i>noun</i><br><ol><li>a goat</li></ol>
ಆದರೆ|ādare	<i>conj</i><br><ol><li>but, however</li></ol>
ಆದಿ|ಆದಿಗಳನ್ನು|ಆದಿಗೆ|ಆದಿಗಳಿಗೆ|ādi|ಆದಿಯು|ಆದಿಯಿಂದ|ಆದಿಗಳ|ಆದಿಯ|ಆದಿಗಳು|ಆದಿಗಳಿಂದ|ಆದಿಯನ್ನು	<i>noun</i><br><ol><li>beginning, start</li></ol>
ಆನು|ānu	<i>pron</i><br><ol><li>(Havyaka) I</li></ol>
ಆನೆ|āne	<i>noun</i><br><ol><li>elephant</li></ol>
ಆಮೆ|āme	<i>noun</i><br><ol><li>a turtle, tortoise</li></ol>
ಆಮ್ಲಜನಕ|āmlajanaka	<i>noun</i><br><ol><li>oxygen</li></ol>
ಆಯಿಸು|ಆಯಿಸುರು|ಆಯಿಸಿದಿರಿ|ಆಯಿಸುೆವು (āyisuೆvu)|ಆಯಿಸುುತ್ತೀಯೆ (āyisuುttīye)|ಆಯಿಸುವು|ಆಯಿಸುಿಯಾಳು (āyisuಿyāḷu)|ಆಯಿಸುುತ್ತ (āyisuುtta)|ಆಯಿಸುಲಿಕ್ಕೆ|ಆಯಿಸುುತ್ತಾಳೆ (āyisuುttāḷe)|ಆಯಿಸುೀರಿ (āyisuೀri)|ಆಯಿಸಿದ|ಆಯಿಸುದೆ|ಆಯಿಸುಲು|ಆಯಿಸುುತ್ತೇನೆ (āyisuುttēne)|ಆಯಿಸಿದೆ|ಆಯಿಸುುವನು (āyisuುvanu)|ಆಯಿಸುುವಿ (āyisuುvi)|ಆಯಿಸುೆನು (āyisuೆnu)|ಆಯಿಸುುವೆ (āyisuುve)|ಆಯಿಸುುವಾ (āyisuುvā)|ಆಯಿಸತು|ಆಯಿಸುದು|ಆಯಿಸಿದನು|ಆಯಿಸುುತ್ತೀ (āyisuುttī)|ಆಯಿಸುುವೆನು (āyisuುvenu)|ಆಯಿಸುಿಯಾರು (āyisuಿyāru)|ಆಯಿಸ|ಆಯಿಸುು (āyisuು)|ಆಯಿಸುುತ್ತಾನೆ (āyisuುttāne)|ಆಯಿಸಿದುವು|ಆಯಿಸುುವುವು (āyisuುvuvu)|ಆಯಿಸುೋಣ (āyisuೋṇa)|ಆಯಿಸುದ|ಆಯಿಸುುತ್ತೀರಿ (āyisuುttīri)|ಆಯಿಸುನು|ಆಯಿಸುೆ (āyisuೆ)|ಆಯಿಸೀಯೆ|ಆಯಿಸುಲಿ|ಆಯಿಸುುತ್ತವೆ (āyisuುttave)|ಆಯಿಸುುತ್ತದೆ (āyisuುttade)|ಆಯಿಸಿದರು|ಆಯಿಸುಿಯಾನು (āyisuಿyānu)|ಆಯಿಸಿದಳು|ಆಯಿಸುಿಯೇವು (āyisuಿyēvu)|ಆಯಿಸುುವರು (āyisuುvaru)|ಆಯಿಸುುವುದು (āyisuುvudu)|ಆಯಿಸಿದೆನು|ಆಯಿಸುರಿ|ಆಯಿಸುುವಳು (āyisuುvaḷu)|ಆಯಿಸಿದೆವು|āyisu|ಆಯಿಸುುತ್ತಾರೆ (āyisuುttāre)|ಆಯಿಸಿದಿ|ಆಯಿಸುಳು|ಆಯಿಸುುವಿರಿ (āyisuುviri)|ಆಯಿಸುೀತು (āyisuೀtu)|ಆಯಿಸಯೇನು|ಆಯಿಸುುತ್ತೇವೆ (āyisuುttēve)|ಆಯಿಸುಿಯಾವು (āyisuಿyāvu)|ಆಯಿಸಿದರೆ|ಆಯಿಸುಿರಿ (āyisuಿri)|ಆಯಿಸುುವ (āyisuುva)|ಆಯಿಸುುವೆವು (āyisuುvevu)	<i>verb</i><br><ol><li>To choose, select</li></ol>
ಆಯ್ಕೆ|ಆಯ್ಕೆಯನ್ನು|ಆಯ್ಕೆಗಳನ್ನು|ಆಯ್ಕೆಗಳು|āyke|ಆಯ್ಕೆಗಳಿಂದ|ಆಯ್ಕೆಗಳ|ಆಯ್ಕೆಗಳಿಗೆ|ಆಯ್ಕೆಯಿಂದ|ಆಯ್ಕೆಯು|ಆಯ್ಕೆಗೆ|ಆಯ್ಕೆಯ	<i>noun</i><br><ol><li>choice</li></ol>
ಆರಂಬಗಾರ|ārambagāra	<i>noun</i><br><ol><li>farmer, peasant, ryot</li></ol>
ಆರು|āru	<i>num</i><br><ol><li>six (numeral: ೬ (6))</li></ol>
ಆರೋಗಣೆ|ārōgaṇe	<i>noun</i><br><ol><li>meal, repast</li></ol>
ಆರೋಗ್ಯದ|ārōgyada	<i>noun</i><br><ol><li>health</li></ol>
ಆರ್ಟಿಲಿ|ārṭili	<i>noun</i><br><ol><li>muskrat</li></ol>
ಆರ್ಯ|ārya	<i>adj</i><br><ol><li>Aryan, Indo-Aryan</li><li>noble</li></ol><br><i>noun</i><br><ol><li>an Aryan, an Indo-Aryan</li></ol>
ಆಲೋಚನೆ|ālōcane	<i>noun</i><br><ol><li>thinking, thought</li></ol>
ಆಲೋಚಿಸು|ālōcisu	<i>verb</i><br><ol><li>to think, consider</li></ol>
ಆಳ್ಜುನಿಡ್|āḷjuniḍ	<i>name</i><br><ol><li>Aljunied</li></ol>
ಆವರಿ|āvari	<i>noun</i><br><ol><li>steam</li></ol>
ಆವೆ|āve	<i>noun</i><br><ol><li>(mineralogy) clay</li></ol>
ಆಸ್ಪತ್ರೆ|āspatre	<i>noun</i><br><ol><li>hospital</li></ol>
ಇ|i	<i>character</i><br><ol><li>The third vowel of the Kannada alphabet.</li></ol>
ಇಂಗಾಲ|iṅgāla	<i>noun</i><br><ol><li>carbon</li></ol>
ಇಂಗು|iṅgu	<i>noun</i><br><ol><li>asafoetida</li></ol>
ಇಂಗುಶೇಟಿಯಾ|iṅguśēṭiyā	<i>name</i><br><ol><li>Ingushetia (a republic of Russia)</li></ol>
ಇಂಗ್ಲಿಷ್|iṅgliṣ	<i>name</i><br><ol><li>(colloquial) the English language</li></ol>
ಇಂದ್ರಚಾಪ|indracāpa	<i>noun</i><br><ol><li>(weather) rainbow</li></ol>
ಇಂದ್ರಧನುಸ್ಸು|indradhanussu	<i>noun</i><br><ol><li>(weather) rainbow</li></ol>
ಇಗ್ಗಾಲಿ|iggāli|ಇಗ್ಗಾಲಿಗಳನ್ನು|ಇಗ್ಗಾಲಿಯನ್ನು|ಇಗ್ಗಾಲಿಗಳಿಂದ|ಇಗ್ಗಾಲಿಗೆ|ಇಗ್ಗಾಲಿಗಳಿಗೆ|ಇಗ್ಗಾಲಿಯಿಂದ|ಇಗ್ಗಾಲಿಗಳ|ಇಗ್ಗಾಲಿಯ|ಇಗ್ಗಾಲಿಗಳು|ಇಗ್ಗಾಲಿಯು	<i>noun</i><br><ol><li>bicycle</li></ol>
ಇಚ್ಛಿಸು|icchisu	<i>verb</i><br><ol><li>to wish, want, crave, desire</li></ol>
ಇಚ್ಛೆ|icche	<i>noun</i><br><ol><li>want, wish, desire</li></ol>
ಇಡ್ಲಿ|iḍli	<i>noun</i><br><ol><li>idli</li></ol>
ಇತಿಹಾಸ|itihāsa|ಇತಿಹಾಸವನ್ನು|ಇತಿಹಾಸಕ್ಕೆ|ಇತಿಹಾಸಗಳ|ಇತಿಹಾಸಗಳನ್ನು|ಇತಿಹಾಸಗಳಿಂದ|ಇತಿಹಾಸವು|ಇತಿಹಾಸಗಳು|ಇತಿಹಾಸದ|ಇತಿಹಾಸಗಳಿಗೆ|ಇತಿಹಾಸದಿಂದ	<i>noun</i><br><ol><li>history</li></ol>
ಇದು|idu	<i>pron</i><br><ol><li>(neuter) this</li><li>(this thing) it</li></ol>
ಇಪ್ಪತ್ತು|ippattu	<i>num</i><br><ol><li>twenty (numeral: ೨೦ (20))</li></ol>
ಇರಾದೆ|irāde	<i>noun</i><br><ol><li>intention</li></ol>
ಇರುಳು|iruḷu	<i>noun</i><br><ol><li>(rare) night</li></ol>
ಇಲಿ|ili	<i>noun</i><br><ol><li>mouse, rat</li></ol>
ಇಲ್ಲವೆ|illave	<i>conj</i><br><ol><li>or</li></ol>
ಇಳಿ|{{{3}}}ಾವು ({{{3}}}ಾvu)|iḷi|ಇಳಿುತ್ತವೆ (iḷiುttave)|{{{5}}}ಿತು ({{{5}}}ಿtu)|{{{3}}}ರೆ ({{{3}}}re)|ಇಳಿಯಲಿ|ಇಳಿುತ್ತೀರಿ (iḷiುttīri)|ಇಳಿಯುವೆನು|{ಇಳಿಯಿರಿ ({iḷiyiri)|ಇಳಿುತ್ತಾಳೆ (iḷiುttāḷe)|ಇಳಿಯುವೆವು|ಇಳಿಯದು|ಇಳಿಯುತ್ತ|ಇಳಿಯದೆ|ಇಳಿಯೆ|{{{3}}}ನು ({{{3}}}nu)|{{{3}}}ಿರಿ ({{{3}}}ಿri)|{{{3}}}ೀತು ({{{3}}}ೀtu)|ಇಳಿಯುವುದು|ಇಳಿಯೆನು|ಇಳಿುತ್ತಾರೆ (iḷiುttāre)|ಇಳಿಯುವರು|{{{3}}}ೇನು ({{{3}}}ೇnu)|ಇಳಿಯುವುವು|ಇಳಿ}ಯಲಿಕ್ಕೆ (iḷi}yalikke)|{{{3}}}ರು ({{{3}}}ru)|ಇಳಿುತ್ತೇವೆ (iḷiುttēve)|{{{3}}}ೀರಿ ({{{3}}}ೀri)|ಇಳಿುತ್ತೀ (iḷiುttī)|{{{3}}}ೀಯೆ ({{{3}}}ೀye)|{{{2}}}ಯುವೆ ({{{2}}}yuve)|ಇಳಿಯುವ|ಇಳಿಯಳು|ಇಳಿಯವು|ಇಳಿಯುವಿ|{{{3}}}ಾರು ({{{3}}}ಾru)|ಇಳಿಯುವಿರಿ|ಇಳಿಯರಿ|ಇಳಿಯಲು|{{{3}}}ೇವು ({{{3}}}ೇvu)|{{{3}}}ಳು ({{{3}}}ḷu)|ಇಳಿಯುವಳು|ಇಳಿಯುವೆ|ಇಳಿುತ್ತೀಯೆ (iḷiುttīye)|ಇಳಿಯೆವು|ಇಳಿಯುವಾ|ಇಳಿುತ್ತೇನೆ (iḷiುttēne)|{{{3}}}ೆವು ({{{3}}}ೆvu)|ಇಳಿಯದ|ಇಳಿಯರು|{{{3}}}ಾನು ({{{3}}}ಾnu)|ಇಳಿಯನು|ಇಳಿುತ್ತದೆ (iḷiುttade)|{{{3}}}ಾಳು ({{{3}}}ಾḷu)|ಇಳಿಯೋಣ|{{{3}}}ುವು ({{{3}}}ುvu)|ಇಳಿಯುವನು|ಇಳಿುತ್ತಾನೆ (iḷiುttāne)|{{{3}}}ೆನು ({{{3}}}ೆnu)	<i>verb</i><br><ol><li>to descend, alight, get down</li></ol>
ಇವ|iva	<i>pron</i><br><ol><li>(masculine) this</li><li>(this person) he</li></ol>
ಇವನು|ivanu	<i>pron</i><br><ol><li>(masculine) this</li><li>(that person) he</li></ol>
ಇವರು|ivaru	<i>pron</i><br><ol><li>(masculine and feminine) these</li><li>(these people) they</li></ol>
ಇವಳು|ivaḷu	<i>pron</i><br><ol><li>(feminine) this</li><li>(this person) she</li></ol>
ಇವು|ivu	<i>pron</i><br><ol><li>(neuter) these</li><li>(these things) they</li></ol>
ಇವುಗಳು|ivugaḷu	<i>pron</i><br><ol><li>(neuter) these</li><li>(these things) they</li></ol>
ಇಶಾರೆ|iśāre	<i>noun</i><br><ol><li>gesture, sign, hint</li></ol>
ಈ|ī	<i>character</i><br><ol><li>The fourth vowel of the Kannada alphabet.</li></ol><br><i>det</i><br><ol><li>this, this here</li></ol>
ಈಗ|īga	<i>adv</i><br><ol><li>now, at this moment, at the present moment</li></ol>
ಈಜು|ಈಜೀರಿ|ಈಜುತ್ತದೆ|ಈಜುತ್ತವೆ|ಈಜೆನು|ಈಜುತ್ತ|ಈಜುತ್ತೀ|ಈಜಿದೆನು|ಈಜಿದೆವು|ಈಜುವ|ಈಜಲಿ|ಈಜುವೆ|ಈಜರಿ|ಈಜಳು|ಈಜುತ್ತೇನೆ|ಈಜುವರು|ಈಜಲು|ಈಜಿದಳು|ಈಜುತ್ತೀಯೆ|ಈಜಿರಿ|ಈಜಿದಿ|ಈಜುವನು|ಈಜಿದೆ|ಈಜದು|ಈಜಿದಿರಿ|ಈಜುವುದು|ಈಜುವೆನು|ಈಜಯೇನು|ಈಜುವಾ|ಈಜುತ್ತೀರಿ|ಈಜೀಯೆ|ಈಜದೆ|ಈಜಿದ|ಈಜಿದರೆ|ಈಜ|ಈಜವು|ಈಜಿಯಾವು|ಈಜಿದುವು|ಈಜಿದರು|ಈಜೋಣ|ಈಜುತ್ತಾರೆ|ಈಜರು|ಈಜೆ|ಈಜಿಯಾಳು|ಈಜುವುವು|ಈಜಲಿಕ್ಕೆ|ಈಜುವಳು|ಈಜಿಯಾನು|ಈಜುವೆವು|ಈಜಿಯೇವು|ಈಜುತ್ತಾನೆ|ಈಜೀತು|ಈಜುವಿ|ಈಜಿದನು|ಈಜುವಿರಿ|ಈಜದ|ಈಜುತ್ತೇವೆ|ಈಜುತ್ತಾಳೆ|īju|ಈಜೆವು|ಈಜತು|ಈಜನು|ಈಜಿಯಾರು	<i>verb</i><br><ol><li>To swim</li></ol>
ಈಟಿ|īṭi	<i>noun</i><br><ol><li>lance, spear</li></ol>
ಈಡಾಡು|ಈಡಾಡುೋಣ|ಈಡಾಡುುತ್ತೀ|ಈಡಾಡುುತ್ತಾಳೆ|ಈಡಾಡುುವ|īḍāḍu|ಈಡಾಡುದ|ಈಡಾಡುಿಯಾನು|ಈಡಾಡುುತ್ತೀರಿ|ಈಡಾಡ|ಈಡಾಡಿದೆವು|ಈಡಾಡುುವುದು|ಈಡಾಡುೆವು|ಈಡಾಡುುವರು|ಈಡಾಡುುತ್ತಾರೆ|ಈಡಾಡತು|ಈಡಾಡುಿರಿ|ಈಡಾಡುಲಿ|ಈಡಾಡುನು|ಈಡಾಡುುವೆವು|ಈಡಾಡುದು|ಈಡಾಡುು|ಈಡಾಡುಲು|ಈಡಾಡುುತ್ತೇವೆ|ಈಡಾಡುಿಯೇವು|ಈಡಾಡುುತ್ತ|ಈಡಾಡುರಿ|ಈಡಾಡುೀರಿ|ಈಡಾಡುರು|ಈಡಾಡುೀತು|ಈಡಾಡುುವಾ|ಈಡಾಡಿದಿರಿ|ಈಡಾಡುುವೆ|ಈಡಾಡುುತ್ತದೆ|ಈಡಾಡುಿಯಾರು|ಈಡಾಡುುತ್ತೇನೆ|ಈಡಾಡಿದ|ಈಡಾಡುುವನು|ಈಡಾಡುಿಯಾವು|ಈಡಾಡುುತ್ತವೆ|ಈಡಾಡಿದನು|ಈಡಾಡುುವಳು|ಈಡಾಡುೆನು|ಈಡಾಡಿದೆ|ಈಡಾಡಿದುವು|ಈಡಾಡುುವೆನು|ಈಡಾಡಿದರೆ|ಈಡಾಡಿದಳು|ಈಡಾಡಿದರು|ಈಡಾಡಯೇನು|ಈಡಾಡುವು|ಈಡಾಡುುವಿ|ಈಡಾಡುಿಯಾಳು|ಈಡಾಡುೆ|ಈಡಾಡುಲಿಕ್ಕೆ|ಈಡಾಡುುವುವು|ಈಡಾಡಿದಿ|ಈಡಾಡುುವಿರಿ|ಈಡಾಡುುತ್ತೀಯೆ|ಈಡಾಡೀಯೆ|ಈಡಾಡುದೆ|ಈಡಾಡುುತ್ತಾನೆ|ಈಡಾಡುಳು|ಈಡಾಡಿದೆನು	<i>verb</i><br><ol><li>to scatter</li></ol>
ಈರು|īru	<i>verb</i><br><ol><li>to comb</li><li>to delouse</li><li>to draw</li></ol>
ಈರ್ಷ್ಯೆ|īrṣye	<i>noun</i><br><ol><li>(rare) envy, jealousy</li></ol>
ಉ|u	<i>character</i><br><ol><li>5th letter in Kannada alphabet.</li></ol>
ಉಗುರು|ಉಗುರುಗಳಿಗೆ|ಉಗುರುಗಳಿಂದ|ಉಗುರುಗಳ|ಉಗುರಿನಿಂದ|ಉಗುರಿಗೆ|uguru|ಉಗುರುಗಳನ್ನು|ಉಗುರುಗಳು|ಉಗುರನ್ನು|ಉಗುರಿನ	<i>noun</i><br><ol><li>(anatomy) nail</li></ol>
ಉಗುಳು|uguḷu	<i>noun</i><br><ol><li>spit, saliva</li></ol>
ಉಗ್ರ|ugra	<i>adj</i><br><ol><li>(formal, literary) fierce, fearful, terrible</li></ol>
ಉಡುಪಿ|uḍupi	<i>name</i><br><ol><li>A city in southwestern India.</li><li>A district in southwestern India, of which Udupi is the chief city and administrative headquarters.</li></ol>
ಉಣ್ಣೆ|uṇṇe	<i>noun</i><br><ol><li>wool</li></ol>
ಉತ್ತಮ|uttama	<i>adj</i><br><ol><li>highest</li><li>superior</li><li>best, most excellent</li></ol>
ಉದ್ದ|udda	<i>adj</i><br><ol><li>tall</li></ol>
ಉಪಯೋಗ|ಉಪಯೋಗಗಳನ್ನು|ಉಪಯೋಗಗಳಿಂದ|ಉಪಯೋಗದಿಂದ|ಉಪಯೋಗವನ್ನು|ಉಪಯೋಗವು|ಉಪಯೋಗಗಳಿಗೆ|upayōga|ಉಪಯೋಗಕ್ಕೆ|ಉಪಯೋಗದ|ಉಪಯೋಗಗಳು|ಉಪಯೋಗಗಳ	<i>noun</i><br><ol><li>use, usage</li></ol>
ಉಪಯೋಗಿಸು|ಉಪಯೋಗಿಸುತ್ತೇವೆ|ಉಪಯೋಗಿಸುವುವು|ಉಪಯೋಗಿಸುವಿರಿ|ಉಪಯೋಗಿಸುವಾ|ಉಪಯೋಗಿಸುತ್ತಾಳೆ|ಉಪಯೋಗಿಸರು|ಉಪಯೋಗಿಸಿದರೆ|ಉಪಯೋಗಿಸಿದುವು|ಉಪಯೋಗಿಸುವೆ|ಉಪಯೋಗಿಸಲು|ಉಪಯೋಗಿಸಳು|ಉಪಯೋಗಿಸೀರಿ|ಉಪಯೋಗಿಸೆನು|ಉಪಯೋಗಿಸ|ಉಪಯೋಗಿಸಿದೆನು|ಉಪಯೋಗಿಸಿದನು|ಉಪಯೋಗಿಸುವುದು|ಉಪಯೋಗಿಸಿದಿ|ಉಪಯೋಗಿಸುವೆವು|ಉಪಯೋಗಿಸುತ್ತೇನೆ|ಉಪಯೋಗಿಸುವಳು|ಉಪಯೋಗಿಸಿರಿ|ಉಪಯೋಗಿಸಲಿಕ್ಕೆ|ಉಪಯೋಗಿಸಿದಳು|ಉಪಯೋಗಿಸಿಯಾಳು|ಉಪಯೋಗಿಸುತ್ತಾನೆ|ಉಪಯೋಗಿಸೀತು|ಉಪಯೋಗಿಸಿಯೇವು|ಉಪಯೋಗಿಸೆ|ಉಪಯೋಗಿಸಿದೆವು|ಉಪಯೋಗಿಸಿಯಾರು|ಉಪಯೋಗಿಸನು|ಉಪಯೋಗಿಸೆವು|ಉಪಯೋಗಿಸತು|ಉಪಯೋಗಿಸುತ್ತದೆ|ಉಪಯೋಗಿಸದು|ಉಪಯೋಗಿಸಿದರು|ಉಪಯೋಗಿಸುವಿ|ಉಪಯೋಗಿಸೀಯೆ|ಉಪಯೋಗಿಸಿದ|ಉಪಯೋಗಿಸದ|ಉಪಯೋಗಿಸುತ್ತವೆ|ಉಪಯೋಗಿಸುತ್ತೀ|ಉಪಯೋಗಿಸಿದೆ|ಉಪಯೋಗಿಸಿಯಾನು|ಉಪಯೋಗಿಸವು|ಉಪಯೋಗಿಸದೆ|ಉಪಯೋಗಿಸುತ್ತ|ಉಪಯೋಗಿಸುವ|ಉಪಯೋಗಿಸಲಿ|upayōgisu|ಉಪಯೋಗಿಸಿಯಾವು|ಉಪಯೋಗಿಸುವನು|ಉಪಯೋಗಿಸಯೇನು|ಉಪಯೋಗಿಸುವರು|ಉಪಯೋಗಿಸರಿ|ಉಪಯೋಗಿಸಿದಿರಿ|ಉಪಯೋಗಿಸುತ್ತೀಯೆ|ಉಪಯೋಗಿಸುತ್ತೀರಿ|ಉಪಯೋಗಿಸೋಣ|ಉಪಯೋಗಿಸುತ್ತಾರೆ|ಉಪಯೋಗಿಸುವೆನು	<i>verb</i><br><ol><li>To use, utilize</li></ol>
ಉಪ್ಪು|uppu	<i>noun</i><br><ol><li>salt</li></ol>
ಉಮೇದು|umēdu	<i>noun</i><br><ol><li>hopefulness, confidence, trust, high probability (of passing an examination, etc.)</li><li>enthusiasm, eagerness, zeal</li></ol>
ಉರಿಬೆಟ್ಟ|ಉರಿಬೆಟ್ಟಗಳಿಗೆ|ಉರಿಬೆಟ್ಟದ|ಉರಿಬೆಟ್ಟದಿಂದ|ಉರಿಬೆಟ್ಟಗಳಿಂದ|ಉರಿಬೆಟ್ಟಕ್ಕೆ|ಉರಿಬೆಟ್ಟಗಳನ್ನು|ಉರಿಬೆಟ್ಟಗಳು|ಉರಿಬೆಟ್ಟವು|uribeṭṭa|ಉರಿಬೆಟ್ಟಗಳ|ಉರಿಬೆಟ್ಟವನ್ನು	<i>noun</i><br><ol><li>(geology) volcano</li></ol>
ಉರಿಯುವ|uriyuva	<i>adj</i><br><ol><li>fiery</li></ol>
ಉರ್ದೂ|urdū	<i>name</i><br><ol><li>Urdu (language)</li></ol>
ಉಸಿರಾಟ|ಉಸಿರಾಟಕ್ಕೆ|ಉಸಿರಾಟದ|usirāṭa|ಉಸಿರಾಟಗಳಿಂದ|ಉಸಿರಾಟಗಳಿಗೆ|ಉಸಿರಾಟಗಳನ್ನು|ಉಸಿರಾಟದಿಂದ|ಉಸಿರಾಟವು|ಉಸಿರಾಟವನ್ನು|ಉಸಿರಾಟಗಳು|ಉಸಿರಾಟಗಳ	<i>noun</i><br><ol><li>breathing, respiration</li></ol>
ಉಸಿರು|usiru	<i>noun</i><br><ol><li>breath</li></ol>
ಊ|ū	<i>character</i><br><ol><li>The sixth letter of the Kannada alphabet.</li></ol>
ಊರು|ūru	<i>noun</i><br><ol><li>habitation, such as a city or town</li></ol>
ಋ|ṛ	<i>character</i><br><ol><li>The seventh vowel of the Kannada script.</li></ol>
ಋಗ್ವೇದ|ṛgvēda	<i>name</i><br><ol><li>Rigveda</li></ol>
ಋಣ|ṛṇa	<i>noun</i><br><ol><li>debt</li><li>obligation</li></ol>
ಋತು|ṛtu	<i>noun</i><br><ol><li>season</li></ol>
ಋಷಭ|ṛṣabha	<i>noun</i><br><ol><li>(formal, literary) a bull</li><li>(music) the second of the seven notes</li><li>(astrology) the zodiac sign Taurus</li></ol>
ಋಷಿ|ṛṣi	<i>noun</i><br><ol><li>(Hinduism) a rishi; a seer</li></ol>
ಌ|l̥	<i>character</i><br><ol><li>8th letter of Kannada alphabet.</li></ol>
ಎ|e	<i>character</i><br><ol><li>The ninth letter of the Kannada alphabet.</li></ol>
ಎಂಟು|eṃṭu	<i>num</i><br><ol><li>eight</li></ol>
ಎಡ|eḍa	<i>noun</i><br><ol><li>left</li></ol>
ಎಣಿಸು|eṇisu	<i>verb</i><br><ol><li>to count, reckon</li></ol>
ಎಣ್ಣೆ|eṇṇe|ಎಣ್ಣೆಗಳು|ಎಣ್ಣೆಗೆ|ಎಣ್ಣೆಯು|ಎಣ್ಣೆಯಿಂದ|ಎಣ್ಣೆಯನ್ನು|ಎಣ್ಣೆಗಳಿಗೆ|ಎಣ್ಣೆಯ|ಎಣ್ಣೆಗಳಿಂದ|ಎಣ್ಣೆಗಳ|ಎಣ್ಣೆಗಳನ್ನು	<i>noun</i><br><ol><li>oil</li><li>(euphemistic) alcohol</li></ol>
ಎತ್ತು|ettu	<i>noun</i><br><ol><li>ox, bullock</li></ol>
ಎರಕ|eraka	<i>noun</i><br><ol><li>casting</li></ol>
ಎರಚು|eracu	<i>verb</i><br><ol><li>to scatter</li></ol>
ಎರಡು|eraḍu	<i>num</i><br><ol><li>two (numeral: ೨ (2))</li></ol>
ಎರವಲುಕೊಡು|ಎರವಲುಕೊಡುುವುದು (eravalukoḍuುvudu)|ಎರವಲುಕೊಡುೀತು (eravalukoḍuೀtu)|ಎರವಲುಕೊಡುುವೆವು (eravalukoḍuುvevu)|ಎರವಲುಕೊಟ್ಟಿರಿ|ಎರವಲುಕೊಡಯೇನು|ಎರವಲುಕೊಡುಿಯೇವು (eravalukoḍuಿyēvu)|ಎರವಲುಕೊಡುುತ್ತೀರಿ (eravalukoḍuುttīri)|ಎರವಲುಕೊಡುಲಿಕ್ಕೆ|ಎರವಲುಕೊಡುುವ (eravalukoḍuುva)|ಎರವಲುಕೊಡುಲಿ|ಎರವಲುಕೊಡುುವೆ (eravalukoḍuುve)|eravalukoḍu|ಎರವಲುಕೊಡುುವನು (eravalukoḍuುvanu)|ಎರವಲುಕೊಡುುವಿರಿ (eravalukoḍuುviri)|ಎರವಲುಕೊಡುು (eravalukoḍuು)|ಎರವಲುಕೊಡುಳು|ಎರವಲುಕೊಡುವು|ಎರವಲುಕೊಡೀಯೆ|ಎರವಲುಕೊಟ್ಟುವು|ಎರವಲುಕೊಡುುತ್ತದೆ (eravalukoḍuುttade)|ಎರವಲುಕೊಡತು|ಎರವಲುಕೊಡುಿಯಾವು (eravalukoḍuಿyāvu)|ಎರವಲುಕೊಟ್ಟರೆ|ಎರವಲುಕೊಡುುತ್ತ (eravalukoḍuುtta)|ಎರವಲುಕೊಡುುತ್ತೀಯೆ (eravalukoḍuುttīye)|ಎರವಲುಕೊಡುದ|ಎರವಲುಕೊಡುುತ್ತೇನೆ (eravalukoḍuುttēne)|ಎರವಲುಕೊಟ್ಟೆವು|ಎರವಲುಕೊಡುರಿ|ಎರವಲುಕೊಡುುತ್ತಾರೆ (eravalukoḍuುttāre)|ಎರವಲುಕೊಡುುತ್ತಾಳೆ (eravalukoḍuುttāḷe)|ಎರವಲುಕೊಡುೆವು (eravalukoḍuೆvu)|ಎರವಲುಕೊಟ್ಟಿ|ಎರವಲುಕೊಡುರು|ಎರವಲುಕೊಡುನು|ಎರವಲುಕೊಡುೀರಿ (eravalukoḍuೀri)|ಎರವಲುಕೊಟ್ಟೆನು|ಎರವಲುಕೊಡುದೆ|ಎರವಲುಕೊಡುಿಯಾಳು (eravalukoḍuಿyāḷu)|ಎರವಲುಕೊಡುಿಯಾರು (eravalukoḍuಿyāru)|ಎರವಲುಕೊಟ್ಟನು|ಎರವಲುಕೊಡುುವಳು (eravalukoḍuುvaḷu)|ಎರವಲುಕೊಡುುವರು (eravalukoḍuುvaru)|ಎರವಲುಕೊಡುದು|ಎರವಲುಕೊಡುುವಾ (eravalukoḍuುvā)|ಎರವಲುಕೊಡುುತ್ತಾನೆ (eravalukoḍuುttāne)|ಎರವಲುಕೊಟ್ಟೆ|ಎರವಲುಕೊಡುುತ್ತೇವೆ (eravalukoḍuುttēve)|ಎರವಲುಕೊಟ್ಟಳು|ಎರವಲುಕೊಡುೋಣ (eravalukoḍuೋṇa)|ಎರವಲುಕೊಡುುತ್ತೀ (eravalukoḍuುttī)|ಎರವಲುಕೊಟ್ಟ|ಎರವಲುಕೊಡುಲು|ಎರವಲುಕೊಡ|ಎರವಲುಕೊಡುಿರಿ (eravalukoḍuಿri)|ಎರವಲುಕೊಟ್ಟರು|ಎರವಲುಕೊಡುೆನು (eravalukoḍuೆnu)|ಎರವಲುಕೊಡುೆ (eravalukoḍuೆ)|ಎರವಲುಕೊಡುುತ್ತವೆ (eravalukoḍuುttave)|ಎರವಲುಕೊಡುುವೆನು (eravalukoḍuುvenu)|ಎರವಲುಕೊಡುುವಿ (eravalukoḍuುvi)|ಎರವಲುಕೊಡುುವುವು (eravalukoḍuುvuvu)|ಎರವಲುಕೊಡುಿಯಾನು (eravalukoḍuಿyānu)	<i>verb</i><br><ol><li>To lend</li></ol>
ಎರುಗು|erugu	<i>noun</i><br><ol><li>(Havyaka) ant</li></ol>
ಎರೆಚೀಲ|erecīla	<i>noun</i><br><ol><li>crop</li></ol>
ಎಲೆ|ಎಲೆಗಳ|ಎಲೆಗಳಿಗೆ|ಎಲೆಗೆ|ಎಲೆಯಿಂದ|ಎಲೆಯ|ಎಲೆಗಳನ್ನು|ಎಲೆಯು|ele|ಎಲೆಗಳಿಂದ|ಎಲೆಯನ್ನು|ಎಲೆಗಳು	<i>noun</i><br><ol><li>leaf (part of a plant)</li></ol>
ಎಸು|esu	<i>verb</i><br><ol><li>to throw</li><li>to expel</li></ol>
ಎಸ್ಟೊನಿಯ|esṭoniya	<i>name</i><br><ol><li>Estonia</li></ol>
ಏ|ē	<i>character</i><br><ol><li>The tenth vowel of the Kannada script.</li></ol>
ಏಕ|ēka	<i>adj</i><br><ol><li>(in compounds) singular, sole</li></ol>
ಏಡು|ಏಡನ್ನು|ಏಡುಗಳಿಂದ|ēḍu|ಏಡುಗಳ|ಏಡುಗಳನ್ನು|ಏಡಿಗೆ|ಏಡಿನಿಂದ|ಏಡುಗಳಿಗೆ|ಏಡಿನ|ಏಡುಗಳು	<i>noun</i><br><ol><li>a period of time</li></ol>
ಏರೋಪ್ಲೇನ್|ērōplēn	<i>noun</i><br><ol><li>airplane, aircraft</li></ol>
ಏಳು|ēḷu	<i>num</i><br><ol><li>seven</li></ol>
ಏಸು ಕ್ರಿಸ್ತ|ēsu krista	<i>name</i><br><ol><li>Jesus Christ</li></ol>
ಐ|ai	<i>character</i><br><ol><li>The eleventh vowel of the Kannada script.</li></ol>
ಐದು|aidu	<i>num</i><br><ol><li>five (numeral: ೫ (5))</li></ol>
ಒ|o	<i>character</i><br><ol><li>The twelfth vowel of the Kannada script.</li></ol>
ಒಂಟೆ|oṇṭe	<i>noun</i><br><ol><li>camel</li></ol>
ಒಂದು|oṃdu	<i>num</i><br><ol><li>one (numeral: ೧ (1))</li></ol>
ಒಂಬತ್ತು|oṃbattu	<i>num</i><br><ol><li>nine</li></ol>
ಒಕ್ಕರಿಸು|okkarisu	<i>verb</i><br><ol><li>to dry heave, gag, retch</li></ol>
ಒಕ್ಕಲಿಗ|okkaliga	<i>noun</i><br><ol><li>farmer, husbandman, peasant, ryot</li></ol>
ಒಕ್ಕೂಟ|okkūṭa	<i>noun</i><br><ol><li>union</li></ol>
ಒಡೆ|oḍe	<i>verb</i><br><ol><li>to break</li></ol>
ಒದವಿ|odavi|ಒದವಿಯಿಂದ|ಒದವಿಯು|ಒದವಿಗಳಿಂದ|ಒದವಿಯನ್ನು|ಒದವಿಯ|ಒದವಿಗೆ|ಒದವಿಗಳಿಗೆ|ಒದವಿಗಳ|ಒದವಿಗಳನ್ನು|ಒದವಿಗಳು	<i>noun</i><br><ol><li>help</li></ol>
ಒನಕೆ|onake	<i>noun</i><br><ol><li>pestle</li></ol>
ಒರಕು|oraku	<i>noun</i><br><ol><li>(Havyaka) sleep, slumber</li></ol>
ಒರಗು|oragu	<i>verb</i><br><ol><li>to lean, recline [+ ಮೇಲೆ (object) = against]</li></ol>
ಒರಟು|oraṭu	<i>noun</i><br><ol><li>implying rudeness</li></ol>
ಒಲವು|olavu	<i>noun</i><br><ol><li>love</li><li>disposition</li></ol>
ಓ|ō	<i>character</i><br><ol><li>The thirteenth vowel of the Kannada script.</li></ol>
ಓಜಸ್ಸು|ōjassu	<i>noun</i><br><ol><li>energy, vigour, strength, power</li></ol>
ಓಡು|ಓಡುಿರಿ|ಓಡಿದೆವು|ಓಡುುವೆನು|ಓಡಿದೆನು|ಓಡುಲಿ|ಓಡೀಯೆ|ಓಡಿದಳು|ಓಡುುವ|ōḍu|ಓಡುೆನು|ಓಡುುವಳು|ಓಡುುತ್ತಾಳೆ|ಓಡುಲಿಕ್ಕೆ|ಓಡಿದರು|ಓಡುುತ್ತವೆ|ಓಡಿದೆ|ಓಡುುತ್ತಾನೆ|ಓಡುಿಯಾನು|ಓಡುನು|ಓಡುುವರು|ಓಡುುತ್ತ|ಓಡುುತ್ತಾರೆ|ಓಡಿದ|ಓಡಿದರೆ|ಓಡುುವಿ|ಓಡುಿಯೇವು|ಓಡುುವೆವು|ಓಡುುತ್ತೀರಿ|ಓಡುುತ್ತೀಯೆ|ಓಡ|ಓಡುುತ್ತೀ|ಓಡುುವಿರಿ|ಓಡುಳು|ಓಡುವು|ಓಡುು|ಓಡಯೇನು|ಓಡುುವುವು|ಓಡುರಿ|ಓಡುುವನು|ಓಡುಿಯಾರು|ಓಡುುತ್ತೇನೆ|ಓಡುಿಯಾವು|ಓಡುುತ್ತದೆ|ಓಡುೀತು|ಓಡುುವುದು|ಓಡುೆ|ಓಡತು|ಓಡುದೆ|ಓಡುೆವು|ಓಡುದ|ಓಡುಲು|ಓಡುೀರಿ|ಓಡುರು|ಓಡುುತ್ತೇವೆ|ಓಡಿದಿ|ಓಡುೋಣ|ಓಡುುವೆ|ಓಡಿದಿರಿ|ಓಡುದು|ಓಡುಿಯಾಳು|ಓಡಿದುವು|ಓಡುುವಾ|ಓಡಿದನು	<i>verb</i><br><ol><li>To run</li></ol>
ಓದು|ಓದುುವ (ōduುva)|ಓದುಲಿಕ್ಕೆ|ಓದುುತ್ತದೆ (ōduುttade)|ಓದಿದರೆ|ಓದುೆನು (ōduೆnu)|ಓದುಳು|ಓದುಿಯಾನು (ōduಿyānu)|ಓದುುತ್ತಾನೆ (ōduುttāne)|ಓದಿದುವು|ಓದುುವುವು (ōduುvuvu)|ಓದುುತ್ತೀ (ōduುttī)|ಓದುನು|ಓದುದ|ಓದುುವಳು (ōduುvaḷu)|ಓದುವು|ಓದುಿಯೇವು (ōduಿyēvu)|ಓದುೋಣ (ōduೋṇa)|ಓದುುವೆ (ōduುve)|ಓದುಲಿ|ōdu|ಓದ|ಓದುಲು|ಓದುುವಿ (ōduುvi)|ಓದಿದನು|ಓದುುವನು (ōduುvanu)|ಓದುದೆ|ಓದುುವುದು (ōduುvudu)|ಓದುುತ್ತ (ōduುtta)|ಓದುುತ್ತಾಳೆ (ōduುttāḷe)|ಓದುುವೆನು (ōduುvenu)|ಓದುುತ್ತೀರಿ (ōduುttīri)|ಓದುೆ (ōduೆ)|ಓದುಿಯಾಳು (ōduಿyāḷu)|ಓದಿದ|ಓದುುವಿರಿ (ōduುviri)|ಓದುೀರಿ (ōduೀri)|ಓದುುವರು (ōduುvaru)|ಓದುರಿ|ಓದಿದೆವು|ಓದಿದಳು|ಓದಿದಿ|ಓದುದು|ಓದುೀತು (ōduೀtu)|ಓದೀಯೆ|ಓದಯೇನು|ಓದುುತ್ತೀಯೆ (ōduುttīye)|ಓದುರು|ಓದುುತ್ತೇವೆ (ōduುttēve)|ಓದುುತ್ತೇನೆ (ōduುttēne)|ಓದತು|ಓದುುವೆವು (ōduುvevu)|ಓದುುತ್ತಾರೆ (ōduುttāre)|ಓದುುತ್ತವೆ (ōduುttave)|ಓದಿದೆ|ಓದುು (ōduು)|ಓದಿದೆನು|ಓದುುವಾ (ōduುvā)|ಓದಿದಿರಿ|ಓದುಿಯಾವು (ōduಿyāvu)|ಓದಿದರು|ಓದುಿಯಾರು (ōduಿyāru)|ಓದುಿರಿ (ōduಿri)|ಓದುೆವು (ōduೆvu)	<i>verb</i><br><ol><li>To read, study</li></ol>
ಓದುಗೆ|ಓದುಗೆಯ|ಓದುಗೆಗಳಿಂದ|ಓದುಗೆಗಳಿಗೆ|ōduge|ಓದುಗೆಗಳನ್ನು|ಓದುಗೆಯಿಂದ|ಓದುಗೆಗಳು|ಓದುಗೆಯು|ಓದುಗೆಗಳ|ಓದುಗೆಯನ್ನು|ಓದುಗೆಗೆ	<i>noun</i><br><ol><li>A book</li></ol>
ಔ|au	<i>character</i><br><ol><li>The fourteenth vowel of the Kannada script.</li></ol>
ಕ|ka	<i>character</i><br><ol><li>The Kannada letter ka, called karagappa.</li></ol>
ಕಂಕ|kaṅka	<i>noun</i><br><ol><li>Vulture</li></ol>
ಕಂಕುಳ|kaṅkuḷa	<i>noun</i><br><ol><li>armpit</li></ol>
ಕಂಚುಳಿಕೆ|kaṅcuḷike	<i>noun</i><br><ol><li>syringe</li></ol>
ಕಂಜ|kanja	<i>noun</i><br><ol><li>lotus</li></ol>
ಕಂಠ|kaṇṭha	<i>noun</i><br><ol><li>(anatomy) throat</li></ol>
ಕಂಡ|kaṇḍa	<i>noun</i><br><ol><li>flesh, meat</li></ol>
ಕಂದರ|kandara	<i>noun</i><br><ol><li>(geography) gulf</li></ol>
ಕಂಪ|kampa|ಕಂಪಕ್ಕೆ|ಕಂಪಗಳ|ಕಂಪದ|ಕಂಪದಿಂದ|ಕಂಪಗಳು|ಕಂಪಗಳಿಗೆ|ಕಂಪಗಳಿಂದ|ಕಂಪಗಳನ್ನು|ಕಂಪವು|ಕಂಪವನ್ನು	<i>noun</i><br><ol><li>(mineralogy) clay</li></ol>
ಕಂಬಳಿಹುಳ|kambaḷihuḷa	<i>noun</i><br><ol><li>caterpillar</li></ol>
ಕಂಮಠ|kaṁmaṭha	<i>noun</i><br><ol><li>sledgehammer</li></ol>
ಕಂಮರು|kaṁmaru	<i>noun</i><br><ol><li>hip</li></ol>
ಕಕ್ಕು|kakku	<i>noun</i><br><ol><li>vomiting,vomit</li></ol>
ಕಕ್ಕುಲತೆ|kakkulate	<i>noun</i><br><ol><li>love</li><li>compassion</li><li>desire</li></ol>
ಕಕ್ಕೆ|kakke	<i>noun</i><br><ol><li>Cassia fistula L.</li></ol>
ಕಗ್ಗತ್ತಲೆ|kaggattale	<i>noun</i><br><ol><li>midnight</li></ol>
ಕಗ್ಗಾರು|kaggāru	<i>noun</i><br><ol><li>famine</li></ol>
ಕಗ್ಗೊಲೆ|kaggole	<i>noun</i><br><ol><li>butchery</li><li>carnage</li><li>massacre</li><li>slaughter</li></ol>
ಕಚಪ|kacapa	<i>noun</i><br><ol><li>leaf</li><li>grass</li></ol>
ಕಚಾಕ|kacāka	<i>noun</i><br><ol><li>smoke</li></ol>
ಕಚೇರಿ|kacēri	<i>noun</i><br><ol><li>office (in general; essentially a place of business)</li></ol>
ಕಟಕರವ|kaṭakarava	<i>noun</i><br><ol><li>butcher</li></ol>
ಕಟಿಕ|kaṭika	<i>noun</i><br><ol><li>butcher</li></ol>
ಕಟು|kaṭu	<i>adj</i><br><ol><li>(formal, literary) bitter</li></ol>
ಕಟ್ಟರಸು|kaṭṭarasu	<i>noun</i><br><ol><li>checkmate</li></ol>
ಕಡಜ|kaḍaja	<i>noun</i><br><ol><li>wasp</li></ol>
ಕಡಲಕಳೆ|kaḍalakaḷē	<i>noun</i><br><ol><li>seaweed</li></ol>
ಕಡಲಜೊಂಡು|kaḍalajoṇḍu	<i>noun</i><br><ol><li>seaweed</li></ol>
ಕಡಲು|kaḍalu	<i>noun</i><br><ol><li>(rare) sea</li></ol>
ಕಡುನುರುವು|kaḍunuruvu	<i>noun</i><br><ol><li>wasp</li></ol>
ಕಡೆಗೆ|kaḍege	<i>postp</i><br><ol><li>to, towards</li></ol>
ಕಣ|kaṇa	<i>noun</i><br><ol><li>(formal) a small particle, fragment</li><li>(sciences) molecule, particle</li></ol>
ಕಣಜ|kaṇaja	<i>noun</i><br><ol><li>granary, barn, garner, cellar</li></ol>
ಕಣ್ಗೆವೆ|kaṇgeve	<i>noun</i><br><ol><li>eyelid</li></ol>
ಕಣ್ಣೀರು|kaṇṇīru	<i>noun</i><br><ol><li>tear</li></ol>
ಕಣ್ಣು|ಕಣ್ಣುಗಳು|ಕಣ್ಣುಗಳಿಂದ|kaṇṇu|ಕಣ್ಣುಗಳ|ಕಣ್ಣುಗಳಿಗೆ|ಕಣ್ಣಿನಿಂದ|ಕಣ್ಣುಗಳನ್ನು|ಕಣ್ಣಿಗೆ|ಕಣ್ಣನ್ನು|ಕಣ್ಣಿನ	<i>noun</i><br><ol><li>eye</li></ol>
ಕತ್ತು|kattu	<i>noun</i><br><ol><li>neck, throat</li></ol><br><i>verb</i><br><ol><li>shout, yell</li><li>kindle</li></ol>
ಕತ್ತೆ|katte	<i>noun</i><br><ol><li>a donkey, an ass</li><li>(vulgar, pejorative) a stupid, obstinate person; general term of abuse</li></ol>
ಕದ|kada	<i>noun</i><br><ol><li>door</li><li>cloud</li></ol>
ಕದಂಬ|ಕದಮ್ಬ|kadamba	<i>noun</i><br><ol><li>kadam, common bur-flower tree (Neolamarckia cadamba, syn. Anthocephalus cadamba, Nauclea cadamba)</li></ol>
ಕನಸು|ಕನಸುಗಳ|ಕನಸಿಗೆ|ಕನಸನ್ನು|ಕನಸುಗಳು|ಕನಸಿನ|ಕನಸುಗಳನ್ನು|ಕನಸುಗಳಿಂದ|ಕನಸಿನಿಂದ|kanasu|ಕನಸುಗಳಿಗೆ	<i>noun</i><br><ol><li>dream</li></ol>
ಕನಿಷ್ಠ|kaniṣṭha	<i>adj</i><br><ol><li>smallest, youngest</li></ol>
ಕನ್ನಡ|ಕನ್ನಡಕ್ಕೆ|ಕನ್ನಡವನ್ನು|ಕನ್ನಡಗಳಿಗೆ|ಕನ್ನಡಗಳು|kannaḍa|ಕನ್ನಡವು|ಕನ್ನಡದ|ಕನ್ನಡಗಳಿಂದ|ಕನ್ನಡಗಳನ್ನು|ಕನ್ನಡಗಳ|ಕನ್ನಡದಿಂದ	<i>name</i><br><ol><li>the Kannada language</li></ol>
ಕನ್ನಡಿಗರು|kannaḍigaru	<i>name</i><br><ol><li>Kannadigas, native Kannada speakers</li></ol>
ಕನ್ಯೆ|kanye	<i>noun</i><br><ol><li>young girl, maiden</li></ol>
ಕಪಟ|kapaṭa	<i>noun</i><br><ol><li>ruse</li><li>deceit, fraud</li></ol>
ಕಪೋತ|kapōta	<i>noun</i><br><ol><li>a pigeon, a dove</li></ol>
ಕಫ|kapha	<i>noun</i><br><ol><li>sputum</li></ol>
ಕಬ್ಬಿಣ|kabbiṇa	<i>noun</i><br><ol><li>iron</li></ol>
ಕಬ್ಬು|kabbu	<i>noun</i><br><ol><li>sugar cane</li></ol>
ಕರಡಿ|karaḍi	<i>noun</i><br><ol><li>bear</li><li>An oblong drum beaten on both sides.</li></ol>
ಕರಾಳ|karāḷa	<i>adj</i><br><ol><li>black</li></ol>
ಕರು|karu	<i>noun</i><br><ol><li>calf (a young cow or bull)</li></ol>
ಕರುಳು|karuḷu	<i>noun</i><br><ol><li>intestine</li></ol>
ಕರೆ|ಕರೆದಿರಿ|ಕರೆಯದ|ಕರೆಯುವನು|ಕರೆಯಲಿ|ಕರೆಗಳಿಗೆ|ಕರೆದರು|ಕರೆಯವು|ಕರೆುತ್ತೀಯೆ|ಕರೆದಾವು|ಕರೆಯುವಾ|ಕರೆುತ್ತವೆ|ಕರೆದನು|ಕರೆಗಳು|ಕರೆಗೆ|ಕರೆಯೋಣ|ಕರೆಯುವುವು|ಕರೆದಾನು|ಕರೆುತ್ತೇನೆ|ಕರೆದೇವು|ಕರೆದೀತು|ಕರೆಯುವೆವು|ಕರೆದೇನು|ಕರೆಯಲು|ಕರೆಯರು|kare|ಕರೆ}ಯಲಿಕ್ಕೆ (kare}yalikke)|ಕರೆಯದು|ಕರೆಯೆವು|ಕರೆಯು|ಕರೆಯುವರು|ಕರೆದುವು|ಕರೆಯುವಿ|ಕರೆಗಳ|ಕರೆುತ್ತೀರಿ|ಕರೆಯಳು|ಕರೆಯಿತುಿತು|ಕರೆಗಳಿಂದ|ಕರೆಗಳನ್ನು|ಕರೆದಳು|ಕರೆದೆವು|ಕರೆಯುವ|ಕರೆಯನ್ನು|ಕರೆಯಯುವೆ|ಕರೆಯುವುದು|ಕರೆಯಿಂದ|ಕರೆಯೆನು|ಕರೆದೆನು|ಕರೆಯರಿ|ಕರೆದರೆ|ಕರೆಯುವಿರಿ|ಕರೆಯುವೆ|ಕರೆುತ್ತಾರೆ|ಕರೆುತ್ತೀ|ಕರೆಯನು|ಕರೆುತ್ತಾನೆ|ಕರೆಯೆ|ಕರೆಯದೆ|ಕರೆಯ|ಕರೆಯುತ್ತ|ಕರೆದಾಳು|ಕರೆದೆ|ಕರೆಯುವಳು|ಕರೆದ|ಕರೆದಿ|ಕರೆುತ್ತದೆ|ಕರೆದಾರು|{ಕರೆಯಿರಿ ({kareyiri)|ಕರೆುತ್ತಾಳೆ|ಕರೆದೀರಿ|ಕರೆಯುವೆನು|ಕರೆದೀಯೆ|ಕರೆುತ್ತೇವೆ	<i>verb</i><br><ol><li>To call, summon, beckon</li><li>To invite</li><li>to milk</li></ol><br><i>noun</i><br><ol><li>The border, fringe</li><li>The edge</li><li>The hem</li></ol>
ಕರ್ತವ್ಯ|kartavya	<i>noun</i><br><ol><li>duty, obligation</li></ol>
ಕರ್ನಾಟಕ|karnāṭaka	<i>name</i><br><ol><li>Karnataka</li></ol>
ಕಲ್ಪನೆ|kalpane	<i>noun</i><br><ol><li>conception, imagination</li></ol>
ಕಲ್ಪಿಸು|kalpisu	<i>verb</i><br><ol><li>to imagine, come up with, to conjure up</li></ol>
ಕಲ್ಲಂಗಡಿ|kallaṅgaḍi	<i>noun</i><br><ol><li>watermelon</li></ol>
ಕಲ್ಲರಗು|kallaragu	<i>noun</i><br><ol><li>asphalt</li></ol>
ಕಲ್ಲಿನ|kallina	<i>adj</i><br><ol><li>rocky</li></ol>
ಕಲ್ಲು|ಕಲ್ಲಿನಿಂದ|ಕಲ್ಲಿನ|ಕಲ್ಲುಗಳನ್ನು|ಕಲ್ಲುಗಳಿಂದ|kallina|ಕಲ್ಲುಗಳು|ಕಲ್ಲನ್ನು|ಕಲ್ಲುಗಳ|ಕಲ್ಲುಗಳಿಗೆ|kallu|ಕಲ್ಲಿಗೆ	<i>noun</i><br><ol><li>rock, stone, pebble</li></ol>
ಕವಾಯತು|ಕವಾಯತಿನ|ಕವಾಯತುಗಳಿಗೆ|ಕವಾಯತಿನಿಂದ|ಕವಾಯತಿಗೆ|ಕವಾಯತುಗಳಿಂದ|ಕವಾಯತನ್ನು|ಕವಾಯತುಗಳನ್ನು|ಕವಾಯತುಗಳು|ಕವಾಯತುಗಳ|kavāyatu	<i>noun</i><br><ol><li>drill (military exercise)</li></ol>
ಕವಿ|kavi	<i>noun</i><br><ol><li>a poet</li></ol>
ಕಷ್ಟ|kaṣṭa	<i>noun</i><br><ol><li>problem, trouble</li></ol>
ಕಸ|kasa	<i>noun</i><br><ol><li>garbage, trash, rubbish</li></ol>
ಕಸುಬು|kasubu	<i>noun</i><br><ol><li>occupation, profession, trade</li></ol>
ಕಾಗದ|ಕಾಗದಕ್ಕೆ|ಕಾಗದದಿಂದ|ಕಾಗದಗಳನ್ನು|ಕಾಗದಗಳು|ಕಾಗದಗಳಿಂದ|ಕಾಗದಗಳಿಗೆ|ಕಾಗದಗಳ|kāgada|ಕಾಗದವು|ಕಾಗದವನ್ನು|ಕಾಗದದ	<i>noun</i><br><ol><li>paper, sheet of paper, card, lettercard</li><li>letter, note (written or printed message addressed to a person)</li><li>document, deed, contract, agreement</li></ol>
ಕಾಗೆ|kāge	<i>noun</i><br><ol><li>a crow</li></ol>
ಕಾಡು|ಕಾಡಿದಿರಿ|ಕಾಡೆವು|ಕಾಡುವಿರಿ|ಕಾಡಯೇನು|ಕಾಡಿನ|ಕಾಡಿಗೆ|ಕಾಡುವನು|kāḍu|ಕಾಡುವಿ|ಕಾಡಿದುವು|ಕಾಡಿದರೆ|ಕಾಡುವೆ|ಕಾಡುತ್ತೀಯೆ|ಕಾಡುತ್ತೀರಿ|ಕಾಡಿನಿಂದ|ಕಾಡೀತು|ಕಾಡೀರಿ|ಕಾಡವು|ಕಾಡಿದೆ|ಕಾಡಿದರು|ಕಾಡೆ|ಕಾಡುತ್ತದೆ|ಕಾಡಿದೆವು|ಕಾಡುತ್ತಾರೆ|ಕಾಡುವೆನು|ಕಾಡದೆ|ಕಾಡಿಯಾಳು|ಕಾಡಿದೆನು|ಕಾಡುತ್ತೇನೆ|ಕಾಡಿಯಾರು|ಕಾಡ|ಕಾಡುತ್ತಾಳೆ|ಕಾಡತು|ಕಾಡಳು|ಕಾಡುಗಳು|ಕಾಡಲಿ|ಕಾಡುವೆವು|ಕಾಡುವುದು|ಕಾಡಿದಳು|ಕಾಡೆನು|ಕಾಡುಗಳಿಂದ|ಕಾಡರಿ|ಕಾಡುವಾ|ಕಾಡಿಯೇವು|ಕಾಡುಗಳನ್ನು|ಕಾಡರು|ಕಾಡನ್ನು|ಕಾಡುಗಳ|ಕಾಡದ|ಕಾಡುತ್ತೇವೆ|ಕಾಡುತ್ತೀ|ಕಾಡಿರಿ|ಕಾಡುವಳು|ಕಾಡುವರು|ಕಾಡುವುವು|ಕಾಡುಗಳಿಗೆ|ಕಾಡಿಯಾನು|ಕಾಡಿಯಾವು|ಕಾಡಲಿಕ್ಕೆ|ಕಾಡುತ್ತವೆ|ಕಾಡಿದನು|ಕಾಡೋಣ|ಕಾಡುತ್ತಾನೆ|ಕಾಡಿದಿ|ಕಾಡೀಯೆ|ಕಾಡುವ|ಕಾಡಿದ|ಕಾಡಲು|ಕಾಡುತ್ತ|ಕಾಡನು|ಕಾಡದು	<i>noun</i><br><ol><li>forest (dense collection of trees)</li></ol><br><i>adj</i><br><ol><li>wild, feral</li><li>uncivilised</li><li>annoying</li></ol><br><i>verb</i><br><ol><li>to pester, annoy</li></ol>
ಕಾದಂಬರಿ|kādambari	<i>noun</i><br><ol><li>a type of liquor</li><li>the Kadambari, a Sanskrit romance written by Bāṇabhaṭṭa</li><li>(by extension, neologism) novel; a work of prose fiction</li></ol>
ಕಾನನ|ಕಾನನವು|ಕಾನನಗಳನ್ನು|kānana|ಕಾನನದ|ಕಾನನಗಳ|ಕಾನನಗಳಿಂದ|ಕಾನನಕ್ಕೆ|ಕಾನನದಿಂದ|ಕಾನನವನ್ನು|ಕಾನನಗಳಿಗೆ|ಕಾನನಗಳು	<i>noun</i><br><ol><li>forest (dense collection of trees)</li></ol>
ಕಾನು|kānu	<i>noun</i><br><ol><li>forest (dense collection of trees)</li></ol>
ಕಾಪಾಡು|ಕಾಪಾಡಿಯಾರು|ಕಾಪಾಡುತ್ತೀರಿ|ಕಾಪಾಡುವಾ|ಕಾಪಾಡಿದೆ|ಕಾಪಾಡುವೆವು|ಕಾಪಾಡುವೆ|ಕಾಪಾಡಿದಳು|ಕಾಪಾಡುತ್ತೇವೆ|ಕಾಪಾಡದ|ಕಾಪಾಡಿದರೆ|ಕಾಪಾಡುತ್ತಾರೆ|ಕಾಪಾಡುವಳು|ಕಾಪಾಡಿಯೇವು|ಕಾಪಾಡಿದೆವು|ಕಾಪಾಡೀಯೆ|ಕಾಪಾಡವು|ಕಾಪಾಡತು|ಕಾಪಾಡಿದಿರಿ|ಕಾಪಾಡಿದರು|ಕಾಪಾಡಲಿಕ್ಕೆ|ಕಾಪಾಡ|ಕಾಪಾಡುವರು|ಕಾಪಾಡುವ|ಕಾಪಾಡನು|ಕಾಪಾಡಿಯಾನು|ಕಾಪಾಡುತ್ತವೆ|ಕಾಪಾಡರು|ಕಾಪಾಡಲಿ|ಕಾಪಾಡುವುದು|ಕಾಪಾಡುವೆನು|ಕಾಪಾಡದು|ಕಾಪಾಡಿದುವು|ಕಾಪಾಡೆವು|ಕಾಪಾಡುವನು|ಕಾಪಾಡಳು|ಕಾಪಾಡೀತು|ಕಾಪಾಡಿಯಾವು|ಕಾಪಾಡಿಯಾಳು|kāpāḍu|ಕಾಪಾಡುತ್ತೀ|ಕಾಪಾಡುತ್ತಾಳೆ|ಕಾಪಾಡದೆ|ಕಾಪಾಡುವಿ|ಕಾಪಾಡಲು|ಕಾಪಾಡಿದೆನು|ಕಾಪಾಡುವಿರಿ|ಕಾಪಾಡಿದ|ಕಾಪಾಡುತ್ತೀಯೆ|ಕಾಪಾಡುತ್ತಾನೆ|ಕಾಪಾಡೀರಿ|ಕಾಪಾಡುವುವು|ಕಾಪಾಡುತ್ತ|ಕಾಪಾಡೋಣ|ಕಾಪಾಡಿದಿ|ಕಾಪಾಡಯೇನು|ಕಾಪಾಡಿದನು|ಕಾಪಾಡೆ|ಕಾಪಾಡುತ್ತೇನೆ|ಕಾಪಾಡುತ್ತದೆ|ಕಾಪಾಡಿರಿ|ಕಾಪಾಡೆನು|ಕಾಪಾಡರಿ	<i>verb</i><br><ol><li>To protect, preserve, maintain</li></ol>
ಕಾಪು|ಕಾಪುಗಳಿಗೆ|ಕಾಪುಗಳಿಂದ|ಕಾಪುಗಳ|ಕಾಪುಗಳು|ಕಾಪುಗಳನ್ನು|ಕಾಪನ್ನು|ಕಾಪಿಗೆ|kāpu|ಕಾಪಿನ|ಕಾಪಿನಿಂದ	<i>noun</i><br><ol><li>protection</li></ol>
ಕಾಫಿ|kāphi	<i>noun</i><br><ol><li>coffee</li></ol>
ಕಾಮನಬಿಲ್ಲು|kāmanabillu	<i>noun</i><br><ol><li>(weather) rainbow</li></ol>
ಕಾಯಿಲೆ|kāyile	<i>noun</i><br><ol><li>disease, malady, illness</li></ol>
ಕಾಯ್ದೆ|ಕಾಯ್ದೆಯ|ಕಾಯ್ದೆಗೆ|ಕಾಯ್ದೆಗಳಿಂದ|ಕಾಯ್ದೆಗಳಿಗೆ|kāyde|ಕಾಯ್ದೆಗಳು|ಕಾಯ್ದೆಗಳ|ಕಾಯ್ದೆಯನ್ನು|ಕಾಯ್ದೆಗಳನ್ನು|ಕಾಯ್ದೆಯು|ಕಾಯ್ದೆಯಿಂದ	<i>noun</i><br><ol><li>law, rule, regulation</li></ol>
ಕಾರು|kāru	<i>noun</i><br><ol><li>car, automobile</li></ol>
ಕಾರ್ಯ|kārya	<i>noun</i><br><ol><li>action, activity, operation, function</li></ol>
ಕಾಲು|ಕಾಲಿಗೆ|kālu|ಕಾಲಿನಿಂದ|ಕಾಲುಗಳಿಂದ|ಕಾಲುಗಳ|ಕಾಲುಗಳಿಗೆ|ಕಾಲಿನ|ಕಾಲುಗಳನ್ನು|ಕಾಲನ್ನು|ಕಾಲುಗಳು	<i>noun</i><br><ol><li>leg</li><li>foot</li></ol>
ಕಾಳಗ|kāḷaga	<i>noun</i><br><ol><li>battle</li></ol>
ಕಾವಿ|kāvi	<i>noun</i><br><ol><li>red ochre</li><li>saffron</li></ol>
ಕಾವಿಬಣ್ಣ|kāvibaṇṇa	<i>noun</i><br><ol><li>ochre</li></ol>
ಕಿ|ki	<i>character</i><br><ol><li>The Kannada letter ki.</li></ol>
ಕಿಚ್ಚು|kiccu	<i>noun</i><br><ol><li>fire</li></ol>
ಕಿತ್ತಳೆ|kittaḷe	<i>noun</i><br><ol><li>Seville orange, bitter orange, Citrus aurantium</li><li>The color orange</li></ol>
ಕಿರುಬ|kiruba	<i>noun</i><br><ol><li>hyena</li><li>leopard</li></ol>
ಕಿವಿ|kivi	<i>noun</i><br><ol><li>ear</li></ol>
ಕೀಲಿಕೈ|kīlikai	<i>noun</i><br><ol><li>key</li></ol>
ಕುಂಕುಮ|kuṅkuma	<i>noun</i><br><ol><li>saffron</li></ol>
ಕುಂಬಳಕಾಯಿ|kumbaḷakāyi	<i>noun</i><br><ol><li>pumpkin</li></ol>
ಕುಂಬಾರ|ಕುಂಬಾರನಿಂದ|ಕುಂಬಾರರು|kumbāra|ಕುಂಬಾರನನ್ನು|ಕುಂಬಾರಗಿತ್ತಿ|ಕುಂಬಾರರಿಂದ|ಕುಂಬಾರರನ್ನು|ಕುಂಬಾರನಿಗೆ|ಕುಂಬಾರನು|ಕುಂಬಾರನ|ಕುಂಬಾರರ|ಕುಂಬಾರರಿಗೆ	<i>noun</i><br><ol><li>potter</li></ol>
ಕುಗ್ಗಟೆ|kuggaṭe	<i>noun</i><br><ol><li>soapnut</li></ol>
ಕುಠಾರ|kuṭhāra	<i>noun</i><br><ol><li>axe</li></ol>
ಕುಡಿ|ಕುಡಿದ|ಕುಡಿದರೆ|ಕುಡಿಯುವುವು|{{{5}}}ಿತು ({{{5}}}ಿtu)|ಕುಡಿುತ್ತದೆ (kuḍiುttade)|ಕುಡಿಯುವಳು|ಕುಡಿಯಲು|ಕುಡಿದರು|ಕುಡಿದನು|ಕುಡಿಯದೆ|ಕುಡಿದೆನು|ಕುಡಿುತ್ತಾಳೆ (kuḍiುttāḷe)|ಕುಡಿಯುವೆವು|ಕುಡಿಯದು|ಕುಡಿಯನು|ಕುಡಿಯುವನು|ಕುಡಿದಿ|ಕುಡಿಯುವಿರಿ|ಕುಡಿದಾಳು|ಕುಡಿಯೆ|ಕುಡಿಯುವರು|ಕುಡಿದಾವು|ಕುಡಿ}ಯಲಿಕ್ಕೆ (kuḍi}yalikke)|ಕುಡಿದೇನು|ಕುಡಿದೇವು|ಕುಡಿಯುವ|ಕುಡಿದೆವು|{ಕುಡಿಯಿರಿ ({kuḍiyiri)|ಕುಡಿಯೆವು|ಕುಡಿಯರು|ಕುಡಿದೀರಿ|ಕುಡಿಯ|ಕುಡಿುತ್ತಾನೆ (kuḍiುttāne)|ಕುಡಿುತ್ತೀಯೆ (kuḍiುttīye)|ಕುಡಿದಿರಿ|ಕುಡಿಯುವಾ|ಕುಡಿುತ್ತೇನೆ (kuḍiುttēne)|ಕುಡಿಯುವುದು|ಕುಡಿದಾರು|ಕುಡಿದೆ|ಕುಡಿಯಯುವೆ|ಕುಡಿದುವು|ಕುಡಿುತ್ತೀ (kuḍiುttī)|ಕುಡಿುತ್ತವೆ (kuḍiುttave)|ಕುಡಿಯುವೆನು|ಕುಡಿಯವು|kuḍi|ಕುಡಿದಾನು|ಕುಡಿಯುವೆ|ಕುಡಿಯುತ್ತ|ಕುಡಿಯಳು|ಕುಡಿುತ್ತೇವೆ (kuḍiುttēve)|ಕುಡಿಯದ|ಕುಡಿುತ್ತೀರಿ (kuḍiುttīri)|ಕುಡಿಯೋಣ|ಕುಡಿದಳು|ಕುಡಿದೀತು|ಕುಡಿಯರಿ|ಕುಡಿುತ್ತಾರೆ (kuḍiುttāre)|ಕುಡಿದೀಯೆ|ಕುಡಿಯೆನು|ಕುಡಿಯುವಿ|ಕುಡಿಯಲಿ	<i>verb</i><br><ol><li>To drink</li></ol>
ಕುಡಿಕೆ|kuḍike	<i>noun</i><br><ol><li>inkstand</li></ol>
ಕುಡುಪ|kuḍupa	<i>noun</i><br><ol><li>drumstick</li></ol>
ಕುಣಿ|kuṇi	<i>noun</i><br><ol><li>hole</li><li>pit</li></ol><br><i>verb</i><br><ol><li>dance</li></ol>
ಕುದುರೆ|ಕುದುರೆಗಳಿಗೆ|ಕುದುರೆಗಳು|ಕುದುರೆಯನ್ನು|ಕುದುರೆಯು|ಕುದುರೆಗಳನ್ನು|ಕುದುರೆಯಿಂದ|ಕುದುರೆಗೆ|ಕುದುರೆಗಳಿಂದ|ಕುದುರೆಗಳ|kudure|ಕುದುರೆಯ	<i>noun</i><br><ol><li>horse</li><li>(chess) knight</li></ol>
ಕುಪ್ಪಿ|kuppi	<i>noun</i><br><ol><li>bottle</li></ol>
ಕುರರ|kurara	<i>noun</i><br><ol><li>osprey</li></ol>
ಕುರಿ|kuri	<i>noun</i><br><ol><li>sheep</li></ol>
ಕುರ್ಚಿ|ಕುರ್ಚಿಗಳಿಗೆ|ಕುರ್ಚಿಯ|ಕುರ್ಚಿಗಳು|ಕುರ್ಚಿಯು|ಕುರ್ಚಿಯನ್ನು|ಕುರ್ಚಿಗಳನ್ನು|kurci|ಕುರ್ಚಿಗಳ|ಕುರ್ಚಿಯಿಂದ|ಕುರ್ಚಿಗೆ|ಕುರ್ಚಿಗಳಿಂದ	<i>noun</i><br><ol><li>chair</li></ol>
ಕುಳ್ಳ|kuḷḷa	<i>adj</i><br><ol><li>short, dwarfish</li></ol>
ಕುಸುವು|kusuvu	<i>noun</i><br><ol><li>hemp</li></ol>
ಕೂಟಾಕ|kūṭāka	<i>noun</i><br><ol><li>hammer</li></ol>
ಕೂದಲು|kūdalu	<i>noun</i><br><ol><li>hair</li></ol>
ಕೂಸು|kūsu	<i>noun</i><br><ol><li>(Havyaka) girl, maiden</li></ol>
ಕೃಶ|kṛśa	<i>adj</i><br><ol><li>weak, emaciated, frail, gaunt</li></ol>
ಕೃಷ್ಣ|kṛṣṇa	<i>name</i><br><ol><li>Krishna (Hindu deity)</li></ol>
ಕೆ|ke	<i>character</i><br><ol><li>The Kannada letter ke.</li></ol>
ಕೆಂಪು|kempu	<i>adj</i><br><ol><li>red</li></ol><br><i>noun</i><br><ol><li>the red color</li></ol>
ಕೆತ್ತನೆಕೆಲಸ|kettanekelasa	<i>noun</i><br><ol><li>sculpture</li></ol>
ಕೆತ್ತನೆಗ|kettanega	<i>noun</i><br><ol><li>sculptor</li></ol>
ಕೆತ್ತುಗ|kettuga	<i>noun</i><br><ol><li>engraver, sculptor</li></ol>
ಕೆನ್ನೆ|kenne	<i>noun</i><br><ol><li>cheek</li></ol>
ಕೆಮ್ಮು|ಕೆಮ್ಮಿದರು|ಕೆಮ್ಮಿನ|ಕೆಮ್ಮುುತ್ತ|ಕೆಮ್ಮುಿಯಾನು|ಕೆಮ್ಮುುವುವು|ಕೆಮ್ಮುಿಯಾವು|ಕೆಮ್ಮಿದೆ|ಕೆಮ್ಮುದು|ಕೆಮ್ಮುುವೆ|ಕೆಮ್ಮುುತ್ತದೆ|ಕೆಮ್ಮಿದಿ|ಕೆಮ್ಮುುವಾ|ಕೆಮ್ಮುುತ್ತೇವೆ|ಕೆಮ್ಮಿದೆನು|ಕೆಮ್ಮುರಿ|ಕೆಮ್ಮಿನಿಂದ|ಕೆಮ್ಮುುತ್ತೇನೆ|ಕೆಮ್ಮುುತ್ತೀಯೆ|kemmu|ಕೆಮ್ಮುಗಳಿಂದ|ಕೆಮ್ಮುಗಳು|ಕೆಮ್ಮಿದನು|ಕೆಮ್ಮಿಗೆ|ಕೆಮ್ಮುಲು|ಕೆಮ್ಮಿದೆವು|ಕೆಮ್ಮಿದಿರಿ|ಕೆಮ್ಮುುವನು|ಕೆಮ್ಮುೆ|ಕೆಮ್ಮುಿಯಾಳು|ಕೆಮ್ಮುಳು|ಕೆಮ್ಮುುತ್ತಾನೆ|ಕೆಮ್ಮುುತ್ತೀರಿ|ಕೆಮ್ಮುೀತು|ಕೆಮ್ಮುಲಿಕ್ಕೆ|ಕೆಮ್ಮನ್ನು|ಕೆಮ್ಮುಗಳನ್ನು|ಕೆಮ್ಮುೀರಿ|ಕೆಮ್ಮುನು|ಕೆಮ್ಮುುತ್ತವೆ|ಕೆಮ್ಮುುವರು|ಕೆಮ್ಮುುವೆವು|ಕೆಮ್ಮುರು|ಕೆಮ್ಮುುವ|ಕೆಮ್ಮ|ಕೆಮ್ಮುೆವು|ಕೆಮ್ಮುಿಯೇವು|ಕೆಮ್ಮುಗಳಿಗೆ|ಕೆಮ್ಮಿದರೆ|ಕೆಮ್ಮುುವಿ|ಕೆಮ್ಮುುವಿರಿ|ಕೆಮ್ಮುವು|ಕೆಮ್ಮತು|ಕೆಮ್ಮುು|ಕೆಮ್ಮುುತ್ತಾರೆ|ಕೆಮ್ಮುಗಳ|ಕೆಮ್ಮುದ|ಕೆಮ್ಮೀಯೆ|ಕೆಮ್ಮುುವಳು|ಕೆಮ್ಮಿದ|ಕೆಮ್ಮಿದಳು|ಕೆಮ್ಮುೆನು|ಕೆಮ್ಮುುವೆನು|ಕೆಮ್ಮುಿಯಾರು|ಕೆಮ್ಮುಿರಿ|ಕೆಮ್ಮುುತ್ತೀ|ಕೆಮ್ಮುುವುದು|ಕೆಮ್ಮಯೇನು|ಕೆಮ್ಮಿದುವು|ಕೆಮ್ಮುುತ್ತಾಳೆ|ಕೆಮ್ಮುೋಣ|ಕೆಮ್ಮುದೆ|ಕೆಮ್ಮುಲಿ	<i>noun</i><br><ol><li>An act of coughing</li><li>A condition that causes one to cough, a tendency to cough</li></ol><br><i>verb</i><br><ol><li>To cough</li></ol>
ಕೆರೆ|kere	<i>noun</i><br><ol><li>lake (body of water)</li></ol><br><i>verb</i><br><ol><li>to scratch, scrape</li></ol>
ಕೆಲಸ|ಕೆಲಸವು|ಕೆಲಸದ|ಕೆಲಸವನ್ನು|ಕೆಲಸಗಳನ್ನು|ಕೆಲಸಗಳಿಗೆ|kelasa|ಕೆಲಸದಿಂದ|ಕೆಲಸಗಳಿಂದ|ಕೆಲಸಕ್ಕೆ|ಕೆಲಸಗಳ|ಕೆಲಸಗಳು	<i>noun</i><br><ol><li>work</li><li>job, activity associated with one's occupation</li></ol>
ಕೆಲಸಗಾರ|kelasagāra	<i>noun</i><br><ol><li>artisan, craftsman</li><li>employee, hand, laborer, worker</li></ol>
ಕೆಲಸಗಾರರು|kelasagāraru	<i>noun</i><br><ol><li>labor, personnel, proletariat</li></ol>
ಕೇರಳ|kēraḷa	<i>name</i><br><ol><li>Kerala</li></ol>
ಕೇಳು|ಕೇಳುುವೆನು|ಕೇಳುುತ್ತೀರಿ|ಕೇಳುದ|ಕೇಳಿದೆವು|ಕೇಳುವು|ಕೇಳುುವೆ|ಕೇಳುರು|ಕೇಳಿದನು|ಕೇಳುುತ್ತ|ಕೇಳುುತ್ತೀಯೆ|ಕೇಳುುತ್ತವೆ|ಕೇಳುುವುದು|ಕೇಳುುತ್ತಾನೆ|ಕೇಳುೀತು|ಕೇಳುುವುವು|ಕೇಳುಲಿಕ್ಕೆ|ಕೇಳುದು|ಕೇಳುಿಯಾವು|ಕೇಳುು|ಕೇಳುುವಳು|ಕೇಳುುತ್ತಾಳೆ|ಕೇಳುಿಯಾನು|ಕೇಳುುವೆವು|ಕೇಳುಿಯಾರು|ಕೇಳುುವರು|ಕೇಳುುತ್ತೀ|ಕೇಳ|ಕೇಳಿದರೆ|ಕೇಳುಳು|ಕೇಳಯೇನು|ಕೇಳುರಿ|ಕೇಳುೆವು|ಕೇಳಿದುವು|ಕೇಳುಲು|ಕೇಳುುತ್ತೇನೆ|kēḷu|ಕೇಳುುವಿರಿ|ಕೇಳುದೆ|ಕೇಳಿದಳು|ಕೇಳಿದೆ|ಕೇಳುುತ್ತದೆ|ಕೇಳುಿಯಾಳು|ಕೇಳುುವ|ಕೇಳಿದೆನು|ಕೇಳೀಯೆ|ಕೇಳುುವನು|ಕೇಳಿದಿ|ಕೇಳುೋಣ|ಕೇಳುುವಾ|ಕೇಳುಿಯೇವು|ಕೇಳುಿರಿ|ಕೇಳುೆ|ಕೇಳತು|ಕೇಳುೀರಿ|ಕೇಳಿದರು|ಕೇಳಿದ|ಕೇಳಿದಿರಿ|ಕೇಳುುತ್ತಾರೆ|ಕೇಳುಲಿ|ಕೇಳುುವಿ|ಕೇಳುನು|ಕೇಳುುತ್ತೇವೆ|ಕೇಳುೆನು	<i>verb</i><br><ol><li>To ask</li><li>To hear</li></ol>
ಕೇವಲ|kēvala	<i>adv</i><br><ol><li>only, just</li></ol>
ಕೇಶ|kēśa	<i>noun</i><br><ol><li>(formal, literary) hair, locks of hair</li></ol>
ಕೈ|ಕೈಯಿಂದ|ಕೈಗಳಿಂದ|ಕೈಗಳನ್ನು|ಕೈಯ|ಕೈಗೆ|ಕೈಗಳು|ಕೈಗಳಿಗೆ|ಕೈಯನ್ನು|ಕೈಯು|ಕೈಗಳ|kai	<i>noun</i><br><ol><li>hand</li></ol>
ಕೊ|ko	<i>character</i><br><ol><li>The Kannada letter ko.</li></ol>
ಕೊಂಕಣಿ|koṅkaṇi	<i>name</i><br><ol><li>Konkani (language)</li></ol>
ಕೊಂಬು|kombu	<i>noun</i><br><ol><li>bugle, horn</li></ol>
ಕೊಟ್ಟಿಗೆ|koṭṭige	<i>noun</i><br><ol><li>cowshed</li></ol>
ಕೊಡಹು|koḍahu	<i>verb</i><br><ol><li>to scatter</li></ol>
ಕೊಡು|ಕೊಡಲಿಕ್ಕೆ|ಕೊಡಿರಿ|ಕೊಡುತ್ತೀಯೆ|ಕೊಡುತ್ತೇವೆ|ಕೊಡುವೆನು|ಕೊಡೆನು|ಕೊಡತು|ಕೊಡಳು|ಕೊಡದು|ಕೊಡಿಯಾನು|ಕೊಡಿಯೇವು|ಕೊಡುವುವು|ಕೊಡೀರಿ|ಕೊಡುತ್ತದೆ|koḍu|ಕೊಟ್ಟಿರಿ|ಕೊಟ್ಟ|ಕೊಡೋಣ|ಕೊಡುತ್ತವೆ|ಕೊಡೀಯೆ|ಕೊಡುತ್ತಾನೆ|ಕೊಡರು|ಕೊಡಯೇನು|ಕೊಡಿಯಾರು|ಕೊಡಿಯಾಳು|ಕೊಡುವನು|ಕೊಡುವಿರಿ|ಕೊಟ್ಟರೆ|ಕೊಡುವೆ|ಕೊಡೆ|ಕೊಟ್ಟುವು|ಕೊಡೆವು|ಕೊಟ್ಟೆ|ಕೊಡೀತು|ಕೊಡದ|ಕೊಟ್ಟನು|ಕೊಡದೆ|ಕೊಡುವ|ಕೊಡುವಾ|ಕೊಟ್ಟಿ|ಕೊಡುವಿ|ಕೊಟ್ಟರು|ಕೊಡ|ಕೊಟ್ಟೆನು|ಕೊಡುತ್ತಾರೆ|ಕೊಡಲಿ|ಕೊಡುತ್ತೇನೆ|ಕೊಟ್ಟೆವು|ಕೊಡನು|ಕೊಡುವಳು|ಕೊಡುತ್ತೀರಿ|ಕೊಡುತ್ತೀ|ಕೊಡುತ್ತಾಳೆ|ಕೊಡುವೆವು|ಕೊಡಿಯಾವು|ಕೊಡರಿ|ಕೊಡುವರು|ಕೊಡುವುದು|ಕೊಡುತ್ತ|ಕೊಡಲು|ಕೊಟ್ಟಳು|ಕೊಡವು	<i>verb</i><br><ol><li>(transitive) to give</li></ol>
ಕೊತ್ತಂಬರಿ|kottambari	<i>noun</i><br><ol><li>coriander</li></ol>
ಕೊಲ್ಲು|ಕೊಂದೆವು|ಕೊಂದರು|ಕೊಲ್ಲುುವೆವು|ಕೊಲ್ಲುುತ್ತೇವೆ|ಕೊಲ್ಲುನು|ಕೊಲ್ಲ|ಕೊಲ್ಲತು|ಕೊಲ್ಲುಿಯೇವು|ಕೊಲ್ಲುುವನು|ಕೊಲ್ಲುುತ್ತದೆ|ಕೊಲ್ಲುಲಿ|ಕೊಲ್ಲುದ|ಕೊಂದರೆ|ಕೊಲ್ಲುಿಯಾವು|ಕೊಲ್ಲುುವಾ|ಕೊಲ್ಲುೋಣ|ಕೊಲ್ಲುೆ|ಕೊಲ್ಲುುವುದು|ಕೊಲ್ಲುುತ್ತಾರೆ|ಕೊಲ್ಲುುವಿರಿ|ಕೊಲ್ಲುೆವು|ಕೊಲ್ಲುಲು|ಕೊಲ್ಲುುತ್ತೇನೆ|ಕೊಲ್ಲುುತ್ತಾಳೆ|ಕೊಂದನು|ಕೊಲ್ಲುುತ್ತೀರಿ|ಕೊಲ್ಲುದೆ|ಕೊಲ್ಲುುತ್ತ|ಕೊಲ್ಲುೆನು|ಕೊಂದ|ಕೊಲ್ಲೀಯೆ|ಕೊಲ್ಲುಿಯಾಳು|ಕೊಂದಳು|ಕೊಲ್ಲುದು|ಕೊಂದೆನು|ಕೊಂದಿ|ಕೊಂದುವು|ಕೊಲ್ಲುುವೆ|ಕೊಲ್ಲುವು|ಕೊಲ್ಲುೀತು|ಕೊಲ್ಲುುತ್ತಾನೆ|ಕೊಲ್ಲುಿರಿ|ಕೊಲ್ಲಯೇನು|ಕೊಲ್ಲುರು|ಕೊಲ್ಲುಳು|ಕೊಂದಿರಿ|kollu|ಕೊಲ್ಲುಿಯಾನು|ಕೊಲ್ಲುುತ್ತೀ|ಕೊಲ್ಲುುವ|ಕೊಲ್ಲುರಿ|ಕೊಲ್ಲುುತ್ತೀಯೆ|ಕೊಲ್ಲುುವುವು|ಕೊಲ್ಲುುತ್ತವೆ|ಕೊಲ್ಲುಿಯಾರು|ಕೊಲ್ಲುುವರು|ಕೊಲ್ಲುಲಿಕ್ಕೆ|ಕೊಲ್ಲುುವಿ|ಕೊಲ್ಲುು|ಕೊಂದೆ|ಕೊಲ್ಲುುವಳು|ಕೊಲ್ಲುುವೆನು|ಕೊಲ್ಲುೀರಿ	<i>verb</i><br><ol><li>To kill</li></ol>
ಕೊಳ|koḷa|ಕೊಳದಿಂದ|ಕೊಳವು|ಕೊಳಕ್ಕೆ|ಕೊಳದ|ಕೊಳಗಳನ್ನು|ಕೊಳಗಳು|ಕೊಳವನ್ನು|ಕೊಳಗಳ|ಕೊಳಗಳಿಗೆ|ಕೊಳಗಳಿಂದ	<i>noun</i><br><ol><li>lake (body of water)</li></ol>
ಕೊಳಲು|koḷalu	<i>noun</i><br><ol><li>flute</li></ol>
ಕೋಟಿ|kōṭi	<i>num</i><br><ol><li>crore, ten million</li></ol>
ಕೋಣ|kōṇa	<i>noun</i><br><ol><li>Buffalo</li></ol>
ಕೋಣೆ|ಕೋಣೆಯನ್ನು|ಕೋಣೆಯ|kōṇe|ಕೋಣೆಯು|ಕೋಣೆಗಳಿಗೆ|ಕೋಣೆಯಿಂದ|ಕೋಣೆಗಳು|ಕೋಣೆಗಳಿಂದ|ಕೋಣೆಗಳ|ಕೋಣೆಗಳನ್ನು|ಕೋಣೆಗೆ	<i>noun</i><br><ol><li>room in a building</li></ol>
ಕೋಪ|kōpa	<i>noun</i><br><ol><li>anger, fury, wrath</li></ol>
ಕೋಮಲ|kōmala	<i>adj</i><br><ol><li>soft, tender</li></ol>
ಕೋರಿಕೆ|kōrike	<i>noun</i><br><ol><li>desire, wish</li><li>a request, demand</li></ol>
ಕೋರೆಷ|kōreṣa	<i>name</i><br><ol><li>Cyrus; an ancient king of Persia</li></ol>
ಕೋಳಿ|kōḷi	<i>noun</i><br><ol><li>fowl</li></ol>
ಕೋಶ|kōśa	<i>noun</i><br><ol><li>lexicon</li></ol>
ಕ್ರಮವಿಧಿ|kramavidhi	<i>noun</i><br><ol><li>(Computer) program</li></ol>
ಕ್ರಿಯಾಪದ|ಕ್ರಿಯಾಪದವು|ಕ್ರಿಯಾಪದಕ್ಕೆ|ಕ್ರಿಯಾಪದಗಳಿಗೆ|ಕ್ರಿಯಾಪದವನ್ನು|ಕ್ರಿಯಾಪದಗಳನ್ನು|ಕ್ರಿಯಾಪದಗಳಿಂದ|ಕ್ರಿಯಾಪದದ|ಕ್ರಿಯಾಪದಗಳು|ಕ್ರಿಯಾಪದಗಳ|ಕ್ರಿಯಾಪದದಿಂದ|kriyāpada	<i>noun</i><br><ol><li>(grammar) verb</li></ol>
ಕ್ರಿಸ್ತ ಪೂರ್ವ|krista pūrva	<i>adv</i><br><ol><li>Before the Common Era</li></ol>
ಕ್ರಿಸ್ಮಸ್|krismas	<i>name</i><br><ol><li>Christmas</li></ol>
ಕ್ರೀಡಿಸು|krīḍisu	<i>verb</i><br><ol><li>(literary) to play, sport, frolic</li></ol>
ಕ್ರೀಡೆ|krīḍe	<i>noun</i><br><ol><li>(formal, literary) sport, game, playing, amusement</li></ol>
ಕ್ರೂರ|krūra	<i>adj</i><br><ol><li>cruel, brutal</li></ol>
ಕ್ರೊಯೆಶಿಯ|kroyeśiya	<i>name</i><br><ol><li>Croatia</li></ol>
ಕ್ರೋಧ|krōdha	<i>noun</i><br><ol><li>anger, fury</li></ol>
ಕ್ಷಣ|kṣaṇa	<i>noun</i><br><ol><li>a moment, an instant</li></ol>
ಕ್ಷತ್ರಿಯ|kṣatriya	<i>noun</i><br><ol><li>a member of the warrior or the ruling caste</li></ol>
ಕ್ಷಯ|kṣaya	<i>noun</i><br><ol><li>corrosion, attrition</li><li>decay</li><li>diminution, decline, wasting away</li><li>tuberculosis</li></ol>
ಕ್ಷಿಪಣಿ|kṣipaṇi	<i>noun</i><br><ol><li>missile</li></ol>
ಕ್ಷೀರ|kṣīra	<i>noun</i><br><ol><li>(literary, poetic) milk</li></ol>
ಕ್ಷುಲ್ಲಕ|kṣullaka	<i>adj</i><br><ol><li>trivial, unimportant, insignificant</li></ol>
ಕ್ಷೇತ್ರ|kṣētra	<i>noun</i><br><ol><li>field</li><li>area, region</li></ol>
ಕ್ಷೇಮ|kṣēma	<i>noun</i><br><ol><li>safety, wellness, well-being</li></ol>
ಖ|kha	<i>character</i><br><ol><li>The Kannada letter kha.</li></ol>
ಖಡ್ಗ|khaḍga	<i>noun</i><br><ol><li>sword</li></ol>
ಖಡ್ಗಮೃಗ|khaḍgamṛga	<i>noun</i><br><ol><li>rhinoceros</li></ol>
ಖಾತೆ|khāte	<i>noun</i><br><ol><li>account</li></ol>
ಖಿ|khi	<i>character</i><br><ol><li>The Kannada letter khi.</li></ol>
ಖೂನಿ|ಖೂನಿಯ|ಖೂನಿಯು|ಖೂನಿಗಳಿಂದ|ಖೂನಿಯಿಂದ|ಖೂನಿಗಳಿಗೆ|ಖೂನಿಗಳ|ಖೂನಿಗಳು|ಖೂನಿಯನ್ನು|ಖೂನಿಗೆ|khūni|ಖೂನಿಗಳನ್ನು	<i>noun</i><br><ol><li>murder</li></ol>
ಗ|ga	<i>character</i><br><ol><li>The Kannada letter ga.</li></ol>
ಗಂಗಾಧರ|gaṅgādhara	<i>name</i><br><ol><li>(Hinduism) an epithet of Shiva</li></ol>
ಗಂಜ|gaṅja	<i>noun</i><br><ol><li>distillery</li></ol>
ಗಂಟೆ|gaṇṭe	<i>noun</i><br><ol><li>hour</li></ol>
ಗಂಡಸು|gaṇḍasu	<i>noun</i><br><ol><li>man</li></ol>
ಗಗನ|gagana	<i>noun</i><br><ol><li>(poetic) the sky</li></ol>
ಗಣಕಯಂತ್ರ|gaṇakayantra	<i>noun</i><br><ol><li>calculator, computer</li></ol>
ಗಣಪತಿ|gaṇapati	<i>name</i><br><ol><li>Ganesha (Hindu deity)</li></ol>
ಗಣೇಶ|gaṇēśa	<i>name</i><br><ol><li>Ganesha (Hindu deity)</li></ol>
ಗತ|gata	<i>adj</i><br><ol><li>(literary, rare) gone, bygone, past</li></ol>
ಗತಿ|gati	<i>noun</i><br><ol><li>going, motion</li><li>path, course</li><li>speed, velocity, pace</li><li>fate, future</li><li>plight</li><li>refuge, shelter</li></ol>
ಗದ್ದ|gadda	<i>noun</i><br><ol><li>chin</li></ol>
ಗದ್ದಲ|gaddala	<i>noun</i><br><ol><li>noise, tumult, clamor, stir, din, racket, fracas, hubbub</li><li>turmoil, pandemonium, melee, commotion</li></ol>
ಗದ್ದುಗೆ|gadduge	<i>noun</i><br><ol><li>throne</li></ol>
ಗದ್ದೆ|gadde	<i>noun</i><br><ol><li>field</li></ol>
ಗಬ್ಬ|gabba	<i>noun</i><br><ol><li>pregnancy (of animals)</li><li>womb, uterus</li><li>the interior; the innermost part of anything</li></ol>
ಗಮನ|gamana	<i>noun</i><br><ol><li>attention</li></ol>
ಗರ್ಭ|garbha	<i>noun</i><br><ol><li>the womb, uterus</li></ol>
ಗರ್ಭಿಣಿ|garbhiṇi	<i>adj</i><br><ol><li>pregnant</li></ol>
ಗಲೀಜು|galīju	<i>adj</i><br><ol><li>dirty, filthy, impure</li></ol>
ಗವಾಕ್ಷ|gavākṣa	<i>noun</i><br><ol><li>window</li></ol>
ಗವಿ|gavi	<i>noun</i><br><ol><li>cave, den</li></ol>
ಗವುಜುಗ|gavujuga	<i>noun</i><br><ol><li>quail</li></ol>
ಗಾಂಜಾ|ಗಾಂಜಾದ|ಗಾಂಜಾಕ್ಕೆ|ಗಾಂಜಾಗಳಿಂದ|ಗಾಂಜಾಗಳಿಗೆ|gān̄jā|ಗಾಂಜಾವನ್ನು|ಗಾಂಜಾಗಳು|ಗಾಂಜಾವು|ಗಾಂಜಾಗಳ|ಗಾಂಜಾದಿಂದ|ಗಾಂಜಾಗಳನ್ನು	<i>noun</i><br><ol><li>ganja, marijuana</li></ol>
ಗಾಜು|gāju	<i>noun</i><br><ol><li>glass</li></ol>
ಗಾಳಿ|ಗಾಳಿಗಳು|ಗಾಳಿಯಿಂದ|ಗಾಳಿಯು|ಗಾಳಿಗೆ|ಗಾಳಿಗಳಿಂದ|ಗಾಳಿಗಳಿಗೆ|ಗಾಳಿಯ|ಗಾಳಿಗಳನ್ನು|ಗಾಳಿಯನ್ನು|gāḷi|ಗಾಳಿಗಳ	<i>noun</i><br><ol><li>wind, air</li><li>ghost, spirit</li></ol>
ಗಾಳಿತೇರು|gāḷitēru	<i>noun</i><br><ol><li>aeroplane</li></ol>
ಗಿ|gi	<i>character</i><br><ol><li>The Kannada letter gi.</li></ol>
ಗಿಡ|ಗಿಡವನ್ನು|ಗಿಡಗಳ|ಗಿಡವು|ಗಿಡಗಳನ್ನು|ಗಿಡಗಳು|ಗಿಡಕ್ಕೆ|ಗಿಡಗಳಿಗೆ|ಗಿಡಗಳಿಂದ|giḍa|ಗಿಡದಿಂದ|ಗಿಡದ	<i>noun</i><br><ol><li>plant</li><li>shrub</li><li>herb</li></ol>
ಗಿರಿ|ಗಿರಿಗಳಿಂದ|ಗಿರಿಯಿಂದ|ಗಿರಿಯನ್ನು|giri|ಗಿರಿಗಳು|ಗಿರಿಗೆ|ಗಿರಿಗಳನ್ನು|ಗಿರಿಯ|ಗಿರಿಗಳಿಗೆ|ಗಿರಿಗಳ|ಗಿರಿಯು	<i>noun</i><br><ol><li>(geography) mountain (large, rocky hill)</li></ol>
ಗಿಳಿ|giḷi	<i>noun</i><br><ol><li>parrot</li></ol>
ಗೀತನಾಟಕ|gītanāṭaka	<i>noun</i><br><ol><li>opera</li></ol>
ಗುಂಡಿಗೆ|guṇḍige	<i>noun</i><br><ol><li>heart</li></ol>
ಗುಂಡು ಬದನೆಗಿಡ|guṇḍu badanegiḍa	<i>noun</i><br><ol><li>eggplant</li></ol>
ಗುಂಪು|gumpu|ಗುಂಪುಗಳಿಂದ|ಗುಂಪುಗಳನ್ನು|ಗುಂಪಿನ|ಗುಂಪುಗಳ|ಗುಂಪಿಗೆ|ಗುಂಪುಗಳಿಗೆ|ಗುಂಪಿನಿಂದ|ಗುಂಪನ್ನು|ಗುಂಪುಗಳು	<i>noun</i><br><ol><li>category</li><li>group, party, batch</li></ol>
ಗುಟುಕು|guṭuku	<i>noun</i><br><ol><li>a sip; a mouthful of a liquid</li></ol>
ಗುಟ್ಟು|guṭṭu	<i>noun</i><br><ol><li>secret</li></ol>
ಗುಡಿ|guḍi	<i>noun</i><br><ol><li>a small house, hut, cabin</li><li>a small shrine, temple</li><li>bunch, tuft (of flowers, grass)</li><li>a flag</li></ol>
ಗುತ್ತಿಗೆದಾರ|guttigedāra	<i>noun</i><br><ol><li>tenant, lessee</li></ol>
ಗುರಿ|guri	<i>noun</i><br><ol><li>aim, target</li><li>goal</li><li>mark, sign</li></ol>
ಗುರು|guru	<i>noun</i><br><ol><li>teacher, master</li><li>a guru; a (spiritual) mentor or guide</li><li>(slang) a friend, a "bro".</li></ol>
ಗುರುವಾರ|guruvāra	<i>noun</i><br><ol><li>Thursday; the fifth day of the week.</li></ol>
ಗುಲಾಬಿ|gulābi	<i>noun</i><br><ol><li>rose</li></ol>
ಗುಹೆ|guhe	<i>noun</i><br><ol><li>cave</li></ol>
ಗೂಢ|gūḍha	<i>adj</i><br><ol><li>secret, hidden</li></ol><br><i>noun</i><br><ol><li>a secret</li></ol>
ಗೂಬೆ|gūbe	<i>noun</i><br><ol><li>owl</li><li>(figurative, pejorative) a stupid or lazy person</li></ol>
ಗೂಳಿ|gūḷi	<i>noun</i><br><ol><li>bull</li></ol>
ಗೃಧ್ರ|gṛdhra	<i>noun</i><br><ol><li>(rare) a vulture</li></ol>
ಗೃಹ|gṛha	<i>noun</i><br><ol><li>(literary, formal) a house</li></ol>
ಗೆಲುವು|geluvu	<i>noun</i><br><ol><li>victory</li></ol>
ಗೆಲ್ಲು|ಗೆಲ್ಲಯೇನು|ಗೆಲ್ಲುತ್ತಾಳೆ|ಗೆಲ್ಲುತ್ತ|ಗೆಲ್ಲುತ್ತಾರೆ|ಗೆಲ್ಲುವನು|ಗೆದ್ದೆವು|ಗೆಲ್ಲುವುದು|ಗೆದ್ದರೆ|ಗೆದ್ದ|ಗೆಲ್ಲುತ್ತಾನೆ|ಗೆದ್ದಿ|ಗೆಲ್ಲುವಿ|ಗೆಲ್ಲೆ|gellu|ಗೆಲ್ಲೀಯೆ|ಗೆಲ್ಲನು|ಗೆಲ್ಲುತ್ತೀರಿ|ಗೆಲ್ಲಿಯಾರು|ಗೆಲ್ಲುವರು|ಗೆಲ್ಲಿಯಾನು|ಗೆಲ್ಲಿಯೇವು|ಗೆಲ್ಲುವಾ|ಗೆಲ್ಲುತ್ತೇವೆ|ಗೆದ್ದಿರಿ|ಗೆಲ್ಲುವುವು|ಗೆಲ್ಲುವೆ|ಗೆಲ್ಲುತ್ತವೆ|ಗೆಲ್ಲಿಯಾವು|ಗೆಲ್ಲುವೆನು|ಗೆಲ್ಲುತ್ತದೆ|ಗೆದ್ದನು|ಗೆದ್ದರು|ಗೆಲ್ಲಿರಿ|ಗೆಲ್ಲಲಿಕ್ಕೆ|ಗೆಲ್ಲುವಿರಿ|ಗೆಲ್ಲಳು|ಗೆಲ್ಲೆವು|ಗೆಲ್ಲದ|ಗೆದ್ದೆ|ಗೆಲ್ಲಲಿ|ಗೆಲ್ಲುತ್ತೇನೆ|ಗೆಲ್ಲುವಳು|ಗೆಲ್ಲೆನು|ಗೆಲ್ಲಲು|ಗೆದ್ದಳು|ಗೆದ್ದೆನು|ಗೆಲ್ಲುತ್ತೀಯೆ|ಗೆಲ್ಲುತ್ತೀ|ಗೆದ್ದುವು|ಗೆಲ್ಲೀರಿ|ಗೆಲ್ಲದೆ|ಗೆಲ್ಲರಿ|ಗೆಲ್ಲೀತು|ಗೆಲ್ಲುವೆವು|ಗೆಲ್ಲಿಯಾಳು|ಗೆಲ್ಲತು|ಗೆಲ್ಲದು|ಗೆಲ್ಲ|ಗೆಲ್ಲೋಣ|ಗೆಲ್ಲವು|ಗೆಲ್ಲುವ|ಗೆಲ್ಲರು	<i>verb</i><br><ol><li>To win, triumph, conquer</li></ol>
ಗೆಳೆತನ|ಗೆಳೆತನಗಳು|ಗೆಳೆತನಗಳಿಗೆ|ಗೆಳೆತನದ|ಗೆಳೆತನವನ್ನು|ಗೆಳೆತನವು|ಗೆಳೆತನಗಳಿಂದ|ಗೆಳೆತನಗಳ|ಗೆಳೆತನಕ್ಕೆ|geḷetana|ಗೆಳೆತನದಿಂದ|ಗೆಳೆತನಗಳನ್ನು	<i>noun</i><br><ol><li>friendship</li><li>amity</li></ol>
ಗೆಳೆಯ|geḷeya	<i>noun</i><br><ol><li>a friend</li></ol>
ಗೊಂಚೆ|goñce	<i>noun</i><br><ol><li>grape</li></ol>
ಗೊಡ್ಡ|goḍḍa	<i>noun</i><br><ol><li>peril, jeopardy</li><li>a complicated, perplexing affair</li><li>an act of cheating or fraud</li><li>an act of irritation</li><li>a useless person</li></ol><br><i>adj</i><br><ol><li>of a plant</li></ol>
ಗೊಬ್ಬರ|gobbara	<i>noun</i><br><ol><li>manure</li></ol>
ಗೊಲ್ಲ|golla	<i>noun</i><br><ol><li>a cowherd</li><li>a member of the Golla caste, a caste historically engaged in tending cattle</li></ol>
ಗೋತ್ರ|gōtra	<i>noun</i><br><ol><li>clan, tribe, race, family</li></ol>
ಗೋದ|gōda	<i>noun</i><br><ol><li>brain</li></ol>
ಗೋಧಿ|gōdhi	<i>noun</i><br><ol><li>wheat (grain)</li></ol>
ಗೋನಸ|gōnasa	<i>noun</i><br><ol><li>boa (constrictor)</li></ol>
ಗೋಪ|gōpa	<i>noun</i><br><ol><li>ox</li></ol>
ಗೋಪಿಬಣ್ಣ|gōpibaṇṇa	<i>noun</i><br><ol><li>ochre</li></ol>
ಗೋಮಾಯು|ಗೋಮಾಯಿಗೆ|ಗೋಮಾಯುಗಳಿಂದ|ಗೋಮಾಯಿನಿಂದ|ಗೋಮಾಯುಗಳು|ಗೋಮಾಯುಗಳಿಗೆ|ಗೋಮಾಯುಗಳನ್ನು|ಗೋಮಾಯಿನ|gōmāyu|ಗೋಮಾಯನ್ನು|ಗೋಮಾಯುಗಳ	<i>noun</i><br><ol><li>jackal</li></ol>
ಗೋಮಾಳ|gōmāḷa	<i>noun</i><br><ol><li>pasture, pasturage, pastureland, meadow</li></ol>
ಗೋವು|gōvu	<i>noun</i><br><ol><li>(literary) a cow</li></ol>
ಗ್ರಹ|graha|ಗ್ರಹವನ್ನು|ಗ್ರಹದಿಂದ|ಗ್ರಹದ|ಗ್ರಹಗಳನ್ನು|ಗ್ರಹಗಳಿಂದ|ಗ್ರಹಗಳಿಗೆ|ಗ್ರಹಗಳ|ಗ್ರಹಗಳು|ಗ್ರಹಕ್ಕೆ|ಗ್ರಹವು	<i>noun</i><br><ol><li>(astronomy) planet</li></ol>
ಗ್ರಾಮ|grāma	<i>noun</i><br><ol><li>village</li></ol>
ಗ್ರೀಷ್ಮ|grīṣma	<i>noun</i><br><ol><li>summer</li></ol>
ಗ್ಲಾನಿ|glāni	<i>noun</i><br><ol><li>exhaustion, tiredness, decline, decrease</li></ol>
ಘ|gha	<i>character</i><br><ol><li>The Kannada letter gha.</li></ol>
ಘೂಕ|ಘೂಕಗಳು|ಘೂಕಗಳ|ಘೂಕಗಳಿಂದ|ಘೂಕಗಳನ್ನು|ಘೂಕಗಳಿಗೆ|ಘೂಕದಿಂದ|ಘೂಕವನ್ನು|ಘೂಕಕ್ಕೆ|ghūka|ಘೂಕದ|ಘೂಕವು	<i>noun</i><br><ol><li>owl</li></ol>
ಘೋಣೆ|ghōṇe	<i>noun</i><br><ol><li>nose</li></ol>
ಘೋರ|ghōra	<i>adj</i><br><ol><li>terrible, fearful</li></ol>
ಘೋಷಿಸು|ghōṣisu	<i>verb</i><br><ol><li>(poetic) to declare</li></ol>
ಙ|ṅa	<i>character</i><br><ol><li>The Kannada letter ṅa.</li></ol>
ಚ|ca	<i>character</i><br><ol><li>The Kannada letter ca.</li></ol>
ಚಂಜೆ|caṅje	<i>noun</i><br><ol><li>evening</li></ol>
ಚಂಡಮಾರುತ|caṇḍamāruta	<i>noun</i><br><ol><li>gale, storm, cyclone</li></ol>
ಚಂದ್ರ|ಚಂದ್ರಗಳಿಗೆ|ಚಂದ್ರದಿಂದ|ಚಂದ್ರವನ್ನು|ಚಂದ್ರದ|ಚಂದ್ರಗಳಿಂದ|ಚಂದ್ರಗಳನ್ನು|candra|ಚಂದ್ರವು|ಚಂದ್ರಗಳು|ಚಂದ್ರಕ್ಕೆ|ಚಂದ್ರಗಳ	<i>noun</i><br><ol><li>moon</li></ol>
ಚಕ್ರ|ಚಕ್ರಗಳು|ಚಕ್ರವನ್ನು|ಚಕ್ರಗಳನ್ನು|ಚಕ್ರಕ್ಕೆ|ಚಕ್ರಗಳಿಂದ|ಚಕ್ರಗಳ|ಚಕ್ರಗಳಿಗೆ|ಚಕ್ರವು|cakra|ಚಕ್ರದ|ಚಕ್ರದಿಂದ	<i>noun</i><br><ol><li>wheel</li></ol>
ಚತುರ್ಥ|caturtha	<i>adj</i><br><ol><li>(formal, literary) fourth</li></ol>
ಚದರು|ಚದರಿರಿ|cadaru|ಚದರಿತೆ|ಚದರುತ್ತೀ|ಚದರುತ್ತದೆ|ಚದರಿಯಾನು|ಚದರಲು|ಚದರುವ|ಚದರಳು|ಚದರುವಾ|ಚದರತು|ಚದರರು|ಚದರವು|ಚದರುವನು|ಚದರುವುದು|ಚದರೆ|ಚದರುತ್ತೇನೆ|ಚದರುತ್ತೇವೆ|ಚದರಿತನು|ಚದರಿತಿ|ಚದರಲಿಕ್ಕೆ|ಚದರದೆ|ಚದರುತ್ತಾರೆ|ಚದರೆನು|ಚದರದು|ಚದರುವುವು|ಚದರಲಿ|ಚದರಿತಿರಿ|ಚದರಿತ|ಚದರಿತರೆ|ಚದರೆವು|ಚದರುತ್ತಾನೆ|ಚದರಿಯಾಳು|ಚದರುವಳು|ಚದರುತ್ತ|ಚದರದ|ಚದರನು|ಚದರುವೆ|ಚದರ|ಚದರುವೆವು|ಚದರುವಿರಿ|ಚದರಿತರು|ಚದರೀಯೆ|ಚದರುತ್ತೀರಿ|ಚದರೀತು|ಚದರಿತೆನು|ಚದರೀರಿ|ಚದರಿಯಾವು|ಚದರುತ್ತವೆ|ಚದರಿತುವು|ಚದರೋಣ|ಚದರುತ್ತಾಳೆ|ಚದರಯೇನು|ಚದರುವಿ|ಚದರಿಯೇವು|ಚದರುವೆನು|ಚದರುತ್ತೀಯೆ|ಚದರುವರು|ಚದರರಿ|ಚದರಿಯಾರು|ಚದರಿತೆವು|ಚದರಿತಳು	<i>verb</i><br><ol><li>to scatter</li></ol>
ಚಮಚ|camaca	<i>noun</i><br><ol><li>spoon</li></ol>
ಚರಿತ್ರಹೀನ|caritrahīna	<i>adj</i><br><ol><li>bereft of values; immoral</li></ol>
ಚರ್ಚು|carcu	<i>noun</i><br><ol><li>church</li></ol>
ಚರ್ಚ್|carc	<i>noun</i><br><ol><li>church</li></ol>
ಚರ್ಮ|carma	<i>noun</i><br><ol><li>skin</li><li>hide, parchment, leather</li></ol>
ಚಲ್ಲು|ಚಲ್ಲುದು|ಚಲ್ಲುನು|ಚಲ್ಲುುವೆನು|{{{3}}}ರೆ ({{{3}}}re)|ಚಲ್ಲ|ಚಲ್ಲುುತ್ತಾಳೆ|ಚಲ್ಲುಿಯಾನು|ಚಲ್ಲುೀರಿ|ಚಲ್ಲುುವೆವು|{{{3}}}ನು ({{{3}}}nu)|{{{3}}}ಿರಿ ({{{3}}}ಿri)|ಚಲ್ಲುುವಳು|ಚಲ್ಲುುವಿರಿ|ಚಲ್ಲುಳು|ಚಲ್ಲುೆವು|ಚಲ್ಲುೀತು|ಚಲ್ಲುವು|ಚಲ್ಲುುವ|ಚಲ್ಲುುತ್ತ|ಚಲ್ಲುಲಿ|ಚಲ್ಲುುವರು|ಚಲ್ಲುುವಾ|ಚಲ್ಲುು|ಚಲ್ಲುದೆ|{{{3}}}ರು ({{{3}}}ru)|ಚಲ್ಲುೆ|ಚಲ್ಲುೆನು|ಚಲ್ಲುದ|ಚಲ್ಲುುತ್ತೇವೆ|ಚಲ್ಲುಿಯಾವು|ಚಲ್ಲುುತ್ತವೆ|ಚಲ್ಲುಲು|ಚಲ್ಲುುತ್ತೀಯೆ|ಚಲ್ಲತು|ಚಲ್ಲುುತ್ತಾನೆ|ಚಲ್ಲುುವನು|ಚಲ್ಲುುತ್ತೀರಿ|ಚಲ್ಲುಿರಿ|ಚಲ್ಲುುತ್ತೀ|callu|ಚಲ್ಲುುವೆ|ಚಲ್ಲುುವುದು|ಚಲ್ಲುುವಿ|ಚಲ್ಲುಿಯಾಳು|ಚಲ್ಲುುತ್ತಾರೆ|ಚಲ್ಲುುತ್ತದೆ|{{{3}}}ಳು ({{{3}}}ḷu)|ಚಲ್ಲಯೇನು|ಚಲ್ಲುಲಿಕ್ಕೆ|{{{3}}}ೆವು ({{{3}}}ೆvu)|ಚಲ್ಲುೋಣ|ಚಲ್ಲುರಿ|ಚಲ್ಲುುವುವು|ಚಲ್ಲುಿಯೇವು|ಚಲ್ಲುುತ್ತೇನೆ|ಚಲ್ಲುರು|{{{3}}}ುವು ({{{3}}}ುvu)|ಚಲ್ಲೀಯೆ|ಚಲ್ಲುಿಯಾರು|{{{3}}}ೆನು ({{{3}}}ೆnu)	<i>verb</i><br><ol><li>to scatter</li></ol>
ಚಹಾ|ಚಹಾದಿಂದ|ಚಹಾಗಳು|ಚಹಾಕ್ಕೆ|ಚಹಾಗಳ|ಚಹಾವು|cahā|ಚಹಾಗಳಿಗೆ|ಚಹಾವನ್ನು|ಚಹಾದ|ಚಹಾಗಳನ್ನು|ಚಹಾಗಳಿಂದ	<i>noun</i><br><ol><li>tea</li></ol>
ಚಾರ್ಟು|cārṭu	<i>noun</i><br><ol><li>chart</li></ol>
ಚಾಲಾಕು|cālāku	<i>adj</i><br><ol><li>intelligent, shrewd, smart, quick, brisk, dextrous, clever</li></ol><br><i>noun</i><br><ol><li>cleverness, shrewdness, acumen, sharpness</li></ol>
ಚಾವಿ|cāvi	<i>noun</i><br><ol><li>key</li></ol>
ಚಿಟ್ಟನೆ|ciṭṭane	<i>adv</i><br><ol><li>firmly</li><li>loudly</li></ol>
ಚಿತ್ರಾನ್ನ|citrānna	<i>noun</i><br><ol><li>chitranna or lemon rice; a South Indian dish combining rice with a mixture of lemon and spices as well as other food for seasoning</li><li>(slang) a bad situation or poor completion of a task</li></ol>
ಚಿನ್ನ|cinna	<i>noun</i><br><ol><li>gold</li></ol>
ಚಿರತೆ|cirate	<i>noun</i><br><ol><li>a cheetah</li></ol>
ಚು|cu	<i>character</i><br><ol><li>The Kannada letter cu.</li></ol>
ಚುಕ್ಕೆ|cukke	<i>noun</i><br><ol><li>star</li><li>a pip on dice or cards</li><li>dot, small mark</li><li>speck, tiny quantity</li><li>venus</li></ol>
ಚುನಾವಣೆ|cunāvaṇe	<i>noun</i><br><ol><li>election</li></ol>
ಚೆನ್ನಾಗಿ|cennāgi	<i>adv</i><br><ol><li>well, okay</li></ol>
ಚೆಲುವು|celuvu	<i>noun</i><br><ol><li>charm, beauty, loveliness</li><li>glory</li></ol>
ಚೇಡಿ|cēḍi	<i>noun</i><br><ol><li>(mineralogy) clay</li></ol>
ಚೇಳು|cēḷu	<i>noun</i><br><ol><li>a scorpion</li></ol>
ಚೊಕ್ಕ|cokka	<i>adj</i><br><ol><li>clean, spotless</li></ol>
ಚೋರ|cōraru|ಚೋರರು|cōra	<i>noun</i><br><ol><li>(formal, literary) a thief</li></ol>
ಚೌಕ|cauka	<i>noun</i><br><ol><li>square</li></ol><br><i>adj</i><br><ol><li>shaped like a square</li></ol>
ಛ|cha	<i>character</i><br><ol><li>The Kannada letter cha.</li></ol>
ಜ|ja	<i>character</i><br><ol><li>The Kannada letter ja.</li></ol>
ಜಂಗಲು|jaṅgalu	<i>noun</i><br><ol><li>jungle</li></ol>
ಜಕಾತಿ|jakāti	<i>noun</i><br><ol><li>excise, toll</li></ol>
ಜಗಲಿ|jagali	<i>noun</i><br><ol><li>verandah, scaffold</li><li>platform, stage</li><li>dais</li></ol>
ಜಡಧಿ|jaḍadhi	<i>noun</i><br><ol><li>ocean</li></ol>
ಜಡೆ|jaḍe	<i>noun</i><br><ol><li>plait, tress, braid of hair</li></ol>
ಜನ|jana	<i>noun</i><br><ol><li>man, person</li><li>mankind, people</li></ol>
ಜಮುನೆ|jamune	<i>name</i><br><ol><li>Yamuna</li></ol>
ಜಯ|jaya	<i>noun</i><br><ol><li>victory</li></ol>
ಜರ್ಮನಿ|ಜರ್ಮನಿಯನ್ನು|ಜರ್ಮನಿಯ|jarmani|ಜರ್ಮನಿಗಳ|ಜರ್ಮನಿಗಳು|ಜರ್ಮನಿಯು|ಜರ್ಮನಿಗಳಿಂದ|ಜರ್ಮನಿಗಳಿಗೆ|ಜರ್ಮನಿಗೆ|ಜರ್ಮನಿಗಳನ್ನು|ಜರ್ಮನಿಯಿಂದ	<i>name</i><br><ol><li>Germany</li></ol>
ಜಲಜನಕ|ಜಲಜನಕಗಳು|ಜಲಜನಕದಿಂದ|ಜಲಜನಕಗಳನ್ನು|ಜಲಜನಕದ|jalajanaka|ಜಲಜನಕಗಳ|ಜಲಜನಕವು|ಜಲಜನಕಕ್ಕೆ|ಜಲಜನಕವನ್ನು|ಜಲಜನಕಗಳಿಂದ|ಜಲಜನಕಗಳಿಗೆ	<i>noun</i><br><ol><li>hydrogen</li></ol>
ಜಲಪಾತ|ಜಲಪಾತಕ್ಕೆ|ಜಲಪಾತವು|ಜಲಪಾತವನ್ನು|ಜಲಪಾತಗಳಿಂದ|ಜಲಪಾತಗಳು|ಜಲಪಾತದ|ಜಲಪಾತದಿಂದ|ಜಲಪಾತಗಳಿಗೆ|jalapāta|ಜಲಪಾತಗಳ|ಜಲಪಾತಗಳನ್ನು	<i>noun</i><br><ol><li>(geography) waterfall</li></ol>
ಜಲಾಶಯ|jalāśaya	<i>noun</i><br><ol><li>lake (body of water)</li></ol>
ಜಲ್ಮ|jalma	<i>noun</i><br><ol><li>(Havyaka) lifetime</li></ol>
ಜವಳಿ|javaḷi	<i>noun</i><br><ol><li>cloth, textile</li></ol>
ಜವಾಬು|javābu	<i>noun</i><br><ol><li>answer, reply, response</li></ol>
ಜಾತಿ|jāti	<i>noun</i><br><ol><li>kind, type</li><li>breed, species</li><li>race, lineage, caste</li></ol>
ಜಾಸ್ತಿ|jāsti	<i>adj</i><br><ol><li>more than, exceeding</li></ol><br><i>adv</i><br><ol><li>more, excessively</li></ol>
ಜಾಹೀರಾತು|ಜಾಹೀರಾತುಗಳು|jāhīrātu|ಜಾಹೀರಾತುಗಳಿಂದ|ಜಾಹೀರಾತನ್ನು|ಜಾಹೀರಾತುಗಳನ್ನು|ಜಾಹೀರಾತುಗಳಿಗೆ|ಜಾಹೀರಾತಿನಿಂದ|ಜಾಹೀರಾತಿಗೆ|ಜಾಹೀರಾತಿನ|ಜಾಹೀರಾತುಗಳ	<i>noun</i><br><ol><li>(marketing) proclamation or the paper containing it, public notice, announcement; commercial advertisement</li></ol>
ಜಿಗಟಾದ|jigaṭāda	<i>adj</i><br><ol><li>glutinous</li></ol>
ಜಿರಳೆ|jiraḷe	<i>noun</i><br><ol><li>cockroach</li></ol>
ಜೀರಿಗೆ|jīrige	<i>noun</i><br><ol><li>cumin seeds</li></ol>
ಜೀವ|jīva	<i>noun</i><br><ol><li>life</li></ol>
ಜೂಜು|jūju	<i>noun</i><br><ol><li>gambling</li></ol>
ಜೇಡಿ|jēḍi|ಜೇಡಿಯ|ಜೇಡಿಯು|ಜೇಡಿಗೆ|ಜೇಡಿಗಳಿಗೆ|ಜೇಡಿಯಿಂದ|ಜೇಡಿಗಳ|ಜೇಡಿಗಳಿಂದ|ಜೇಡಿಯನ್ನು|ಜೇಡಿಗಳು|ಜೇಡಿಗಳನ್ನು	<i>noun</i><br><ol><li>(mineralogy) clay</li></ol>
ಜೇನು|jēnu	<i>noun</i><br><ol><li>honey</li></ol>
ಜೋಗು|jōgu	<i>noun</i><br><ol><li>(geography) waterfall</li></ol>
ಜೋಯಿಸ|jōyisa	<i>noun</i><br><ol><li>an astrologer</li></ol>
ಜ್ಯಾ|jyā	<i>noun</i><br><ol><li>Earth</li><li>bowstring</li></ol>
ಜ್ವಲಿಸು|jvalisu	<i>verb</i><br><ol><li>to flare</li><li>to blaze, flash</li></ol>
ಜ್ವಾಲಾಮುಖಿ|ಜ್ವಾಲಾಮುಖಿಯ|ಜ್ವಾಲಾಮುಖಿಗಳ|ಜ್ವಾಲಾಮುಖಿಯು|ಜ್ವಾಲಾಮುಖಿಗಳು|jvālāmukhi|ಜ್ವಾಲಾಮುಖಿಗಳಿಗೆ|ಜ್ವಾಲಾಮುಖಿಗಳನ್ನು|ಜ್ವಾಲಾಮುಖಿಗಳಿಂದ|ಜ್ವಾಲಾಮುಖಿಗೆ|ಜ್ವಾಲಾಮುಖಿಯಿಂದ|ಜ್ವಾಲಾಮುಖಿಯನ್ನು	<i>noun</i><br><ol><li>(geology) volcano</li></ol>
ಝ|jha	<i>character</i><br><ol><li>The Kannada letter jha.</li></ol>
ಞ|ña	<i>character</i><br><ol><li>The Kannada letter ña.</li></ol>
ಟ|ṭa	<i>character</i><br><ol><li>The Kannada letter ṭa.</li></ol>
ಟಂಕಿ|ṭaṅki	<i>noun</i><br><ol><li>tabret</li></ol>
ಟಿಟ್ಟಿಭ|ṭiṭṭibha	<i>noun</i><br><ol><li>quail</li></ol>
ಟೊಂಗು|ṭoṅgu	<i>noun</i><br><ol><li>fist</li><li>knock, rap (with the hand)</li></ol>
ಟೊಣೆ|ಟೊಣೆುತ್ತಾಳೆ|{ಟೊಣೆಯಿರಿ ({ṭoṇeyiri)|{{{3}}}ಾವು ({{{3}}}ಾvu)|ಟೊಣೆುತ್ತಾನೆ|{{{5}}}ಿತು ({{{5}}}ಿtu)|{{{3}}}ರೆ ({{{3}}}re)|ಟೊಣೆಯುವುದು|ಟೊಣೆಯುವ|ಟೊಣೆಯದ|ಟೊಣೆಯುವಿ|{{{3}}}ನು ({{{3}}}nu)|ಟೊಣೆುತ್ತೇವೆ|{{{3}}}ಿರಿ ({{{3}}}ಿri)|{{{3}}}ೀತು ({{{3}}}ೀtu)|ಟೊಣೆಯುವಾ|ಟೊಣೆಯಲು|{{{3}}}ೇನು ({{{3}}}ೇnu)|ಟೊಣೆಯುವೆ|ಟೊಣೆುತ್ತೀರಿ|ಟೊಣೆಯವು|ಟೊಣೆಯೆನು|ಟೊಣೆಯನು|{{{3}}}ರು ({{{3}}}ru)|ಟೊಣೆ}ಯಲಿಕ್ಕೆ (ṭoṇe}yalikke)|ಟೊಣೆಯುವಳು|ಟೊಣೆಯಲಿ|{{{3}}}ೀರಿ ({{{3}}}ೀri)|{{{3}}}ೀಯೆ ({{{3}}}ೀye)|ಟೊಣೆುತ್ತಾರೆ|ಟೊಣೆಯುವೆವು|{{{2}}}ಯುವೆ ({{{2}}}yuve)|ಟೊಣೆಯುತ್ತ|ಟೊಣೆುತ್ತೀಯೆ|ಟೊಣೆಯೋಣ|ಟೊಣೆಯದೆ|ಟೊಣೆಯದು|ಟೊಣೆಯೆ|{{{3}}}ಾರು ({{{3}}}ಾru)|{{{3}}}ೇವು ({{{3}}}ೇvu)|ಟೊಣೆುತ್ತದೆ|{{{3}}}ಳು ({{{3}}}ḷu)|ಟೊಣೆಯುವುವು|ಟೊಣೆಯುವನು|ಟೊಣೆಯೆವು|{{{3}}}ೆವು ({{{3}}}ೆvu)|ṭoṇe|ಟೊಣೆಯುವೆನು|ಟೊಣೆಯುವಿರಿ|ಟೊಣೆುತ್ತೀ|ಟೊಣೆಯುವರು|ಟೊಣೆಯಳು|{{{3}}}ಾನು ({{{3}}}ಾnu)|ಟೊಣೆಯರು|{{{3}}}ಾಳು ({{{3}}}ಾḷu)|{{{3}}}ುವು ({{{3}}}ುvu)|ಟೊಣೆಯರಿ|ಟೊಣೆುತ್ತೇನೆ|ಟೊಣೆುತ್ತವೆ|{{{3}}}ೆನು ({{{3}}}ೆnu)	<i>verb</i><br><ol><li>say, tell</li></ol>
ಟೋಪಿ|ṭōpi	<i>noun</i><br><ol><li>hat, helmet</li></ol>
ಠ|ṭha	<i>character</i><br><ol><li>The Kannada letter ṭha.</li></ol>
ಡ|ḍa	<i>character</i><br><ol><li>The Kannada letter ḍa.</li></ol>
ಡಕೋಟಾ|ḍakōṭā	<i>adj</i><br><ol><li>(slang) poor quality; sub-standard (especially of vehicles)</li></ol>
ಢ|ḍha	<i>character</i><br><ol><li>The Kannada letter ḍha.</li></ol>
ಣ|ṇa	<i>character</i><br><ol><li>The Kannada letter ṇa.</li></ol>
ಣಿ|ṇi	<i>character</i><br><ol><li>The Kannada letter ṇi.</li></ol>
ತ|ta	<i>character</i><br><ol><li>The Kannada letter ta.</li></ol>
ತಂಡ|taṇḍa	<i>noun</i><br><ol><li>league</li><li>troupe,</li><li>team, set, crew, gang, band, contingent, company, party, panel</li><li>batch, class</li><li>horde</li><li>assemblage</li></ol>
ತಂಡವಾಳ|taṇḍavāḷa	<i>noun</i><br><ol><li>cast iron</li></ol>
ತಂಡೆ|tanḍe|ತಂಡೆಯು|ತಂಡೆಗಳಿಗೆ|ತಂಡೆಯಿಂದ|ತಂಡೆಗಳು|ತಂಡೆಯ|ತಂಡೆಗೆ|ತಂಡೆಗಳ|ತಂಡೆಗಳಿಂದ|ತಂಡೆಗಳನ್ನು|ತಂಡೆಯನ್ನು	<i>noun</i><br><ol><li>anklet</li></ol>
ತಂದೆ|ತಂದೆಗಳ|ತಂದೆಗಳಿಂದ|ತಂದೆಗೆ|ತಂದೆಗಳಿಗೆ|ತಂದೆಗಳನ್ನು|ತಂದೆಗಳು|ತಂದೆಯನ್ನು|ತಂದೆಯ|ತಂದೆಯಿಂದ|ತಂದೆಯು|tande	<i>noun</i><br><ol><li>father</li></ol>
ತಟ್ಟೆ|taṭṭe	<i>noun</i><br><ol><li>metal dinnerplate</li><li>a small metal tumbler</li></ol>
ತಡಿಕೆ|taḍike	<i>noun</i><br><ol><li>wattle</li></ol>
ತಡೆ|ತಡೆದುವು|ತಡೆುತ್ತೇವೆ (taḍeುttēve)|ತಡೆಯದು|ತಡೆಯೋಣ|{{{5}}}ಿತು ({{{5}}}ಿtu)|ತಡೆಯು|ತಡೆದೀತು|ತಡೆುತ್ತಾಳೆ (taḍeುttāḷe)|ತಡೆಯರು|ತಡೆಯುವೆ|ತಡೆಯುವೆನು|ತಡೆಯಲು|ತಡೆದಳು|ತಡೆದಿರಿ|ತಡೆಯುವ|ತಡೆಯುವಿರಿ|{ತಡೆಯಿರಿ ({taḍeyiri)|ತಡೆದೆ|ತಡೆಯುವಾ|ತಡೆಯುವುದು|ತಡೆಯುವರು|ತಡೆಯುವಿ|ತಡೆದರೆ|ತಡೆದಾಳು|ತಡೆದೇನು|ತಡೆಯೆ|ತಡೆಯ|ತಡೆದೀಯೆ|ತಡೆುತ್ತೀಯೆ (taḍeುttīye)|ತಡೆಯುವಳು|ತಡೆುತ್ತೇನೆ (taḍeುttēne)|ತಡೆಯದ|ತಡೆಗಳ|ತಡೆುತ್ತದೆ (taḍeುttade)|ತಡೆುತ್ತಾರೆ (taḍeುttāre)|ತಡೆಯನು|ತಡೆದೀರಿ|ತಡೆಯುವೆವು|ತಡೆಗಳಿಂದ|ತಡೆಯಲಿ|ತಡೆದ|ತಡೆದಾವು|taḍe|ತಡೆಗೆ|ತಡೆುತ್ತವೆ (taḍeುttave)|ತಡೆಗಳನ್ನು|ತಡೆುತ್ತಾನೆ (taḍeುttāne)|ತಡೆದಾನು|ತಡೆಯಳು|ತಡೆದಿ|ತಡೆದೇವು|ತಡೆದಾರು|ತಡೆಯದೆ|ತಡೆ}ಯಲಿಕ್ಕೆ (taḍe}yalikke)|ತಡೆಯುತ್ತ|ತಡೆದೆನು|ತಡೆಯನ್ನು|ತಡೆದರು|ತಡೆಗಳು|ತಡೆಯುವನು|ತಡೆಯುವುವು|ತಡೆುತ್ತೀ (taḍeುttī)|ತಡೆದೆವು|ತಡೆಗಳಿಗೆ|ತಡೆಯಯುವೆ|ತಡೆದನು|ತಡೆಯೆನು|ತಡೆಯೆವು|ತಡೆಯವು|ತಡೆಯಿಂದ|ತಡೆುತ್ತೀರಿ (taḍeುttīri)|ತಡೆಯರಿ	<i>noun</i><br><ol><li>obstacle, hindrance, block</li><li>injunction</li><li>delay</li></ol><br><i>verb</i><br><ol><li>to obstruct, stop</li><li>to tolerate, bear, stand</li><li>to wait</li></ol>
ತತ್ಕ್ಷಣ|tatkṣaṇa	<i>adv</i><br><ol><li>immediately, instantaneously</li></ol>
ತನುವು|tanuvu	<i>noun</i><br><ol><li>(poetic, literary) the body</li></ol>
ತಮ|tama	<i>noun</i><br><ol><li>(poetic, literary) darkness; (by extension) ignorance</li></ol>
ತಮಸ್ಸು|tamassu	<i>noun</i><br><ol><li>(literary, poetic) darkness</li></ol>
ತಲಪು|talapu	<i>verb</i><br><ol><li>arrive, reach</li></ol>
ತಲೆ|ತಲೆಗಳ|ತಲೆಗೆ|ತಲೆಯನ್ನು|ತಲೆಗಳು|ತಲೆಯು|ತಲೆಯಿಂದ|tale|ತಲೆಗಳಿಂದ|ತಲೆಗಳನ್ನು|ತಲೆಗಳಿಗೆ|ತಲೆಯ	<i>noun</i><br><ol><li>head of the body</li></ol>
ತವರ|tavara	<i>noun</i><br><ol><li>tin</li></ol>
ತಾಕೀತು|tākītu	<i>noun</i><br><ol><li>order, decree (issued by a government or higher officer to an employee)</li><li>warning someone not to do some offence again</li></ol>
ತಾಯಿ|ತಾಯಿಗಳಿಗೆ|ತಾಯಿಗೆ|ತಾಯಿಗಳು|ತಾಯಿಯು|ತಾಯಿಯ|ತಾಯಿಗಳ|ತಾಯಿಗಳನ್ನು|ತಾಯಿಗಳಿಂದ|tāyi|ತಾಯಿಯನ್ನು|ತಾಯಿಯಿಂದ	<i>noun</i><br><ol><li>a mother</li></ol>
ತಾರೆ|tāre	<i>noun</i><br><ol><li>(literary) a star</li></ol>
ತಾವರೆ|tāvare	<i>noun</i><br><ol><li>lotus</li></ol>
ತಿ|ti	<i>character</i><br><ol><li>The Kannada letter ti.</li></ol>
ತಿಂಗಳು|ತಿಂಗಳುಗಳು|ತಿಂಗಳುಗಳಿಂದ|ತಿಂಗಳಿನ|ತಿಂಗಳುಗಳ|ತಿಂಗಳುಗಳನ್ನು|ತಿಂಗಳಿಗೆ|ತಿಂಗಳಿನಿಂದ|tiṅgaḷu|ತಿಂಗಳುಗಳಿಗೆ|ತಿಂಗಳನ್ನು	<i>noun</i><br><ol><li>a month</li><li>(rare) the moon</li></ol>
ತಿನ್ನಿಸು|tinnisu	<i>verb</i><br><ol><li>to cause to eat, feed</li></ol>
ತಿನ್ನು|tinnu	<i>verb</i><br><ol><li>to eat</li></ol>
ತು|tu	<i>character</i><br><ol><li>The Kannada letter tu.</li></ol>
ತುಕ್ಕು|tukku	<i>noun</i><br><ol><li>rust</li></ol>
ತುಟಿ|ತುಟಿಗೆ|tuṭi|ತುಟಿಯು|ತುಟಿಯಿಂದ|ತುಟಿಗಳಿಂದ|ತುಟಿಯ|ತುಟಿಗಳಿಗೆ|ತುಟಿಗಳು|ತುಟಿಯನ್ನು|ತುಟಿಗಳನ್ನು|ತುಟಿಗಳ	<i>noun</i><br><ol><li>lip of the body</li></ol>
ತುತ್ತೂರಿ|ತುತ್ತೂರಿಗಳು|ತುತ್ತೂರಿಯ|ತುತ್ತೂರಿಗಳ|ತುತ್ತೂರಿಯನ್ನು|ತುತ್ತೂರಿಯಿಂದ|tuttūri|ತುತ್ತೂರಿಗಳನ್ನು|ತುತ್ತೂರಿಗಳಿಗೆ|ತುತ್ತೂರಿಗಳಿಂದ|ತುತ್ತೂರಿಗೆ|ತುತ್ತೂರಿಯು	<i>noun</i><br><ol><li>bugle</li></ol>
ತುಪ್ಪ|tuppa	<i>noun</i><br><ol><li>ghee</li></ol>
ತುಫಾನು|tuphānu	<i>noun</i><br><ol><li>(meteorology) tornado</li></ol>
ತುರುಕ|turuka	<i>name</i><br><ol><li>Turk, Turkish, Turkey</li><li>Muslim</li></ol>
ತುರ್ತು|turtu	<i>noun</i><br><ol><li>emergency</li></ol>
ತೃಣ|tṛṇa	<i>noun</i><br><ol><li>grass</li></ol>
ತೃಪ್ತ|tṛpta	<i>adj</i><br><ol><li>satisfied, satiated</li></ol>
ತೃಪ್ತಿ|tṛpti	<i>noun</i><br><ol><li>satisfaction, contentment</li></ol>
ತೃಷ್ಣೆ|tṛṣṇe	<i>noun</i><br><ol><li>(literary) desire, longing</li></ol>
ತೆ|te	<i>character</i><br><ol><li>The Kannada letter te.</li></ol>
ತೆಂಕಣ|teṅkaṇa	<i>noun</i><br><ol><li>south</li></ol><br><i>adj</i><br><ol><li>southern</li></ol>
ತೆರಿಗೆ|terige	<i>noun</i><br><ol><li>tax, duty, excise, tariff, impost, toll</li></ol>
ತೆಲುಗು|telugu	<i>name</i><br><ol><li>Telugu (language)</li></ol>
ತೆಲ್ಲ|tella	<i>noun</i><br><ol><li>sesamum oil; edible oil</li></ol>
ತೇರು|tēru	<i>noun</i><br><ol><li>a chariot</li></ol>
ತೊಂದರೆ|tondare	<i>noun</i><br><ol><li>difficulty, problem</li></ol>
ತೊಂನು|toṅnu	<i>noun</i><br><ol><li>(medicine) leprosy</li></ol>
ತೊಗಲು|togalu	<i>noun</i><br><ol><li>skin</li></ol>
ತೊಡೆ|ತೊಡೆಗಳಿಂದ|ತೊಡೆಗಳನ್ನು|ತೊಡೆಯಿಂದ|ತೊಡೆಗಳು|ತೊಡೆಯ|toḍe|ತೊಡೆಗಳ|ತೊಡೆಗೆ|ತೊಡೆಗಳಿಗೆ|ತೊಡೆಯನ್ನು|ತೊಡೆಯು	<i>noun</i><br><ol><li>thigh</li></ol>
ತೊಪ್ಪಿಗೆ|toppige	<i>noun</i><br><ol><li>hat, cap</li></ol>
ತೊಳೆ|ತೊಳೆದೆನು|ತೊಳೆದಾಳು|ತೊಳೆದೀತು|ತೊಳೆುತ್ತೀಯೆ (toḷeುttīye)|ತೊಳೆಯೆ|ತೊಳೆಯರು|ತೊಳೆಯುವೆವು|ತೊಳೆಯದು|ತೊಳೆಯವು|ತೊಳೆಯೆನು|ತೊಳೆದಾವು|{ತೊಳೆಯಿರಿ ({toḷeyiri)|ತೊಳೆಯದೆ|ತೊಳೆದನು|ತೊಳೆದರು|ತೊಳೆಯಳು|ತೊಳೆ}ಯಲಿಕ್ಕೆ (toḷe}yalikke)|ತೊಳೆಯುವ|ತೊಳೆಯುವರು|ತೊಳೆದೀಯೆ|ತೊಳೆುತ್ತಾರೆ (toḷeುttāre)|ತೊಳೆದಿರಿ|ತೊಳೆಯೆವು|ತೊಳೆಯುವಾ|ತೊಳೆಯುವುವು|ತೊಳೆದಾನು|ತೊಳೆುತ್ತೀ (toḷeುttī)|ತೊಳೆಯುವೆ|ತೊಳೆಯ|ತೊಳೆಯುವುದು|ತೊಳೆದೇವು|ತೊಳೆಯಯುವೆ|ತೊಳೆಯನು|ತೊಳೆಯರಿ|ತೊಳೆದುವು|ತೊಳೆಯದ|ತೊಳೆಯೋಣ|ತೊಳೆದೆವು|ತೊಳೆಯಲಿ|ತೊಳೆದ|ತೊಳೆುತ್ತದೆ (toḷeುttade)|ತೊಳೆುತ್ತವೆ (toḷeುttave)|ತೊಳೆುತ್ತಾಳೆ (toḷeುttāḷe)|ತೊಳೆದೀರಿ|ತೊಳೆಯಲು|ತೊಳೆುತ್ತಾನೆ (toḷeುttāne)|ತೊಳೆುತ್ತೀರಿ (toḷeುttīri)|ತೊಳೆದೆ|ತೊಳೆದಳು|ತೊಳೆದಾರು|ತೊಳೆಯುವೆನು|ತೊಳೆುತ್ತೇನೆ (toḷeುttēne)|ತೊಳೆುತ್ತೇವೆ (toḷeುttēve)|ತೊಳೆದಿ|ತೊಳೆಯುವಿ|ತೊಳೆಯುತ್ತ|ತೊಳೆಯುವಳು|ತೊಳೆಯಿತುಿತು (toḷeyituಿtu)|ತೊಳೆದರೆ|ತೊಳೆಯುವಿರಿ|ತೊಳೆದೇನು|toḷe|ತೊಳೆಯುವನು	<i>verb</i><br><ol><li>To wash</li></ol>
ತೋಟ|tōṭa	<i>noun</i><br><ol><li>garden, farm, orchard, plantation</li></ol>
ತೋಪು|tōpu	<i>noun</i><br><ol><li>cannon</li></ol>
ತೋಳ|tōḷa	<i>noun</i><br><ol><li>the Indian wolf; Canis lupus pallipes</li></ol>
ತ್ಯಜಿಸು|tyajisu	<i>verb</i><br><ol><li>to abandon, give up, discard</li></ol>
ತ್ಯಾಗ|tyāga	<i>noun</i><br><ol><li>renunciation, giving up</li><li>sacrifice</li></ol>
ತ್ವಚೆ|tvace	<i>noun</i><br><ol><li>skin</li></ol>
ಥ|tha	<i>character</i><br><ol><li>The Kannada letter tha.</li></ol>
ದ|da	<i>character</i><br><ol><li>The Kannada letter da.</li></ol>
ದಂಡ|daṇḍa	<i>noun</i><br><ol><li>fine, penalty</li></ol>
ದಂತ|danta	<i>noun</i><br><ol><li>tusk</li></ol>
ದಂತವರ್ಣ|dantavarṇa	<i>noun</i><br><ol><li>ivory</li></ol>
ದಯವಿಟ್ಟು|dayaviṭṭu	<i>adv</i><br><ol><li>please</li></ol>
ದಶಮ|daśama	<i>adj</i><br><ol><li>(literary) tenth</li></ol>
ದಹಿಸು|dahisu	<i>verb</i><br><ol><li>(rare, literary) to burn, scorch</li><li>to cremate</li></ol>
ದಾಟು|ದಾಟುವೆವು|ದಾಟುವಿರಿ|ದಾಟುವೆ|ದಾಟೋಣ|ದಾಟುತ್ತೇವೆ|ದಾಟುತ್ತಾರೆ|ದಾಟಿದಿ|ದಾಟುವುವು|ದಾಟಿಯಾನು|ದಾಟೆ|ದಾಟಿ|ದಾಟುವಾ|ದಾಟಿತು|ದಾಟೆನು|ದಾಟನು|ದಾಟಿಯಾವು|ದಾಟಿದೆನು|ದಾಟಿೀಯೆ|ದಾಟುತ್ತವೆ|ದಾಟಿರಿ|dāṭu|ದಾಟಿದೆ|ದಾಟೀರಿ|ದಾಟುವ|ದಾಟಲಿಕ್ಕೆ|ದಾಟಿದರು|ದಾಟುತ್ತೀ|ದಾಟಿದಿರಿ|ದಾಟವು|ದಾಟಿಯಾಳು|ದಾಟಿದೆವು|ದಾಟುವನು|ದಾಟದೆ|ದಾಟದು|ದಾಟದ|ದಾಟರು|ದಾಟುತ್ತ|ದಾಟುವೆನು|ದಾಟುತ್ತೇನೆ|ದಾಟಿದರೆ|ದಾಟುತ್ತಾಳೆ|ದಾಟುವಳು|ದಾಟಿದ|ದಾಟೀತು|ದಾಟಿದಳು|ದಾಟುತ್ತದೆ|ದಾಟಳು|ದಾಟಿಯೇವು|ದಾಟುತ್ತೀಯೆ|ದಾಟುವರು|ದಾಟಿಯಾರು|ದಾಟುತ್ತಾನೆ|ದಾಟಿದುವು|ದಾಟೆವು|ದಾಟುವಿ|ದಾಟಲಿ|ದಾಟುವುದು|ದಾಟರಿ|ದಾಟಲು|ದಾಟಿದನು|ದಾಟಿಯೇನು|ದಾಟುತ್ತೀರಿ	<i>verb</i><br><ol><li>To cross, overcome, transgress</li></ol>
ದಾಡಿ|dāḍi	<i>noun</i><br><ol><li>(anatomy) chin, jaw</li><li>beard</li></ol>
ದಿ|di	<i>character</i><br><ol><li>The Kannada letter di.</li></ol>
ದಿಕ್ಕು|dikku	<i>noun</i><br><ol><li>direction</li></ol>
ದಿನ|dina	<i>noun</i><br><ol><li>day</li></ol>
ದಿನಪತ್ರಿಕೆ|dinapatrike	<i>noun</i><br><ol><li>journal</li></ol>
ದಿನಾಂಕ|dināṅka	<i>noun</i><br><ol><li>calendar date</li></ol>
ದಿನೇ ದಿನೇ|dinē dinē	<i>adv</i><br><ol><li>day by day</li></ol>
ದಿವಸ|divasa	<i>noun</i><br><ol><li>day</li></ol>
ದಿವ್ಯ|divya	<i>adj</i><br><ol><li>divine, heavenly</li></ol>
ದೀಪಾವಳಿ|dīpāvaḷi	<i>name</i><br><ol><li>(Hinduism) Diwali</li></ol>
ದೀರ್ಘ|dīrgha	<i>adj</i><br><ol><li>long, of much duration</li><li>(grammar, of a vowel) long</li></ol>
ದುಕಾನು|dukānu	<i>noun</i><br><ol><li>shop</li></ol>
ದುಗ್ಧ|dugdha	<i>noun</i><br><ol><li>(rare, literary) milk</li></ol>
ದುಷ್ಠ|duṣṭha	<i>noun</i><br><ol><li>evil person</li></ol><br><i>adj</i><br><ol><li>evil, bad</li></ol>
ದುಹಿತೆ|duhite	<i>noun</i><br><ol><li>(rare, literary, poetic) a daughter</li></ol>
ದೂತ|dūta	<i>noun</i><br><ol><li>a messenger</li></ol>
ದೂರ|dūra	<i>adj</i><br><ol><li>far, distant</li></ol>
ದೂರದರ್ಶನ|dūradarśana|ದೂರದರ್ಶನಗಳ|ದೂರದರ್ಶನಕ್ಕೆ|ದೂರದರ್ಶನಗಳಿಂದ|ದೂರದರ್ಶನವನ್ನು|ದೂರದರ್ಶನದ|ದೂರದರ್ಶನಗಳಿಗೆ|ದೂರದರ್ಶನವು|ದೂರದರ್ಶನದಿಂದ|ದೂರದರ್ಶನಗಳನ್ನು|ದೂರದರ್ಶನಗಳು	<i>noun</i><br><ol><li>television</li></ol>
ದೂರ್ವೆ|dūrve	<i>noun</i><br><ol><li>holy grass offered to Ganesha</li></ol>
ದೃಗ್ಗಣಿತ|dṛggaṇita	<i>noun</i><br><ol><li>"sight-calculation" - an Indian system of astronomical calculations</li></ol>
ದೃಢ|dṛḍha	<i>adj</i><br><ol><li>staunch, steadfast, sure</li><li>tough, constant, strong</li></ol>
ದೃಷ್ಟಿ|dṛṣṭi	<i>noun</i><br><ol><li>vision, sight</li></ol>
ದೇವ|ದೇವನಿಂದ|ದೇವನು|ದೇವರನ್ನು|ದೇವರಿಗೆ|ದೇವನ|ದೇವರು|ದೇವರ|ದೇವರಿಂದ|ದೇವನನ್ನು|ದೇವನಿಗೆ|dēva	<i>noun</i><br><ol><li>god, deity</li></ol>
ದೇವಿ|dēvi	<i>noun</i><br><ol><li>goddess</li></ol>
ದೇಶ|dēśa	<i>noun</i><br><ol><li>country</li></ol>
ದೇಹ|dēha	<i>noun</i><br><ol><li>body</li></ol>
ದೈತ್ಯ|daitya	<i>noun</i><br><ol><li>monster</li></ol>
ದೊಡ್ಡ|doḍḍa	<i>adj</i><br><ol><li>big, large, great, significant</li></ol>
ದೊನ್ನೆ|donne	<i>noun</i><br><ol><li>a cup or bowl made of leaves used for holding offerings during rituals</li></ol>
ದೋಸೆ|dōse	<i>noun</i><br><ol><li>dosa; a type of thin south Indian food made from fermented lentils and rice blended with water, typically served with chutney or sambar.</li></ol>
ದ್ಯುತಿಸಂಶ್ಲೇಷಿಸು|ದ್ಯುತಿಸಂಶ್ಲೇಷಿಸುುವಾ|ದ್ಯುತಿಸಂಶ್ಲೇಷಿಸುೋಣ|ದ್ಯುತಿಸಂಶ್ಲೇಷಿಸುೆನು|ದ್ಯುತಿಸಂಶ್ಲೇಷಿಸುುವೆನು|ದ್ಯುತಿಸಂಶ್ಲೇಷಿಸುಿರಿ|ದ್ಯುತಿಸಂಶ್ಲೇಷಿಸುೆ|ದ್ಯುತಿಸಂಶ್ಲೇಷಿಸುದೆ|ದ್ಯುತಿಸಂಶ್ಲೇಷಿಸ|ದ್ಯುತಿಸಂಶ್ಲೇಷಿಸಿದೆವು|ದ್ಯುತಿಸಂಶ್ಲೇಷಿಸುುವಳು|ದ್ಯುತಿಸಂಶ್ಲೇಷಿಸುಿಯಾಳು|ದ್ಯುತಿಸಂಶ್ಲೇಷಿಸಿದುವು|ದ್ಯುತಿಸಂಶ್ಲೇಷಿಸುನು|ದ್ಯುತಿಸಂಶ್ಲೇಷಿಸುುವುದು|ದ್ಯುತಿಸಂಶ್ಲೇಷಿಸಯೇನು|ದ್ಯುತಿಸಂಶ್ಲೇಷಿಸುಿಯಾರು|ದ್ಯುತಿಸಂಶ್ಲೇಷಿಸಿದಳು|ದ್ಯುತಿಸಂಶ್ಲೇಷಿಸುುವೆವು|ದ್ಯುತಿಸಂಶ್ಲೇಷಿಸುಳು|ದ್ಯುತಿಸಂಶ್ಲೇಷಿಸಿದಿ|ದ್ಯುತಿಸಂಶ್ಲೇಷಿಸಿದ|ದ್ಯುತಿಸಂಶ್ಲೇಷಿಸೀಯೆ|ದ್ಯುತಿಸಂಶ್ಲೇಷಿಸತು|ದ್ಯುತಿಸಂಶ್ಲೇಷಿಸುುತ್ತೇನೆ|dyutisaṃślēṣisu|ದ್ಯುತಿಸಂಶ್ಲೇಷಿಸುುವರು|ದ್ಯುತಿಸಂಶ್ಲೇಷಿಸುುತ್ತೀ|ದ್ಯುತಿಸಂಶ್ಲೇಷಿಸುುವೆ|ದ್ಯುತಿಸಂಶ್ಲೇಷಿಸುದು|ದ್ಯುತಿಸಂಶ್ಲೇಷಿಸುಿಯಾನು|ದ್ಯುತಿಸಂಶ್ಲೇಷಿಸುಲು|ದ್ಯುತಿಸಂಶ್ಲೇಷಿಸುುತ್ತೀಯೆ|ದ್ಯುತಿಸಂಶ್ಲೇಷಿಸಿದೆನು|ದ್ಯುತಿಸಂಶ್ಲೇಷಿಸುುತ್ತವೆ|ದ್ಯುತಿಸಂಶ್ಲೇಷಿಸಿದರು|ದ್ಯುತಿಸಂಶ್ಲೇಷಿಸಿದನು|ದ್ಯುತಿಸಂಶ್ಲೇಷಿಸುುವಿ|ದ್ಯುತಿಸಂಶ್ಲೇಷಿಸುೀರಿ|ದ್ಯುತಿಸಂಶ್ಲೇಷಿಸುುತ್ತೇವೆ|ದ್ಯುತಿಸಂಶ್ಲೇಷಿಸುುತ್ತೀರಿ|ದ್ಯುತಿಸಂಶ್ಲೇಷಿಸುಲಿಕ್ಕೆ|ದ್ಯುತಿಸಂಶ್ಲೇಷಿಸುುತ್ತಾರೆ|ದ್ಯುತಿಸಂಶ್ಲೇಷಿಸುವು|ದ್ಯುತಿಸಂಶ್ಲೇಷಿಸುಿಯಾವು|ದ್ಯುತಿಸಂಶ್ಲೇಷಿಸುದ|ದ್ಯುತಿಸಂಶ್ಲೇಷಿಸುೆವು|ದ್ಯುತಿಸಂಶ್ಲೇಷಿಸುೀತು|ದ್ಯುತಿಸಂಶ್ಲೇಷಿಸುಲಿ|ದ್ಯುತಿಸಂಶ್ಲೇಷಿಸುುತ್ತದೆ|ದ್ಯುತಿಸಂಶ್ಲೇಷಿಸುುತ್ತಾನೆ|ದ್ಯುತಿಸಂಶ್ಲೇಷಿಸುರು|ದ್ಯುತಿಸಂಶ್ಲೇಷಿಸುುತ್ತ|ದ್ಯುತಿಸಂಶ್ಲೇಷಿಸುುವುವು|ದ್ಯುತಿಸಂಶ್ಲೇಷಿಸಿದೆ|ದ್ಯುತಿಸಂಶ್ಲೇಷಿಸುುವನು|ದ್ಯುತಿಸಂಶ್ಲೇಷಿಸುುತ್ತಾಳೆ|ದ್ಯುತಿಸಂಶ್ಲೇಷಿಸುುವಿರಿ|ದ್ಯುತಿಸಂಶ್ಲೇಷಿಸಿದಿರಿ|ದ್ಯುತಿಸಂಶ್ಲೇಷಿಸುಿಯೇವು|ದ್ಯುತಿಸಂಶ್ಲೇಷಿಸುುವ|ದ್ಯುತಿಸಂಶ್ಲೇಷಿಸುರಿ|ದ್ಯುತಿಸಂಶ್ಲೇಷಿಸುು|ದ್ಯುತಿಸಂಶ್ಲೇಷಿಸಿದರೆ	<i>verb</i><br><ol><li>To photosynthesize</li></ol>
ದ್ಯೂತ|dyūta	<i>noun</i><br><ol><li>(literary, formal) gambling</li></ol>
ದ್ರಾಕ್ಷಿ|drākṣi	<i>noun</i><br><ol><li>grape</li></ol>
ದ್ರೋಹ|drōha	<i>noun</i><br><ol><li>betrayal, treachery, infidelity, breaking of trust</li></ol>
ದ್ವೀಪ|dvīpa	<i>noun</i><br><ol><li>island</li></ol>
ದ್ವೇಷ|dvēṣa	<i>noun</i><br><ol><li>hatred, enmity</li></ol>
ಧ|dha	<i>character</i><br><ol><li>The Kannada letter dha.</li></ol>
ಧನ|dhana	<i>noun</i><br><ol><li>wealth, money</li></ol>
ಧನುಸ್ಸು|dhanussu	<i>noun</i><br><ol><li>a bow</li></ol>
ಧನ್ಯವಾದ|dhanyavāda	<i>intj</i><br><ol><li>thanks, thank you</li></ol>
ಧಬಧಬೆ|dhabadhabe	<i>noun</i><br><ol><li>(geography) waterfall</li></ol>
ಧೂಮಕೇತು|dhūmakētu	<i>noun</i><br><ol><li>(astronomy) comet</li></ol>
ಧೈರ್ಯ|dhairya	<i>noun</i><br><ol><li>courage</li></ol>
ಧೊಬಿ ಘಔತ್|dhūbi ghaut	<i>name</i><br><ol><li>Dhoby Ghaut</li></ol>
ಧ್ಯಾನ|dhyāna	<i>noun</i><br><ol><li>meditation</li></ol>
ಧ್ವನಿ|dhvani	<i>noun</i><br><ol><li>voice</li></ol>
ನ|na	<i>character</i><br><ol><li>The Kannada letter na.</li></ol>
ನಂಜು|naṃju	<i>noun</i><br><ol><li>poison</li></ol>
ನಕ್ಷತ್ರ|nakṣatra	<i>noun</i><br><ol><li>star</li><li>constellation</li></ol>
ನಗರ|nagara	<i>noun</i><br><ol><li>city</li></ol>
ನಗು|nagu	<i>verb</i><br><ol><li>to laugh</li></ol><br><i>noun</i><br><ol><li>laughter</li></ol>
ನಟ|naṭa	<i>noun</i><br><ol><li>actor</li></ol>
ನಟಿ|naṭi	<i>noun</i><br><ol><li>actress</li></ol>
ನಡತೆ|naḍate	<i>noun</i><br><ol><li>disposition, character, demeanor</li><li>deportment</li><li>conduct</li></ol>
ನಡೆ|ನಡೆುತ್ತ (naḍeುtta)|ನಡೆದಿರಿ|ನಡೆುವಳು (naḍeುvaḷu)|ನಡೆುವೆವು (naḍeುvevu)|ನಡೆಿಯಾರು (naḍeಿyāru)|naḍe|ನಡೆುತ್ತಾನೆ (naḍeುttāne)|ನಡೆುವೆ (naḍeುve)|ನಡೆರು|ನಡೆುತ್ತವೆ (naḍeುttave)|ನಡೆುವನು (naḍeುvanu)|ನಡೆೆ (naḍeೆ)|ನಡೆನು|ನಡೆುವುವು (naḍeುvuvu)|ನಡೆದೆವು|ನಡೆಯೀಯೆ|ನಡೆುತ್ತದೆ (naḍeುttade)|ನಡೆಲಿಕ್ಕೆ|ನಡೆೋಣ (naḍeೋṇa)|ನಡೆಿಯೇವು (naḍeಿyēvu)|ನಡೆದೆನು|ನಡೆದರು|ನಡೆದು|ನಡೆೀರಿ (naḍeೀri)|ನಡೆದಿ|ನಡೆಿಯಾವು (naḍeಿyāvu)|ನಡೆುತ್ತೇವೆ (naḍeುttēve)|ನಡೆೆನು (naḍeೆnu)|ನಡೆುತ್ತೇನೆ (naḍeುttēne)|ನಡೆುವ (naḍeುva)|ನಡೆು (naḍeು)|ನಡೆವು|ನಡೆಿರಿ (naḍeಿri)|ನಡೆದನು|ನಡೆರಿ|ನಡೆುವರು (naḍeುvaru)|ನಡೆಯ|ನಡೆೀತು (naḍeೀtu)|ನಡೆದುವು|ನಡೆದ|ನಡೆದೆ|ನಡೆಯಯೇನು|ನಡೆಿಯಾನು (naḍeಿyānu)|ನಡೆಿಯಾಳು (naḍeಿyāḷu)|ನಡೆಯತು|ನಡೆಲಿ|ನಡೆುವಾ (naḍeುvā)|ನಡೆುವುದು (naḍeುvudu)|ನಡೆುತ್ತಾರೆ (naḍeುttāre)|ನಡೆದಳು|ನಡೆಳು|ನಡೆುತ್ತೀರಿ (naḍeುttīri)|ನಡೆುವೆನು (naḍeುvenu)|ನಡೆೆವು (naḍeೆvu)|ನಡೆದರೆ|ನಡೆುತ್ತಾಳೆ (naḍeುttāḷe)|ನಡೆಲು|ನಡೆುತ್ತೀ (naḍeುttī)|ನಡೆುವಿ (naḍeುvi)|ನಡೆುತ್ತೀಯೆ (naḍeುttīye)|ನಡೆುವಿರಿ (naḍeುviri)	<i>noun</i><br><ol><li>walking, gait</li><li>behavior</li></ol><br><i>verb</i><br><ol><li>to walk</li><li>to behave</li><li>to go on, proceed, continue</li></ol>
ನದಿ|ನದಿಯಿಂದ|ನದಿಗಳಿಂದ|ನದಿಗಳ|ನದಿಯು|ನದಿಗಳಿಗೆ|ನದಿಯನ್ನು|ನದಿಯ|ನದಿಗಳನ್ನು|ನದಿಗೆ|nadi|ನದಿಗಳು	<i>noun</i><br><ol><li>(geography) river</li></ol>
ನನಸು|ನನಸಿನಿಂದ|ನನಸುಗಳ|ನನಸಿನ|ನನಸುಗಳಿಂದ|ನನಸುಗಳು|ನನಸಿಗೆ|ನನಸನ್ನು|nanasu|ನನಸುಗಳಿಗೆ|ನನಸುಗಳನ್ನು	<i>noun</i><br><ol><li>truth</li></ol>
ನನ್ನಿ|nanni	<i>noun</i><br><ol><li>truth</li></ol>
ನಪುಂಸಕ|napuṃsaka	<i>noun</i><br><ol><li>a eunuch</li><li>an impotent or effeminate man</li><li>(grammar) neuter gender</li></ol><br><i>adj</i><br><ol><li>weak, effeminate, ineffective</li><li>(grammar) neuter</li></ol>
ನಭ|nabha	<i>noun</i><br><ol><li>(rare, literary) sky, atmosphere</li></ol>
ನಮ್ರ|namra	<i>adj</i><br><ol><li>humble, docile, submissive, meek</li></ol>
ನರ|nara	<i>noun</i><br><ol><li>nerve</li><li>(literary) a man</li></ol><br><i>adj</i><br><ol><li>male</li></ol>
ನರಿ|nari	<i>noun</i><br><ol><li>fox</li><li>jackal</li></ol>
ನವಮ|navama	<i>adj</i><br><ol><li>(literary) ninth</li></ol>
ನವಿರು|naviru	<i>noun</i><br><ol><li>hair</li></ol>
ನವಿಲು|navilu	<i>noun</i><br><ol><li>peacock</li></ol>
ನವೀನ|navīna	<i>adj</i><br><ol><li>new, fresh</li></ol>
ನಶೆ|naśe	<i>noun</i><br><ol><li>intoxication</li></ol>
ನಸುಡಿ|nasuḍi	<i>noun</i><br><ol><li>forehead</li></ol>
ನಾಗ|nāga	<i>noun</i><br><ol><li>snake</li></ol>
ನಾಡು|nāḍu	<i>noun</i><br><ol><li>land</li></ol>
ನಾನು|ನಮ್ಮದೆಸೆಯಿಂದ|ನಮ್ಮ|nānu|ನನ್ನನ್ನು|ನಮ್ಮಿಂದ|ನಮ್ಮನ್ನು|ನನ್ನದೆಸೆಯಿಂದ|ನಾವು|ನಮ್ಮಲ್ಲಿ|ನಮಗೆ|nāvu|ನನಗೆ|ನನ್ನ|ನನ್ನಲ್ಲಿ|ನನ್ನಿಂದ	<i>pron</i><br><ol><li>I</li></ol>
ನಾಮಪದ|ನಾಮಪದಗಳನ್ನು|ನಾಮಪದವನ್ನು|ನಾಮಪದವು|nāmapada|ನಾಮಪದಕ್ಕೆ|ನಾಮಪದದಿಂದ|ನಾಮಪದಗಳಿಂದ|ನಾಮಪದಗಳು|ನಾಮಪದಗಳ|ನಾಮಪದಗಳಿಗೆ|ನಾಮಪದದ	<i>noun</i><br><ol><li>(grammar) noun</li></ol>
ನಾಯಿ|nāyi|ನಾಯಿಗಳಿಂದ|ನಾಯಿಗಳಿಗೆ|ನಾಯಿಗೆ|ನಾಯಿಯನ್ನು|ನಾಯಿಯಿಂದ|ನಾಯಿಯ|ನಾಯಿಯು|ನಾಯಿಗಳು|ನಾಯಿಗಳ|ನಾಯಿಗಳನ್ನು	<i>noun</i><br><ol><li>dog</li></ol>
ನಾರಾಯಣ|nārāyaṇa	<i>name</i><br><ol><li>(Hinduism) a name of Vishnu</li></ol>
ನಾರಿ|nāri	<i>noun</i><br><ol><li>(formal) a woman</li></ol>
ನಾಲಿಗೆ|nālige	<i>noun</i><br><ol><li>tongue</li></ol>
ನಾಲ್ಕು|nālku	<i>num</i><br><ol><li>four (numeral: ೪ (4))</li></ol>
ನಾಳು|ನಾಳುಗಳಿಂದ|ನಾಳಿಗೆ|ನಾಳಿನ|ನಾಳುಗಳ|ನಾಳುಗಳನ್ನು|nāḷu|ನಾಳಿನಿಂದ|ನಾಳುಗಳಿಗೆ|ನಾಳುಗಳು|ನಾಳನ್ನು	<i>noun</i><br><ol><li>day</li></ol>
ನಾಳೆ|nāḷe	<i>adv</i><br><ol><li>tomorrow</li></ol>
ನಾವು|nāvu	<i>pron</i><br><ol><li>we</li></ol>
ನಾಶ|nāśa	<i>noun</i><br><ol><li>destruction, ruin</li></ol>
ನಾಷ್ಟಾ|nāṣṭā	<i>noun</i><br><ol><li>breakfast</li></ol>
ನಿ|ni	<i>character</i><br><ol><li>The Kannada letter ni.</li></ol>
ನಿಘಂಟು|nighaṇṭu	<i>noun</i><br><ol><li>dictionary</li></ol>
ನಿದ್ದೆ|nidde	<i>noun</i><br><ol><li>sleep, slumber</li></ol>
ನಿದ್ರೆ|nidre	<i>noun</i><br><ol><li>sleep, slumber</li></ol>
ನಿಧಿ|nidhi	<i>noun</i><br><ol><li>treasure, hoard</li></ol>
ನಿಮಿಷ|nimiṣa	<i>noun</i><br><ol><li>minute</li></ol>
ನಿಯತಕಾಲಿಕ|niyatakālika	<i>noun</i><br><ol><li>review, magazine</li></ol>
ನಿಯಮ|ನಿಯಮಗಳ|ನಿಯಮದಿಂದ|ನಿಯಮಕ್ಕೆ|ನಿಯಮಗಳಿಗೆ|ನಿಯಮವನ್ನು|ನಿಯಮಗಳನ್ನು|ನಿಯಮಗಳು|ನಿಯಮಗಳಿಂದ|ನಿಯಮವು|niyama|ನಿಯಮದ	<i>noun</i><br><ol><li>rule, law, restraint, regulation</li></ol>
ನಿರಭ್ರ|nirabhra	<i>adj</i><br><ol><li>(of the sky) cloudless</li><li>(figuratively) clean, spotless, pure</li></ol>
ನಿರ್ಗಮನ|nirgamana	<i>noun</i><br><ol><li>exit, egress</li></ol>
ನಿಲುಗಡೆ|nilugaḍe	<i>noun</i><br><ol><li>stop, cessation</li></ol>
ನಿಲ್ದಾಣ|nildāṇa	<i>noun</i><br><ol><li>station</li></ol>
ನಿಲ್ಲು|nillu	<i>verb</i><br><ol><li>(intransitive) to stand</li><li>(intransitive) to stop, halt</li><li>(intransitive) to cease</li></ol>
ನೀನು|ನಿಮಗೆ|ನಿನ್ನ|ನಿಮ್ಮಲ್ಲಿ|ನಿಮ್ಮಿಂದ|ನಿನಗೆ|ನಿಮ್ಮನ್ನು|ನಿಮ್ಮ|ನಿನ್ನದೆಸೆಯಿಂದ|ನೀವು|nīvu|ನಿನ್ನಲ್ಲಿ|ನಿನ್ನಿಂದ|ನಿನ್ನನ್ನು|ನಿಮ್ಮದೆಸೆಯಿಂದ|nīnu	<i>pron</i><br><ol><li>you (singular)</li></ol>
ನೀರಿನ ಬೀಳು|nīrina bīḷu	<i>noun</i><br><ol><li>(geography) waterfall</li></ol>
ನೀರು|ನೀರನ್ನು|ನೀರುಗಳ|ನೀರುಗಳನ್ನು|nīru|ನೀರಿಗೆ|ನೀರುಗಳಿಗೆ|ನೀರುಗಳು|ನೀರುಗಳಿಂದ|ನೀರಿನಿಂದ|ನೀರಿನ	<i>noun</i><br><ol><li>water</li></ol>
ನೀವು|nīvu	<i>pron</i><br><ol><li>you (plural)</li></ol>
ನು|nu	<i>character</i><br><ol><li>The Kannada letter nu.</li></ol>
ನುಡಿ|nuḍi	<i>noun</i><br><ol><li>language</li><li>(grammar) sentence</li><li>(grammar) word</li><li>saying</li><li>promise</li></ol><br><i>verb</i><br><ol><li>to say</li><li>to tell</li><li>to speak</li></ol>
ನೂರು|nūru	<i>num</i><br><ol><li>hundred</li></ol>
ನೆ|ne	<i>character</i><br><ol><li>The Kannada letter ne.</li></ol>
ನೆತ್ತರು|nettaru	<i>noun</i><br><ol><li>(rare, obsolete) blood</li></ol>
ನೆಮ್ಮದಿ|ನೆಮ್ಮದಿಯಿಂದ|ನೆಮ್ಮದಿಯನ್ನು|ನೆಮ್ಮದಿಯ|ನೆಮ್ಮದಿಯು|ನೆಮ್ಮದಿಗೆ|ನೆಮ್ಮದಿಗಳನ್ನು|ನೆಮ್ಮದಿಗಳು|ನೆಮ್ಮದಿಗಳ|nemmadi|ನೆಮ್ಮದಿಗಳಿಗೆ|ನೆಮ್ಮದಿಗಳಿಂದ	<i>noun</i><br><ol><li>peace, tranquility, calm, quiet</li></ol>
ನೆಯ್ಗೆ|neyge	<i>noun</i><br><ol><li>weaving, textile</li></ol>
ನೆರಳು|neraḷu	<i>noun</i><br><ol><li>shade</li><li>shadow</li></ol>
ನೆಲಗುಳ್ಳ|nelaguḷḷa	<i>noun</i><br><ol><li>eggplant</li></ol>
ನೇಗಿಲು|nēgilu	<i>noun</i><br><ol><li>plough</li></ol>
ನೇತ್ರ|nētra	<i>noun</i><br><ol><li>eye</li></ol>
ನೇಸರು|ನೇಸರುಗಳನ್ನು|ನೇಸರುಗಳಿಂದ|ನೇಸರಿನ|ನೇಸರಿನಿಂದ|ನೇಸರಿಗೆ|nēsaru|ನೇಸರುಗಳು|ನೇಸರುಗಳ|ನೇಸರನ್ನು|ನೇಸರುಗಳಿಗೆ	<i>noun</i><br><ol><li>sun</li></ol>
ನೊಣ|noṇa	<i>noun</i><br><ol><li>fly</li></ol>
ನೊವೊಸಿಬಿರ್ಸ್ಕ್|novosibirsk	<i>name</i><br><ol><li>Novosibirsk (a city in Russia)</li></ol>
ನೊಸಲು|nosalu	<i>noun</i><br><ol><li>forehead</li></ol>
ನೋಟ|nōṭa	<i>noun</i><br><ol><li>look</li><li>appearance</li></ol>
ನೋಡು|ನೋಡಿದರೆ|ನೋಡುವನು|ನೋಡೆ|ನೋಡುವೆವು|ನೋಡನು|ನೋಡುತ್ತ|ನೋಡದ|ನೋಡುವಿ|ನೋಡೀರಿ|ನೋಡಯೇನು|ನೋಡುವಳು|ನೋಡಿದ|ನೋಡಿದಿರಿ|ನೋಡಳು|ನೋಡಲಿಕ್ಕೆ|ನೋಡೋಣ|ನೋಡುವಾ|ನೋಡದೆ|ನೋಡುವ|ನೋಡಲು|ನೋಡಿದೆ|ನೋಡೆನು|ನೋಡುತ್ತಾಳೆ|ನೋಡೆವು|ನೋಡುತ್ತೀ|ನೋಡುವೆ|ನೋಡುತ್ತೇವೆ|ನೋಡಿಯಾರು|ನೋಡರು|ನೋಡುತ್ತದೆ|ನೋಡಿದರು|ನೋಡುವರು|ನೋಡೀಯೆ|ನೋಡಿದಳು|ನೋಡವು|ನೋಡ|ನೋಡಿಯಾವು|ನೋಡತು|ನೋಡೀತು|ನೋಡುತ್ತವೆ|ನೋಡುತ್ತಾನೆ|ನೋಡಿರಿ|ನೋಡಿದೆವು|ನೋಡದು|ನೋಡಿಯೇವು|ನೋಡಿಯಾಳು|ನೋಡುವುವು|ನೋಡಿದನು|ನೋಡುತ್ತೇನೆ|ನೋಡುತ್ತೀರಿ|ನೋಡಿದೆನು|ನೋಡುವುದು|ನೋಡಲಿ|nōḍu|ನೋಡರಿ|ನೋಡಿದಿ|ನೋಡುವೆನು|ನೋಡಿಯಾನು|ನೋಡುತ್ತಾರೆ|ನೋಡುವಿರಿ|ನೋಡಿದುವು|ನೋಡುತ್ತೀಯೆ	<i>verb</i><br><ol><li>to look at, watch</li></ol>
ನೌಕೆ|nauke	<i>noun</i><br><ol><li>ship, boat</li></ol>
ನ್	<i>character</i><br><ol><li>The Kannada letter n.</li></ol>
ನ್ಯಗ್ರೋಧ|nyagrōdha	<i>noun</i><br><ol><li>banyan</li></ol>
ಪ|pa	<i>character</i><br><ol><li>The Kannada letter pa.</li></ol>
ಪಂಜರ|paṅjara	<i>noun</i><br><ol><li>skeleton</li><li>cage</li></ol>
ಪಂಜಾಬ್|pan̄jāb	<i>name</i><br><ol><li>Punjab</li></ol>
ಪಂಡಿತ|paṇḍita	<i>noun</i><br><ol><li>learned man, scholar; a pandit</li></ol>
ಪಂಣು|paṇṇu	<i>noun</i><br><ol><li>fruit</li><li>advantage</li></ol><br><i>verb</i><br><ol><li>to make, do</li><li>to ripen</li></ol>
ಪಕ್ಕ|pakka	<i>noun</i><br><ol><li>side, flank</li></ol><br><i>prep</i><br><ol><li>next to; at the side of</li></ol>
ಪಕ್ಷಿ|pakṣi	<i>noun</i><br><ol><li>a bird</li></ol>
ಪಚ್ಚೆ|pacce	<i>noun</i><br><ol><li>emerald</li><li>green</li><li>virescence</li></ol>
ಪಟೀರ|paṭīra	<i>noun</i><br><ol><li>sandalwood</li></ol>
ಪಟ್ಟಡೆ|paṭṭaḍe	<i>noun</i><br><ol><li>anvil</li><li>necklace</li></ol>
ಪಟ್ಟಣ|paṭṭaṇa	<i>noun</i><br><ol><li>city</li></ol>
ಪಡಿಯಚ್ಚು|ಪಡಿಯಚ್ಚಿನ|ಪಡಿಯಚ್ಚುಗಳು|ಪಡಿಯಚ್ಚಿಗೆ|ಪಡಿಯಚ್ಚುಗಳ|ಪಡಿಯಚ್ಚುಗಳಿಗೆ|paḍiyaccu|ಪಡಿಯಚ್ಚನ್ನು|ಪಡಿಯಚ್ಚುಗಳನ್ನು|ಪಡಿಯಚ್ಚಿನಿಂದ|ಪಡಿಯಚ್ಚುಗಳಿಂದ	<i>noun</i><br><ol><li>duplicate</li></ol>
ಪಣತಿ|ಹಣತೆ|haṇati|paṇati|ಹಣತಿ|haṇate	<i>noun</i><br><ol><li>diya (an Indian oil lamp, usually made from clay, with a cotton wick dipped in ghee or vegetable oil)</li></ol>
ಪತಿ|pati	<i>noun</i><br><ol><li>(formal, literary) a husband</li><li>(in compounds) lord, master</li></ol>
ಪತ್ನಿ|patni	<i>noun</i><br><ol><li>(formal, literary) a wife</li></ol>
ಪತ್ರ|patra	<i>noun</i><br><ol><li>letter (written message)</li></ol>
ಪದ|pada	<i>noun</i><br><ol><li>word, term</li></ol>
ಪದದ ಹಿನ್ನೆಲೆ|padada hinnele	<i>noun</i><br><ol><li>etymology</li></ol>
ಪದೇ ಪದೇ|padē padē	<i>adv</i><br><ol><li>repeatedly, frequently</li></ol>
ಪಯಸ್ಸು|payassu	<i>noun</i><br><ol><li>(rare) milk</li></ol>
ಪರಿಮಳ|parimaḷa	<i>noun</i><br><ol><li>fragrance, pleasant scent</li></ol>
ಪರೀಕ್ಷಿಸು|parīkṣisu	<i>verb</i><br><ol><li>to examine, investigate, verify</li></ol>
ಪರ್ಜನ್ಯ|parjanya	<i>noun</i><br><ol><li>(meteorology) rainfall</li></ol>
ಪರ್ಣ|parṇa	<i>noun</i><br><ol><li>leaf</li></ol>
ಪರ್ರಹ|parraha	<i>noun</i><br><ol><li>(music) kettledrum</li></ol>
ಪರ್ವತ|ಪರ್ವತಗಳಿಗೆ|ಪರ್ವತವನ್ನು|parvata|ಪರ್ವತಗಳು|ಪರ್ವತವು|ಪರ್ವತದ|ಪರ್ವತಗಳ|ಪರ್ವತದಿಂದ|ಪರ್ವತಕ್ಕೆ|ಪರ್ವತಗಳಿಂದ|ಪರ್ವತಗಳನ್ನು	<i>noun</i><br><ol><li>(geography) mountain (large, rocky hill)</li></ol>
ಪಲಂಕಷ|palaṅkaśa	<i>noun</i><br><ol><li>goblin, imp</li></ol>
ಪಳು|paḷu	<i>noun</i><br><ol><li>forest</li></ol>
ಪಶು|paśu	<i>noun</i><br><ol><li>livestock, cattle</li></ol>
ಪಾಕ|pāka	<i>noun</i><br><ol><li>a thick liquid prepared by boiling sugar with water; sugar syrup</li></ol>
ಪಾಕಿಸ್ತಾನ್|pākistān	<i>name</i><br><ol><li>Pakistan</li></ol>
ಪಾತ್ರ|pātra	<i>noun</i><br><ol><li>container of a liquid</li></ol>
ಪಾದರಸ|pādarasa	<i>noun</i><br><ol><li>(chemistry) mercury, quicksilver</li></ol>
ಪಾದ್ರಿ|pādri	<i>noun</i><br><ol><li>(Christianity) church father; pastor, Christian priest</li></ol>
ಪಾಪ|pāpa	<i>noun</i><br><ol><li>sin</li></ol>
ಪಾರಜ|pāraja	<i>noun</i><br><ol><li>(chemistry) mercury, quicksilver</li></ol>
ಪಾಳುಭೂಮಿ|pāḷubhūmi	<i>noun</i><br><ol><li>moor</li></ol>
ಪಿತ|pita	<i>noun</i><br><ol><li>(literary) a father</li></ol>
ಪಿತ್ತ|pitta	<i>noun</i><br><ol><li>bile</li></ol>
ಪಿಪಾಸು|pipāsu	<i>noun</i><br><ol><li>(rare) thirst</li></ol>
ಪು|pu	<i>character</i><br><ol><li>The Kannada letter pu.</li></ol>
ಪುಕ್ಕ|pukka	<i>noun</i><br><ol><li>feather</li></ol>
ಪುಟ|puṭa	<i>noun</i><br><ol><li>page</li></ol>
ಪುತ್ರ|putra	<i>noun</i><br><ol><li>(literary) a son</li></ol>
ಪುರುಷ|puruṣa	<i>noun</i><br><ol><li>(formal) a man</li></ol>
ಪುರುಸತ್ತು|purusattu	<i>noun</i><br><ol><li>leisure, spare time</li></ol>
ಪುಳಿ|puḷi	<i>noun</i><br><ol><li>acid</li><li>acidity, tartness</li></ol><br><i>adj</i><br><ol><li>sour, acidic</li></ol>
ಪುಷ್ಕರಿಣಿ|ಪುಷ್ಕರಿಣಿಗಳ|ಪುಷ್ಕರಿಣಿಯಿಂದ|ಪುಷ್ಕರಿಣಿಗಳು|ಪುಷ್ಕರಿಣಿಯನ್ನು|puṣkariṇi|ಪುಷ್ಕರಿಣಿಗಳಿಂದ|ಪುಷ್ಕರಿಣಿಗಳಿಗೆ|ಪುಷ್ಕರಿಣಿಗೆ|ಪುಷ್ಕರಿಣಿಗಳನ್ನು|ಪುಷ್ಕರಿಣಿಯ|ಪುಷ್ಕರಿಣಿಯು	<i>noun</i><br><ol><li>lake (body of water)</li></ol>
ಪುಷ್ಪ|puṣpa	<i>noun</i><br><ol><li>(formal, literary) flower</li></ol>
ಪುಸ್ತಕ|ಪುಸ್ತಕಗಳಿಗೆ|pustaka|ಪುಸ್ತಕಗಳಿಂದ|ಪುಸ್ತಕಗಳು|ಪುಸ್ತಕದ|ಪುಸ್ತಕಗಳ|ಪುಸ್ತಕವನ್ನು|ಪುಸ್ತಕಕ್ಕೆ|ಪುಸ್ತಕಗಳನ್ನು|ಪುಸ್ತಕದಿಂದ|ಪುಸ್ತಕವು	<i>noun</i><br><ol><li>book</li></ol>
ಪೂರ್ಣ|pūrṇa	<i>adj</i><br><ol><li>full, entire</li></ol>
ಪೂರ್ವ|pūrva	<i>noun</i><br><ol><li>east</li></ol>
ಪೂವು|pūvu	<i>noun</i><br><ol><li>(regional, dialectal) a flower</li></ol>
ಪೈಗಂಬರ್|paigambar	<i>name</i><br><ol><li>(Islam) the Prophet; i.e., Muhammad</li></ol>
ಪೊರ|pora	<i>noun</i><br><ol><li>little boy, kid, lad</li></ol>
ಪೊಳೆ|ಪೊಳೆಯು|ಪೊಳೆಯನ್ನು|poḷe|ಪೊಳೆಗಳು|ಪೊಳೆಗಳನ್ನು|ಪೊಳೆಗಳ|ಪೊಳೆಗಳಿಗೆ|ಪೊಳೆಗೆ|ಪೊಳೆಯಿಂದ|ಪೊಳೆಗಳಿಂದ|ಪೊಳೆಯ	<i>noun</i><br><ol><li>(geography) river</li></ol>
ಪೋಷಾಕು|ಪೋಷಾಕನ್ನು|pōṣāku|ಪೋಷಾಕಿನಿಂದ|ಪೋಷಾಕುಗಳನ್ನು|ಪೋಷಾಕುಗಳಿಂದ|ಪೋಷಾಕಿಗೆ|ಪೋಷಾಕುಗಳಿಗೆ|ಪೋಷಾಕುಗಳು|ಪೋಷಾಕಿನ|ಪೋಷಾಕುಗಳ	<i>noun</i><br><ol><li>apparel, dress, clothes, stitched garments</li></ol>
ಪೌರುಷ|pauruṣa	<i>noun</i><br><ol><li>masculinity, manliness, virility</li><li>courage, bravery, strength, vigor, valiance</li></ol>
ಪ್ರಜ್ಞೆ|prajñe	<i>noun</i><br><ol><li>consciousness</li></ol>
ಪ್ರತಿಮೆ|pratime	<i>noun</i><br><ol><li>image, idol, statue</li><li>likeness</li></ol>
ಪ್ರಥಮ|prathama	<i>adj</i><br><ol><li>(formal, literary) first, foremost</li></ol>
ಪ್ರಮಾಣ|pramāṇa	<i>noun</i><br><ol><li>quantity</li></ol>
ಪ್ರಯತ್ನ|ಪ್ರಯತ್ನಗಳ|ಪ್ರಯತ್ನಗಳಿಗೆ|ಪ್ರಯತ್ನಗಳು|ಪ್ರಯತ್ನದಿಂದ|ಪ್ರಯತ್ನಕ್ಕೆ|prayatna|ಪ್ರಯತ್ನಗಳಿಂದ|ಪ್ರಯತ್ನಗಳನ್ನು|ಪ್ರಯತ್ನವನ್ನು|ಪ್ರಯತ್ನದ|ಪ್ರಯತ್ನವು	<i>noun</i><br><ol><li>attempt, try, effort</li></ol>
ಪ್ರಯತ್ನಿಸು|ಪ್ರಯತ್ನಿಸುುತ್ತಾನೆ|ಪ್ರಯತ್ನಿಸುಿಯೇವು|prayatnisu|ಪ್ರಯತ್ನಿಸಿದೆನು|ಪ್ರಯತ್ನಿಸುನು|ಪ್ರಯತ್ನಿಸುಳು|ಪ್ರಯತ್ನಿಸುೀರಿ|ಪ್ರಯತ್ನಿಸಿದರು|ಪ್ರಯತ್ನಿಸುುವಾ|ಪ್ರಯತ್ನಿಸುುವಿರಿ|ಪ್ರಯತ್ನಿಸುುವೆನು|ಪ್ರಯತ್ನಿಸಿದೆವು|ಪ್ರಯತ್ನಿಸುಲಿಕ್ಕೆ|ಪ್ರಯತ್ನಿಸಿದನು|ಪ್ರಯತ್ನಿಸುದ|ಪ್ರಯತ್ನಿಸುುತ್ತ|ಪ್ರಯತ್ನಿಸುಲು|ಪ್ರಯತ್ನಿಸುುತ್ತೀರಿ|ಪ್ರಯತ್ನಿಸಿದುವು|ಪ್ರಯತ್ನಿಸುುವರು|ಪ್ರಯತ್ನಿಸುುವುವು|ಪ್ರಯತ್ನಿಸುಿಯಾರು|ಪ್ರಯತ್ನಿಸುುವೆ|ಪ್ರಯತ್ನಿಸುುತ್ತಾಳೆ|ಪ್ರಯತ್ನಿಸುುತ್ತಾರೆ|ಪ್ರಯತ್ನಿಸಿದೆ|ಪ್ರಯತ್ನಿಸ|ಪ್ರಯತ್ನಿಸುೋಣ|ಪ್ರಯತ್ನಿಸುುವಳು|ಪ್ರಯತ್ನಿಸುದು|ಪ್ರಯತ್ನಿಸುುವೆವು|ಪ್ರಯತ್ನಿಸಿದ|ಪ್ರಯತ್ನಿಸುಿರಿ|ಪ್ರಯತ್ನಿಸಿದಳು|ಪ್ರಯತ್ನಿಸುೆವು|ಪ್ರಯತ್ನಿಸುುವ|ಪ್ರಯತ್ನಿಸಿದಿರಿ|ಪ್ರಯತ್ನಿಸುಿಯಾವು|ಪ್ರಯತ್ನಿಸುುತ್ತೀ|ಪ್ರಯತ್ನಿಸುದೆ|ಪ್ರಯತ್ನಿಸುೀತು|ಪ್ರಯತ್ನಿಸುುತ್ತದೆ|ಪ್ರಯತ್ನಿಸಯೇನು|ಪ್ರಯತ್ನಿಸೀಯೆ|ಪ್ರಯತ್ನಿಸುವು|ಪ್ರಯತ್ನಿಸುೆ|ಪ್ರಯತ್ನಿಸುುತ್ತೇವೆ|ಪ್ರಯತ್ನಿಸುುವನು|ಪ್ರಯತ್ನಿಸುಿಯಾಳು|ಪ್ರಯತ್ನಿಸಿದರೆ|ಪ್ರಯತ್ನಿಸುುತ್ತೇನೆ|ಪ್ರಯತ್ನಿಸುುತ್ತವೆ|ಪ್ರಯತ್ನಿಸುಲಿ|ಪ್ರಯತ್ನಿಸುರಿ|ಪ್ರಯತ್ನಿಸುು|ಪ್ರಯತ್ನಿಸುಿಯಾನು|ಪ್ರಯತ್ನಿಸಿದಿ|ಪ್ರಯತ್ನಿಸುುವುದು|ಪ್ರಯತ್ನಿಸುೆನು|ಪ್ರಯತ್ನಿಸುುತ್ತೀಯೆ|ಪ್ರಯತ್ನಿಸುುವಿ|ಪ್ರಯತ್ನಿಸತು|ಪ್ರಯತ್ನಿಸುರು	<i>verb</i><br><ol><li>To attempt, try</li></ol>
ಪ್ರಯಾಣ|prayāṇa	<i>noun</i><br><ol><li>journey, travel</li></ol>
ಪ್ರಾಣ|prāṇa	<i>noun</i><br><ol><li>vitality, life, spirit, animation</li></ol>
ಪ್ರಾತಃಕಾಲ|prātaḥkāla	<i>noun</i><br><ol><li>(literary, formal) morning</li></ol>
ಪ್ರಿಯ|priya	<i>adj</i><br><ol><li>beloved, dear</li><li>fond of, attached to</li></ol>
ಪ್ರೀತಿ|prīti	<i>noun</i><br><ol><li>love, affection</li></ol>
ಪ್ರೇತ|prēta	<i>noun</i><br><ol><li>a ghost</li><li>(formal) a corpse</li></ol>
ಫ|pha	<i>character</i><br><ol><li>The Kannada letter pha.</li></ol>
ಫಜೀತಿ|ಫಜೀತಿಗಳನ್ನು|ಫಜೀತಿಗಳಿಂದ|phajīti|ಫಜೀತಿಗೆ|ಫಜೀತಿಯಿಂದ|ಫಜೀತಿಯು|ಫಜೀತಿಗಳ|ಫಜೀತಿಯನ್ನು|ಫಜೀತಿಗಳು|ಫಜೀತಿಗಳಿಗೆ|ಫಜೀತಿಯ	<i>noun</i><br><ol><li>embarrassment, abashment</li><li>suffering, difficulty, fix (of minor order)</li></ol>
ಫ್ರೆಂಚ್|phreñc	<i>name</i><br><ol><li>the French language</li></ol>
ಫ್ಲೂರೀನ್|phlūrīn	<i>noun</i><br><ol><li>fluorine</li></ol>
ಬ|ba	<i>character</i><br><ol><li>The Kannada letter ba.</li></ol>
ಬಂಗಾರ|baṅgāra	<i>noun</i><br><ol><li>gold</li></ol>
ಬಂಜರು|bañjaru	<i>noun</i><br><ol><li>wasteland, desert, a barren tract, fallow land</li></ol>
ಬಂಜೆ|bañje	<i>noun</i><br><ol><li>an infertile woman</li></ol>
ಬಂಧನ|bandhana	<i>noun</i><br><ol><li>bond</li><li>fetter, bondage</li></ol>
ಬಂಬು|ಬಂಬನ್ನು|ಬಂಬಿನ|ಬಂಬಿಗೆ|bambu|ಬಂಬುಗಳನ್ನು|ಬಂಬುಗಳಿಗೆ|ಬಂಬಿನಿಂದ|ಬಂಬುಗಳು|ಬಂಬುಗಳಿಂದ|ಬಂಬುಗಳ	<i>noun</i><br><ol><li>(colloquial, nonstandard) bamboo</li></ol>
ಬಗೆ|bage	<i>noun</i><br><ol><li>category</li></ol>
ಬಗ್ಗರಿ|baggari	<i>noun</i><br><ol><li>thorax</li></ol>
ಬಗ್ಗೆ|bagge	<i>postp</i><br><ol><li>about, concerning</li></ol>
ಬಟಾಟೆ|baṭāṭe	<i>noun</i><br><ol><li>potato</li></ol>
ಬಡಿತಕೇಳುಕ|baḍitakēḷuka	<i>noun</i><br><ol><li>stethoscope</li></ol>
ಬಣ್ಣ|baṇṇa	<i>noun</i><br><ol><li>color</li></ol>
ಬದನೆ|badane	<i>noun</i><br><ol><li>eggplant, brinjal</li></ol>
ಬದನೇಕಾಯಿ|badanēkāyi	<i>noun</i><br><ol><li>brinjal</li></ol>
ಬದುಕು|baduku	<i>verb</i><br><ol><li>to live</li></ol>
ಬಯಕೆ|ಬಯಕೆಯಿಂದ|ಬಯಕೆಗಳನ್ನು|ಬಯಕೆಗಳ|bayake|ಬಯಕೆಗಳಿಗೆ|ಬಯಕೆಗಳಿಂದ|ಬಯಕೆಯು|ಬಯಕೆಯ|ಬಯಕೆಯನ್ನು|ಬಯಕೆಗೆ|ಬಯಕೆಗಳು	<i>noun</i><br><ol><li>want, desire</li></ol>
ಬಯಲು|bayalu	<i>noun</i><br><ol><li>open space; plain</li></ol>
ಬಯಸು|ಬಯಸಿದುವು|ಬಯಸಯೇನು|ಬಯಸುೋಣ|ಬಯಸುುತ್ತೀರಿ|ಬಯಸುೀರಿ|ಬಯಸ|ಬಯಸಿದೆ|ಬಯಸುಿಯಾವು|ಬಯಸಿದೆವು|ಬಯಸುುವನು|ಬಯಸುೆವು|ಬಯಸಿದರು|ಬಯಸುರು|ಬಯಸುರಿ|ಬಯಸುಿಯಾಳು|ಬಯಸತು|ಬಯಸುುವ|ಬಯಸೀಯೆ|ಬಯಸುುತ್ತದೆ|ಬಯಸುುತ್ತೀಯೆ|bayasu|ಬಯಸುುವಳು|ಬಯಸುುತ್ತೇವೆ|ಬಯಸಿದೆನು|ಬಯಸುದು|ಬಯಸುೀತು|ಬಯಸಿದಿ|ಬಯಸುಳು|ಬಯಸುುವಿರಿ|ಬಯಸುುವುವು|ಬಯಸುುತ್ತ|ಬಯಸುುವೆನು|ಬಯಸುಿಯೇವು|ಬಯಸುಿಯಾರು|ಬಯಸುವು|ಬಯಸುೆ|ಬಯಸುುತ್ತೀ|ಬಯಸುು|ಬಯಸಿದರೆ|ಬಯಸುದೆ|ಬಯಸುಿರಿ|ಬಯಸುುತ್ತೇನೆ|ಬಯಸಿದನು|ಬಯಸುುವರು|ಬಯಸುಿಯಾನು|ಬಯಸಿದಿರಿ|ಬಯಸುುವಿ|ಬಯಸುೆನು|ಬಯಸುುತ್ತಾರೆ|ಬಯಸುಲಿ|ಬಯಸುುವಾ|ಬಯಸುುವೆವು|ಬಯಸುುತ್ತಾನೆ|ಬಯಸುಲು|ಬಯಸಿದಳು|ಬಯಸುುತ್ತವೆ|ಬಯಸಿದ|ಬಯಸುನು|ಬಯಸುುತ್ತಾಳೆ|ಬಯಸುಲಿಕ್ಕೆ|ಬಯಸುುವುದು|ಬಯಸುುವೆ|ಬಯಸುದ	<i>verb</i><br><ol><li>to want, wish, desire</li></ol>
ಬರೆಕೋಲು|ಬರೆಕೋಲಿನ|ಬರೆಕೋಲಿನಿಂದ|barekōlu|ಬರೆಕೋಲುಗಳನ್ನು|ಬರೆಕೋಲುಗಳು|ಬರೆಕೋಲುಗಳಿಂದ|ಬರೆಕೋಲನ್ನು|ಬರೆಕೋಲುಗಳ|ಬರೆಕೋಲಿಗೆ|ಬರೆಕೋಲುಗಳಿಗೆ	<i>noun</i><br><ol><li>writing utensil</li></ol>
ಬಲ|bala	<i>noun</i><br><ol><li>force, strength</li></ol>
ಬಲಮರ್ದು|balamardu	<i>noun</i><br><ol><li>gunpowder</li></ol>
ಬಲಾತ್ಕಾರ|balātkāra	<i>noun</i><br><ol><li>rape</li></ol>
ಬಳ್ಳಿ|baḷḷi	<i>noun</i><br><ol><li>(Botany) creeper</li></ol>
ಬಸವ|basava	<i>noun</i><br><ol><li>(regional) a bull</li></ol><br><i>name</i><br><ol><li>the name of a celebrated 12th century philosopher, known for founding Lingayatism</li></ol>
ಬಸ್ತ|basta	<i>noun</i><br><ol><li>(male) goat</li></ol>
ಬಾಕಿ|bāki	<i>noun</i><br><ol><li>arrears, balance</li></ol>
ಬಾಗಿಲು|bāgilu	<i>noun</i><br><ol><li>door</li></ol>
ಬಾಚು|bācu	<i>verb</i><br><ol><li>to comb</li></ol>
ಬಾಟಲಿ|bāṭali	<i>noun</i><br><ol><li>bottle</li></ol>
ಬಾಡಿಗೆ|bāḍige	<i>noun</i><br><ol><li>rent</li><li>fare</li><li>hire</li></ol>
ಬಾನಾಡಿ|bānāḍi	<i>noun</i><br><ol><li>skylark</li></ol>
ಬಾನುಲಿ|bānuli	<i>noun</i><br><ol><li>radio</li></ol>
ಬಾಯಿ|bāyi	<i>noun</i><br><ol><li>the mouth</li></ol>
ಬಾಳೆ|bāḷe	<i>noun</i><br><ol><li>Musa × paradisiaca, plantain, banana, banana tree</li></ol>
ಬಾವಿ|bāvi	<i>noun</i><br><ol><li>a well</li></ol>
ಬಿಡಾಲ|biḍāla	<i>noun</i><br><ol><li>cat</li></ol>
ಬಿಡು|biḍu	<i>verb</i><br><ol><li>to leave, let go, release</li><li>to quit</li></ol>
ಬಿಡುಗಡೆ|ಬಿಡುಗಡೆಗಳಿಂದ|ಬಿಡುಗಡೆಗೆ|ಬಿಡುಗಡೆಗಳ|biḍugaḍe|ಬಿಡುಗಡೆಯನ್ನು|ಬಿಡುಗಡೆಗಳನ್ನು|ಬಿಡುಗಡೆಯ|ಬಿಡುಗಡೆಯಿಂದ|ಬಿಡುಗಡೆಗಳಿಗೆ|ಬಿಡುಗಡೆಯು|ಬಿಡುಗಡೆಗಳು	<i>noun</i><br><ol><li>salvation</li></ol>
ಬಿದಿರು|bidiru	<i>noun</i><br><ol><li>bamboo (plant)</li></ol><br><i>verb</i><br><ol><li>to scatter</li></ol>
ಬಿದು|ಬಿದುವು|ಬಿದುಗಳು|bidu|ಬಿದುಗಳಿಂದ|ಬಿದುಗಳಿಗೆ|ಬಿದುವಿಗೆ|ಬಿದುಗಳನ್ನು|ಬಿದುಗಳ|ಬಿದುವಿನ|ಬಿದುವನ್ನು|ಬಿದುವಿನಿಂದ	<i>noun</i><br><ol><li>moon</li></ol>
ಬಿಮ್ಮಗೆ|bimmage	<i>adv</i><br><ol><li>firmly</li></ol>
ಬಿರುಗಾಳಿ|ಬಿರುಗಾಲಿಗಳನ್ನು|ಬಿರುಗಾಲಿಯು|ಬಿರುಗಾಲಿಯಿಂದ|ಬಿರುಗಾಲಿಯನ್ನು|ಬಿರುಗಾಲಿಗಳಿಗೆ|ಬಿರುಗಾಲಿಯ|ಬಿರುಗಾಲಿಗಳಿಂದ|ಬಿರುಗಾಲಿಗಳ|ಬಿರುಗಾಲಿಗಳು|ಬಿರುಗಾಲಿಗೆ|birugāḷi	<i>noun</i><br><ol><li>(meteorology) tornado</li></ol>
ಬಿಲ್ಗಾರ|bilgāra	<i>noun</i><br><ol><li>archer</li></ol>
ಬಿಲ್ಲು|billu	<i>noun</i><br><ol><li>a bow</li></ol>
ಬಿಳಿಬದನೆ|biḷabadane	<i>noun</i><br><ol><li>eggplant</li></ol>
ಬೀ|bī	<i>character</i><br><ol><li>The Kannada letter bī.</li></ol>
ಬೀಗದ ಕೈ|bīgada kai	<i>noun</i><br><ol><li>key</li></ol>
ಬೀಚ್|bīc	<i>noun</i><br><ol><li>beach</li></ol>
ಬೀಜ|bīja	<i>noun</i><br><ol><li>a seed</li><li>(figuratively) semen</li></ol>
ಬೀಜಾಂಕುರ|bījāṅkura	<i>noun</i><br><ol><li>seedling</li></ol>
ಬೀರು|bīru	<i>verb</i><br><ol><li>to scatter</li><li>to cost</li><li>to confer</li><li>to dissipate</li></ol>
ಬೀಳ್ಚುಕ್ಕಿ|bīḷcukki	<i>noun</i><br><ol><li>(astronomy) meteor</li></ol>
ಬೀಸು|bīsu	<i>verb</i><br><ol><li>to flutter</li></ol>
ಬುಟ್ಟಿ|buṭṭi	<i>noun</i><br><ol><li>basket</li></ol>
ಬುದ್ಧ|buddha	<i>name</i><br><ol><li>the Buddha</li></ol>
ಬುದ್ಧಿ|buddhi	<i>noun</i><br><ol><li>intellect, intelligence</li></ol>
ಬುಧವಾರ|budhavāra	<i>noun</i><br><ol><li>Wednesday; the fourth day of the week.</li></ol>
ಬುನ್ ಳೈ|bun ḷai	<i>name</i><br><ol><li>Boon Lay</li></ol>
ಬುರುಡೆ|buruḍe	<i>noun</i><br><ol><li>skull</li></ol>
ಬೂದಿ|būdi	<i>noun</i><br><ol><li>ash</li></ol>
ಬೆಂಕಿ|ಬೆಂಕಿಗಳನ್ನು|ಬೆಂಕಿಯಿಂದ|ಬೆಂಕಿಯು|ಬೆಂಕಿಗೆ|ಬೆಂಕಿಯನ್ನು|ಬೆಂಕಿಗಳಿಂದ|beṅki|ಬೆಂಕಿಗಳ|ಬೆಂಕಿಯ|ಬೆಂಕಿಗಳಿಗೆ|ಬೆಂಕಿಗಳು	<i>noun</i><br><ol><li>fire</li></ol>
ಬೆಂಗಳೂರು|beṅgaḷūru	<i>name</i><br><ol><li>Bangalore (a megacity, the state capital of Karnataka, India)</li></ol>
ಬೆಕ್ಕು|bekku	<i>noun</i><br><ol><li>a cat</li></ol>
ಬೆಟ್ಟ|ಬೆಟ್ಟದಿಂದ|ಬೆಟ್ಟಕ್ಕೆ|ಬೆಟ್ಟಗಳನ್ನು|ಬೆಟ್ಟಗಳು|beṭṭa|ಬೆಟ್ಟವನ್ನು|ಬೆಟ್ಟಗಳಿಂದ|ಬೆಟ್ಟವು|ಬೆಟ್ಟಗಳಿಗೆ|ಬೆಟ್ಟದ|ಬೆಟ್ಟಗಳ	<i>noun</i><br><ol><li>(geography) mountain (large, rocky hill)</li></ol>
ಬೆಣ್ಣೆ|ಬೆಣ್ಣೆಯು|ಬೆಣ್ಣೆಗಳಿಂದ|ಬೆಣ್ಣೆಗಳ|ಬೆಣ್ಣೆಗೆ|ಬೆಣ್ಣೆಗಳನ್ನು|ಬೆಣ್ಣೆಗಳಿಗೆ|ಬೆಣ್ಣೆಯ|ಬೆಣ್ಣೆಯನ್ನು|beṇṇe|ಬೆಣ್ಣೆಗಳು|ಬೆಣ್ಣೆಯಿಂದ	<i>noun</i><br><ol><li>butter</li></ol>
ಬೆರಳು|ಬೆರಳುಗಳಿಂದ|ಬೆರಳುಗಳ|ಬೆರಳುಗಳು|ಬೆರಳುಗಳನ್ನು|ಬೆರಳಿನ|ಬೆರಳಿನಿಂದ|ಬೆರಳನ್ನು|ಬೆರಳಿಗೆ|ಬೆರಳುಗಳಿಗೆ|beraḷu	<i>noun</i><br><ol><li>finger.</li></ol>
ಬೆಲ್ಲ|bella	<i>noun</i><br><ol><li>jaggery</li></ol>
ಬೆಲ್ಲೊಟ್ಟಿ|belloṭṭi	<i>noun</i><br><ol><li>dhobi tree (Mussaenda frondosa)</li></ol>
ಬೆವರು|ಬೆವರನ್ನು|ಬೆವರಿಗೆ|ಬೆವರುಗಳ|ಬೆವರುಗಳು|ಬೆವರುಗಳನ್ನು|ಬೆವರಿನಿಂದ|ಬೆವರುಗಳಿಂದ|bevaru|ಬೆವರುಗಳಿಗೆ|ಬೆವರಿನ	<i>noun</i><br><ol><li>sweat</li></ol>
ಬೇಜಾರು|bējāru	<i>noun</i><br><ol><li>annoyance</li><li>ennui; weariness from boredom</li></ol>
ಬೇಲಿ|bēli	<i>noun</i><br><ol><li>fence</li></ol>
ಬೇವು|bēvu	<i>noun</i><br><ol><li>Azadirachta indica; margosa or neem tree</li></ol>
ಬೇಸಿಗೆ|bēsige	<i>noun</i><br><ol><li>summer</li></ol>
ಬೈಗು|ಬೈಗುಗಳನ್ನು|ಬೈಗಿಗೆ|ಬೈಗುಗಳು|ಬೈಗುಗಳ|ಬೈಗಿನಿಂದ|ಬೈಗುಗಳಿಂದ|ಬೈಗಿನ|ಬೈಗನ್ನು|ಬೈಗುಗಳಿಗೆ|baigu	<i>noun</i><br><ol><li>evening</li></ol>
ಬೋಧಿಸು|bōdhisu	<i>verb</i><br><ol><li>to teach, instruct, provide understanding</li><li>to preach</li></ol>
ಭ|bha	<i>character</i><br><ol><li>The Kannada letter bha.</li></ol>
ಭಕ್ತಿ|ಭಕ್ತಿಯು|ಭಕ್ತಿಗಳ|ಭಕ್ತಿಗಳಿಗೆ|ಭಕ್ತಿಗಳು|ಭಕ್ತಿಯಿಂದ|ಭಕ್ತಿಗೆ|ಭಕ್ತಿಗಳಿಂದ|bhakti|ಭಕ್ತಿಯ|ಭಕ್ತಿಯನ್ನು|ಭಕ್ತಿಗಳನ್ನು	<i>noun</i><br><ol><li>bhakti</li><li>devotion; profound, unconditional love for God</li></ol>
ಭತ್ತ|bhatta	<i>noun</i><br><ol><li>unhusked rice</li></ol>
ಭಯ|bhaya	<i>noun</i><br><ol><li>fear</li></ol>
ಭಯೋತ್ಪಾದನೆ|bhayōtpādane	<i>noun</i><br><ol><li>terrorism</li></ol>
ಭರ್ಜಿ|bharji	<i>noun</i><br><ol><li>lance, spear, pike</li></ol>
ಭಸ್ಮ|bhasma	<i>noun</i><br><ol><li>ashes</li></ol>
ಭಾಗ|bhāga	<i>noun</i><br><ol><li>part, portion</li></ol>
ಭಾನುವಾರ|bhānuvāra	<i>noun</i><br><ol><li>Sunday; the first day of the week.</li></ol>
ಭಾರತ|bhārata	<i>name</i><br><ol><li>a legendary emperor of India, and is referred to in Hindu and Jain theology. He was son of King Dushyanta and Sakuntala.</li><li>descendant of the emperor Bharata</li><li>(Hinduism) younger brother of Rāma in Ramayana</li><li>India</li></ol>
ಭಾಷೆ|bhāṣe	<i>noun</i><br><ol><li>language</li><li>promise</li></ol>
ಭುಜ|bhuja	<i>noun</i><br><ol><li>shoulder</li></ol>
ಭೂಮಿ|bhūmi	<i>noun</i><br><ol><li>Earth</li></ol>
ಭೇದ|bhēda	<i>noun</i><br><ol><li>discrimination, differentiation</li><li>contrast, distinction</li></ol>
ಮ|ma	<i>character</i><br><ol><li>The Kannada letter ma.</li></ol>
ಮಂಗಳವಾರ|maṅgaḷavāra	<i>noun</i><br><ol><li>Tuesday; the third day of the week.</li></ol>
ಮಂಗಳೂರು|maṅgaḷūru	<i>name</i><br><ol><li>Mangalore, Mangaluru (a city in Karnataka, India)</li></ol>
ಮಂಜುಸುರಿತ|mañjusurita	<i>noun</i><br><ol><li>(meteorology) snowfall</li></ol>
ಮಂಡೆ|maṇḍe	<i>noun</i><br><ol><li>head</li></ol>
ಮಂದಿ|mandi	<i>noun</i><br><ol><li>folk, people, populace, public</li><li>laity</li></ol>
ಮಕ್ಕ|makka	<i>noun</i><br><ol><li>(Havyaka) Alternative form of ಮಕ್ಕೊ (makko, “children”)</li></ol>
ಮಕ್ಕೊ|makko	<i>noun</i><br><ol><li>(Havyaka) Synonym of ಮಕ್ಕಳು (makkaḷu); children</li></ol>
ಮಗ|ಮಕ್ಕಳನ್ನು|ಮಗನ|ಮಕ್ಕಳಿಂದ|ಮಕ್ಕಳಿಗೆ|makkaḷu|ಮಕ್ಕಳ|ಮಕ್ಕಳು|ಮಗನಿಗೆ|maga|ಮಗನಿಂದ|ಮಗನನ್ನು|ಮಗನು	<i>noun</i><br><ol><li>a son</li></ol>
ಮಗಳು|magaḷu	<i>noun</i><br><ol><li>a daughter</li></ol>
ಮಗಾದನ್|magādan	<i>name</i><br><ol><li>Magadan (a city in Russia)</li></ol>
ಮಗು|ಮಗುವಿಗೆ|ಮಕ್ಕಳನ್ನು|ಮಕ್ಕಳಿಂದ|ಮಕ್ಕಳಿಗೆ|ಮಗುವನ್ನು|makkaḷu|ಮಗುವು|ಮಕ್ಕಳ|ಮಕ್ಕಳು|magu|ಮಗುವಿನಿಂದ|ಮಗುವಿನ	<i>noun</i><br><ol><li>child</li></ol>
ಮಗ್ಗ|magga	<i>noun</i><br><ol><li>loom</li></ol>
ಮಗ್ನ|magna	<i>adj</i><br><ol><li>immersed</li><li>(figuratively) absorbed, attentive, enrapt</li></ol>
ಮಜ್ಜಿಗೆ|majjige	<i>noun</i><br><ol><li>buttermilk</li></ol>
ಮಜ್ಜೆ|majje	<i>noun</i><br><ol><li>marrow of the bones</li></ol>
ಮಡಿದ|maḍida	<i>adj</i><br><ol><li>dead, deceased, late</li></ol>
ಮಡಿಮಾಡು|ಮಡಿಮಾಡುೀತು (maḍimāḍuೀtu)|ಮಡಿಮಾಡುುತ್ತೀರಿ (maḍimāḍuುttīri)|ಮಡಿಮಾಡುನು|ಮಡಿಮಾಡುಿಯಾನು (maḍimāḍuಿyānu)|ಮಡಿಮಾಡುದ|ಮಡಿಮಾಡುದೆ|ಮಡಿಮಾಡುುತ್ತೀಯೆ (maḍimāḍuುttīye)|ಮಡಿಮಾಡುುತ್ತಾಳೆ (maḍimāḍuುttāḷe)|ಮಡಿಮಾಡಿದೆ|ಮಡಿಮಾಡುುವಾ (maḍimāḍuುvā)|ಮಡಿಮಾಡುೋಣ (maḍimāḍuೋṇa)|ಮಡಿಮಾಡುು (maḍimāḍuು)|ಮಡಿಮಾಡುುವೆವು (maḍimāḍuುvevu)|ಮಡಿಮಾಡುಲಿ|ಮಡಿಮಾಡುುವೆನು (maḍimāḍuುvenu)|ಮಡಿಮಾಡುುತ್ತೇವೆ (maḍimāḍuುttēve)|ಮಡಿಮಾಡುುತ್ತವೆ (maḍimāḍuುttave)|ಮಡಿಮಾಡುರಿ|ಮಡಿಮಾಡುುವುವು (maḍimāḍuುvuvu)|ಮಡಿಮಾಡುಿಯಾವು (maḍimāḍuಿyāvu)|ಮಡಿಮಾಡಿದುವು|ಮಡಿಮಾಡಿದೆವು|ಮಡಿಮಾಡುುವಳು (maḍimāḍuುvaḷu)|ಮಡಿಮಾಡತು|ಮಡಿಮಾಡುಿರಿ (maḍimāḍuಿri)|ಮಡಿಮಾಡಿದಿ|ಮಡಿಮಾಡುುವಿ (maḍimāḍuುvi)|ಮಡಿಮಾಡುುತ್ತಾನೆ (maḍimāḍuುttāne)|ಮಡಿಮಾಡಿದೆನು|ಮಡಿಮಾಡಯೇನು|ಮಡಿಮಾಡ|ಮಡಿಮಾಡಿದಿರಿ|ಮಡಿಮಾಡುೆವು (maḍimāḍuೆvu)|ಮಡಿಮಾಡಿದನು|ಮಡಿಮಾಡುೀರಿ (maḍimāḍuೀri)|ಮಡಿಮಾಡುುವುದು (maḍimāḍuುvudu)|ಮಡಿಮಾಡುಲಿಕ್ಕೆ|ಮಡಿಮಾಡಿದರು|ಮಡಿಮಾಡಿದ|ಮಡಿಮಾಡುುತ್ತೇನೆ (maḍimāḍuುttēne)|ಮಡಿಮಾಡುೆ (maḍimāḍuೆ)|ಮಡಿಮಾಡುಲು|ಮಡಿಮಾಡುುವೆ (maḍimāḍuುve)|ಮಡಿಮಾಡಿದಳು|ಮಡಿಮಾಡುುತ್ತ (maḍimāḍuುtta)|maḍimāḍu|ಮಡಿಮಾಡುುವ (maḍimāḍuುva)|ಮಡಿಮಾಡುುವಿರಿ (maḍimāḍuುviri)|ಮಡಿಮಾಡಿದರೆ|ಮಡಿಮಾಡುಳು|ಮಡಿಮಾಡುದು|ಮಡಿಮಾಡುವು|ಮಡಿಮಾಡುಿಯೇವು (maḍimāḍuಿyēvu)|ಮಡಿಮಾಡುರು|ಮಡಿಮಾಡುೆನು (maḍimāḍuೆnu)|ಮಡಿಮಾಡುುತ್ತದೆ (maḍimāḍuುttade)|ಮಡಿಮಾಡುುತ್ತೀ (maḍimāḍuುttī)|ಮಡಿಮಾಡುುತ್ತಾರೆ (maḍimāḍuುttāre)|ಮಡಿಮಾಡುುವನು (maḍimāḍuುvanu)|ಮಡಿಮಾಡುುವರು (maḍimāḍuುvaru)|ಮಡಿಮಾಡೀಯೆ|ಮಡಿಮಾಡುಿಯಾಳು (maḍimāḍuಿyāḷu)|ಮಡಿಮಾಡುಿಯಾರು (maḍimāḍuಿyāru)	<i>verb</i><br><ol><li>To clean</li></ol>
ಮಣಿ|maṇi	<i>noun</i><br><ol><li>gem, jewel</li></ol>
ಮಣ್ಣು|maṇṇu	<i>noun</i><br><ol><li>soil</li></ol>
ಮತ್ತು|mattu	<i>conj</i><br><ol><li>and</li></ol>
ಮದ್ದು|maddu	<i>noun</i><br><ol><li>medicine, drug, curative, physic, remedy, medication</li></ol>
ಮದ್ದುಗ|madduga	<i>noun</i><br><ol><li>chemist, druggist</li></ol>
ಮದ್ಯ|madya	<i>noun</i><br><ol><li>(literary, formal) liquor</li></ol>
ಮದ್ಯಪಾನ|madyapāna	<i>noun</i><br><ol><li>(literary, formal) drinking of alcohol</li></ol>
ಮಧು|madhu	<i>noun</i><br><ol><li>honey, nectar</li></ol>
ಮಧುರ|madhura	<i>adj</i><br><ol><li>sweet</li></ol>
ಮಧ್ಯ|madhya	<i>adv</i><br><ol><li>in the middle</li></ol>
ಮಧ್ಯಾಹ್ನ|madhyāhna	<i>noun</i><br><ol><li>midday, noon</li></ol>
ಮನ|mana	<i>noun</i><br><ol><li>(poetic, literary) the mind</li></ol>
ಮನಸ್ಸು|manasu|ಮನಸು|manassu	<i>noun</i><br><ol><li>the mind</li></ol>
ಮನುಷ್ಯ|manuṣya	<i>noun</i><br><ol><li>man</li><li>human being</li></ol>
ಮನೆ|ಮನೆಯನ್ನು|ಮನೆಗಳನ್ನು|ಮನೆಗಳು|ಮನೆಯ|mane|ಮನೆಗಳಿಂದ|ಮನೆಗೆ|ಮನೆಗಳಿಗೆ|ಮನೆಗಳ|ಮನೆಯಿಂದ|ಮನೆಯು	<i>noun</i><br><ol><li>home, house</li></ol>
ಮರ|ಮರಗಳು|ಮರಗಳನ್ನು|ಮರಕ್ಕೆ|ಮರಗಳ|ಮರವನ್ನು|ಮರಗಳಿಂದ|ಮರದ|ಮರಗಳಿಗೆ|mara|ಮರವು|ಮರದಿಂದ	<i>noun</i><br><ol><li>tree</li></ol>
ಮರಕತ|marakata	<i>noun</i><br><ol><li>emerald</li></ol>
ಮರುಭೂಮಿ|marubhūmi	<i>noun</i><br><ol><li>desert</li></ol>
ಮಲಗಿಸು|malagisu	<i>verb</i><br><ol><li>to cause to lie down or to recline; to put (to sleep, etc.)</li><li>to put down what stands upright (as a tree, a book, etc.)</li></ol>
ಮಲಗು|malagu	<i>verb</i><br><ol><li>to recline, to lie down (to sleep, etc.)</li><li>(intransitive) to incline, to bend (as full ears of paddy, etc.)</li></ol><br><i>noun</i><br><ol><li>pillow, cushion</li></ol>
ಮಲಯಾಳಂ|malayāḷaṃ	<i>name</i><br><ol><li>Malayalam (language)</li></ol>
ಮಲೆ	<i>noun</i><br><ol><li>(geography) mountain (large, rocky hill)</li><li>forest (dense collection of trees)</li></ol><br><i>verb</i><br><ol><li>to counteract</li></ol>
ಮಲ್ಲಿಗೆ|mallige	<i>noun</i><br><ol><li>jasmine</li></ol>
ಮಳೆ|ಮಳೆಗಳನ್ನು|ಮಳೆಗಳಿಂದ|ಮಳೆಯನ್ನು|ಮಳೆಗಳು|ಮಳೆಗೆ|ಮಳೆಯಿಂದ|ಮಳೆಯ|ಮಳೆಯು|maḷe|ಮಳೆಗಳ|ಮಳೆಗಳಿಗೆ	<i>noun</i><br><ol><li>rain</li></ol>
ಮಳೆಗಾಲ|maḷegāla	<i>noun</i><br><ol><li>rainy season</li></ol>
ಮಳೆಬಿಲ್ಲು|maḷebillu	<i>noun</i><br><ol><li>(weather) rainbow</li></ol>
ಮಳೆಯಳತೆ|maḷeyaḷate	<i>noun</i><br><ol><li>(meteorology) rainfall</li></ol>
ಮಳೆಸುರಿತ|maḷesurita	<i>noun</i><br><ol><li>(meteorology) rainfall</li></ol>
ಮಸೀದಿ|masīdi	<i>noun</i><br><ol><li>mosque</li></ol>
ಮಹಾದೇವ|mahādēva	<i>name</i><br><ol><li>Shiva (Hindu deity)</li></ol>
ಮಹಾನಗರ|mahānagara	<i>noun</i><br><ol><li>metropolis</li></ol>
ಮಹಾರಾಷ್ಟ್ರ|mahārāṣṭra	<i>name</i><br><ol><li>Maharashtra (a state of India; capital: Mumbai)</li></ol>
ಮಾಂಸ|māṃsa	<i>noun</i><br><ol><li>flesh, meat</li></ol>
ಮಾಜಿ|māji	<i>adj</i><br><ol><li>former, retired, ex-, past, earlier (used for former office-bearers)</li></ol>
ಮಾಡು|ಮಾಡುವ|ಮಾಡುತ್ತ|ಮಾಡುವೆವು|ಮಾಡುತ್ತದೆ|ಮಾಡುವುವು|ಮಾಡರಿ|ಮಾಡಿದಳು|māḍu|ಮಾಡುವೆ|ಮಾಡಿತು|ಮಾಡಿಯಾನು|ಮಾಡವು|ಮಾಡಿಯಾಳು|ಮಾಡದು|ಮಾಡೀತು|ಮಾಡದೆ|ಮಾಡಿಯಾರು|ಮಾಡೆವು|ಮಾಡುವಾ|ಮಾಡದ|ಮಾಡುತ್ತೇನೆ|ಮಾಡಿದಿ|ಮಾಡಲಿ|ಮಾಡುವರು|ಮಾಡುತ್ತಾಳೆ|ಮಾಡಿಯೇವು|ಮಾಡುವಿರಿ|ಮಾಡಿಯಾವು|ಮಾಡುತ್ತಾರೆ|ಮಾಡಿ|ಮಾಡಿದನು|ಮಾಡುತ್ತೀರಿ|ಮಾಡುವಳು|ಮಾಡುತ್ತೀಯೆ|ಮಾಡನು|ಮಾಡಿದರು|ಮಾಡರು|ಮಾಡಿದ|ಮಾಡೋಣ|ಮಾಡಿದರೆ|ಮಾಡೆನು|ಮಾಡಿದೆವು|ಮಾಡಳು|ಮಾಡೀರಿ|ಮಾಡುವುದು|ಮಾಡುವಿ|ಮಾಡಲು|ಮಾಡಿದುವು|ಮಾಡಿೀಯೆ|ಮಾಡುತ್ತವೆ|ಮಾಡಿದಿರಿ|ಮಾಡೆ|ಮಾಡುತ್ತೇವೆ|ಮಾಡುತ್ತೀ|ಮಾಡುವೆನು|ಮಾಡಿರಿ|ಮಾಡಿದೆ|ಮಾಡಿಯೇನು|ಮಾಡುತ್ತಾನೆ|ಮಾಡಲಿಕ್ಕೆ|ಮಾಡಿದೆನು|ಮಾಡುವನು	<i>verb</i><br><ol><li>To do</li><li>To make</li></ol>
ಮಾಣಿ|māṇi	<i>noun</i><br><ol><li>(Havyaka) boy, lad, young man</li></ol>
ಮಾಣಿಕ್ಯ|māṇikya	<i>noun</i><br><ol><li>ruby</li></ol>
ಮಾತು|mātu	<i>noun</i><br><ol><li>saying</li><li>word</li><li>promise</li></ol>
ಮಾತೆ|māte	<i>noun</i><br><ol><li>a mother</li></ol>
ಮಾತ್ರ|mātra	<i>adv</i><br><ol><li>only, just</li></ol>
ಮಾಧವ|mādhava	<i>name</i><br><ol><li>(Hinduism) a name of Krishna or Vishnu</li></ol>
ಮಾಯ್ಕೊಪ್|māykop	<i>name</i><br><ol><li>Maykop (the capital and largest city of Adygea, Russia)</li></ol>
ಮಾರು|ಮಾರಿದರೆ|ಮಾರುತ್ತೇನೆ|ಮಾರಿದಳು|ಮಾರಿಯೇನು|ಮಾರಿನ|ಮಾರುತ್ತ|ಮಾರುತ್ತಾರೆ|ಮಾರುತ್ತವೆ|ಮಾರಿಯಾನು|ಮಾರುವ|ಮಾರೋಣ|ಮಾರದೆ|ಮಾರುವಳು|ಮಾರವು|ಮಾರೀತು|ಮಾರೆ|ಮಾರಿದೆನು|ಮಾರಿದೆ|ಮಾರಲು|ಮಾರಿದ|ಮಾರಲಿ|ಮಾರಿಯಾರು|ಮಾರೆವು|ಮಾರುತ್ತೀರಿ|ಮಾರುವನು|ಮಾರುತ್ತಾನೆ|ಮಾರುವುದು|ಮಾರುಗಳಿಂದ|ಮಾರಿಗೆ|ಮಾರಲಿಕ್ಕೆ|ಮಾರುತ್ತೀ|ಮಾರಿದಿ|ಮಾರಿದಿರಿ|ಮಾರಿೀಯೆ (māriೀye)|ಮಾರಿದನು|ಮಾರಿಯಾವು|ಮಾರುವಿ|ಮಾರುವೆವು|ಮಾರುತ್ತೇವೆ|ಮಾರಿದೆವು|ಮಾರದ|ಮಾರಿ|ಮಾರುವೆ|ಮಾರೀರಿ|ಮಾರುಗಳಿಗೆ|ಮಾರುತ್ತಾಳೆ|ಮಾರೆನು|ಮಾರುವಿರಿ|ಮಾರಿದುವು|ಮಾರುತ್ತೀಯೆ|ಮಾರಿಯೇವು|ಮಾರುತ್ತದೆ|ಮಾರನ್ನು|ಮಾರುಗಳು|ಮಾರಳು|ಮಾರದು|ಮಾರಿಯಾಳು|ಮಾರಿರಿ|ಮಾರುವೆನು|ಮಾರುವರು|ಮಾರನು|ಮಾರುಗಳ|ಮಾರಿತು|ಮಾರಿದರು|māru|ಮಾರುವಾ|ಮಾರುಗಳನ್ನು|ಮಾರುವುವು|ಮಾರರಿ|ಮಾರಿನಿಂದ|ಮಾರರು	<i>noun</i><br><ol><li>disposition</li></ol><br><i>adj</i><br><ol><li>contrary (of an opposing idea)</li></ol><br><i>verb</i><br><ol><li>to counteract</li><li>to change</li></ol>
ಮಾರ್ಗ|ಮಾರ್ಗವು|ಮಾರ್ಗಗಳಿಗೆ|ಮಾರ್ಗಗಳ|ಮಾರ್ಗಗಳು|ಮಾರ್ಗವನ್ನು|ಮಾರ್ಗದಿಂದ|ಮಾರ್ಗಗಳನ್ನು|ಮಾರ್ಗಗಳಿಂದ|ಮಾರ್ಗಕ್ಕೆ|ಮಾರ್ಗದ|mārga	<i>noun</i><br><ol><li>path, way, road</li></ol>
ಮಾವಿನ ಹಣ್ಣು|māvina haṇṇu	<i>noun</i><br><ol><li>mango</li></ol>
ಮಾವು|māvu	<i>noun</i><br><ol><li>mango species</li></ol>
ಮಾಸ|māsa	<i>noun</i><br><ol><li>a month, especially a month of the Hindu calendar</li></ol>
ಮಿಂಚೆ|miñce	<i>noun</i><br><ol><li>e-mail</li></ol>
ಮಿತ್ರ|mitra	<i>noun</i><br><ol><li>(formal) a friend</li></ol>
ಮಿಲನ|milana	<i>noun</i><br><ol><li>meeting, coming together</li></ol>
ಮೀ|ಮೀಯನ್ನು|ಮೀಯವು|ಮೀಯ|ಮೀಯುತ್ತ|ಮಿಂದೀರಿ|ಮಿಂದಾರು|{{{5}}}ಿತು ({{{5}}}ಿtu)|ಮೀಯಳು|ಮೀುತ್ತೇವೆ|ಮೀಗೆ|ಮಿಂದಾಳು|ಮೀಯುವೆನು|ಮಿಂದರು|ಮೀುತ್ತೀರಿ|ಮಿಂದೆನು|ಮೀಯಯುವೆ|ಮೀಗಳು|ಮೀುತ್ತೀಯೆ|ಮೀುತ್ತದೆ|ಮೀುತ್ತೇನೆ|ಮೀಯುವನು|ಮಿಂದೇನು|ಮೀಯುವುವು|ಮೀಯೆ|ಮೀಯಲು|ಮೀಯುವೆ|mī|ಮೀಯುವುದು|ಮೀಯನು|ಮಿಂದಾವು|ಮೀಯುವಾ|ಮೀಯರು|ಮೀಗಳನ್ನು|ಮೀಯುವಿರಿ|ಮೀಯೋಣ|ಮೀುತ್ತಾಳೆ|ಮಿಂದೀತು|ಮೀಯದೆ|ಮೀಯುವೆವು|ಮಿಂದಳು|ಮೀಯೆನು|ಮಿಂದಿ|ಮೀಯುವಿ|ಮೀಗಳಿಂದ|ಮಿಂದಾನು|ಮೀ}ಯಲಿಕ್ಕೆ (mī}yalikke)|ಮೀಯಿಂದ|ಮೀಯುವ|ಮಿಂದೆವು|ಮೀುತ್ತಾನೆ|ಮೀುತ್ತಾರೆ|ಮೀಯುವಳು|ಮೀಯದು|ಮೀುತ್ತೀ|ಮಿಂದೆ|ಮಿಂದರೆ|ಮಿಂದುವು|ಮೀಯುವರು|ಮಿಂದೀಯೆ|ಮಿಂದೇವು|ಮೀುತ್ತವೆ|ಮಿಂದಿರಿ|ಮೀಯರಿ|ಮೀಯು|ಮೀಗಳಿಗೆ|ಮೀಯದ|ಮೀಯಲಿ|ಮೀಯೆವು|ಮಿಂದನು|ಮಿಂದ|{ಮೀಯಿರಿ ({mīyiri)|ಮೀಗಳ	<i>noun</i><br><ol><li>bath</li></ol><br><i>verb</i><br><ol><li>(intransitive) to bathe, take a bath</li><li>(transitive) to bathe, give a bath</li></ol>
ಮೀನು|mīnu	<i>noun</i><br><ol><li>fish</li></ol>
ಮೀರು|ಮೀರಿಯಾಳು|ಮೀರಿದ|ಮೀರುವೆ|ಮೀರಿದಿ|ಮೀರುವರು|ಮೀರವು|ಮೀರುತ್ತಾನೆ|ಮೀರಿದರೆ|ಮೀರಲಿ|ಮೀರುತ್ತವೆ|ಮೀರಿದೆ|ಮೀರದು|ಮೀರಳು|ಮೀರಿಯಾರು|ಮೀರುವಿ|ಮೀರುತ್ತಾಳೆ|ಮೀರೀರಿ|ಮೀರಿದಿರಿ|ಮೀರಿದೆವು|ಮೀರೆವು|ಮೀರದ|ಮೀರುವಾ|ಮೀರುವಳು|ಮೀರುವೆವು|ಮೀರೋಣ|mīru|ಮೀರುತ್ತೀಯೆ|ಮೀರುತ್ತೇನೆ|ಮೀರುತ್ತಾರೆ|ಮೀರುವುವು|ಮೀರುತ್ತೀರಿ|ಮೀರರಿ|ಮೀರಿಯೇವು|ಮೀರಲು|ಮೀರುತ್ತೀ|ಮೀರೀತು|ಮೀರಿದಳು|ಮೀರಿದೆನು|ಮೀರುತ್ತದೆ|ಮೀರೆನು|ಮೀರುತ್ತ|ಮೀರೀಯೆ|ಮೀರದೆ|ಮೀರಿಯಾವು|ಮೀರುವುದು|ಮೀರಯೇನು|ಮೀರನು|ಮೀರ|ಮೀರಿದನು|ಮೀರತು|ಮೀರುವನು|ಮೀರುವಿರಿ|ಮೀರುವೆನು|ಮೀರಿದುವು|ಮೀರೆ|ಮೀರುವ|ಮೀರಿದರು|ಮೀರರು|ಮೀರುತ್ತೇವೆ|ಮೀರಿರಿ|ಮೀರಲಿಕ್ಕೆ|ಮೀರಿಯಾನು	<i>verb</i><br><ol><li>to transcend, exceed, surpass</li><li>to contravene, disobey, infringe</li></ol>
ಮೀಸೆ|mīse	<i>noun</i><br><ol><li>moustache</li></ol>
ಮು|mu	<i>character</i><br><ol><li>The Kannada letter mu.</li></ol>
ಮುಂಗುಸಿ|muṅgusi	<i>noun</i><br><ol><li>mongoose</li></ol>
ಮುಂದಿನ|mundina	<i>adj</i><br><ol><li>next, subsequent</li></ol>
ಮುಂಬೈ|mumbai	<i>name</i><br><ol><li>Mumbai (a megacity, the capital of Maharashtra, India)</li></ol>
ಮುಖ|mukha	<i>noun</i><br><ol><li>the face</li></ol>
ಮುಖ್ಯ|mukhya	<i>adj</i><br><ol><li>prime, main, important</li></ol>
ಮುಗ್ಧ|mugdha	<i>adj</i><br><ol><li>innocent, naive</li></ol>
ಮುಟ್ಟು|muṭṭu	<i>verb</i><br><ol><li>to touch</li></ol><br><i>noun</i><br><ol><li>menstruation</li></ol>
ಮುಡಿಪು|muḍipu	<i>noun</i><br><ol><li>devotion</li></ol>
ಮುಳ್ಳು|muḷḷu	<i>noun</i><br><ol><li>thorn</li><li>a pointed thing as in prickle, sting, hand of a clock, tongue of a balance, fork etc.</li></ol>
ಮುಷ್ಟಿ|muṣṭi	<i>noun</i><br><ol><li>fist</li></ol>
ಮುಹೂರ್ತ|muhūrta	<i>noun</i><br><ol><li>an astrologically auspicious time, for any ceremony such as a wedding or any other purpose</li></ol>
ಮೂಕ|mūka	<i>adj</i><br><ol><li>dumb, mute, speechless</li></ol><br><i>noun</i><br><ol><li>a dumb man</li></ol>
ಮೂಗು|mūgu	<i>noun</i><br><ol><li>nose</li></ol>
ಮೂಢ|mūḍha	<i>adj</i><br><ol><li>foolish, stupid</li></ol>
ಮೂತ್ರ|mūtra	<i>noun</i><br><ol><li>(formal) urine</li></ol>
ಮೂರು|mūru	<i>num</i><br><ol><li>three (numeral: ೩ (3))</li></ol>
ಮೂರ್ಖ|mūrkha	<i>adj</i><br><ol><li>stupid</li></ol><br><i>noun</i><br><ol><li>a stupid man</li></ol>
ಮೂಲ|mūla	<i>noun</i><br><ol><li>fountain</li></ol>
ಮೂಸಂಬಿ|mūsambi	<i>noun</i><br><ol><li>mousambi</li></ol>
ಮೃಗ|mṛga	<i>noun</i><br><ol><li>a beast, wild animal</li><li>a deer</li></ol>
ಮೃತ|mṛta	<i>adj</i><br><ol><li>dead, deceased</li></ol>
ಮೃತ್ಯು|mṛtyu	<i>noun</i><br><ol><li>death</li></ol>
ಮೃದು|mṛdu	<i>adj</i><br><ol><li>soft, gentle</li></ol>
ಮೆಂತೆ|mente	<i>noun</i><br><ol><li>fenugreek</li></ol>
ಮೆಂಥೆಯ|meṅtheya	<i>noun</i><br><ol><li>Flame of the Forest</li></ol>
ಮೆದುಳು|meduḷu	<i>noun</i><br><ol><li>brain</li></ol>
ಮೆಲ್ನಗೆ|melnage	<i>noun</i><br><ol><li>smile</li></ol>
ಮೇ ತಿಂಗಳು|mē tiṅgaḷu	<i>name</i><br><ol><li>May</li></ol>
ಮೇಂಥಿ|mēnthi	<i>noun</i><br><ol><li>fenugreek</li></ol>
ಮೇಕೆ|mēke	<i>noun</i><br><ol><li>goat</li></ol>
ಮೇಘ|mēgha	<i>noun</i><br><ol><li>a cloud</li></ol>
ಮೇಜು|mēju	<i>noun</i><br><ol><li>table</li></ol>
ಮೇಣ|mēṇa	<i>noun</i><br><ol><li>paraffin</li></ol>
ಮೇರಿ|mēri	<i>name</i><br><ol><li>(Christianity) Mary</li></ol>
ಮೇಲೆ|mēle	<i>adv</i><br><ol><li>up, above</li><li>on, over, on top of</li></ol>
ಮೇಷ್ಟ್ರು|mēṣṭru	<i>noun</i><br><ol><li>a master; a school teacher.</li></ol>
ಮೇಸ್ತ್ರಿ|mēstri	<i>noun</i><br><ol><li>a leader of a group of workers or coolies; a foreman.</li></ol>
ಮೈ|mai	<i>noun</i><br><ol><li>body</li></ol>
ಮೈಸೂರು|maisūru	<i>name</i><br><ol><li>Mysore</li></ol>
ಮೊಂಡು|moṇḍu	<i>adj</i><br><ol><li>persistent</li><li>pertinacious</li><li>refractory</li><li>blunt</li><li>contumacious</li></ol>
ಮೊಟ್ಟೆ|moṭṭe	<i>noun</i><br><ol><li>egg</li></ol>
ಮೊಣಗಾಲು|moṇagālu	<i>noun</i><br><ol><li>knee</li></ol>
ಮೊಳಕೆ|moḷake	<i>noun</i><br><ol><li>seedling</li></ol>
ಮೊಸರು|mosaru	<i>noun</i><br><ol><li>curd</li><li>yoghurt</li></ol>
ಮೊಸಳೆ|mosaḷe	<i>noun</i><br><ol><li>a crocodile</li></ol>
ಮೋಹ|mōha	<i>noun</i><br><ol><li>wonder, amazement</li><li>love, lust, infatuation</li></ol>
ಮೌಕ್ತಿಕ|mauktika	<i>noun</i><br><ol><li>pearl</li></ol>
ಮ್ಲೇಚ್ಛ|mlēccha	<i>noun</i><br><ol><li>barbarian, foreigner, savage</li></ol>
ಯ|ya	<i>character</i><br><ol><li>The Kannada letter ya.</li></ol>
ಯಂತ್ರ|yantra	<i>noun</i><br><ol><li>a machine, device</li></ol>
ಯಕೃತ್ತು|yakṛttu	<i>noun</i><br><ol><li>the liver</li></ol>
ಯಕ್ಷ|yakṣa	<i>noun</i><br><ol><li>(Hinduism, Buddhism) yaksha</li></ol>
ಯಜ್ಞ|yajña	<i>noun</i><br><ol><li>(Hinduism) yajna; ritual sacrifice</li></ol>
ಯಶಸ್ಸು|yaśassu	<i>noun</i><br><ol><li>success</li></ol>
ಯಾ|yā	<i>conj</i><br><ol><li>or</li></ol>
ಯಾತ್ರಾರ್ಥಿ|ಯಾತ್ರಾರ್ಥಿಗಳನ್ನು|ಯಾತ್ರಾರ್ಥಿಯನ್ನು|yātrārthi|ಯಾತ್ರಾರ್ಥಿಯ|ಯಾತ್ರಾರ್ಥಿಯಿಂದ|ಯಾತ್ರಾರ್ಥಿಗೆ|ಯಾತ್ರಾರ್ಥಿಗಳಿಂದ|ಯಾತ್ರಾರ್ಥಿಗಳು|ಯಾತ್ರಾರ್ಥಿಯು|ಯಾತ್ರಾರ್ಥಿಗಳಿಗೆ|ಯಾತ್ರಾರ್ಥಿಗಳ	<i>noun</i><br><ol><li>pilgrim (one who travels)</li></ol>
ಯಾತ್ರಿಕ|ಯಾತ್ರಿಕರನ್ನು|ಯಾತ್ರಿಕರಿಗೆ|ಯಾತ್ರಿಕನು|ಯಾತ್ರಿಕನಿಂದ|ಯಾತ್ರಿಕನ|ಯಾತ್ರಿಕನಿಗೆ|ಯಾತ್ರಿಕರಿಂದ|yātrika|ಯಾತ್ರಿಕನನ್ನು|ಯಾತ್ರಿಕರು|ಯಾತ್ರಿಕರ	<i>noun</i><br><ol><li>pilgrim (one who travels)</li></ol>
ಯಾವಾಗ|yāvāga	<i>adv</i><br><ol><li>(interrogative) when</li></ol>
ಯುಕ್ತ|yukta	<i>adj</i><br><ol><li>(formal) joined, united</li></ol>
ಯುದ್ಧ|yuddha	<i>noun</i><br><ol><li>battle</li></ol>
ಯುರೋಪ|ಯುರೋಪಗಳಿಂದ|ಯುರೋಪದ|ಯುರೋಪವನ್ನು|ಯುರೋಪಗಳು|yurōpa|ಯುರೋಪವು|ಯುರೋಪಕ್ಕೆ|ಯುರೋಪಗಳ|ಯುರೋಪದಿಂದ|ಯುರೋಪಗಳಿಗೆ|ಯುರೋಪಗಳನ್ನು	<i>noun</i><br><ol><li>Europe</li></ol>
ಯುರೋಪ್|yurōp	<i>name</i><br><ol><li>Europe</li></ol>
ಯೋಗ್ಯ|yōgya	<i>adj</i><br><ol><li>fit for, deserving</li><li>usable</li></ol>
ಯೌವನ|yauvana	<i>noun</i><br><ol><li>youth</li><li>adolescence</li></ol>
ರ|ra	<i>character</i><br><ol><li>The Kannada letter ra.</li></ol>
ರಂಜಕ|rañjaka	<i>noun</i><br><ol><li>phosphorous</li></ol>
ರಂಡೆ|raṇḍe	<i>noun</i><br><ol><li>(vulgar, derogatory) a prostitute, whore; a promiscuous woman, slut</li></ol>
ರಕ್ಕಸ|rakkasa	<i>noun</i><br><ol><li>demon, fiend, monster</li></ol>
ರಕ್ತ|rakta	<i>noun</i><br><ol><li>blood</li></ol>
ರಕ್ಷಿಸು|rakṣisu	<i>verb</i><br><ol><li>to protect, defend, guard</li></ol>
ರಜೆ|raje	<i>noun</i><br><ol><li>holiday</li><li>leave of absence</li></ol>
ರಣಕಹಳೆ|raṇakahaḷe	<i>noun</i><br><ol><li>bugle</li></ol>
ರಣಗೊಲೆ|raṇagole	<i>noun</i><br><ol><li>bloodbath</li></ol>
ರಣಹದ್ದು|raṇahaddu	<i>noun</i><br><ol><li>a vulture</li></ol>
ರಥ|ratha	<i>noun</i><br><ol><li>a chariot</li></ol>
ರದ್ದು|raddu	<i>adj</i><br><ol><li>cancelled, rejected; null and void</li></ol>
ರಮಣೀಯ|ramaṇīya	<i>adj</i><br><ol><li>pleasing, delightful</li><li>beautiful, lovely, charming</li></ol>
ರವಿ|ravi	<i>noun</i><br><ol><li>the Sun</li></ol>
ರವಿವಾರ|ravivāra	<i>noun</i><br><ol><li>Sunday; the first day of the week.</li></ol>
ರಷ್ಯಾ|raṣyā	<i>name</i><br><ol><li>Russia</li></ol>
ರಸಜ್ಞ|rasajña	<i>noun</i><br><ol><li>epicure</li></ol>
ರಸೀದಿ|rasīdi	<i>noun</i><br><ol><li>receipt</li></ol>
ರಸ್ತೆ|ರಸ್ತೆಗಳನ್ನು|ರಸ್ತೆಗೆ|raste|ರಸ್ತೆಗಳಿಗೆ|ರಸ್ತೆಯಿಂದ|ರಸ್ತೆಯನ್ನು|ರಸ್ತೆಗಳು|ರಸ್ತೆಗಳ|ರಸ್ತೆಗಳಿಂದ|ರಸ್ತೆಯ|ರಸ್ತೆಯು	<i>noun</i><br><ol><li>road</li></ol>
ರಹಸ್ಯ|rahasya	<i>noun</i><br><ol><li>secret, mystery</li></ol>
ರಾಕ್ಷಸ|rākṣasa	<i>noun</i><br><ol><li>demon, monster</li></ol>
ರಾಜ|rāja	<i>noun</i><br><ol><li>a king</li></ol>
ರಾಜಪುತ್ರ|rājaputra	<i>noun</i><br><ol><li>(literary, rare) the son of a king; a prince</li></ol>
ರಾಜ್ಯ|rājya	<i>noun</i><br><ol><li>kingdom, realm, state</li></ol>
ರಾಣಿ|ರಾಣಿಯರು|ರಾಣಿಯರಿಂದ|ರಾಣಿಗೆ|ರಾಣಿಯರಿಗೆ|rāṇi|ರಾಣಿಯನ್ನು|ರಾಣಿಯಿಂದ|ರಾಣಿಯರ|ರಾಣಿಯ|ರಾಣಿಯು|ರಾಣಿಯರನ್ನು	<i>noun</i><br><ol><li>queen</li></ol>
ರಾತ್ರಿ|rātri	<i>noun</i><br><ol><li>night</li></ol>
ರಾಮ|ರಾಮರು|ರಾಮರ|ರಾಮರಿಗೆ|ರಾಮನು|ರಾಮರಿಂದ|ರಾಮರನ್ನು|ರಾಮನ|ರಾಮನಿಗೆ|ರಾಮನನ್ನು|ರಾಮನಿಂದ|rāma	<i>name</i><br><ol><li>Rama</li></ol>
ರಾಮಚಂದ್ರ|rāmacandra	<i>name</i><br><ol><li>(Hinduism) a name of Rama</li></ol>
ರಾಯ|rāya	<i>noun</i><br><ol><li>(rare) a king</li><li>an honorific suffix added to a male personal name, often used by kings, chieftains, headmen, etc</li></ol>
ರಾಷ್ಟ್ರ|rāṣṭra	<i>noun</i><br><ol><li>nation, state</li></ol>
ರಾಷ್ಟ್ರಪತಿ|rāṣṭrapati	<i>noun</i><br><ol><li>president</li></ol>
ರಿ|ri	<i>character</i><br><ol><li>The Kannada letter ri.</li></ol>
ರಿಕ್ತ|rikta	<i>adj</i><br><ol><li>empty, blank, vacant</li></ol>
ರಿಪೇರಿ|ripēri	<i>noun</i><br><ol><li>the act of repairing something</li></ol>
ರು|ru	<i>character</i><br><ol><li>The Kannada letter ru.</li></ol>
ರುದ್ರ|rudra	<i>name</i><br><ol><li>(Vedic religion) Rudra</li></ol>
ರುದ್ರಭೂಮಿ|rudrabhūmi	<i>noun</i><br><ol><li>a crematorium</li></ol>
ರುದ್ರರಮಣೀಯ|rudraramaṇīya|rudra ramaṇīya|ರುದ್ರ ರಮಣೀಯ	<i>adj</i><br><ol><li>pleasingly or excitingly fearsome; awe inspiring; scary but causing thrill; thrilling; breathtaking</li><li>(of weather) violent, stormy</li></ol>
ರೂಪ|rūpa	<i>noun</i><br><ol><li>form, figure</li><li>beauty</li></ol>
ರೆ|re	<i>character</i><br><ol><li>The Kannada letter re.</li></ol>
ರೇತಸ್ಸು|rētassu	<i>noun</i><br><ol><li>semen, seminal fluid</li></ol>
ರೈತ|ರೈತರ|ರೈತನ|ರೈತಳು|ರೈತರನ್ನು|ರೈತನಿಗೆ|ರೈತನು|ರೈತರಿಂದ|ರೈತನನ್ನು|ರೈತರು|raita|ರೈತರಿಗೆ|ರೈತನಿಂದ	<i>noun</i><br><ol><li>farmer, peasant, ryot, cultivator, agriculturist</li></ol>
ರೊಕ್ಕ|rokka	<i>noun</i><br><ol><li>(finance) cash, ready money</li></ol>
ರೋಗ|rōga	<i>noun</i><br><ol><li>disease, illness, ailment</li></ol>
ರೋಗ ನಿರೋಧಕ ಶಕ್ತಿ|rōga nirōdhaka śakti	<i>noun</i><br><ol><li>immunity; resistance to disease</li></ol>
ರೋದನೆ|rōdane	<i>noun</i><br><ol><li>the act of wailing, weeping, crying</li></ol>
ರೋದಿಸು|rōdisu	<i>verb</i><br><ol><li>(rare, literary) to weep, cry</li></ol>
ಱ|ṟa	<i>character</i><br><ol><li>The Kannada letter ṟa.</li></ol>
ಲ|la	<i>character</i><br><ol><li>The Kannada letter la.</li></ol>
ಲಕ್ಷ್ಮಿ|lakṣmi	<i>name</i><br><ol><li>Lakshmi (Hindu deity)</li></ol>
ಲಗ್ನ|lagna	<i>noun</i><br><ol><li>(literary) marriage or wedding</li></ol>
ಲಘು|laghu	<i>adj</i><br><ol><li>(formal) light, not heavy</li></ol>
ಲಜ್ಜೆ|lajje	<i>noun</i><br><ol><li>modesty, shyness, bashfulness</li><li>shame</li><li>embarrassment</li></ol>
ಲವಂಗ|lavaṅga	<i>noun</i><br><ol><li>clove</li></ol>
ಲಾ|lā	<i>character</i><br><ol><li>The Kannada letter lā.</li></ol>
ಲಿಂಗ|liṅga	<i>noun</i><br><ol><li>(Hinduism) lingam</li><li>gender, sex</li><li>the male generative organ; the penis</li></ol>
ಲೆಪ್ಟಾನ್|lepṭān	<i>noun</i><br><ol><li>(physics) lepton</li></ol>
ಲೇಪಿಸು|lēpisu	<i>verb</i><br><ol><li>to smear</li></ol>
ಲೈಬೀರಿಯ|laibīriya	<i>name</i><br><ol><li>Liberia (a country in West Africa)</li></ol>
ಲೋಕ|lōka	<i>noun</i><br><ol><li>world</li></ol>
ಲೋಟ|lōṭa|ಲೋಟವನ್ನು|ಲೋಟಗಳಿಗೆ|ಲೋಟಗಳ|ಲೋಟಗಳಿಂದ|ಲೋಟದಿಂದ|ಲೋಟದ|ಲೋಟಗಳನ್ನು|ಲೋಟವು|ಲೋಟಗಳು|ಲೋಟಕ್ಕೆ	<i>noun</i><br><ol><li>A cup</li><li>A tumbler</li></ol>
ಳ|ḷa	<i>character</i><br><ol><li>The Kannada letter ḷa.</li></ol>
ವ|tva	<i>character</i><br><ol><li>The Kannada letter va.</li></ol>
ವಜ್ಜೆ|ojje|vajje|ಒಜ್ಜೆ	<i>adj</i><br><ol><li>heavy</li></ol><br><i>noun</i><br><ol><li>burden, load</li></ol>
ವಜ್ರ|vajra	<i>noun</i><br><ol><li>diamond</li></ol>
ವಧು|vadhu	<i>noun</i><br><ol><li>(formal) a bride</li></ol>
ವನ|ವನದಿಂದ|ವನಗಳು|ವನಗಳಿಂದ|ವನದ|ವನಗಳಿಗೆ|ವನಗಳನ್ನು|ವನವನ್ನು|ವನಕ್ಕೆ|vana|ವನವು|ವನಗಳ	<i>noun</i><br><ol><li>forest (dense collection of trees)</li></ol>
ವಮ್ಶ|vamśa	<i>noun</i><br><ol><li>dynasty, lineage</li></ol>
ವಯಸ್ಸು|vayassu	<i>noun</i><br><ol><li>age</li></ol>
ವರಕು|varaku	<i>noun</i><br><ol><li>(Havyaka) Alternative form of ಒರಕು (oraku, “sleep”)</li></ol>
ವರ್ಣ|varṇa	<i>noun</i><br><ol><li>(literary) color</li></ol>
ವರ್ಣಭೇದ|varṇabhēda	<i>noun</i><br><ol><li>(neologism) racism</li></ol>
ವರ್ಷ|varṣa	<i>noun</i><br><ol><li>a year</li></ol>
ವಳೆ|vaḷe	<i>noun</i><br><ol><li>rain</li></ol>
ವಸಂತ|vasanta	<i>noun</i><br><ol><li>spring (season)</li></ol>
ವಸಾರಾ|vasārā	<i>noun</i><br><ol><li>verandah</li></ol>
ವಸ್ತ್ರ|vastra	<i>noun</i><br><ol><li>cloth</li><li>garment, dress</li></ol>
ವಾ|vā	<i>conj</i><br><ol><li>or</li></ol>
ವಾಕ್ಕು|vākku	<i>noun</i><br><ol><li>(rare, literary) speech, talk, language, voice</li></ol>
ವಾಕ್ಯ|ವಾಕ್ಯದ|ವಾಕ್ಯಕ್ಕೆ|ವಾಕ್ಯಗಳ|ವಾಕ್ಯದಿಂದ|ವಾಕ್ಯಗಳಿಂದ|ವಾಕ್ಯಗಳಿಗೆ|vākya|ವಾಕ್ಯವು|ವಾಕ್ಯವನ್ನು|ವಾಕ್ಯಗಳನ್ನು|ವಾಕ್ಯಗಳು	<i>noun</i><br><ol><li>(grammar) sentence</li><li>(Christianity) Logos, divine word</li></ol>
ವಾತಾವರಣ|vātāvaraṇa	<i>noun</i><br><ol><li>weather</li></ol>
ವಾಯು|vāyu	<i>noun</i><br><ol><li>(literary, formal) air</li></ol><br><i>name</i><br><ol><li>(Hinduism) Vayu, the Hindu god of wind</li></ol>
ವಿ|vi	<i>character</i><br><ol><li>The Kannada letter vi.</li></ol>
ವಿಕಟ|vikaṭa	<i>adj</i><br><ol><li>frightful, hideous</li><li>huge</li></ol>
ವಿಕೃತ|vikṛta	<i>adj</i><br><ol><li>misshapen, distorted, strange, disgusting</li></ol>
ವಿಕ್ಷನರಿ|vikṣanari	<i>name</i><br><ol><li>Wiktionary</li></ol>
ವಿದ್ಯಾರ್ಥಿ|vidyārthi	<i>noun</i><br><ol><li>student</li></ol>
ವಿದ್ಯುತ್ತು|ವಿದ್ಯುತ್ತನ್ನು|ವಿದ್ಯುತ್ತುಗಳನ್ನು|ವಿದ್ಯುತ್ತಿನ|ವಿದ್ಯುತ್ತುಗಳು|ವಿದ್ಯುತ್ತುಗಳಿಂದ|ವಿದ್ಯುತ್ತುಗಳ|ವಿದ್ಯುತ್ತಿನಿಂದ|ವಿದ್ಯುತ್ತುಗಳಿಗೆ|ವಿದ್ಯುತ್ತಿಗೆ|vidyuttu	<i>noun</i><br><ol><li>electricity</li></ol>
ವಿಧವೆ|vidhave	<i>noun</i><br><ol><li>a widow</li></ol>
ವಿಮಾನ|vimāna	<i>noun</i><br><ol><li>airplane, aircraft</li></ol>
ವಿಮಾನ ನಿಲ್ದಾಣ|vimāna nildāṇa	<i>noun</i><br><ol><li>airport</li></ol>
ವಿಮಾನಯಾನ|vimānayāna	<i>noun</i><br><ol><li>airline</li></ol>
ವಿಮುಕ್ತಿ|vimukti|ವಿಮುಕ್ತಿಗಳ|ವಿಮುಕ್ತಿಯನ್ನು|ವಿಮುಕ್ತಿಗಳಿಗೆ|ವಿಮುಕ್ತಿಯು|ವಿಮುಕ್ತಿಗಳಿಂದ|ವಿಮುಕ್ತಿಯಿಂದ|ವಿಮುಕ್ತಿಗೆ|ವಿಮುಕ್ತಿಗಳು|ವಿಮುಕ್ತಿಯ|ವಿಮುಕ್ತಿಗಳನ್ನು	<i>noun</i><br><ol><li>salvation</li></ol>
ವಿಮೋಚನೆ|ವಿಮೋಚನೆಗಳಿಂದ|ವಿಮೋಚನೆಗಳನ್ನು|vimōcane|ವಿಮೋಚನೆಗಳಿಗೆ|ವಿಮೋಚನೆಯಿಂದ|ವಿಮೋಚನೆಯು|ವಿಮೋಚನೆಗಳು|ವಿಮೋಚನೆಯ|ವಿಮೋಚನೆಗಳ|ವಿಮೋಚನೆಗೆ|ವಿಮೋಚನೆಯನ್ನು	<i>noun</i><br><ol><li>salvation</li></ol>
ವಿರಾಜಮಾನ|virājamāna	<i>adj</i><br><ol><li>seated; on the throne</li><li>reigning, ruling, in power</li><li>radiant, gleaming</li></ol>
ವಿಳಾಸ|viḷāsa	<i>noun</i><br><ol><li>address</li></ol>
ವಿವರ್ಣ|vivarṇa	<i>adj</i><br><ol><li>pale, colorless</li></ol>
ವಿಷ|viṣa	<i>noun</i><br><ol><li>poison, venom</li></ol>
ವಿಷ್ಣು|viṣṇu	<i>name</i><br><ol><li>Vishnu (Hindu deity)</li></ol>
ವಿಸ್ಮಯ|vismaya	<i>noun</i><br><ol><li>wonder, amazement</li></ol>
ವೀರ|vīra	<i>noun</i><br><ol><li>hero</li></ol>
ವು|vu	<i>character</i><br><ol><li>The Kannada letter vu.</li></ol>
ವೃಕ್ಷ|vṛkṣa	<i>noun</i><br><ol><li>a tree</li></ol>
ವೃತ್ತಪತ್ರಿಕೆ|vṛttapatrike	<i>noun</i><br><ol><li>newspaper</li></ol>
ವೃದ್ಧ|vṛddha	<i>adj</i><br><ol><li>old, mature</li></ol>
ವೆ|ve	<i>character</i><br><ol><li>The Kannada letter ve.</li></ol>
ವೈಷ್ಣವ|vaiṣṇava	<i>noun</i><br><ol><li>a worshipper of Vishnu, a follower of Vaishnavism</li></ol>
ವ್ಯಕ್ತಿ|vyakti	<i>noun</i><br><ol><li>person</li></ol>
ಶ|śa	<i>character</i><br><ol><li>The Kannada letter śa.</li></ol>
ಶಂಕರ|śaṅkara	<i>name</i><br><ol><li>(Hinduism) a name of Shiva</li></ol>
ಶಂಕೆ|śaṅke	<i>noun</i><br><ol><li>suspicion, doubt</li></ol>
ಶಕೃತ್ತು|śakṛttu	<i>noun</i><br><ol><li>(rare) dung</li></ol>
ಶಕ್ತಿ|ಶಕ್ತಿಯ|śakti|ಶಕ್ತಿಗಳ|ಶಕ್ತಿಗೆ|ಶಕ್ತಿಯನ್ನು|ಶಕ್ತಿಯು|ಶಕ್ತಿಗಳು|ಶಕ್ತಿಯಿಂದ|ಶಕ್ತಿಗಳಿಗೆ|ಶಕ್ತಿಗಳಿಂದ|ಶಕ್ತಿಗಳನ್ನು	<i>noun</i><br><ol><li>energy</li><li>power</li><li>capability, strength</li></ol>
ಶನಿವಾರ|śanivāra	<i>noun</i><br><ol><li>Saturday; the seventh day of the week.</li></ol>
ಶಬ್ದ|śabda	<i>noun</i><br><ol><li>word</li><li>sound, noise</li></ol>
ಶರೀರ|śarīra	<i>noun</i><br><ol><li>the body</li></ol>
ಶಾಟ|śāṭa	<i>noun</i><br><ol><li>pubic hair</li></ol><br><i>intj</i><br><ol><li>general expression for any strong emotion</li></ol>
ಶಾಯಿ|śāyi	<i>noun</i><br><ol><li>ink</li></ol>
ಶಾರದಿ|śāradi	<i>noun</i><br><ol><li>blackboard tree</li></ol>
ಶಿಫಾರಸು|ಶಿಫಾರಸಿನ|ಶಿಫಾರಸುಗಳ|ಶಿಫಾರಸುಗಳನ್ನು|ಶಿಫಾರಸಿನಿಂದ|ಶಿಫಾರಸುಗಳಿಗೆ|ಶಿಫಾರಸಿಗೆ|ಶಿಫಾರಸುಗಳು|śiphārasu|ಶಿಫಾರಸುಗಳಿಂದ|ಶಿಫಾರಸನ್ನು	<i>noun</i><br><ol><li>recommendation, endorsement</li></ol>
ಶಿವ|śiva	<i>name</i><br><ol><li>Shiva (Hindu deity)</li></ol>
ಶಿಶು|śiśu	<i>noun</i><br><ol><li>infant</li></ol>
ಶಿಶ್ನ|śiśna	<i>noun</i><br><ol><li>membrum virile</li></ol>
ಶಿಷ್ಯ|śiṣya	<i>noun</i><br><ol><li>pupil, disciple, student</li></ol>
ಶುಂಠಿ|śuṇṭhi	<i>noun</i><br><ol><li>ginger</li></ol>
ಶುಕ್ರ|śukra	<i>name</i><br><ol><li>Venus</li></ol><br><i>noun</i><br><ol><li>semen, sperm</li></ol><br><i>adj</i><br><ol><li>bright</li></ol>
ಶುಕ್ರವಾರ|śukravāra	<i>noun</i><br><ol><li>Friday; the sixth day of the week.</li></ol>
ಶೂನ್ಯ|śūnya	<i>num</i><br><ol><li>zero (numeral: ೦ (0))</li></ol>
ಶೂರ|śūra	<i>adj</i><br><ol><li>brave, heroic</li></ol><br><i>noun</i><br><ol><li>hero</li></ol>
ಶೈವ|śaiva	<i>noun</i><br><ol><li>a worshipper of Shiva, a follower of Shaivism</li></ol>
ಶೋಕ|śōka	<i>noun</i><br><ol><li>sorrow</li></ol>
ಶೌಚಾಲಯ|śaucālaya	<i>noun</i><br><ol><li>toilet; bathroom</li></ol>
ಶೌರ್ಯ|śaurya	<i>noun</i><br><ol><li>heroism, bravery, valor</li></ol>
ಶ್ರದ್ಧೆ|śraddhe	<i>noun</i><br><ol><li>faith, belief</li><li>dedication</li></ol>
ಶ್ರೀ	<i>prefix</i><br><ol><li>(honorific) sir, lord, master</li></ol>
ಶ್ರೀನಿವಾಸ|śrīnivāsa	<i>name</i><br><ol><li>a name of Vishnu</li></ol>
ಶ್ರೇಷ್ಠ|śrēṣṭha	<i>adj</i><br><ol><li>great, noble, notable</li><li>meritorious, best</li></ol>
ಶ್ಲೋಕ|ślōka	<i>noun</i><br><ol><li>(Hinduism) verse, line (of a holy text)</li></ol>
ಶ್ವಾನ|śvāna	<i>noun</i><br><ol><li>a dog</li></ol>
ಶ್ವಾಸ|śvāsa	<i>noun</i><br><ol><li>breath</li></ol>
ಶ್ವೇತ|śvēta	<i>adj</i><br><ol><li>(literary) white</li></ol>
ಷ|ṣa	<i>character</i><br><ol><li>The Kannada letter ṣa.</li></ol>
ಷಟ್ಕೋನ|ṣaṭkōna	<i>noun</i><br><ol><li>hexagon</li></ol>
ಸ|sa	<i>character</i><br><ol><li>The Kannada letter sa.</li></ol>
ಸಂಕೇತ|saṅkēta	<i>noun</i><br><ol><li>sign, signal</li></ol>
ಸಂಕ್ಷಿಪ್ತ|saṅkṣipta	<i>adj</i><br><ol><li>heaped or piled up</li><li>brief, abbreviated</li></ol><br><i>noun</i><br><ol><li>summary; short or abbreviated form</li></ol>
ಸಂಖ್ಯೆ|saṅkhye	<i>noun</i><br><ol><li>number</li><li>figure</li><li>numeral</li></ol>
ಸಂಗತಿಗಳು|saṅgatigaḷu	<i>noun</i><br><ol><li>lore</li></ol>
ಸಂಜೆ|sañje	<i>noun</i><br><ol><li>evening</li></ol>
ಸಂತೋಷ|ಸಂತೋಷಕ್ಕೆ|ಸಂತೋಷವು|ಸಂತೋಷಗಳಿಗೆ|ಸಂತೋಷಗಳ|ಸಂತೋಷಗಳಿಂದ|ಸಂತೋಷದಿಂದ|ಸಂತೋಷವನ್ನು|ಸಂತೋಷಗಳು|santōṣa|ಸಂತೋಷದ|ಸಂತೋಷಗಳನ್ನು	<i>noun</i><br><ol><li>happiness, joy, gladness</li></ol>
ಸಂದೇಹ|ಸಂದೇಹಗಳು|ಸಂದೇಹವನ್ನು|ಸಂದೇಹವು|ಸಂದೇಹಗಳನ್ನು|ಸಂದೇಹದಿಂದ|ಸಂದೇಹಗಳಿಂದ|ಸಂದೇಹಗಳ|ಸಂದೇಹದ|ಸಂದೇಹಕ್ಕೆ|sandēha|ಸಂದೇಹಗಳಿಗೆ	<i>noun</i><br><ol><li>doubt, uncertainty</li></ol>
ಸಂಪಿಗೆ|sampige	<i>noun</i><br><ol><li>the Michelia champaca flower</li></ol>
ಸಂಯುಕ್ತ|saṃyukta	<i>adj</i><br><ol><li>united</li></ol>
ಸಂವತ್ಸರ|saṃvatsara	<i>noun</i><br><ol><li>(Hinduism) Samvatsara; a Hindu Jovian year</li></ol>
ಸಂಸ್ಕೃತ|ಸಂಸ್ಕೃತವನ್ನು|ಸಂಸ್ಕೃತದಿಂದ|saṃskṛta|ಸಂಸ್ಕೃತಗಳಿಗೆ|ಸಂಸ್ಕೃತಕ್ಕೆ|ಸಂಸ್ಕೃತಗಳು|ಸಂಸ್ಕೃತವು|ಸಂಸ್ಕೃತಗಳ|ಸಂಸ್ಕೃತಗಳಿಂದ|ಸಂಸ್ಕೃತದ|ಸಂಸ್ಕೃತಗಳನ್ನು	<i>name</i><br><ol><li>Sanskrit</li></ol>
ಸಂಸ್ಥೆ|saṃsthe	<i>noun</i><br><ol><li>association, body, company, institute, organization, society</li><li>enterprise</li><li>establishment, institution</li><li>club</li><li>memorial</li><li>union</li></ol>
ಸಕತ್|sakat	<i>adj</i><br><ol><li>serious, severe, vehement, acute</li><li>good, impressive, remarkable</li></ol>
ಸಕ್ಕರೆ|sakkare	<i>noun</i><br><ol><li>sugar</li></ol>
ಸಕ್ಕರೆ ಕಾಯಿಲೆ|sakkare kāyile	<i>noun</i><br><ol><li>diabetes</li></ol>
ಸಗಣಿ|sagaṇi	<i>noun</i><br><ol><li>cowdung</li></ol>
ಸಡಿಲು|saḍilu	<i>adj</i><br><ol><li>loose, slack</li></ol>
ಸಣ್ಣ|saṇṇa	<i>adj</i><br><ol><li>small, little</li></ol>
ಸಣ್ಣಗಿಡ|ಸಣ್ಣಗಿಡಗಳು|ಸಣ್ಣಗಿಡಕ್ಕೆ|ಸಣ್ಣಗಿಡಗಳಿಗೆ|ಸಣ್ಣಗಿಡಗಳ|ಸಣ್ಣಗಿಡವನ್ನು|ಸಣ್ಣಗಿಡವು|ಸಣ್ಣಗಿಡಗಳನ್ನು|ಸಣ್ಣಗಿಡದ|ಸಣ್ಣಗಿಡಗಳಿಂದ|ಸಣ್ಣಗಿಡದಿಂದ|saṇṇagiḍa	<i>noun</i><br><ol><li>seedling</li></ol>
ಸತ್ಯ|satya	<i>adj</i><br><ol><li>true, real</li></ol><br><i>noun</i><br><ol><li>truth, reality</li></ol>
ಸದಾಶಿವ|sadāśiva	<i>name</i><br><ol><li>(Hinduism) a manifestation of Shiva</li></ol>
ಸದ್ದು|saddu	<i>noun</i><br><ol><li>sound, noise</li></ol>
ಸಪ್ತಮ|saptama	<i>adj</i><br><ol><li>(literary) seventh</li></ol>
ಸಬಳ|sabaḷa	<i>noun</i><br><ol><li>spear</li></ol>
ಸಭಾಪತಿ|sabhāpati	<i>noun</i><br><ol><li>(politics) the presiding officer of a legislative assembly</li></ol>
ಸಭೆ|sabhe	<i>noun</i><br><ol><li>council, assembly</li></ol>
ಸಮ|sama	<i>adj</i><br><ol><li>same, equal, even</li></ol>
ಸಮಯ|samaya	<i>noun</i><br><ol><li>time</li></ol>
ಸಮಸ್ಯೆ|samasye	<i>noun</i><br><ol><li>problem</li></ol>
ಸಮುದ್ರ|samudra	<i>noun</i><br><ol><li>the sea, ocean</li></ol>
ಸರಸ್ಸು|sarassu	<i>noun</i><br><ol><li>lake (body of water)</li></ol>
ಸರಿ|sari	<i>intj</i><br><ol><li>fine, okay, OK</li><li>all right</li></ol>
ಸರೋವರ|sarōvaragaḷu|ಸರೋವರವು|ಸರೋವರಗಳು|sarōvara|ಸರೋವರಗಳಿಗೆ|sarōvaragaḷannu|ಸರೋವರಗಳನ್ನು|sarōvaragaḷige|sarōvarada|sarōvaragaḷinda|ಸರೋವರಗಳ|sarōvaravannu|ಸರೋವರದಿಂದ|ಸರೋವರವನ್ನು|ಸರೋವರಗಳಿಂದ|sarōvaravu|ಸರೋವರಕ್ಕೆ|ಸರೋವರದ|sarōvarakke|sarōvaragaḷa|sarōvaradinda	<i>noun</i><br><ol><li>lake (body of water)</li></ol>
ಸರ್ಪ|sarpa	<i>noun</i><br><ol><li>a serpent</li></ol>
ಸಲ|sala	<i>noun</i><br><ol><li>(colloquial) time, occurrence, recurrence, turn</li></ol>
ಸಲಕಡತ|salakaḍata	<i>noun</i><br><ol><li>log</li></ol>
ಸಲಕರಣೆ|salakaraṇe	<i>noun</i><br><ol><li>apparatus, contraption, machine, contraption, device, appliance</li><li>tool, implement, instrument</li><li>means</li><li>rack</li><li>expedient</li><li>equipment</li></ol>
ಸಲಹೆ|ಸಲಹೆಯಿಂದ|ಸಲಹೆಯನ್ನು|ಸಲಹೆಗೆ|ಸಲಹೆಯ|ಸಲಹೆಗಳಿಂದ|salahe|ಸಲಹೆಗಳ|ಸಲಹೆಗಳನ್ನು|ಸಲಹೆಗಳಿಗೆ|ಸಲಹೆಯು|ಸಲಹೆಗಳು	<i>noun</i><br><ol><li>advice, counsel, counselling</li><li>pointer, tip, suggestion</li><li>proposal</li></ol>
ಸಲಹೆಗಾರ|ಸಲಹೆಗಾರ್ತಿ|ಸಲಹೆಗಾರರಿಂದ|ಸಲಹೆಗಾರರಿಗೆ|salahegāra|ಸಲಹೆಗಾರರನ್ನು|ಸಲಹೆಗಾರರ|ಸಲಹೆಗಾರನಿಂದ|ಸಲಹೆಗಾರನನ್ನು|ಸಲಹೆಗಾರನಿಗೆ|ಸಲಹೆಗಾರನು|ಸಲಹೆಗಾರನ|ಸಲಹೆಗಾರರು	<i>noun</i><br><ol><li>adviser</li></ol>
ಸಸಿ|sasi	<i>noun</i><br><ol><li>seedling</li></ol>
ಸಸ್ಯ|ಸಸ್ಯವು|ಸಸ್ಯಕ್ಕೆ|ಸಸ್ಯಗಳನ್ನು|ಸಸ್ಯಗಳ|ಸಸ್ಯಗಳಿಂದ|sasya|ಸಸ್ಯವನ್ನು|ಸಸ್ಯಗಳು|ಸಸ್ಯಗಳಿಗೆ|ಸಸ್ಯದಿಂದ|ಸಸ್ಯದ	<i>noun</i><br><ol><li>a plant</li></ol>
ಸಹಿಸು|sahisu	<i>verb</i><br><ol><li>to endure, tolerate, bear, put up with</li></ol>
ಸಾಕು|sāku	<i>verb</i><br><ol><li>to suffice, be enough</li></ol>
ಸಾಕುಗ|ಸಾಕುಗನಿಂದ|ಸಾಕುಗನನ್ನು|ಸಾಕುಗನ|ಸಾಕುಗರು|ಸಾಕುಗರ|sākuga|ಸಾಕುಗನಿಗೆ|ಸಾಕುಗರಿಂದ|ಸಾಕುಗರನ್ನು|ಸಾಕುಗರಿಗೆ|ಸಾಕುಗನು	<i>noun</i><br><ol><li>nurturer, one who fosters and cares</li></ol>
ಸಾಬೂನು|sābūnu	<i>noun</i><br><ol><li>soap</li></ol>
ಸಾಯಿಸು|ಸಾಯಿಸುುವೆವು (sāyisuುvevu)|ಸಾಯಿಸುುತ್ತಾಳೆ (sāyisuುttāḷe)|ಸಾಯಿಸಿದಿ|ಸಾಯಿಸುುತ್ತೇನೆ (sāyisuುttēne)|ಸಾಯಿಸಿದೆನು|ಸಾಯಿಸುುವಳು (sāyisuುvaḷu)|ಸಾಯಿಸತು|ಸಾಯಿಸುನು|ಸಾಯಿಸುುತ್ತಾರೆ (sāyisuುttāre)|ಸಾಯಿಸುದ|ಸಾಯಿಸೀಯೆ|ಸಾಯಿಸುಲಿ|ಸಾಯಿಸುಿಯಾನು (sāyisuಿyānu)|ಸಾಯಿಸುು (sāyisuು)|ಸಾಯಿಸುೆನು (sāyisuೆnu)|ಸಾಯಿಸುಿಯಾರು (sāyisuಿyāru)|ಸಾಯಿಸುುತ್ತೀಯೆ (sāyisuುttīye)|ಸಾಯಿಸುದೆ|ಸಾಯಿಸಿದರೆ|ಸಾಯಿಸುುತ್ತೀ (sāyisuುttī)|ಸಾಯಿಸುುವುವು (sāyisuುvuvu)|ಸಾಯಿಸಿದೆ|ಸಾಯಿಸುಿರಿ (sāyisuಿri)|ಸಾಯಿಸುುತ್ತಾನೆ (sāyisuುttāne)|ಸಾಯಿಸುೆ (sāyisuೆ)|ಸಾಯಿಸಿದುವು|ಸಾಯಿಸುುತ್ತೇವೆ (sāyisuುttēve)|ಸಾಯಿಸುುವಿ (sāyisuುvi)|ಸಾಯಿಸುಲು|ಸಾಯಿಸುಲಿಕ್ಕೆ|ಸಾಯಿಸಿದ|ಸಾಯಿಸಿದಿರಿ|ಸಾಯಿಸಿದೆವು|ಸಾಯಿಸ|ಸಾಯಿಸುದು|ಸಾಯಿಸಿದಳು|ಸಾಯಿಸುಳು|ಸಾಯಿಸುೆವು (sāyisuೆvu)|ಸಾಯಿಸುಿಯೇವು (sāyisuಿyēvu)|ಸಾಯಿಸುಿಯಾವು (sāyisuಿyāvu)|ಸಾಯಿಸುುತ್ತದೆ (sāyisuುttade)|ಸಾಯಿಸುುತ್ತೀರಿ (sāyisuುttīri)|ಸಾಯಿಸುುವೆ (sāyisuುve)|ಸಾಯಿಸುುವರು (sāyisuುvaru)|ಸಾಯಿಸುೀತು (sāyisuೀtu)|ಸಾಯಿಸಿದರು|ಸಾಯಿಸುರಿ|ಸಾಯಿಸುೋಣ (sāyisuೋṇa)|ಸಾಯಿಸುುವಿರಿ (sāyisuುviri)|sāyisu|ಸಾಯಿಸುಿಯಾಳು (sāyisuಿyāḷu)|ಸಾಯಿಸುವು|ಸಾಯಿಸಿದನು|ಸಾಯಿಸುುವನು (sāyisuುvanu)|ಸಾಯಿಸುುವಾ (sāyisuುvā)|ಸಾಯಿಸುುವುದು (sāyisuುvudu)|ಸಾಯಿಸಯೇನು|ಸಾಯಿಸುರು|ಸಾಯಿಸುುವೆನು (sāyisuುvenu)|ಸಾಯಿಸುುತ್ತ (sāyisuುtta)|ಸಾಯಿಸುುತ್ತವೆ (sāyisuುttave)|ಸಾಯಿಸುುವ (sāyisuುva)|ಸಾಯಿಸುೀರಿ (sāyisuೀri)	<i>verb</i><br><ol><li>to kill</li></ol>
ಸಾರಾಯಿ|sārāyi	<i>noun</i><br><ol><li>liquor, toddy, arrack, beer</li></ol>
ಸಾರಿಗೆ|sārige	<i>noun</i><br><ol><li>transport</li></ol>
ಸಾವಿರ|sāvira	<i>num</i><br><ol><li>thousand</li></ol>
ಸಾವೆ|sāve	<i>noun</i><br><ol><li>proso millet</li></ol>
ಸಾಸವ|sāsava	<i>noun</i><br><ol><li>flower</li></ol>
ಸಾಸಿವೆ|sāsive	<i>noun</i><br><ol><li>mustard</li></ol>
ಸಿ|si	<i>character</i><br><ol><li>The Kannada letter si.</li></ol>
ಸಿಂಧುರ|sindhura	<i>noun</i><br><ol><li>vermilion</li></ol>
ಸಿಂಪಿ|simpi	<i>noun</i><br><ol><li>oyster</li><li>shell</li></ol>
ಸಿಂಹ|ಸಿಂಹಗಳಿಂದ|ಸಿಂಹಗಳಿಗೆ|ಸಿಂಹದಿಂದ|ಸಿಂಹಕ್ಕೆ|ಸಿಂಹಗಳನ್ನು|ಸಿಂಹವು|siṃha|ಸಿಂಹಗಳು|ಸಿಂಹಗಳ|ಸಿಂಹವನ್ನು|ಸಿಂಹದ	<i>noun</i><br><ol><li>lion</li><li>(astrology) Leo</li></ol>
ಸಿಂಹಳದೇಶ|siṁhaladēša	<i>name</i><br><ol><li>Sri Lanka</li></ol>
ಸಿಂಹಿ|siṁhi	<i>noun</i><br><ol><li>lioness</li></ol>
ಸಿಡಿಗುಂಡು|siḍiguṇḍu	<i>noun</i><br><ol><li>bomb (explosive device)</li></ol>
ಸಿಹಿ|sihi	<i>adj</i><br><ol><li>sweet</li></ol>
ಸೀತೆ|sīte	<i>name</i><br><ol><li>(Hinduism) Sita; the wife of Rama in the epic Ramayana.</li></ol>
ಸೀರು|sīru	<i>verb</i><br><ol><li>to scatter</li><li>to comb</li><li>to delouse</li></ol><br><i>noun</i><br><ol><li>(mineralogy) clay</li></ol>
ಸು|su	<i>character</i><br><ol><li>The Kannada letter su.</li></ol>
ಸುಂಟರಗಾಳಿ|ಸುಂಟರಗಾಳಿಗಳನ್ನು|ಸುಂಟರಗಾಳಿಯನ್ನು|ಸುಂಟರಗಾಳಿಯಿಂದ|ಸುಂಟರಗಾಳಿಗೆ|ಸುಂಟರಗಾಳಿಯ|ಸುಂಟರಗಾಳಿಗಳ|suṇṭaragāḷi|ಸುಂಟರಗಾಳಿಗಳಿಂದ|ಸುಂಟರಗಾಳಿಗಳಿಗೆ|ಸುಂಟರಗಾಳಿಯು|ಸುಂಟರಗಾಳಿಗಳು	<i>noun</i><br><ol><li>(meteorology) tornado</li></ol>
ಸುಂಡಿಲಿ|sunḍili	<i>noun</i><br><ol><li>Asian house shrew, muskrat (Suncus murinus)</li></ol>
ಸುಗ್ಗಿ|suggi	<i>name</i><br><ol><li>A Hindu harvest festival celebrated in the spring in Karnataka</li></ol><br><i>noun</i><br><ol><li>harvest-season</li></ol>
ಸುಣ್ಣ|suṇṇa	<i>noun</i><br><ol><li>slaked lime</li></ol>
ಸುದ್ದಿ|suddi|ಸುದ್ದಿಗಳಿಗೆ|ಸುದ್ದಿಗೆ|ಸುದ್ದಿಗಳನ್ನು|ಸುದ್ದಿಯಿಂದ|ಸುದ್ದಿಗಳ|ಸುದ್ದಿಗಳು|ಸುದ್ದಿಯು|ಸುದ್ದಿಯ|ಸುದ್ದಿಯನ್ನು|ಸುದ್ದಿಗಳಿಂದ	<i>noun</i><br><ol><li>news, tidings</li></ol>
ಸುಪ್ತ|supta	<i>adj</i><br><ol><li>asleep</li><li>dormant, inactive, latent</li><li>unused, hidden, undiscovered</li></ol>
ಸುರಿಸು|surisu	<i>verb</i><br><ol><li>(intransitive) to spill, pour out</li></ol>
ಸುವಿಧೆ|suvidhe	<i>noun</i><br><ol><li>convenience, comfort, ease</li><li>facility, accommodation</li></ol>
ಸೂಕರ|sūkara	<i>noun</i><br><ol><li>(formal) a pig</li></ol>
ಸೂಜಿ|sūji	<i>noun</i><br><ol><li>needle</li></ol>
ಸೂರ್ಯ|ಸೂರ್ಯವನ್ನು|ಸೂರ್ಯರಿಂದ|ಸೂರ್ಯರ|ಸೂರ್ಯಗಳು|ಸೂರ್ಯಗಳಿಗೆ|ಸೂರ್ಯನ|ಸೂರ್ಯವು|ಸೂರ್ಯದ|ಸೂರ್ಯನಿಗೆ|ಸೂರ್ಯದಿಂದ|ಸೂರ್ಯಗಳನ್ನು|ಸೂರ್ಯಗಳ|ಸೂರ್ಯರನ್ನು|sūrya|ಸೂರ್ಯಗಳಿಂದ|ಸೂರ್ಯರು|ಸೂರ್ಯನಿಂದ|ಸೂರ್ಯನು|ಸೂರ್ಯರಿಗೆ|ಸೂರ್ಯನನ್ನು|ಸೂರ್ಯಕ್ಕೆ	<i>noun</i><br><ol><li>the sun</li></ol><br><i>name</i><br><ol><li>Surya, the sun deity of many Hindu sects</li></ol>
ಸೂರ್ಯಧಾತು|ಸೂರ್ಯಧಾತುಗಳನ್ನು|ಸೂರ್ಯಧಾತುಗಳ|ಸೂರ್ಯಧಾತುಗಳಿಗೆ|ಸೂರ್ಯಧಾತುವಿನಿಂದ|ಸೂರ್ಯಧಾತುಗಳಿಂದ|ಸೂರ್ಯಧಾತುವಿನ|ಸೂರ್ಯಧಾತುವನ್ನು|ಸೂರ್ಯಧಾತುಗಳು|ಸೂರ್ಯಧಾತುವು|ಸೂರ್ಯಧಾತುವಿಗೆ|sūryadhātu	<i>noun</i><br><ol><li>helium</li></ol>
ಸೆಕೆಂಡ್ ಸೆಟಪ್|sekeṇḍ seṭap	<i>noun</i><br><ol><li>(colloquial) mistress, affair partner</li></ol>
ಸೆಳೆ|seḷe	<i>verb</i><br><ol><li>to draw</li><li>to entice</li><li>to fascinate</li><li>to grab</li><li>to lure</li><li>to lead on</li><li>to flog</li></ol>
ಸೇತುವೆ|sētuve	<i>noun</i><br><ol><li>a bridge</li></ol>
ಸೇಬು|sēbu	<i>noun</i><br><ol><li>apple</li></ol>
ಸೈಕಲ್|saikal	<i>noun</i><br><ol><li>cycle</li></ol>
ಸೊಂಡಿಲು|soṇḍilu	<i>noun</i><br><ol><li>the trunk of an elephant</li></ol>
ಸೊನ್ನೆ|sonne	<i>num</i><br><ol><li>zero (numeral: ೦ (0))</li><li>the anusvāra ಂ (ṃ), also referred to as ಒಂದು ಸೊನ್ನೆ (ondu sonne) to contrast with the visarga ಃ (ḥ), ಎರಡು ಸೊನ್ನೆ (eraḍu sonne).</li></ol>
ಸೊಪ್ಪು|sappu|soppu|ಸಪ್ಪು	<i>noun</i><br><ol><li>any plant eaten as a leaf vegetable</li></ol>
ಸೊಲ್ಲಾಪುರ|sollāpura	<i>name</i><br><ol><li>(geography) Solapur</li></ol>
ಸೊವಿಯೆಟ್ ಒಕ್ಕೂಟ|soviyeṭ okkūṭa	<i>name</i><br><ol><li>Soviet Union</li></ol>
ಸೊಸೆ|sose	<i>noun</i><br><ol><li>daughter-in-law (the wife of one's child)</li></ol>
ಸೋಮವಾರ|sōmavāra	<i>noun</i><br><ol><li>Monday; the second day of the week.</li></ol>
ಸ್ಟಾಲಿನ್|sṭālin	<i>name</i><br><ol><li>Stalin</li></ol>
ಸ್ತನ|stana	<i>noun</i><br><ol><li>breast of a woman</li></ol>
ಸ್ತ್ರೀ|strī	<i>noun</i><br><ol><li>(formal, literary) a woman</li></ol>
ಸ್ಥಾನ|sthāna	<i>noun</i><br><ol><li>place, location</li><li>position</li></ol>
ಸ್ಥಿತಿ|sthiti	<i>noun</i><br><ol><li>condition, state, situation</li></ol>
ಸ್ನೇಹ|snēha	<i>noun</i><br><ol><li>friendship, fondness, love</li></ol>
ಸ್ನೇಹಿತ|snēhita	<i>noun</i><br><ol><li>a friend</li></ol>
ಸ್ಪರ್ಧೆ|spardhe	<i>noun</i><br><ol><li>competition</li></ol>
ಸ್ಪಷ್ಟ|spaṣṭa	<i>adj</i><br><ol><li>clear, coherent, apparent</li><li>distinguishable</li></ol>
ಸ್ಫೋಟ|sphōṭa	<i>noun</i><br><ol><li>an explosion</li></ol>
ಸ್ರೋತ|srōta	<i>noun</i><br><ol><li>flow of water</li><li>river</li><li>source</li></ol>
ಸ್ರೋತಸ್ಸು|srōtassu	<i>noun</i><br><ol><li>(literary, formal, rare) flow of water, river, source</li></ol>
ಸ್ವಪ್ನ|svapna	<i>noun</i><br><ol><li>(regional, otherwise literary) a dream</li></ol>
ಸ್ವರ್ಣ|svarṇa	<i>noun</i><br><ol><li>gold</li></ol>
ಸ್ವಲ್ಪ|svalpa	<i>adj</i><br><ol><li>small, little, insignificant</li></ol><br><i>adv</i><br><ol><li>slightly, a little bit</li></ol>
ಸ್ವಾದಿಷ್ಟ|svādiṣṭa	<i>adj</i><br><ol><li>tastiest, most delicious</li></ol>
ಹ|ha	<i>character</i><br><ol><li>The Kananda letter ha.</li></ol>
ಹಂಕಣಿ|haṅkaṇi	<i>adj</i><br><ol><li>something which is fallen down</li></ol>
ಹಂಕಣಿದಲೆ|haṅkaṇidale	<i>noun</i><br><ol><li>a head which has been fallen down</li></ol>
ಹಂಕರ|haṅkara	<i>noun</i><br><ol><li>greed</li></ol>
ಹಂಕೃತಿ|haṅkṛti	<i>noun</i><br><ol><li>greed</li></ol>
ಹಂದಿ|handi	<i>noun</i><br><ol><li>a pig</li></ol>
ಹಂಬಲ|haṃbala	<i>noun</i><br><ol><li>desire</li></ol>
ಹಂಸ|haṃsa	<i>noun</i><br><ol><li>a swan</li></ol>
ಹಕ್ಕಿ|hakki	<i>noun</i><br><ol><li>bird</li></ol>
ಹಕ್ಕಿಯರಿಮೆ|hakkiyarime	<i>noun</i><br><ol><li>ornithology</li></ol>
ಹಕ್ಕು|hakku	<i>noun</i><br><ol><li>right, entitlement</li></ol>
ಹಗಲು|hagalu	<i>noun</i><br><ol><li>daylight</li></ol>
ಹಗುರು|haguru	<i>adj</i><br><ol><li>light (not heavy)</li><li>mild</li></ol>
ಹಚ್ಚುಮದ್ದು|haccumaddu	<i>noun</i><br><ol><li>salve</li></ol>
ಹಠ|haṭha	<i>noun</i><br><ol><li>obstinacy, stubbornness</li></ol>
ಹಡಗು|haḍagu	<i>noun</i><br><ol><li>a ship</li></ol>
ಹಣ|haṇa	<i>noun</i><br><ol><li>money</li></ol>
ಹತ್ತು|hattu	<i>num</i><br><ol><li>ten</li></ol>
ಹತ್ತೊಂಬತ್ತು|hattoṃbattu	<i>num</i><br><ol><li>nineteen (numeral: ೧೯ (19))</li></ol>
ಹದಿನಾರು|hadināru	<i>num</i><br><ol><li>sixteen (numeral: ೧೬ (16))</li></ol>
ಹದಿನಾಲ್ಕು|hadinālku	<i>num</i><br><ol><li>fourteen (numeral: ೧೪ (14))</li></ol>
ಹದಿನೆಂಟು|hadineṃṭu	<i>num</i><br><ol><li>eighteen (numeral: ೧೮ (18))</li></ol>
ಹದಿನೇಳು|hadinēḷu	<i>num</i><br><ol><li>seventeen (numeral: ೧೭ (17))</li></ol>
ಹದಿನೈದು|hadinaidu	<i>num</i><br><ol><li>fifteen (numeral: ೧೫ (15))</li></ol>
ಹದಿಮೂರು|hadimūru	<i>num</i><br><ol><li>thirteen (numeral: ೧೩ (13))</li></ol>
ಹನ್ನೆರಡು|hanneraḍu	<i>num</i><br><ol><li>twelve (numeral: ೧೨ (12))</li></ol>
ಹನ್ನೊಂದು|hannoṃdu	<i>num</i><br><ol><li>eleven (numeral: ೧೧ (11))</li></ol>
ಹಪ್ಪಳ|happaḷa	<i>noun</i><br><ol><li>papad</li></ol>
ಹಬ್ಬ|habba	<i>noun</i><br><ol><li>festival</li></ol>
ಹರಯ|haraya	<i>noun</i><br><ol><li>puberty</li></ol>
ಹಲಗೆ|halage	<i>noun</i><br><ol><li>a plank or a slab</li></ol>
ಹಲಸು|halasu	<i>noun</i><br><ol><li>the jackfruit</li></ol>
ಹಲ್ಲು|ಹಲ್ಲುಗಳನ್ನು|ಹಲ್ಲುಗಳಿಂದ|ಹಲ್ಲಿನ|ಹಲ್ಲಿನಿಂದ|ಹಲ್ಲುಗಳು|ಹಲ್ಲಿಗೆ|hallu|ಹಲ್ಲುಗಳಿಗೆ|ಹಲ್ಲುಗಳ|ಹಲ್ಲನ್ನು	<i>noun</i><br><ol><li>tooth</li></ol>
ಹಳದಿ|haḷadi	<i>noun</i><br><ol><li>yellow (color)</li></ol>
ಹಳು|haḷu	<i>noun</i><br><ol><li>forest</li></ol>
ಹಳುವು|haḷuvu	<i>noun</i><br><ol><li>forest (dense collection of trees)</li></ol>
ಹಳುವು ಕಿಚ್ಚು|haḷuvu kiccu	<i>noun</i><br><ol><li>forest fire</li></ol>
ಹಳೆ|haḷe	<i>adj</i><br><ol><li>old</li></ol>
ಹಳೆಗನ್ನಡ|haḷegannaḍa	<i>name</i><br><ol><li>Old Kannada language, the ancestor of Modern Kannada.</li></ol>
ಹಳ್ಳಿ|haḷḷi	<i>noun</i><br><ol><li>hamlet, village</li></ol>
ಹವಾಮಾನ|havāmāna	<i>noun</i><br><ol><li>weather</li></ol>
ಹವಾಯಿ|havāyi	<i>name</i><br><ol><li>(geography) Hawaii (one of the states of the United States)</li></ol>
ಹವಿಗನ್ನಡ|havigannaḍa	<i>name</i><br><ol><li>Synonym of ಹವ್ಯಕ ಕನ್ನಡ (havyaka kannaḍa)</li></ol>
ಹವೀಕ|havīka	<i>noun</i><br><ol><li>Synonym of ಹವ್ಯಕ (havyaka)</li></ol><br><i>adj</i><br><ol><li>Synonym of ಹವ್ಯಕ (havyaka)</li></ol>
ಹವೀಗ|havīga	<i>noun</i><br><ol><li>Synonym of ಹವ್ಯಕ (havyaka)</li></ol><br><i>adj</i><br><ol><li>Synonym of ಹವ್ಯಕ (havyaka)</li></ol>
ಹವ್ಯಕ|havyaka	<i>noun</i><br><ol><li>a Havyaka; a member of the Brahmin community native to coastal Karnataka, historically engaged in priestly activities</li></ol><br><i>adj</i><br><ol><li>of or relating to the Havyakas or their language</li></ol>
ಹವ್ಯಕ ಕನ್ನಡ|havyaka kannaḍa	<i>name</i><br><ol><li>the dialect of Kannada spoken by the Havyakas</li></ol>
ಹಸು|hasu	<i>noun</i><br><ol><li>cow, cattle</li></ol>
ಹಸ್ತ|hasta	<i>noun</i><br><ol><li>(anatomy) palm</li></ol>
ಹಾಂಗ್ ಕಾಂಗ್|hāṅg kāṅg	<i>name</i><br><ol><li>Hong Kong</li></ol>
ಹಾಗೂ|hāgū	<i>conj</i><br><ol><li>and</li></ol>
ಹಾಜರಿ|hājari	<i>noun</i><br><ol><li>attendance, presence</li></ol>
ಹಾಡು|ಹಾಡಲಿಕ್ಕೆ|ಹಾಡಿದರೆ|ಹಾಡುತ್ತೇನೆ|ಹಾಡಲು|ಹಾಡಿಯಾನು|ಹಾಡುತ್ತೇವೆ|ಹಾಡೆನು|ಹಾಡುವೆನು|ಹಾಡದೆ|ಹಾಡುವಿ|ಹಾಡೀತು|ಹಾಡುತ್ತಾರೆ|ಹಾಡುವೆವು|ಹಾಡುವಳು|ಹಾಡತು|ಹಾಡುತ್ತಾನೆ|ಹಾಡುತ್ತವೆ|ಹಾಡುತ್ತ|ಹಾಡವು|ಹಾಡಿಯಾವು|ಹಾಡಳು|ಹಾಡುತ್ತೀಯೆ|ಹಾಡೋಣ|ಹಾಡುವಿರಿ|ಹಾಡದು|ಹಾಡೀಯೆ|ಹಾಡುತ್ತದೆ|ಹಾಡೆವು|ಹಾಡುವ|ಹಾಡಿದೆವು|ಹಾಡಿಯೇವು|ಹಾಡಲಿ|ಹಾಡಿದಳು|ಹಾಡುತ್ತೀರಿ|ಹಾಡೆ|ಹಾಡದ|ಹಾಡಿದೆ|ಹಾಡನು|ಹಾಡರಿ|ಹಾಡರು|ಹಾಡಿಯಾಳು|ಹಾಡುವಾ|ಹಾಡುವನು|ಹಾಡಿರಿ|ಹಾಡಿದಿರಿ|ಹಾಡಿದರು|ಹಾಡಿದುವು|ಹಾಡಿದಿ|ಹಾಡಿದೆನು|ಹಾಡುವೆ|ಹಾಡುವರು|ಹಾಡಿದ|ಹಾಡುವುದು|ಹಾಡುವುವು|hāḍu|ಹಾಡಯೇನು|ಹಾಡೀರಿ|ಹಾಡುತ್ತೀ|ಹಾಡುತ್ತಾಳೆ|ಹಾಡಿಯಾರು|ಹಾಡಿದನು|ಹಾಡ	<i>verb</i><br><ol><li>to sing</li></ol>
ಹಾದರಿ|hādari	<i>noun</i><br><ol><li>trumpet flower</li></ol>
ಹಾಯನ|hāyana	<i>noun</i><br><ol><li>year</li></ol>
ಹಾರು|ಹಾರಳು|ಹಾರ|ಹಾರಿರಿ|ಹಾರಿದುವು|hāru|ಹಾರತು|ಹಾರೆ|ಹಾರುವಿರಿ|ಹಾರೀತು|ಹಾರದು|ಹಾರೀರಿ|ಹಾರವು|ಹಾರುವ|ಹಾರಲಿಕ್ಕೆ|ಹಾರುವುದು|ಹಾರುತ್ತವೆ|ಹಾರಿಯೇವು|ಹಾರೆನು|ಹಾರುವೆ|ಹಾರುತ್ತೀಯೆ|ಹಾರುತ್ತೀರಿ|ಹಾರಿದರು|ಹಾರೋಣ|ಹಾರುತ್ತಾಳೆ|ಹಾರಿದರೆ|ಹಾರಿದೆವು|ಹಾರರು|ಹಾರಿಯಾವು|ಹಾರೆವು|ಹಾರಲಿ|ಹಾರುತ್ತೀ|ಹಾರಿದಿರಿ|ಹಾರುವಿ|ಹಾರುವಾ|ಹಾರುವರು|ಹಾರುವೆವು|ಹಾರುವೆನು|ಹಾರಿದೆನು|ಹಾರುವಳು|ಹಾರರಿ|ಹಾರುತ್ತೇನೆ|ಹಾರುತ್ತ|ಹಾರದ|ಹಾರಿದೆ|ಹಾರುತ್ತೇವೆ|ಹಾರಿದನು|ಹಾರುವನು|ಹಾರಿಯಾನು|ಹಾರುತ್ತಾರೆ|ಹಾರದೆ|ಹಾರಿಯಾಳು|ಹಾರಲು|ಹಾರುತ್ತದೆ|ಹಾರುವುವು|ಹಾರಿದಿ|ಹಾರಿದಳು|ಹಾರಿದ|ಹಾರಯೇನು|ಹಾರೀಯೆ|ಹಾರುತ್ತಾನೆ|ಹಾರನು|ಹಾರಿಯಾರು	<i>verb</i><br><ol><li>to fly</li><li>to jump</li></ol>
ಹಾಲು|ಹಾಲಿನ|ಹಾಲಿಗೆ|ಹಾಲುಗಳ|ಹಾಲುಗಳಿಂದ|hālu|ಹಾಲನ್ನು|ಹಾಲುಗಳಿಗೆ|ಹಾಲಿನಿಂದ|ಹಾಲುಗಳು|ಹಾಲುಗಳನ್ನು	<i>noun</i><br><ol><li>milk</li></ol>
ಹಾವು|hāvu	<i>noun</i><br><ol><li>snake</li></ol>
ಹಾಸಿಗೆ|ಹಾಸಿಗೆಗೆ|ಹಾಸಿಗೆಗಳು|ಹಾಸಿಗೆಯ|ಹಾಸಿಗೆಗಳ|ಹಾಸಿಗೆಗಳಿಂದ|ಹಾಸಿಗೆಯಿಂದ|ಹಾಸಿಗೆಯು|ಹಾಸಿಗೆಗಳನ್ನು|ಹಾಸಿಗೆಗಳಿಗೆ|hāsige|ಹಾಸಿಗೆಯನ್ನು	<i>noun</i><br><ol><li>bed</li></ol>
ಹಿಂಡು|hiṇḍu	<i>verb</i><br><ol><li>to wring, squeeze</li></ol><br><i>noun</i><br><ol><li>a group of persons, animals, or things; a herd</li></ol>
ಹಿಂದಿ|hindi	<i>name</i><br><ol><li>Hindi</li></ol>
ಹಿಟ್ಟು|hiṭṭu	<i>noun</i><br><ol><li>flour (cooking ingredient)</li><li>meal</li></ol>
ಹಿತ್ತಾಳೆ|hittāḷe	<i>noun</i><br><ol><li>brass</li></ol>
ಹಿಮ|hima	<i>noun</i><br><ol><li>snow, ice</li></ol>
ಹಿಮದ ಬಿಳಲು|himada biḷalu	<i>noun</i><br><ol><li>icicle</li></ol>
ಹಿಮಪಾತ|himapāta	<i>noun</i><br><ol><li>blizzard</li></ol>
ಹಿಮವರ್ಷ|himavarṣa	<i>noun</i><br><ol><li>(meteorology) snowfall</li></ol>
ಹಿಮಸರಳು|himasaraḷu	<i>noun</i><br><ol><li>icicle</li></ol>
ಹೀಗೆ|hīge	<i>adv</i><br><ol><li>like this, thus, in this way</li></ol>
ಹೀನ|hīna	<i>adj</i><br><ol><li>(in compounds) deprived of, bereft of; lacking</li><li>lowly, dirty, crude</li></ol>
ಹುಟ್ಟು|ಹುಟ್ಟುಳು|ಹುಟ್ಟುುತ್ತೀ|ಹುಟ್ಟುುವೆ|ಹುಟ್ಟಿದೆವು|ಹುಟ್ಟಿದರೆ|ಹುಟ್ಟುುತ್ತೇವೆ|ಹುಟ್ಟಿದೆ|ಹುಟ್ಟುುವುದು|ಹುಟ್ಟುಿಯಾಳು|ಹುಟ್ಟುುವ|ಹುಟ್ಟಿದಳು|ಹುಟ್ಟುೆವು|ಹುಟ್ಟುುತ್ತೇನೆ|ಹುಟ್ಟುುವೆನು|ಹುಟ್ಟುುವಿ|ಹುಟ್ಟುುತ್ತಾಳೆ|ಹುಟ್ಟಿದುವು|ಹುಟ್ಟುುತ್ತಾನೆ|ಹುಟ್ಟುು|ಹುಟ್ಟುಿಯಾರು|huṭṭu|ಹುಟ್ಟುಲಿಕ್ಕೆ|ಹುಟ್ಟುೆನು|ಹುಟ್ಟುದು|ಹುಟ್ಟುಿಯಾನು|ಹುಟ್ಟತು|ಹುಟ್ಟಿದರು|ಹುಟ್ಟುೋಣ|ಹುಟ್ಟುರಿ|ಹುಟ್ಟುವು|ಹುಟ್ಟ|ಹುಟ್ಟುಲು|ಹುಟ್ಟಯೇನು|ಹುಟ್ಟಿದ|ಹುಟ್ಟುುತ್ತಾರೆ|ಹುಟ್ಟಿದಿ|ಹುಟ್ಟುೆ|ಹುಟ್ಟುುವೆವು|ಹುಟ್ಟುೀತು|ಹುಟ್ಟುುವಳು|ಹುಟ್ಟುದೆ|ಹುಟ್ಟುುತ್ತ|ಹುಟ್ಟುುತ್ತೀಯೆ|ಹುಟ್ಟುಿಯಾವು|ಹುಟ್ಟಿದೆನು|ಹುಟ್ಟುಿಯೇವು|ಹುಟ್ಟುುವನು|ಹುಟ್ಟುನು|ಹುಟ್ಟುಿರಿ|ಹುಟ್ಟುುವಿರಿ|ಹುಟ್ಟುದ|ಹುಟ್ಟುುತ್ತೀರಿ|ಹುಟ್ಟುಲಿ|ಹುಟ್ಟುುವರು|ಹುಟ್ಟುೀರಿ|ಹುಟ್ಟುುತ್ತದೆ|ಹುಟ್ಟುುತ್ತವೆ|ಹುಟ್ಟಿದಿರಿ|ಹುಟ್ಟುುವಾ|ಹುಟ್ಟೀಯೆ|ಹುಟ್ಟುರು|ಹುಟ್ಟುುವುವು|ಹುಟ್ಟಿದನು	<i>verb</i><br><ol><li>to be born</li><li>to come into existence</li></ol>
ಹುಟ್ಟುಹಬ್ಬ|huṭṭuhabba	<i>noun</i><br><ol><li>birthday</li></ol>
ಹುಡುಕು|huḍuku	<i>verb</i><br><ol><li>search</li></ol>
ಹುಡುಗ|ಹುಡುಗರಿಗೆ|ಹುಡುಗನಿಂದ|ಹುಡುಗರಿಂದ|ಹುಡುಗನು|ಹುಡುಗರನ್ನು|huḍuga|ಹುಡುಗನಿಗೆ|ಹುಡುಗರ|ಹುಡುಗನನ್ನು|ಹುಡುಗನ|ಹುಡುಗರು	<i>noun</i><br><ol><li>boy</li></ol>
ಹುಡುಗಿ|huḍugi	<i>noun</i><br><ol><li>girl</li></ol>
ಹುಣ್ಣಿಮೆ|huṇṇime	<i>noun</i><br><ol><li>night of the full moon</li></ol>
ಹುಬ್ಬು|hubbu	<i>noun</i><br><ol><li>eyebrow</li></ol>
ಹುರುಳಿ|huruḷi	<i>noun</i><br><ol><li>horse gram</li></ol>
ಹುಲಿ|huli	<i>noun</i><br><ol><li>tiger</li></ol>
ಹುಲ್ಲು|hullu	<i>noun</i><br><ol><li>grass</li><li>hay</li></ol>
ಹುಳಿ|huḷi	<i>noun</i><br><ol><li>acid</li><li>acidity, tartness</li></ol><br><i>adj</i><br><ol><li>sour, acidic</li></ol>
ಹುಳು|huḷu	<i>noun</i><br><ol><li>a worm</li><li>an insect</li></ol>
ಹೂ|hū	<i>noun</i><br><ol><li>flower</li></ol>
ಹೂಗು|hūgu	<i>noun</i><br><ol><li>(Havyaka) Alternative form of ಹೂವು (hūvu, “flower”)</li></ol>
ಹೂವು|hūvu	<i>noun</i><br><ol><li>a flower</li></ol>
ಹೃದಯ|ಹೃದಯಗಳನ್ನು|ಹೃದಯಗಳಿಗೆ|ಹೃದಯಗಳ|ಹೃದಯದಿಂದ|ಹೃದಯವು|ಹೃದಯಗಳು|ಹೃದಯವನ್ನು|ಹೃದಯದ|hṛdaya|ಹೃದಯಕ್ಕೆ|ಹೃದಯಗಳಿಂದ	<i>noun</i><br><ol><li>heart</li></ol>
ಹೃದ್ರೋಗ|hṛdrōga	<i>noun</i><br><ol><li>heart disease</li></ol>
ಹೆಂಗಸು|heṅgasu	<i>noun</i><br><ol><li>woman</li></ol>
ಹೆಂಡತಿ|heṇḍati	<i>noun</i><br><ol><li>a wife</li></ol>
ಹೆಣ|heṇa	<i>adj</i><br><ol><li>corpse</li></ol>
ಹೆಣ್ಣು|heṇṇu	<i>adj</i><br><ol><li>female</li></ol><br><i>noun</i><br><ol><li>girl, woman</li></ol>
ಹೆಸರಿಸು|ಹೆಸರಿಸ|ಹೆಸರಿಸುುತ್ತದೆ|ಹೆಸರಿಸುು|ಹೆಸರಿಸುುತ್ತಾರೆ|ಹೆಸರಿಸಿದೆನು|ಹೆಸರಿಸುುವಳು|ಹೆಸರಿಸುಳು|ಹೆಸರಿಸುೋಣ|ಹೆಸರಿಸುುವಾ|ಹೆಸರಿಸುುವಿರಿ|ಹೆಸರಿಸುುವರು|ಹೆಸರಿಸೀಯೆ|ಹೆಸರಿಸುೀತು|hesarisu|ಹೆಸರಿಸತು|ಹೆಸರಿಸುರು|ಹೆಸರಿಸುಿಯೇವು|ಹೆಸರಿಸುುತ್ತವೆ|ಹೆಸರಿಸುಿಯಾವು|ಹೆಸರಿಸಯೇನು|ಹೆಸರಿಸಿದಿ|ಹೆಸರಿಸುುತ್ತಾನೆ|ಹೆಸರಿಸುುವ|ಹೆಸರಿಸುುತ್ತೇನೆ|ಹೆಸರಿಸುುವೆವು|ಹೆಸರಿಸುುವುವು|ಹೆಸರಿಸಿದುವು|ಹೆಸರಿಸುಿಯಾರು|ಹೆಸರಿಸಿದೆ|ಹೆಸರಿಸುುವುದು|ಹೆಸರಿಸುುವಿ|ಹೆಸರಿಸುವು|ಹೆಸರಿಸಿದಳು|ಹೆಸರಿಸುುವೆನು|ಹೆಸರಿಸುೆ|ಹೆಸರಿಸುರಿ|ಹೆಸರಿಸುೆವು|ಹೆಸರಿಸುೀರಿ|ಹೆಸರಿಸುಲು|ಹೆಸರಿಸುುವೆ|ಹೆಸರಿಸಿದರು|ಹೆಸರಿಸಿದರೆ|ಹೆಸರಿಸುುತ್ತೇವೆ|ಹೆಸರಿಸಿದನು|ಹೆಸರಿಸುೆನು|ಹೆಸರಿಸುದೆ|ಹೆಸರಿಸಿದ|ಹೆಸರಿಸುುತ್ತ|ಹೆಸರಿಸುನು|ಹೆಸರಿಸುುತ್ತೀ|ಹೆಸರಿಸುಿಯಾನು|ಹೆಸರಿಸುಿಯಾಳು|ಹೆಸರಿಸಿದೆವು|ಹೆಸರಿಸುಿರಿ|ಹೆಸರಿಸುುತ್ತೀಯೆ|ಹೆಸರಿಸಿದಿರಿ|ಹೆಸರಿಸುಲಿ|ಹೆಸರಿಸುುತ್ತಾಳೆ|ಹೆಸರಿಸುುವನು|ಹೆಸರಿಸುದ|ಹೆಸರಿಸುುತ್ತೀರಿ|ಹೆಸರಿಸುದು|ಹೆಸರಿಸುಲಿಕ್ಕೆ	<i>verb</i><br><ol><li>To name</li></ol>
ಹೆಸರು|ಹೆಸರನ್ನು|ಹೆಸರುಗಳನ್ನು|ಹೆಸರಿನಿಂದ|ಹೆಸರುಗಳ|ಹೆಸರುಗಳಿಂದ|ಹೆಸರುಗಳು|hesaru|ಹೆಸರುಗಳಿಗೆ|ಹೆಸರಿಗೆ|ಹೆಸರಿನ	<i>noun</i><br><ol><li>name</li></ol>
ಹೇಗೆ|hēge	<i>adv</i><br><ol><li>(interrogative) how</li></ol>
ಹೇನು|hēnu	<i>noun</i><br><ol><li>louse</li></ol>
ಹೇಮಂತ|hēmanta	<i>noun</i><br><ol><li>winter</li></ol>
ಹೇರಿಕೆ|hērike	<i>noun</i><br><ol><li>imposition</li></ol>
ಹೇಳು|hēḷu|ಹೇಳುತ್ತದೆ|ಹೇಳುವಿ|ಹೇಳುವುವು|ಹೇಳಿದರು|ಹೇಳುತ್ತೀರಿ|ಹೇಳುತ್ತ|ಹೇಳ|ಹೇಳುವನು|ಹೇಳಿದೆವು|ಹೇಳೀಯೆ|ಹೇಳದ|ಹೇಳಿಯಾರು|ಹೇಳಿದಿ|ಹೇಳುವ|ಹೇಳದೆ|ಹೇಳುತ್ತೀಯೆ|ಹೇಳಿಯೇವು|ಹೇಳಲಿಕ್ಕೆ|ಹೇಳರಿ|ಹೇಳುವಾ|ಹೇಳುವುದು|ಹೇಳರು|ಹೇಳಲು|ಹೇಳುವೆವು|ಹೇಳೀರಿ|ಹೇಳಿದರೆ|ಹೇಳುತ್ತೇನೆ|ಹೇಳಿದುವು|ಹೇಳಿದನು|ಹೇಳೋಣ|ಹೇಳೀತು|ಹೇಳುವಿರಿ|ಹೇಳಿದೆ|ಹೇಳುವೆ|ಹೇಳುತ್ತಾರೆ|ಹೇಳುತ್ತಾನೆ|ಹೇಳಯೇನು|ಹೇಳುತ್ತಾಳೆ|ಹೇಳೆವು|ಹೇಳಲಿ|ಹೇಳಿದಳು|ಹೇಳಳು|ಹೇಳುವಳು|ಹೇಳಿಯಾನು|ಹೇಳುತ್ತೀ|ಹೇಳಿದೆನು|ಹೇಳೆ|ಹೇಳುತ್ತವೆ|ಹೇಳುತ್ತೇವೆ|ಹೇಳಿದಿರಿ|ಹೇಳನು|ಹೇಳವು|ಹೇಳಿದ|ಹೇಳುವೆನು|ಹೇಳುವರು|ಹೇಳತು|ಹೇಳಿರಿ|ಹೇಳೆನು|ಹೇಳಿಯಾವು|ಹೇಳದು|ಹೇಳಿಯಾಳು	<i>verb</i><br><ol><li>To say</li><li>To tell</li></ol>
ಹೈಗ|haiga	<i>noun</i><br><ol><li>Synonym of ಹವ್ಯಕ (havyaka)</li></ol><br><i>adj</i><br><ol><li>Synonym of ಹವ್ಯಕ (havyaka)</li></ol>
ಹೈಗನ್ನಡ|haigannaḍa	<i>name</i><br><ol><li>Synonym of ಹವ್ಯಕ ಕನ್ನಡ (havyaka kannaḍa)</li></ol>
ಹೊಗೆ|hoge	<i>noun</i><br><ol><li>broom</li><li>reek</li><li>smoke</li><li>fumes</li></ol>
ಹೊಟ್ಟೆ|hoṭṭe	<i>noun</i><br><ol><li>stomach</li></ol>
ಹೊತ್ತು|hottu	<i>noun</i><br><ol><li>time</li><li>(rare, obsolete) the sun</li></ol>
ಹೊನ್ನು|honnu	<i>noun</i><br><ol><li>gold</li></ol>
ಹೊರಗೆ|horage	<i>adv</i><br><ol><li>outside</li></ol>
ಹೊರಡು|ಹೊರಡುೆನು (horaḍuೆnu)|ಹೊರಡುವು|ಹೊರಡುುವರು (horaḍuುvaru)|ಹೊರಡುುತ್ತಾನೆ (horaḍuುttāne)|ಹೊರಡುನು|ಹೊರಡುುವುದು (horaḍuುvudu)|ಹೊರಟ್ಟ|ಹೊರಡುೀತು (horaḍuೀtu)|ಹೊರಟ್ಟಿರಿ|ಹೊರಡುುತ್ತೇವೆ (horaḍuುttēve)|ಹೊರಡುದೆ|ಹೊರಟ್ಟೆವು|ಹೊರಡ|ಹೊರಡುುವೆನು (horaḍuುvenu)|ಹೊರಡುುವೆವು (horaḍuುvevu)|ಹೊರಡತು|ಹೊರಡುಳು|ಹೊರಡುೆವು (horaḍuೆvu)|ಹೊರಡುುತ್ತೀ (horaḍuುttī)|ಹೊರಟ್ಟೆ|ಹೊರಟ್ಟರು|ಹೊರಡುರಿ|ಹೊರಡುುತ್ತ (horaḍuುtta)|ಹೊರಡುಲಿಕ್ಕೆ|ಹೊರಡುದ|ಹೊರಡುುತ್ತವೆ (horaḍuುttave)|ಹೊರಟ್ಟಿ|ಹೊರಡುುತ್ತೀಯೆ (horaḍuುttīye)|ಹೊರಡುುವಿರಿ (horaḍuುviri)|ಹೊರಡೀಯೆ|ಹೊರಡುಿಯಾಳು (horaḍuಿyāḷu)|ಹೊರಡುುವ (horaḍuುva)|ಹೊರಟ್ಟನು|ಹೊರಡುುವೆ (horaḍuುve)|ಹೊರಡಯೇನು|ಹೊರಡುಲು|ಹೊರಡುಿಯಾರು (horaḍuಿyāru)|ಹೊರಟ್ಟೆನು|ಹೊರಡುುವನು (horaḍuುvanu)|ಹೊರಡುುವಾ (horaḍuುvā)|ಹೊರಡುೋಣ (horaḍuೋṇa)|ಹೊರಡುಿರಿ (horaḍuಿri)|ಹೊರಡುುತ್ತದೆ (horaḍuುttade)|ಹೊರಡುುತ್ತಾಳೆ (horaḍuುttāḷe)|ಹೊರಡುೀರಿ (horaḍuೀri)|ಹೊರಡುದು|ಹೊರಟ್ಟಳು|ಹೊರಡುಿಯಾವು (horaḍuಿyāvu)|ಹೊರಡುುವುವು (horaḍuುvuvu)|ಹೊರಡುುತ್ತಾರೆ (horaḍuುttāre)|ಹೊರಡುೆ (horaḍuೆ)|ಹೊರಡುರು|ಹೊರಡುುತ್ತೀರಿ (horaḍuುttīri)|ಹೊರಡುುವಿ (horaḍuುvi)|ಹೊರಡುಿಯಾನು (horaḍuಿyānu)|ಹೊರಟ್ಟುವು|horaḍu|ಹೊರಡುುವಳು (horaḍuುvaḷu)|ಹೊರಡುುತ್ತೇನೆ (horaḍuುttēne)|ಹೊರಡುಿಯೇವು (horaḍuಿyēvu)|ಹೊರಟ್ಟರೆ|ಹೊರಡುು (horaḍuು)|ಹೊರಡುಲಿ	<i>verb</i><br><ol><li>To leave from a place</li><li>To set out</li></ol>
ಹೊಲ|ಹೊಲಗಳಿಗೆ|ಹೊಲವು|ಹೊಲಗಳು|ಹೊಲಗಳನ್ನು|ಹೊಲಗಳಿಂದ|ಹೊಲಗಳ|ಹೊಲಕ್ಕೆ|hola|ಹೊಲವನ್ನು|ಹೊಲದ|ಹೊಲದಿಂದ	<i>noun</i><br><ol><li>field</li></ol>
ಹೊಳೆ|ಹೊಳೆುತ್ತೀರಿ (hoḷeುttīri)|ಹೊಳೆಗಳು|ಹೊಳೆದನು|ಹೊಳೆಯುವುವು|{{{5}}}ಿತು ({{{5}}}ಿtu)|ಹೊಳೆಯವು|ಹೊಳೆಯುವನು|ಹೊಳೆಗೆ|ಹೊಳೆ}ಯಲಿಕ್ಕೆ (hoḷe}yalikke)|ಹೊಳೆಯಯುವೆ|ಹೊಳೆಯೆವು|ಹೊಳೆಯದೆ|ಹೊಳೆಯಲಿ|ಹೊಳೆಯನು|ಹೊಳೆಯುವೆವು|ಹೊಳೆಯರಿ|ಹೊಳೆಯುವುದು|ಹೊಳೆದಿ|ಹೊಳೆಯೆ|ಹೊಳೆಯಳು|ಹೊಳೆಗಳಿಂದ|ಹೊಳೆದಾವು|ಹೊಳೆದರು|ಹೊಳೆಯು|ಹೊಳೆದರೆ|ಹೊಳೆಯದು|ಹೊಳೆಯದ|ಹೊಳೆದಳು|ಹೊಳೆಯ|ಹೊಳೆಯುವರು|ಹೊಳೆಯೆನು|ಹೊಳೆದೀರಿ|ಹೊಳೆುತ್ತೀ (hoḷeುttī)|ಹೊಳೆಯುವಿ|ಹೊಳೆುತ್ತಾನೆ (hoḷeುttāne)|ಹೊಳೆದುವು|ಹೊಳೆಯುವ|ಹೊಳೆದ|ಹೊಳೆುತ್ತಾಳೆ (hoḷeುttāḷe)|ಹೊಳೆಯುವಳು|ಹೊಳೆಯುತ್ತ|ಹೊಳೆುತ್ತೀಯೆ (hoḷeುttīye)|ಹೊಳೆದೇವು|ಹೊಳೆಯುವೆ|ಹೊಳೆುತ್ತೇನೆ (hoḷeುttēne)|ಹೊಳೆುತ್ತದೆ (hoḷeುttade)|ಹೊಳೆುತ್ತಾರೆ (hoḷeುttāre)|ಹೊಳೆುತ್ತವೆ (hoḷeುttave)|ಹೊಳೆದಾನು|ಹೊಳೆಯೋಣ|hoḷe|ಹೊಳೆಗಳಿಗೆ|ಹೊಳೆದೆ|ಹೊಳೆದೀಯೆ|ಹೊಳೆಗಳ|ಹೊಳೆದೀತು|ಹೊಳೆದೆವು|{ಹೊಳೆಯಿರಿ ({hoḷeyiri)|ಹೊಳೆದೆನು|ಹೊಳೆದೇನು|ಹೊಳೆದಾಳು|ಹೊಳೆಯರು|ಹೊಳೆಗಳನ್ನು|ಹೊಳೆಯುವಾ|ಹೊಳೆುತ್ತೇವೆ (hoḷeುttēve)|ಹೊಳೆದಿರಿ|ಹೊಳೆಯುವಿರಿ|ಹೊಳೆಯನ್ನು|ಹೊಳೆದಾರು|ಹೊಳೆಯಿಂದ|ಹೊಳೆಯುವೆನು|ಹೊಳೆಯಲು	<i>noun</i><br><ol><li>(geography) river</li></ol><br><i>verb</i><br><ol><li>to shine</li><li>to brighten</li></ol>
ಹೊಸ|hosa	<i>adj</i><br><ol><li>new</li></ol>
ಹೋಗು|ಹೋಗಿಯೇನು|ಹೋಗುತ್ತದೆ|ಹೋದಿರಿ|ಹೋಗುವರು|ಹೋಗಿಯಾಳು|ಹೋಗೀರಿ|ಹೋಗುವುದು|ಹೋಗುತ್ತಾನೆ|ಹೋದನು|ಹೋಗುತ್ತಾರೆ|ಹೋಗುತ್ತವೆ|ಹೋಗದು|ಹೋಗುವಳು|ಹೋಗುವಿ|ಹೋಗೀತು|ಹೋಗುತ್ತೀ|ಹೋಗಿಯಾನು|ಹೋದರು|ಹೋಗುತ್ತಾಳೆ|ಹೋಗುವನು|ಹೋದುವು|ಹೋಗುವೆನು|ಹೋಗವು|ಹೋಗಿಯಾವು|ಹೋಗುವಿರಿ|ಹೋಗುವುವು|ಹೋಗುತ್ತೇವೆ|ಹೋಗುತ್ತೀರಿ|ಹೋಗನು|ಹೋಗರಿ|ಹೋಗೀಯೆ|ಹೋದಳು|ಹೋಗಿಯಾರು|hōgu|ಹೋಗುತ್ತೇನೆ|ಹೋದೆ|ಹೋಗೆವು|ಹೋಗರು|ಹೋದೆನು|ಹೋದೆವು|ಹೋಗಳು|ಹೋಗುವೆವು|ಹೋಯಿತು|ಹೋಗೆನು|ಹೋಗಿಯೇವು|ಹೋಗೆ	<i>verb</i><br><ol><li>To go</li><li>Used with the past verbal participle of verbs to give a completive aspect for verbs that involve change of state with a usually negative meaning</li><li>(euphemistic) to die</li></ol>
ಹೋಮ|hōma	<i>noun</i><br><ol><li>(Hinduism) homa; a Vedic ritual</li></ol>
ಹೋಳಿಗೆ|hōḷige	<i>noun</i><br><ol><li>a kind of sweet flatbread</li></ol>
ಹೌದು|haudu	<i>noun</i><br><ol><li>yes</li></ol>
ಹ್ರಸ್ವ|hrasva	<i>adj</i><br><ol><li>(grammar, of a vowel) short</li></ol>
ಽ	<i>character</i><br><ol><li>The avagraha in the Kannada script.</li></ol>
ಿ	<i>character</i><br><ol><li>The vowel sign of ಇ (i) in the Kannada script.</li></ol>
ೀ	<i>character</i><br><ol><li>The vowel sign of ಈ (ī) in the Kannada script.</li></ol>
ೂ	<i>character</i><br><ol><li>The vowel sign of ಊ (ū) in the Kannada script.</li></ol>
ೃ	<i>character</i><br><ol><li>The vowel sign of ಋ (ṛ) in the Kannada script.</li></ol>
ೄ	<i>character</i><br><ol><li>(obsolete) The vowel sign of ೠ (r̥̄) in the Kannada script.</li></ol>
ೆ	<i>character</i><br><ol><li>The vowel sign of ಎ (e) in the Kannada script.</li></ol>
ೈ	<i>character</i><br><ol><li>The vowel sign of ಐ (ai) in the Kannada script.</li></ol>
ೊ	<i>character</i><br><ol><li>The vowel sign of ಒ (o) in the Kannada script.</li></ol>
ೋ	<i>character</i><br><ol><li>The vowel sign of ಓ (ō) in the Kannada script.</li></ol>
ೌ	<i>character</i><br><ol><li>The vowel sign of ಔ (au) in the Kannada script.</li></ol>
್	<i>character</i><br><ol><li>The virama or killer in the Kannada script.</li></ol>
ೕ	<i>character</i><br><ol><li>The vowel length mark in the Kannada script. Example: ಿ (i) + ೕ (ೕ) = ೀ (ī)</li></ol>
ೖ	<i>character</i><br><ol><li>A vowel sign in the Kannada script.</li></ol>
ೞ|ḻa	<i>character</i><br><ol><li>(obsolete) The Kannada letter ḻa, which disappeared from Kannada around 1000 AD and is not part of the current Kannada orthography.</li></ol>
ೠ|r̥̄	<i>character</i><br><ol><li>(obsolete) The eighth vowel of the Kannada script.</li></ol>
೦|sonne	<i>num</i><br><ol><li>zero (numeral: 0 )</li></ol>
೧	<i>num</i><br><ol><li>ಒಂದು (ondu).</li><li>Represents the number 1 (one) in the Kannada script.</li></ol>
೨	<i>num</i><br><ol><li>ಎರಡು (eraḍu). Represents the number 2 (two) in the Kannada script.</li></ol>
೩	<i>num</i><br><ol><li>ಮೂರು (mūru). Represents the number 3 (three) in the Kannada script.</li></ol>
೪	<i>num</i><br><ol><li>ನಾಲ್ಕು (nālku). Represents the number 4 (four) in the Kannada script.</li></ol>
೫	<i>num</i><br><ol><li>ಐದು (aidu). Represents the number 5 (five) in the Kannada script.</li></ol>
೬	<i>num</i><br><ol><li>ಆರು (āru). Represents the number 6 (six) in the Kannada script.</li></ol>
೭	<i>num</i><br><ol><li>ಏಳು (ēḷu). Represents the number 7 (seven) in the Kannada script.</li></ol>
೮	<i>num</i><br><ol><li>ಎಂಟು (eṃṭu). Represents the number 8 (eight) in the Kannada script.</li></ol>
೯	<i>num</i><br><ol><li>ಒಂಬತ್ತು (ombattu). Represents the number 9 (nine) in the Kannada script.</li></ol>
ೱ	<i>character</i><br><ol><li>This diacritic is only used in Sanskrit and Prakrit texts. When a visargah comes after k or kh it becomes a [x] similar to the scotish loch.</li></ol>
ೲ	<i>character</i><br><ol><li>This diacritic is only used in Sanskrit and Prakrit texts. When a visargah comes after p or ph it becomes a [ɸ] similar to the f in fan but made with just the lips without touching the teeth, like blowing air.</li></ol>
