Biyarnis	<i>name</i><br><ol><li>Friday</li></ol>
Disimbri	<i>name</i><br><ol><li>December</li></ol>
Domingko	<i>name</i><br><ol><li>Sunday</li></ol>
Donis	<i>name</i><br><ol><li>Monday</li></ol>
Holyo	<i>name</i><br><ol><li>July</li></ol>
Kowibis	<i>name</i><br><ol><li>Thursday</li></ol>
Madtis	<i>name</i><br><ol><li>Tuesday</li></ol>
Marso	<i>name</i><br><ol><li>March</li></ol>
Mayo	<i>name</i><br><ol><li>May</li></ol>
Midkolis	<i>name</i><br><ol><li>Wednesday</li></ol>
Nobimbri	<i>name</i><br><ol><li>November</li></ol>
Oktobri	<i>name</i><br><ol><li>October</li></ol>
Sabaro	<i>name</i><br><ol><li>Saturday</li></ol>
abang	<i>noun</i><br><ol><li>rent money</li></ol>
abidat	<i>noun</i><br><ol><li>spouse of sibling-in-law</li></ol>
abokaro	<i>noun</i><br><ol><li>lawyer</li></ol>
achal	<i>noun</i><br><ol><li>learning; education</li></ol>
adak	<i>noun</i><br><ol><li>alcoholic beverage</li></ol>
adodon	<i>noun</i><br><ol><li>dragonfly</li></ol>
afoy	<i>noun</i><br><ol><li>fire</li></ol>
agas	<i>noun</i><br><ol><li>medicine</li></ol>
agom	<i>noun</i><br><ol><li>greed</li></ol>
agong	<i>noun</i><br><ol><li>small hut (usually located in the rice field or a garden)</li></ol>
agpayso	<i>noun</i><br><ol><li>truth</li></ol>
agsapa	<i>noun</i><br><ol><li>morning</li></ol>
agwa	<i>noun</i><br><ol><li>edible root of the taro plant</li></ol>
agwel	<i>noun</i><br><ol><li>woven cloth; loom</li></ol>
ahat	<i>noun</i><br><ol><li>ginger</li></ol>
ahi	<i>noun</i><br><ol><li>sibling</li></ol>
akbot	<i>noun</i><br><ol><li>backpack made of animal hide (usually deer or goat skins)</li></ol>
akdo	<i>noun</i><br><ol><li>any large serving utensil (such as a ladle, spatula, rice paddle, etc.)</li></ol>
akgwang	<i>noun</i><br><ol><li>length of stride</li></ol>
akow	<i>noun</i><br><ol><li>sun</li></ol>
alad	<i>noun</i><br><ol><li>fence; free-standing wall</li></ol>
alang	<i>noun</i><br><ol><li>rice granary</li></ol>
alebong	<i>noun</i><br><ol><li>(anatomy) thigh</li></ol>
alichon	<i>noun</i><br><ol><li>shadow</li></ol>
alingo	<i>noun</i><br><ol><li>wild pig</li></ol>
alinta	<i>noun</i><br><ol><li>large leech</li></ol>
alipospos	<i>noun</i><br><ol><li>whirlwind</li></ol>
along	<i>noun</i><br><ol><li>nosebleed</li></ol>
altiy	<i>noun</i><br><ol><li>(anatomy) liver</li></ol>
amayo	<i>noun</i><br><ol><li>toy</li></ol>
ambiyongan	<i>noun</i><br><ol><li>bumblebee</li></ol>
amis	<i>noun</i><br><ol><li>taste; flavor</li></ol>
amo	<i>noun</i><br><ol><li>master</li></ol>
amol	<i>noun</i><br><ol><li>dew</li></ol>
ampasit	<i>noun</i><br><ol><li>evil spirit (causing people to become ill and living in trees near water)</li></ol>
anak	<i>noun</i><br><ol><li>child</li></ol>
angal	<i>noun</i><br><ol><li>dog fight</li></ol>
angchap	<i>noun</i><br><ol><li>frost</li></ol>
angel	<i>noun</i><br><ol><li>(anatomy) body</li></ol>
anghil	<i>noun</i><br><ol><li>angel (messenger from a deity)</li></ol>
angin	<i>noun</i><br><ol><li>wind (movement of air)</li></ol>
angkop	<i>noun</i><br><ol><li>owl</li></ol>
angob	<i>noun</i><br><ol><li>smell</li></ol>
angpas	<i>noun</i><br><ol><li>tick (insect)</li></ol>
angpasit	<i>noun</i><br><ol><li>spirit that usually lives near trees or streams</li></ol>
angsed	<i>noun</i><br><ol><li>body odor</li></ol>
ani	<i>noun</i><br><ol><li>rice harvest</li></ol>
aninit	<i>noun</i><br><ol><li>ghost; spirit</li></ol>
anos	<i>noun</i><br><ol><li>patience</li></ol>
apal	<i>noun</i><br><ol><li>envy; jealousy</li></ol>
apalja	<i>noun</i><br><ol><li>bitter gourd</li></ol>
apangel	<i>noun</i><br><ol><li>big red ant</li></ol>
apko	<i>noun</i><br><ol><li>(anatomy) gall bladder</li></ol>
aramdi	<i>noun</i><br><ol><li>wire</li></ol>
aramid	<i>noun</i><br><ol><li>custom; practice</li></ol>
arem	<i>noun</i><br><ol><li>boyfriend; girlfriend; sweetheart</li></ol>
ari	<i>noun</i><br><ol><li>king</li></ol>
arig	<i>noun</i><br><ol><li>example</li></ol>
asimiy	<i>noun</i><br><ol><li>small red ant</li></ol>
asin	<i>noun</i><br><ol><li>salt</li></ol>
aso	<i>noun</i><br><ol><li>dog</li></ol>
asok	<i>noun</i><br><ol><li>smoke</li></ol>
asokal	<i>noun</i><br><ol><li>sugar</li></ol>
athap	<i>adj</i><br><ol><li>wild (of an animal)</li></ol>
athip	<i>noun</i><br><ol><li>sheath (of a bolo)</li></ol>
atob	<i>noun</i><br><ol><li>prayer chanted by women to a dead person</li></ol>
ayog	<i>noun</i><br><ol><li>accent (in speech)</li></ol>
baas	<i>noun</i><br><ol><li>coffee dreg (left on a cup or kettle)</li></ol>
badekbek	<i>noun</i><br><ol><li>hot spring</li></ol>
badeki	<i>noun</i><br><ol><li>cockroach</li></ol>
badilis	<i>noun</i><br><ol><li>wheel; tyre</li></ol>
badiyang	<i>noun</i><br><ol><li>menstruation</li></ol>
bado	<i>adj</i><br><ol><li>new</li></ol>
badoran	<i>noun</i><br><ol><li>jail</li></ol>
baeng	<i>noun</i><br><ol><li>backyard</li></ol>
bagaen	<i>noun</i><br><ol><li>servant; slave</li></ol>
bagwet	<i>noun</i><br><ol><li>top (toy)</li></ol>
baha	<i>noun</i><br><ol><li>cow</li></ol>
bahasjon	<i>noun</i><br><ol><li>vacation</li></ol>
bahoko	<i>noun</i><br><ol><li>turtle</li></ol>
bajawas	<i>noun</i><br><ol><li>guava</li></ol>
bakilat	<i>noun</i><br><ol><li>lightning</li></ol>
bala	<i>noun</i><br><ol><li>(anatomy) lung</li></ol>
balat	<i>noun</i><br><ol><li>banana</li></ol>
balcharo	<i>noun</i><br><ol><li>fishing net</li></ol>
bales	<i>noun</i><br><ol><li>revenge</li></ol>
balitok	<i>noun</i><br><ol><li>gold</li></ol>
baliy	<i>noun</i><br><ol><li>house</li></ol>
balkeg	<i>noun</i><br><ol><li>five centavos</li></ol>
balkes	<i>noun</i><br><ol><li>belt</li></ol>
balkot	<i>noun</i><br><ol><li>package</li></ol>
balo	<i>noun</i><br><ol><li>widow; widower</li></ol>
balodahi	<i>noun</i><br><ol><li>young, unmarried man</li></ol>
balongibing	<i>noun</i><br><ol><li>cockscomb</li></ol>
banag	<i>noun</i><br><ol><li>meaning</li></ol>
banaw	<i>noun</i><br><ol><li>width; dimension</li></ol>
bancha	<i>noun</i><br><ol><li>warning</li></ol>
banga	<i>noun</i><br><ol><li>clayen pot</li><li>soot (from a clayen pot)</li></ol>
bangaw	<i>noun</i><br><ol><li>owl</li></ol>
bangdo	<i>noun</i><br><ol><li>fragrance</li></ol>
bangka	<i>noun</i><br><ol><li>small boat; canoe</li></ol>
bangko	<i>noun</i><br><ol><li>bench</li></ol>
baniy	<i>noun</i><br><ol><li>leg band</li></ol>
banol	<i>noun</i><br><ol><li>value</li></ol>
bapor	<i>noun</i><br><ol><li>large ship</li></ol>
baras	<i>noun</i><br><ol><li>whip</li></ol>
barkada	<i>noun</i><br><ol><li>gang</li></ol>
baro	<i>noun</i><br><ol><li>clothes; dress</li></ol>
basikol	<i>noun</i><br><ol><li>a type of large, round, and edible snail (found in rice fields)</li></ol>
baso	<i>noun</i><br><ol><li>drinking glass</li></ol>
basol	<i>noun</i><br><ol><li>sin; fault</li></ol>
basora	<i>noun</i><br><ol><li>garbage</li></ol>
bathatas	<i>noun</i><br><ol><li>potato</li></ol>
batho	<i>noun</i><br><ol><li>stone; rock</li></ol>
bawang	<i>noun</i><br><ol><li>garlic</li></ol>
bayad	<i>noun</i><br><ol><li>payment</li></ol>
bayaw	<i>noun</i><br><ol><li>sibling-in-law</li></ol>
bayek	<i>noun</i><br><ol><li>tadpole</li></ol>
bayengbeng	<i>noun</i><br><ol><li>bamboo</li><li>bamboo water container</li></ol>
bechel	<i>noun</i><br><ol><li>pregnancy</li></ol>
bedat	<i>noun</i><br><ol><li>(anatomy) skin</li><li>bark (of a tree)</li></ol>
bekas	<i>noun</i><br><ol><li>uncooked rice</li></ol>
belniw	<i>noun</i><br><ol><li>fishing line</li></ol>
belsis	<i>noun</i><br><ol><li>(anatomy) bile</li></ol>
bengat	<i>adv</i><br><ol><li>only</li></ol>
bengbeng	<i>noun</i><br><ol><li>door</li></ol>
bengel	<i>noun</i><br><ol><li>headband</li></ol>
betang	<i>noun</i><br><ol><li>share; portion</li></ol>
bigla	<i>adv</i><br><ol><li>suddenly</li></ol>
bii	<i>noun</i><br><ol><li>woman</li></ol>
bileg	<i>noun</i><br><ol><li>small leech</li></ol>
bilin	<i>noun</i><br><ol><li>counsel; advice; instruction</li></ol>
binga	<i>noun</i><br><ol><li>small edible snail</li></ol>
binis	<i>noun</i><br><ol><li>tax</li></ol>
birong	<i>noun</i><br><ol><li>(anatomy) bladder</li><li>balloon</li></ol>
bitheg	<i>noun</i><br><ol><li>poverty</li></ol>
bithibit	<i>noun</i><br><ol><li>ash; cinders</li></ol>
bithil	<i>noun</i><br><ol><li>famine</li></ol>
biyag	<i>noun</i><br><ol><li>life</li></ol>
biyang	<i>noun</i><br><ol><li>responsibility</li></ol>
bobod	<i>noun</i><br><ol><li>yeast</li></ol>
bobongan	<i>noun</i><br><ol><li>roof</li></ol>
bodki	<i>noun</i><br><ol><li>blindness in one eye</li></ol>
bohi	<i>noun</i><br><ol><li>meat</li></ol>
bokaw	<i>noun</i><br><ol><li>hawk</li></ol>
bokdow	<i>noun</i><br><ol><li>(anatomy) neck</li></ol>
bokjong	<i>noun</i><br><ol><li>goiter</li></ol>
bolan	<i>noun</i><br><ol><li>moon</li><li>month</li></ol>
bolengen	<i>noun</i><br><ol><li>monkey</li></ol>
bolikas	<i>noun</i><br><ol><li>pronunciation</li></ol>
bolilit	<i>noun</i><br><ol><li>small adult</li></ol>
bolnong	<i>noun</i><br><ol><li>rainbow</li></ol>
bolong	<i>noun</i><br><ol><li>leaf</li></ol>
bonat	<i>noun</i><br><ol><li>family relative (person)</li></ol>
bonga	<i>noun</i><br><ol><li>flower</li></ol>
bongbong	<i>noun</i><br><ol><li>explosion</li></ol>
bonong	<i>noun</i><br><ol><li>prayer directed to the spirits</li></ol>
boot	<i>noun</i><br><ol><li>mold</li></ol>
borit	<i>noun</i><br><ol><li>line</li></ol>
boros	<i>noun</i><br><ol><li>pine tree</li></ol>
bosakan	<i>noun</i><br><ol><li>east</li></ol>
bosol	<i>noun</i><br><ol><li>bandit</li></ol>
botbot	<i>noun</i><br><ol><li>curse; swearing</li></ol>
botheng	<i>noun</i><br><ol><li>drunkenness</li></ol>
botho	<i>noun</i><br><ol><li>(anatomy) vagina</li></ol>
bowa	<i>noun</i><br><ol><li>areca nut</li></ol>
bowaja	<i>noun</i><br><ol><li>crocodile</li></ol>
bowek	<i>noun</i><br><ol><li>(anatomy) hair</li></ol>
chadsak	<i>noun</i><br><ol><li>joy; happiness</li></ol>
chafan	<i>noun</i><br><ol><li>(anatomy) sole (of one's foot)</li></ol>
chaga	<i>noun</i><br><ol><li>land</li></ol>
chahem	<i>noun</i><br><ol><li>wind</li></ol>
chakom	<i>noun</i><br><ol><li>needle; straight pin</li></ol>
chala	<i>noun</i><br><ol><li>(anatomy) blood</li></ol>
chalan	<i>noun</i><br><ol><li>path; route; trail</li></ol>
chalay	<i>noun</i><br><ol><li>large clay jar (used for storing water)</li></ol>
chalojon	<i>noun</i><br><ol><li>waves</li></ol>
chamag	<i>noun</i><br><ol><li>news</li></ol>
changko	<i>noun</i><br><ol><li>scallion; green onion</li></ol>
chani	<i>noun</i><br><ol><li>plaque (on one's teeth)</li></ol>
chanom	<i>noun</i><br><ol><li>water</li></ol>
chegwa	<i>num</i><br><ol><li>two</li></ol>
cheko	<i>noun</i><br><ol><li>small rice field</li></ol>
chepdas	<i>noun</i><br><ol><li>cliff</li></ol>
chepen	<i>noun</i><br><ol><li>cushion; pad; padding</li></ol>
chigo	<i>noun</i><br><ol><li>soup; broth</li></ol>
chigwa	<i>noun</i><br><ol><li>belief</li></ol>
chingching	<i>noun</i><br><ol><li>wall</li></ol>
chingkol	<i>noun</i><br><ol><li>dispute</li></ol>
chochongan	<i>noun</i><br><ol><li>low stool</li></ol>
chokiy	<i>noun</i><br><ol><li>length</li></ol>
cholong	<i>noun</i><br><ol><li>lumber</li></ol>
chontog	<i>noun</i><br><ol><li>mountain</li></ol>
chopda	<i>noun</i><br><ol><li>spit</li></ol>
choron	<i>noun</i><br><ol><li>grasshopper; locust</li></ol>
chosa	<i>noun</i><br><ol><li>punishment; penalty</li></ol>
chotchot	<i>noun</i><br><ol><li>feather; fur; hair</li></ol>
daba	<i>noun</i><br><ol><li>laundry</li></ol>
dadabi	<i>noun</i><br><ol><li>early morning</li></ol>
daga	<i>noun</i><br><ol><li>ritual performed for a sick person</li></ol>
dagbo	<i>noun</i><br><ol><li>salary</li></ol>
dagoy	<i>noun</i><br><ol><li>moss</li></ol>
dakari	<i>noun</i><br><ol><li>saw (tool)</li></ol>
dalat	<i>noun</i><br><ol><li>leather</li></ol>
damot	<i>noun</i><br><ol><li>root</li></ol>
danas	<i>noun</i><br><ol><li>flood</li></ol>
danchok	<i>noun</i><br><ol><li>metal</li></ol>
dangaja	<i>noun</i><br><ol><li>round basket</li></ol>
dangan	<i>noun</i><br><ol><li>absence</li></ol>
dangit	<i>noun</i><br><ol><li>sky; heaven</li><li>meat for sale</li></ol>
dangka	<i>noun</i><br><ol><li>jackfruit</li></ol>
dansa	<i>noun</i><br><ol><li>nail (tool)</li></ol>
danti	<i>noun</i><br><ol><li>hail</li></ol>
dantong	<i>noun</i><br><ol><li>sweet potato leaf</li></ol>
daring	<i>noun</i><br><ol><li>small fish</li></ol>
dasa	<i>noun</i><br><ol><li>fine dust from pounded rice</li></ol>
dasona	<i>noun</i><br><ol><li>small red onion</li></ol>
dasos	<i>num</i><br><ol><li>hundred</li></ol>
dathi	<i>noun</i><br><ol><li>rust</li></ol>
dawan	<i>noun</i><br><ol><li>flesh (the meat of a body).</li></ol>
dawed	<i>noun</i><br><ol><li>a type of vine (whose leaves are chewed with areca nut and lime)</li></ol>
debeg	<i>noun</i><br><ol><li>rice mixed with liquid (usually eaten by children)</li></ol>
degdeg	<i>noun</i><br><ol><li>clay (white, gray, or blue)</li></ol>
dekna	<i>noun</i><br><ol><li>emotion (physical or emotional)</li></ol>
demdem	<i>noun</i><br><ol><li>drizzle; little rain</li></ol>
denakan	<i>noun</i><br><ol><li>west</li></ol>
depok	<i>noun</i><br><ol><li>dust</li></ol>
depto	<i>noun</i><br><ol><li>blister</li></ol>
dibcho	<i>noun</i><br><ol><li>book</li></ol>
dibo	<i>num</i><br><ol><li>thousand</li></ol>
difad	<i>noun</i><br><ol><li>(anatomy) upper thigh</li></ol>
digat	<i>noun</i><br><ol><li>difficulty; hardship</li></ol>
dilos	<i>noun</i><br><ol><li>wristwatch; clock</li></ol>
dima	<i>num</i><br><ol><li>five</li></ol>
dimonyo	<i>noun</i><br><ol><li>demon</li></ol>
dinawa	<i>noun</i><br><ol><li>soul (person or animal, living or dead)</li></ol>
dingagwan	<i>noun</i><br><ol><li>backdoor</li></ol>
dinget	<i>noun</i><br><ol><li>sweat</li></ol>
dingkamas	<i>noun</i><br><ol><li>jicama</li></ol>
dinowan	<i>noun</i><br><ol><li>bee</li><li>honeycomb</li></ol>
dinteg	<i>noun</i><br><ol><li>law; rule</li></ol>
disibo	<i>noun</i><br><ol><li>receipt</li></ol>
dismaya	<i>noun</i><br><ol><li>disappointment; discouragement</li></ol>
distaan	<i>noun</i><br><ol><li>list</li></ol>
ditdit	<i>noun</i><br><ol><li>small house bat</li></ol>
diwa	<i>noun</i><br><ol><li>(anatomy) arm; hand</li></ol>
diyek	<i>noun</i><br><ol><li>termite</li></ol>
dobid	<i>noun</i><br><ol><li>thread</li></ol>
dobong	<i>noun</i><br><ol><li>world; earth</li></ol>
dofa	<i>noun</i><br><ol><li>(anatomy) face</li></ol>
dofot	<i>noun</i><br><ol><li>cloth; material</li></ol>
dogad	<i>noun</i><br><ol><li>place; area; region</li></ol>
dohod	<i>noun</i><br><ol><li>measurement; measure</li></ol>
dokbong	<i>noun</i><br><ol><li>arrow</li></ol>
dokto	<i>noun</i><br><ol><li>sweet potato</li></ol>
domingko	<i>noun</i><br><ol><li>week</li></ol>
dongban	<i>noun</i><br><ol><li>pomelo</li></ol>
doong	<i>noun</i><br><ol><li>space underneath something</li></ol>
dowado	<i>noun</i><br><ol><li>prayer</li></ol>
dowag	<i>noun</i><br><ol><li>stream</li></ol>
edem	<i>noun</i><br><ol><li>jealousy (for one's spouse, boyfriend, or girlfriend)</li></ol>
egchi	<i>noun</i><br><ol><li>handle</li></ol>
egwas	<i>noun</i><br><ol><li>knife</li></ol>
ekaget	<i>adj</i><br><ol><li>industrious</li></ol>
ekes	<i>noun</i><br><ol><li>(anatomy) stomach</li></ol>
ekow	<i>noun</i><br><ol><li>thirst</li></ol>
emo	<i>adv</i><br><ol><li>maybe</li></ol>
enem	<i>num</i><br><ol><li>six</li></ol>
engasin	<i>adj</i><br><ol><li>salty</li></ol>
engos	<i>noun</i><br><ol><li>sadness; sorrow</li></ol>
engoso	<i>noun</i><br><ol><li>orphan</li></ol>
epat	<i>num</i><br><ol><li>four</li></ol>
esim	<i>noun</i><br><ol><li>sheet of tin (used for roofs or sides of buildings)</li></ol>
etak	<i>noun</i><br><ol><li>bolo</li></ol>
etek	<i>noun</i><br><ol><li>pride</li></ol>
etiy	<i>noun</i><br><ol><li>dead person</li></ol>
etot	<i>noun</i><br><ol><li>fart; flatulence</li></ol>
goyabano	<i>noun</i><br><ol><li>soursop</li></ol>
gwahal	<i>noun</i><br><ol><li>vine</li></ol>
gwakes	<i>noun</i><br><ol><li>(anatomy) waist</li></ol>
gwalgwadik	<i>noun</i><br><ol><li>flower of the banana tree</li></ol>
gwalo	<i>num</i><br><ol><li>eight</li></ol>
gwasay	<i>noun</i><br><ol><li>axe</li></ol>
hombok	<i>noun</i><br><ol><li>Chinese cabbage; Napa cabbage</li></ol>
idad	<i>noun</i><br><ol><li>age</li></ol>
ifit	<i>noun</i><br><ol><li>clothespin; paper clip; hairclip</li></ol>
ihol	<i>noun</i><br><ol><li>tail</li></ol>
iit	<i>noun</i><br><ol><li>reed broom; broom made of sticks</li></ol>
ikdog	<i>noun</i><br><ol><li>egg</li></ol>
ikot	<i>noun</i><br><ol><li>selfishness</li></ol>
ili	<i>noun</i><br><ol><li>community where people live</li><li>home country</li></ol>
ilit	<i>noun</i><br><ol><li>nit; egg of a louse</li></ol>
ilol	<i>noun</i><br><ol><li>(anatomy) saliva</li></ol>
imbaliy	<i>noun</i><br><ol><li>spouse</li></ol>
iming	<i>noun</i><br><ol><li>(anatomy) beard; mustache</li></ol>
ina	<i>noun</i><br><ol><li>mother</li></ol>
indotho	<i>noun</i><br><ol><li>hot cooked rice</li></ol>
ineng	<i>noun</i><br><ol><li>rice seedling</li></ol>
inengan	<i>noun</i><br><ol><li>seedling bed for rice</li></ol>
inepoy	<i>noun</i><br><ol><li>hot cooked rice</li></ol>
inoman	<i>noun</i><br><ol><li>drinking place</li></ol>
ira	<i>pron</i><br><ol><li>they</li></ol>
iros	<i>noun</i><br><ol><li>ladle</li></ol>
iskwida	<i>noun</i><br><ol><li>school</li></ol>
ispada	<i>noun</i><br><ol><li>sword</li></ol>
ispiho	<i>noun</i><br><ol><li>mirror</li></ol>
ispirito	<i>noun</i><br><ol><li>spirit</li></ol>
itek	<i>noun</i><br><ol><li>lie</li></ol>
itsa	<i>noun</i><br><ol><li>tea</li></ol>
jabjab	<i>noun</i><br><ol><li>breeze</li><li>fan</li></ol>
jafit	<i>adj</i><br><ol><li>thin (of inanimate objects)</li></ol>
jaod	<i>noun</i><br><ol><li>(anatomy) back of the knee</li></ol>
jasjas	<i>noun</i><br><ol><li>breath</li></ol>
jegjeg	<i>noun</i><br><ol><li>earthquake</li></ol>
jenged	<i>noun</i><br><ol><li>(anatomy) nape</li></ol>
jogaw	<i>noun</i><br><ol><li>baby food (made by grinding or cooking until soft)</li></ol>
jowjow	<i>noun</i><br><ol><li>huge flood; deluge</li></ol>
kaakawan	<i>noun</i><br><ol><li>daytime</li></ol>
kaamayo	<i>noun</i><br><ol><li>playmate</li></ol>
kaapoan	<i>noun</i><br><ol><li>ancestor</li></ol>
kaasi	<i>noun</i><br><ol><li>compassion; pity</li></ol>
kabajo	<i>noun</i><br><ol><li>horse</li></ol>
kabal	<i>noun</i><br><ol><li>enemy</li></ol>
kabat	<i>noun</i><br><ol><li>scar</li></ol>
kabaw	<i>adj</i><br><ol><li>senile</li></ol>
kabikab	<i>noun</i><br><ol><li>padlock; lock</li></ol>
kabjon	<i>noun</i><br><ol><li>long-handled hoe with three or four metal prongs</li></ol>
kabonian	<i>noun</i><br><ol><li>supreme spirit being (in the traditional religion)</li></ol>
kadina	<i>noun</i><br><ol><li>chain</li></ol>
kafot	<i>noun</i><br><ol><li>thin rope</li><li>strand of a spiderweb</li></ol>
kagol	<i>noun</i><br><ol><li>cause; reason</li></ol>
kagwis	<i>noun</i><br><ol><li>dawn (from about 3AM to 6AM)</li></ol>
kahoy	<i>noun</i><br><ol><li>cassava</li></ol>
kaing	<i>noun</i><br><ol><li>skirt</li></ol>
kaising	<i>noun</i><br><ol><li>parent-in-law of one's child</li></ol>
kajem	<i>noun</i><br><ol><li>friend</li></ol>
kakaban	<i>noun</i><br><ol><li>henhouse; chicken coop</li></ol>
kakagwa	<i>noun</i><br><ol><li>spider</li></ol>
kakajap	<i>noun</i><br><ol><li>small, brown edible beans</li></ol>
kakanan	<i>noun</i><br><ol><li>eating place</li></ol>
kakaok	<i>noun</i><br><ol><li>crow (of a rooster)</li></ol>
kalabian	<i>noun</i><br><ol><li>nighttime</li></ol>
kalakiyan	<i>noun</i><br><ol><li>big male water buffalo</li></ol>
kalapati	<i>noun</i><br><ol><li>dove; pigeon</li></ol>
kalat	<i>noun</i><br><ol><li>bite; sting</li></ol>
kalbot	<i>noun</i><br><ol><li>large cloth for wrapping objects or one's body (for sleeping)</li></ol>
kalchang	<i>noun</i><br><ol><li>string (of a musical instrument)</li></ol>
kalebosan	<i>noun</i><br><ol><li>jail; prison</li></ol>
kalengahang	<i>noun</i><br><ol><li>(anatomy) palate</li></ol>
kalesay	<i>noun</i><br><ol><li>shield</li></ol>
kalidkid	<i>noun</i><br><ol><li>digging tool with a long handle and a pointed end</li></ol>
kalikagom	<i>noun</i><br><ol><li>desire; hope; wish</li></ol>
kalka	<i>noun</i><br><ol><li>cargo; load</li></ol>
kalniro	<i>noun</i><br><ol><li>sheep</li></ol>
kalomot	<i>noun</i><br><ol><li>(anatomy) finger; toe</li></ol>
kalon	<i>noun</i><br><ol><li>water buffalo butchered to celebrate a marriage</li></ol>
kalongkong	<i>noun</i><br><ol><li>(anatomy) throat</li></ol>
kaloy	<i>noun</i><br><ol><li>mud</li></ol>
kalpat	<i>noun</i><br><ol><li>large basket carried by men on the back with a head strap</li></ol>
kalpintiro	<i>noun</i><br><ol><li>carpenter</li></ol>
kalsa	<i>noun</i><br><ol><li>brass gong</li></ol>
kalsara	<i>noun</i><br><ol><li>road</li></ol>
kamajan	<i>noun</i><br><ol><li>centipede</li></ol>
kamali	<i>noun</i><br><ol><li>mistake</li></ol>
kamatis	<i>noun</i><br><ol><li>tomato</li></ol>
kamdang	<i>noun</i><br><ol><li>knife used for harvesting rice</li></ol>
kamen	<i>noun</i><br><ol><li>sleeping mat</li></ol>
kameng	<i>noun</i><br><ol><li>property; possessions</li></ol>
kamodas	<i>noun</i><br><ol><li>smallpox</li></ol>
kampilan	<i>noun</i><br><ol><li>sword</li></ol>
kamposan	<i>noun</i><br><ol><li>grave; cemetery</li></ol>
kancharo	<i>noun</i><br><ol><li>cooking pot (usually metal)</li></ol>
kanchila	<i>noun</i><br><ol><li>candle</li></ol>
kanching	<i>noun</i><br><ol><li>goat</li></ol>
kanjaw	<i>noun</i><br><ol><li>celebration with a butchered pig or water buffalo</li></ol>
kanso	<i>noun</i><br><ol><li>goose</li></ol>
kaong	<i>noun</i><br><ol><li>female pig that has given birth</li></ol>
kapi	<i>noun</i><br><ol><li>coffee</li></ol>
kapian	<i>noun</i><br><ol><li>coffee place; cafe</li><li>coffee plantation</li></ol>
kara	<i>noun</i><br><ol><li>purpose; motive; intention</li></ol>
karambel	<i>noun</i><br><ol><li>skin rash</li></ol>
karang	<i>noun</i><br><ol><li>span from the extended middle finger to the thumb</li></ol>
kararag	<i>noun</i><br><ol><li>prayer</li></ol>
karawjan	<i>noun</i><br><ol><li>custom; ritual</li></ol>
karebengan	<i>noun</i><br><ol><li>authority</li></ol>
karing	<i>noun</i><br><ol><li>rubber band</li></ol>
kasaad	<i>noun</i><br><ol><li>social status</li></ol>
kasal	<i>noun</i><br><ol><li>wedding</li></ol>
kasapolan	<i>noun</i><br><ol><li>necessity</li></ol>
kasat	<i>noun</i><br><ol><li>luck</li></ol>
kasimon	<i>noun</i><br><ol><li>cucumber</li></ol>
kasingsing	<i>noun</i><br><ol><li>cousin</li></ol>
kastarol	<i>noun</i><br><ol><li>spendthrift</li></ol>
kastos	<i>noun</i><br><ol><li>expense</li></ol>
katdi	<i>noun</i><br><ol><li>scissors</li></ol>
katham	<i>noun</i><br><ol><li>plane (tool)</li></ol>
kathas	<i>noun</i><br><ol><li>milk</li></ol>
kathat	<i>noun</i><br><ol><li>leather; hide of an animal</li></ol>
kathin	<i>noun</i><br><ol><li>footstep</li></ol>
katiljas	<i>noun</i><br><ol><li>bathroom; toilet</li></ol>
katiri	<i>noun</i><br><ol><li>bed</li></ol>
kawa	<i>noun</i><br><ol><li>middle; halfway</li></ol>
kawi	<i>pron</i><br><ol><li>we; us (exclusive of the person spoken to)</li></ol>
kawil	<i>noun</i><br><ol><li>coconut shell</li></ol>
kawitan	<i>noun</i><br><ol><li>cock; rooster</li></ol>
kayang	<i>noun</i><br><ol><li>spear</li></ol>
kaybang	<i>noun</i><br><ol><li>conical basket carried usually by women on the back using a head strap</li></ol>
kayo	<i>pron</i><br><ol><li>(in the plural) you</li></ol>
kebkeban	<i>noun</i><br><ol><li>pigpen</li></ol>
kechay	<i>noun</i><br><ol><li>landslide; erosion</li></ol>
kechel	<i>noun</i><br><ol><li>domesticated pig</li></ol>
kedang	<i>noun</i><br><ol><li>intestinal worm</li></ol>
kedeb	<i>noun</i><br><ol><li>wall that separates a higher ricefield from a lower one</li></ol>
kedit	<i>noun</i><br><ol><li>pinch</li></ol>
kednal	<i>noun</i><br><ol><li>first weeding of rice plants</li></ol>
kedpeng	<i>adj</i><br><ol><li>short (in length)</li></ol>
kedsang	<i>noun</i><br><ol><li>strength (of people or animals)</li></ol>
kedso	<i>noun</i><br><ol><li>wooden pestle (used with a wooden mortar)</li></ol>
kejag	<i>noun</i><br><ol><li>round flat basket (used for winnowing)</li></ol>
kejow	<i>noun</i><br><ol><li>tree; firewood</li></ol>
kelchas	<i>noun</i><br><ol><li>epilepsy</li></ol>
keljaw	<i>noun</i><br><ol><li>shout</li></ol>
kemkemti	<i>noun</i><br><ol><li>firefly</li></ol>
kenchat	<i>noun</i><br><ol><li>natural tendency</li></ol>
kenot	<i>noun</i><br><ol><li>dried tobacco</li></ol>
kesis	<i>noun</i><br><ol><li>(anatomy) semen</li></ol>
kespo	<i>adj</i><br><ol><li>short (of height)</li></ol>
ketap	<i>noun</i><br><ol><li>blanket</li></ol>
kidingan	<i>noun</i><br><ol><li>coffee grinder</li></ol>
kihan	<i>noun</i><br><ol><li>celebration where meat is served</li></ol>
kihing	<i>noun</i><br><ol><li>(anatomy) little finger; little toe</li></ol>
kikaw	<i>noun</i><br><ol><li>young louse</li></ol>
kikkihan	<i>noun</i><br><ol><li>(anatomy) armpit</li></ol>
kilaban	<i>noun</i><br><ol><li>cold cooked rice</li></ol>
kilig	<i>noun</i><br><ol><li>edge (of rivers, tables, paper, etc.)</li></ol>
kilkil	<i>noun</i><br><ol><li>headache</li></ol>
kilkiling	<i>noun</i><br><ol><li>(anatomy) uterus</li></ol>
kilo	<i>noun</i><br><ol><li>kilogram</li></ol>
kimkim	<i>noun</i><br><ol><li>blink (of eyes)</li></ol>
kinatoo	<i>noun</i><br><ol><li>personhood</li></ol>
kingki	<i>noun</i><br><ol><li>homemade kerosene lamp</li></ol>
kinoyod	<i>noun</i><br><ol><li>tug-of-war</li></ol>
kintoman	<i>noun</i><br><ol><li>red rice</li></ol>
kiripo	<i>noun</i><br><ol><li>faucet</li></ol>
kiriy	<i>noun</i><br><ol><li>(anatomy) eyebrow</li></ol>
kirol	<i>noun</i><br><ol><li>thunder</li></ol>
kiskis	<i>noun</i><br><ol><li>fish scales</li></ol>
kitheb	<i>noun</i><br><ol><li>bedbug</li></ol>
kitjaw	<i>noun</i><br><ol><li>lie; falsehood</li></ol>
kiwet	<i>noun</i><br><ol><li>eel</li></ol>
kiya	<i>pron</i><br><ol><li>we (inclusive of the person spoken to)</li></ol>
kiyes	<i>noun</i><br><ol><li>cicada</li></ol>
kobat	<i>noun</i><br><ol><li>war</li></ol>
kobchal	<i>noun</i><br><ol><li>use; benefit</li></ol>
kodkod	<i>noun</i><br><ol><li>mange</li></ol>
kodsara	<i>noun</i><br><ol><li>spoon</li></ol>
kofit	<i>adj</i><br><ol><li>narrow</li></ol>
kofita	<i>noun</i><br><ol><li>wallet; purse</li></ol>
kogal	<i>noun</i><br><ol><li>traditional G-string garment worn by men</li></ol>
kogit	<i>noun</i><br><ol><li>circumcision</li></ol>
koho	<i>noun</i><br><ol><li>(anatomy) fingernail; toenail</li><li>claw (of an animal)</li></ol>
kokip	<i>noun</i><br><ol><li>dream</li></ol>
kolad	<i>noun</i><br><ol><li>ringworm</li></ol>
kolada	<i>noun</i><br><ol><li>bleach</li></ol>
kolbong	<i>noun</i><br><ol><li>rattan or bamboo container (round or rectangular)</li></ol>
kolengis	<i>noun</i><br><ol><li>harelip</li></ol>
kolid	<i>noun</i><br><ol><li>scab</li></ol>
kolideng	<i>noun</i><br><ol><li>(anatomy) earwax</li></ol>
kolo	<i>noun</i><br><ol><li>trouble; disturbance</li></ol>
kolokol	<i>noun</i><br><ol><li>irrigation canal</li></ol>
kolong	<i>noun</i><br><ol><li>coffin</li></ol>
kolos	<i>noun</i><br><ol><li>river; stream</li></ol>
kolpot	<i>noun</i><br><ol><li>cloud; fog</li></ol>
kombibi	<i>noun</i><br><ol><li>freshwater clam</li></ol>
komising	<i>noun</i><br><ol><li>flute</li></ol>
kompay	<i>noun</i><br><ol><li>small hand sickle</li></ol>
komsil	<i>noun</i><br><ol><li>edible root of a taro plant</li></ol>
konkona	<i>noun</i><br><ol><li>reward; gain; benefit</li></ol>
korabis	<i>noun</i><br><ol><li>matches</li></ol>
korinti	<i>noun</i><br><ol><li>electricity</li></ol>
korona	<i>noun</i><br><ol><li>crown</li></ol>
koros	<i>noun</i><br><ol><li>cross</li></ol>
korti	<i>noun</i><br><ol><li>court of law</li></ol>
kosang	<i>noun</i><br><ol><li>charcoal; coal</li></ol>
kosina	<i>noun</i><br><ol><li>kitchen</li></ol>
kosnod	<i>noun</i><br><ol><li>walking stick</li></ol>
kotho	<i>noun</i><br><ol><li>head lice (on people)</li></ol>
kotkot	<i>noun</i><br><ol><li>grater</li></ol>
kowadja	<i>noun</i><br><ol><li>guard</li></ol>
kowadto	<i>noun</i><br><ol><li>room</li></ol>
kowagdaro	<i>noun</i><br><ol><li>square</li></ol>
lola	<i>noun</i><br><ol><li>grandmother</li></ol>
lolo	<i>noun</i><br><ol><li>grandfather</li></ol>
madri	<i>noun</i><br><ol><li>nun</li></ol>
magasat	<i>adj</i><br><ol><li>lucky; fortunate</li></ol>
magetel	<i>adj</i><br><ol><li>itchy</li></ol>
mahina	<i>noun</i><br><ol><li>machine</li></ol>
mahisi	<i>adj</i><br><ol><li>noisy</li></ol>
mahitjaw	<i>noun</i><br><ol><li>liar</li></ol>
maikot	<i>adj</i><br><ol><li>selfish</li></ol>
mais	<i>noun</i><br><ol><li>corn</li></ol>
makastos	<i>adj</i><br><ol><li>expensive</li></ol>
makgwas	<i>noun</i><br><ol><li>deer</li></ol>
malinis	<i>adj</i><br><ol><li>clean</li></ol>
malmal	<i>noun</i><br><ol><li>snack</li></ol>
malokong	<i>noun</i><br><ol><li>bowl</li></ol>
maltiha	<i>noun</i><br><ol><li>cooking oil</li></ol>
mamati	<i>noun</i><br><ol><li>believer</li></ol>
mamechihit	<i>noun</i><br><ol><li>young, unmarried woman</li></ol>
manador	<i>noun</i><br><ol><li>boar</li></ol>
managbasol	<i>noun</i><br><ol><li>sinner</li></ol>
mangidi	<i>noun</i><br><ol><li>visitor</li></ol>
mangka	<i>noun</i><br><ol><li>mango</li></ol>
mani	<i>noun</i><br><ol><li>peanut</li></ol>
manok	<i>noun</i><br><ol><li>chicken</li></ol>
manoteng	<i>adj</i><br><ol><li>noisy</li></ol>
mansa	<i>noun</i><br><ol><li>stain</li></ol>
mansanas	<i>noun</i><br><ol><li>apple</li></ol>
mapteng	<i>adj</i><br><ol><li>good</li></ol>
marekem	<i>adj</i><br><ol><li>windy</li></ol>
maritem	<i>adj</i><br><ol><li>sharp</li></ol>
masaplora	<i>noun</i><br><ol><li>passion fruit</li></ol>
matha	<i>noun</i><br><ol><li>(anatomy) eye</li></ol>
maykadasos	<i>adj</i><br><ol><li>hundredth; 100th</li></ol>
maykadgwa	<i>adj</i><br><ol><li>second; 2nd</li></ol>
maykadibo	<i>adj</i><br><ol><li>thousandth; 1000th</li></ol>
maykafintedo	<i>noun</i><br><ol><li>third time</li></ol>
maykagwalo	<i>adj</i><br><ol><li>eighth; 8th</li></ol>
maykalima	<i>adj</i><br><ol><li>fifth; 5th</li></ol>
maykapitho	<i>adj</i><br><ol><li>seventh; 7th</li></ol>
maykasampolo	<i>adj</i><br><ol><li>tenth; 10th</li></ol>
maykasiyam	<i>adj</i><br><ol><li>ninth; 9th</li></ol>
maykatdo	<i>adj</i><br><ol><li>third; 3rd</li></ol>
mebedin	<i>adj</i><br><ol><li>possible</li></ol>
mekan	<i>noun</i><br><ol><li>food</li></ol>
meket	<i>noun</i><br><ol><li>sticky rice</li></ol>
migis	<i>noun</i><br><ol><li>intermittent rain showers</li></ol>
milagro	<i>noun</i><br><ol><li>miracle</li></ol>
mimi	<i>noun</i><br><ol><li>urine</li></ol>
mingel	<i>noun</i><br><ol><li>endurance</li></ol>
minoto	<i>noun</i><br><ol><li>minute</li></ol>
modsok	<i>noun</i><br><ol><li>point of a sharp object</li></ol>
mohod	<i>noun</i><br><ol><li>(anatomy) heel</li></ol>
mokdo	<i>noun</i><br><ol><li>group</li></ol>
moksit	<i>noun</i><br><ol><li>piglet</li></ol>
mola	<i>noun</i><br><ol><li>plant</li></ol>
molmol	<i>noun</i><br><ol><li>large, castrated pig</li></ol>
molta	<i>noun</i><br><ol><li>fine</li></ol>
monggo	<i>noun</i><br><ol><li>mung bean</li></ol>
mostasa	<i>noun</i><br><ol><li>mustard plant</li></ol>
motheg	<i>noun</i><br><ol><li>(anatomy) nose</li><li>mucus</li></ol>
mowan	<i>adv</i><br><ol><li>again</li></ol>
namat	<i>noun</i><br><ol><li>flavor; taste</li></ol>
namit	<i>noun</i><br><ol><li>fat (of an animal)</li></ol>
namnama	<i>noun</i><br><ol><li>expectation; hope</li></ol>
nangis	<i>noun</i><br><ol><li>cry</li></ol>
nangoy	<i>noun</i><br><ol><li>act of swimming</li></ol>
natheng	<i>noun</i><br><ol><li>vegetable</li></ol>
nemnem	<i>noun</i><br><ol><li>thought; idea</li></ol>
neta	<i>noun</i><br><ol><li>sap (of a plant)</li></ol>
ngaap	<i>noun</i><br><ol><li>cinder</li></ol>
ngafol	<i>noun</i><br><ol><li>puppy</li></ol>
ngalab	<i>noun</i><br><ol><li>burning coal</li></ol>
ngalakngak	<i>noun</i><br><ol><li>loud laugh</li></ol>
ngalawngaw	<i>noun</i><br><ol><li>disturbance caused by noise</li></ol>
ngano	<i>noun</i><br><ol><li>tool; utensil; instrument</li></ol>
ngaran	<i>noun</i><br><ol><li>name</li></ol>
ngarednged	<i>noun</i><br><ol><li>growl (of an animal)</li></ol>
ngayow	<i>noun</i><br><ol><li>headhunting</li></ol>
ngifis	<i>noun</i><br><ol><li>playing cards</li></ol>
ngikngik	<i>noun</i><br><ol><li>oink (of a piglet)</li></ol>
ngila	<i>noun</i><br><ol><li>(anatomy) ear</li></ol>
nginaw	<i>noun</i><br><ol><li>first month of pregnancy (of women)</li></ol>
ngithi	<i>noun</i><br><ol><li>dirt</li></ol>
ngiyaw	<i>noun</i><br><ol><li>cat</li></ol>
ngiyog	<i>noun</i><br><ol><li>coconut</li></ol>
ngoaman	<i>intj</i><br><ol><li>exclamation indicating surprise</li></ol>
ngokngok	<i>noun</i><br><ol><li>howl (of a dog)</li><li>oink (of a pig)</li></ol>
ngoro	<i>noun</i><br><ol><li>end; edge; rim</li></ol>
ngoseb	<i>noun</i><br><ol><li>snout (of animals)</li></ol>
ngoyat	<i>noun</i><br><ol><li>newborn baby</li></ol>
ngoyngoyob	<i>noun</i><br><ol><li>(anatomy) nipple</li></ol>
niman	<i>adv</i><br><ol><li>now; today</li></ol>
nomiro	<i>noun</i><br><ol><li>number</li></ol>
nonong	<i>noun</i><br><ol><li>pimple</li></ol>
noso	<i>noun</i><br><ol><li>small, elongated, edible snail (found in rice fields, streams, and irrigation canals)</li></ol>
notheng	<i>noun</i><br><ol><li>noise</li></ol>
notnot	<i>noun</i><br><ol><li>talk; gossip</li></ol>
nowang	<i>noun</i><br><ol><li>water buffalo</li></ol>
obda	<i>noun</i><br><ol><li>work</li></ol>
odsek	<i>noun</i><br><ol><li>tip of young leaves (of any edible plant)</li></ol>
ofa	<i>noun</i><br><ol><li>hunger</li><li>hen</li></ol>
ofis	<i>noun</i><br><ol><li>massage</li></ol>
ogadi	<i>noun</i><br><ol><li>custom; ritual</li><li>behavior</li></ol>
ogan	<i>noun</i><br><ol><li>gray or white hair</li></ol>
oget	<i>noun</i><br><ol><li>(anatomy) buttocks</li><li>bottom (of an object)</li></ol>
ogis	<i>noun</i><br><ol><li>sign of the cross</li></ol>
ogolan	<i>noun</i><br><ol><li>whetstone</li></ol>
ogong	<i>noun</i><br><ol><li>nest</li></ol>
ohis	<i>noun</i><br><ol><li>outer peel (of beans, grains, or fruits)</li></ol>
ok-ok	<i>noun</i><br><ol><li>cough</li></ol>
okbong	<i>noun</i><br><ol><li>small cloth bag</li></ol>
oki	<i>noun</i><br><ol><li>sleep (rheum or gummy discharge found in the eye)</li></ol>
olat	<i>noun</i><br><ol><li>(anatomy) vein</li></ol>
oleg	<i>noun</i><br><ol><li>snake</li></ol>
oles	<i>noun</i><br><ol><li>blanket</li></ol>
oligweg	<i>noun</i><br><ol><li>whirlpool</li></ol>
oling	<i>noun</i><br><ol><li>tree sap</li></ol>
olpo	<i>noun</i><br><ol><li>(anatomy) lower thigh</li></ol>
olsa	<i>noun</i><br><ol><li>deer</li></ol>
oma	<i>noun</i><br><ol><li>mountainside garden</li></ol>
omang	<i>noun</i><br><ol><li>slander</li></ol>
omnel	<i>noun</i><br><ol><li>muteness; dumbness</li></ol>
omsiyang	<i>noun</i><br><ol><li>mid-morning (between 8AM and 10AM)</li></ol>
onas	<i>noun</i><br><ol><li>sugar cane</li></ol>
oneg	<i>noun</i><br><ol><li>certain period of time</li></ol>
onjon	<i>noun</i><br><ol><li>cooperation</li></ol>
onod	<i>noun</i><br><ol><li>last one; end</li></ol>
opisina	<i>noun</i><br><ol><li>office</li></ol>
oran	<i>noun</i><br><ol><li>rain</li></ol>
oras	<i>noun</i><br><ol><li>hour</li><li>time</li></ol>
osab	<i>noun</i><br><ol><li>bubble</li></ol>
ospital	<i>noun</i><br><ol><li>hospital</li></ol>
otha	<i>noun</i><br><ol><li>vomit</li></ol>
othang	<i>noun</i><br><ol><li>debt; money owed</li></ol>
othek	<i>noun</i><br><ol><li>(anatomy) brain</li><li>(anatomy) bone marrow</li></ol>
othin	<i>noun</i><br><ol><li>(anatomy) penis</li></ol>
othom	<i>noun</i><br><ol><li>wrapping</li></ol>
othot	<i>noun</i><br><ol><li>rat</li></ol>
othoy	<i>noun</i><br><ol><li>diarrhea</li></ol>
owab	<i>noun</i><br><ol><li>yawn</li></ol>
owak	<i>noun</i><br><ol><li>crow (bird)</li></ol>
owen	<i>intj</i><br><ol><li>yes</li></ol>
padot	<i>noun</i><br><ol><li>cockfight</li></ol>
padto	<i>noun</i><br><ol><li>prophecy; prediction</li></ol>
pahiy	<i>noun</i><br><ol><li>unhusked rice</li></ol>
pahow	<i>noun</i><br><ol><li>(anatomy) chest</li></ol>
paideng	<i>noun</i><br><ol><li>fish</li></ol>
pajaspas	<i>noun</i><br><ol><li>waterfall</li></ol>
pakawan	<i>noun</i><br><ol><li>forgiveness</li></ol>
pakchal	<i>noun</i><br><ol><li>ladder</li><li>steps</li></ol>
pakgwit	<i>noun</i><br><ol><li>hook (as for a window or door)</li></ol>
pakod	<i>noun</i><br><ol><li>rope</li></ol>
pala	<i>noun</i><br><ol><li>shovel</li></ol>
palad	<i>noun</i><br><ol><li>(anatomy) palm (of the hand)</li><li>(anatomy) lines (on one's hand)</li></ol>
palangka	<i>noun</i><br><ol><li>chair</li></ol>
palingping	<i>noun</i><br><ol><li>mountain ridge</li></ol>
palit	<i>adj</i><br><ol><li>expensive</li><li>difficult</li></ol>
palpalan	<i>noun</i><br><ol><li>inedible frog with a big stomach</li></ol>
palsiit	<i>noun</i><br><ol><li>slingshot</li></ol>
paltak	<i>noun</i><br><ol><li>(anatomy) testis</li></ol>
paltog	<i>noun</i><br><ol><li>gun</li></ol>
pamati	<i>noun</i><br><ol><li>belief; faith</li></ol>
pamilja	<i>noun</i><br><ol><li>family</li></ol>
paminta	<i>noun</i><br><ol><li>black pepper</li></ol>
pana	<i>noun</i><br><ol><li>homemade spear gun (for catching fish)</li></ol>
panad	<i>noun</i><br><ol><li>level area</li></ol>
panakaangel	<i>noun</i><br><ol><li>representative (person)</li></ol>
panakabalin	<i>noun</i><br><ol><li>divine power</li></ol>
panchon	<i>noun</i><br><ol><li>grave; tomb</li></ol>
paneknek	<i>noun</i><br><ol><li>evidence; proof</li></ol>
panga	<i>noun</i><br><ol><li>branch (of a tree)</li></ol>
pangal	<i>noun</i><br><ol><li>(anatomy) chin</li></ol>
pangamaan	<i>noun</i><br><ol><li>uncle</li><li>(anatomy) thumb</li></ol>
panganahan	<i>noun</i><br><ol><li>nephew; niece</li></ol>
panganan	<i>noun</i><br><ol><li>meal</li></ol>
pangbal	<i>noun</i><br><ol><li>excuse</li></ol>
pangchan	<i>noun</i><br><ol><li>pineapple</li></ol>
panginaan	<i>noun</i><br><ol><li>aunt</li></ol>
pangsit	<i>noun</i><br><ol><li>noodles</li></ol>
paniki	<i>noun</i><br><ol><li>large, edible bat</li></ol>
pao	<i>noun</i><br><ol><li>edible type of fern found near water</li></ol>
papang	<i>noun</i><br><ol><li>father</li></ol>
papaya	<i>noun</i><br><ol><li>papaya</li></ol>
paras	<i>noun</i><br><ol><li>test</li></ol>
pari	<i>noun</i><br><ol><li>priest</li></ol>
paris	<i>noun</i><br><ol><li>pair</li></ol>
parsowa	<i>noun</i><br><ol><li>creation; creature (as created by God)</li></ol>
pasamak	<i>noun</i><br><ol><li>happening; event</li></ol>
pasanan	<i>noun</i><br><ol><li>(anatomy) shoulder</li></ol>
pasayan	<i>noun</i><br><ol><li>shrimp</li></ol>
pasbol	<i>noun</i><br><ol><li>gate</li></ol>
pasiking	<i>noun</i><br><ol><li>rattan backpack</li></ol>
pasil	<i>noun</i><br><ol><li>coarse sand; larger pebbles</li></ol>
pasingsing	<i>noun</i><br><ol><li>star</li></ol>
paspas	<i>noun</i><br><ol><li>(anatomy) eyelash</li></ol>
pathiy	<i>noun</i><br><ol><li>death</li></ol>
pato	<i>noun</i><br><ol><li>duck</li></ol>
payad	<i>noun</i><br><ol><li>wing (of birds, insects, etc.)</li></ol>
payong	<i>noun</i><br><ol><li>umbrella</li></ol>
payow	<i>noun</i><br><ol><li>wet rice field</li><li>field for growing any kind of grain</li></ol>
pedak	<i>noun</i><br><ol><li>moonlight</li></ol>
pegpeg	<i>noun</i><br><ol><li>heartbeat</li></ol>
pekel	<i>noun</i><br><ol><li>celebration where pigs are butchered performed before a rice harvest to invoke a good harvest</li></ol>
peliti	<i>noun</i><br><ol><li>transportation fare</li></ol>
pelnek	<i>noun</i><br><ol><li>short adult</li></ol>
pelsa	<i>noun</i><br><ol><li>(medicine) boil</li></ol>
peltan	<i>noun</i><br><ol><li>cock; rooster</li></ol>
pesaw	<i>noun</i><br><ol><li>downriver</li></ol>
petang	<i>adj</i><br><ol><li>hot</li></ol>
peteg	<i>noun</i><br><ol><li>boundary; border line</li></ol>
petok	<i>noun</i><br><ol><li>blast; bang; loud noise</li></ol>
pidgwa	<i>noun</i><br><ol><li>second weeding of rice plants</li></ol>
piig	<i>noun</i><br><ol><li>side</li></ol>
pilak	<i>noun</i><br><ol><li>money</li></ol>
pilay	<i>noun</i><br><ol><li>lameness in both legs</li></ol>
pingil	<i>noun</i><br><ol><li>full moon</li></ol>
pingkan	<i>noun</i><br><ol><li>plate</li></ol>
pinikpikan	<i>noun</i><br><ol><li>chicken dish with singed feathers</li></ol>
pintok	<i>noun</i><br><ol><li>abaca</li></ol>
pirinsa	<i>noun</i><br><ol><li>iron (for clothes)</li></ol>
pirongko	<i>noun</i><br><ol><li>bottle (usually of alcoholic beverage)</li></ol>
pisi	<i>noun</i><br><ol><li>part; piece</li></ol>
pising	<i>noun</i><br><ol><li>taro</li></ol>
pisita	<i>noun</i><br><ol><li>twenty centavos</li></ol>
piskaw	<i>noun</i><br><ol><li>small dried fish</li></ol>
pisos	<i>noun</i><br><ol><li>peso (currency)</li></ol>
pithek	<i>noun</i><br><ol><li>soil</li></ol>
pitho	<i>num</i><br><ol><li>seven</li></ol>
pitpit	<i>noun</i><br><ol><li>red-colored bird</li></ol>
pitsa	<i>noun</i><br><ol><li>date</li></ol>
pitsay	<i>noun</i><br><ol><li>Chinese cabbage (either napa cabbage or bok choy)</li></ol>
piya	<i>pron</i><br><ol><li>(interrogative) how many</li></ol>
piyal	<i>noun</i><br><ol><li>trust</li></ol>
piyasta	<i>noun</i><br><ol><li>festival</li></ol>
plano	<i>noun</i><br><ol><li>plan</li></ol>
pohel	<i>noun</i><br><ol><li>(anatomy) bone</li><li>trunk (of a banana tree)</li></ol>
pohis	<i>noun</i><br><ol><li>hairstyle; haircut</li></ol>
poligwesgwes	<i>noun</i><br><ol><li>cowlick</li></ol>
ponas	<i>noun</i><br><ol><li>cloth; rag (for wiping)</li></ol>
poncho	<i>noun</i><br><ol><li>money collected for a common purpose</li></ol>
pongan	<i>noun</i><br><ol><li>pillow</li></ol>
ponpon	<i>noun</i><br><ol><li>burial; funeral</li></ol>
pontilja	<i>noun</i><br><ol><li>ambition</li></ol>
pool	<i>noun</i><br><ol><li>large fire (which causes damage)</li></ol>
poot	<i>noun</i><br><ol><li>consciousness</li></ol>
posa	<i>noun</i><br><ol><li>cat</li></ol>
poseg	<i>noun</i><br><ol><li>(anatomy) navel</li></ol>
poso	<i>noun</i><br><ol><li>(anatomy) heart</li></ol>
potot	<i>noun</i><br><ol><li>offspring; child</li></ol>
poweg	<i>noun</i><br><ol><li>(anatomy) knee</li></ol>
powek	<i>noun</i><br><ol><li>rainstorm; typhoon</li></ol>
prino	<i>noun</i><br><ol><li>brake (of a vehicle)</li></ol>
problima	<i>noun</i><br><ol><li>problem</li></ol>
rebeng	<i>noun</i><br><ol><li>duty; obligation; responsibility</li></ol>
rigalo	<i>noun</i><br><ol><li>gift</li></ol>
riri	<i>noun</i><br><ol><li>complaint; grumbling</li></ol>
rispito	<i>noun</i><br><ol><li>respect</li></ol>
sa-ki	<i>num</i><br><ol><li>one</li></ol>
sabirong	<i>noun</i><br><ol><li>poison</li></ol>
sabsab	<i>noun</i><br><ol><li>immature rice</li></ol>
sabsabong	<i>noun</i><br><ol><li>(decorative) flower</li></ol>
sada	<i>noun</i><br><ol><li>dance (of contemporary style)</li></ol>
safal	<i>noun</i><br><ol><li>bunch (of fruit)</li></ol>
safiy	<i>noun</i><br><ol><li>female traditional dress</li></ol>
safot	<i>noun</i><br><ol><li>cobweb</li></ol>
sagana	<i>noun</i><br><ol><li>preparation</li></ol>
sagaysay	<i>noun</i><br><ol><li>comb</li></ol>
sagon	<i>noun</i><br><ol><li>soap</li></ol>
sagwag	<i>noun</i><br><ol><li>wild chicken</li></ol>
sagwal	<i>noun</i><br><ol><li>dried rice stalks (used as fodder or fertilizer)</li></ol>
sagwejen	<i>noun</i><br><ol><li>doorway</li></ol>
sahit	<i>noun</i><br><ol><li>sickness</li></ol>
sahop	<i>noun</i><br><ol><li>area within the jurisdiction of a larger area</li></ol>
sairo	<i>noun</i><br><ol><li>devil; demon; evil spirit</li></ol>
sakdod	<i>noun</i><br><ol><li>horn (of animals)</li></ol>
sakdong	<i>noun</i><br><ol><li>(archaic) earthquake</li></ol>
sakepan	<i>noun</i><br><ol><li>front door; entrance</li></ol>
sakmao	<i>noun</i><br><ol><li>shelter</li></ol>
salagma	<i>noun</i><br><ol><li>eagle</li></ol>
salamat	<i>intj</i><br><ol><li>thanks</li></ol>
salaw	<i>noun</i><br><ol><li>antique Chinese jar</li></ol>
salepi	<i>noun</i><br><ol><li>fifty centavos</li></ol>
salming	<i>noun</i><br><ol><li>glass</li></ol>
salodsod	<i>noun</i><br><ol><li>question</li></ol>
salomagi	<i>noun</i><br><ol><li>tamarind</li></ol>
saloysoy	<i>noun</i><br><ol><li>harrow (with several prongs)</li></ol>
saminto	<i>noun</i><br><ol><li>cement</li></ol>
sampolo	<i>num</i><br><ol><li>ten</li></ol>
sandabi	<i>noun</i><br><ol><li>whole night</li></ol>
sangal	<i>noun</i><br><ol><li>loop</li></ol>
sangi	<i>noun</i><br><ol><li>(anatomy) tooth</li></ol>
sangkap	<i>noun</i><br><ol><li>digging tool with a long wooden handle and a rectangular metal blade</li></ol>
sapalit	<i>noun</i><br><ol><li>whip</li></ol>
sarado	<i>noun</i><br><ol><li>long-handled hoe with a straight blade</li></ol>
sardinas	<i>noun</i><br><ol><li>sardines</li></ol>
sarong	<i>noun</i><br><ol><li>blanket worn by women in traditional dancing</li></ol>
saya	<i>noun</i><br><ol><li>tear; teardrop</li></ol>
sayoti	<i>noun</i><br><ol><li>chayote</li></ol>
sebit	<i>noun</i><br><ol><li>thorn</li></ol>
sechek	<i>noun</i><br><ol><li>beginning of a period of time</li></ol>
sechel	<i>noun</i><br><ol><li>thickness</li></ol>
sedek	<i>noun</i><br><ol><li>brushy, uninhabited area (with small bushes and a few trees)</li></ol>
sedong	<i>noun</i><br><ol><li>upriver</li></ol>
segseg	<i>noun</i><br><ol><li>sooty dirt (as which hangs down from the drying rack over a wood fire)</li></ol>
seka	<i>noun</i><br><ol><li>fuzzy-haired caterpillar (with either red or black hairs)</li></ol>
sekep	<i>noun</i><br><ol><li>inside</li></ol>
seket	<i>noun</i><br><ol><li>youngest child (in the family)</li></ol>
seki	<i>noun</i><br><ol><li>foot; leg</li></ol>
selbeng	<i>noun</i><br><ol><li>door</li></ol>
semek	<i>noun</i><br><ol><li>love</li><li>gift</li></ol>
sengeg	<i>noun</i><br><ol><li>trunk (of a tree)</li><li>source (of a stream, canal, etc.)</li></ol>
sengkit	<i>noun</i><br><ol><li>joking; teasing</li></ol>
senit	<i>noun</i><br><ol><li>offense</li></ol>
sepig	<i>noun</i><br><ol><li>sideburns</li></ol>
sepsep	<i>noun</i><br><ol><li>gnat</li></ol><br><i>adj</i><br><ol><li>low</li></ol>
sianian	<i>noun</i><br><ol><li>season for harvesting rice</li></ol>
sibog	<i>noun</i><br><ol><li>container for watering plants (usually large square metal can with long spout)</li></ol>
sibosahan	<i>noun</i><br><ol><li>time of sunrise</li></ol>
siboyas	<i>noun</i><br><ol><li>mature onion (either green or red)</li></ol>
sida	<i>noun</i><br><ol><li>silk</li></ol>
sidenekan	<i>noun</i><br><ol><li>time of sunset</li></ol>
siged	<i>adj</i><br><ol><li>good</li></ol>
sigib	<i>noun</i><br><ol><li>any house that is not the central house of a family or clan</li></ol>
signos	<i>noun</i><br><ol><li>sign</li></ol>
sigod	<i>adj</i><br><ol><li>original</li></ol>
sigsigmot	<i>noun</i><br><ol><li>flying ant</li></ol>
sihi	<i>noun</i><br><ol><li>small pieces of rice left after winnowing (usually fed to chickens)</li></ol>
siho	<i>noun</i><br><ol><li>(anatomy) elbow</li></ol>
sikariljo	<i>noun</i><br><ol><li>cigarette</li></ol>
sikdop	<i>noun</i><br><ol><li>food taken along to eat when away from home</li></ol>
sikop	<i>noun</i><br><ol><li>area included within a larger area</li></ol>
sikrito	<i>noun</i><br><ol><li>secret</li></ol>
siksik	<i>noun</i><br><ol><li>scale (of a fish)</li></ol>
sili	<i>noun</i><br><ol><li>hot pepper</li></ol>
siljo	<i>noun</i><br><ol><li>change (money)</li></ol>
simbaan	<i>noun</i><br><ol><li>church</li></ol>
sinan	<i>adj</i><br><ol><li>false</li></ol>
singil	<i>noun</i><br><ol><li>fishhook</li></ol>
singin	<i>noun</i><br><ol><li>twin</li></ol>
singsing	<i>noun</i><br><ol><li>ring</li></ol>
sini	<i>noun</i><br><ol><li>cinema; film</li></ol>
sinodid	<i>noun</i><br><ol><li>thread</li></ol>
sinolsolcharo	<i>noun</i><br><ol><li>toy soldier</li></ol>
sioranan	<i>noun</i><br><ol><li>rainy season; time of rain</li></ol>
sipet	<i>noun</i><br><ol><li>silverfish</li></ol>
sira	<i>noun</i><br><ol><li>dish eaten with rice</li></ol>
sirom	<i>noun</i><br><ol><li>shade (shelter from the elements)</li></ol>
sisiw	<i>noun</i><br><ol><li>chick; young chicken</li></ol>
siwsiwan	<i>noun</i><br><ol><li>sauce; spread</li></ol>
siya	<i>pron</i><br><ol><li>(interrogative) who</li></ol>
siyam	<i>num</i><br><ol><li>nine</li></ol>
siyodad	<i>noun</i><br><ol><li>city</li></ol>
sobil	<i>noun</i><br><ol><li>(anatomy) lip</li></ol>
sodsod	<i>noun</i><br><ol><li>explanation; story</li></ol>
sofot	<i>noun</i><br><ol><li>pillowcase</li></ol>
sogal	<i>noun</i><br><ol><li>gambling</li></ol>
sogat	<i>noun</i><br><ol><li>wound</li></ol>
sogod	<i>noun</i><br><ol><li>short comb for removing hair lice (with teeth on both sides)</li></ol>
sohong	<i>noun</i><br><ol><li>corner</li></ol>
soka	<i>noun</i><br><ol><li>vinegar</li></ol>
solat	<i>noun</i><br><ol><li>letter; written communication</li><li>handwriting</li></ol>
solcharo	<i>noun</i><br><ol><li>soldier</li></ol>
solibaw	<i>noun</i><br><ol><li>soldier (used in traditional music)</li></ol>
solit	<i>adj</i><br><ol><li>slow</li></ol>
solkok	<i>noun</i><br><ol><li>hen that has not laid eggs</li></ol>
solog	<i>noun</i><br><ol><li>joke</li></ol>
songbat	<i>noun</i><br><ol><li>answer; reply</li></ol>
songsong	<i>noun</i><br><ol><li>beak (of the bird)</li></ol>
soodan	<i>noun</i><br><ol><li>drying rack (over cooking fire)</li></ol>
sool	<i>noun</i><br><ol><li>share of harvested rice that goes to the person who helps harvest someone else's field</li></ol>
soso	<i>noun</i><br><ol><li>(anatomy) breast</li></ol>
sosot	<i>noun</i><br><ol><li>(anatomy) intestines</li></ol>
sowep	<i>noun</i><br><ol><li>lid; top; cap; stopper</li></ol>
sowilcho	<i>noun</i><br><ol><li>salary</li></ol>
tabaw	<i>noun</i><br><ol><li>civet cat</li></ol>
tagdang	<i>noun</i><br><ol><li>(anatomy) rib</li></ol>
taheb	<i>noun</i><br><ol><li>(anatomy) scapula</li></ol>
taladong	<i>noun</i><br><ol><li>(anatomy) lower leg</li></ol>
tamil	<i>noun</i><br><ol><li>(anatomy) cheek</li></ol>
tarong	<i>noun</i><br><ol><li>eggplant</li></ol>
tasa	<i>noun</i><br><ol><li>cup</li></ol>
tatabaw	<i>noun</i><br><ol><li>butterfly</li></ol>
tawa	<i>noun</i><br><ol><li>window</li></ol>
tawen	<i>noun</i><br><ol><li>year</li></ol>
tawid	<i>noun</i><br><ol><li>inheritance</li></ol>
tayaw	<i>noun</i><br><ol><li>blanket worn by men when performing a traditional dance</li></ol>
taychek	<i>noun</i><br><ol><li>a type of ritual performed by women</li></ol>
taytay	<i>noun</i><br><ol><li>(anatomy) tongue</li></ol>
tebak	<i>noun</i><br><ol><li>cloth or clothing made from tree bark</li></ol>
tebal	<i>noun</i><br><ol><li>conversation; discussion; talk</li></ol>
tebing	<i>noun</i><br><ol><li>pierced hole (in one's nose or ear)</li></ol>
tebol	<i>noun</i><br><ol><li>new or young wine</li></ol>
tedo	<i>num</i><br><ol><li>three</li></ol>
teg-ab	<i>noun</i><br><ol><li>belch; burp</li></ol>
teg-ak	<i>noun</i><br><ol><li>phlegm</li></ol>
tegwing	<i>noun</i><br><ol><li>earthworm</li></ol>
tek-ing	<i>noun</i><br><ol><li>mumps</li></ol>
temi	<i>noun</i><br><ol><li>(anatomy) mouth</li></ol>
temok	<i>noun</i><br><ol><li>(anatomy) forehead</li></ol>
temtem	<i>noun</i><br><ol><li>freshwater spring</li></ol>
teneng	<i>noun</i><br><ol><li>top of a dike in a rice field</li><li>top of a dam for channeling water</li></ol>
tep	<i>conj</i><br><ol><li>because</li></ol>
titit	<i>noun</i><br><ol><li>bird</li></ol>
toktok	<i>noun</i><br><ol><li>(anatomy) head</li></ol>
tongkal	<i>noun</i><br><ol><li>price</li></ol>
too	<i>noun</i><br><ol><li>person</li></ol>
topdik	<i>noun</i><br><ol><li>act of harrowing a rice field the second time</li></ol>
toray	<i>noun</i><br><ol><li>reign</li></ol>
toti	<i>noun</i><br><ol><li>speech defect; lisp</li></ol>
towalja	<i>noun</i><br><ol><li>towel</li></ol>
trangkaso	<i>noun</i><br><ol><li>(pathology) influenza; flu</li></ol>
trompita	<i>noun</i><br><ol><li>trumpet</li></ol>
yoyo	<i>noun</i><br><ol><li>mudfish</li></ol>
