'may	<i>noun</i><br><ol><li>cooked rice</li></ol>
'si	<i>noun</i><br><ol><li>meat</li></ol>
Rabas	<i>noun</i><br><ol><li>root (of a plant)</li></ol>
Rabay	<i>noun</i><br><ol><li>wheat; barley; oats</li></ol>
Rabetin	<i>num</i><br><ol><li>ten</li></ol>
Rabi	<i>noun</i><br><ol><li>evening</li></ol>
Rabis	<i>noun</i><br><ol><li>knife; pocket knife</li></ol>
Rainang	<i>noun</i><br><ol><li>blood</li></ol>
Rais	<i>noun</i><br><ol><li>rope; string</li></ol>
Ramaz	<i>noun</i><br><ol><li>fire</li></ol>
Rami	<i>noun</i><br><ol><li>rice straw</li></ol>
Raputuy	<i>noun</i><br><ol><li>dream</li></ol>
Raq	<i>noun</i><br><ol><li>alcoholic beverage</li></ol>
Raqlupup	<i>noun</i><br><ol><li>sea anemone</li></ol>
Rasibu	<i>num</i><br><ol><li>hundred</li></ol>
Raya	<i>adj</i><br><ol><li>big, large, great</li><li>fat (trunk of the body)</li><li>strong (as wind)</li><li>plenty; large in amount</li></ol>
RiRi	<i>noun</i><br><ol><li>saw (hand tool for cutting wood)</li></ol>
Ribang	<i>noun</i><br><ol><li>tool; instrument</li></ol>
Rikum	<i>noun</i><br><ol><li>sea wave</li></ol>
Rinang	<i>noun</i><br><ol><li>blood</li></ol>
Rinuk	<i>noun</i><br><ol><li>strawberry</li></ol>
Rinuq	<i>noun</i><br><ol><li>strawberry</li></ol>
RipRip	<i>noun</i><br><ol><li>nest</li></ol>
Ris	<i>noun</i><br><ol><li>mosquito</li></ol>
Risis	<i>noun</i><br><ol><li>nit (of louse)</li><li>twig, small branches</li></ol>
Rmatis	<i>noun</i><br><ol><li>(pathology) small boil</li></ol>
Rneng	<i>noun</i><br><ol><li>quail</li></ol>
Rumzang	<i>noun</i><br><ol><li>sweat; perspiration</li></ol>
Runanay	<i>noun</i><br><ol><li>male; boy; man</li></ol>
Runges	<i>noun</i><br><ol><li>soft pith of rattan</li></ol>
Rusi	<i>noun</i><br><ol><li>tear; teardrop</li></ol>
Rusu	<i>noun</i><br><ol><li>water pipe; hose</li></ol>
Rusun	<i>noun</i><br><ol><li>yarn</li></ol>
Rutung	<i>noun</i><br><ol><li>monkey</li></ol>
RuwaRu	<i>noun</i><br><ol><li>congee</li></ol>
Rzim	<i>noun</i><br><ol><li>(anatomy) molar</li></ol>
adam	<i>noun</i><br><ol><li>bird</li></ol>
adi	<i>adv</i><br><ol><li>maybe; perhaps</li></ol>
aiku	<i>pron</i><br><ol><li>I (personal pronoun)</li></ol>
aimi	<i>pron</i><br><ol><li>we (exclusive of the person spoken to)</li></ol>
aimu	<i>pron</i><br><ol><li>you (plural)</li></ol>
aisu	<i>pron</i><br><ol><li>you (singular)</li></ol>
aita	<i>pron</i><br><ol><li>we (inclusive of the person spoken to)</li></ol>
aizipna	<i>pron</i><br><ol><li>he; she</li></ol>
alam	<i>noun</i><br><ol><li>bird</li></ol>
anem	<i>noun</i><br><ol><li>(anatomy) heart</li></ol>
apaw	<i>noun</i><br><ol><li>cassava</li></ol>
apuk	<i>noun</i><br><ol><li>lime</li></ol>
arim	<i>noun</i><br><ol><li>(anatomy) pancreas</li></ol>
aritta	<i>adj</i><br><ol><li>false</li><li>unknown</li></ol>
asa	<i>noun</i><br><ol><li>price</li></ol>
atungur	<i>noun</i><br><ol><li>protruding part of the forehead</li></ol>
aul	<i>noun</i><br><ol><li>a type of shark that does not attack people</li></ol>
awa	<i>noun</i><br><ol><li>drinkware; cup; glass</li></ol>
bRasuq	<i>noun</i><br><ol><li>pimples</li></ol>
bRina	<i>noun</i><br><ol><li>batten (of loom)</li><li>a type of poisonous snake</li></ol>
bRing	<i>noun</i><br><ol><li>(anatomy) ribs</li></ol>
baReng	<i>noun</i><br><ol><li>dung beetle; scarab beetle</li></ol>
baRqian	<i>noun</i><br><ol><li>old person</li></ol>
babusaR	<i>noun</i><br><ol><li>whitish</li></ol>
babuy	<i>noun</i><br><ol><li>pig</li></ol>
badaq	<i>noun</i><br><ol><li>(anatomy) lung</li></ol>
baka	<i>noun</i><br><ol><li>cow</li></ol>
balaq	<i>noun</i><br><ol><li>(anatomy) lung</li></ol>
balat	<i>noun</i><br><ol><li>east wind</li></ol>
bali	<i>noun</i><br><ol><li>wind</li></ol>
balun	<i>noun</i><br><ol><li>belt; girdle</li></ol>
banaw	<i>verb</i><br><ol><li>to wash (one's hands or feet)</li></ol>
bangRaw	<i>noun</i><br><ol><li>(anatomy) tooth</li></ol>
banged	<i>noun</i><br><ol><li>typhoon</li></ol>
bangel	<i>noun</i><br><ol><li>typhoon</li></ol>
bangkuy	<i>noun</i><br><ol><li>cupboard to store important things</li></ol>
bangsis	<i>noun</i><br><ol><li>fragrant, pleasant smell</li></ol>
baniw	<i>noun</i><br><ol><li>mushroom</li></ol>
bantiti	<i>noun</i><br><ol><li>play; stageplay</li></ol>
banul	<i>noun</i><br><ol><li>pigeon; dove</li></ol>
banur	<i>noun</i><br><ol><li>pigeon; dove</li></ol>
banus	<i>noun</i><br><ol><li>fur</li></ol>
baqi	<i>noun</i><br><ol><li>Deinagkistrodon</li><li>grandchild</li><li>grandfather</li></ol>
baquay	<i>noun</i><br><ol><li>Seediq</li></ol>
baquy	<i>noun</i><br><ol><li>flag</li></ol>
bari	<i>noun</i><br><ol><li>wind</li></ol>
baring	<i>noun</i><br><ol><li>(pathology) mumps</li></ol>
baris	<i>noun</i><br><ol><li>nail (tool)</li></ol>
barun	<i>noun</i><br><ol><li>belt</li><li>hoops (of a tub)</li></ol>
basu	<i>noun</i><br><ol><li>bus</li></ol>
bateng	<i>noun</i><br><ol><li>web</li></ol>
battis	<i>noun</i><br><ol><li>flat and smooth hard stone</li></ol>
baut	<i>noun</i><br><ol><li>fish</li></ol>
bawa	<i>noun</i><br><ol><li>boat</li></ol>
bawbi	<i>noun</i><br><ol><li>nonirrigated farmland; dry land</li></ol>
bayan	<i>noun</i><br><ol><li>old leaves</li></ol>
beRas	<i>noun</i><br><ol><li>rice ((raw) seeds used as food)</li></ol>
beRing	<i>noun</i><br><ol><li>(anatomy) rib</li></ol>
bedes	<i>noun</i><br><ol><li>(anatomy) abdomen</li></ol>
beluRuk	<i>noun</i><br><ol><li>(medicine) goitre</li></ol>
bengbengar	<i>adj</i><br><ol><li>unripe</li></ol>
benina	<i>noun</i><br><ol><li>banana</li></ol>
bettu	<i>noun</i><br><ol><li>stone</li></ol>
bettuq	<i>noun</i><br><ol><li>lake</li></ol>
bibing	<i>noun</i><br><ol><li>cobra</li></ol>
bilu	<i>noun</i><br><ol><li>charcoal</li></ol>
biru	<i>noun</i><br><ol><li>charcoal</li><li>embers</li></ol>
bitik	<i>noun</i><br><ol><li>(anatomy) part above the heel</li></ol>
bitik na zapan	<i>noun</i><br><ol><li>(anatomy) Achilles tendon</li></ol>
bitnguR	<i>noun</i><br><ol><li>big, slow, useless fellow</li></ol>
bitting	<i>noun</i><br><ol><li>headache</li></ol>
biw	<i>noun</i><br><ol><li>temple</li></ol>
biwbiw	<i>noun</i><br><ol><li>breeze</li></ol>
biyabas|byabas	<i>noun</i><br><ol><li>guava</li></ol>
biyat	<i>noun</i><br><ol><li>frog</li></ol>
blabal	<i>noun</i><br><ol><li>tin</li></ol>
blayang	<i>noun</i><br><ol><li>large cooking pan</li></ol>
bles	<i>noun</i><br><ol><li>(anatomy) belly; abdomen</li></ol>
blukuk	<i>noun</i><br><ol><li>a kind of fern (somewhat thick and bitter)</li></ol>
blung	<i>noun</i><br><ol><li>shell (of beans, peanuts, seashell, snail, etc.)</li><li>peel</li></ol>
bnabnaqian	<i>noun</i><br><ol><li>ancestors</li></ol>
bnanaR	<i>noun</i><br><ol><li>blister</li></ol>
bnangaw	<i>noun</i><br><ol><li>syphilis</li></ol>
bnaqian	<i>noun</i><br><ol><li>elder</li></ol>
bnauR	<i>noun</i><br><ol><li>cucumber</li></ol>
bneq	<i>noun</i><br><ol><li>salt water</li></ol>
bngar	<i>adj</i><br><ol><li>half ripe</li></ol>
bniRan	<i>noun</i><br><ol><li>stingray; ray fish</li></ol>
bnina	<i>noun</i><br><ol><li>banana</li></ol>
bnit	<i>noun</i><br><ol><li>skin cracks (in winter)</li></ol>
bnuay	<i>noun</i><br><ol><li>kite</li></ol>
bnuqu	<i>noun</i><br><ol><li>winnowing basket</li></ol>
bras	<i>noun</i><br><ol><li>rice (uncooked seeds used as food)</li></ol>
brawan	<i>noun</i><br><ol><li>gold</li></ol>
bruhuk	<i>noun</i><br><ol><li>goiter</li></ol>
brukun	<i>noun</i><br><ol><li>fishhook</li></ol>
bsangay	<i>noun</i><br><ol><li>small field mouse</li></ol>
btu	<i>noun</i><br><ol><li>stone</li></ol>
btuuq	<i>noun</i><br><ol><li>pond</li><li>fishpond</li></ol>
buRang	<i>noun</i><br><ol><li>rock</li></ol>
buRut	<i>noun</i><br><ol><li>flying squirrel</li></ol>
buRwa	<i>noun</i><br><ol><li>canoe</li></ol>
bubu	<i>noun</i><br><ol><li>conical bamboo basket, a fish trap</li></ol>
bubur	<i>noun</i><br><ol><li>jellyfish</li></ol>
bukkun	<i>noun</i><br><ol><li>swelling</li></ol>
bulan	<i>noun</i><br><ol><li>moon</li></ol>
bulayang	<i>noun</i><br><ol><li>large pot</li></ol>
buletedan	<i>noun</i><br><ol><li>star</li></ol>
bungil	<i>noun</i><br><ol><li>dried areca nut</li></ol>
bungut	<i>noun</i><br><ol><li>head ornament</li></ol>
buqaRes	<i>adj</i><br><ol><li>lazy</li></ol>
buqan	<i>noun</i><br><ol><li>sand</li></ol>
buqas	<i>noun</i><br><ol><li>dust</li></ol>
buqes	<i>noun</i><br><ol><li>(anatomy) hair</li><li>hair-like brown seaweed</li></ol>
buran	<i>noun</i><br><ol><li>moon</li><li>month</li></ol>
buras	<i>noun</i><br><ol><li>(ophthalmology) cataract</li></ol>
burek	<i>noun</i><br><ol><li>young animal (of a cow, pig, bear, etc.)</li></ol>
burtellan	<i>noun</i><br><ol><li>star</li></ol>
busaR	<i>adj</i><br><ol><li>white</li></ol>
busel	<i>noun</i><br><ol><li>(anatomy) navel</li></ol>
busuq	<i>adj</i><br><ol><li>drunk</li></ol>
busur	<i>noun</i><br><ol><li>bowstring</li></ol>
busus	<i>noun</i><br><ol><li>Hoklo person</li></ol>
butbut	<i>noun</i><br><ol><li>spring (water)</li></ol>
butuR	<i>noun</i><br><ol><li>(anatomy) scrotum</li></ol>
butuq	<i>noun</i><br><ol><li>footwear; gaiters; leggings</li></ol>
butuy	<i>noun</i><br><ol><li>joint; node; knot (of a bamboo, sugarcane, tree, finger, etc.)</li></ol>
byaquR	<i>noun</i><br><ol><li>toad</li></ol>
dadas	<i>noun</i><br><ol><li>betel</li></ol>
damu	<i>noun</i><br><ol><li>tribe</li></ol>
dasam	<i>adj</i><br><ol><li>dirty</li></ol>
daud	<i>adj</i><br><ol><li>far</li></ol>
deddan	<i>noun</i><br><ol><li>sky</li><li>weather</li></ol>
dengat	<i>noun</i><br><ol><li>window</li></ol>
dihib	<i>noun</i><br><ol><li>grotto; cave</li></ol>
dingwa	<i>noun</i><br><ol><li>telephone</li></ol>
duki	<i>noun</i><br><ol><li>clock</li><li>time</li></ol>
duqunu	<i>noun</i><br><ol><li>turtle</li></ol>
engu	<i>noun</i><br><ol><li>goose</li></ol>
hakun	<i>noun</i><br><ol><li>skirt</li></ol>
hikuki	<i>noun</i><br><ol><li>airplane</li></ol>
hukang	<i>noun</i><br><ol><li>male carabao</li></ol>
hulam	<i>noun</i><br><ol><li>mainlander in Taiwan</li></ol>
humung	<i>noun</i><br><ol><li>sea cucumber</li></ol>
iRaR	<i>noun</i><br><ol><li>gate</li><li>fence (around the garden)</li></ol>
iRanay	<i>noun</i><br><ol><li>animal skull</li></ol>
iRem	<i>noun</i><br><ol><li>pangolin</li></ol>
iRuR	<i>noun</i><br><ol><li>river</li><li>stream; creek; brook</li></ol>
ibu	<i>noun</i><br><ol><li>ash</li></ol>
ilam	<i>noun</i><br><ol><li>strength; energy</li></ol>
imis	<i>noun</i><br><ol><li>north</li></ol>
inat	<i>noun</i><br><ol><li>comb</li></ol>
ineb	<i>noun</i><br><ol><li>door</li></ol>
ingRuan	<i>noun</i><br><ol><li>pillow</li></ol>
inges	<i>noun</i><br><ol><li>(anatomy) gums</li></ol>
ingsay	<i>noun</i><br><ol><li>water spinach (Ipomoea aquatica)</li></ol>
inna	<i>noun</i><br><ol><li>stamp</li></ol>
inpan	<i>noun</i><br><ol><li>mat</li></ol>
ipaz	<i>noun</i><br><ol><li>raft</li></ol>
isi	<i>noun</i><br><ol><li>dregs (from winemaking)</li></ol>
ising	<i>noun</i><br><ol><li>doctor</li></ol>
iteb	<i>noun</i><br><ol><li>deadfall trap</li></ol>
itus	<i>noun</i><br><ol><li>necklace</li><li>beads</li></ol>
iyu	<i>noun</i><br><ol><li>medicine</li></ol>
izip	<i>noun</i><br><ol><li>(anatomy) body</li><li>life</li></ol>
kakurut	<i>noun</i><br><ol><li>bitter gourd</li></ol>
kakuyur	<i>noun</i><br><ol><li>broad bean</li></ol>
kalumut	<i>noun</i><br><ol><li>scarf; hood</li></ol>
kama	<i>noun</i><br><ol><li>orange; tangerine</li></ol>
kames	<i>noun</i><br><ol><li>claw; nail (of an animal)</li></ol>
kapangan	<i>noun</i><br><ol><li>coffin</li></ol>
kapar	<i>noun</i><br><ol><li>young people; teenager</li></ol>
kapi	<i>noun</i><br><ol><li>concubine; second or third wife</li></ol>
kapil	<i>noun</i><br><ol><li>scar</li></ol>
kaput	<i>noun</i><br><ol><li>friend</li></ol>
karat	<i>noun</i><br><ol><li>coral; coral reef</li></ol>
karuR	<i>noun</i><br><ol><li>broken stones</li></ol>
kasa	<i>noun</i><br><ol><li>green bean</li></ol>
kasi	<i>adv</i><br><ol><li>fortunately</li></ol>
katsaw	<i>noun</i><br><ol><li>pus head</li></ol>
kawraR	<i>noun</i><br><ol><li>prize</li></ol>
kayal	<i>noun</i><br><ol><li>(anatomy) ear</li></ol>
kayal na mutun	<i>noun</i><br><ol><li>wood ear; tree ear; black fungus</li></ol>
kayar	<i>noun</i><br><ol><li>(anatomy) ear</li></ol>
kayar na mutun	<i>noun</i><br><ol><li>Jew's-ear</li></ol>
kaysing	<i>noun</i><br><ol><li>bowl</li></ol>
kbayu	<i>noun</i><br><ol><li>horse</li></ol>
kebalan	<i>adj</i><br><ol><li>Kavalan</li></ol>
kedabu	<i>noun</i><br><ol><li>child-in-law</li></ol>
kelaba	<i>noun</i><br><ol><li>duck</li></ol>
keladut	<i>noun</i><br><ol><li>earthworm</li></ol>
kelisiw	<i>noun</i><br><ol><li>money</li></ol>
kenaped	<i>noun</i><br><ol><li>rice bran</li></ol>
kenaw	<i>noun</i><br><ol><li>onion</li><li>garlic</li></ol>
kezut	<i>adj</i><br><ol><li>short</li></ol>
kiskis	<i>noun</i><br><ol><li>razor</li></ol>
kiu	<i>noun</i><br><ol><li>eggplant</li></ol>
klabu	<i>noun</i><br><ol><li>child-in-law</li></ol>
klamlamu	<i>noun</i><br><ol><li>firefly</li></ol>
kluqun	<i>noun</i><br><ol><li>hermit crab</li></ol>
kmaz	<i>noun</i><br><ol><li>(anatomy) eyelash</li></ol>
kmutileng	<i>noun</i><br><ol><li>tomato</li></ol>
knapel	<i>noun</i><br><ol><li>bran</li></ol>
knasaw	<i>noun</i><br><ol><li>black sea urchin (with long stings usually in rocks underwater)</li></ol>
kpua	<i>noun</i><br><ol><li>cotton</li></ol>
kraba	<i>noun</i><br><ol><li>duck (domesticated or wild)</li></ol>
kralut	<i>noun</i><br><ol><li>laver</li><li>earthworm; roundworm; intestinal worm</li></ol>
krarez	<i>noun</i><br><ol><li>moss (in water and inedible)</li></ol>
krisiw	<i>noun</i><br><ol><li>money</li></ol>
kriwit	<i>noun</i><br><ol><li>rudder</li></ol>
kriwsus	<i>noun</i><br><ol><li>whirl of hair</li><li>whirlpool (of a river)</li></ol>
krizeng	<i>noun</i><br><ol><li>wheel; tyre</li></ol>
kruli	<i>noun</i><br><ol><li>loach</li></ol>
krupu	<i>noun</i><br><ol><li>(anatomy) eyebrow</li></ol>
ktirur	<i>noun</i><br><ol><li>(anatomy) testicles</li></ol>
kubu	<i>noun</i><br><ol><li>hat</li></ol>
kuciyu	<i>noun</i><br><ol><li>principal</li></ol>
kucu	<i>noun</i><br><ol><li>shoes</li></ol>
kuit	<i>noun</i><br><ol><li>souls of the dead</li><li>a type of wild betel nut (with small leaves)</li></ol>
kukkungan	<i>noun</i><br><ol><li>drum</li><li>gong</li></ol>
kukuy	<i>noun</i><br><ol><li>rice cake</li></ol>
kumret	<i>adj</i><br><ol><li>icy; very cold</li></ol>
kun	<i>noun</i><br><ol><li>pants; trousers</li><li>skirt; sarong</li></ol>
kunani	<i>noun</i><br><ol><li>pus</li></ol>
kungku	<i>noun</i><br><ol><li>old story; oral tradition</li></ol>
kungkung	<i>noun</i><br><ol><li>water bucket</li><li>a measure of quantity</li><li>sound of tapping, flicking finger against wood, etc.</li></ol>
kunip	<i>noun</i><br><ol><li>freshwater turtle</li></ol>
kurazu	<i>noun</i><br><ol><li>hangover; veisalgia</li></ol>
kuriseng	<i>noun</i><br><ol><li>circumference</li></ol>
kuti	<i>noun</i><br><ol><li>gunpowder</li></ol>
kutus	<i>noun</i><br><ol><li>(pathology) measles</li></ol>
kuu	<i>noun</i><br><ol><li>owl</li></ol>
kwasay	<i>noun</i><br><ol><li>Chinese mustard</li></ol>
kwawi	<i>noun</i><br><ol><li>longan</li></ol>
kyama	<i>noun</i><br><ol><li>mango</li></ol>
kzianan	<i>noun</i><br><ol><li>Venus (planet)</li></ol>
kzumai	<i>adv</i><br><ol><li>next year</li></ol>
lalay	<i>noun</i><br><ol><li>cicada</li></ol>
lalis	<i>noun</i><br><ol><li>ear discharge</li></ol>
lallalas	<i>adj</i><br><ol><li>ugly</li></ol>
lallu	<i>noun</i><br><ol><li>(anatomy) pupil (of the eyes)</li></ol>
lalusa	<i>noun</i><br><ol><li>half</li></ol>
laman	<i>noun</i><br><ol><li>driftwood</li></ol>
lamsu	<i>noun</i><br><ol><li>tax</li></ol>
lamu	<i>noun</i><br><ol><li>village</li></ol>
lanem	<i>noun</i><br><ol><li>cloud</li></ol>
langaw	<i>noun</i><br><ol><li>fly (insect)</li></ol>
lapis	<i>noun</i><br><ol><li>squirrel</li></ol>
lasun	<i>noun</i><br><ol><li>mulberry</li></ol>
lawang	<i>noun</i><br><ol><li>gate</li></ol>
lazan	<i>noun</i><br><ol><li>road; path; way</li></ol>
lazat	<i>noun</i><br><ol><li>person</li></ol>
lazing	<i>noun</i><br><ol><li>seaside; beach</li></ol>
lazum	<i>noun</i><br><ol><li>needle</li></ol>
leppaw	<i>noun</i><br><ol><li>house; home</li></ol>
lidam	<i>noun</i><br><ol><li>(anatomy) tongue</li></ol>
lihib	<i>noun</i><br><ol><li>cave</li><li>ledge</li></ol>
lihum	<i>noun</i><br><ol><li>azuki bean; red bean (Vigna angularis)</li></ol>
lilut	<i>noun</i><br><ol><li>mud</li></ol>
lima	<i>noun</i><br><ol><li>(anatomy) hand</li></ol>
limusmus	<i>noun</i><br><ol><li>drizzle</li></ol>
lineng	<i>noun</i><br><ol><li>wall</li></ol>
linggu	<i>noun</i><br><ol><li>apple</li></ol>
liqud	<i>noun</i><br><ol><li>tail</li></ol>
lislis	<i>noun</i><br><ol><li>fish scales</li></ol>
lita	<i>noun</i><br><ol><li>clay</li></ol>
llut	<i>noun</i><br><ol><li>beak (of birds, chickens, etc.)</li></ol>
lngat	<i>noun</i><br><ol><li>window</li></ol>
lqap	<i>noun</i><br><ol><li>white, woven sunshade coat or raincoat</li></ol>
lqutas	<i>noun</i><br><ol><li>edible moss (found on rocks along streams)</li></ol>
lubanang	<i>noun</i><br><ol><li>plain; flat land</li></ol>
luki	<i>noun</i><br><ol><li>hour</li><li>time</li></ol>
luksan	<i>noun</i><br><ol><li>friend</li></ol>
lulen	<i>noun</i><br><ol><li>(anatomy) neck</li></ol>
lulluq	<i>noun</i><br><ol><li>garbage</li></ol>
luma	<i>pron</i><br><ol><li>(interrogative) why</li></ol>
lupas	<i>noun</i><br><ol><li>peach</li></ol>
luqenaw	<i>noun</i><br><ol><li>panther; leopard</li></ol>
luqu	<i>noun</i><br><ol><li>Asian conical hat</li></ol>
lusel	<i>noun</i><br><ol><li>(anatomy) heel</li></ol>
lusing	<i>noun</i><br><ol><li>gun trap</li></ol>
lutumpis	<i>noun</i><br><ol><li>cliff</li></ol>
lutut	<i>noun</i><br><ol><li>(anatomy) clitoris</li></ol>
luzay	<i>noun</i><br><ol><li>hulled grain of foxtail millet (Setaria italica)</li></ol>
luzem	<i>noun</i><br><ol><li>ant</li></ol>
luzit	<i>noun</i><br><ol><li>wound</li></ol>
ma	<i>adv</i><br><ol><li>only</li></ol><br><i>noun</i><br><ol><li>daddy; father (term of address)</li></ol>
maRunapawan	<i>noun</i><br><ol><li>former spouse</li></ol>
maRung	<i>adj</i><br><ol><li>long</li></ol>
mais	<i>noun</i><br><ol><li>corn</li></ol>
mali	<i>noun</i><br><ol><li>ball</li></ol>
mammet	<i>noun</i><br><ol><li>vegetarian diet (for religious reasons)</li></ol>
manna	<i>pron</i><br><ol><li>(interrogative) why</li></ol>
mata	<i>noun</i><br><ol><li>eye (organ)</li></ol>
matqas	<i>adj</i><br><ol><li>ripe (of fruits)</li></ol>
maynep	<i>verb</i><br><ol><li>to sleep</li></ol>
mbusuq	<i>adj</i><br><ol><li>drunk</li><li>dizzy</li></ol>
meRapuq	<i>noun</i><br><ol><li>(anatomy) kidney</li></ol>
melabulil	<i>adj</i><br><ol><li>handsome</li></ol>
melanay	<i>noun</i><br><ol><li>earth; soil</li></ol>
melimu	<i>noun</i><br><ol><li>Reeves's muntjac (Muntiacus reevesi)</li></ol>
melipay	<i>noun</i><br><ol><li>Sunday</li></ol>
melqel	<i>adj</i><br><ol><li>correct</li></ol>
mennet	<i>adj</i><br><ol><li>spicy</li></ol>
mezizi	<i>adj</i><br><ol><li>wet</li></ol>
milam	<i>adj</i><br><ol><li>strong</li></ol>
missi	<i>adj</i><br><ol><li>fat (of a person)</li></ol>
mkatem	<i>adj</i><br><ol><li>crispy; crumbly</li></ol>
mkuras	<i>adj</i><br><ol><li>bald (of one's head)</li></ol>
mlames	<i>adj</i><br><ol><li>clean</li></ol>
mlasilas	<i>adj</i><br><ol><li>flat</li></ol>
mlaziu	<i>adj</i><br><ol><li>smooth</li></ol>
mlilumen	<i>adj</i><br><ol><li>honest</li></ol>
mlulay	<i>adj</i><br><ol><li>loose</li></ol>
mlunut	<i>adj</i><br><ol><li>sticky</li><li>tough</li></ol>
mngizaw	<i>adj</i><br><ol><li>toothless (due to age)</li></ol>
mnguRaz	<i>adj</i><br><ol><li>dumb; mute</li></ol>
mpias	<i>noun</i><br><ol><li>diarrhea</li></ol>
mqaRat	<i>adj</i><br><ol><li>itchy</li></ol>
mqaRim	<i>adj</i><br><ol><li>sour</li></ol>
mqesseR	<i>adj</i><br><ol><li>strong</li></ol>
mqilis	<i>adj</i><br><ol><li>steep</li></ol>
mquzung	<i>adj</i><br><ol><li>hunchbacked</li></ol>
msaiz	<i>adj</i><br><ol><li>cheap</li></ol>
msanem	<i>adj</i><br><ol><li>clever; wise</li><li>skillful</li><li>capable</li></ol>
msikit	<i>adj</i><br><ol><li>blind on one eye</li></ol>
msukaw	<i>adj</i><br><ol><li>bad</li></ol>
msupa	<i>adj</i><br><ol><li>poor</li></ol>
mtian	<i>adj</i><br><ol><li>pregnant (human)</li></ol>
mulin	<i>noun</i><br><ol><li>sparrow</li></ol>
mulu	<i>noun</i><br><ol><li>mandarin orange; tangerine</li></ol>
mutideng	<i>noun</i><br><ol><li>tomato</li></ol>
mutun	<i>noun</i><br><ol><li>mouse</li></ol>
nangan	<i>noun</i><br><ol><li>name</li></ol>
napawan	<i>noun</i><br><ol><li>spouse</li></ol>
naquni	<i>pron</i><br><ol><li>(interrogative) how</li></ol>
ngangay	<i>noun</i><br><ol><li>saliva</li></ol>
ngaqat	<i>noun</i><br><ol><li>chink; crack; crevice</li></ol>
ngasas	<i>noun</i><br><ol><li>profit</li></ol>
ngazuy	<i>noun</i><br><ol><li>(anatomy) chin</li></ol>
ngibiR	<i>noun</i><br><ol><li>(anatomy) mouth</li></ol>
ngingul	<i>noun</i><br><ol><li>tadpole</li></ol>
ngisaw	<i>adv</i><br><ol><li>always; often</li></ol>
nglul	<i>noun</i><br><ol><li>butt (of tobacco or cigarette)</li></ol>
ngu	<i>noun</i><br><ol><li>goose</li></ol>
nguit	<i>noun</i><br><ol><li>nasal mucus</li></ol>
nguripan	<i>noun</i><br><ol><li>edible moss (found on streams and fields)</li></ol>
nguyuR	<i>noun</i><br><ol><li>(anatomy, archaic) mouth</li></ol>
nguzus	<i>noun</i><br><ol><li>small cape</li></ol>
ningu	<i>noun</i><br><ol><li>picture</li><li>shadow</li><li>reflection</li></ol>
ningur	<i>noun</i><br><ol><li>tadpole</li></ol>
niniR	<i>noun</i><br><ol><li>sieve</li></ol>
ninutuz	<i>noun</i><br><ol><li>knot</li></ol>
niziut a sazzan	<i>noun</i><br><ol><li>suspension bridge</li></ol>
nka	<i>noun</i><br><ol><li>heddle (part of a loom)</li></ol>
nuzu	<i>noun</i><br><ol><li>coconut</li></ol>
pRawiR	<i>noun</i><br><ol><li>rabbit; hare</li></ol>
paiz	<i>noun</i><br><ol><li>fan</li></ol>
pakiskisan	<i>noun</i><br><ol><li>barbershop</li></ol>
pakuayan	<i>noun</i><br><ol><li>farmer</li><li>wife</li></ol>
pakuytan	<i>noun</i><br><ol><li>(anatomy) jaw</li></ol>
pakuz	<i>noun</i><br><ol><li>wing</li></ol>
paliatipan	<i>noun</i><br><ol><li>head of the house</li></ol>
palwawa	<i>noun</i><br><ol><li>backspike (in a fish trap to prevent fish from escaping)</li></ol>
pangi	<i>noun</i><br><ol><li>wart</li></ol>
pangzan	<i>noun</i><br><ol><li>screw pine</li></ol>
pani	<i>noun</i><br><ol><li>bow (for shooting)</li><li>knitting tool (shuttle)</li></ol>
paniusan	<i>noun</i><br><ol><li>fishing rod</li></ol>
paniwsan	<i>noun</i><br><ol><li>fishing rod</li></ol>
paqaw	<i>noun</i><br><ol><li>spider</li></ol>
parbaquyan	<i>noun</i><br><ol><li>whale</li></ol>
parikuan	<i>noun</i><br><ol><li>spindle</li></ol>
parin	<i>noun</i><br><ol><li>handle</li></ol>
parurukan	<i>noun</i><br><ol><li>hunter</li></ol>
pasabilangan	<i>noun</i><br><ol><li>calculator</li><li>abacus</li></ol>
pasnawa	<i>noun</i><br><ol><li>scarecrow</li></ol>
passan	<i>noun</i><br><ol><li>animal</li></ol>
pataqsian	<i>noun</i><br><ol><li>student</li></ol>
patudan	<i>noun</i><br><ol><li>teacher</li></ol>
patullan	<i>noun</i><br><ol><li>teacher</li></ol>
pawhuk	<i>noun</i><br><ol><li>scarf</li></ol>
pawis	<i>noun</i><br><ol><li>edge</li></ol>
pawman	<i>noun</i><br><ol><li>rice seedlings for autumn</li></ol>
paylas	<i>noun</i><br><ol><li>Chinese cinnamon</li></ol>
pazengitan	<i>noun</i><br><ol><li>(anatomy) liver</li></ol>
paziq	<i>noun</i><br><ol><li>locust</li></ol>
peRasku	<i>noun</i><br><ol><li>bottle</li></ol>
pelating	<i>noun</i><br><ol><li>Urtica thunbergiana, of east Asia</li></ol>
pelikid	<i>noun</i><br><ol><li>bat (animal)</li></ol>
pelisin	<i>noun</i><br><ol><li>taboo</li></ol>
penani	<i>noun</i><br><ol><li>(anatomy) thigh</li></ol>
penay	<i>noun</i><br><ol><li>bee</li></ol>
pennu	<i>noun</i><br><ol><li>sea turtle</li></ol>
piaz	<i>noun</i><br><ol><li>dish; plate</li></ol>
pikak	<i>noun</i><br><ol><li>yeast; leaven</li></ol>
pilay	<i>adj</i><br><ol><li>lazy</li></ol>
pilit	<i>noun</i><br><ol><li>stockpot</li></ol>
pillan	<i>adv</i><br><ol><li>every day</li></ol>
pinneng	<i>noun</i><br><ol><li>(anatomy) gall bladder</li></ol>
piqiq	<i>noun</i><br><ol><li>(anatomy) vulva; vagina</li></ol>
piruren	<i>noun</i><br><ol><li>collar</li></ol>
pius	<i>noun</i><br><ol><li>(anatomy) nape</li></ol>
plias	<i>noun</i><br><ol><li>cliff</li></ol>
pliket	<i>noun</i><br><ol><li>(anatomy) collarbone; clavicle</li></ol>
pnanian	<i>noun</i><br><ol><li>(anatomy) thigh</li></ol>
pniarpaw	<i>noun</i><br><ol><li>family</li></ol>
pnu	<i>noun</i><br><ol><li>sea turtle (generic for all sea turtles, including the hawksbill)</li></ol>
prikil	<i>noun</i><br><ol><li>bat (animal)</li></ol>
pruru	<i>noun</i><br><ol><li>watermelon</li></ol>
psipas	<i>noun</i><br><ol><li>fin (of a fish)</li></ol>
puRuR	<i>noun</i><br><ol><li>grassland</li></ol>
pukaw	<i>noun</i><br><ol><li>yoke</li></ol>
pulaw	<i>noun</i><br><ol><li>butterfly</li></ol>
pulung	<i>noun</i><br><ol><li>smallpox</li></ol>
punel	<i>noun</i><br><ol><li>(anatomy) brain</li></ol>
pungkang	<i>noun</i><br><ol><li>cave; cavern</li></ol>
punuz	<i>noun</i><br><ol><li>(anatomy) buttocks</li></ol>
puq	<i>noun</i><br><ol><li>peanut</li></ol>
puraw	<i>noun</i><br><ol><li>butterfly</li></ol>
putaw	<i>noun</i><br><ol><li>axe</li></ol>
putez	<i>noun</i><br><ol><li>goby</li></ol>
putit	<i>noun</i><br><ol><li>dragonfly</li></ol>
pwarwarin	<i>noun</i><br><ol><li>lizard; gecko</li></ol>
pzen	<i>noun</i><br><ol><li>hammer (made of iron)</li></ol>
qRawas	<i>noun</i><br><ol><li>large container made from bamboo</li></ol>
qa'iRnan	<i>noun</i><br><ol><li>groin</li></ol>
qa'ibuan	<i>noun</i><br><ol><li>ashtray</li></ol>
qa'ipitan	<i>noun</i><br><ol><li>chopstick container</li></ol>
qa't	<i>noun</i><br><ol><li>phleghm</li></ol>
qaRabi	<i>noun</i><br><ol><li>night</li></ol>
qaRat	<i>adj</i><br><ol><li>itchy</li></ol>
qaRtal	<i>noun</i><br><ol><li>rust</li></ol>
qaRut	<i>noun</i><br><ol><li>harrow</li></ol>
qabaw	<i>noun</i><br><ol><li>cow</li></ol>
qabinget	<i>noun</i><br><ol><li>rascal</li></ol>
qabinnusan	<i>noun</i><br><ol><li>life</li></ol>
qablayangan	<i>noun</i><br><ol><li>stove</li></ol>
qabtuan	<i>noun</i><br><ol><li>cupboard</li></ol>
qaburkan	<i>noun</i><br><ol><li>womb (of an animal)</li></ol>
qaddan	<i>noun</i><br><ol><li>pencil</li></ol>
qadud	<i>noun</i><br><ol><li>spoon</li></ol>
qakrisiwan	<i>noun</i><br><ol><li>purse</li></ol>
qallan	<i>noun</i><br><ol><li>chair</li><li>stool</li></ol>
qaniyau	<i>pron</i><br><ol><li>they</li></ol>
qaq	<i>noun</i><br><ol><li>crow; raven</li></ol>
qaqa	<i>noun</i><br><ol><li>older sibling</li></ol>
qaqaqa	<i>noun</i><br><ol><li>oldest sibling</li></ol>
qariman	<i>noun</i><br><ol><li>glove</li></ol>
qarpawan	<i>noun</i><br><ol><li>land to build a house</li></ol>
qasaray	<i>noun</i><br><ol><li>a type of Kavalan dance</li></ol>
qasba	<i>adj</i><br><ol><li>tough (of meat)</li></ol>
qasep	<i>noun</i><br><ol><li>clasp</li></ol>
qasi'uyan	<i>noun</i><br><ol><li>pad for a hot cooking pot</li></ol>
qasilapan	<i>adj</i><br><ol><li>ticklish</li></ol>
qasser	<i>adj</i><br><ol><li>moistened</li></ol>
qastian	<i>noun</i><br><ol><li>lamp</li></ol>
qasumman	<i>noun</i><br><ol><li>tub for urine; cesspit</li></ol>
qatadan	<i>noun</i><br><ol><li>toilet; bathroom; lavatory</li></ol>
qatbakuan	<i>noun</i><br><ol><li>tobacco case; tobacco bag</li></ol>
qatnes	<i>adj</i><br><ol><li>long (of a period of time)</li></ol>
qattallan	<i>noun</i><br><ol><li>lavatory; toilet</li></ol>
qawRiR	<i>adj</i><br><ol><li>insane</li></ol>
qawas	<i>noun</i><br><ol><li>big basket</li></ol>
qawiR	<i>noun</i><br><ol><li>hooked toe</li></ol>
qawpiR	<i>noun</i><br><ol><li>sweet potato</li></ol>
qawsua	<i>noun</i><br><ol><li>umbrella</li></ol>
qaymisan	<i>noun</i><br><ol><li>north</li></ol>
qayni	<i>pron</i><br><ol><li>(interrogative) where</li></ol>
qaytu	<i>conj</i><br><ol><li>because</li></ol>
qaznuman	<i>noun</i><br><ol><li>water container</li></ol>
qebangaRan	<i>noun</i><br><ol><li>cucumber</li></ol>
qebayu	<i>noun</i><br><ol><li>horse</li></ol>
qedqedan	<i>noun</i><br><ol><li>(anatomy) armpit</li></ol>
qeliwaRwaR	<i>noun</i><br><ol><li>rainbow</li></ol>
qelizen	<i>noun</i><br><ol><li>thread</li></ol>
qeluqung	<i>noun</i><br><ol><li>(anatomy) throat</li></ol>
qeluqut	<i>noun</i><br><ol><li>insect</li></ol>
qemadanan	<i>noun</i><br><ol><li>afternoon</li></ol>
qenabid	<i>noun</i><br><ol><li>enemy</li></ol>
qenabinnus	<i>noun</i><br><ol><li>birthday</li><li>life</li></ol>
qenasuani	<i>noun</i><br><ol><li>cousin</li></ol>
qiReb	<i>noun</i><br><ol><li>smoke</li></ol>
qiaqiat	<i>noun</i><br><ol><li>big frog</li></ol>
qinpan	<i>noun</i><br><ol><li>bed</li></ol>
qisuasuay	<i>adj</i><br><ol><li>wild</li></ol>
qitem	<i>noun</i><br><ol><li>iron clamp trap</li></ol>
qiwat	<i>adj</i><br><ol><li>thin (of a person)</li></ol>
qiyul	<i>noun</i><br><ol><li>eagle</li></ol>
qiznuman	<i>noun</i><br><ol><li>source; origin</li></ol>
qizuanan	<i>noun</i><br><ol><li>container</li><li>dwelling</li><li>place; area</li></ol>
qlapian	<i>noun</i><br><ol><li>pants; trousers</li></ol>
qlita	<i>noun</i><br><ol><li>octopus</li></ol>
qluni	<i>noun</i><br><ol><li>termite</li></ol>
qmuziquz	<i>noun</i><br><ol><li>(pathology) epilepsy</li></ol>
qnabil	<i>noun</i><br><ol><li>enemy</li></ol>
qnananam	<i>noun</i><br><ol><li>acquaintance</li></ol>
qnaruzitan	<i>noun</i><br><ol><li>scar</li></ol>
qnaynepan	<i>noun</i><br><ol><li>placenta</li></ol>
qnngian	<i>noun</i><br><ol><li>ecstasy (in sexual intercourse)</li></ol>
qnuluan	<i>adj</i><br><ol><li>adopted</li></ol>
qnuqus	<i>noun</i><br><ol><li>(anatomy) fingernail; toenail</li></ol>
qranann	<i>adj</i><br><ol><li>pregnant (of a non-human)</li></ol>
qrarez	<i>noun</i><br><ol><li>slippery rock with moss</li></ol>
qriwaRwaR	<i>noun</i><br><ol><li>rainbow</li></ol>
qruqqung	<i>noun</i><br><ol><li>(anatomy) throat; Adam's apple</li></ol>
qruqut	<i>noun</i><br><ol><li>worm</li><li>ringworm</li><li>maggot</li></ol>
qsi	<i>noun</i><br><ol><li>mosquito net</li></ol>
quRit	<i>noun</i><br><ol><li>pig skin</li></ol>
quan	<i>noun</i><br><ol><li>sprout from the stump</li></ol>
qubing	<i>noun</i><br><ol><li>whiskers (hair on both cheeks)</li></ol>
qubqub	<i>noun</i><br><ol><li>cage (for chickens, rats, mice, etc.)</li></ol>
qubu	<i>noun</i><br><ol><li>sea urchin</li></ol>
qudus	<i>noun</i><br><ol><li>clothes</li></ol>
qumni	<i>pron</i><br><ol><li>(interrogative) when</li></ol>
qupil	<i>noun</i><br><ol><li>men's net bag made of rattan</li></ol>
ququ	<i>noun</i><br><ol><li>call for chicken</li></ol>
qusazui	<i>noun</i><br><ol><li>future</li></ol>
qutqut	<i>noun</i><br><ol><li>rice crust; burnt rice sticking to the bottom of the pot</li></ol>
qutu	<i>noun</i><br><ol><li>head louse; nit</li></ol>
quyu	<i>noun</i><br><ol><li>mountain cat</li></ol>
qzan	<i>noun</i><br><ol><li>stove</li></ol>
qzim	<i>noun</i><br><ol><li>gap between teeth</li></ol>
rabang	<i>noun</i><br><ol><li>guest</li></ol>
rai	<i>noun</i><br><ol><li>mussel</li></ol>
rain	<i>noun</i><br><ol><li>waves in the open sea</li></ol>
rangaw	<i>noun</i><br><ol><li>fly (insect)</li></ol>
rapis	<i>noun</i><br><ol><li>squirrel</li></ol>
raqu	<i>noun</i><br><ol><li>weasel</li></ol>
raray	<i>noun</i><br><ol><li>cicada</li></ol>
raris	<i>noun</i><br><ol><li>discharge from the ear</li></ol>
rasu	<i>noun</i><br><ol><li>bullet</li></ol>
rasung	<i>noun</i><br><ol><li>well (for collecting water)</li></ol>
rawa	<i>noun</i><br><ol><li>cloth</li></ol>
rawar	<i>noun</i><br><ol><li>flying squirrel</li></ol>
razan	<i>noun</i><br><ol><li>road</li><li>path; trail</li></ol>
razat	<i>noun</i><br><ol><li>person; human being</li></ol>
razing	<i>noun</i><br><ol><li>sea</li><li>beach</li></ol>
razum	<i>noun</i><br><ol><li>needle</li></ol>
razung	<i>noun</i><br><ol><li>shade</li></ol>
ri'im	<i>noun</i><br><ol><li>loincloth</li></ol>
ribun	<i>noun</i><br><ol><li>sheath; scabbard</li></ol>
rihum	<i>noun</i><br><ol><li>azuki bean</li></ol>
rilam	<i>noun</i><br><ol><li>(anatomy) tongue</li></ol>
rineng	<i>noun</i><br><ol><li>wall (of a house, etc.)</li></ol>
rintun	<i>noun</i><br><ol><li>banyan (tree)</li></ol>
ripay	<i>noun</i><br><ol><li>Sunday</li></ol>
riqul	<i>noun</i><br><ol><li>tail (of land animals)</li></ol>
risikuy	<i>noun</i><br><ol><li>rooster with a big cockscomb</li></ol>
rittaz	<i>noun</i><br><ol><li>a skin disease with white spots</li></ol>
rizap	<i>noun</i><br><ol><li>lightning</li></ol>
rmun	<i>noun</i><br><ol><li>dolphin</li></ol>
rpaw	<i>noun</i><br><ol><li>house</li></ol>
rubung	<i>noun</i><br><ol><li>(anatomy) skin</li><li>bark</li></ol>
ruliq	<i>noun</i><br><ol><li>(anatomy) glans penis</li></ol>
rungabin	<i>noun</i><br><ol><li>starfish</li></ol>
rungrung	<i>noun</i><br><ol><li>stem (of a flower)</li></ol>
runuq	<i>noun</i><br><ol><li>(anatomy) back of the head</li></ol>
rupas	<i>noun</i><br><ol><li>peach</li></ol>
ruqnaw	<i>noun</i><br><ol><li>clouded leopard</li></ol>
ruren	<i>noun</i><br><ol><li>(anatomy) neck</li></ol>
rurus	<i>noun</i><br><ol><li>(anatomy) bladder</li><li>balloon</li></ol>
ruzem	<i>noun</i><br><ol><li>ant</li></ol>
ruzit	<i>noun</i><br><ol><li>wound</li></ol>
rzizing	<i>noun</i><br><ol><li>sea; ocean</li></ol>
saRu	<i>noun</i><br><ol><li>pestle</li></ol>
sabun	<i>noun</i><br><ol><li>soap</li></ol>
sabuq	<i>noun</i><br><ol><li>(anatomy) lower part of the abdomen</li></ol>
sait	<i>noun</i><br><ol><li>scissors</li></ol>
sakaw	<i>noun</i><br><ol><li>shortcut</li></ol>
saku	<i>noun</i><br><ol><li>cat</li></ol>
sakula	<i>noun</i><br><ol><li>cherry blossom; sakura</li></ol>
salamek	<i>adj</i><br><ol><li>fertile (said of land)</li></ol>
salamuan	<i>noun</i><br><ol><li>village</li><li>people from the same village</li></ol>
salang	<i>noun</i><br><ol><li>soup</li></ol>
salil	<i>noun</i><br><ol><li>(fish) net</li></ol>
salilut	<i>adj</i><br><ol><li>muddy</li></ol>
salu	<i>noun</i><br><ol><li>pumpkin</li></ol>
samukun	<i>noun</i><br><ol><li>iron mallet</li></ol>
samuz	<i>noun</i><br><ol><li>sesame</li></ol>
sann	<i>noun</i><br><ol><li>oyster</li></ol>
sanu	<i>noun</i><br><ol><li>taste</li></ol>
sapibulan	<i>noun</i><br><ol><li>answer</li></ol>
saqut	<i>verb</i><br><ol><li>to transport something</li></ol>
sasuRuqan	<i>noun</i><br><ol><li>dustbin</li></ol>
sasupasan	<i>noun</i><br><ol><li>eraser</li></ol>
satezay	<i>noun</i><br><ol><li>color</li></ol>
sawaq	<i>noun</i><br><ol><li>(anatomy) waist</li></ol>
sawki	<i>noun</i><br><ol><li>sickle</li></ol>
saypu	<i>noun</i><br><ol><li>takuwan</li></ol>
saytaw	<i>noun</i><br><ol><li>daikon; Chinese radish</li></ol>
saytu	<i>noun</i><br><ol><li>kitchen knife</li></ol>
sazan	<i>noun</i><br><ol><li>bridge</li></ol>
sazaqisan	<i>noun</i><br><ol><li>ladder</li></ol>
sazzan	<i>noun</i><br><ol><li>bridge</li></ol>
sbalat	<i>noun</i><br><ol><li>east wind</li><li>southeast wind</li></ol>
sbali	<i>noun</i><br><ol><li>arm ornament of silver</li><li>bracelet</li></ol>
sban	<i>noun</i><br><ol><li>long binding cloth for carrying a child on the back</li></ol>
sbi	<i>adj</i><br><ol><li>hungry</li></ol>
sebata	<i>noun</i><br><ol><li>taro</li></ol>
semutalul	<i>noun</i><br><ol><li>(anatomy) ring finger</li></ol>
semuteban	<i>noun</i><br><ol><li>(anatomy) middle finger</li></ol>
senizas	<i>noun</i><br><ol><li>roof</li></ol>
sepul	<i>adj</i><br><ol><li>soft</li></ol>
sessen	<i>adj</i><br><ol><li>cold</li></ol>
sezang	<i>noun</i><br><ol><li>sun</li></ol>
siR	<i>noun</i><br><ol><li>storehouse; warehouse</li></ol>
siRab	<i>adv</i><br><ol><li>yesterday</li></ol>
siRemuq	<i>noun</i><br><ol><li>deer</li></ol>
siak	<i>noun</i><br><ol><li>winter melon</li></ol>
siakiu	<i>noun</i><br><ol><li>new moon</li></ol>
siamqazui	<i>adv</i><br><ol><li>three days from now</li></ol>
siasing	<i>noun</i><br><ol><li>photograph</li></ol>
sibin	<i>noun</i><br><ol><li>towel</li></ol>
sidi'	<i>noun</i><br><ol><li>chili pepper; red pepper</li></ol>
sigu	<i>noun</i><br><ol><li>buffalo; water buffalo</li></ol>
siku	<i>noun</i><br><ol><li>(anatomy) elbow</li></ol>
sili	<i>noun</i><br><ol><li>hot pepper</li></ol>
silit	<i>noun</i><br><ol><li>knitting wool; wool yarn</li></ol>
simaR	<i>noun</i><br><ol><li>fat; grease</li></ol>
simau	<i>noun</i><br><ol><li>petal</li></ol>
simlang	<i>noun</i><br><ol><li>(pathology) prickly heat; miliaria</li></ol>
simllut	<i>noun</i><br><ol><li>cockfight</li></ol>
simmet	<i>noun</i><br><ol><li>glutinous rice</li></ol>
simpian	<i>noun</i><br><ol><li>fate; destiny</li></ol>
simpu	<i>noun</i><br><ol><li>priest</li></ol>
sinapnay	<i>noun</i><br><ol><li>beeswax</li></ol>
sining	<i>noun</i><br><ol><li>youth</li></ol>
sinsuli	<i>noun</i><br><ol><li>plum</li></ol>
sinut	<i>noun</i><br><ol><li>torch</li><li>flashlight</li></ol>
sipes	<i>noun</i><br><ol><li>cockroach</li></ol>
sipul	<i>noun</i><br><ol><li>small shrimp (in freshwater)</li></ol>
siqaR	<i>noun</i><br><ol><li>cotton-wadded quilt</li></ol>
siqqay	<i>noun</i><br><ol><li>snake</li></ol>
siraw	<i>noun</i><br><ol><li>pickled meat (pickled for a long time)</li></ol>
sisu	<i>noun</i><br><ol><li>(anatomy) breast</li></ol>
siti	<i>noun</i><br><ol><li>oil</li></ol>
sizi	<i>noun</i><br><ol><li>goat</li></ol>
smutki	<i>noun</i><br><ol><li>(anatomy) little finger; little toe</li></ol>
srakzayan	<i>adj</i><br><ol><li>jealous</li></ol>
suReman	<i>noun</i><br><ol><li>entrance</li></ol>
suRena	<i>noun</i><br><ol><li>ice</li></ol>
suRna	<i>noun</i><br><ol><li>snow</li><li>ice</li><li>frost</li></ol>
suani	<i>noun</i><br><ol><li>younger sibling</li></ol>
subar	<i>noun</i><br><ol><li>chisel</li></ol>
subungu	<i>adj</i><br><ol><li>lonely</li></ol>
sudad	<i>noun</i><br><ol><li>book</li></ol>
suksuk	<i>noun</i><br><ol><li>key</li><li>lock</li></ol>
sulal	<i>noun</i><br><ol><li>book</li><li>letter (written communication)</li></ol>
sulaq	<i>noun</i><br><ol><li>(anatomy) penis</li></ol>
sum	<i>noun</i><br><ol><li>urine</li></ol>
sunis	<i>noun</i><br><ol><li>kid; child</li></ol>
supayan	<i>noun</i><br><ol><li>whetstone</li></ol>
supuz	<i>noun</i><br><ol><li>dawn</li></ol>
sussu	<i>noun</i><br><ol><li>hoof (of a cow, horse, pig, sheep, etc.)</li></ol>
sussut	<i>noun</i><br><ol><li>plug; cork</li></ol>
suway	<i>noun</i><br><ol><li>grass</li></ol>
szang	<i>noun</i><br><ol><li>sun</li></ol>
taRaw	<i>adj</i><br><ol><li>painful</li></ol>
taRbabi	<i>noun</i><br><ol><li>morning</li></ol>
takan	<i>noun</i><br><ol><li>table</li><li>desk</li></ol>
taktak	<i>verb</i><br><ol><li>to cut (fish or chicken...etc) into pieces</li></ol>
tama	<i>noun</i><br><ol><li>father</li></ol>
tangan	<i>noun</i><br><ol><li>door</li></ol>
tangi	<i>adv</i><br><ol><li>now</li><li>today</li></ol>
tanian	<i>pron</i><br><ol><li>(interrogative) where</li></ol>
taqan	<i>noun</i><br><ol><li>column; pillar</li></ol>
taqisan	<i>noun</i><br><ol><li>school</li></ol>
taquq	<i>noun</i><br><ol><li>chicken</li></ol>
taquqan	<i>noun</i><br><ol><li>lily flower</li></ol>
tasaw	<i>noun</i><br><ol><li>year</li><li>age</li></ol>
tatak	<i>noun</i><br><ol><li>hoe</li></ol>
tawyu	<i>noun</i><br><ol><li>soy sauce</li></ol>
taya	<i>noun</i><br><ol><li>pneumatic tire</li></ol>
tayzin	<i>noun</i><br><ol><li>police</li></ol>
tazungan	<i>noun</i><br><ol><li>woman; girl; female</li></ol>
tbus	<i>noun</i><br><ol><li>sugarcane</li></ol>
tebaqan	<i>noun</i><br><ol><li>pomelo</li></ol>
tebuquR	<i>noun</i><br><ol><li>grasshopper</li></ol>
tebus	<i>noun</i><br><ol><li>sugar cane (Saccharum officinarum)</li></ol>
temawaR	<i>adv</i><br><ol><li>tomorrow</li></ol>
tenayan	<i>noun</i><br><ol><li>bamboo</li></ol>
tengabulan	<i>noun</i><br><ol><li>Pingpu or Pepo indigenous people, an ethnic group in Taiwan</li></ol>
tenguRed	<i>noun</i><br><ol><li>(anatomy) forehead</li></ol>
tenuded	<i>noun</i><br><ol><li>(anatomy) finger</li></ol>
tepuluk	<i>noun</i><br><ol><li>paper</li></ol>
tiRRan	<i>noun</i><br><ol><li>bone</li></ol>
tiRbu	<i>noun</i><br><ol><li>a kind of miscanthus</li></ol>
tiRmuq	<i>noun</i><br><ol><li>dust; grime</li><li>dust on road</li></ol>
tiRpes	<i>noun</i><br><ol><li>spittle</li></ol>
tiRuR	<i>noun</i><br><ol><li>egg</li></ol>
tiana	<i>pron</i><br><ol><li>(interrogative) who</li></ol>
tiannaw	<i>noun</i><br><ol><li>computer</li></ol>
tikas	<i>noun</i><br><ol><li>trap; snare</li></ol>
tilibi	<i>noun</i><br><ol><li>television</li></ol>
timRa	<i>noun</i><br><ol><li>flea</li></ol>
tiquq	<i>noun</i><br><ol><li>(anatomy) Adam's apple</li></ol>
tiran	<i>noun</i><br><ol><li>bedbug</li></ol>
tirep	<i>noun</i><br><ol><li>low door (to keep out dogs)</li></ol>
tiseq	<i>noun</i><br><ol><li>drill</li></ol>
tissan	<i>noun</i><br><ol><li>seed</li></ol>
tit	<i>noun</i><br><ol><li>kingfisher</li></ol>
titu	<i>noun</i><br><ol><li>puppy</li></ol>
tiyennaw	<i>noun</i><br><ol><li>computer</li></ol>
tizik	<i>noun</i><br><ol><li>cricket (insect)</li></ol>
tkep	<i>noun</i><br><ol><li>deadfall trap (for birds, rats, etc.)</li></ol>
tking	<i>noun</i><br><ol><li>match (for lighting candles, cigars, etc.)</li></ol>
tkituk	<i>noun</i><br><ol><li>summit; peak; top (of a mountain)</li></ol>
tlem	<i>adj</i><br><ol><li>dark</li></ol>
tlub	<i>adj</i><br><ol><li>muddy</li></ol>
tlumsik	<i>noun</i><br><ol><li>a kind of sea urchin</li></ol>
tlun	<i>noun</i><br><ol><li>sap</li><li>latex</li></ol>
tmez	<i>noun</i><br><ol><li>thorn</li></ol>
tmunaw	<i>noun</i><br><ol><li>hall</li></ol>
tnal	<i>noun</i><br><ol><li>(anatomy) intestines; guts</li></ol>
tnamasan	<i>noun</i><br><ol><li>cord of woven rattan</li></ol>
tnas	<i>noun</i><br><ol><li>soy sauce</li></ol>
tnayan	<i>noun</i><br><ol><li>bamboo</li></ol>
tnel	<i>noun</i><br><ol><li>vegetable</li></ol>
tnguRel	<i>noun</i><br><ol><li>(anatomy) forehead</li></ol>
tni	<i>noun</i><br><ol><li>semen; sperm</li></ol>
tniktikan	<i>noun</i><br><ol><li>tattoo</li></ol>
tnulel	<i>noun</i><br><ol><li>(anatomy) finger; toe</li></ol>
tnun	<i>root</i><br><ol><li>forms words relating to weaving</li></ol>
tpu	<i>noun</i><br><ol><li>mold (fungus)</li></ol>
tpuruk	<i>noun</i><br><ol><li>paper</li></ol>
tqiaR	<i>noun</i><br><ol><li>(anatomy) shoulder</li></ol>
traquq	<i>noun</i><br><ol><li>chicken</li></ol>
tray	<i>noun</i><br><ol><li>electric wire; barbed wire</li></ol>
tuRantuRabi	<i>noun</i><br><ol><li>midnight</li></ol>
tub	<i>noun</i><br><ol><li>lid</li></ol>
tubil	<i>noun</i><br><ol><li>(anatomy) lip</li></ol>
tuliq	<i>noun</i><br><ol><li>wasp</li></ol>
tumay	<i>noun</i><br><ol><li>bear</li></ol>
tuqtuq	<i>noun</i><br><ol><li>waterfall</li></ol>
tusungan	<i>noun</i><br><ol><li>sleeve</li></ol>
uRas	<i>noun</i><br><ol><li>dew</li></ol>
uRu	<i>noun</i><br><ol><li>(anatomy) head</li></ol>
ulima	<i>num</i><br><ol><li>five</li></ol>
unem	<i>num</i><br><ol><li>six</li></ol>
ungit	<i>noun</i><br><ol><li>soot</li></ol>
unglay|ungray	<i>noun</i><br><ol><li>pineapple</li></ol>
unung	<i>noun</i><br><ol><li>(anatomy) nose</li></ol>
upitu	<i>num</i><br><ol><li>seven</li></ol>
usepat	<i>num</i><br><ol><li>four</li></ol>
usiwa	<i>num</i><br><ol><li>nine</li></ol>
ussiq	<i>num</i><br><ol><li>one</li></ol>
utulu	<i>num</i><br><ol><li>three</li></ol>
utuz	<i>noun</i><br><ol><li>earthquake</li></ol>
uwalu	<i>num</i><br><ol><li>eight</li></ol>
uway	<i>noun</i><br><ol><li>rattan</li></ol>
uzan	<i>noun</i><br><ol><li>rain</li></ol>
uzis	<i>verb</i><br><ol><li>to bathe; to take a bath</li></ol>
uzusa	<i>num</i><br><ol><li>two</li></ol>
waRang	<i>noun</i><br><ol><li>crab</li></ol>
waki	<i>noun</i><br><ol><li>horn (of an animal)</li></ol>
wanay	<i>intj</i><br><ol><li>thank you</li><li>goodbye</li></ol>
wasu	<i>noun</i><br><ol><li>dog</li></ol>
waway	<i>noun</i><br><ol><li>culture</li></ol>
zais	<i>noun</i><br><ol><li>(anatomy) face</li></ol>
zamaR	<i>noun</i><br><ol><li>fire</li></ol>
zanum	<i>noun</i><br><ol><li>water</li></ol>
zapan	<i>noun</i><br><ol><li>(anatomy) foot</li></ol>
zaqisan	<i>noun</i><br><ol><li>stairs</li><li>ladder</li></ol>
zaszas	<i>noun</i><br><ol><li>(anatomy) chest</li></ol>
zaya	<i>noun</i><br><ol><li>west</li></ol>
zazang	<i>verb</i><br><ol><li>to broil</li><li>to dry clothing by a fire</li></ol>
zemiam	<i>noun</i><br><ol><li>salt</li></ol>
zengzeng	<i>noun</i><br><ol><li>thunder</li></ol>
zepu	<i>noun</i><br><ol><li>shoe</li></ol>
zimmet	<i>noun</i><br><ol><li>glutinous rice; sticky rice</li></ol>
zimuz	<i>noun</i><br><ol><li>(anatomy) nipple</li></ol>
zingit	<i>noun</i><br><ol><li>pygmy; dwarf</li></ol>
zinneq	<i>adj</i><br><ol><li>heavy</li></ol>
zippun	<i>noun</i><br><ol><li>Japan</li></ol>
ziting	<i>noun</i><br><ol><li>dictionary</li></ol>
zitinsia	<i>noun</i><br><ol><li>bicycle</li></ol>
ziun	<i>noun</i><br><ol><li>swing</li><li>cradle</li></ol>
ziutan	<i>noun</i><br><ol><li>hook</li></ol>
zmian	<i>noun</i><br><ol><li>salt</li></ol>
zna	<i>noun</i><br><ol><li>rice paddy</li></ol>
zu'	<i>noun</i><br><ol><li>elephant</li></ol>
zuket	<i>noun</i><br><ol><li>short neck</li></ol>
zukut	<i>noun</i><br><ol><li>scarf</li></ol>
