A	<i>character</i><br><ol><li>The first letter of the Kikuyu alphabet, written in the Latin script.</li></ol>
Gĩkũyũ	<i>name</i><br><ol><li>(collective) Kikuyu people</li><li>Kikuyu language</li></ol>
Kamau mwerũ nĩ airaga	<i>proverb</i><br><ol><li>All earthly things are transitory.</li></ol>
Maina	<i>name</i><br><ol><li>name of one of the ruling generation-sets (mariika); the other is Mwangi.</li></ol>
Mwangi	<i>name</i><br><ol><li>name of one of the two ruling generation-sets (mariika); the other is Maina.</li></ol>
Mũthũngũ|Athũngũ	<i>noun</i><br><ol><li>white, European, Caucasian</li></ol>
Ngai	<i>noun</i><br><ol><li>God</li></ol>
aca	<i>particle</i><br><ol><li>no</li></ol>
aga|kwaga	<i>verb</i><br><ol><li>to lack, to miss, to fail to find</li></ol>
aka|gwaka	<i>verb</i><br><ol><li>to build</li></ol>
akia|gwakia	<i>verb</i><br><ol><li>to kindle, to light</li></ol>
amba|kwamba	<i>verb</i><br><ol><li>to peg (out), to pitch</li><li>to stretch out</li><li>to do first</li></ol>
ambata|kwambata	<i>verb</i><br><ol><li>to come up, to go up, to ascend</li></ol>
ambĩrĩria|kwambĩrĩria	<i>verb</i><br><ol><li>(transitive) to begin, to start</li></ol>
andĩka|kwandĩka	<i>verb</i><br><ol><li>to write</li></ol>
aria|kwaria	<i>verb</i><br><ol><li>to speak</li></ol>
atha|gwatha	<i>verb</i><br><ol><li>to order, to command</li></ol>
atĩa	<i>pron</i><br><ol><li>(interrogative) what</li><li>(interrogative) how</li></ol>
atĩrĩrĩ	<i>particle</i><br><ol><li>listen to me</li></ol>
atũka|gwatũka	<i>verb</i><br><ol><li>(intransitive) to split</li></ol>
atũra|gwatũra	<i>verb</i><br><ol><li>(transitive) to split, to divide, to part</li></ol>
baara|kũbaara	<i>verb</i><br><ol><li>to look at, to examine</li></ol>
baba	<i>noun</i><br><ol><li>my father, dad</li></ol>
bangiri	<i>noun</i><br><ol><li>bangle</li></ol>
bara	<i>noun</i><br><ol><li>road</li></ol>
barabara	<i>noun</i><br><ol><li>road</li></ol>
barĩthiramu	<i>noun</i><br><ol><li>pyrethrum</li></ol>
biacara|mbiacara|mabiacara	<i>noun</i><br><ol><li>trade, commerce, business</li></ol>
biribiri	<i>noun</i><br><ol><li>red pepper, hot pepper, chili pepper</li></ol>
bitharĩ	<i>noun</i><br><ol><li>curry powder</li></ol>
bongwe	<i>noun</i><br><ol><li>(Chanler's) mountain reedbuck (Redunca fulvorufula chanleri)</li></ol>
borithi	<i>noun</i><br><ol><li>police</li></ol>
butha|kũbutha	<i>verb</i><br><ol><li>to be rotten</li></ol>
bũrũri|mabũrũri	<i>noun</i><br><ol><li>country, region</li></ol>
cemania|gũcemania	<i>verb</i><br><ol><li>to meet, to join up with</li></ol>
ciara|gũciara	<i>verb</i><br><ol><li>to bring forth, to give birth, to give rise</li><li>to bear (fruit)</li><li>to adopt</li></ol>
cimba|gũcimba	<i>verb</i><br><ol><li>to hoe, to dig with a hoe</li></ol>
cina|gũcina	<i>verb</i><br><ol><li>(transitive) to burn</li></ol>
cindano|macindano	<i>noun</i><br><ol><li>needle</li></ol>
coka|gũcoka	<i>verb</i><br><ol><li>to go back, to return</li></ol>
cokia|gũcokia	<i>verb</i><br><ol><li>to give back, to put back</li><li>to reply, to answer</li></ol>
conoka|gũconoka	<i>verb</i><br><ol><li>to be ashamed, to be shy</li></ol>
cuba|gacuba|macuba	<i>noun</i><br><ol><li>bottle</li></ol>
cukari	<i>noun</i><br><ol><li>sugar</li></ol>
cuma|macuma	<i>noun</i><br><ol><li>iron, steel</li></ol>
cumbĩ|macumbĩ	<i>noun</i><br><ol><li>salt</li></ol>
cuuka|gũcuuka	<i>verb</i><br><ol><li>to slander</li></ol>
cũcũ|macũcũ	<i>noun</i><br><ol><li>my grandmother, gramma</li></ol>
cũna|gũcũna	<i>verb</i><br><ol><li>to lick</li></ol>
enda|kũenda|kwenda	<i>verb</i><br><ol><li>to like, to love</li><li>to want</li></ol>
endia|kwendia）|endia infinitives kũendia	<i>verb</i><br><ol><li>to sell</li></ol>
enja|kwenja	<i>verb</i><br><ol><li>to dig</li><li>to shave</li></ol>
gatagatĩ|tũtagatĩ	<i>noun</i><br><ol><li>middle, between</li></ol>
gatarũ|tũtarũ	<i>noun</i><br><ol><li>small boat, small canoe</li></ol>
gatego	<i>noun</i><br><ol><li>venereal disease, especially syphilis</li></ol>
gathuku|tũthuku	<i>noun</i><br><ol><li>parrot</li></ol>
gathĩrĩthĩrĩ|tũthĩrĩthĩrĩ	<i>noun</i><br><ol><li>something that is long and thin</li></ol>
gatinyinyiraga gatarĩ gakunye	<i>proverb</i><br><ol><li>no smoke without fire (lit. little one does not squeak without being pinched)</li></ol>
gatitũ|tũtitũ	<i>noun</i><br><ol><li>small forest, copse, grove</li></ol>
gatumia|tũtumia	<i>noun</i><br><ol><li>Dwarf Cavendish banana, a cultivar, (Musa acuminata Colla (AAA Group) 'Dwarf Cavendish')</li><li>Bandé banana</li><li>(common) purslane (Portulaca oleracea)</li></ol>
gaturumo|tũturumo	<i>noun</i><br><ol><li>dot, spot</li><li>full stop, point</li></ol>
geithia|kũgeithia	<i>verb</i><br><ol><li>to greet</li></ol>
gera|kũgera	<i>verb</i><br><ol><li>to count, to measure, to reckon</li><li>to pass through</li></ol>
geria|kũgeria	<i>verb</i><br><ol><li>to try, to attempt</li><li>to tempt (someone)</li></ol>
giria|kũgiria	<i>verb</i><br><ol><li>to prevent</li></ol>
guka	<i>noun</i><br><ol><li>my grandfather</li></ol>
guoko|moko	<i>noun</i><br><ol><li>hand</li><li>arm</li></ol>
gwata|kũgwata	<i>verb</i><br><ol><li>to grasp</li><li>to seize</li><li>to rape</li></ol>
gĩathĩ|ciathĩ	<i>noun</i><br><ol><li>appointment for gathering</li><li>prearranged meeting</li><li>any social event where people gather at a market, feast; party</li></ol>
gĩathĩ kĩa ngũha	<i>noun</i><br><ol><li>(idiomatic) An expression used for reminding a speaker's peer of a secret hide-out where they used to and are to meet. (lit. an appointment/a gathering of ticks)</li></ol>
gĩcagi|icagi	<i>noun</i><br><ol><li>an untidy, sprawling agglomeration of homesteads built by a mixed group of people from different clans or sub-clans</li><li>a new village</li></ol>
gĩcanjama|icanjama	<i>noun</i><br><ol><li>rabble, disorderly crowd, mob</li></ol>
gĩcanũri|icanũri	<i>noun</i><br><ol><li>comb (for hairs)</li></ol>
gĩcicio|icicio	<i>noun</i><br><ol><li>mirror</li><li>pane (for windows, doors, etc.)</li><li>(in the plural) eyeglasses</li></ol>
gĩcigĩrĩra|icigĩrĩra	<i>noun</i><br><ol><li>island</li></ol>
gĩciko|iciko	<i>noun</i><br><ol><li>spoon</li></ol>
gĩciri|iciri	<i>noun</i><br><ol><li>shoulder-blade</li><li>part of goat meat including shoulder-blade</li></ol>
gĩcunjĩ|icunjĩ|gacunjĩ	<i>noun</i><br><ol><li>part, piece, portion</li><li>section</li></ol>
gĩcuthĩ|icuthĩ	<i>noun</i><br><ol><li>tail</li></ol>
gĩcũhĩ|icũhĩ	<i>noun</i><br><ol><li>ring</li></ol>
gĩcũnũnũ	<i>noun</i><br><ol><li>gonorrhea</li></ol>
gĩeterero	<i>noun</i><br><ol><li>waiting with patience; endurance</li></ol>
gĩkama|ikama	<i>noun</i><br><ol><li>piece of pig iron</li></ol>
gĩkeno|ikeno	<i>noun</i><br><ol><li>joy, happiness</li></ol>
gĩkere|ikere	<i>noun</i><br><ol><li>(Anatomy) calf (of the leg)</li></ol>
gĩkombe|ikombe	<i>noun</i><br><ol><li>cup</li></ol>
gĩkoni|makoni|ikoni	<i>noun</i><br><ol><li>husk, skin</li></ol>
gĩkorora|ikorora	<i>noun</i><br><ol><li>phlegm</li></ol>
gĩkundi|ikundi	<i>noun</i><br><ol><li>group, assembly, collection</li></ol>
gĩkuũ	<i>noun</i><br><ol><li>death</li></ol>
gĩkwa|ikwa	<i>noun</i><br><ol><li>yam</li></ol>
gĩkĩngĩ|ikĩngĩ	<i>noun</i><br><ol><li>stake</li></ol>
gĩkũnjo|ikũnjo	<i>noun</i><br><ol><li>ball of string or wool</li><li>tied or rolled up bundle or load</li></ol>
gĩtahi|itahi	<i>noun</i><br><ol><li>anything used as a dipper</li></ol>
gĩtaigua|itaigua	<i>noun</i><br><ol><li>deaf person</li><li>(derogatory) the deaf</li><li>disobedient person</li></ol>
gĩtanda|itanda	<i>noun</i><br><ol><li>bed</li></ol>
gĩtarũrũ|gatarũrũ|itarũrũ	<i>noun</i><br><ol><li>A winnowing tray twined with bark of mũgio (Triumfetta brachyceras, syn. T. macrophylla, T. ruwenzorensis), a kind of shrub, used also as a server.</li></ol>
gĩtete|itete	<i>noun</i><br><ol><li>long narrow calabash with strap gruel or beer</li></ol>
gĩthagathago|ithagathago	<i>noun</i><br><ol><li>preparation</li></ol>
gĩthana|ithana	<i>noun</i><br><ol><li>beestings</li></ol>
gĩthemengũ|ithemengũ	<i>noun</i><br><ol><li>evil eye</li></ol>
gĩthima|ithima	<i>noun</i><br><ol><li>well (a pit for keeping water)</li></ol>
gĩthima mbũri|ithima mbũri	<i>noun</i><br><ol><li>coucal,</li></ol>
gĩthingithia|ithingithia	<i>noun</i><br><ol><li>earthquake</li></ol>
gĩthitũ|ithitũ	<i>noun</i><br><ol><li>amulet, charm</li></ol>
gĩthoguo|ithoguo	<i>noun</i><br><ol><li>a tin can with a stone put in, worn by boys on the calf of the leg during dances; a rattle</li></ol>
gĩthomo|ithomo	<i>noun</i><br><ol><li>education</li><li>study, learning</li></ol>
gĩthũnũ|ithũnũ	<i>noun</i><br><ol><li>roughly built hut</li><li>initiation candidates' hut built adjacent to the women's sleeping place of the senior co-wife's hut</li></ol>
gĩthũri|ithũri	<i>noun</i><br><ol><li>chest</li></ol>
gĩthũũkũ	<i>noun</i><br><ol><li>measles</li></ol>
gĩthũũri|ithũũri	<i>noun</i><br><ol><li>candelabra tree, naboom (E. ingens); its latex may cause temporary blindness if applied to the eyes.</li><li>E. bussei var. kibwezensis</li><li>E. cussonioides</li></ol>
gĩtina|matina|itina	<i>noun</i><br><ol><li>base</li></ol>
gĩtingĩ|itingĩ	<i>noun</i><br><ol><li>pole, pillar</li></ol>
gĩtoero|itoero	<i>noun</i><br><ol><li>stew with potato, vegetable and sometimes meat</li></ol>
gĩtoka|itoka	<i>noun</i><br><ol><li>pyjama lily (Crinum kirkii); formerly planted for marking boundaries of individual land holdings.</li><li>Cape coast lily, pyjama lily (Crinum macowanii)</li></ol>
gĩtonga|atonga	<i>noun</i><br><ol><li>rich person</li></ol>
gĩtore|itoore|itore|gĩtoore	<i>noun</i><br><ol><li>tree hyrax</li></ol>
gĩtugĩ|itugĩ	<i>noun</i><br><ol><li>pillar, post, prop</li></ol>
gĩtukũ|itukũ	<i>noun</i><br><ol><li>headdress with feathers worn when a performer dances</li></ol>
gĩtumumu|atumumu	<i>noun</i><br><ol><li>(derogatory) blind person</li></ol>
gĩtĩ|itĩ	<i>noun</i><br><ol><li>stool (a utensil on which one sits)</li></ol>
gĩtũngũrũ|itũngũrũ	<i>noun</i><br><ol><li>onion</li></ol>
gĩĩko|ciĩko	<i>noun</i><br><ol><li>cobra</li><li>tobacco pipe</li></ol>
gũota mwaki nĩ kũhuria	<i>proverb</i><br><ol><li>no gain without pain (lit. to warm oneself is to stoke the fire)</li></ol>
gũra|kũgũra	<i>verb</i><br><ol><li>to buy</li></ol>
gũtũ|matũ	<i>noun</i><br><ol><li>ear</li></ol>
haaro	<i>noun</i><br><ol><li>quarrel, dispute</li></ol>
haica|kũhaica	<i>verb</i><br><ol><li>to mount, to climb, to ride</li></ol>
haka|kũhaka	<i>verb</i><br><ol><li>to paint, to smear</li><li>to propitiate by gift</li><li>to bribe</li></ol>
hamwe	<i>adv</i><br><ol><li>together</li></ol>
handa|kũhanda	<i>verb</i><br><ol><li>to sow, to plant</li></ol>
handũ|kũndũ	<i>noun</i><br><ol><li>place, spot, site</li></ol>
hanyũka|kũhanyũka	<i>verb</i><br><ol><li>to run</li></ol>
harika	<i>noun</i><br><ol><li>female goat that has not yet borne a kid</li></ol>
he|kũhe	<i>verb</i><br><ol><li>to give</li></ol>
heho	<i>noun</i><br><ol><li>coldness</li></ol>
heke	<i>noun</i><br><ol><li>testicle</li></ol>
higo	<i>noun</i><br><ol><li>kidney</li></ol>
hinya|mahinya	<i>noun</i><br><ol><li>strength, power, force, effort</li></ol>
hitha|kũhitha	<i>verb</i><br><ol><li>to hide, to conceal</li></ol>
hiti	<i>noun</i><br><ol><li>hyena, especially spotted hyena (Crocuta crocuta)</li></ol>
hiti ciathiĩ mbwe ciegangara	<i>proverb</i><br><ol><li>when the cat's away the mice will play (lit. when hyenas go away, foxes play)</li></ol>
hota|kũhota	<i>verb</i><br><ol><li>to be able, to be capable</li></ol>
hoya|kũhoya	<i>verb</i><br><ol><li>to ask for, to beg for</li><li>to pray</li></ol>
huko	<i>noun</i><br><ol><li>mole rat</li><li>mole</li></ol>
huria|kũhuria	<i>verb</i><br><ol><li>to snatch</li></ol><br><i>noun</i><br><ol><li>rhinoceros</li></ol>
hwaĩ|mahwaĩ	<i>noun</i><br><ol><li>last evening</li></ol>
hwaĩ-inĩ	<i>adv</i><br><ol><li>in the evening</li></ol>
hĩtũka|kũhĩtũka	<i>verb</i><br><ol><li>to pass</li></ol>
hĩtũkĩra|kũhĩtũkĩra	<i>verb</i><br><ol><li>to pass by</li></ol>
hũngũ	<i>noun</i><br><ol><li>kite</li><li>hawk</li><li>vulture</li></ol>
hũnĩro	<i>noun</i><br><ol><li>loins, flanks, waist</li></ol>
hũra|kũhũra	<i>verb</i><br><ol><li>to beat, to hit, to strike, to tap</li><li>to pound</li><li>to brew</li></ol>
ibabai|mababai	<i>noun</i><br><ol><li>fruit of papaya, pawpaw</li></ol>
ibuku|mabuku	<i>noun</i><br><ol><li>book</li></ol>
iburi|maburi	<i>noun</i><br><ol><li>umbrella</li></ol>
icani|macani	<i>noun</i><br><ol><li>tea(-plant)</li><li>(plural only) tea-leaves</li></ol>
icembe|macembe	<i>noun</i><br><ol><li>hoe</li></ol>
icoya|macoya	<i>noun</i><br><ol><li>musaceous leaf</li></ol>
icungwa|macungwa	<i>noun</i><br><ol><li>orange</li></ol>
iga|kũiga	<i>verb</i><br><ol><li>to put</li><li>to keep, to store, to put aside</li></ol>
igana|kũigana	<i>verb</i><br><ol><li>to be sufficient, to be enough, to come up to a point, to be up to</li></ol>
igata|magata	<i>noun</i><br><ol><li>piece of trona</li><li>(plural only) bad scurf on head</li></ol>
igego|magego	<i>noun</i><br><ol><li>tooth</li></ol>
igoko|magoko	<i>noun</i><br><ol><li>bark of tree</li></ol>
igoti|magoti	<i>noun</i><br><ol><li>back of neck</li></ol>
igua|kũigua	<i>verb</i><br><ol><li>to hear</li><li>to feel</li><li>to smell (at)</li><li>to obey</li></ol>
iguana|kũiguana	<i>verb</i><br><ol><li>to agree</li><li>to be reconciled</li><li>to be in one mind</li><li>to be friendly</li></ol>
iguku|maguku	<i>noun</i><br><ol><li>hump (especially one on the back of a cow)</li></ol>
iheeni|maheeni	<i>noun</i><br><ol><li>lie, untruth, falsehood</li><li>trick, deception</li></ol>
ihera|mahera	<i>noun</i><br><ol><li>punishment, penalty</li></ol>
ihiga|mahiga	<i>noun</i><br><ol><li>stone</li></ol>
ihinda|mahinda	<i>noun</i><br><ol><li>time, moment</li></ol>
ihooru|mahooru	<i>noun</i><br><ol><li>loneliness, solitude</li><li>feeling of sadness, apprehension, foreboding</li></ol>
ihoru|mahoru	<i>noun</i><br><ol><li>see ihooru</li></ol>
ihuti|mahuti	<i>noun</i><br><ol><li>rubbish, scum</li></ol>
ihĩa|mahĩa	<i>noun</i><br><ol><li>burn, scald</li></ol>
ihĩndu|mahĩndu	<i>noun</i><br><ol><li>Abyssinian banana, ensete (Ensete ventricosum, syn. E. edule)</li></ol>
ihĩndĩ|mahĩndĩ	<i>noun</i><br><ol><li>bone</li></ol>
ihĩtia|mahĩtia	<i>noun</i><br><ol><li>fault, error</li></ol>
ihũa|mahũa	<i>noun</i><br><ol><li>flower</li></ol>
ihũha|mahũha	<i>noun</i><br><ol><li>boil (on skin)</li></ol>
ihũri|mahũri	<i>noun</i><br><ol><li>lung</li></ol>
ikai|makai	<i>noun</i><br><ol><li>cheek</li><li>mouthful</li></ol>
ikamburu|makamburu	<i>noun</i><br><ol><li>molar</li></ol>
ikara|makara|gũikara	<i>noun</i><br><ol><li>(chiefly in plural) charcoal</li></ol><br><i>verb</i><br><ol><li>to sit</li><li>to stay, to remain</li><li>to dwell</li></ol>
ikia|gũikia	<i>verb</i><br><ol><li>to put in, to throw, to dip</li></ol>
ikia ngono|gũikia ngono	<i>verb</i><br><ol><li>to arrest, to lay one's hands on, to give one's hands on</li></ol>
ikinya|makinya	<i>noun</i><br><ol><li>sole</li><li>footprint</li></ol>
ikoni|makoni	<i>noun</i><br><ol><li>bark of tree</li></ol>
ikoro|makoro	<i>noun</i><br><ol><li>skin (of banana, potato, etc.)</li></ol>
ikorobia|makorobia	<i>noun</i><br><ol><li>avocado fruit</li></ol>
ikundo|makundo	<i>noun</i><br><ol><li>one of several knots made for counting days until the day, by which an appointment should be fulfilled, etc.</li></ol>
ikunũ|makunũ	<i>noun</i><br><ol><li>mushroom</li></ol>
ikũmbĩ|makũmbĩ	<i>noun</i><br><ol><li>granary</li><li>wave</li></ol>
ikũmi|makũmi	<i>noun</i><br><ol><li>ten</li></ol>
ikũrũka|gũikũrũka	<i>verb</i><br><ol><li>to go down, to descend</li></ol>
ime	<i>noun</i><br><ol><li>dew</li></ol>
ina|kũina	<i>verb</i><br><ol><li>to dance</li><li>to sing</li></ol>
inagu|managu	<i>noun</i><br><ol><li>black nightshade (Solanum nigrum); its leaves have been traditionally regarded as edible.</li></ol>
inanathi|mananathi	<i>noun</i><br><ol><li>pineapple</li></ol>
inegene|manegene	<i>noun</i><br><ol><li>noise, din, chatter</li></ol>
ini|mani	<i>noun</i><br><ol><li>liver</li></ol>
inia|kũinia	<i>verb</i><br><ol><li>(literally) to make someone dance</li><li>to shake</li></ol>
iniũrũ|maniũrũ	<i>noun</i><br><ol><li>nose</li></ol>
inooro|manooro	<i>noun</i><br><ol><li>whetstone</li></ol>
inyuĩ	<i>pron</i><br><ol><li>you (plural)</li></ol>
inũka|kũinũka	<i>verb</i><br><ol><li>to go home</li></ol>
ira|kũira	<i>verb</i><br><ol><li>to be black, to turn black</li><li>to feel stinted of</li></ol>
irathĩro	<i>noun</i><br><ol><li>east</li></ol>
irebeta|marebeta	<i>noun</i><br><ol><li>poem, verse</li><li>song with cryptic phrasing sung to the accompaniment of the gourd instrument (gĩcandĩ)</li><li>epigram</li></ol>
iria|maria	<i>noun</i><br><ol><li>milk</li><li>lake, pond</li><li>sea</li></ol>
irigithathi|marigithathi	<i>noun</i><br><ol><li>first child, first-born</li></ol>
irigũ|marigũ	<i>noun</i><br><ol><li>banana</li></ol>
irima|marima	<i>noun</i><br><ol><li>hole, pit</li></ol>
irimũ|marimũ	<i>noun</i><br><ol><li>ogre who appears in folktales and tends to eat human beings</li></ol>
irio	<i>noun</i><br><ol><li>food</li></ol>
iru|maru	<i>noun</i><br><ol><li>knee</li></ol>
irurumĩ|marurumĩ	<i>noun</i><br><ol><li>thunderclap</li></ol>
irĩhi|marĩhi	<i>noun</i><br><ol><li>compensation, fine</li></ol>
irũa|karũa|marũa	<i>noun</i><br><ol><li>piece of paper, sheet of paper</li><li>letter</li></ol>
irũngo|marũngo	<i>noun</i><br><ol><li>joint, section</li></ol>
ita|ita 10 or|gũita	<i>verb</i><br><ol><li>to strangle</li><li>to pour out, to pour away</li><li>to leak</li></ol><br><i>noun</i><br><ol><li>troop of warriors organized for a foray; a raiding party</li></ol>
itaata|mataata	<i>noun</i><br><ol><li>drop, drip</li></ol>
itahuha|matahuha	<i>noun</i><br><ol><li>puff adder (Bitis arietans)</li></ol>
itangi|matangi	<i>noun</i><br><ol><li>metal water tank</li></ol>
itarara|matarara	<i>noun</i><br><ol><li>python, especially (African) rock python (Python sebae)</li></ol>
ithagu|mathagu	<i>noun</i><br><ol><li>wing</li></ol>
ithandũkũ|mathandũkũ	<i>noun</i><br><ol><li>box</li></ol>
ithangũ|mathangũ	<i>noun</i><br><ol><li>leaf</li></ol>
ithanwa|gathanwa|mathanwa	<i>noun</i><br><ol><li>axe</li></ol>
ithe	<i>noun</i><br><ol><li>his or her father</li></ol>
itherero	<i>noun</i><br><ol><li>east</li></ol>
ithuĩ	<i>pron</i><br><ol><li>we</li></ol>
ithĩnjĩro|mathĩnjĩro	<i>noun</i><br><ol><li>place where slaughter takes place</li></ol>
ithũĩro	<i>noun</i><br><ol><li>west</li></ol>
itimũ|matimũ	<i>noun</i><br><ol><li>spear</li></ol>
itina|matina	<i>noun</i><br><ol><li>buttocks</li></ol>
itu|matu	<i>noun</i><br><ol><li>cloud</li></ol>
itumbĩ|matumbĩ	<i>noun</i><br><ol><li>egg</li></ol>
itunda|matunda	<i>noun</i><br><ol><li>fruit</li></ol>
iturubarĩ|maturubarĩ	<i>noun</i><br><ol><li>brick</li></ol>
ituuya|matuuya|ituya|matuya	<i>noun</i><br><ol><li>edible fruit of Myrianthus arboreus (mũtuuya).</li></ol>
itũũra|matũũra	<i>noun</i><br><ol><li>village</li></ol>
iya|kũiya	<i>verb</i><br><ol><li>to steal</li></ol>
iyũra|kũiyũra	<i>verb</i><br><ol><li>to be full, to be plentiful</li><li>to become full</li></ol>
kaana|twana	<i>noun</i><br><ol><li>baby, boy</li></ol>
kaara kamwe gatiũragaga ndaa	<i>proverb</i><br><ol><li>one hand washes the other, and both wash the face (lit. one tiny finger does not kill a louse)</li></ol>
kahĩĩ|tũhĩĩ	<i>noun</i><br><ol><li>little boy</li></ol>
kahũa	<i>noun</i><br><ol><li>coffee, including the plant (Coffea arabica)</li></ol>
kaingĩ	<i>adv</i><br><ol><li>often, frequently</li></ol>
kaiyaba|tũiyaba	<i>noun</i><br><ol><li>Kei apple (Dovyalis caffra); introduced from Southern Africa, fruit edible, also used for hedging.</li></ol>
kameme|tũmeme	<i>noun</i><br><ol><li>radio</li><li>wireless set</li><li>gramophone</li><li>loudspeaker</li></ol>
kamũcoroge|tũmĩcoroge	<i>noun</i><br><ol><li>small genet</li></ol>
kamũingĩ koyaga ndĩrĩ	<i>proverb</i><br><ol><li>many hands make light work (lit. a group of people lifts a mortar)</li></ol>
kana	<i>conj</i><br><ol><li>or, whether</li></ol>
kang'aurũ|tũng'aurũ	<i>noun</i><br><ol><li>scorpion</li></ol>
kanitha|makanitha|kanitha	<i>noun</i><br><ol><li>the church (as an organization)</li><li>church building</li></ol>
kanua|tũnua	<i>noun</i><br><ol><li>mouth</li></ol>
kanyoni|tũnyoni	<i>noun</i><br><ol><li>small bird, birdlet</li></ol>
kanyĩrĩ|tũnyĩrĩ	<i>noun</i><br><ol><li>long tailfeather of male bird</li></ol>
karani|tũrani	<i>noun</i><br><ol><li>clerk, secretary</li></ol>
karema|tũrema	<i>noun</i><br><ol><li>deformity, malformation</li></ol>
kari|tũri	<i>noun</i><br><ol><li>Agelaea pentagyna (syn. A. heterophylla)</li><li>Rourea thomsonii</li></ol>
karĩgũ|tũrĩgũ	<i>noun</i><br><ol><li>little girl</li></ol>
karĩma|tũrĩma	<i>noun</i><br><ol><li>small hill</li></ol>
karũũĩ|tũrũũĩ	<i>noun</i><br><ol><li>stream, brook</li></ol>
kaĩ	<i>intj</i><br><ol><li>expression of astonishment or joy; my word!</li></ol>
kena|gũkena	<i>verb</i><br><ol><li>to be glad</li></ol>
kenda|makenda	<i>num</i><br><ol><li>nine</li></ol>
kenda mũiyũru	<i>num</i><br><ol><li>ten</li></ol>
kiino	<i>noun</i><br><ol><li>see kĩino</li></ol>
kira|gũkira	<i>verb</i><br><ol><li>to hold one's tongue</li></ol>
kiugo|ciugo	<i>noun</i><br><ol><li>word</li></ol>
kiugũ|ciugũ	<i>noun</i><br><ol><li>cattle enclosure, pen, corral</li></ol>
kiugũigũ|ciugũigũ	<i>noun</i><br><ol><li>nightjar</li></ol>
kiumia|ciumia	<i>noun</i><br><ol><li>week</li></ol>
koma|gũkoma	<i>verb</i><br><ol><li>to sleep, to lie down</li></ol>
korora|gũkorora	<i>verb</i><br><ol><li>to cough</li></ol>
kua|gũkua	<i>verb</i><br><ol><li>to die</li><li>to break into pieces, to fall into pieces</li></ol>
kumia|gũkumia	<i>verb</i><br><ol><li>to praise</li></ol>
kundĩka|gũkundĩka	<i>verb</i><br><ol><li>to tie</li></ol>
kunya|gũkunya	<i>verb</i><br><ol><li>to pinch</li></ol>
kuuma	<i>prep</i><br><ol><li>from</li></ol>
kĩande|ciande	<i>noun</i><br><ol><li>shoulder</li></ol>
kĩara|kaara|tũara|ciara	<i>noun</i><br><ol><li>dunghill, midden, compost pit</li><li>finger</li></ol>
kĩara kĩmwe gĩtiũragaga ndaa	<i>proverb</i><br><ol><li>see kaara kamwe gatiũragaga ndaa</li></ol>
kĩbaũ|ibaũ|kĩbaaũ|ibaaũ	<i>noun</i><br><ol><li>board</li><li>(Northern) serval cat (Leptailurus serval)</li><li>cheetah (Acinonyx jubatus)</li></ol>
kĩbiriti|ibiriti	<i>noun</i><br><ol><li>matchbox</li></ol>
kĩboko|iboko	<i>noun</i><br><ol><li>sjambok (a leather whip, especially made of hippopotamus' or rhinoceros' hide)</li></ol>
kĩegetha|ciegetha	<i>noun</i><br><ol><li>hiccup</li></ol>
kĩeha|cieha	<i>noun</i><br><ol><li>grief, sorrow, sadness, anxiety</li><li>Englerina woodfordioides); parasitic plant found on trees, like mistletoe</li></ol>
kĩero|ciero	<i>noun</i><br><ol><li>thigh</li></ol>
kĩganda|iganda	<i>noun</i><br><ol><li>factory, workshop</li><li>blacksmith's or wiredrawer's shed or working hut; forge</li><li>temporary hut for initiates</li></ol>
kĩgera|igera	<i>noun</i><br><ol><li>iron</li><li>metal</li></ol>
kĩgokora|igokora	<i>noun</i><br><ol><li>elbow</li></ol>
kĩgomano|igomano	<i>noun</i><br><ol><li>meeting</li><li>gathering place, meeting place</li><li>junction of two rivers; confluence, conflux</li></ol>
kĩgunyarĩrĩ|igunyarĩrĩ	<i>noun</i><br><ol><li>a hairy caterpillar</li></ol>
kĩgunyũ|igunyũ	<i>noun</i><br><ol><li>caterpillar</li><li>maggot</li></ol>
kĩgwa|igwa	<i>noun</i><br><ol><li>sugar cane; Kikuyu people use its juice for making alcoholic drink (njohi)</li></ol>
kĩhaaro|ihaaro	<i>noun</i><br><ol><li>field or public place, public square</li><li>court, which also implies a public place</li></ol>
kĩhaato|ihaato	<i>noun</i><br><ol><li>broom</li></ol>
kĩhara|ihara	<i>noun</i><br><ol><li>bald patch, baldness, bald pate</li></ol>
kĩharũrũka|iharũrũka	<i>noun</i><br><ol><li>steep slope, drop, cliff, precipice</li></ol>
kĩhembe|ihembe	<i>noun</i><br><ol><li>cylindrical barrel for storing honey</li><li>drum</li></ol>
kĩhingo|ihingo	<i>noun</i><br><ol><li>gate</li></ol>
kĩhuti|mahuti|ihuti	<i>noun</i><br><ol><li>cold (disease)</li></ol>
kĩhĩĩ|ihĩĩ	<i>noun</i><br><ol><li>big uncircumcised boy</li></ol>
kĩihũ|ciihũ	<i>noun</i><br><ol><li>mongoose, especially white-tailed mongoose (Ichneumia albicauda)</li></ol>
kĩimba|ciimba	<i>noun</i><br><ol><li>corpse, dead body</li></ol>
kĩiniĩ gĩtaita	<i>phrase</i><br><ol><li>A riddle whose solution is mũkamo wa ng'ombe “cow's udder”; another solution is kĩnya.</li><li>A fool who does not make use of an obvious opportunity.</li></ol>
kĩino|ciino	<i>noun</i><br><ol><li>female reproductive organs</li></ol>
kĩmamo|imamo	<i>noun</i><br><ol><li>place where animal or person sleeps; lair</li></ol>
kĩmera|imera	<i>noun</i><br><ol><li>season (for agriculture)</li><li>(agriculture) crops</li></ol>
kĩmone|imone	<i>noun</i><br><ol><li>eyelid</li></ol>
kĩmũrĩ|imũrĩ	<i>noun</i><br><ol><li>torch</li></ol>
kĩndũ|indo	<i>noun</i><br><ol><li>thing</li><li>(in the plural) property</li><li>(in the plural) livestock</li></ol>
kĩnena|inena	<i>noun</i><br><ol><li>mons pubis</li></ol>
kĩng'ang'i|ing'ang'i	<i>noun</i><br><ol><li>crocodile</li></ol>
kĩnundu|inundu	<i>noun</i><br><ol><li>fog, mist</li></ol>
kĩohe|ciohe	<i>noun</i><br><ol><li>parcel, package, bundle, bunch</li></ol>
kĩoho|cioho	<i>noun</i><br><ol><li>prison</li><li>imprisonment</li></ol>
kĩonereria|cionereria	<i>noun</i><br><ol><li>example, pattern</li></ol>
kĩongo|ciongo	<i>noun</i><br><ol><li>skull</li><li>head</li></ol>
kĩonje|cionje	<i>noun</i><br><ol><li>(derogatory) disabled person, cripple</li></ol>
kĩoro|cioro	<i>noun</i><br><ol><li>toilet, lavatory</li></ol>
kĩraka|iraka	<i>noun</i><br><ol><li>patch put on other cloth</li></ol>
kĩratũ|iratũ	<i>noun</i><br><ol><li>shoe</li></ol>
kĩrema|irema	<i>noun</i><br><ol><li>scar</li></ol>
kĩreru|ireru	<i>noun</i><br><ol><li>chin</li></ol>
kĩrimũ|marimũ|irimũ	<i>noun</i><br><ol><li>fool, idiot, stupid</li></ol>
kĩroboto|iroboto	<i>noun</i><br><ol><li>(big) flea</li></ol>
kĩroko	<i>noun</i><br><ol><li>morning</li></ol>
kĩromo|iromo	<i>noun</i><br><ol><li>lip</li></ol>
kĩronda|ironda	<i>noun</i><br><ol><li>sore, ulcer; especially veld(t) sore, Barcoo rot, (diphtheric) desert sore, septic sore</li></ol>
kĩroruha|iroruha	<i>noun</i><br><ol><li>callosity, callus</li><li>corn (on the skin)</li></ol>
kĩroto|iroto	<i>noun</i><br><ol><li>dream</li></ol>
kĩrumi|irumi	<i>noun</i><br><ol><li>curse</li></ol>
kĩrung'u|irung'u|karung'u	<i>noun</i><br><ol><li>section of log or pole</li><li>chunk, hunk, joint (of meat)</li></ol>
kĩrĩgũ|irĩgũ	<i>noun</i><br><ol><li>big uncircumcised girl</li></ol>
kĩrĩkanĩro|irĩkanĩro|irĩĩkanĩro|kĩrĩĩkanĩro	<i>noun</i><br><ol><li>agreement, compact</li><li>covenant</li></ol>
kĩrĩma|irĩma	<i>noun</i><br><ol><li>hill, mountain</li></ol>
kĩrĩndĩ|irĩndĩ	<i>noun</i><br><ol><li>people, populace</li></ol>
kĩrĩro|irĩro	<i>noun</i><br><ol><li>weeping</li><li>mourning</li></ol>
kĩrũngũrĩra|irũngũrĩra	<i>noun</i><br><ol><li>heartburn</li></ol>
kĩrũũmi|irũũmi	<i>noun</i><br><ol><li>serval (cat) (Leptailurus serval)</li><li>cheetah (Acinonyx jubatus)</li></ol>
kĩĩgamba|ciĩgamba	<i>noun</i><br><ol><li>a huge peapod-shaped cast iron containing iron balls, or an empty container filled with pieces of a bottle, used as a musical instrument for making rhythms of dances; tied to legs and shaking them would produce sounds like baca, baca, baca, baca...</li></ol>
kĩĩhindiĩ|ciĩhindiĩ	<i>noun</i><br><ol><li>swimming underwater, diving</li></ol>
kĩĩhuruta|ciĩhuruta	<i>noun</i><br><ol><li>butterfly</li><li>moth</li></ol>
kĩĩmbu|ciĩmbu	<i>noun</i><br><ol><li>chameleon</li></ol>
kĩĩruru|ciĩruru	<i>noun</i><br><ol><li>shadow; traditionally regarded as a place where one's own spirit sits during his or her life</li><li>shade</li></ol>
kĩĩrũma|ciĩrũma	<i>noun</i><br><ol><li>aloe, especially Aloe lateritia</li></ol>
kĩũgũ|ciũgũ	<i>noun</i><br><ol><li>any being or animal with a congenital abnormality</li><li>(obsolete) albino</li></ol>
kĩũma|ciũma	<i>noun</i><br><ol><li>bead</li></ol>
kĩũra|ciũra	<i>noun</i><br><ol><li>frog</li></ol>
kũgũrũ|magũrũ	<i>noun</i><br><ol><li>leg</li></ol>
kũhũra maaĩ na ndĩrĩ	<i>proverb</i><br><ol><li>to flog a dead horse (lit. to pound water with a mortar)</li></ol>
kũngũ	<i>intj</i><br><ol><li>hail!</li></ol>
kũnja|gũkũnja	<i>verb</i><br><ol><li>to fold</li></ol>
kũya|gũkũya	<i>verb</i><br><ol><li>to lead the chorus in song</li><li>to sing solo</li></ol>
ma	<i>noun</i><br><ol><li>truth</li></ol><br><i>adv</i><br><ol><li>truly</li></ol><br><i>particle</i><br><ol><li>(for class 6) of</li></ol>
maatha|kũmaatha	<i>verb</i><br><ol><li>to search for</li></ol>
magathĩ	<i>noun</i><br><ol><li>scissors, shears</li></ol>
maguta	<i>noun</i><br><ol><li>oil, fat</li></ol>
mahira	<i>noun</i><br><ol><li>pus</li></ol>
mai	<i>noun</i><br><ol><li>shit, stool</li></ol>
marakara|maraakara	<i>noun</i><br><ol><li>anger</li></ol>
mata	<i>noun</i><br><ol><li>saliva</li></ol>
mathugumo	<i>noun</i><br><ol><li>pee, urine</li></ol>
mathĩnjĩro	<i>noun</i><br><ol><li>leaves on which an animal is slaughtered and cut up</li></ol>
maĩ|tũĩ|tũmaĩ|maaĩ	<i>noun</i><br><ol><li>water</li></ol>
mbaara	<i>noun</i><br><ol><li>battle,</li></ol>
mbaka	<i>noun</i><br><ol><li>cat</li></ol>
mbakĩ	<i>noun</i><br><ol><li>tobacco</li><li>snuff</li><li>tobacco-plant</li><li>dried leaves of tobacco-plant</li></ol>
mbarara	<i>noun</i><br><ol><li>wart</li></ol>
mbarathi	<i>noun</i><br><ol><li>horse</li></ol>
mbarĩ	<i>noun</i><br><ol><li>family group, sub-clan</li></ol>
mbarĩki	<i>noun</i><br><ol><li>castor bean</li><li>castor oil; Kikuyu people use it for treating minor wounds and protecting skin, etc.</li></ol>
mbeca	<i>noun</i><br><ol><li>money</li></ol>
mbegũ	<i>noun</i><br><ol><li>seed(s)</li></ol>
mbembe	<i>noun</i><br><ol><li>maize, corn (Zea mays)</li></ol>
mbere	<i>noun</i><br><ol><li>front</li></ol>
mbeũ	<i>noun</i><br><ol><li>seed(s)</li></ol>
mbica	<i>noun</i><br><ol><li>picture</li><li>photograph</li></ol>
mbiro	<i>noun</i><br><ol><li>soot, smut</li><li>lampblack</li></ol>
mboco	<i>noun</i><br><ol><li>dwarf bean (Phaseolus vulgaris)</li><li>(in general) bean(s)</li></ol>
mbogo	<i>noun</i><br><ol><li>buffalo</li></ol>
mbogoro	<i>noun</i><br><ol><li>a curved stick one of whose ends is crooked and the other forked, used for suspending a beehive</li><li>bandy-leggedness, bow-leggedness</li></ol>
mbugi	<i>noun</i><br><ol><li>bell (especially attached to goats or cattle)</li></ol>
mbuku	<i>noun</i><br><ol><li>book</li></ol>
mbura	<i>noun</i><br><ol><li>rain</li></ol>
mbuĩ	<i>noun</i><br><ol><li>grey hairs</li></ol>
mbwe	<i>noun</i><br><ol><li>jackal</li><li>fox</li></ol>
mbĩrĩra	<i>noun</i><br><ol><li>grave</li></ol>
mbũkũ|kabũkũ	<i>noun</i><br><ol><li>hare</li></ol>
mbũmbũĩ	<i>noun</i><br><ol><li>spider</li></ol>
mbũri	<i>noun</i><br><ol><li>goat</li></ol>
mbũtũ	<i>noun</i><br><ol><li>force, platoon, company, battalion</li></ol>
mbũũ	<i>noun</i><br><ol><li>(Northern) plantain</li></ol>
mena|kũmena	<i>verb</i><br><ol><li>to dislike, to despise</li></ol>
menya|kũmenya	<i>verb</i><br><ol><li>to know</li></ol>
meria|kũmeria	<i>verb</i><br><ol><li>to swallow</li></ol>
metha	<i>noun</i><br><ol><li>table</li></ol>
minji	<i>noun</i><br><ol><li>pea (Pisum sativum)</li></ol>
moni	<i>noun</i><br><ol><li>ear lobe</li></ol>
mori|moori	<i>noun</i><br><ol><li>young cow, heifer</li></ol>
muonjoria|onjoria	<i>noun</i><br><ol><li>trader, businessman</li></ol>
muoyo|mĩoyo	<i>noun</i><br><ol><li>life</li></ol>
muratina	<i>noun</i><br><ol><li>see mũratina</li></ol>
muuma|miuma	<i>noun</i><br><ol><li>oath taken with proper ritual before a tribunal of elders in daytime and in public</li></ol>
muunjuga|miunjuga	<i>noun</i><br><ol><li>(blue) butterfly bush (Rotheca myricoides, syn. Clerodendrum myricoides)</li><li>jammy mouth (Ruttya fruticosa)</li></ol>
muunjuga-iria|miunjuga-iria	<i>noun</i><br><ol><li>(blue) butterfly bush (Rotheca myricoides, syn. Clerodendrum myricoides); recently reported that decoction of a shoot or roots used for treating STDs, including syphilis and gonorrhea.</li><li>Pavetta elliottii</li><li>jammy mouth (Ruttya fruticosa)</li></ol>
muuto|miuto	<i>noun</i><br><ol><li>pillow</li></ol>
mwaka|mĩaka	<i>noun</i><br><ol><li>year</li></ol>
mwaki|mĩaki|aaki	<i>noun</i><br><ol><li>fire</li><li>builder</li></ol>
mwambato|mĩambato	<i>noun</i><br><ol><li>acclivity, rising slope, rise</li></ol>
mwana|ciana	<i>noun</i><br><ol><li>child</li></ol>
mwanake|aanake	<i>noun</i><br><ol><li>young male person who has gone through circumcision but is not yet married</li></ol>
mwanga|mĩanga	<i>noun</i><br><ol><li>cassava, manioc</li></ol>
mwarimũ|arimũ|aarimũ	<i>noun</i><br><ol><li>teacher</li></ol>
mwario|mĩario	<i>noun</i><br><ol><li>way of speaking, manner of speaking</li></ol>
mwarĩ|aarĩ	<i>noun</i><br><ol><li>daughter</li></ol>
mwarĩki|mĩarĩki	<i>noun</i><br><ol><li>castor oil plant (Ricinus communis)</li></ol>
mwathani|aathani	<i>noun</i><br><ol><li>(Christianity) Lord</li><li>master, ruler</li></ol>
mwathimũro|mĩathimũro	<i>noun</i><br><ol><li>sneeze</li></ol>
mwatĩ|mĩatĩ	<i>noun</i><br><ol><li>virgin ewe</li></ol>
mwatũ|mĩatũ	<i>noun</i><br><ol><li>beehive made of tree trunk split in two and hollowed out</li><li>cylindrical wooden barrel whose both ends have lids, used for storage in the home</li></ol>
mwatũka|mĩatũka	<i>noun</i><br><ol><li>crack</li></ol>
mwe|kamwe|tũmwe|kũmwe|ũmwe|mamwe|hamwe|rũmwe|amwe|imwe|kĩmwe|ĩmwe|rĩmwe	<i>adj</i><br><ol><li>one</li><li>(with plural) some</li></ol>
mwegetho|mĩegetho	<i>noun</i><br><ol><li>hiccuping</li></ol>
mwena|mĩena	<i>noun</i><br><ol><li>side, surface</li><li>direction</li></ol>
mwendwa|eendwa	<i>noun</i><br><ol><li>lover</li></ol>
mwene|eene	<i>noun</i><br><ol><li>owner</li></ol>
mwera|mĩera	<i>noun</i><br><ol><li>hen</li></ol>
mwere|mĩere	<i>noun</i><br><ol><li>pearl millet, bulrush millet (Pennisetum glaucum)</li><li>finger millet (Eleusine coracana)</li><li>field of bulrush millet or finger millet</li></ol>
mweri|mĩeri	<i>noun</i><br><ol><li>moon</li><li>month</li><li>menstruation</li></ol>
mwĩnũ|mĩĩnũ	<i>noun</i><br><ol><li>peanut butter cassia, candelabra tree (Senna didymobotrya); traditionally used as a purgative, etc.</li></ol>
mwĩrĩ|mĩĩrĩ	<i>noun</i><br><ol><li>body</li></ol>
mwĩthũa|mĩĩthũa	<i>noun</i><br><ol><li>itching, itch</li></ol>
mĩhang'o	<i>noun</i><br><ol><li>odd timewasting jobs, busy activity of any kind</li></ol>
mũbangi|mĩbangi	<i>noun</i><br><ol><li>Mexican marigold, tall khaki weed (Tagetes minuta)</li></ol>
mũbango|mĩbango	<i>noun</i><br><ol><li>plan</li></ol>
mũbariti|mĩbariti	<i>noun</i><br><ol><li>silky oak, southern silky oak (Grevillea robusta)</li></ol>
mũbarĩki|mĩbarĩki	<i>noun</i><br><ol><li>castor oil plant (Ricinus communis)</li></ol>
mũbaũ|mĩbaũ	<i>noun</i><br><ol><li>blue gum (Eucalyptus globulus)</li></ol>
mũbeebe|mĩbeebe	<i>noun</i><br><ol><li>maize stalk without leaves</li></ol>
mũbira|mĩbira	<i>noun</i><br><ol><li>ball</li><li>rubber</li><li>bicycle</li></ol>
mũbirũbirũ|mĩbirũbirũ	<i>noun</i><br><ol><li>Rytigynia uhligii (syn. R. schumannii）</li><li>Canthium oligocarpum subsp. friesiorum (syn. Rytigynia friesiorum)</li></ol>
mũbĩngũ|mĩbĩngũ	<i>noun</i><br><ol><li>African blackwood (Dalbergia melanoxylon)</li></ol>
mũcakwe|mĩcakwe	<i>noun</i><br><ol><li>corncob, cob</li></ol>
mũcarage|mĩcarage	<i>noun</i><br><ol><li>East African olive, Elgon olive (Olea capensis subsp. macrocarpa, syn. O. hochstetteri); its timber is traded internationally.</li><li>Elgon olive (Olea welwitschii, syn. Linociera welwitschii)</li><li>Cape chestnut (Calodendrum capense)</li></ol>
mũceera na mũkũndũ akũndũkaga taguo	<i>proverb</i><br><ol><li>he who keeps company with the wolf, will learn to howl like a wolf (lit. one who walks with a scoundrel turns bad like him)</li></ol>
mũceere|mĩceere|mũcere|mĩcere	<i>noun</i><br><ol><li>rice</li></ol>
mũcege|mĩcege	<i>noun</i><br><ol><li>blackjack, hairy beggarticks, cobbler's pegs (Bidens pilosa)</li></ol>
mũcemanio|mĩcemanio	<i>noun</i><br><ol><li>meeting, assembly</li></ol>
mũcemeki|mĩcemeki	<i>noun</i><br><ol><li>Afrocrania volkensii (syn. Cornus volkensii), a timber-tree of the family Cornaceae.</li></ol>
mũciari|aciari	<i>noun</i><br><ol><li>parent</li></ol>
mũciarithia|aciarithia	<i>noun</i><br><ol><li>midwife</li></ol>
mũcibi|mĩcibi	<i>noun</i><br><ol><li>belt</li></ol>
mũciciũ|mĩciciũ	<i>noun</i><br><ol><li>Premna maxima, a tree species of the family Lamiaceae (formerly Verbenaceae); endemic to Kenya, producing timber, but in the IUCN Red List evaluated as 'Endangered' due to probable habitat loss caused by local development.</li></ol>
mũcinga|mĩcinga	<i>noun</i><br><ol><li>gun</li></ol>
mũcingũ|mĩcingo|mĩcingũ|mũcingo	<i>noun</i><br><ol><li>A savoury smell,</li></ol>
mũciĩ|mĩciĩ	<i>noun</i><br><ol><li>homestead</li><li>household, home</li><li>village</li></ol>
mũcumarĩ|mũcumaarĩ|mĩcumarĩ|mĩcumaarĩ	<i>noun</i><br><ol><li>nail (used for building something)</li></ol>
mũcura|mĩcura	<i>noun</i><br><ol><li>singed food found on the bottom of a pot</li></ol>
mũcuthĩ|mĩcuthĩ	<i>noun</i><br><ol><li>fairly long tail of any animal</li><li>(Kabete) penis</li></ol>
mũcũgi|mĩcũgi	<i>noun</i><br><ol><li>white pear (Apodytes dimidiata); produces hard timber.</li></ol>
mũcũrĩ|mĩcũrĩ	<i>noun</i><br><ol><li>neck of a calabash cut in a half, used as a handle</li></ol>
mũcũthi|mĩcũthi	<i>noun</i><br><ol><li>gravy, broth</li><li>Agelaea pentagyna (syn. A. heterophylla); according to Leakey (1977), it was used for making tonic soup.</li></ol>
mũembe|mĩembe	<i>noun</i><br><ol><li>mango-tree (Mangifera indica)</li></ol>
mũgaa|mĩgaa	<i>noun</i><br><ol><li>red acacia (Vachellia seyal, syn. Acacia stenocarpa, A. seyal)</li><li>(in the singular) rainless hot period at end of one growing season and before the long or short rains begin</li></ol>
mũgagaca|mĩgagaca	<i>noun</i><br><ol><li>small red scavenger ant</li></ol>
mũgaita|mĩgaita	<i>noun</i><br><ol><li>Cape myrtle (Myrsine africana)</li><li>Myrsine rhododendroides, syn. Rapanea rhododendroides</li></ol>
mũgambo|mĩgambo	<i>noun</i><br><ol><li>voice</li></ol>
mũgate|mĩgate	<i>noun</i><br><ol><li>bread</li></ol>
mũgathĩ|mĩgathĩ	<i>noun</i><br><ol><li>necklace</li></ol>
mũgeka|mĩgeka	<i>noun</i><br><ol><li>mat, rug</li></ol>
mũgendi|agendi	<i>noun</i><br><ol><li>traveller</li></ol>
mũgeni|ageni	<i>noun</i><br><ol><li>stranger</li><li>guest</li></ol>
mũgiro|mĩgiro	<i>noun</i><br><ol><li>taboo</li></ol>
mũgogo|mĩgogo	<i>noun</i><br><ol><li>stout log</li><li>fallen or felled trunk</li><li>log bridge, trunk bridge</li></ol>
mũgoma|mĩgoma	<i>noun</i><br><ol><li>female (of animal, but except for sheep)</li></ol>
mũgongo|mĩgongo	<i>noun</i><br><ol><li>(one's) back</li></ol>
mũgoro|mĩgoro	<i>noun</i><br><ol><li>tree-fuchsia (Halleria lucida)</li></ol>
mũgumo|mĩgumo	<i>noun</i><br><ol><li>wild fig,</li><li>bark cloth fig (Ficus natalensis)</li></ol>
mũguongo|mĩguongo	<i>noun</i><br><ol><li>elephant's tusk, ivory</li></ol>
mũguĩ|mĩguĩ	<i>noun</i><br><ol><li>arrow</li></ol>
mũguĩmi|aguĩmi	<i>noun</i><br><ol><li>hunter</li></ol>
mũgwanja	<i>num</i><br><ol><li>seven</li></ol>
mũgĩmbĩ|mĩgĩmbĩ	<i>noun</i><br><ol><li>finger millet (Eleusine coracana)</li></ol>
mũgũnda|mĩgũnda	<i>noun</i><br><ol><li>cultivated field, garden</li></ol>
mũgũrũki|agũrũki	<i>noun</i><br><ol><li>madman, lunatic, maniac</li></ol>
mũhaara|mĩhaara	<i>noun</i><br><ol><li>column (of ants, etc.)</li><li>trail of column of ants; used by them in their usual activity</li></ol>
mũhaka|mĩhaka	<i>noun</i><br><ol><li>border, boundary</li></ol>
mũhari|mĩhari	<i>noun</i><br><ol><li>line</li></ol>
mũheenania|aheenania	<i>noun</i><br><ol><li>liar</li></ol>
mũhehe|mĩhehe	<i>noun</i><br><ol><li>giant lobelia (Lobelia giberroa); its stem was used as a substitute for blowing horn</li></ol>
mũhethu|mĩhethu	<i>noun</i><br><ol><li>charcoal tree, gunpowder tree (Trema orientalis,)</li></ol>
mũhikania|ahikania	<i>noun</i><br><ol><li>groom, bridegroom</li></ol>
mũhiki|ahiki	<i>noun</i><br><ol><li>bride</li><li>girlfriend, fiancée</li></ol>
mũhoko|mĩhoko	<i>noun</i><br><ol><li>endod, African soapberry (Phytolacca dodecandra; though very poisonous, parts of this plant were traditionally used for treating cattle sickness and as aperient for human being.</li><li>soap berry (Deinbollia kilimandscharica)</li></ol>
mũhu|mĩhu	<i>noun</i><br><ol><li>ash(es) (of wood)</li></ol>
mũhĩa|mĩhĩa	<i>noun</i><br><ol><li>sorghum, Kaffir corn, dhurra (Sorghum bicolor)</li></ol>
mũhĩnga|mĩhĩnga	<i>noun</i><br><ol><li>obstacle, stumbling block</li></ol>
mũhĩrĩgo|mĩhĩrĩgo	<i>noun</i><br><ol><li>plank used as circular external wall of a hut or internal dividing wall</li></ol>
mũhũgũ|mĩhũgũ	<i>noun</i><br><ol><li>muhugu, muhuhu (Brachylaena huillensis, syn. B. hutchinsii); Kikuyu people have used this species for firewood, poles, partitioning walls (mĩhĩrĩgo), etc.</li></ol>
mũhũmũ|mũhũũmũ|mĩhũũmũ|mĩhũmũ	<i>noun</i><br><ol><li>(chiefly in plural) respiration</li><li>(chiefly in plural) deep-breathing</li><li>(chiefly in plural) panting</li></ol>
mũhũri|mĩhũri	<i>noun</i><br><ol><li>Oncoba routledgei</li><li>fried egg tree, snuff-box tree (Oncoba spinosa)</li></ol>
mũici|aici	<i>noun</i><br><ol><li>thief</li></ol>
mũigaigua|mĩigaigua	<i>noun</i><br><ol><li>Oncoba routledgei</li><li>snuff-box tree, fried egg tree (Oncoba spinosa)</li></ol>
mũigua|mĩigua	<i>noun</i><br><ol><li>thorn</li></ol>
mũikari|aikari	<i>noun</i><br><ol><li>(human) resident</li></ol>
mũiko|mĩiko	<i>noun</i><br><ol><li>broad-ended</li></ol>
mũikũrũko|mĩikũrũko	<i>noun</i><br><ol><li>declivity, downward slope</li></ol>
mũiri|mĩiri	<i>noun</i><br><ol><li>red stinkwood, African cherry, African plum, African prune (Prunus africana, syn. Pygeum africanum</li></ol>
mũiru|airu	<i>noun</i><br><ol><li>co-wife</li></ol>
mũirĩtu|mũirĩĩtu|airĩtu|airĩĩtu	<i>noun</i><br><ol><li>big circumcised girl; maiden</li></ol>
mũita-thũa|mĩita-thũa	<i>noun</i><br><ol><li>orange-milk tree (Harungana madagascariensis); contains red sap and wood used for building material.</li></ol>
mũitĩrĩro|mĩitĩrĩro	<i>noun</i><br><ol><li>rafter</li><li>giraffe</li></ol>
mũka|aka	<i>noun</i><br><ol><li>wife</li></ol>
mũkamo|mĩkamo	<i>noun</i><br><ol><li>udder</li></ol>
mũkanda|mĩkanda	<i>noun</i><br><ol><li>rope</li></ol>
mũkangarithi|mĩkangarithi	<i>noun</i><br><ol><li>milkweed, swan plant, wild cotton (Gomphocarpus physocarpus, syn. Asclepias physocarpa and G. fruticosus)</li></ol>
mũkarakaba|mĩkarakaba	<i>noun</i><br><ol><li>cypress, especially Monterey cypress (Cupressus macrocarpa)</li></ol>
mũkarara|mĩkarara	<i>noun</i><br><ol><li>Margaritaria discoidea (syn. Phyllanthus discoideus), a deciduous tree of the family Phyllanthaceae (formerly Euphorbiaceae); traditionally used for making planks (mĩhĩrĩgo).</li></ol>
mũkaro|mĩkaro	<i>noun</i><br><ol><li>ditch, furrow, trench</li></ol>
mũkebe|mĩkebe	<i>noun</i><br><ol><li>tin, can</li></ol>
mũkengeria|mĩkengeria	<i>noun</i><br><ol><li>any species of the genus Commelina, especially wandering Jew (C. benghalensis)</li></ol>
mũkenia|mĩkenia	<i>noun</i><br><ol><li>Lantana trifolia</li></ol>
mũkiha|mĩkiha	<i>noun</i><br><ol><li>vein</li></ol>
mũkinyai|mĩkinyai	<i>noun</i><br><ol><li>magic guarri (Euclea divinorum)</li></ol>
mũkoigo|mĩkoigo	<i>noun</i><br><ol><li>coast goldleaf, coastal goldenleaf, sweetberry (Bridelia micrantha); traditionally used for building material</li></ol>
mũkoigwa|mĩkoigwa	<i>noun</i><br><ol><li>tassel-berry (Antidesma venosum)</li></ol>
mũkomakoma|mĩkomakoma	<i>noun</i><br><ol><li>Psychotria fractinervata (syn. Grumilea exserta)</li><li>Galiniera saxifraga (syn. G. coffeoides) (Rubiaceae)</li></ol>
mũkombi|mĩkombi	<i>noun</i><br><ol><li>foxtail millet</li></ol>
mũkongoro|mĩkongoro	<i>noun</i><br><ol><li>Kilimanjaro mahogany, brown mahogany (Lovoa swynnertonii); produces timber of good quality</li><li>mortar for making sugar-cane beer; according to Leakey (1977), it was made of red stinkwood (mũiri).</li></ol>
mũkonyo|mĩkonyo	<i>noun</i><br><ol><li>navel</li></ol>
mũkoro|mĩkoro	<i>noun</i><br><ol><li>(banana-)stem</li></ol>
mũkorobia|mĩkorobia	<i>noun</i><br><ol><li>avocado (Persea americana)</li></ol>
mũkorombothi|mĩkorombothi	<i>noun</i><br><ol><li>Afrocrania volkensii, a timber-tree of the family Cornaceae</li></ol>
mũkuha|mĩkuha	<i>noun</i><br><ol><li>awl, especially for sewing leather, skin garments, etc.</li></ol>
mũkururo|mĩkururo|kamũkururo	<i>noun</i><br><ol><li>line</li><li>scratch, score</li></ol>
mũkĩndũ|mĩkĩndũ	<i>noun</i><br><ol><li>Senegal date palm, wild date palm (Phoenix reclinata)</li></ol>
mũkĩra|mĩkĩra	<i>noun</i><br><ol><li>side</li></ol>
mũkũndũ|mĩkũndũ	<i>noun</i><br><ol><li>Mitragyna rubrostipulata (syn. Fleroya rubrostipulata); yields timber.</li><li>Meyna tetraphylla</li><li>evil person, corrupted person; scum</li></ol>
mũkũnga|mĩkũnga	<i>noun</i><br><ol><li>eel</li></ol>
mũkũnga-mbura|mĩkũnga-mbura	<i>noun</i><br><ol><li>rainbow</li></ol>
mũkũngũgũ|mĩkũngũgũ	<i>noun</i><br><ol><li>Commiphora eminii subsp. zimmermannii), tree of the family Burseraceae; traditionally used by Kikuyu people for hedging, supporter of yam vine, and so on.</li></ol>
mũkũyũ|mĩkũyũ	<i>noun</i><br><ol><li>sycamore (F. sycomorus)</li><li>Cape fig (F. sur)</li></ol>
mũmero|mĩmero	<i>noun</i><br><ol><li>throat</li></ol>
mũmondo|mĩmondo	<i>noun</i><br><ol><li>African redwood (Hagenia abyssinica, syn. Brayera anthelmintica)</li></ol>
mũna|mĩna	<i>noun</i><br><ol><li>muna (Pouteria adolfi-friedericii, syn. Aningeria adolfi-friedericii); yields timber.</li></ol>
mũndũ|andũ	<i>noun</i><br><ol><li>human being, man</li><li>person</li></ol>
mũndũ mũgo|andũ ago	<i>noun</i><br><ol><li>a person who performs healing and divination practices; medicine man</li></ol>
mũno	<i>adv</i><br><ol><li>very, much</li></ol>
mũnungo|mĩnungo	<i>noun</i><br><ol><li>smell, especially bad one; odor</li></ol>
mũnyago|mĩnyago	<i>noun</i><br><ol><li>long and quite heavy digging pole with the digging end pointed, used for first breaking up of land</li></ol>
mũnyaka|mĩnyaka	<i>noun</i><br><ol><li>luck</li><li>copper</li></ol>
mũnyiginyigi|mĩnyiginyigi	<i>noun</i><br><ol><li>backbone, spine</li></ol>
mũnyongoro|mĩnyongoro	<i>noun</i><br><ol><li>centipede</li><li>millipede</li><li>earthworm</li></ol>
mũnyĩrĩ|mĩnyĩrĩ	<i>noun</i><br><ol><li>pin-tailed whydah (Vidua macroura)</li><li>paradise flycatcher (Terpsiphone spp.); in Kenya, where Kikuyu people live, at least two species are found: red-bellied paradise flycatcher (T. rufiventer) and African paradise flycatcher (T. viridis).</li></ol>
mũnyũrũrũko|mĩnyũrũrũko	<i>noun</i><br><ol><li>thin river, trickle, rivulet</li></ol>
mũragũri|aragũri	<i>noun</i><br><ol><li>diviner, soothsayer, fortune-teller</li></ol>
mũrangi|mĩrangi	<i>noun</i><br><ol><li>species of bamboo (Oldeania alpina, syns. Yushania alpina, Arundinaria alpina)</li></ol>
mũrango|mĩrango	<i>noun</i><br><ol><li>door</li></ol>
mũraraciĩ|mĩraraciĩ	<i>noun</i><br><ol><li>Cape chestnut (Calodendrum capense)</li></ol>
mũraru|mĩraru	<i>noun</i><br><ol><li>one of the banana cultivars</li></ol>
mũrarĩ|mĩrarĩ	<i>noun</i><br><ol><li>thatch blackened with soot or tar</li></ol>
mũrarũ|mĩrarũ	<i>noun</i><br><ol><li>a sort of harmless snake</li></ol>
mũrata|araata|mũraata|arata	<i>noun</i><br><ol><li>friend</li><li>girlfriend</li></ol>
mũratho|mĩratho	<i>noun</i><br><ol><li>first rafters to be set in position</li><li>(Northern) a bent stick over tops of posts supporting a roof on which rafters are placed</li><li>one of the traditional season, part of the months from September to December</li></ol>
mũratina|mĩratina	<i>noun</i><br><ol><li>sausage tree; its ripe fruits are used for fermenting sugar-cane beverage and in Nyeri County, decoction of the leaves, barks and fruits is allegedly used for treating gonorrhoea, syphilis, measles, etc.</li><li>a type of alcoholic beverage, especially made from sugar-cane fermented with a thoroughly dried sausage tree fruit</li></ol>
mũrera|mĩrera	<i>noun</i><br><ol><li>fever tree, Naivasha thorn (Acacia xanthophloea)</li></ol>
mũrera-kĩĩmbu|mĩrera-kĩĩmbu	<i>noun</i><br><ol><li>Canthium oligocarpum subsp. friesiorum (syn. Rytigynia friesiorum), shrub or tree species of the family Rubiaceae</li></ol>
mũri|mĩri	<i>noun</i><br><ol><li>root</li></ol>
mũrigo|mĩrigo	<i>noun</i><br><ol><li>load</li></ol>
mũrimũ|mĩrimũ	<i>noun</i><br><ol><li>disease, illness, sickness; traditionally referring to ones that were thought to be caused by supernatural beings.</li></ol>
mũringa|mĩringa	<i>noun</i><br><ol><li>large-leafed cordia (Cordia africana, syn. C. abyssinica, C. holstii); traditionally used for making hives and stools</li></ol>
mũringathinga|mĩringathinga	<i>noun</i><br><ol><li>Mussaenda microdonta subsp. odorata (syn. M. odorata); tree or shrub of the family Rubiaceae</li></ol>
mũriyũ|mĩriyũ	<i>noun</i><br><ol><li>three-horned chameleon</li></ol>
mũrogi|arogi	<i>noun</i><br><ol><li>one who harms others by practising witchcraft or black magic; wizard, sorcerer</li></ol>
mũromo|mĩromo	<i>noun</i><br><ol><li>doorway, entrance</li><li>lip</li></ol>
mũrongo|mĩrongo	<i>num</i><br><ol><li>ten</li></ol>
mũruma-andũ|mĩruma-andũ	<i>noun</i><br><ol><li>Bersama abyssinica, a shrub or tree of the family Francoaceae (formerly Melianthaceae)</li></ol>
mũrutani|arutani	<i>noun</i><br><ol><li>teacher</li></ol>
mũrĩithi|arĩithi	<i>noun</i><br><ol><li>shepherd</li></ol>
mũrĩmi|arĩmi	<i>noun</i><br><ol><li>farmer, cultivator</li></ol>
mũrĩmo|mĩrĩmo	<i>noun</i><br><ol><li>side of a river or a valley</li></ol>
mũrũaru|mũrũarũ|arũarũ|mĩrũaru	<i>noun</i><br><ol><li>sick person, patient</li><li>crowned crane, golden crested crane, Kavirondo crane (Balearica sp.)</li></ol>
mũrũgũ|mĩrũgũ	<i>noun</i><br><ol><li>species of long-tailed widowbird, including Jackson's widowbird (Euplectes jacksoni)</li></ol>
mũrũngũru|mĩrũngũru	<i>noun</i><br><ol><li>slender mongoose (Herpestes sanguineus, syn. Galerella sanguinea)</li><li>weasel</li><li>serval (cat) (Leptailurus serval)</li></ol>
mũrũrũ|mĩrũrũ	<i>noun</i><br><ol><li>ramontchi, governor's plum, Indian plum (Flacourtia indica); fruit edible.</li><li>forest pepper, Lopez root, wild orange tree (Toddalia asiatica)</li></ol>
mũrũrũa|mĩrũrũa	<i>noun</i><br><ol><li>Cape chestnut (Calodendrum capense)</li></ol>
mũrũrũe|mĩrũrũe	<i>noun</i><br><ol><li>forest pepper, Lopez root, wild orange tree (Toddalia asiatica); formerly its leaves and roots were used for treating feverish colds, and recently leaf decoction for colds, asthma, chest pain and toothache</li></ol>
mũrũthi|mĩrũthi	<i>noun</i><br><ol><li>lion</li></ol>
mũtamaiyũ|mĩtamaiyũ	<i>noun</i><br><ol><li>wild olive, brown olive O. europaea subsp. africana, O. chrysophylla)</li></ol>
mũtarakwa|mĩtarakwa	<i>noun</i><br><ol><li>African pencil cedar, East African cedar (Juniperus procera)</li><li>Mexican white cedar, Mexican cedar (Hesperocyparis lusitanica, syn. Cupressus lusitanica)</li></ol>
mũtaratara|mĩtaratara	<i>noun</i><br><ol><li>order, plan, method of activity, procedure</li><li>row, line, column</li></ol>
mũtaro|mĩtaro	<i>noun</i><br><ol><li>canal</li><li>(both natural and artificial) watercourse</li></ol>
mũtatĩ|mĩtatĩ	<i>noun</i><br><ol><li>Polyscias kikuyuensis; produces soft timber, used traditionally for making beehive and mole-trap.</li><li>Polyscias fulva</li></ol>
mũtego|mĩtego	<i>noun</i><br><ol><li>snare, trap</li></ol>
mũtembei|mĩtembei	<i>noun</i><br><ol><li>black rat (Rattus rattus)</li><li>Norwegian rat (Rattus norvegicus)</li></ol>
mũtendera|mĩtendera	<i>noun</i><br><ol><li>forest peach (Rawsonia lucida (syn. R. usambarensis); produces timber.</li></ol>
mũthaatũ	<i>noun</i><br><ol><li>misty season, from July to early September</li></ol>
mũthaithi|mĩthaithi	<i>noun</i><br><ol><li>pillar wood (C. malosana)</li><li>C. rotundifolia</li></ol>
mũthaitĩ|mĩthaitĩ	<i>noun</i><br><ol><li>East African camphorwood (Kuloa usambarensis; syn. Ocotea usambarensis) or Ocotea kenyensis; wood of at least the former one was used for making partitioning walls (mĩhĩrĩgo), containers related to honey, etc.</li></ol>
mũthamaki|athamaki	<i>noun</i><br><ol><li>an individual with influence, who played the role of spokesman and primus inter pares in Kikuyu society before the colonial period, strictly controlled by his peers (Muriuki 1974:132)</li><li>ruler; king or queen</li></ol>
mũthandũkũ|mĩthandũkũ	<i>noun</i><br><ol><li>black wattle, especially Acacia decurrens</li><li>chicken pox</li></ol>
mũthanga|mĩthanga	<i>noun</i><br><ol><li>sand, grit</li></ol>
mũtharaba|mĩtharaba	<i>noun</i><br><ol><li>cross</li></ol>
mũthathumwa|mĩthathumwa	<i>noun</i><br><ol><li>Hypericum revolutum, a shrub or tree of the St. John's wort family (Hypericaceae)</li></ol>
mũthece|mĩthece|mĩtheece|mũtheece	<i>noun</i><br><ol><li>beak</li></ol>
mũthee|athee	<i>noun</i><br><ol><li>old man</li><li>honorific used for males older than a speaker and also for speaker's father especially in absent</li></ol>
mũthegethe|mĩthegethe	<i>noun</i><br><ol><li>canary-bird bush, birdflower, lion's claw, rattlebox (Crotalaria agatiflora)</li></ol>
mũthekere|mĩthekere	<i>noun</i><br><ol><li>manner of laughing</li></ol>
mũthemba|mĩthemba	<i>noun</i><br><ol><li>kind, sort</li></ol>
mũthia|mĩthia	<i>noun</i><br><ol><li>tip, point, end</li></ol>
mũthigari|athigari	<i>noun</i><br><ol><li>soldier</li></ol>
mũthigiti|mĩthigiti	<i>noun</i><br><ol><li>mosque</li></ol>
mũthita|mũthiita|mĩthita|mĩthiita|gĩthita	<i>noun</i><br><ol><li>(uncircumcised) penis</li></ol>
mũthitarĩ|mĩthitarĩ	<i>noun</i><br><ol><li>line</li></ol>
mũthithe|mĩthithe	<i>noun</i><br><ol><li>African sandalwood (Osyris lanceolata, syn. O. abyssinica)</li></ol>
mũthithikũ|mĩthithikũ	<i>noun</i><br><ol><li>African redwood (Hagenia abyssinica)</li></ol>
mũthiũrũrũko|mĩthiũrũrũko	<i>noun</i><br><ol><li>to turning (a)round and (a)round</li></ol>
mũthongorima|mĩthongorima	<i>noun</i><br><ol><li>hole or cavity under the ground made naturally or by ants</li></ol>
mũthuru|mĩthuru	<i>noun</i><br><ol><li>long leather skirt</li></ol>
mũthuuri|mũthuri|athuri|athuuri	<i>noun</i><br><ol><li>married male person with children,</li><li>male person, man</li><li>adult (man)</li><li>elder</li></ol>
mũthĩga|mĩthĩga	<i>noun</i><br><ol><li>East African greenheart (Warburgia ugandensis)</li></ol>
mũthũ|mĩthũ	<i>noun</i><br><ol><li>fruit-eating mousebird, especially speckled mousebird (Colius striatus)</li></ol>
mũthũa|mĩthũa	<i>noun</i><br><ol><li>termite, white ant</li></ol>
mũthũũri|mĩthũũri	<i>noun</i><br><ol><li>candelabra tree (Euphorbia ingens); its latex may cause temporary blindness if applied to the eyes.</li></ol>
mũting'oe|mĩting'oe	<i>noun</i><br><ol><li>tail</li></ol>
mũtino|mĩtino	<i>noun</i><br><ol><li>misfortune, bad luck, calamity</li></ol>
mũtitũ|mĩtitũ	<i>noun</i><br><ol><li>forest</li></ol>
mũtokaa|mĩtokaa	<i>noun</i><br><ol><li>motorcar, car, automobile</li></ol>
mũtomoko|mĩtomoko	<i>noun</i><br><ol><li>cherimoya tree (Annona cherimola)</li></ol>
mũtongoria|atongoria	<i>noun</i><br><ol><li>leader</li></ol>
mũtongu|mĩtongu	<i>noun</i><br><ol><li>apple of Sodom, Sodom's apple, bitter tomato (Solanum incanum and S. campylacanthum)</li></ol>
mũtore|mĩtore	<i>noun</i><br><ol><li>a certain kind of banana usually roasted or mashed before consumption</li></ol>
mũtumia|atumia	<i>noun</i><br><ol><li>woman</li><li>married woman; wife</li></ol>
mũtumia wa kĩero gĩtune|atumia a kĩero gĩtune	<i>noun</i><br><ol><li>(idiomatic) a woman whose husbands die one after another (lit. a wife of a red thigh).</li></ol>
mũturi|aturi	<i>noun</i><br><ol><li>smith, blacksmith</li></ol>
mũtuuya|mĩtuya|mĩtuuya|mũtuya	<i>noun</i><br><ol><li>giant yellow mulberry (Myrianthus holstii and Myrianthus arboreus)</li></ol>
mũtwe|mĩtwe	<i>noun</i><br><ol><li>head</li></ol>
mũtĩ|mĩtĩ	<i>noun</i><br><ol><li>tree</li><li>stick</li><li>arrow shaft</li><li>(plural only) herbal medicine</li></ol>
mũtĩ-mũirũ|mĩtĩ-mũirũ	<i>noun</i><br><ol><li>Galiniera saxifraga (syn. G. coffeoides); shrub or tree of the family Rubiaceae</li><li>Turraea holstii</li><li>Turraea abyssinica</li></ol>
mũtũma|mĩtũma	<i>noun</i><br><ol><li>rifle</li><li>shot-gun</li><li>Schrebera alata, tree of the family Oleaceae</li></ol>
mũtũng'ũ|mĩtũng'ũ	<i>noun</i><br><ol><li>small-pox</li></ol>
mũtũngũrũ|mĩtũngũrũ	<i>noun</i><br><ol><li>forest fever tree (Anthocleista grandiflora, syn. Anthocleista zambesiaca)</li><li>Mitragyna rubrostipulata (syn. Fleroya rubrostipulata), Rubiaceae; yields timber.</li><li>Meyna tetraphylla (Rubiaceae)</li></ol>
mũũnyũ|mĩũnyũ	<i>noun</i><br><ol><li>salty earth</li><li>(for cattle) salt lick</li></ol>
na	<i>particle</i><br><ol><li>(instrumental) with</li><li>(comitative) and, with</li><li>(source) from</li><li>but</li></ol>
namba	<i>noun</i><br><ol><li>number</li></ol>
namũ	<i>noun</i><br><ol><li>eland (Taurotragus oryx)</li></ol>
nathi	<i>noun</i><br><ol><li>cape gooseberry</li></ol>
nda	<i>noun</i><br><ol><li>belly, stomach</li></ol>
ndaa	<i>noun</i><br><ol><li>louse</li></ol>
ndabibi	<i>noun</i><br><ol><li>wood sorrel (Oxalis sp.)</li><li>clover (Trifolium sp.)</li></ol>
ndaci	<i>noun</i><br><ol><li>dance</li></ol>
ndagĩtarĩ|mandagĩtarĩ	<i>noun</i><br><ol><li>doctor</li></ol>
ndahi	<i>noun</i><br><ol><li>calabash used for drawing beer etc.</li></ol>
ndaka	<i>noun</i><br><ol><li>mud</li></ol>
ndangũrũ	<i>noun</i><br><ol><li>tapeworm</li></ol>
ndaraca	<i>noun</i><br><ol><li>bridge</li><li>social class</li><li>military rank</li></ol>
ndarama	<i>noun</i><br><ol><li>drum</li></ol>
ndare	<i>noun</i><br><ol><li>bramble (Rubus spp.); berry at least of R. keniensis, R. pinnatus, R. steudneri, and R. volkensii</li></ol>
ndarũa	<i>noun</i><br><ol><li>hide, skin, especially oxhide</li></ol>
ndawa	<i>noun</i><br><ol><li>drug</li></ol>
ndaĩ	<i>noun</i><br><ol><li>riddle</li></ol>
ndege	<i>noun</i><br><ol><li>aeroplane, airplane, plane</li></ol>
ndegwa|ndeegwa	<i>noun</i><br><ol><li>bull, ox</li></ol>
ndemwa	<i>noun</i><br><ol><li>tattoo</li><li>letter (of alphabet)</li></ol>
ndereba|matereba	<i>noun</i><br><ol><li>driver, chauffeur</li></ol>
ndereti	<i>noun</i><br><ol><li>conversation</li></ol>
nderi	<i>noun</i><br><ol><li>vulture</li></ol>
ndete|gatete	<i>noun</i><br><ol><li>species of warbler, especially grass warbler</li></ol>
ndeto	<i>noun</i><br><ol><li>affair, matter, event</li><li>word, utterance</li><li>news</li></ol>
ndia	<i>noun</i><br><ol><li>broad or deep pool in river</li></ol>
ndigiri	<i>noun</i><br><ol><li>donkey</li></ol>
ndigithũ	<i>noun</i><br><ol><li>large and thin necked pot or jar used for storing water, millet, oil</li></ol>
ndimũ	<i>noun</i><br><ol><li>lemon (fruit)</li><li>(key) lime (Citrus aurantiifolia)</li></ol>
ndina	<i>noun</i><br><ol><li>buttocks</li></ol>
nding'oing'o|gating'oing'o	<i>noun</i><br><ol><li>dung beetle</li><li>stupid person, fool, idiot</li></ol>
ndinoho	<i>noun</i><br><ol><li>snail</li></ol>
ndira	<i>noun</i><br><ol><li>heel</li></ol>
ndirica|matirica|ndirica 9 or 10 or	<i>noun</i><br><ol><li>window</li></ol>
ndoco	<i>noun</i><br><ol><li>fine</li></ol>
ndogo	<i>noun</i><br><ol><li>smoke</li><li>steam</li></ol>
ndome	<i>noun</i><br><ol><li>wooden armshield used by male youngsters; see more on Ndome (Schild).</li></ol>
ndongoro	<i>noun</i><br><ol><li>bongo (Tragelaphus eurycerus, syn. Boocercus eurycerus)</li><li>greater kudu (Tragelaphus strepsiceros)</li></ol>
ndoo|ndoo	<i>noun</i><br><ol><li>waterbuck (Kobus ellipsiprymnus)</li><li>bucket, pail</li></ol>
ndoro	<i>noun</i><br><ol><li>mud</li></ol>
ndotono	<i>noun</i><br><ol><li>A club made of a pulled out shrub or sapling (of mũnderendu (Vepris spp., syn. Teclea spp.) according to Leakey (1977))</li></ol>
nduka|matuka|nduka 9 or 10 or	<i>noun</i><br><ol><li>shop</li></ol>
nduma	<i>noun</i><br><ol><li>darkness</li></ol>
ndume	<i>noun</i><br><ol><li>bull</li></ol>
ndundu|ndundu	<i>noun</i><br><ol><li>secret talk, secret agreement</li><li>owl</li></ol>
ndungata	<i>noun</i><br><ol><li>servant</li></ol>
ndururumo	<i>noun</i><br><ol><li>waterfall</li></ol>
ndutu	<i>noun</i><br><ol><li>chigoe, chigoe flea, chigger, sand flea, jigger</li></ol>
ndutura	<i>noun</i><br><ol><li>dove</li></ol>
ndwari	<i>noun</i><br><ol><li>severe sickness;</li></ol>
ndĩrĩ	<i>noun</i><br><ol><li>wooden mortar for crushing sugar cane to make beer</li></ol>
ndũgũ	<i>noun</i><br><ol><li>friendship</li><li>(Northern) relationship by blood or marriage</li></ol>
ndũiga	<i>noun</i><br><ol><li>giraffe</li></ol>
ndũnyũ	<i>noun</i><br><ol><li>market</li></ol>
ndũrũme	<i>noun</i><br><ol><li>ram (male sheep)</li></ol>
ndũũma|ndũma	<i>noun</i><br><ol><li>(old) cocoyam, taro (Colocasia esculenta)</li></ol>
ng'aragu	<i>noun</i><br><ol><li>hunger, famine</li></ol>
ng'aragu ndĩhoyagwo ũhoro	<i>proverb</i><br><ol><li>you should feed a hungry person/people first, then ask him/her/them what he/she/they need(s).</li><li>you should feed a hungry person/people first before you try to obtain news from him/her/them.</li></ol>
ng'ombe	<i>noun</i><br><ol><li>cow or ox</li></ol>
ng'ondu	<i>noun</i><br><ol><li>sheep</li></ol>
ngaara	<i>noun</i><br><ol><li>mouse</li></ol>
ngage	<i>noun</i><br><ol><li>chigoe, chigger, jigger</li></ol>
ngaita	<i>noun</i><br><ol><li>fruit of some Primulaceae (Cape myrtle Myrsine africana or Rapanea rhododendroides); purple in color, turning to light brown when fully ripe, used as a general stomach medicine and as an anthelmintic</li></ol>
nganga	<i>noun</i><br><ol><li>guinea fowl</li></ol>
nganja	<i>noun</i><br><ol><li>doubt</li></ol>
ngari	<i>noun</i><br><ol><li>car</li></ol>
ngarĩ	<i>noun</i><br><ol><li>leopard</li></ol>
ngatata	<i>noun</i><br><ol><li>gnu, wildebeest</li></ol>
ngathĩti	<i>noun</i><br><ol><li>newspaper</li><li>magazine</li><li>official journal, official gazette</li></ol>
ngatia	<i>noun</i><br><ol><li>(Northern) lion</li></ol>
ngatia ciathiĩ hiti cĩeragara	<i>proverb</i><br><ol><li>when the cat's away, the mice will play (lit. when lions have gone, hyenas dance)</li></ol>
ngemi	<i>noun</i><br><ol><li>ululation made by women as an expression of joy</li></ol>
ngi	<i>noun</i><br><ol><li>fly (insect)</li></ol>
ngigĩ	<i>noun</i><br><ol><li>locust</li></ol>
ngingo	<i>noun</i><br><ol><li>neck</li></ol>
nginya	<i>prep</i><br><ol><li>up to, until</li></ol>
ngirathi	<i>noun</i><br><ol><li>glass (a vessel used for drinking)</li></ol>
ngiria	<i>noun</i><br><ol><li>silence</li><li>loud-chirruping cricket</li><li>cicada</li></ol>
ngitĩ	<i>noun</i><br><ol><li>dog</li></ol>
ngo	<i>noun</i><br><ol><li>shield</li></ol>
ngobo	<i>noun</i><br><ol><li>seed(s) of wild banana (Ensete ventricosum); formerly used for making special beads for ceremonial purposes.</li></ol>
ngoma	<i>noun</i><br><ol><li>spirit of the deceased</li><li>(Christianity) devil</li></ol>
ngoma cia aka	<i>noun</i><br><ol><li>whirlwind (lit. spirits of wives)</li></ol>
ngombo	<i>noun</i><br><ol><li>slave</li></ol>
ngono	<i>noun</i><br><ol><li>hands</li></ol>
ngoro	<i>noun</i><br><ol><li>heart</li><li>mind, heart</li><li>chest</li></ol>
ngoru	<i>noun</i><br><ol><li>buzzard</li></ol>
ngothi	<i>noun</i><br><ol><li>hide, leather</li><li>skin</li></ol>
ngucanio	<i>noun</i><br><ol><li>dispute, tussle, quarrel</li></ol>
ngui	<i>noun</i><br><ol><li>dog</li></ol>
ngumo	<i>noun</i><br><ol><li>fame, renown</li><li>reputation</li><li>praise</li></ol>
ngundi	<i>noun</i><br><ol><li>fist</li></ol>
ngunĩko|gĩkunĩko|gakunĩko	<i>noun</i><br><ol><li>lid, cover</li></ol>
nguru	<i>noun</i><br><ol><li>tortoise</li></ol>
ngurunyu	<i>noun</i><br><ol><li>suet</li></ol>
nguruu	<i>noun</i><br><ol><li>glue</li></ol>
nguuũ	<i>noun</i><br><ol><li>hippopotamus</li></ol>
nguya	<i>noun</i><br><ol><li>winged termite</li></ol>
nguyo	<i>noun</i><br><ol><li>colobus</li></ol>
ngwacĩ	<i>noun</i><br><ol><li>sweet potato (Ipomoea batatas)</li></ol>
ngware	<i>noun</i><br><ol><li>partridge</li></ol>
ngĩma	<i>noun</i><br><ol><li>blue monkey (Cercopithecus mitis)</li><li>Sykes' monkey (Cercopithecus albogularis)</li></ol>
ngĩrĩ	<i>noun</i><br><ol><li>warthog</li></ol>
ngũbia	<i>noun</i><br><ol><li>cap, hat</li><li>tilde (̃); a diacritical mark over vowel letter such as ĩ or ũ.</li></ol>
ngũgũ	<i>noun</i><br><ol><li>turaco, lourie,</li></ol>
ngũgũtũ	<i>noun</i><br><ol><li>a kind of cowrie shell about 1/2 inch long, used as a charm</li></ol>
ngũha	<i>noun</i><br><ol><li>tick that infests cattle</li></ol>
ngũkũ	<i>noun</i><br><ol><li>fowl</li><li>chicken</li></ol>
ngũkũma	<i>noun</i><br><ol><li>tick</li></ol>
ngũngũni	<i>noun</i><br><ol><li>bedbug</li></ol>
ngũrũe	<i>noun</i><br><ol><li>pig</li></ol>
niĩ	<i>pron</i><br><ol><li>I</li></ol>
njagathi	<i>noun</i><br><ol><li>lizard</li></ol>
njagĩ	<i>noun</i><br><ol><li>zebra</li></ol>
njahĩ	<i>noun</i><br><ol><li>seed(s) of hyacinth bean (Lablab purpureus, syn. Dolichos lablab)</li></ol>
njamba	<i>noun</i><br><ol><li>hero</li><li>male (of animal)</li></ol>
njara	<i>noun</i><br><ol><li>hand</li></ol>
njata	<i>noun</i><br><ol><li>star</li></ol>
njege	<i>noun</i><br><ol><li>porcupine</li></ol>
njegeeke	<i>noun</i><br><ol><li>armpit</li></ol>
njeneni|gaceneni	<i>noun</i><br><ol><li>firefly</li></ol>
njikarĩro	<i>noun</i><br><ol><li>seat (of a stool or a chair)</li><li>buttocks</li></ol>
njogoo	<i>noun</i><br><ol><li>cock (a male chicken)</li></ol>
njogu	<i>noun</i><br><ol><li>elephant</li></ol>
njohero	<i>noun</i><br><ol><li>waist</li></ol>
njohi	<i>noun</i><br><ol><li>alcoholic beverage made from sugar-cane or honey</li><li>any kind of alcoholic beverage</li></ol>
njoka	<i>noun</i><br><ol><li>parasite</li></ol>
njuĩrĩ	<i>noun</i><br><ol><li>hair</li></ol>
njĩmbĩrĩ	<i>noun</i><br><ol><li>otter, especially spot-necked otter (Hydrictis maculicollis, syn. Lutra maculicollis)</li></ol>
njĩra	<i>noun</i><br><ol><li>way, path, road</li></ol>
njũgũma|gacũgũma	<i>noun</i><br><ol><li>knobkerry, a type of throwing club</li></ol>
njũi	<i>noun</i><br><ol><li>African hunting dog, African wild dog</li></ol>
njũkĩ	<i>noun</i><br><ol><li>bee</li></ol>
njũragano	<i>noun</i><br><ol><li>slaughter (of people)</li><li>killing of one another</li></ol>
no	<i>particle</i><br><ol><li>(it is) only</li></ol><br><i>conj</i><br><ol><li>but</li></ol>
noe	<i>noun</i><br><ol><li>Lima bean(s), butter bean(s), Madagascar bean(s) (Phaseolus lunatus)</li></ol>
noora|kũnoora	<i>verb</i><br><ol><li>to sharpen (on grindstone)</li></ol>
numĩra	<i>noun</i><br><ol><li>giant forest hog, giant hog (Hylochoerus meinertzhageni)</li></ol>
nyaga	<i>noun</i><br><ol><li>ostrich</li></ol>
nyama|nyama	<i>noun</i><br><ol><li>meat, flesh</li><li>aardvark</li></ol>
nyamĩndigi	<i>noun</i><br><ol><li>a bird of the genus Cossypha, especially cape robin(-chat) (C. caffra, syn. Dessonornis caffer)</li></ol>
nyamũ	<i>noun</i><br><ol><li>animal, beast</li></ol>
nyamũ ya thĩ|nyamũ cia thĩ	<i>noun</i><br><ol><li>a certain species of snake; according to Hobley (1911:418) and Leakey (1977), it was the custom that the snake was treated with milk or fat poured out on the floor for drinking if the animal entered a hut and the snake was made to leave the hut lest the snake should be by any chance killed. Hobley also reports that Kikuyu people regarded the snake as incarnation of a spirit of the departed (ngoma).</li><li>(in general) snake</li></ol>
nyamũga	<i>noun</i><br><ol><li>sandal</li></ol>
nyau|diminutive kanyau）|10 （augmentative kĩnyau	<i>noun</i><br><ol><li>cat</li><li>wild cat (Felis silvestris)</li></ol>
nyee	<i>noun</i><br><ol><li>testicle</li></ol>
nyeni	<i>noun</i><br><ol><li>vegetables</li></ol>
nyenje	<i>noun</i><br><ol><li>cockroach</li></ol>
nyina	<i>noun</i><br><ol><li>his or her mother</li></ol>
nyoka	<i>noun</i><br><ol><li>snake</li></ol>
nyondo|nyondo	<i>noun</i><br><ol><li>(woman's) breast</li><li>hammer</li></ol>
nyoneka na rua yũraga na rua	<i>proverb</i><br><ol><li>easy come, easy go; quick come, quick go</li></ol>
nyoni|kanyoni|tũnyoni	<i>noun</i><br><ol><li>bird</li></ol>
nyoro	<i>noun</i><br><ol><li>Dwarf Cavendish banana a cultivar of Musa acuminata (Colla (AAA Group) 'Dwarf Cavendish')</li></ol>
nyua|kũnyua	<i>verb</i><br><ol><li>to drink</li></ol>
nyũmba	<i>noun</i><br><ol><li>house; a hut where woman lives</li><li>lineage, family</li><li>room</li></ol>
nyũmba ya mbũmbũĩ	<i>noun</i><br><ol><li>spider web, spider's web (lit. spider's house)</li></ol>
nyũngũ	<i>noun</i><br><ol><li>earthen pot used for cooking or keeping something</li></ol>
nĩ	<i>particle</i><br><ol><li>(copula) is</li><li>(in passive construction) by</li></ol>
nĩ wega	<i>phrase</i><br><ol><li>thank you</li></ol>
nĩ ũndũ wa	<i>phrase</i><br><ol><li>because of</li></ol>
nĩkĩ	<i>adv</i><br><ol><li>(interrogative) why</li></ol>
nĩkĩo	<i>det</i><br><ol><li>that</li></ol>
nũgũ	<i>noun</i><br><ol><li>baboon</li></ol>
nũũ	<i>pron</i><br><ol><li>who</li></ol>
o	<i>pron</i><br><ol><li>they</li></ol>
oha|kuoha	<i>verb</i><br><ol><li>to tie</li></ol>
ona|kũona|kuona	<i>verb</i><br><ol><li>to see</li><li>to find</li><li>to get into, to find oneself (unusual situation)</li></ol>
onga|kuonga	<i>verb</i><br><ol><li>to suck</li></ol>
onia|kuonia	<i>verb</i><br><ol><li>to show</li><li>to teach</li></ol>
oya|kuoya	<i>verb</i><br><ol><li>to pick</li><li>to lift</li></ol>
raara|kũraara	<i>verb</i><br><ol><li>to spend the night</li></ol>
raaria|kũraaria	<i>verb</i><br><ol><li>to protect, to keep company (through the night)</li></ol>
ragũra|kũragũra	<i>verb</i><br><ol><li>to divine</li></ol>
ragũrĩra|kũragũrĩra	<i>verb</i><br><ol><li>to divine for</li></ol>
rakara|kũrakara	<i>verb</i><br><ol><li>to be angry</li></ol>
rangi|marangi	<i>noun</i><br><ol><li>colour</li></ol>
ratha|kũratha	<i>verb</i><br><ol><li>to shoot</li><li>(of celestial bodies) to rise</li><li>to foresee</li><li>to profess</li></ol>
rega|kũrega	<i>verb</i><br><ol><li>to refuse</li></ol>
rema|kũrema	<i>verb</i><br><ol><li>to disobey</li></ol>
remwo|kũremwo	<i>verb</i><br><ol><li>(followed by nĩ) to be unable</li></ol>
riboti	<i>noun</i><br><ol><li>report</li></ol>
riika|mariika|rika|marika	<i>noun</i><br><ol><li>group of the people who have been circumcised at the same time; used to play a role in tying up kinship relations such as mũhĩrĩga, mbarĩ and nyũmba; age group, age set</li></ol>
riitho|maitho	<i>noun</i><br><ol><li>eye</li></ol>
ririkana|kũririkana	<i>verb</i><br><ol><li>to remember</li></ol>
ririkania|kũririkania	<i>verb</i><br><ol><li>to remind</li></ol>
riũa|mariũa	<i>noun</i><br><ol><li>sun</li></ol>
rora|kũrora	<i>verb</i><br><ol><li>to see, to look</li></ol>
rota|kũrota	<i>verb</i><br><ol><li>to dream</li></ol>
ruai	<i>noun</i><br><ol><li>whistling thorn (Vachellia drepanolobium, syn. Acacia drepanolobium)</li></ol>
ruga|kũruga	<i>verb</i><br><ol><li>to cook</li></ol>
ruma|kũruma	<i>verb</i><br><ol><li>to curse, to abuse</li></ol>
rumu	<i>noun</i><br><ol><li>room</li></ol>
ruoya|njoya	<i>noun</i><br><ol><li>feather</li></ol>
ruruma|kũruruma	<i>verb</i><br><ol><li>to thunder</li></ol>
ruta|kũruta	<i>verb</i><br><ol><li>to take out from</li><li>to remove, to take away</li><li>to teach</li><li>to obtain, to produce</li></ol>
rwagĩ	<i>noun</i><br><ol><li>mosquito</li></ol>
rwambo|nyambo	<i>noun</i><br><ol><li>one of the pegs used for stretching out hides and skins to dry up</li></ol>
rwara|ndwara	<i>noun</i><br><ol><li>fingernail, nail</li></ol>
rĩa|kũrĩa	<i>verb</i><br><ol><li>to eat</li><li>to hurt, to harm, to damage</li></ol>
rĩera	<i>noun</i><br><ol><li>air</li></ol>
rĩha|kũrĩha	<i>verb</i><br><ol><li>to pay</li></ol>
rĩithia|kũrĩithia	<i>verb</i><br><ol><li>to make (someone) eat forcefully</li><li>to graze, to pasture</li></ol>
rĩithori|maithori	<i>noun</i><br><ol><li>teardrop, tear</li></ol>
rĩma|kũrĩma	<i>verb</i><br><ol><li>to cultivate</li></ol>
rĩra|kũrĩra	<i>verb</i><br><ol><li>to cry, to weep</li></ol>
rĩrĩa	<i>pron</i><br><ol><li>(not interrogative) when</li></ol>
rĩu	<i>adv</i><br><ol><li>now</li></ol>
rĩĩtwa|marĩĩtwa	<i>noun</i><br><ol><li>name</li></ol>
rĩũmba	<i>noun</i><br><ol><li>mixture of sand and clay used for making pottery</li></ol>
rũathe|njathe	<i>noun</i><br><ol><li>Psydrax parviflora,), tree of the madder family (Rubiaceae); yields timber.</li><li>Psydrax schimperiana subsp. schimperiana; yields hard wood and is used for building.</li><li>false turkey-berry, mottled-bark canthium (Psydrax livida); yields very hard wood.</li></ol>
rũbaru|mbaru	<i>noun</i><br><ol><li>rib</li></ol>
rũbaũ|mbaaũ|rũbaaũ|mbaũ	<i>noun</i><br><ol><li>plank, long board</li><li>sawn timber</li></ol>
rũbutu|mbutu	<i>noun</i><br><ol><li>eyebrow</li></ol>
rũbũa|mbũa	<i>noun</i><br><ol><li>flaky solder</li><li>bee's sting left in skin</li><li>peel of sugar-cane chipped off before eating</li></ol>
rũcinĩ	<i>noun</i><br><ol><li>morning</li></ol>
rũcuĩrĩ|njuĩrĩ	<i>noun</i><br><ol><li>single hair</li></ol>
rũga|nga	<i>noun</i><br><ol><li>sinew, tendon</li><li>ligament</li></ol>
rũgama|kũrũgama	<i>verb</i><br><ol><li>to stand (still)</li></ol>
rũgano|ng'ano	<i>noun</i><br><ol><li>story, tale</li></ol>
rũgendo|ng'endo	<i>noun</i><br><ol><li>journey, travel</li></ol>
rũgiri|ngiri	<i>noun</i><br><ol><li>fence</li></ol>
rũgito|ngito	<i>noun</i><br><ol><li>a place where a roof and wall meet inside a traditional hut</li><li>a space under eaves outside a hut</li></ol>
rũgongo|kagongo|ng'ongo	<i>noun</i><br><ol><li>ridge of land</li><li>upper part of slope</li><li>region forming a community whose borders are two rivers or valleys</li><li>north or south</li></ol>
rũgucio|ngucio	<i>noun</i><br><ol><li>wire</li></ol>
rũgũrũ	<i>noun</i><br><ol><li>upcountry</li><li>west</li></ol>
rũheni|heni	<i>noun</i><br><ol><li>lightning</li></ol>
rũhiũ|hiũ	<i>noun</i><br><ol><li>knife</li></ol>
rũhonge|'honge	<i>noun</i><br><ol><li>branch, bough</li><li>rump, hip</li><li>pelvis</li><li>ilium</li></ol>
rũhuho|huho	<i>noun</i><br><ol><li>wind</li></ol>
rũhĩ|hĩ	<i>noun</i><br><ol><li>palm of the hand</li><li>hand</li></ol>
rũhĩa|hĩa|kahĩa	<i>noun</i><br><ol><li>horn</li></ol>
rũkunyũ|ngunyũ	<i>noun</i><br><ol><li>scratch, laceration</li></ol>
rũkũngũ|ngũngũ	<i>noun</i><br><ol><li>dust</li></ol>
rũma|kũrũma	<i>verb</i><br><ol><li>to bite</li><li>to be firm</li><li>to take a handful</li></ol>
rũmĩrĩra|kũrũmĩrĩra	<i>verb</i><br><ol><li>to follow</li></ol>
rũng'ũthũ|ng'ũthũ	<i>noun</i><br><ol><li>clitoris</li></ol>
rũnyarĩrĩ|nyarĩrĩ	<i>noun</i><br><ol><li>instep</li><li>human foot</li></ol>
rũraacio|rũracio|ndacio|ndaacio	<i>noun</i><br><ol><li>bride price, bridewealth; cows, sheep, goats, cash, mead, etc. paid continuously by a groom to his father-in-law.</li></ol>
rũrigi|ndigi	<i>noun</i><br><ol><li>string</li></ol>
rũru|ndũru	<i>noun</i><br><ol><li>herd</li></ol>
rũrĩmĩ|nĩmĩ	<i>noun</i><br><ol><li>tongue</li></ol>
rũrĩra|ndĩra	<i>noun</i><br><ol><li>umbilical cord</li><li>relationship, kinship</li><li>button at the bottom of a gourd</li></ol>
rũthingo|thingo	<i>noun</i><br><ol><li>wall</li></ol>
rũthiomi|thiomi	<i>noun</i><br><ol><li>language</li></ol>
rũthirũ|thirũ	<i>noun</i><br><ol><li>bracken fern (Pteridium aquilinum)</li></ol>
rũthĩa|thĩa	<i>noun</i><br><ol><li>jaw</li><li>cheek</li></ol>
rũĩmbo|rwĩmbo|nyĩmbo	<i>noun</i><br><ol><li>song</li><li>dance</li></ol>
rũũga|kũrũũga	<i>verb</i><br><ol><li>to jump</li></ol>
rũũĩ|njũĩ	<i>noun</i><br><ol><li>river</li></ol>
ta	<i>particle</i><br><ol><li>like, as</li></ol>
ta gĩkwa na mũkũngũgũ	<i>adv</i><br><ol><li>quite harmoniously, harmoniously fit together (lit. “like a yam and a mũkũngũgũ tree”; this tree has been used traditionally for supporting yam vines, etc.)</li></ol>
taara|gũtaara	<i>verb</i><br><ol><li>to advise</li></ol>
taha|gũtaha	<i>verb</i><br><ol><li>to draw (water, beer, etc.)</li><li>to seize (booty)</li></ol>
tahĩka|gũtahĩka	<i>verb</i><br><ol><li>to vomit</li></ol>
te|gũte	<i>verb</i><br><ol><li>to throw away</li></ol>
teithia|gũteithia	<i>verb</i><br><ol><li>to help</li></ol>
tema|gũtema	<i>verb</i><br><ol><li>to cut (with a knife)</li></ol>
tene	<i>noun</i><br><ol><li>past</li></ol><br><i>adv</i><br><ol><li>early, soon</li></ol>
tene na tene	<i>adv</i><br><ol><li>forever (and ever)</li></ol>
teng'era|gũteng'era	<i>verb</i><br><ol><li>to run</li></ol>
teta|gũteta	<i>verb</i><br><ol><li>to grumble</li></ol>
thaatũ	<i>noun</i><br><ol><li>mist</li></ol>
thabina	<i>noun</i><br><ol><li>Noah's ark</li><li>ship</li></ol>
thabuni|mathabuni	<i>noun</i><br><ol><li>soap</li></ol>
thaburia	<i>noun</i><br><ol><li>metal cooking pot, saucepan</li></ol>
thahabu	<i>noun</i><br><ol><li>gold</li></ol>
thaitha|gũthaitha	<i>verb</i><br><ol><li>to beseech</li></ol>
thakame	<i>noun</i><br><ol><li>blood</li></ol>
thakara|gũthakara	<i>verb</i><br><ol><li>to be beautiful</li></ol>
thamaka|gũthamaka	<i>verb</i><br><ol><li>to judge</li><li>to govern</li></ol>
thamaki	<i>noun</i><br><ol><li>fish</li></ol>
thambara	<i>noun</i><br><ol><li>leech</li></ol>
thambia|gũthambia	<i>verb</i><br><ol><li>(transitive) to wash</li></ol>
thandara	<i>noun</i><br><ol><li>tangerine</li></ol>
thandĩ	<i>noun</i><br><ol><li>spark</li></ol>
thani	<i>noun</i><br><ol><li>plate</li></ol>
thara	<i>noun</i><br><ol><li>Napier grass, elephant grass (Pennisetum purpureum)</li></ol>
thathi	<i>noun</i><br><ol><li>meat soup</li></ol>
theca|gũtheca	<i>verb</i><br><ol><li>to pierce, to stab</li></ol>
thegere	<i>noun</i><br><ol><li>small animal that breaks up beehives (mĩatũ) and steals all the honeycombs; honey badger, or ratel (Mellivora capensis)</li><li>ichneumon, Egyptian mongoose (Herpestes ichneumon)</li></ol>
theka|gũtheka	<i>verb</i><br><ol><li>to laugh</li></ol>
thenge	<i>noun</i><br><ol><li>he-goat</li></ol>
thiari	<i>noun</i><br><ol><li>tickbird, oxpecker, especially red-billed oxpecker (Buphagus erythrorhynchus)</li></ol>
thibitarĩ	<i>noun</i><br><ol><li>hospital</li></ol>
thigai	<i>noun</i><br><ol><li>stable fly (Stomoxys calcitrans)</li></ol>
thigiriri	<i>noun</i><br><ol><li>small black garden or sugar ant</li></ol>
thiirĩ|mathiirĩ	<i>noun</i><br><ol><li>debt</li></ol>
thimbũ	<i>noun</i><br><ol><li>walking stick</li></ol>
thimo	<i>noun</i><br><ol><li>proverb</li></ol>
thiota|mathiota	<i>noun</i><br><ol><li>warmth of ashes of dead fire</li><li>warm ashes</li></ol>
thirikari	<i>noun</i><br><ol><li>government</li></ol>
thiruai	<i>noun</i><br><ol><li>eland</li></ol>
thithino	<i>noun</i><br><ol><li>sweat, perspiration</li></ol>
thitima	<i>noun</i><br><ol><li>electricity</li></ol>
thiya	<i>noun</i><br><ol><li>duiker (bush duiker or common duiker (Sylvicapra grimmia), etc.)</li></ol>
thiĩ|gũthiĩ	<i>verb</i><br><ol><li>to go, to walk</li></ol>
thiũrũra	<i>noun</i><br><ol><li>dizziness, giddiness, vertigo</li></ol>
thogora|mathogora	<i>noun</i><br><ol><li>price</li></ol>
thoguo|mathoguo	<i>noun</i><br><ol><li>thy father</li></ol>
thoko	<i>noun</i><br><ol><li>market, marketplace</li></ol>
thoma|gũthoma	<i>verb</i><br><ol><li>to read</li></ol>
thondeka|gũthondeka	<i>verb</i><br><ol><li>to mend</li><li>to prepare</li><li>to adjust</li></ol>
thonjo	<i>noun</i><br><ol><li>weaverbird, including baglafecht weaver (Ploceus baglafecht)</li></ol>
thukuru|mathukuru|cukuru|macukuru	<i>noun</i><br><ol><li>school</li></ol>
thumu|thumu	<i>noun</i><br><ol><li>manure, fertilizer, obtained chiefly from cattle or sheep dung</li><li>venom</li></ol>
thundo	<i>noun</i><br><ol><li>pimple, spot, rash</li></ol>
thuraku	<i>noun</i><br><ol><li>safari ant, driver ant</li></ol>
thutha|thuutha	<i>noun</i><br><ol><li>back, rear</li></ol>
thuya	<i>noun</i><br><ol><li>flea</li></ol>
thwara	<i>noun</i><br><ol><li>Thomson's gazelle (Eudorcas thomsonii)</li><li>Grant's gazelle (Nanger granti)</li><li>impala (Aepyceros melampus)</li><li>reedbuck (Redunca spp.)</li><li>large duiker</li></ol>
thwariga	<i>noun</i><br><ol><li>bushbuck</li><li>deer</li></ol>
thĩ	<i>noun</i><br><ol><li>earth</li></ol>
thĩa|gũthĩa	<i>verb</i><br><ol><li>to grind</li></ol>
thĩgĩngĩ	<i>noun</i><br><ol><li>barbed wire</li></ol>
thũ	<i>noun</i><br><ol><li>enemy</li></ol>
thũng'wa	<i>noun</i><br><ol><li>ankle(-bone)</li></ol>
thũngũri	<i>noun</i><br><ol><li>hillock, knoll</li><li>bump</li></ol>
thũriũ	<i>noun</i><br><ol><li>fiscal shrike (Lanius collaris)</li></ol>
ti	<i>particle</i><br><ol><li>(negation) not</li></ol>
tiga|gũtiga	<i>verb</i><br><ol><li>to stop, to quit</li><li>to leave, to quit</li></ol>
tinia|gũtinia	<i>verb</i><br><ol><li>to sever, to cut (off)</li></ol>
tivii	<i>noun</i><br><ol><li>television</li></ol>
tombo|matombo	<i>noun</i><br><ol><li>brain</li></ol>
tongoria|gũtongoria	<i>verb</i><br><ol><li>to lead</li></ol>
tonya|gũtonya	<i>verb</i><br><ol><li>to enter</li></ol>
toro|matoro	<i>noun</i><br><ol><li>sleep</li></ol>
tura|gũtura	<i>verb</i><br><ol><li>to forge</li></ol>
twara|gũtwara	<i>verb</i><br><ol><li>to take, to conduct, to convey (to)</li></ol>
tĩĩri|matĩĩri	<i>noun</i><br><ol><li>soil, earth</li></ol>
tũma|gũtũma	<i>verb</i><br><ol><li>to send</li></ol>
tũnga|gũtũnga	<i>verb</i><br><ol><li>to meet</li></ol>
tũũra|gũtũũra	<i>verb</i><br><ol><li>to live</li></ol>
uga|kuuga	<i>verb</i><br><ol><li>to say</li></ol>
uma|kuuma	<i>verb</i><br><ol><li>to go out, come out</li></ol>
umagara|kuumagara	<i>verb</i><br><ol><li>go out, set out</li></ol>
uungumania|mauungumania	<i>noun</i><br><ol><li>machination, underhand tactics</li><li>treachery</li><li>robbery by guile</li></ol>
wabici|mawabici	<i>noun</i><br><ol><li>office</li></ol>
wakarurĩ	<i>noun</i><br><ol><li>African striped weasel (Poecilogale albinucha)</li></ol>
wandĩndĩ	<i>noun</i><br><ol><li>single-stringed chordophone</li></ol>
waru	<i>noun</i><br><ol><li>potato (of not sweet variety)</li></ol>
warĩire athĩnirie waigire	<i>proverb</i><br><ol><li>a fool and his money are soon parted (lit. one who had eaten bothered one who had stored)</li></ol>
watho|mawatho	<i>noun</i><br><ol><li>law, rule</li></ol>
we|wee	<i>pron</i><br><ol><li>you, thou</li><li>s/he</li></ol>
wega	<i>noun</i><br><ol><li>goodness</li></ol>
wega uumaga na mũciĩ	<i>proverb</i><br><ol><li>charity begins at home (lit. goodness comes from home)</li></ol>
wendo|mawendo	<i>noun</i><br><ol><li>love</li></ol>
werũ|mawerũ	<i>noun</i><br><ol><li>whiteness</li><li>plain, grassland</li></ol>
wonjoria	<i>noun</i><br><ol><li>trade, business</li><li>barter</li></ol>
wĩ mwega	<i>phrase</i><br><ol><li>how are you? (lit. are you good?)</li></ol>
wĩra|mawĩra	<i>noun</i><br><ol><li>work</li></ol>
ĩ|Ĩ	<i>character</i><br><ol><li>The ninth letter of the Kikuyu alphabet, written in the Latin script.</li></ol>
ĩka|gwĩka	<i>verb</i><br><ol><li>to do, to perform</li></ol>
ĩra|kwĩra	<i>verb</i><br><ol><li>to tell</li></ol>
ĩrorera|kwĩrorera	<i>verb</i><br><ol><li>(literally) to look for oneself</li><li>to watch (matches, TV programmes, etc.)</li></ol>
ĩrĩ|twĩrĩ|ĩĩrĩ|merĩ|erĩ|igĩrĩ	<i>num</i><br><ol><li>two</li></ol>
ĩta|gwĩta	<i>verb</i><br><ol><li>to call</li><li>to invite</li></ol>
ĩtigĩra|gwĩtigĩra	<i>verb</i><br><ol><li>to be afraid (lit. to stop for oneself)</li></ol>
ĩĩ	<i>intj</i><br><ol><li>yes</li></ol>
ũ|Ũ	<i>character</i><br><ol><li>The eighteenth letter of the Kikuyu alphabet, written in the Latin script.</li></ol>
ũbuthu|mobuthu	<i>noun</i><br><ol><li>rottenness, rot, decay</li></ol>
ũcũrũ	<i>noun</i><br><ol><li>gruel, porridge</li></ol>
ũgwati|mogwati	<i>noun</i><br><ol><li>danger, hazard</li></ol>
ũgũrũki|mogũrũki	<i>noun</i><br><ol><li>madness, craziness</li></ol>
ũhere	<i>noun</i><br><ol><li>scabies</li></ol>
ũhoro|mohoro	<i>noun</i><br><ol><li>news, account, discourse, words, affair, matter, subject, theme, topic</li><li>peace, well-being</li></ol>
ũiru	<i>noun</i><br><ol><li>jealousy, envy</li></ol>
ũka|gũũka	<i>verb</i><br><ol><li>to come</li></ol>
ũkuhĩ	<i>noun</i><br><ol><li>shortness</li></ol>
ũkĩra|gũũkĩra	<i>verb</i><br><ol><li>to wake, to get up</li></ol>
ũmba|kũũmba	<i>verb</i><br><ol><li>to mould, to create</li></ol>
ũmotho	<i>noun</i><br><ol><li>left-hand side</li></ol>
ũmũthĩ	<i>noun</i><br><ol><li>today</li></ol><br><i>adv</i><br><ol><li>today</li></ol>
ũra|kũũra	<i>verb</i><br><ol><li>to get lost, to go astray</li></ol>
ũraga|kũũraga	<i>verb</i><br><ol><li>to kill</li><li>to break, to smash</li></ol>
ũraihu|moraihu	<i>noun</i><br><ol><li>length</li><li>height</li></ol>
ũrata	<i>noun</i><br><ol><li>friendship</li></ol>
ũria|kũũria	<i>verb</i><br><ol><li>to ask</li></ol>
ũrimũ	<i>noun</i><br><ol><li>foolishness, stupidity</li></ol>
ũruu	<i>noun</i><br><ol><li>penis</li></ol>
ũrĩmi|morĩmi	<i>noun</i><br><ol><li>agriculture</li></ol>
ũrĩo	<i>noun</i><br><ol><li>right-hand side</li></ol>
ũrĩrĩ|morĩrĩ	<i>noun</i><br><ol><li>bed</li></ol>
ũta|mota	<i>noun</i><br><ol><li>bow (for shooting)</li></ol>
ũtheri|motheri	<i>noun</i><br><ol><li>light</li></ol>
ũthiũ|mothiũ	<i>noun</i><br><ol><li>face</li></ol>
ũtonga	<i>noun</i><br><ol><li>wealth</li></ol>
ũtukũ|matukũ	<i>noun</i><br><ol><li>night</li><li>(in the plural) days</li></ol>
ũtune|motune	<i>noun</i><br><ol><li>redness, red</li></ol>
ũĩ	<i>verb</i><br><ol><li>(defective) to know, to recognize</li></ol>
ũũgĩ|maũũgĩ	<i>noun</i><br><ol><li>cleverness, wisdom</li><li>knowledge</li><li>wit, intelligence, witticism</li><li>skill</li></ol>
ũũkĩ|maũũkĩ	<i>noun</i><br><ol><li>honey</li><li>mead</li></ol>
ũũru|maũũru	<i>noun</i><br><ol><li>badness, wrong doing</li></ol>
