अंडें|aṇḍẽ	<i>noun</i><br><ol><li>egg</li></ol>
अंधार|andhār	<i>noun</i><br><ol><li>darkness</li></ol>
अक्खो|akkhô|akkho|ಅಕ್ಖೊ	<i>adj</i><br><ol><li>whole, entire</li></ol>
अगशी|ಅಗಶೀ|agśī|Agxi	<i>name</i><br><ol><li>A village in Goa, India</li></ol>
अळणी|aḷṇī	<i>adj</i><br><ol><li>insipid, tasteless</li><li>lacking salt</li></ol>
अळमी|almi|ಅಳಮೀ|aḷmī	<i>noun</i><br><ol><li>mushroom</li></ol>
अशें|aśẽ|ಅಶೆಂ|oxem	<i>prep</i><br><ol><li>like this, like so, in this manner</li></ol>
अस्तरि|ostori|ಅಸ್ತರಿ|astari	<i>noun</i><br><ol><li>(archaic, rare) a woman</li></ol>
आंडु गुंडु|āṇḍu guṇḍu	<i>noun</i><br><ol><li>(offensive, derogatory, ethnic slur) Mimicking Tamil, Kannada, Malayalam and Telugu speech.</li></ol><br><i>adj</i><br><ol><li>(offensive, derogatory, ethnic slur) South Indian, relating or pertaining to South Indians</li></ol>
आंत|ಆಂತ್|ant|ā̃t	<i>noun</i><br><ol><li>intestine</li></ol>
आंधळो|ಆಂಧಳೊ|āndhḷo|andhllo	<i>adj</i><br><ol><li>blind</li></ol>
आंबट|ಆಂಬೋಟ್|āmbaṭ|ambot	<i>adj</i><br><ol><li>sour</li></ol>
आट|āt|ಆಟ್|āṭ	<i>num</i><br><ol><li>eight</li></ol>
आठवें|āṭhvẽ|ಆಠವೆಂ|atthvem	<i>adj</i><br><ol><li>eighth</li></ol>
आड|āḍ|add|ಆಡ್	<i>adj</i><br><ol><li>across, lying down, horizontal</li></ol>
आडव्चे|adavche|āḍavce|ಆಡವ್ಚೆ	<i>verb</i><br><ol><li>to obstruct, to stop</li></ol>
आता|ata|ātā|ಆತಾ	<i>adv</i><br><ol><li>now</li></ol>
आत्मो|ātmo|otmo	<i>noun</i><br><ol><li>soul, self</li></ol>
आदेव्स|adevs|ādevs|ಆದೆವ್ಸ್	<i>intj</i><br><ol><li>farewell, goodbye</li></ol>
आदोगाद|adogad|ಆದೋಗಾದ್|ādōgād	<i>noun</i><br><ol><li>a lawyer</li></ol>
आनी|ānī	<i>conj</i><br><ol><li>and</li></ol>
आपव्चे|afovche|ಆಫವ್ಚೆ|āpavce	<i>verb</i><br><ol><li>to call, to summon</li></ol>
आमि|ಆಮಿ|म्हका|म्हझि|आम्ची|म्हझे|आम्चो|आम्च्यान्नि|ಹಾಂವ್|म्हझात्ल्यान|म्हजो|āmi|ami|hā̃v|आम्चे|म्हझेर|आम्चेर|हांवेन|म्हझ्यान|आम्का|hanv|आम्च्यान|हांव	<i>pron</i><br><ol><li>we</li></ol>
आम्बो|आम्ब्या|आम्ब्यात्ल्यान|आम्ब्यान्चो|आम्बे|आम्ब्याचो|ambo|आम्ब्यार|आम्ब्यान्चेर|आम्ब्यान्त्ल्यान|आम्ब्यान्नो|āmbo|आम्ब्याचेर|आम्ब्यानि|आम्ब्यान्नि|आम्ब्यान|आम्ब्यान्चि|आम्ब्याचि|आम्ब्यान्चे|आम्ब्यांक|आम्ब्याचे|आम्ब्याक|ಆಂಬೊ	<i>noun</i><br><ol><li>(formal, literary) mango</li></ol>
आयज|āyj|ಅಯಜ|aiz	<i>adv</i><br><ol><li>today</li></ol>
आयिल्लो|आयल्लो|āyllo|āillo|āyillo|ಆಯಲ್ಲೊ|ailolo|ಆಇಲ್ಲೊ|ಆಯಿಲ್ಲೊ|आइल्लो	<i>adj</i><br><ol><li>come, arrived</li></ol>
आय्तार|āytār|ಆಯ್ತಾರ್|aitar	<i>noun</i><br><ol><li>Sunday</li></ol>
आरसो|आरसे|arso|आरस्याक|आरस्यान्चि|आरस्यान्नि|आरस्यान्त्ल्यान|आरस्याचे|आरस्यान्चे|आरस्यान्नो|आरस्यान्चेर|आरस्या|आरस्यान|आरस्याचो|आरस्यार|आरस्याचि|आरस्यांक|आरस्याचेर|ārso|आरस्यान्चो|ಆರಸೊ|आरस्यानि|आरस्यात्ल्यान	<i>noun</i><br><ol><li>mirror</li></ol>
आल्ले|ālle|alle|ಅಲ್ಲೆ	<i>noun</i><br><ol><li>ginger</li></ol>
आळू|ಆಳೂ|allu|āḷū	<i>noun</i><br><ol><li>the Colocasia esculenta plant and its tuber</li></ol>
आवड|ಆವಡ್|āvaḍ|avodd	<i>noun</i><br><ol><li>liking, fondness, preference</li></ol>
आवड्चे|āvaḍce|avoddche|ಆವಡ್ಚೆ	<i>verb</i><br><ol><li>to be liked, loved by</li><li>to please</li></ol>
आस्चे|āsce|ಆಸ್ಚೆ|asche|āsā|आसा	<i>verb</i><br><ol><li>to be, to be there, to be present</li></ol>
इंगाळो|iṅgāḷô|ingalo|ಇಂಗಾಳೊ	<i>noun</i><br><ol><li>charcoal</li></ol>
इंग्लेज|Inglez|inglej	<i>name</i><br><ol><li>English, British</li><li>English language</li></ol>
इक्रा|ikrā|ikra|ಇಕ್ರಾ	<i>num</i><br><ol><li>eleven</li></ol>
इगर्जे|igarze|ಇಗರ್ಜೆ	<i>noun</i><br><ol><li>church, cathedral</li></ol>
इर्मांव|irmanv|irmā̃v|ಇರ್ಮಾಂವ್	<i>noun</i><br><ol><li>brother</li></ol>
इश्कोल|iskol|iśkol|ಇಶ್ಕೊಲ್	<i>noun</i><br><ol><li>school</li></ol>
उंदिर|undir|ಉಂದಿರ	<i>noun</i><br><ol><li>a mouse</li></ol>
उकड्चे|ukaḍce|ukkaduche|ಉಕಡ್ಚೆ	<i>verb</i><br><ol><li>to boil</li></ol>
उगड्चे|ugodche|ಉಗಡ್ಚೆ|ugaḍce	<i>verb</i><br><ol><li>to open</li></ol>
उजवें|ಉಜವೆಂ|uzvem|ujvẽ	<i>adj</i><br><ol><li>on or towards the right side</li></ol>
उजो|ujo|ಉಜೊ	<i>noun</i><br><ol><li>fire</li></ol>
उणे|uṇe|unem|ಉಣೆ	<i>adj</i><br><ol><li>less, short (of the right number)</li></ol>
उणेपण|ಉಣೆಪಣ|unneponn|uṇepaṇ	<i>noun</i><br><ol><li>deficiency, defect</li><li>(euphemistic) infertility</li></ol>
उदक|उदकाचो|ಉದಕ|उदकानि|उदकाचेर|उदकाक|उदकाचे|udok|उदकात्ल्यान|उदकाची|उदकान|udak	<i>noun</i><br><ol><li>water</li></ol>
उबार्चे|ubārce|ಉಭಾರ್ಚೆ|ubharche	<i>verb</i><br><ol><li>to lift</li></ol>
उभो|ubho|ubhô|ಉಭೊ	<i>adj</i><br><ol><li>erect, upright, standing</li></ol>
उलोव्चे|ಉಲವ್ಚೆ|ulovuche|ulovce	<i>verb</i><br><ol><li>to speak, talk</li></ol>
उशें|uśẽ|ಉಶೆಂ|uxem	<i>noun</i><br><ol><li>pillow</li></ol>
ऊंस|us|ū̃s|ಊಂಸ್	<i>noun</i><br><ol><li>sugar cane</li></ol>
एक|ek|ಎಕ	<i>num</i><br><ol><li>one</li></ol>
एकोणीस|ekonnis|ಏಕೋಣೀಸ್|ekoṇīs	<i>num</i><br><ol><li>nineteen</li></ol>
ओक्चे|okche|ಓಕ್ಚೆ|ōkce	<i>verb</i><br><ol><li>to vomit, throw up</li></ol>
ओनु|onu|ಒನು	<i>adv</i><br><ol><li>this year</li></ol>
कर्चे|karce|karche|ಕರ್ಚೆ	<i>verb</i><br><ol><li>to do, make</li></ol>
कळसो|kollso|ಕಳಸೊ|kaḷso	<i>noun</i><br><ol><li>water-vessel, pitcher, a large jar</li></ol>
काजार|kazar|ಕಾಜಾರ್|kāzār	<i>noun</i><br><ol><li>(Catholic) wedding</li></ol>
कातार|kātār|ಕಾತಾರ್|katar	<i>noun</i><br><ol><li>(Catholic) a song</li></ol>
कातोर्चे|kātorce|ಕಾತೊರ್ಚೆ|kātortā|कातोर्ता|kattorche	<i>verb</i><br><ol><li>to cut, slice</li></ol>
कापो|kāpô	<i>noun</i><br><ol><li>(offensive, derogatory, religious slur) a Muslim</li></ol>
काबुकी|kābukī	<i>noun</i><br><ol><li>kabuki (form of Japanese theatre)</li></ol>
काळिंग|kāỊiṅg|kalling|ಕಾಳಿಂಗ್	<i>noun</i><br><ol><li>watermelon</li></ol>
काळें|kallem|kāḷễ|ಕಾಳೆಂ	<i>adj</i><br><ol><li>black</li></ol>
कावळो|kavllo|ಕಾವ್ಳೊ|kāvḷo	<i>noun</i><br><ol><li>a crow</li></ol>
किडो|किड्या|किड्यात्ल्यान|किड्यान|किड्यांक|kiḍô|किड्यान्नि|किड्याचो|किड्याक|kiddo|किड्यार|किडे|किड्याचे|किड्यान्त्ल्यान|किड्यान्चि|किड्यान्चो|किड्याचि|किड्यानि|किड्यान्नो|किड्यान्चे|किड्याचेर|किड्यान्चेर	<i>noun</i><br><ol><li>insect</li><li>worm</li></ol>
किदें|kidễ|kidem|ಕಿದೆಂ	<i>pron</i><br><ol><li>what?</li></ol>
किद्याक|kidyāk|kidyak|ಕಿದ್ಯಾಕ	<i>adv</i><br><ol><li>why (literally “for what?”)</li></ol>
किरिस्तांव|kiristanv|ಕಿರಿಸ್ತಾಂವ್|kiristā̃v	<i>noun</i><br><ol><li>a Christian person</li></ol>
कुंकड|ಕುಂಕಡ|kunkod|kuṅkaḍ	<i>noun</i><br><ol><li>chicken</li></ol>
कुंकळी|kuṅkaḷī|Cuncolim|ಕುಕಂಳೀ	<i>name</i><br><ol><li>A village in Goa, India</li></ol>
कुठ्ठाळी|Cortalim|ಕುಠ್ಠಾಳೀ|kuṭhṭhāḷī	<i>name</i><br><ol><li>A village in Goa, India</li></ol>
कुत्रो|कुत्र्याचे|कुत्र्याचो|कुत्र्याक|कुत्र्यानि|कुत्र्यान|कुत्र्यान्चेर|ಕುತ್ರೊ|कुत्र्यांक|kutro|कुत्र्यान्चे|कुत्र्याचि|कुत्र्यान्त्ल्यान|कुत्र्यान्नो|कुत्र्या|कुत्र्यान्नि|कुत्र्यार|कुत्रे|कुत्र्याचेर|कुत्र्यान्चो|कुत्र्यात्ल्यान|kutrô|कुत्र्यान्चि	<i>noun</i><br><ol><li>dog</li></ol>
कुरडो|कुरड्यान्चे|ಕುಡ್ಡೊ|कुरड्यार|कुरड्याचि|कुरड्यान्चो|कुरड्यात्ल्यान|कुरड्या|कुरड्यान्नो|kudd'ddo|कुरड्यान्त्ल्यान|कुरड्याचो|कुरडे|कुरड्यान्नि|कुरड्यान|कुरड्यान्चेर|कुरड्यानि|kurḍo|कुरड्याक|kuddo|कुरड्यांक|कुरड्यान्चि|कुरड्याचेर|कुरड्याचे	<i>adj</i><br><ol><li>blind</li></ol><br><i>noun</i><br><ol><li>a blind man</li></ol>
कुलेर|ಕುಲ್ಯೆರ್|kuʎer|kuler	<i>noun</i><br><ol><li>(Catholic) spoon</li></ol>
कुलो|kulô|kulo|ಕುಲೊ	<i>noun</i><br><ol><li>hip</li></ol>
केंद्र|kendr|ಕೆಂದ್ರ್|kendra	<i>noun</i><br><ol><li>center (US), centre (UK); middle</li></ol>
केल्लो|kelolo|kello|ಕೆಲ್ಲೊ	<i>adj</i><br><ol><li>done, made</li></ol>
केस|ಕೆಸ್|kes	<i>noun</i><br><ol><li>hair</li></ol>
कोंकणी|Konknni|ಕೊಂಕಣಿ|koṅkṇī	<i>name</i><br><ol><li>Konkani (language)</li></ol>
कोंपर|kỗpar|komper|ಕೊಂಪರ್	<i>noun</i><br><ol><li>elbow</li></ol>
कोडू|koḍū|kodum|ಕೊಡೂ	<i>adj</i><br><ol><li>bitter</li></ol>
कोड्के|ಕೊಡ್ಕೆ|koddke|koḍke	<i>noun</i><br><ol><li>(Mangalorean Konkani) a cowshed or a barn</li></ol>
कोतमीर|kotmir|kōtmīr|ಕೋತಮೀರ್	<i>noun</i><br><ol><li>coriander</li></ol>
कोपेल|kopel|ಕೊಪೆಲ್|kôpêl	<i>noun</i><br><ol><li>a chapel; a small church</li></ol>
कोब्बु|kobu|ಕೊಬ್ಬು|kobbu	<i>noun</i><br><ol><li>sugar cane</li></ol>
खण्चे|khaṇce|khannche|ಖಣ್ಚೆ	<i>verb</i><br><ol><li>to dig</li></ol>
खाव्चे|khavche|ಖಾವ್ಚೆ|khāvce	<i>verb</i><br><ol><li>to eat, consume</li></ol>
खुरिस|khuris|ಖುರಿಸ್	<i>noun</i><br><ol><li>(Christianity) the holy cross</li></ol>
खेळ्चे|kheḷṭā|खेळ्टा|kheḷce|khevtam|ಖೆಳ್ಟಾ|ಖೆಳ್ಚೆ|khevchem	<i>verb</i><br><ol><li>to play</li></ol>
गंव|gonv|gãv|ಗಂವ್	<i>noun</i><br><ol><li>wheat</li></ol>
गळो|ಗೊಳೊ|गळ्यार|गळ्याचो|गळ्यान्चेर|गळ्यानि|गळ्यान्नि|गळे|gaḷô|गळ्यान्नो|गळ्याचि|गळ्यान्चि|गळ्याचेर|गळ्यान्चे|golo|गळ्यान्त्ल्यान|गळ्याक|गळ्या|गळ्यांक|गळ्यात्ल्यान|गळ्याचे|गळ्यान|गळ्यान्चो	<i>noun</i><br><ol><li>neck, throat</li></ol>
गळ्चे|ಗಳ್ಚೆ|gaḷce|gallche	<i>verb</i><br><ol><li>to leak, drip, dribble</li></ol>
गांय्दोळ|gā̃ydōḷ|gaidol|ಗಾಂಯ್ದೊಳ್	<i>noun</i><br><ol><li>an earthworm</li></ol>
गांव|gā̃v|gaum|ಗಾಂವ	<i>noun</i><br><ol><li>village</li></ol>
गाल|gāl	<i>noun</i><br><ol><li>cheek</li></ol>
गाव्चे|ಗಾವ್ಚೆ|gāvce|gavche	<i>verb</i><br><ol><li>to sing</li></ol>
गिड्डो|ಗಿಡ್ಡೊ|गिड्ड्यांक|गिड्ड्याचि|गिड्ड्यान्नो|गिड्डे|गिड्ड्यान्नि|गिड्ड्यान|गिड्ड्याचे|गिड्ड्यान्चि|गिड्ड्यान्त्ल्यान|गिड्ड्यात्ल्यान|गिड्ड्या|गिड्ड्यानि|गिड्ड्यान्चो|giddo|गिड्ड्याक|गिड्ड्यान्चे|giḍḍô|गिड्ड्याचो|गिड्ड्यान्चेर|गिड्ड्याचेर|गिड्ड्यार	<i>adj</i><br><ol><li>short (in stature)</li></ol><br><i>noun</i><br><ol><li>a short man</li></ol>
गीद|gid|ಗೀದ್|gīd	<i>noun</i><br><ol><li>a vulture</li></ol>
गू|gu|gū|ಗೂ	<i>noun</i><br><ol><li>excrement</li><li>(vulgar) shit</li></ol>
गेल्लो|gelolo|gello|ಗೆಲ್ಲೊ	<i>adj</i><br><ol><li>gone</li></ol>
गोंय|Gõy|ಗೊಂಯ್|gõy	<i>name</i><br><ol><li>Goa (a state of India)</li></ol>
गोटो|gotto|goṭo|ಗೊಟೊ	<i>noun</i><br><ol><li>a cowshed or a barn</li><li>(Christianity) crib (the representation of the nativity scene, depicting the birth of Jesus Christ in a barn)</li></ol>
गोड|ಗೋಡ|goud|gōḍ	<i>adj</i><br><ol><li>sweet</li></ol>
गोरो|goro|gôrô|ಗೊರೊ	<i>adj</i><br><ol><li>fair (of skin)</li></ol>
गोर्वां|gorva|gōrvā̃|ಗೋರ್ವಾಂ	<i>noun</i><br><ol><li>(only in plural) cattle</li></ol>
घंटो|ಘಂಟೊ|ghãṇṭô|ghonto	<i>noun</i><br><ol><li>a bell</li><li>(euphemistic) the penis</li></ol>
घाटी|ghati|ghāṭī|ಘಾಟಿ	<i>noun</i><br><ol><li>(derogatory) a non-Goan, a non-Konkani speaker, a person from Karnataka, an immigrant laborer</li><li>of or related to the Western Ghats</li></ol>
घाम	<i>noun</i><br><ol><li>sweat</li></ol><br><i>verb</i><br><ol><li>sweat</li></ol>
घेव्चे|ghevce|ghevche|ಘೆವ್ಚೆ	<i>verb</i><br><ol><li>to take</li></ol>
घोडो|घोड्यात्ल्यान|घोड्यान्चि|घोड्याचे|घोड्यानि|घोड्याक|घोड्याचि|ghoḍô|घोड्यान्चेर|घोड्यान्नि|घोड्यांक|घोड्यान्चे|घोड्यान्नो|घोड्या|घोड्यान्त्ल्यान|घोड्यान्चो|घोड्यार|घोडे|घोड्याचेर|घोड्यान|घोड्याचो|goddo	<i>noun</i><br><ol><li>horse</li></ol>
चडव्चे|ಚಡವ್ಚೆ|chadavche|tsaḍavce	<i>verb</i><br><ol><li>to cause one to climb, ascend or mount</li><li>to place on higher location</li><li>to ritually offer food, incense or flowers to a deity</li><li>(euphemistic) to ingest alcohol (or any other intoxicant)</li></ol>
चड्चे|ಚಡ್ಚೆ|tsaḍce|chaddche	<i>verb</i><br><ol><li>to climb, mount</li><li>(euphemistic) to have sex with (following the locative of the object)</li></ol>
चन्द्र|चन्द्रांक|चन्द्रान्नो|चन्द्रान|चन्द्रान्चे|चन्द्रात्ल्यान|चन्द्राक|चन्द्रान्चो|candr|ಚನ್ದ್ರ|चन्द्रान्चेर|चन्द्रार|चन्द्रान्नि|chandr|चन्द्राचे|चन्द्रान्चि|चन्द्राचि|चन्द्राचो|चन्द्रा|चन्द्राचेर|चन्द्रानि|चन्द्रान्त्ल्यान	<i>noun</i><br><ol><li>the Moon</li></ol>
चवथें|cavthẽ|ಚವ್ಥೆಂ|chovtem	<i>adj</i><br><ol><li>fourth</li></ol>
चाक|cāk|ಚಾಕ್|chaak	<i>noun</i><br><ol><li>wheel</li></ol>
चार|cār|ಚಾರ್|char	<i>num</i><br><ol><li>four</li></ol>
चेडी|cheddi|ಚೇಡೀ|cēḍī	<i>noun</i><br><ol><li>a prostitute</li></ol>
चोर|चोरा|चोरानि|चोरान्नो|चोरान्चो|चोरात्ल्यान|चोरार|चोराचे|चोराचेर|chor|चोरान्त्ल्यान|चोरांक|ಚೋರ|चोराक|चोरान्नि|चोरान|चोरान्चे|चोरान्चि|चोराचो|ċōr|चोराचि|चोरान्चेर	<i>noun</i><br><ol><li>thief</li></ol>
चोर्चे|ಚೋರ್ಚೆ|chorche|tsōrce	<i>verb</i><br><ol><li>to steal</li></ol>
जनेल|ಜನೆಲ್|zanel|zônêl	<i>noun</i><br><ol><li>window</li></ol>
जल्म|jalm|ಜಲ್ಮ್|zolm	<i>noun</i><br><ol><li>birth</li><li>lifetime</li></ol>
जळ्चे|zalhche|j̈aḷce|ಜಳ್ಚೆ	<i>verb</i><br><ol><li>to burn</li><li>(figuratively) to feel jealousy</li></ol>
जवळ|zavaḷ|zaval|ಜವಳ	<i>noun</i><br><ol><li>a twin</li></ol>
जांग|ಜಾಂಗ್|zang|zāṅg	<i>noun</i><br><ol><li>thigh</li></ol>
जांवंय|jā̃vãy|ಜಾಂವೈ|jā̃vai|जांवै|ಜಾಂವಂಯ್|zanvoim	<i>noun</i><br><ol><li>a son-in-law (daughter's husband)</li></ol>
जाग्चे|jāgce|zagche|ಜಾಗ್ಚೆ	<i>verb</i><br><ol><li>to be awake</li></ol>
जाण|zāṇ	<i>noun</i><br><ol><li>(in compounds) people</li></ol>
जाण्चे|zannche|ಜಾಣ್ಚೆ|jāṇce	<i>verb</i><br><ol><li>to know</li></ol>
जाण्टो|ಜಾಂಟೊ|zanntto|jāṇṭo	<i>adj</i><br><ol><li>(of a person) old, aged</li></ol>
जान्वें|zanvem|ಜಾನ್ವೆಂ|jānvẽ	<i>noun</i><br><ol><li>a sacred thread worn by Hindu men</li></ol>
जाल्यार|zalear|jālyār|ಜಾಲ್ಯಾರ್	<i>conj</i><br><ol><li>then, in that case</li></ol>
जाल्लो|ಜಾಲ್ಲೊ|zalolo|jāllo	<i>adj</i><br><ol><li>done, prepared, happened</li><li>born</li></ol>
जाव|ಜಾವ|zav|zāv	<i>noun</i><br><ol><li>co-sister-in-law (the wife of one's husband's brother)</li></ol>
जाव्चे|zāvce|ಜಾಲಾ|जाला|zalem|ಜಾವ್ಚೆ|zalolo|jāllo|jālā|zala|ಜಾಲೆ|zavche|jāle|ಜಾಲ್ಲೊ|जाले|जाल्लो	<i>verb</i><br><ol><li>to be born</li><li>to happen</li></ol>
जीब|jib|jīb	<i>noun</i><br><ol><li>(anatomy) tongue</li></ol>
जीव|jīv|jeev|ಜೀವ	<i>noun</i><br><ol><li>life</li></ol>
जु|zu|ಜು|zum	<i>noun</i><br><ol><li>yoke (a bar or frame of wood by which two oxen or other draught animals are joined at the heads or necks enabling them to pull a plough, cart etc.)</li></ol>
जुनें|junẽ|zunem|ಜುನೆಂ	<i>adj</i><br><ol><li>old, ancient, worn out</li></ol>
जेजू|ಜೆಜೂ|Jezu|jezū	<i>name</i><br><ol><li>(Christianity) Jesus Christ</li></ol>
जेवण|ಜೆವಣ್|jevonn|jevaṇ	<i>noun</i><br><ol><li>meal</li></ol>
जेवाण|jevann|jevāṇ|ಜೆವಾಣ	<i>noun</i><br><ol><li>(Maharashtrian, Canarese) Alternative form of जेवण (jevaṇ, “meal”)</li></ol>
जोर|zor|ಜೋರ್|zōr	<i>noun</i><br><ol><li>fever</li></ol>
झर्चे|ಝರ್ಚೆ|zharce|jhorche	<i>verb</i><br><ol><li>to wear away due to abrasion</li></ol>
झव्चे|ಝವ್ಚೆ|zovche|jhavce	<i>verb</i><br><ol><li>to copulate</li><li>(vulgar) to fuck</li></ol>
झूंज|ಝೂಂಜ್|zhuz|jhū̃j	<i>noun</i><br><ol><li>battle, struggle, resistance</li></ol>
झेम|ಝೇಮ್|jhem	<i>noun</i><br><ol><li>sleepiness, drowsiness</li><li>the urge to yawn</li><li>a yawn</li></ol>
ठाण|ಠಾಣ|ṭhāṇ|tthanna	<i>noun</i><br><ol><li>camp</li></ol>
डुक्कर|ಡುಕ್ಕರ|dukkor|ḍukkar	<i>noun</i><br><ol><li>hog, sow, pig</li></ol>
णव|ಣವ|ṇav|nav	<i>num</i><br><ol><li>nine</li></ol>
णवें|nnovem|ಣವೆಂ|ṇavẽ	<i>adj</i><br><ol><li>ninth</li></ol>
तण|ತಣ|तणाचि|तणानि|tan|तणा|तणान्चे|तणाक|तणान्चो|तणाचो|तणान|तणार|तणान्त्ल्यान|taṇ|तणान्चेर|तणाचेर|तणान्नि|तणान्नो|तणात्ल्यान|तणाचे|तणान्चि|तणांक	<i>noun</i><br><ol><li>dried grass, hay</li></ol>
तांदूळ|ತಾಂದೂಳ|tandul|tāndūḷ	<i>noun</i><br><ol><li>uncooked rice</li></ol>
ताक|ತಾಕ್|tāk|tak	<i>noun</i><br><ol><li>buttermilk</li></ol>
ताती|ತಾತೀ|tati|tātī	<i>noun</i><br><ol><li>egg</li></ol>
तान|tan|ತಾನ|tān	<i>noun</i><br><ol><li>thirst</li></ol>
तिखट|tikot|ತೀಖಟ್|तीखट|tikhaṭ|ತಿಖಟ್|tīkhaṭ	<i>adj</i><br><ol><li>spicy, hot (of taste)</li></ol>
तियात्र|tiatr|tiyātra	<i>noun</i><br><ol><li>musical theater</li></ol>
तीख|tīkh|ತೀಖ|tik	<i>adj</i><br><ol><li>spicy, hot (of taste)</li></ol>
तू|tū|tu|ತೂ	<i>pron</i><br><ol><li>you (the second person personal singular pronoun) (Plural: तुमि (tumi))</li></ol>
तूप|tup|tūp|ತೂಪ್	<i>noun</i><br><ol><li>ghee</li></ol>
तो|ತೊ|to	<i>pron</i><br><ol><li>he</li></ol>
तोण|tō̂ṇ|ತೊಣ|tonn	<i>noun</i><br><ol><li>mouth</li><li>face</li></ol>
त्रास|ತ್ರಾಸ|trās|tras	<i>noun</i><br><ol><li>difficulty, inconvenience</li></ol>
दांडो|dāṇḍo|ದಾಂಡೊ|danndo	<i>noun</i><br><ol><li>a stick, staff</li></ol>
दाड|daad|ದಾಡ|dāḍ	<i>noun</i><br><ol><li>(anatomy) molar</li></ol>
दार|dār|dar	<i>noun</i><br><ol><li>door</li></ol>
दिल्ली|dilli|dillī|ದಿಲ್ಲೀ	<i>name</i><br><ol><li>Delhi (a megacity and union territory of India, containing the national capital New Delhi)</li></ol>
दिवो|दिव्यार|दिव्यान्नो|दिव्याक|दिव्यान्त्ल्यान|दिव्यान|दिव्यान्चो|divo|दिव्याचि|ದಿಮೊ|दिव्यान्चेर|दिव्याचे|दिव्यान्चि|दिव्यांक|दिव्यान्नि|divô|दिव्या|दिव्यानि|दिव्यात्ल्यान|दिवे|दिव्याचो|दिव्यान्चे|दिव्याचेर	<i>noun</i><br><ol><li>light</li></ol>
दिव्चे|divche|ದಿವ್ಚೆ|divce	<i>verb</i><br><ol><li>to give</li></ol>
दिस्चे|ದಿಸ್ಚೆ|disce|dische	<i>verb</i><br><ol><li>to be seen</li><li>to appear</li></ol>
दीस|dis|dīs|ದೀಸ್	<i>noun</i><br><ol><li>day</li></ol>
दूद|dūd|ದೂದ್|dud	<i>noun</i><br><ol><li>milk</li></ol>
देर|देरान्नो|देरानि|der|ದೇರ್|देराचेर|देराचे|देरान्चो|देरान|देराचो|देरांक|देरान्त्ल्यान|देराचि|देरा|dēr|देरार|देरान्नि|देरान्चि|देराक|देरान्चेर|देरात्ल्यान|देरान्चे	<i>noun</i><br><ol><li>a woman's brother-in-law</li></ol>
दोत|dot	<i>noun</i><br><ol><li>dowry</li></ol>
दोतोर|दोतोरांक|दोतोराक|दोतोरान्चो|दोतोरा|दोतोरान्चेर|दोतोरानि|दोतोरान्चे|दोतोरात्ल्यान|दोतोराचेर|ದೊತೋರ್|दोतोरान्नो|dotōr|दोतोराचि|दोतोराचो|दोतोरान्त्ल्यान|दोतोराचे|dotor|दोतोरान|दोतोरार|दोतोरान्चि|दोतोरान्नि	<i>noun</i><br><ol><li>a doctor, physician</li></ol>
दोन|ದೊನ|dòn|don	<i>num</i><br><ol><li>two</li></ol>
दोळो|दोळ्याचि|दोळ्यांक|दोळ्याचे|दोळ्यान्त्ल्यान|दोळ्यात्ल्यान|दोळ्याचेर|दोळ्यान्नि|दोळे|दोळ्याक|dôḷô|दोळ्यान्चि|दोळ्यान्चो|दोळ्यान्नो|दोळ्यान|दोळ्याचो|दोळ्यान्चेर|dolo|दोळ्यानि|दोळ्यान्चे|दोळ्यार|दोळ्या|ದೊಳೊ	<i>noun</i><br><ol><li>the eye</li></ol>
धंय|ಧಯ|dhãy|dhay|dhoim|ಧಂಯ್|धय	<i>noun</i><br><ol><li>curd, yogurt</li></ol>
धर्चे|dharce|ಧರ್ಚೆ|dharche	<i>verb</i><br><ol><li>to hold</li></ol>
धवें|ಧವೆಂ|dhovem|dhavễ	<i>adj</i><br><ol><li>white</li></ol>
धा|ಧಾ|dhā|dha	<i>num</i><br><ol><li>ten</li></ol>
धाड्चे|dhaddche|ಧಾಡ್ಚೆ|dhāḍce	<i>verb</i><br><ol><li>to send, dispatch</li><li>to allow to leave or go</li></ol>
धाव्चे|dhavche|dhāvce|ಧಾವ್ಚೆ	<i>verb</i><br><ol><li>to run, flee</li></ol>
धुवोर|duvor|dhuvor|ಧುವೋರ	<i>noun</i><br><ol><li>smoke</li></ol>
धूव|dhūv|dhuv|ಧೂವ್	<i>noun</i><br><ol><li>daughter</li></ol>
धोणू|dhonnu|dhoṇū|ಧೋಣೂ	<i>noun</i><br><ol><li>a bow</li></ol>
नवें|नवे|नव्या|नवो|novem|ನವೆಂ|नव्यान्नो|navễ	<i>adj</i><br><ol><li>new, fresh</li></ol>
नाच्चे|नाच़्चे|nachche|ನಾಚ಼್ಚೆ|nāċce	<i>verb</i><br><ol><li>to dance</li></ol>
नाताळ|Natal|nātāḷ|ನಾತಾಳ್	<i>name</i><br><ol><li>Christmas</li></ol>
नाथु|ನಾಥು|nathu|nāthu	<i>noun</i><br><ol><li>grandson</li></ol>
नाव|ನಾವ್|nāv|nav	<i>noun</i><br><ol><li>name</li></ol>
निवळ|nivaḷ|nivoll|ನಿವಳ್	<i>adj</i><br><ol><li>clean, spotless</li></ol>
नीट|nīṭ|ನೀಟ್|nitt	<i>adj</i><br><ol><li>straight</li></ol>
नू|nū|ನೂ|nu	<i>particle</i><br><ol><li>not</li></ol>
नेण्टो|ನೆಂಟೊ|nenntto|neṇṭo	<i>adj</i><br><ol><li>young, youthful</li><li>immature</li></ol>
नेपाळ|nepāḷ	<i>name</i><br><ol><li>Nepal (a country in South Asia)</li></ol>
न्हीद|नीद|ನ್ಹೀದ್|nhid|nīd|nhīd|nid|ನೀದ್	<i>noun</i><br><ol><li>sleep</li></ol>
पगार|pagar|pagār	<i>noun</i><br><ol><li>pay, salary, monthly pay, wages</li></ol>
पणजी|pôṇjī|Ponnji	<i>name</i><br><ol><li>Panaji (a city, the state capital of Goa, India)</li></ol>
पन्नास|ಪನ್ನಾಸ್|ponnas|pannās	<i>num</i><br><ol><li>fifty</li></ol>
पयलें|ಪಯವೆಂ|poilem|paylẽ	<i>num</i><br><ol><li>first</li></ol>
पयलो|paylo|ಪಯಲೊ|poilo	<i>adj</i><br><ol><li>first</li></ol>
पलतडी|poltoddi|paltaḍī|ಪಲತಡೀ	<i>noun</i><br><ol><li>the opposite bank of a river or lake</li><li>the other side of anything</li></ol>
पळव्चे|palavche|ಪಳವ್ಚೆ|paḷavce	<i>verb</i><br><ol><li>to see, look</li></ol>
पांक|ಪಾಂಕ|pā̃k|pank	<i>noun</i><br><ol><li>a thick syrup prepared by boiling sugar with water</li></ol>
पाच|pach|ಪಾಚ|pāċ	<i>num</i><br><ol><li>five</li></ol>
पात्रांव|pātrā̃v|patranv|ಪಾತ್ರಾಂವ್	<i>noun</i><br><ol><li>boss</li><li>a respectful term of address to a man; equivalent to Hindi साहिब (sāhib) and English sir.</li></ol>
पाद्रि|padri|pādri|ಪಾದ್ರಿ	<i>noun</i><br><ol><li>(Christianity) priest (Christian clergyman who performs masses)</li></ol>
पान|ಪಾನ್|paan|pān	<i>noun</i><br><ol><li>a leaf</li></ol>
पानो|पान्या|पान्याचि|पान्यान्नो|ಪಾನೊ|pānô|पान्याक|पान्यान्चि|पान्याचे|पान्यान|पान्यानि|पान्यान्नि|पान्याचेर|पान्यान्त्ल्यान|पान्यांक|पान्यान्चेर|पान्यान्चे|पान्यात्ल्यान|पान्याचो|पान्यार|पान्यान्चो|पाने|pano	<i>noun</i><br><ol><li>spanner</li></ol>
पाल|ಪಾಲ್|pal|pāl	<i>noun</i><br><ol><li>house gecko</li></ol>
पाव्स|pavs|pāvs|ಪಾವ್ಸ್	<i>noun</i><br><ol><li>rain</li></ol>
पाश्येंस|ಪಾಶ್ಯೆಂಸ್|pāśyẽs|paxiems	<i>noun</i><br><ol><li>patience</li></ol>
पासय|passoim|ಪಾಸಯ್|pāsay	<i>noun</i><br><ol><li>a walk, stroll</li></ol>
पियेव्चे|piyevche|ಪಿಯೆವ್ಚೆ|piyevce	<i>verb</i><br><ol><li>to drink</li></ol>
पिल्लू|pillū|ಪಿಲ್ಲೂ|pillu	<i>noun</i><br><ol><li>the young of an animal</li></ol>
पिळ्चे|piḷce|pillche|ಪಿಳ್ಚೆ	<i>verb</i><br><ol><li>to wring, squeeze</li><li>to twist</li></ol>
पिव्चे|pivce|pivche|ಪಿವ್ಚೆ	<i>verb</i><br><ol><li>to drink</li></ol>
पिसो|piso|ಪಿಸೊ|pisô	<i>adj</i><br><ol><li>mad, crazy</li></ol><br><i>noun</i><br><ol><li>a madman</li></ol>
पीट|pitt|ಪೀಟ|pīṭ	<i>noun</i><br><ol><li>flour</li></ol>
पुनव|ಪುನವ್|punou|punav	<i>noun</i><br><ol><li>the night or day of the full moon</li></ol>
पुरो|puro|purô|ಪುರೊ	<i>particle</i><br><ol><li>enough</li></ol>
पुर्चे|purce|purche|ಪುರ್ಚೆ	<i>verb</i><br><ol><li>to bury</li></ol>
पुर्तुगेज|purtugej	<i>name</i><br><ol><li>Portuguese</li></ol>
पू|pū|pu|ಪೂ	<i>noun</i><br><ol><li>discharge from a wound; pus</li></ol>
पूण|ಪೂಣ್|punn|pūṇ	<i>conj</i><br><ol><li>but, however</li></ol>
पूत|ಪೂತ್|pūt|put	<i>noun</i><br><ol><li>son</li></ol>
पूर्ण|pūrṇ|ಪೂರ್ಣ|poorn	<i>adj</i><br><ol><li>full, entire</li></ol>
पेज|pêz|pez|ಪೆಜ್	<i>noun</i><br><ol><li>rice gruel</li></ol>
पेद्रु|ಪೆದ್ರು|pedru|Pedru	<i>name</i><br><ol><li>(Christianity) Peter (Biblical figure)</li></ol>
पैस|pois|ಪೈಸ್|pais	<i>adj</i><br><ol><li>far, distance</li></ol>
पोंव्चे|povche|põvce|ಪೋವ್ಚೆ	<i>verb</i><br><ol><li>to swim, float</li></ol>
पोदेर|पोदेरान्त्ल्यान|पोदेराचेर|पोदेरान्नि|पोदेरान्चि|ಪೊದೆರ್|पोदेरांक|पोदेरात्ल्यान|पोदेराचो|पोदेरार|पोदेराचि|पोदेरान्नो|पोदेरान्चेर|पोदेरानि|पोदेराक|पोदेराचे|poder|पोदेरान|पोदेरा|पोदेरान्चो|पोदेरान्चे	<i>noun</i><br><ol><li>a baker</li></ol>
पोर|pôr|por|ಪೊರ	<i>noun</i><br><ol><li>a young (of an animal), kid</li></ol>
पोरणें|ponnẽ|pornnem|पोन्नें|ಪೊರಣೆಂ|porṇẽ	<i>adj</i><br><ol><li>old, ancient</li></ol>
पोळी|poḷī|ಪೋಳೀ|polli	<i>noun</i><br><ol><li>a kind of unleavened flatbread</li><li>a kind of sweet bread; a pastry or cake</li></ol>
प्रेम|ಪ್ರೇಮ|prem	<i>noun</i><br><ol><li>love, passion</li><li>affection</li><li>attachment, fondness</li><li>inclination</li></ol>
फाट|fatt|fāṭ|ಫಾಟ್	<i>noun</i><br><ol><li>back (rear of the body)</li></ol>
फातर|fator|fātôr	<i>noun</i><br><ol><li>stone, rock</li></ol>
फुट्चे|fuṭce|futtche|ಫುಟ್ಚೆ	<i>verb</i><br><ol><li>to burst</li><li>to explode</li></ol>
फुडें|fuḍẽ|ಫುಡೆಂ|fuddem|phuḍẽ	<i>adv</i><br><ol><li>ahead, in front, beyond</li><li>later on</li></ol><br><i>postp</i><br><ol><li>ahead, in front, beyond</li></ol>
फेस्त|फेस्ता|फेस्ताचे|फेस्ताचेर|फेस्तार|फेस्तानि|फेस्तान्त्ल्यान|फेस्तान|फेस्तान्चि|फेस्तान्चे|fest|फेस्तान्चो|फेस्ताक|फेस्ताचो|फेस्तान्नो|फेस्ताचि|फेस्तान्चेर|ಫೆಸ್ತ|फेस्तांक|फेस्तान्नि|फेस्तात्ल्यान	<i>noun</i><br><ol><li>any Catholic festival or holiday</li><li>a fair</li></ol>
फोड|fodd|ಫೋಡ್|phoḍ	<i>noun</i><br><ol><li>a boil, an abscess</li></ol>
फोदो|phodo|fodo|ಫೊದೊ	<i>noun</i><br><ol><li>(vulgar) the vulva; cunt</li></ol>
बकें|ಬಕೆಂ|bokem|bakẽ	<i>noun</i><br><ol><li>crane</li></ol>
बरोव्चे|borovche|ಬೊರೊವ್ಚೆ|barovce	<i>verb</i><br><ol><li>to write</li></ol>
बहुतेक|ಬಹುತೇಕ|bahutek|bahutēk	<i>adv</i><br><ol><li>probably, possibly</li></ol>
बांय|baim|ಬಾಂಯ್|bā̃y	<i>noun</i><br><ol><li>a well</li></ol>
बाक|बाकान्चेर|बाकाचि|बाकाक|बाकान्नि|बाकाचे|बाकार|बाकानि|बाकांक|बाकान्चे|ಬಾಕ್|बाकाचेर|बाकाचो|बाकान्नो|bāk|बाकान्त्ल्यान|bak|बाकात्ल्यान|बाकान|बाकान्चि|बाका|बाकान्चो	<i>noun</i><br><ol><li>bench</li></ol>
बाणावली|bāṇāvlī|Bannavli|ಬಾಣಾವಲೀ	<i>name</i><br><ol><li>A village in Goa, India</li></ol>
बापुइ|bapui|ಬಾಪುಇ|bāpui	<i>noun</i><br><ol><li>father</li></ol>
बामण|bāmaṇ|ಬಾಮಣ್|bamonn	<i>noun</i><br><ol><li>Brahmin</li></ol>
बी|ಬೀ|bī|bim	<i>noun</i><br><ol><li>seed, pea</li></ol>
बुराक|ಬುರಾಕ್|burāk|burac	<i>noun</i><br><ol><li>a hole</li></ol>
बेगीन|begin|ಬೆಗೀನ್|begīn	<i>adv</i><br><ol><li>early</li><li>soon</li><li>quickly, rapidly</li></ol>
बेल्लोटि|belloṭi	<i>noun</i><br><ol><li>dhobi tree (Mussaenda frondosa)</li></ol>
बोरोचे|boroche|boroce|ಬೊರೊಚೆ	<i>verb</i><br><ol><li>to write</li></ol>
भंय|bhoim|ಭಂಯ|bhãy	<i>noun</i><br><ol><li>fear, dread</li></ol>
भांगर|bhāṅgar|ಭಾಂಗರ್|bhangor	<i>noun</i><br><ol><li>gold</li></ol>
भाग|bhāg|ಭಾಗ್|bhaag	<i>noun</i><br><ol><li>(formal) part, portion</li></ol>
भाचो|ಭಾಚೊ|भाच्यात्ल्यान|भाच्याचेर|भाच्यान्नो|भाच्यान्चि|भाच्यार|भाच्याचे|भाच्यान्चेर|भाच्या|भाच्याचो|भाच्यान्नि|भाच्यान|भाच्याचि|भाच्यानि|भाच्यांक|भाच्यान्त्ल्यान|भाच्यान्चे|भाचे|bhātsô|भाच्याक|भाच्यान्चो|bhacho	<i>noun</i><br><ol><li>nephew: sibling's son</li></ol>
भाज्चे|bhazche|bhāzce|ಭಾಜ್ಚೆ	<i>verb</i><br><ol><li>to be roasted, baked</li></ol>
भारत|ಭಾರತ|bhārat|Bharot	<i>name</i><br><ol><li>India (a country in South Asia)</li></ol>
भाव|भावान्चेर|भावाचि|भावान|भावांक|ಭಾವ್|भावार|bhāv|भावान्त्ल्यान|भावाचे|bhav|भावाचेर|भावा|भावाक|भावान्नो|भावानि|भावात्ल्यान|भावान्चि|भावान्चे|भावान्नि|भावाचो|भावान्चो	<i>noun</i><br><ol><li>brother</li></ol>
भास|bhās|bhas|ಭಾಸ್	<i>noun</i><br><ol><li>language</li></ol>
भिव्चे|bhivce|bhivche|ಭಿವ್ಚೆ	<i>verb</i><br><ol><li>to fear, dread, be frightened or afraid</li></ol>
भुव|bhuv|ಭುವ್	<i>noun</i><br><ol><li>eyebrow</li></ol>
भेड्डो|beddo|भेड्ड्यान्नि|भेड्ड्याचो|भेड्ड्यान|भेड्ड्यानि|भेड्ड्याचे|भेड्ड्यान्चो|भेड्ड्याक|भेड्ड्या|भेड्ड्यार|ಭೆಡ್ಡೊ|भेड्ड्यांक|bhêḍḍô|भेड्ड्यान्नो|भेड्डे|भेड्ड्यान्चेर|भेड्ड्यान्चे|भेड्ड्यान्चि|भेड्ड्यात्ल्यान|भेड्ड्याचेर|भेड्ड्याचि|भेड्ड्यान्त्ल्यान	<i>adj</i><br><ol><li>deaf</li></ol><br><i>noun</i><br><ol><li>a deaf man</li></ol>
भैण|bhayṇ|bhain|ಭೈಣ	<i>noun</i><br><ol><li>sister</li></ol>
मडगांव|maḍgā̃v|Moddganv|ಮಡಗಾಂವ್	<i>name</i><br><ol><li>Margao (a city in Goa, India)</li></ol>
मडें|maḍẽ|ಮಡೆಂ|moddem	<i>noun</i><br><ol><li>a corpse</li></ol>
मदी|madi|ಮದೀ|madī	<i>adv</i><br><ol><li>in the middle</li></ol>
मनीस|ಮನೀಸ್|monis|manīs	<i>noun</i><br><ol><li>a man</li></ol>
मर्चे|मेलो|ಮರ್ಚೆ|ಮೆಲೆ|morche|ಮೆಲೊ|melo|मेले|marce|mele	<i>verb</i><br><ol><li>to die</li></ol>
मसण|moson|masaṇ|ಮಸಣ್	<i>noun</i><br><ol><li>cremation ground</li><li>(Catholic) cemetery</li></ol>
महाराष्ट्र|Maharaxhttr|ಮಹಾರಾಷ್ಟ್ರ|mahārāṣṭra	<i>name</i><br><ol><li>Maharashtra (a state of India; capital: Mumbai)</li></ol>
मांय|mā̃y|ಮಾಂಯ್|mãi	<i>noun</i><br><ol><li>(Bardez Catholic) a mother</li><li>mother-in-law</li></ol>
माजर|mazor|माज़र|māj̈ar|ಮಾಜ಼ರ್	<i>noun</i><br><ol><li>a cat</li></ol>
माति|ಮಾತಿ|matti|māti	<i>noun</i><br><ol><li>soil, earth</li></ol>
मातें|matem|mātẽ	<i>noun</i><br><ol><li>head</li></ol>
मान|mon|mān|ಮಾನ	<i>noun</i><br><ol><li>back of the neck</li></ol>
मायभास|māybhās	<i>noun</i><br><ol><li>(Catholic) mother tongue</li></ol>
मार्चे|marche|ಮಾರ್ಚೆ|mārce	<i>verb</i><br><ol><li>to beat, hit</li><li>to kill</li></ol>
मालक|mālak	<i>noun</i><br><ol><li>boss, owner</li></ol>
मावशी|माउशी|māvśī|ಮಾಉಶೀ|māuśī|mavxi|ಮಾವಶೀ	<i>noun</i><br><ol><li>maternal aunt</li></ol>
मावु|ಮಾವು|māvu|mavu	<i>noun</i><br><ol><li>father-in-law</li></ol>
मास|maas|mās|ಮಾಸ್	<i>noun</i><br><ol><li>flesh</li></ol>
मासोळी|ಮಾಸೊಳಿ|māsoḷī|masoli	<i>noun</i><br><ol><li>a fish</li></ol>
मिसळ|ಮಿಸಳ|misaḷ|misoll	<i>noun</i><br><ol><li>a popular dish prepared by mixing vegetables, savories and gravy</li></ol>
मूजे|ಮೂಜೆ|mūje|Muje	<i>name</i><br><ol><li>(Christianity) Moses (Biblical figure)</li></ol>
मूट|mut|ಮೂಟ್|mūṭ	<i>noun</i><br><ol><li>fist</li><li>a punch</li></ol>
मूस|मूसात्ल्यान|मूसान्चो|मूसांक|मूसान्चे|मूसानि|मूसाचो|मूसान्त्ल्यान|मूसान्नो|ಮೂಸ್|मूसा|mūs|मूसान|मूसाक|मूसान्चि|mus|मूसाचे|मूसान्चेर|मूसान्नि|मूसाचि|मूसार|मूसाचेर	<i>noun</i><br><ol><li>a housefly or a gnat</li></ol>
मेज्चे|ಮೆಜ್ಚೆ|mezce|mejche	<i>verb</i><br><ol><li>to count, measure</li></ol>
मेण|ಮೆಣ್|meṇ|menn	<i>noun</i><br><ol><li>wax</li></ol>
मेल्लो|mello|melolo|ಮೆಲ್ಲೊ	<i>adj</i><br><ol><li>dead</li></ol>
मेळ्चे|मेळ्टा|meḷṭā|mevtam|ಮೆಳ್ಟಾ|ಮೆಳ್ಚೆ|meḷce|mevchem	<i>verb</i><br><ol><li>to meet</li><li>to be found</li></ol>
मैर|moir|mair|ಮೈರ್	<i>noun</i><br><ol><li>a Muslim person</li></ol>
मोग|ಮೊಗ್|mog	<i>noun</i><br><ol><li>love</li></ol>
मोटे|moṭe	<i>adj</i><br><ol><li>large, fat</li></ol>
मोल|mol|ಮೋಲ್	<i>noun</i><br><ol><li>cost, value</li></ol>
मोव|ಮೊವ್|mov|mou	<i>adj</i><br><ol><li>soft</li></ol>
म्हणून|mhanun|mhaṇūn|ಮ್ಹಣೂನ್	<i>adv</i><br><ol><li>thus, therefore</li></ol>
म्हण्चे|mhaṇce|ಮ್ಹಣ್ಚೆ|mhannche	<i>verb</i><br><ol><li>to say, tell</li></ol>
म्हस|mhos|mhas|ಮ್ಹಸ್	<i>noun</i><br><ol><li>a buffalo</li></ol>
म्हांतारो|mhantaro|म्हांतार्यान्चो|म्हांतार्याचि|म्हांतार्याक|म्हांतार्यान|म्हांतार्यान्नि|म्हांतार्यान्चेर|म्हांतार्यान्नो|mhā̃tārô|म्हांतार्यांक|म्हांतार्याचो|म्हांतारे|म्हांतार्यार|म्हांतार्यानि|म्हांतार्यात्ल्यान|म्हांतार्याचेर|म्हांतार्यान्चे|म्हांतार्या|ಮ್ಹಾಂತಾರೂ|म्हांतार्यान्चि|म्हांतार्याचे|म्हांतार्यान्त्ल्यान	<i>noun</i><br><ol><li>an old man</li></ol>
म्हारग|mhārag|mharog|ಮ್ಹಾರಗ್	<i>adj</i><br><ol><li>expensive</li></ol>
म्होंव|ಮ್ಹೊಂವ್|mhonv|mhõv	<i>noun</i><br><ol><li>honey</li></ol>
येव्चे|āylo|ievchem|आयल्लो|ಆಯಿಲ್ಲೊ|āyllo|ಆಯಲ್ಲೊ|yevce|ailo|āyillo|ಯೆವ್ಚೆ|आयिल्लो|ailolo|ಆಇಲ್ಲೊ|ಆಯಲೊ|आइल्लो|āillo|आयलो	<i>verb</i><br><ol><li>to come</li></ol>
रगत|ರಗತ್|rogot|ragat	<i>noun</i><br><ol><li>blood</li></ol>
रट्टो|रट्ट्यान्चे|raṭṭô|रट्ट्यान्चो|रट्ट्यान्चि|ರಟ್ಟೊ|रट्ट्यानि|रट्ट्यांक|रट्टे|रट्ट्याचेर|रट्ट्यान|रट्ट्यान्नि|रट्ट्यान्चेर|रट्ट्याक|रट्ट्यान्नो|रट्ट्यात्ल्यान|रट्ट्यान्त्ल्यान|रट्ट्याचो|रट्ट्या|रट्ट्याचि|रट्ट्यार|रट्ट्याचे|ratto	<i>noun</i><br><ol><li>arm (the portion of the human appendage between the shoulder and the elbow)</li></ol>
रड्चे|raddce|raḍce|ರಡ್ಚೆ	<i>verb</i><br><ol><li>to cry, weep</li></ol>
रस|ರಸ್|ras|ros	<i>noun</i><br><ol><li>gravy</li></ol>
रांद्चे|ರಾಂದ್ಚೆ|randche|rāndce	<i>verb</i><br><ol><li>to cook food</li></ol>
राखण|ರಾಖಣ್|rakhonn|rākhaṇ	<i>noun</i><br><ol><li>guarding, protection</li></ol>
राजधानी|rājdhānī	<i>noun</i><br><ol><li>capital, capital city</li></ol>
रान|ran|ರಾನ್|rān	<i>noun</i><br><ol><li>forest</li></ol>
रानवटी|rānvaṭī|रानटी|ರಾನವಟೀ|ರಾನಟೀ|rānṭī|ranvotti|rantti	<i>adj</i><br><ol><li>wild</li><li>uncivilized, barbaric</li></ol>
राव्चे|rāvce|ravche|ರಾವ್ಚೆ	<i>verb</i><br><ol><li>to stay, remain</li><li>to inhabit, reside</li></ol>
रित्तें|ರಿತ್ತೆಂ|ritem|rittẽ	<i>adj</i><br><ol><li>empty</li></ol>
रुपें|rupẽ|rupem	<i>noun</i><br><ol><li>silver</li></ol>
रेबेक|rebek	<i>noun</i><br><ol><li>violin</li></ol>
रोग|rōg|rog|ರೋಗ	<i>noun</i><br><ol><li>disease</li></ol>
रोव्चे|rovce|rowche|ರೊವ್ಚೆ	<i>verb</i><br><ol><li>to plant</li></ol>
ऱ|ṛ	<i>character</i><br><ol><li>Used to represent the [ɽ] sound in Konkani. https://omniglot.com/writing/konkani.htm</li></ol>
लग्न|lagn|logon|ಲಗ್ನ	<i>noun</i><br><ol><li>wedding</li></ol>
लज|loz|ಲಜ|laj̈	<i>noun</i><br><ol><li>modesty, shyness, bashfulness</li><li>shame</li><li>embarrassment</li></ol>
लान|laan|lān|ಲಾನ್	<i>adj</i><br><ol><li>small, little</li><li>smooth</li></ol>
लाळ|lāḷ|ಲಾಳ್|lall	<i>noun</i><br><ol><li>slobber</li></ol>
लास्चे|lāsce|lasche|ಲಾಸ್ಚೆ	<i>verb</i><br><ol><li>(intransitive) to burn</li></ol>
लेंव्चे|levnche|ಲೆಂವ್ಚೆ|lễvce	<i>verb</i><br><ol><li>to lick, caress with the tongue</li></ol>
लोक|lok	<i>noun</i><br><ol><li>people</li></ol>
लोणी|lonnim|lōṇī|ಲೋಣೀ	<i>noun</i><br><ol><li>butter</li></ol>
ल्हार|lhār|ಲ್ಹಾರ್|lhar	<i>noun</i><br><ol><li>wave (of water)</li></ol>
वखद|ವಖದ್|vokhod|vakhad	<i>noun</i><br><ol><li>medicine, drug</li></ol>
वच्चे|gelolo|gello|गेल्लो|ಗೆಲೊ|gele|गेले|vacce|गेलो|vachche|gelo|ಗೆಲೆ|ಗೆಲ್ಲೊ	<i>verb</i><br><ol><li>to go</li></ol>
वड|vôḍ	<i>noun</i><br><ol><li>banyan tree, Ficus benghalensis</li></ol>
वत|ವತ್|vot|vat	<i>noun</i><br><ol><li>sunlight</li></ol>
वर्स|voros|vars|ವರ್ಸ್	<i>noun</i><br><ol><li>a year</li></ol>
वा|vā	<i>conj</i><br><ol><li>or</li></ol>
वांज|vānz|vā̃z|ವಾಂಜ್|vanz	<i>adj</i><br><ol><li>(of a woman) infertile, barren, childless</li></ol>
वाट|vāṭ|vaat|ವಾಟ್	<i>noun</i><br><ol><li>way, road, path</li></ol>
वाट्चे|vāṭce|ವಾಟ್ಚೆ|vattche	<i>verb</i><br><ol><li>to distribute</li></ol>
वाडो|वाड्यान्चो|वाड्याक|वाड्यानि|वाड्या|वाड्यान्चे|vado|vāḍô|वाडे|वाड्यात्ल्यान|वाड्याचे|वाड्याचेर|वाड्यान्नो|ವಾಡೊ|वाड्याचो|वाड्याचि|वाड्यांक|वाड्यान्नि|वाड्यान्चि|वाड्यान|वाड्यार|वाड्यान्त्ल्यान|वाड्यान्चेर	<i>noun</i><br><ol><li>neighborhood, alley</li></ol>
विज्ञान|vidian|vidnyān|ವಿಜ್ಞಾನ	<i>noun</i><br><ol><li>science.</li></ol>
विसोर्चे|ವಿಸೊರ್ಚೆ|visorche|visorce	<i>verb</i><br><ol><li>to forget</li></ol>
वीज|viz|vīj|ವೀಜ್	<i>noun</i><br><ol><li>lightning</li></ol>
वीस|vis|ವೀಸ್|vīs	<i>num</i><br><ol><li>twenty</li></ol>
वोंट|vỗṭ|वोंटांक|वोंटाचो|वोंटाक|वोंटाचि|वोंटान्चि|वोंटान्त्ल्यान|वोंटान्नो|वोंटात्ल्यान|वोंटार|ವೊಟ್|वोंटानि|vhot|वोंटा|वोंटान|वोंटाचेर|वोंटाचे|वोंटान्चे|vōṭ|वोंटान्नि|वोंटान्चेर|वोंटान्चो	<i>noun</i><br><ol><li>lip</li></ol>
व्हर्चे|vharce|vharche|ವ್ಹರ್ಚೆ	<i>verb</i><br><ol><li>to take away, carry off</li></ol>
व्हाण|ವ್ಹಾಣ|vhann|vhāṇ	<i>noun</i><br><ol><li>sandal, shoe</li></ol>
व्होड्लें|vhoḍlê|ವ್ಹೊಡ್ಲೆಂ|voddlem	<i>adj</i><br><ol><li>big, great</li><li>elder</li></ol>
शंकर|śaṅkar|ಶಂಕರ್|Xencor	<i>name</i><br><ol><li>(Hinduism) Shiva</li></ol>
शंभर|ಶಂಭರ್|śambhar|xembor	<i>num</i><br><ol><li>hundred</li></ol>
शक्चे|śakce|xakche|ಶಕ್ಚೆ	<i>verb</i><br><ol><li>to be able</li></ol>
शार|śār|xar	<i>noun</i><br><ol><li>city</li></ol>
शिक्चे|xikche|ಶಿಕ್ಚೆ|śikce	<i>verb</i><br><ol><li>to learn</li><li>to study</li></ol>
शिक्षण|ಶಿಕ್ಷಣ|śikṣaṇ|xikxonn	<i>noun</i><br><ol><li>education, learning</li></ol>
शिगमो|Xigmo|ಶಿಗಮೊ|śigmo	<i>name</i><br><ol><li>A Hindu spring festival celebrated in Goa in the month of Phalguna of the Hindu calendar</li></ol>
शिगार|shigar|śigār|ಶಿಗಾರ	<i>noun</i><br><ol><li>cigarette</li></ol>
शिव्चे|śivce|xivche|ಶಿವ್ಚೆ	<i>verb</i><br><ol><li>to sew, stitch</li></ol>
शींग|xing|śīṅg|ಶೀಙ್ಗ	<i>noun</i><br><ol><li>horn (of an animal) (Plural: शिङा (śiṅā))</li></ol>
शींव|xinv|ಶೀಂವ್|śīṃv	<i>noun</i><br><ol><li>a lion</li></ol>
शीत|śīt|ಶೀತ್|xitt	<i>noun</i><br><ol><li>cooked rice</li></ol>
शीतळ|śītaḷ|ಶೀತಳ್|xittol	<i>adj</i><br><ol><li>(poetic, literary) cool, cold</li></ol>
शेंपडी|ximttim|śẽpaḍī|śẽpḍī|ಶೇಪಡೀ	<i>noun</i><br><ol><li>(anatomy) tail</li></ol>
शेजारि|ಶೆಜಾರಿ|xezari|śezāri	<i>noun</i><br><ol><li>neighbor</li></ol>
शेड्डो|xeddom|śêḍḍô|ಶೆಡ್ಡೊ	<i>noun</i><br><ol><li>garden lizard</li></ol>
शेण|ಶೇಣ್|xenn|śeṇ	<i>noun</i><br><ol><li>dung, especially cowdung</li></ol>
शेत|xet|ಶೆತ್|śet	<i>noun</i><br><ol><li>field</li></ol>
श्वास|śvās|ಶ್ವಾಸ|xvas	<i>noun</i><br><ol><li>breath, breathing</li></ol>
स|ಸ|sov|sa/so	<i>num</i><br><ol><li>six</li></ol>
सकाळ|sokall|sakāḷ|ಸಕಾಳ್	<i>noun</i><br><ol><li>morning</li></ol>
सग्ळे|sagḷê|sogle|ಸಗ್ಳೆ	<i>det</i><br><ol><li>all</li></ol><br><i>pron</i><br><ol><li>every one</li></ol>
सत्थे|ಸತ್ಥೆ|satthê|satthe	<i>noun</i><br><ol><li>umbrella</li></ol>
सद्दा|saddā|ಸದ್ದಾ|sodda	<i>adv</i><br><ol><li>every day</li></ol>
सरळ|ಸರಳ್|saraḷ|sorolh	<i>adj</i><br><ol><li>straight</li><li>easy, simple; not complicated</li></ol>
सवणें|savṇẽ|ಸವಣೆಂ|sovnnem	<i>noun</i><br><ol><li>a bird</li></ol>
सांचो|ಸಾಂಚೊ|sancho|sāncô	<i>noun</i><br><ol><li>evening</li></ol>
सांज|sāñj|sanz|ಸಾಂಜ	<i>noun</i><br><ol><li>evening</li></ol>
साक|sāk|ಸಾಕ್|sak	<i>noun</i><br><ol><li>sack, bag</li></ol>
साकळी|sākaḷī|ಸಾಕಳೀ|sakali	<i>noun</i><br><ol><li>a chain</li></ol>
साखळी|sākhḷī|ಸಾಖಳೀ|sankolli	<i>noun</i><br><ol><li>a chain</li></ol>
सातवें|sātvẽ|ಸಾತವೆಂ|satvem	<i>adj</i><br><ol><li>seventh</li></ol>
साव्ळी|sāvḷī|ಸಾವ್ಳೀ|saulli	<i>noun</i><br><ol><li>shade, shadow</li></ol>
सुंगट|ಸುಂಗಟ್|sungat|suṅgaṭ	<i>noun</i><br><ol><li>prawn, shrimp</li></ol>
सुणो|सुण्याक|सुण्याचेर|सुण्यार|सुण्यान|सुण्यान्त्ल्यान|सुण्यान्चे|ಸುಣೊ|सुण्यान्चि|सुण्यान्नो|सुण्यान्चो|suṇô|suno|सुण्यांक|सुण्याचे|सुण्यान्चेर|सुण्याचो|सुण्यान्नि|सुणे|सुण्यात्ल्यान|सुण्याचि|सुण्यानि|सुण्या	<i>noun</i><br><ol><li>dog</li></ol>
सुसेगाद|susegad|ಸುಸೆಗಾದ್|susegād	<i>adv</i><br><ol><li>peacefully, relaxedly</li></ol><br><i>adj</i><br><ol><li>relaxed, calm, laid back, peaceful</li></ol>
सून|sūn|ಸೂನ್|sun	<i>noun</i><br><ol><li>daughter-in-law</li><li>bride</li></ol>
सोंपण|somponn|sõpaṇ|ಸೊಂಪಣ್	<i>noun</i><br><ol><li>stair, step of a staircase</li></ol>
सोंपें|ಸೊಂಪೆಂ|sompem|sỗpễ	<i>adj</i><br><ol><li>easy, simple</li></ol>
सोंसो|सोंस्यांक|सोंस्याक|सोंस्यानि|सोंस्याचेर|सोंस्यान्चे|सोंस्याचो|सोंसे|सोंस्यान्त्ल्यान|सोंस्यान्चि|सोंस्या|सोंस्यान्नो|ಸೊಸೊ|सोंस्यान्चेर|sỗsô|सोंस्याचि|सोंस्यार|सोंस्याचे|सोंस्यान|soso|सोंस्यात्ल्यान|सोंस्यान्नि|सोंस्यान्चो	<i>noun</i><br><ol><li>rabbit</li></ol>
सोबित|sobit|ಸೋಬಿತ್	<i>adj</i><br><ol><li>beautiful, splendid, gorgeous</li></ol>
सोयरो|ಸೊಯರೊ|soiro|soyro	<i>noun</i><br><ol><li>a relative, a kinsman</li></ol>
सोरो|सोर्यात्ल्यान|सोरे|सोर्यान्नो|सोर्यार|सोर्याचि|सोर्याचो|सोर्याक|सोर्यान्नि|सोर्यान्चे|सोर्याचे|सोर्यान्चि|सोर्यानि|सोर्याचेर|ಸೊರೊ|सोर्यान्त्ल्यान|soro|सोर्या|सोर्यान|सोर्यान्चेर|सोर्यान्चो|सोर्यांक	<i>noun</i><br><ol><li>liquor</li></ol>
सोरोप|सोरोपान्त्ल्यान|सोरोपा|सोरोपार|ಸೊರೊಪ್|सोरोपाचि|सोरोपान्चि|सोरोपाक|सोरोपाचेर|सोरोपानि|सोरोपान्चे|सोरोपान्नि|सोरोपान|सोरोपान्चो|सोरोपान्नो|sorop|सोरोपांक|सोरोपान्चेर|सोरोपाचो|सोरोपात्ल्यान|सोरोपाचे	<i>noun</i><br><ol><li>a snake</li></ol>
सोळा|ಸೊಳಾ|sovla|sôḷā	<i>num</i><br><ol><li>sixteen</li></ol>
सोव्चे|sovche|ಸೊವ್ಚೆ|sovce	<i>verb</i><br><ol><li>to swear at, to curse</li></ol>
हांगा|hāṅgā|anga|ಹಂಗಾ	<i>adv</i><br><ol><li>here</li></ol>
हांयस|ಹಾಂಯಸ|hā̃ys|hains	<i>noun</i><br><ol><li>a swan</li></ol>
हांव|म्हका|आमि|ಆಮಿ|म्हझि|आम्ची|म्हझे|आम्चो|आम्च्यान्नि|ಹಾಂವ್|म्हझात्ल्यान|म्हजो|āmi|ami|hā̃v|आम्चे|म्हझेर|आम्चेर|हांवेन|म्हझ्यान|आम्का|hanv|आम्च्यान	<i>pron</i><br><ol><li>I (the first person personal singular pronoun) (Plural: आमि (āmi))</li></ol>
हाग्चे|hāgce|hagche|ಹಾಗ್ಚೆ	<i>verb</i><br><ol><li>to defecate</li></ol>
हाड्चे|hāḍce|haddche|ಹಾಡ್ಚೆ	<i>verb</i><br><ol><li>to bring, to fetch</li></ol>
हात|hāt|ಹಾತ್|hat	<i>noun</i><br><ol><li>(anatomy) hand</li></ol>
हून|hūn|ಹೂನ್|hoon	<i>adj</i><br><ol><li>hot</li></ol>
ಜುನೆಂ	<i>adj</i><br><ol><li>old, ancient, worn out</li><li>जुनें in Goyakanadi (Kannada) script</li></ol>
ಪೊರಣೆಂ	<i>adj</i><br><ol><li>old, ancient</li><li>पोरणें in Goyakanadi (Kannada) script</li></ol>
