Ades	<i>name</i><br><ol><li>Adige (a river in South Tyrol)</li></ol>
Badia	<i>name</i><br><ol><li>A town in South Tyrol</li></ol>
Bulsan	<i>name</i><br><ol><li>Bolzano</li></ol>
Croazia	<i>name</i><br><ol><li>Croatia</li></ol>
Gherdëina	<i>name</i><br><ol><li>Val Gardena</li></ol>
Madona|Madones	<i>noun</i><br><ol><li>(Gherdëina) Madonna, Our Lady</li></ol>
Moroder	<i>name</i><br><ol><li>a Ladin surname.</li></ol>
Nadel	<i>name</i><br><ol><li>Christmas</li></ol>
Senoner	<i>name</i><br><ol><li>a Ladin surname from a farm name (the most common in Gherdëina.</li></ol>
Südtirol	<i>name</i><br><ol><li>South Tyrol (a province of Italy)</li></ol>
Talia	<i>name</i><br><ol><li>Italy</li></ol>
Trentin	<i>name</i><br><ol><li>Trentino</li></ol>
Trënt	<i>name</i><br><ol><li>Trento</li></ol>
Unieja|Uniejes	<i>noun</i><br><ol><li>(Gherdëina) Venice</li></ol>
Val Badia	<i>name</i><br><ol><li>Badia Valley</li></ol>
a	<i>prep</i><br><ol><li>in</li><li>at</li><li>to</li></ol>
aa	<i>noun</i><br><ol><li>farmyard</li><li>threshing floor</li></ol>
abilitazion|abilitazions	<i>noun</i><br><ol><li>qualification</li><li>license</li><li>activation</li></ol>
abitant|abitanć|abitanc	<i>noun</i><br><ol><li>inhabitant</li></ol>
abitazion|abitazions	<i>noun</i><br><ol><li>habitation</li><li>residence</li></ol>
abrogazion|abrogazions	<i>noun</i><br><ol><li>abrogation</li></ol>
abrogaziun|abrogaziuns	<i>noun</i><br><ol><li>abrogation, repeal</li></ol>
academia|academies	<i>noun</i><br><ol><li>academy</li></ol>
acioche	<i>conj</i><br><ol><li>so that, in order that</li></ol>
aconsiadù|aconsiadus	<i>noun</i><br><ol><li>councillor</li></ol>
acordanza|acordanzes	<i>noun</i><br><ol><li>accordance</li></ol>
acrediter|acreditea|acredités|acrediteia|acreditaron|acreditan|acredite|acrediton|acreditassa|acreditedes|acreditasses|acreditasse|acreditovan|acreditova|acredita|acreditove|acredité|acreditaré|acreditassais|acrediteis|acreditarà|acreditareis|acreditede|acreditassan|acreditoves|acreditovais|acrediteda|acredites|acrediteies|acrediteie|acreditaras|avea	<i>verb</i><br><ol><li>To confirm</li><li>To credit</li></ol>
acriticamenter	<i>adv</i><br><ol><li>uncritically</li><li>dogmatically</li></ol>
acritich|acritices|acriticia|acritic	<i>adj</i><br><ol><li>uncritical</li><li>dogmatic</li></ol>
acuisizion|acuisizions	<i>noun</i><br><ol><li>acquisition</li></ol>
acurder|esse|as|aesses|é|acurdaré|acurdaron|areis|ébe|essais|aron|acurdeda|acurdassan|essa|ebes|ovais|ae|acurdé|acurdan|acurdove|arà|acurdeia|acurda|acurdés|aras|esses|abù|acurdes|acurdeis|aveais|acurdoves|acurdea|acurdasses|acurdon|acurdasse|acurdaras|avei|aré|acurdovan|acurdeie|acurdovais|ovan|avean|avee|acurdarà|acurde|on|ebe|acurdareis|acurdassa|acurdede|essan|à|oves|acurdova|aesse|aon|ove|ova|avees|acurdassais|aessan|eis|aessa|acurdeies|aes|aeis|avea|aessais|ombe|aede|eibes|acurdedes|aean	<i>verb</i><br><ol><li>To grant (something to someone)</li></ol>
acusa|acuses	<i>noun</i><br><ol><li>accusation</li></ol>
acuser|esse|as|aesses|é|aean|acusova|acuseis|acusaron|acusovan|acusaras|areis|ébe|acusedes|acuseie|aron|acuses|essa|acusassais|acusassan|ovais|arà|ae|acusasse|ebes|acuson|aras|abù|acuseia|esses|aveais|acusede|aessan|acusove|acusareis|avei|acusa|acusea|acuseda|acusassa|aré|ovan|avean|avee|acusés|ebe|on|acuseies|acusaré|acusoves|essan|à|oves|aesse|aon|acusovais|acuse|acusan|ove|avees|ova|eis|ombe|aessa|eibes|aes|aeis|avea|aessais|acusarà|aede|acusé|essais|acusasses	<i>verb</i><br><ol><li>To acuse</li></ol>
adater|esse|as|adates|é|aesses|adatasses|adateie|areis|adatasse|adataron|adatassan|ébe|adateia|adata|adatareis|aron|adatede|adataré|adatedes|adatovais|ovais|adatassais|arà|ae|ebes|essa|adaté|adatea|aras|esses|abù|aveais|adatoves|adatove|adataras|adatassa|adateies|adatarà|avei|adatovan|aré|ovan|avean|avee|adatés|on|ebe|adate|essan|à|oves|aesse|adateda|aon|ove|avees|ova|aessan|eis|aessa|adaton|adateis|adatova|aeis|avea|aes|ombe|aessais|aede|eibes|adatan|essais|aean	<i>verb</i><br><ol><li>To adapt</li></ol>
adatè	<i>adj</i><br><ol><li>adapted</li></ol>
adecuateza|adecuatezes	<i>noun</i><br><ol><li>adequacy</li></ol>
ademplimënt|ademplimënts	<i>noun</i><br><ol><li>fulfilment</li></ol>
adoter|esse|as|aesses|é|adotaré|adotassais|adoteia|adotoves|areis|adotede|adotaron|adotova|ébe|essais|aron|adotasse|adoteis|essa|ebes|ovais|adotovan|arà|ae|aras|esses|adotés|adoteies|abù|adotarà|aveais|adotove|adotea|adotassa|adota|avei|adotareis|adoteie|adoton|aré|adotes|adotasses|ovan|avean|avee|adoté|on|ebe|adotan|essan|à|adoteda|oves|aesse|aon|ove|adote|avees|ova|adotedes|aessan|adotovais|eis|aessa|aessais|aes|aeis|avea|aede|ombe|adotassan|eibes|adotaras|aean	<i>verb</i><br><ol><li>To adopt</li><li>To choose, select</li></ol>
adotè	<i>adj</i><br><ol><li>adopted</li></ol>
adum	<i>adv</i><br><ol><li>together</li></ol>
adurver|esse|as|adurvova|é|aesses|areis|adurveies|ébe|adurvasse|essais|aron|essa|ebes|ovais|adurvoves|arà|ae|adurveis|aras|adurva|adurvassan|abù|esses|aveais|adurves|adurveie|avei|adurveia|adurvedes|adurvaré|adurvaras|adurvea|aré|adurvon|adurvovan|ovan|avee|adurvove|avean|adurveda|adurvassa|adurvasses|ebe|adurvovais|adurvareis|on|adurvarà|adurvés|essan|à|oves|aesse|aon|ove|ova|adurve|avees|aessan|adurvassais|eis|aessa|eibes|aes|aeis|avea|adurvé|ombe|aessais|aede|adurvan|adurvede|adurvaron|aean	<i>verb</i><br><ol><li>To use, employ</li></ol>
aeroport|aeroporc	<i>noun</i><br><ol><li>airport</li></ol>
afermer|esse|afermés|as|aesses|é|afermeda|aferme|aferman|afermon|afermede|afermedes|afermaras|areis|ébe|afermaré|aron|essa|afermareis|afermassan|ovais|arà|aferma|ae|ebes|afermes|afermoves|aras|esses|abù|aveais|afermarà|afermovan|afermé|afermasses|afermassais|avei|aré|ovan|afermea|avee|avean|afermove|afermasse|on|ebe|afermova|essan|afermeis|afermeie|afermassa|à|oves|aon|ove|afermovais|avees|ova|afermaron|aesse|afermeies|eis|aessa|aessan|aes|afermeia|avea|aeis|ombe|aessais|aede|eibes|essais|aean	<i>verb</i><br><ol><li>To affirm</li></ol>
aga	<i>noun</i><br><ol><li>(Brach) water</li></ol>
agacion	<i>noun</i><br><ol><li>alpine chough</li><li>jackdaw</li></ol>
agreghel|agregheles|agreghela|agreghei	<i>adj</i><br><ol><li>aggregated</li></ol>
agrer|agreres|agrers|agrera	<i>adj</i><br><ol><li>agrarian, agricultural</li></ol>
ai	<i>abbrev</i><br><ol><li>at or to the (+ plural noun)</li></ol>
aisciuda|aisciudes	<i>noun</i><br><ol><li>(Fascian) spring (season)</li></ol>
aisciöda|aisciödes	<i>noun</i><br><ol><li>(Badiot) spring (season)</li></ol>
al	<i>abbrev</i><br><ol><li>Contraction of a l (“at/to the”).</li></ol>
ala	<i>abbrev</i><br><ol><li>at or to the (+ feminine singular noun)</li></ol>
aldò	<i>prep</i><br><ol><li>according to</li></ol><br><i>adj</i><br><ol><li>(Val di Fassa) suitable; adequate; appropriate</li></ol>
ales	<i>abbrev</i><br><ol><li>at the; to the (feminine plural)</li></ol>
alesirer|alesirarà|esse|as|aesses|alesirede|alesiran|é|aean|areis|alesiron|ébe|alesirassa|essais|alesirovan|aron|alesiraré|essa|ebes|alesirasse|ovais|alesires|arà|alesirareis|ae|alesire|alesirovais|aras|alesireies|abù|esses|alesirassan|aveais|alesireis|alesireie|alesireda|avei|alesiroves|alesirova|aré|ovan|avean|avee|alesiraron|alesirassais|alesira|alesiré|ebe|alesireia|on|alesiredes|essan|à|alesirés|alesirasses|oves|aon|ove|ova|avees|aesse|aessan|alesirea|eis|aessa|aessais|aes|aeis|avea|aede|ombe|eibes|alesirove|alesiraras	<i>verb</i><br><ol><li>To facilitate; to help</li></ol>
alimentazion|alimentazions	<i>noun</i><br><ol><li>nutrition</li><li>nourishment</li></ol>
almanco	<i>adv</i><br><ol><li>at least</li></ol>
ambient|ambienc	<i>noun</i><br><ol><li>environment</li></ol>
ambiental|ambientala|ambientei|ambientela|ambientai|ambienteles|ambientales|ambientel	<i>adj</i><br><ol><li>environmental</li></ol>
ambolt|ambolc	<i>noun</i><br><ol><li>(Gherdëina) mayor</li></ol>
aministratif|aministratives|aministrativa|aministratifs	<i>adj</i><br><ol><li>administrative</li></ol>
aministrazion|aministrazions	<i>noun</i><br><ol><li>administration</li></ol>
aministraziun|aministraziuns	<i>noun</i><br><ol><li>administration</li></ol>
amiscion|amisciones	<i>noun</i><br><ol><li>admission, admittance, entrance</li><li>acknowledgement</li></ol>
amnestia|amnesties	<i>noun</i><br><ol><li>amnesty</li></ol>
amnistia|amnisties	<i>noun</i><br><ol><li>amnesty</li></ol>
ampl|amples|ampli|ampla	<i>adj</i><br><ol><li>wide</li><li>ample</li></ol>
an|ani	<i>noun</i><br><ol><li>year</li></ol>
anagrafe|anagrafs	<i>noun</i><br><ol><li>register office</li><li>register of births, marriages and/or deaths</li></ol>
ancunter|esse|as|aesses|é|aean|ancunteie|ancunté|ancuntaras|ancunta|areis|ébe|aron|ancuntés|ancuntassa|essa|ancuntoves|ovais|ae|arà|ancuntaron|ancuntove|ancunteies|ebes|ancunteis|ancuntasse|ancuntovais|ancuntes|ancuntassan|aras|ancuntovan|abù|esses|aveais|ancunteda|ancuntea|ancuntassais|ancuntasses|ancuntan|ancuntova|avei|ancuntede|ancunteia|aré|ovan|avean|avee|on|ebe|essan|ancuntareis|ancuntarà|à|oves|aesse|ancuntedes|aon|ove|avees|ancunte|ova|aessan|eis|aessa|aessais|aes|aeis|avea|aede|ombe|eibes|ancuntaré|essais|ancunton	<i>verb</i><br><ol><li>reconcile</li></ol>
andament|andaments	<i>noun</i><br><ol><li>course</li><li>trend</li></ol>
ann|agn	<i>noun</i><br><ol><li>year</li></ol>
ansciuda|ansciudes	<i>noun</i><br><ol><li>(Gherdëina) spring (season)</li></ol>
anter	<i>prep</i><br><ol><li>through; across; over</li></ol>
anuler|esse|anulassan|as|anuleda|anulova|anulovais|anuleies|é|anulea|aesses|anulassa|areis|anulasses|anularon|ébe|anulasse|aron|anularà|essa|anulovan|ovais|ae|arà|ebes|anuloves|anulareis|anules|anularas|aras|anulé|abù|esses|anuleia|aveais|avei|anulede|anulon|aré|anulove|ovan|avean|anulassais|avee|anularé|ebe|on|anulés|anuledes|anule|anuleie|essan|à|oves|aesse|aon|ove|anula|avees|anuleis|ova|aessan|eis|aessa|eibes|aes|aeis|avea|aessais|ombe|aede|anulan|essais|aean	<i>verb</i><br><ol><li>To annul</li></ol>
aost|aosts	<i>noun</i><br><ol><li>August</li></ol>
apel|apels	<i>noun</i><br><ol><li>appeal</li></ol>
aplicazion|aplicazions	<i>noun</i><br><ol><li>application</li></ol>
aplicher|esse|as|aesses|aplichasses|aplichan|é|aplichassa|aplichede|areis|aplicharon|aplicharas|ébe|aplichasse|aron|aplicheda|essa|ebes|ovais|ae|arà|aplichova|aplichove|aras|esses|aplicheis|aplichovan|abù|aveais|aplichoves|aplichovais|essan|apliches|aplichés|avei|aplichassan|aré|aplichon|aplicharé|ovan|avee|apliche|aplicha|avean|aplicheia|on|ebe|aplichea|aplichassais|avea|aplichedes|à|oves|aplicheie|aesse|aon|aplicharà|aplicheies|ove|avees|ova|aessan|eis|aessa|aessais|aes|aeis|aplichareis|apliché|ombe|aede|eibes|essais|aean	<i>verb</i><br><ol><li>To apply</li></ol>
apost|aposts|aposta|apostes	<i>adj</i><br><ol><li>appropriate</li></ol>
aproer|aproa|esse|as|aesses|é|aproes|aproaré|aproassais|aproassa|aproe|aproeia|areis|ébe|aproovais|aron|aproasses|essa|aproedes|ovais|ae|arà|ebes|aproea|aras|esses|abù|aveais|aproon|aproés|aproan|aessan|avei|aproovan|aproova|aproaras|aré|aproeies|aproé|avee|aproasse|ovan|avean|aproarà|on|ebe|aprooves|aproeis|essan|à|oves|aesse|aon|ove|ova|avees|ombe|aproove|aproede|eis|aessa|aproareis|aproeie|aes|aeis|avea|aessais|aproaron|aede|aproeda|eibes|aproassan|essais|aean	<i>verb</i><br><ol><li>To approve</li></ol>
apurvazion|apurvazions	<i>noun</i><br><ol><li>approval</li></ol>
apurver|esse|as|aesses|é|apurvove|apurveies|apurvasse|apurvan|apurveda|areis|apurva|ébe|essais|aron|essa|ebes|ovais|apurve|arà|ae|apurvaré|apurveis|aras|esses|abù|apurvon|apurveia|apurves|apurvassan|aveais|apurvaron|apurvaras|apurvés|apurvassa|apurveie|avei|aré|apurvovais|apurvoves|ovan|apurvasses|avee|avean|apurvea|apurvede|on|ebe|apurvareis|apurvedes|apurvarà|apurvovan|essan|à|oves|apurvé|aesse|aon|ove|ova|avees|ombe|aessan|eis|aessa|aessais|aes|aeis|avea|aede|apurvassais|eibes|apurvova|aean	<i>verb</i><br><ol><li>To approve</li></ol>
araldich|araldices|araldic|araldicia	<i>adj</i><br><ol><li>heraldic</li></ol>
arbitrat|arbitrac	<i>noun</i><br><ol><li>arbitration</li></ol>
arbitrer|esse|arbitreis|as|aesses|é|aean|arbitrove|arbitrassa|arbitrovais|arbitraron|arbitroves|areis|arbitran|arbitra|ébe|aron|arbitreia|arbitrasses|essa|ebes|ovais|ae|arbitredes|arbitraras|arà|arbitré|arbitreie|arbitre|arbitron|aras|abù|esses|aveais|arbitreda|arbitraré|arbitrede|arbitrassan|arbitrarà|avei|aré|ovan|arbitreies|avee|avean|arbitrassais|on|arbitres|ebe|arbitrovan|essan|à|oves|aesse|aon|ove|ova|avees|ombe|aessan|eis|aessa|arbitrareis|eibes|arbitrea|aeis|avea|aes|arbitrés|aessais|aede|arbitrova|essais|arbitrasse	<i>verb</i><br><ol><li>to arbitrate</li></ol>
arest|arests	<i>noun</i><br><ol><li>stop, standstill</li><li>arrest</li></ol>
arester|esse|arestea|as|aesses|é|aresté|areis|arestasses|arestassan|aresteie|ébe|aresteia|arestasse|arestovan|aron|essa|arestassa|ovais|ae|arà|aresta|ebes|arestova|arestede|arestes|aras|esses|abù|arestovais|aveais|arestarà|areston|arestaron|aessan|arestove|aresteies|avei|aré|arestés|ovan|arestassais|avee|avean|aresteis|on|ebe|arestaras|aresteda|essan|à|oves|arestedes|aon|ove|areste|arestan|avees|arestareis|ova|eis|aesse|arestaré|arestoves|aes|aeis|avea|aessa|ombe|aessais|aede|eibes|essais|aean	<i>verb</i><br><ol><li>to halt, stop</li><li>to arrest, detain</li></ol>
arjonjer|arjonjovan|esse|as|aesses|é|arjonjon|arjonje|arjonjes|areis|arjonjessa|ébe|arjonjovais|aron|arjonjova|essa|ebes|arjont|arjonjoves|arjonjessais|ovais|arà|ae|aras|esses|abù|aveais|arjonjessan|arjonjaron|arjonjaré|arjonjeis|arjonjarà|avei|arjonj|aré|arjonjesse|ovan|avean|arjonjede|avee|on|ebe|arjonjan|arjonjù|arjonjareis|essan|à|oves|aesse|aon|arjonjove|ove|avees|ova|aessan|arjonjaras|eis|aessa|aessais|aes|aeis|avea|aede|ombe|arjonjesses|eibes|essais|aean	<i>verb</i><br><ol><li>To reach</li><li>To attain</li></ol>
armed|armeda|armedes|armeds	<i>adj</i><br><ol><li>armed</li></ol>
arment	<i>noun</i><br><ol><li>cattle</li></ol>
armonisazion|armonisazions	<i>noun</i><br><ol><li>harmonization</li></ol>
armunia	<i>noun</i><br><ol><li>harmony</li></ol>
arpejon|arpejons	<i>noun</i><br><ol><li>heredity</li></ol>
artejanat|artejanats	<i>noun</i><br><ol><li>craft</li><li>craftsman; artisan</li></ol>
articul|articuli|articui	<i>noun</i><br><ol><li>article</li></ol>
artistisch|artistisc|artistischs|artistisches|artistischa|artistisces|artistiscia	<i>adj</i><br><ol><li>artistic</li></ol>
asil	<i>noun</i><br><ol><li>shelter, refuge, asylum</li></ol>
assegurazion|assegurazions	<i>noun</i><br><ol><li>assurance</li><li>insurance</li></ol>
assegurer|esse|as|aesses|é|assegurareis|assegureie|assegures|areis|assegurés|asseguré|ébe|assegurassais|assegurassan|assegurassa|assegureia|aron|essa|ebes|ovais|assegurovan|asseguron|arà|ae|assegura|aras|esses|asseguran|assegureies|abù|assegure|aveais|asseguraré|aessan|asseguraras|avei|assegurea|assegurarà|aré|ovan|avean|assegurasses|avee|on|assegurove|ebe|assegurasse|essan|à|oves|assegureda|assegurova|aon|ove|ova|asseguraron|avees|assegurovais|aesse|asseguredes|eis|aessa|eibes|aes|aeis|avea|aessais|ombe|asseguroves|assegureis|assegurede|aede|essais|aean	<i>verb</i><br><ol><li>To assure</li><li>To ensure</li><li>To insure</li></ol>
assemblea|assemblees	<i>noun</i><br><ol><li>assembly</li></ol>
asseniazion|asseniazions	<i>noun</i><br><ol><li>allocation</li><li>assignment</li></ol>
assenier|esse|as|asseniede|é|aean|asseniove|aesses|assenieies|asseniareis|asseniasses|assenieie|areis|ébe|aron|asseniova|essa|asseniassan|ovais|asseniovais|arà|ae|ebes|asseniés|assenia|asseniea|aras|asseniarà|assenie|abù|esses|aveais|assenieda|assenié|assenion|avei|assenioves|aré|ovan|avean|assenies|avee|assenian|asseniaré|on|ebe|assenieis|asseniovan|essan|à|assenieia|oves|asseniasse|aon|ove|ova|avees|aesse|aessan|asseniaras|asseniaron|eis|aessa|aessais|aes|aeis|avea|aede|ombe|asseniedes|eibes|asseniassa|essais|asseniassais	<i>verb</i><br><ol><li>To assign; to award; to allocate</li></ol>
assistenza|assistenzes	<i>noun</i><br><ol><li>assistance</li></ol>
assolut|assoluts|assolutes|assoluta	<i>adj</i><br><ol><li>absolute</li></ol>
assoziazion|assoziazions	<i>noun</i><br><ol><li>association</li></ol>
assozied|assoziedes|assozieds|assozieda	<i>adj</i><br><ol><li>associated</li></ol>
assunzion|assunzions	<i>noun</i><br><ol><li>employment</li><li>engagement</li><li>assumption</li></ol>
at|ac	<i>noun</i><br><ol><li>act</li><li>action</li><li>work</li></ol>
atentat|atentac	<i>noun</i><br><ol><li>attack</li></ol>
atif|atifs|atives|ativa	<i>adj</i><br><ol><li>active</li></ol>
ativamenter	<i>adv</i><br><ol><li>actively</li></ol>
atività|ativiteies	<i>noun</i><br><ol><li>activity</li></ol>
atribuir|esse|as|aesses|é|atribu|atribuireis|atribuissa|areis|atribue|ébe|aron|atribuesce|essa|ebes|ovais|atribuide|arà|ae|atribues|atribuieis|atribuiré|atribuissan|aras|atribuiva|abù|esses|aveais|atribuirà|atribuesces|atribuesc|atribuisse|avei|aré|ovan|atribuì|avee|avean|atribuion|atribuivais|atribuiron|on|atribuian|ebe|atribuives|essan|à|oves|aesse|aon|ove|ova|atribuiras|atribuisses|avees|ombe|eis|aessa|atribuissais|aessan|aes|aeis|avea|aessais|atribuivan|aede|eibes|atribuive|essais|aean	<i>verb</i><br><ol><li>to attribute</li><li>to award</li></ol>
atribuzion|atribuzions	<i>noun</i><br><ol><li>attribution</li></ol>
atuazion|atuazions	<i>noun</i><br><ol><li>implementation</li><li>application</li></ol>
atuer|esse|as|atuedes|atuovais|é|aesses|atues|atuasse|atuaras|atueda|areis|atua|ébe|aron|atués|atueia|ovais|ae|arà|ebes|atuede|essa|atuova|atuassan|aras|esses|atuareis|atuove|atuassa|abù|aveais|atue|atué|atuea|atuon|avei|atueis|aré|atuovan|ovan|avean|avee|atuarà|ebe|on|atuasses|atuan|atuaré|essan|à|oves|aesse|aon|atuoves|ove|avees|ova|aessan|eis|aessa|atueie|atuaron|atuassais|aeis|avea|aes|ombe|aessais|aede|eibes|atueies|essais|aean	<i>verb</i><br><ol><li>To implement or carry out</li></ol>
aucat|aucac	<i>noun</i><br><ol><li>lawyer, solicitor</li><li>advocate</li></ol>
aurela	<i>noun</i><br><ol><li>(Gherdëina) spare time, free time</li></ol>
ausilier|ausilieres|ausiliers|ausiliera	<i>adj</i><br><ol><li>auxiliary</li></ol>
aussei|aussaras|aussù|aussovais|ausseis|aussovan|aussessa|aussa|aussarà|aussessais|aussareis|aussesses|aussove|ausses|ausse|ausser|aussaron|aussé|aussoves|aussesse|aussan|aussessan|aussaré|auss|ausson	<i>verb</i><br><ol><li>To accustom</li><li>To be wont to</li><li>To use</li></ol>
aut|autes|auta|auc	<i>adj</i><br><ol><li>high</li></ol>
auter|autres|autri|autra	<i>adj</i><br><ol><li>other</li><li>previous</li></ol>
autonom|autonomes|autonoma|autonoms	<i>adj</i><br><ol><li>autonomous</li></ol>
autonomamënter	<i>adv</i><br><ol><li>autonomously</li><li>independently</li></ol>
autonomia|autonomies	<i>noun</i><br><ol><li>autonomy</li></ol>
autorisazion|autorisazions	<i>noun</i><br><ol><li>authorization</li></ol>
autoriser|esse|as|aesses|é|autorisasse|autorisa|autorison|areis|ébe|aron|autoriseie|essa|ebes|ovais|ae|arà|autorisova|aras|esses|abù|autorisaras|autorisasses|autorisea|aveais|autorisareis|autorisassa|autorisove|autorisan|avei|autorises|autoriseda|autorisede|autorisovais|autorisassan|aré|ovan|avean|autorisés|autorisarà|autorisoves|avee|autorise|autorisedes|ebe|on|autoriseies|autorisé|avea|essan|à|oves|autoriseia|autorisassais|aon|autorisaron|ove|avees|ova|aesse|aessan|autoriseis|autorisaré|eis|aessa|aes|aeis|autorisovan|aessais|ombe|aede|eibes|essais|aean	<i>verb</i><br><ol><li>to authorize</li></ol>
autorità|autoriteies	<i>noun</i><br><ol><li>authority</li></ol>
autr|autri|autres|autra	<i>adj</i><br><ol><li>other, another</li></ol>
autramenter	<i>adv</i><br><ol><li>otherwise</li><li>differently</li></ol>
autro|autri|autres|autra	<i>adj</i><br><ol><li>other</li></ol>
avei|esse|as|aesses|é|areis|ébe|aron|essa|ebes|ovais|ae|arà|aras|esses|abù|aveais|aré|ovan|avean|avee|on|ebe|essan|à|oves|aesse|aon|ove|ova|avees|aessan|eis|aessa|aessais|aes|aeis|avea|aede|ombe|eibes|essais|aean	<i>verb</i><br><ol><li>(Mareo, Livinallongo) to have</li></ol>
avisé	<i>verb</i><br><ol><li>(Gherdëina) to drive (a wheeled motorized vehicle)</li></ol>
avocat|avocac	<i>noun</i><br><ol><li>lawyer, solicitor</li><li>advocate</li></ol>
avëi	<i>verb</i><br><ol><li>(Badia, Val Gardena) Alternative form of avei</li></ol>
azertamënt|azertamënc	<i>noun</i><br><ol><li>verification</li><li>assessment</li></ol>
azerter|esse|as|aesses|azerteia|é|azertovais|azertoves|areis|azertasse|azertova|azerteis|ébe|azertove|aron|essa|ebes|ovais|ae|arà|azertaras|azerta|azertareis|azerton|azertaré|aras|esses|azertede|azerteie|abù|azerte|aveais|azertasses|azertan|azerteda|avei|azertassa|azerté|azertes|aré|ovan|avean|avee|azertarà|azertaron|azerteies|ebe|on|azertés|azertassan|avea|essan|à|oves|aesse|aon|ove|ova|avees|ombe|aessan|eis|aessa|azertea|aes|azertedes|azertassais|aeis|azertovan|aessais|aede|eibes|essais|aean	<i>verb</i><br><ol><li>To assess</li><li>To verify, check</li></ol>
azess	<i>noun</i><br><ol><li>access</li></ol>
azessibl|azessibli|azessibles|azessibla	<i>adj</i><br><ol><li>accessible</li></ol>
azetazion|azetazions	<i>noun</i><br><ol><li>acceptance</li></ol>
azienda|aziendes	<i>noun</i><br><ol><li>firm, company, business</li></ol>
azion|azions	<i>noun</i><br><ol><li>action</li><li>effect</li><li>activity</li></ol>
aziuner|aziuners|aziunera|aziuneres	<i>adj</i><br><ol><li>stock, share (attributive)</li></ol>
ać	<i>noun</i><br><ol><li>act</li></ol>
balé	<i>verb</i><br><ol><li>(Gherdëina) to dance</li></ol>
bandiera	<i>noun</i><br><ol><li>flag</li></ol>
barancio|barance	<i>noun</i><br><ol><li>(Anpezan) mountain pine (Pinus mugo)</li></ol>
baroch|baroges|barogia|barocs	<i>adj</i><br><ol><li>baroque</li></ol>
basa	<i>noun</i><br><ol><li>base</li></ol>
becalen fosch	<i>noun</i><br><ol><li>black woodpecker</li></ol>
becalen gran	<i>noun</i><br><ol><li>great spotted woodpecker</li></ol>
belora	<i>noun</i><br><ol><li>weasel, least weasel</li></ol>
ben|bens|miec	<i>adv</i><br><ol><li>well</li><li>properly</li></ol><br><i>noun</i><br><ol><li>(especially in the plural) goods, property</li></ol>
berba|berbes|berbesc	<i>noun</i><br><ol><li>(Gherdëina) beard</li><li>(Gherdëina) uncle</li><li>mister (title of adult male)</li><li>man (adult male)</li><li>gentleman (well-mannered man)</li></ol>
berdon|berdons	<i>noun</i><br><ol><li>(Gherdëina) cloth, polishing cloth, cleaning cloth, rag, cleaning rag</li></ol>
berdon da fonz|berdons da fonz	<i>noun</i><br><ol><li>(Gherdëina) floorcloth</li></ol>
biescia|biesces	<i>noun</i><br><ol><li>(Gherdëina) sheep</li></ol>
bigul|biguli	<i>noun</i><br><ol><li>(Gherdëina, esp. Urtijëi) sweet (UK), candy (US)</li><li>(Gherdëina, esp. Sëlva, S. Crestina) penis</li></ol>
bilanz|bilanc	<i>noun</i><br><ol><li>balance sheet, balance, budget</li><li>assessment, result</li></ol>
bisont european	<i>noun</i><br><ol><li>European bison, wisent</li></ol>
blanch	<i>adj</i><br><ol><li>white</li></ol>
bo salvare	<i>noun</i><br><ol><li>buffalo</li></ol>
bolp|bolpes	<i>noun</i><br><ol><li>(Gherdëina) fox</li></ol>
bon|bona|bons|bones	<i>adj</i><br><ol><li>able</li><li>good</li><li>probable</li></ol>
bon Nadel	<i>phrase</i><br><ol><li>Merry Christmas</li></ol>
bonamenter	<i>adv</i><br><ol><li>easily</li><li>likely, probably</li></ol>
bonificazion|bonificazions	<i>noun</i><br><ol><li>reclamation</li></ol>
bosch|bòsc	<i>noun</i><br><ol><li>(Gherdëina) wood, forest</li></ol>
brama|brames	<i>noun</i><br><ol><li>(Gherdëina) cream (of milk)</li></ol>
brascion|brascioi	<i>noun</i><br><ol><li>(Anpezan) tree</li></ol>
brum|bruma|brums|brumes	<i>adj</i><br><ol><li>(Gherdëina) blue</li></ol><br><i>noun</i><br><ol><li>(Gherdëina) blue</li></ol>
bujën|bujëns	<i>noun</i><br><ol><li>requirement, need, necessity</li></ol>
ca	<i>adv</i><br><ol><li>(Gherdëina) hither, to this place, to here, to me/us</li></ol>
caia	<i>noun</i><br><ol><li>quail</li></ol>
cajo|caji	<i>noun</i><br><ol><li>case, circumstance</li><li>(Val di Fassa) chance; fate</li></ol>
calighé|caligheies	<i>noun</i><br><ol><li>(Gherdëina) cobbler, shoemaker</li></ol>
camera|cameres	<i>noun</i><br><ol><li>chamber, room</li></ol>
canche	<i>adv</i><br><ol><li>barely, hardly</li><li>just, recently</li><li>when</li></ol>
capazità|capaziteies	<i>noun</i><br><ol><li>capacity</li></ol>
capir|capisse|capieis|esse|capirà|as|aesses|é|capives|capiva|capivais|capiras|areis|cape|capiré|capion|ébe|aron|essa|ebes|ovais|ae|arà|capissan|aras|esses|capive|abù|aveais|capesc|capissa|avei|capisses|aré|ovan|avean|avee|capissais|cap|on|ebe|capian|capide|essan|capireis|à|capesces|oves|aesse|capes|capesce|aon|ove|avees|capì|ova|eis|aessa|aessan|aessais|capiron|aeis|avea|aes|ombe|aede|eibes|capivan|essais|aean	<i>verb</i><br><ol><li>to understand</li></ol>
capitela|capiteles	<i>noun</i><br><ol><li>capital</li></ol>
capoluech	<i>noun</i><br><ol><li>capital (administrative centre)</li></ol>
caranta	<i>adj</i><br><ol><li>forty</li></ol><br><i>noun</i><br><ol><li>forty</li></ol>
carantecater	<i>adj</i><br><ol><li>forty-four</li></ol><br><i>noun</i><br><ol><li>forty-four</li></ol>
carantecinch	<i>adj</i><br><ol><li>forty-five</li></ol><br><i>noun</i><br><ol><li>forty-five</li></ol>
carantedoes	<i>adj</i><br><ol><li>forty-two</li></ol><br><i>noun</i><br><ol><li>forty-two</li></ol>
carantenuef	<i>adj</i><br><ol><li>forty-nine</li></ol><br><i>noun</i><br><ol><li>forty-nine</li></ol>
caranteset	<i>adj</i><br><ol><li>forty-seven</li></ol><br><i>noun</i><br><ol><li>forty-seven</li></ol>
carantesies	<i>adj</i><br><ol><li>forty-six</li></ol><br><i>noun</i><br><ol><li>forty-six</li></ol>
carantetrei	<i>adj</i><br><ol><li>forty-three</li></ol><br><i>noun</i><br><ol><li>forty-three</li></ol>
carantot	<i>adj</i><br><ol><li>forty-eight</li></ol><br><i>noun</i><br><ol><li>forty-eight</li></ol>
carantun	<i>adj</i><br><ol><li>forty-one</li></ol><br><i>noun</i><br><ol><li>forty-one</li></ol>
carater|caraters	<i>noun</i><br><ol><li>character</li></ol>
carateristich|carateristicia|carateristic|carateristices	<i>adj</i><br><ol><li>characteristic</li></ol>
cariera|carieres	<i>noun</i><br><ol><li>career</li></ol>
cassa|casses	<i>noun</i><br><ol><li>case, crate</li><li>cash register, cash desk</li><li>fund (of money)</li></ol>
cassazion|cassazions	<i>noun</i><br><ol><li>cassation</li></ol>
castour	<i>noun</i><br><ol><li>beaver</li></ol>
categoria|categories	<i>noun</i><br><ol><li>category</li></ol>
cater	<i>adj</i><br><ol><li>four</li></ol><br><i>noun</i><br><ol><li>four</li></ol>
catolich|catolic|catolices|catolicia	<i>adj</i><br><ol><li>catholic / Catholic</li></ol>
catordesc	<i>adj</i><br><ol><li>fourteen</li></ol><br><i>noun</i><br><ol><li>fourteen</li></ol>
cerf	<i>noun</i><br><ol><li>deer</li></ol>
cert|certes|certa|certs	<i>adj</i><br><ol><li>certain</li><li>some</li></ol>
cesa|ceses	<i>noun</i><br><ol><li>home</li><li>house</li></ol>
che	<i>conj</i><br><ol><li>that</li></ol>
cheder|cheders	<i>noun</i><br><ol><li>ambit, scope</li></ol>
chel|chela|chël|chei|chëi|cheles|chëla|chëles	<i>adj</i><br><ol><li>which</li><li>what</li></ol>
chelner|chelneri|chelerin	<i>noun</i><br><ol><li>(Gherdëina) waiter</li></ol>
chemun|chemuns	<i>noun</i><br><ol><li>commune</li></ol>
cherder|foves|sun|saras|sies|ae|fova|fovan|cherdede|fosse|abù|esses|cherdovais|cherdoves|cherdés|fossais|saré|ebe|cherdea|à|ove|avees|ombe|cherdove|aessa|cherdes|cherdareis|ies|essais|esse|as|aesses|cherdovan|saron|aron|fossan|cherdeia|ester|cherdeie|cherdedes|on|sede|stedes|ova|sian|seis|aes|eibes|essan|sareis|cherdassais|essa|ebes|fovais|fossa|arà|steda|aras|sarà|cherdaras|avei|stés|aré|cherdeies|ovan|avean|cherdaron|oves|aon|fove|cherdeis|aessais|sie|cherdan|aean|é|sté|fosses|areis|cherdassa|cherdova|ébe|cherda|ovais|cherdasse|aveais|cherdasses|avee|son|cherdarà|aesse|aessan|cherdon|cherdé|cherdeda|eis|aede|aeis|avea|cherde|cherdassan|cherdaré	<i>verb</i><br><ol><li>To call</li></ol>
chest|chestes|chisc|chesta	<i>adj</i><br><ol><li>this</li><li>(in the plural) these</li></ol>
chetù	<i>adv</i><br><ol><li>(colloquial, Gherdëina) right?; is it?; is it not?</li></ol>
chi	<i>pron</i><br><ol><li>who, whoever</li></ol>
chibl|chibli	<i>noun</i><br><ol><li>(Gherdëina) bucket, bin</li></ol>
chindesc	<i>adj</i><br><ol><li>fifteen</li></ol><br><i>noun</i><br><ol><li>fifteen</li></ol>
chisc	<i>adj</i><br><ol><li>such</li></ol>
chécen|chécegn|chéces|chéca	<i>adj</i><br><ol><li>(Fascian) red</li></ol>
chésto|chésti|chéstes|chésta	<i>adj</i><br><ol><li>this</li></ol>
chëifer|chëifri	<i>noun</i><br><ol><li>(Gherdëina) beetle</li></ol>
chëifer dala lum|chëifri dala lum	<i>noun</i><br><ol><li>(Gherdëina) firefly, glowworm</li></ol>
chëifer dla Madona|chëifri dla Madona	<i>noun</i><br><ol><li>(Gherdëina) ladybird, ladybug</li></ol>
chësc|chisc|chësta|chëscs|chëstes	<i>adj</i><br><ol><li>this</li><li>such</li></ol>
chësto|chësti|chësta|chëstes	<i>adj</i><br><ol><li>this</li></ol>
ciamorc	<i>noun</i><br><ol><li>chamois (goat)</li></ol>
ciamp|ciamps	<i>noun</i><br><ol><li>field (all senses)</li></ol>
cian|cians	<i>noun</i><br><ol><li>dog</li></ol>
ciancané|ciancaneda|ciancanedes|ciancaneisc	<i>adj</i><br><ol><li>(Gherdëina) left-handed</li></ol>
cianter|esse|as|aesses|é|ciantareis|cianteies|cianton|ciante|areis|ciantoves|ébe|aron|ciantasse|ciantede|ciantovais|cianta|ebes|ovais|ciantarà|cianteis|arà|ae|ciantaron|cianté|ciantassa|cianteie|ciantova|aras|abù|cianteda|ciantove|esses|aveais|ciantaras|essa|ciantés|avei|ciantedes|ciantasses|aré|ciantovan|ciantes|ciantassan|ovan|avean|avee|ciantassais|ciantan|ebe|on|essan|à|oves|ciantea|aesse|aon|ove|ova|avees|aessan|eis|aessa|aessais|aes|cianteia|avea|aeis|ombe|aede|eibes|ciantaré|essais|aean	<i>verb</i><br><ol><li>To sing</li></ol>
cincanta	<i>adj</i><br><ol><li>fifty</li></ol><br><i>noun</i><br><ol><li>fifty</li></ol>
cincantecater	<i>adj</i><br><ol><li>fifty-four</li></ol><br><i>noun</i><br><ol><li>fifty-four</li></ol>
cincantecinch	<i>adj</i><br><ol><li>fifty-five</li></ol><br><i>noun</i><br><ol><li>fifty-five</li></ol>
cincantedoes	<i>adj</i><br><ol><li>fifty-two</li></ol><br><i>noun</i><br><ol><li>fifty-two</li></ol>
cincantenuef	<i>adj</i><br><ol><li>fifty-nine</li></ol><br><i>noun</i><br><ol><li>fifty-nine</li></ol>
cincanteset	<i>adj</i><br><ol><li>fifty-seven</li></ol><br><i>noun</i><br><ol><li>fifty-seven</li></ol>
cincantesies	<i>adj</i><br><ol><li>fifty-six</li></ol><br><i>noun</i><br><ol><li>fifty-six</li></ol>
cincantetrei	<i>adj</i><br><ol><li>fifty-three</li></ol><br><i>noun</i><br><ol><li>fifty-three</li></ol>
cincantot	<i>adj</i><br><ol><li>fifty-eight</li></ol><br><i>noun</i><br><ol><li>fifty-eight</li></ol>
cincantun	<i>adj</i><br><ol><li>fifty-one</li></ol><br><i>noun</i><br><ol><li>fifty-one</li></ol>
cinch	<i>adj</i><br><ol><li>five</li></ol><br><i>noun</i><br><ol><li>five</li></ol>
ciol|cioi	<i>noun</i><br><ol><li>(Gherdëina) belt (band worn around the waist)</li></ol>
ciun|ciugn|ciuna|ciunes	<i>adj</i><br><ol><li>what, which</li></ol>
co	<i>conj</i><br><ol><li>than (used in comparisons)</li></ol><br><i>adv</i><br><ol><li>how (in what manner)</li><li>how (in what state)</li></ol>
coche	<i>adv</i><br><ol><li>how (in what manner)</li><li>as, like</li></ol>
cochemei	<i>conj</i><br><ol><li>however, whatever</li></ol>
coesion|coesions	<i>noun</i><br><ol><li>cohesion</li></ol>
cogner|cognasse|é|cogne|foves|cognove|sté|fosses|sareis|cogn|cogneies|sun|saron|saras|cognés|sies|cognasses|fovais|fossa|cogna|fova|fossan|fovan|cogné|ester|steda|fosse|cognassa|cognea|cognassais|cognarà|sarà|cognassan|cognan|fossais|cognovan|stés|cognaron|cognoves|saré|cognedes|cognaré|cogneie|cogneia|cognaras|cogneda|sede|cognareis|cognovais|son|cognede|stedes|cognova|sian|fove|seis|sie|cognon|cogneis|ies|cognei|cognes	<i>verb</i><br><ol><li>to have to; must</li></ol>
colegialmënter	<i>adv</i><br><ol><li>corporately (as a body or group)</li></ol>
coma|comes	<i>noun</i><br><ol><li>(Val di Fassa, law) subsection</li><li>(Val di Fassa, orthography) comma</li></ol>
componënt|componënć	<i>noun</i><br><ol><li>component</li></ol>
comprer|esse|comprassan|as|aesses|é|compran|compreies|compra|comprova|areis|comprove|comprassa|ébe|compreie|comprovais|aron|compres|essa|ebes|ovais|ae|arà|aras|esses|abù|aveais|compreis|comprasses|aessan|compredes|compreda|comprovan|avei|compraron|aré|comprea|compreia|compraré|ovan|avee|avean|comproves|on|compre|ebe|comprareis|compré|avea|essan|à|oves|compraras|comprede|aon|ove|avees|ova|comprassais|aesse|comprasse|eis|aessa|eibes|aes|aeis|comprés|aessais|ombe|aede|compron|comprarà|essais|aean	<i>verb</i><br><ol><li>To purchase, buy</li></ol>
comunicazion|comunicazions	<i>noun</i><br><ol><li>communication</li></ol>
comunicher|esse|as|aesses|é|comunichassais|comunichede|areis|comunichon|comunichassan|comunicharà|comunichoves|comunicha|comunichove|ébe|essais|comunicharon|comuniches|comunichareis|aron|essa|ebes|ovais|ae|comunicharé|arà|comunichovan|comunicharas|comunichan|comunichés|comunicheis|aras|comunichasses|abù|esses|comunichassa|aveais|comunichedes|avei|aré|ovan|avean|avee|comunichea|on|comunicheda|ebe|comunichasse|comunichova|comuniche|essan|à|oves|aesse|aon|ove|ova|avees|aessan|comunicheie|comunicheies|eis|aessa|aessais|aes|aeis|avea|comuniché|ombe|comunicheia|aede|eibes|comunichovais|aean	<i>verb</i><br><ol><li>To communicate</li></ol>
comuniter|comuniteres|comuniters|comunitera	<i>adj</i><br><ol><li>community (attributive)</li></ol>
comunité|comunités	<i>noun</i><br><ol><li>community (a group sharing a common understanding)</li></ol>
con	<i>prep</i><br><ol><li>with</li></ol>
concors	<i>noun</i><br><ol><li>contest (competition)</li></ol>
concurent|concurentes|concurenc|concurenta	<i>adj</i><br><ol><li>concurrent</li></ol>
concurenza|concurenzes	<i>noun</i><br><ol><li>competition (commercial rivalry)</li></ol>
condujer|esse|condujessais|as|aesses|é|aede|condujaras|areis|condujesse|condujon|condujareis|ébe|aron|essa|condujove|ovais|ae|arà|ebes|aras|esses|abù|conduj|condujaron|condujede|condujaré|condut|aveais|avei|condujan|aré|condujessan|condujessa|ovan|avee|avean|condujeis|on|conduje|ebe|essan|à|oves|aesse|aon|ove|condujovan|condujova|condujovais|avees|condujoves|eis|ova|aessa|aessan|condujarà|aeis|avea|aes|ombe|condujes|condujesses|eibes|aessais|essais|aean	<i>verb</i><br><ol><li>To lead, conduct</li></ol>
consulenza|consulenzes	<i>noun</i><br><ol><li>consultancy</li><li>advice</li></ol>
consuler|consuleres|consulers|consulera	<i>adj</i><br><ol><li>consular</li></ol>
cont|conc|contessa|conts|contesses	<i>noun</i><br><ol><li>(Val di Fassa) calculation; computation</li><li>(Val di Fassa) counting</li><li>(Val di Fassa) count (male ruler of a county)</li></ol>
contra	<i>prep</i><br><ol><li>against</li></ol>
contrasotscrit|contrasotscric	<i>noun</i><br><ol><li>countersignature</li></ol>
cooperazion|cooperazions	<i>noun</i><br><ol><li>cooperation</li></ol>
coordener|coordinovais|coordinasse|coordenés|coordenaras|coordinedes|coordineia|coordina|ae|esses|abù|coordineie|coordeneda|coordenarà|coordenassais|coordiner|ebe|coordenede|à|coordinova|ove|avees|aessa|coordinaré|essais|esse|as|aesses|coordinan|coordenova|aron|coordenes|coordiné|coordenassan|coordenaré|on|coordenedes|coordenareis|ova|aes|coordineies|essan|eibes|coordenan|coordinovan|coordenovais|coordenasse|coordineda|coordinasses|coordinoves|coordenaron|essa|ebes|arà|coordinaron|aras|coordinove|coordenoves|avei|coordenasses|coordeneies|aré|ovan|avean|coordinea|coordinon|coordinarà|coordinareis|coordines|oves|aon|coordenon|aessais|coordene|aean|é|coordenassa|coordenea|areis|ébe|coordine|coordinassan|ovais|coordinassais|coordené|coordeneia|aveais|coordineis|coordinaras|coordena|coordeneie|coordenove|coordinassa|coordenovan|coordinés|avee|aesse|aessan|coordeneis|eis|coordinede|aede|aeis|avea|ombe	<i>verb</i><br><ol><li>To coordinate</li></ol>
coordinament|coordinamenc	<i>noun</i><br><ol><li>coordination</li></ol>
cornacia	<i>noun</i><br><ol><li>jackdaw</li></ol>
corompe|corot|esse|coromparon|coromparà|coromper|é|as|aesses|corompove|areis|ébe|aron|essa|corompovan|ovais|ae|arà|ebes|corompeis|corompovais|corompesse|corompan|aras|abù|coromp|esses|aveais|corompoves|coromparé|avei|corompareis|aré|ovan|avean|avee|on|corompesses|ebe|corompon|coromparas|essan|à|oves|aesse|aon|corompes|ove|corompede|avees|ova|ombe|eis|aessa|corompessais|aessan|aes|aeis|avea|aessais|corompova|corompessan|aede|eibes|corompessa|essais|aean	<i>verb</i><br><ol><li>To corrupt</li></ol>
cossa|cosses	<i>noun</i><br><ol><li>thing, object</li></ol>
coster|esse|costasse|as|aesses|é|coste|costeies|costede|costeis|coston|costova|areis|costea|ébe|costaras|costan|aron|costeie|ebes|ovais|costovan|arà|ae|costeda|essa|costove|aras|costovais|abù|esses|costarà|aveais|costes|costassa|costaré|costassais|avei|costareis|costés|aré|ovan|avean|avee|costé|costeia|on|ebe|costa|costedes|essan|costassan|à|oves|costoves|aesse|aon|ove|ova|avees|aessan|eis|aessa|eibes|aes|aeis|avea|costaron|ombe|aessais|aede|costasses|essais|aean	<i>verb</i><br><ol><li>To cost</li></ol>
costituent|costituents|costituenta|costituentes	<i>adj</i><br><ol><li>constituent</li></ol>
costituir|costitu|costituesc|costituieis|as|esse|costitues|é|aesses|costitue|areis|ébe|essais|aron|costituiva|essa|ebes|ovais|ae|arà|aras|esses|abù|costituiron|aveais|costituiras|costituissa|costituisses|costituivais|avei|costituirà|costituisse|aré|costituide|ovan|avean|avee|costituissais|costituiré|costituivan|ebe|on|costituives|avea|essan|à|costituireis|oves|aesse|aon|ove|ova|avees|ombe|costituì|aessan|eis|aessa|costituian|costituissan|costituive|costituesce|aeis|aes|costituion|aessais|eibes|aede|costituesces|aean	<i>verb</i><br><ol><li>To constitute</li></ol>
costituzion|costituzions	<i>noun</i><br><ol><li>constitution</li></ol>
costituzionel|costituzionela|costituzionei|costituzioneles	<i>adj</i><br><ol><li>constitutional</li></ol>
creta|cretes	<i>noun</i><br><ol><li>credit (financial)</li><li>confidence</li></ol>
criazion|criazions	<i>noun</i><br><ol><li>creation</li></ol>
critich|criticia|critices|critic	<i>adj</i><br><ol><li>critical</li></ol>
cruzier|esse|as|cruziaras|aesses|é|aean|cruziede|cruzie|areis|cruziassais|ébe|aron|cruziea|cruzieia|cruzieis|cruziova|ovais|arà|ae|ebes|essa|aras|cruzies|cruzieie|cruzioves|abù|esses|aveais|cruzian|cruziove|cruziassa|cruziaré|avei|cruziarà|cruziareis|cruziovan|aré|ovan|avean|avee|cruziés|on|ebe|cruziassan|cruzieies|cruziovais|cruziasse|essan|cruzion|à|oves|aesse|aon|ove|ova|avees|aessan|aede|eis|cruzieda|cruzia|cruziaron|aes|aeis|avea|cruziasses|ombe|aessa|aessais|eibes|cruzié|essais|cruziedes	<i>verb</i><br><ol><li>To charge, entrust</li><li>To disturb, upset</li></ol>
crëidum|crëidums	<i>noun</i><br><ol><li>creed, faith (particular religion)</li></ol>
crëp|crëpsc	<i>noun</i><br><ol><li>(Gherdëina) mountain, rock</li></ol>
cualità|cualiteies	<i>noun</i><br><ol><li>quality</li></ol>
cuantità|cuantiteies	<i>noun</i><br><ol><li>quantity</li></ol>
cuecen|cuecenas|cuecena|cuecegn	<i>adj</i><br><ol><li>red</li></ol>
cueciun	<i>adj</i><br><ol><li>(Gherdëina) red</li></ol>
cuestion|cuestions	<i>noun</i><br><ol><li>question</li></ol>
cuinto	<i>noun</i><br><ol><li>fifth</li></ol>
cul|cui	<i>noun</i><br><ol><li>(Gherdëina, vulgar slang) ass, bottom, buttocks, butt</li></ol>
culetif|culetiva|culetifs|culetives	<i>adj</i><br><ol><li>collective</li></ol>
culetività	<i>noun</i><br><ol><li>collectivity</li></ol>
cult|cults	<i>noun</i><br><ol><li>cult, religion</li></ol>
cultivazion|cultivazions	<i>noun</i><br><ol><li>cultivation</li></ol>
cultura|cultures	<i>noun</i><br><ol><li>culture</li></ol>
culturel|culturela|culturei|cultureles	<i>adj</i><br><ol><li>cultural</li></ol>
cumander|esse|as|cumandede|cumandeies|é|aesses|cumandaras|cumandon|cumandé|areis|cumandedes|cumandova|cumandea|cumandaron|ébe|aron|cumandasses|essa|ebes|ovais|cumandeia|arà|ae|cumandaré|cumanda|cumandeda|aras|esses|abù|aveais|cumandarà|cumandan|cumandovan|avei|aré|cumandove|cumandes|ovan|cumandareis|avee|avean|cumandassa|cumande|cumandés|on|cumandasse|cumandassais|cumandeie|ebe|avea|essan|à|oves|aesse|aon|ove|cumandeis|avees|ova|aessan|cumandassan|cumandoves|eis|aessa|aes|aeis|cumandovais|aessais|ombe|aede|eibes|essais|aean	<i>verb</i><br><ol><li>To command</li></ol>
cumando	<i>noun</i><br><ol><li>command</li></ol>
cumember|cumembri	<i>noun</i><br><ol><li>member (of a group)</li></ol>
cumerz|cumerc	<i>noun</i><br><ol><li>commerce</li></ol>
cumetù|cumetui|cumetudes|cumetuda	<i>adj</i><br><ol><li>committed</li><li>commissioned</li></ol>
cumiscion|cumiscions	<i>noun</i><br><ol><li>commission</li></ol>
cumisser|cumissers	<i>noun</i><br><ol><li>commissioner</li></ol>
cumpatibl|cumpatibla|cumpatibles|cumpatibli	<i>adj</i><br><ol><li>compatible</li></ol>
cumpatibltà	<i>noun</i><br><ol><li>compatibility</li></ol>
cumpetenza|cumpetenzes	<i>noun</i><br><ol><li>competency</li><li>field, department</li></ol>
cumplementer|cumplementeres|cumplementers|cumplementera	<i>adj</i><br><ol><li>complementary (all senses)</li></ol>
cumplesc	<i>noun</i><br><ol><li>complex</li></ol>
cumporter|cumportan|esse|as|aesses|é|cumportassais|cumportés|cumporteis|areis|cumporteies|cumportasse|ébe|aron|essa|ebes|cumporteia|ovais|cumportarà|cumporteda|arà|ae|cumportasses|aras|esses|abù|cumportassa|cumportareis|cumportea|cumportovan|cumportes|aveais|cumportaron|cumportaras|avei|cumportove|cumportova|cumportassan|aré|ovan|avean|avee|cumporte|on|cumportedes|cumportede|ebe|cumporton|essan|à|oves|cumporta|aon|ove|ova|avees|cumportovais|aesse|cumportaré|cumportoves|eis|aessa|aessan|aes|aeis|avea|aessais|ombe|aede|cumporté|eibes|cumporteie|essais|aean	<i>verb</i><br><ol><li>To involve, imply, entail</li></ol>
cumposizion|cumposizions	<i>noun</i><br><ol><li>composition</li></ol>
cumpunent|cumpunenc	<i>noun</i><br><ol><li>component</li></ol>
cumpurtament|cumpurtamenc	<i>noun</i><br><ol><li>compartment</li></ol>
cumunel|cumunela|cumunei|cumuneles	<i>adj</i><br><ol><li>communal</li></ol>
cun	<i>prep</i><br><ol><li>(Gherdëina) with</li><li>(Badia) Alternative form of con</li></ol>
cuncor|cuncors	<i>noun</i><br><ol><li>competition</li><li>exam</li></ol>
cundaned|cundaneds|cundaneda|cundanedes	<i>adj</i><br><ol><li>condemned</li><li>convicted</li></ol>
cundaner|esse|cundanassais|as|cundanova|aesses|é|cundanovais|cundanon|aean|cundanasses|cundanovan|areis|ébe|aron|cundanede|essa|cundanassa|cundane|cundaneies|ovais|cundanaras|cundanareis|arà|ae|ebes|cundanaré|cundanoves|aras|abù|esses|aveais|cundanassan|cundaneie|cundanarà|cundanes|cundanés|cundanove|avei|aré|ovan|avean|avee|cundanaron|on|ebe|cundaneia|cundanasse|essan|à|oves|aesse|aon|cundanea|ove|avees|ova|aessan|cundaneis|eis|aessa|aessais|aes|aeis|avea|cundana|ombe|aede|cundanan|eibes|essais|cundané	<i>verb</i><br><ol><li>To convict, sentence</li><li>To condemn</li></ol>
cundizion|cundizions	<i>noun</i><br><ol><li>condition</li></ol>
cunferir|esse|cunferian|cunferives|as|aesses|é|areis|cunferiré|cunferieis|ébe|cunferion|cunferesc|aron|cunferissan|essa|cunferissais|ovais|ae|arà|ebes|cunferisses|aras|cunferissa|abù|cunferive|esses|aveais|cunferirà|cunfer|cunferiva|cunferesce|avei|cunferireis|cunferesces|aré|cunferiras|cunferide|ovan|avean|avee|cunferivais|cunferiron|on|ebe|cunferì|essan|cunfere|à|oves|cunferes|aon|ove|ova|cunferivan|avees|cunferisse|aesse|eis|aessa|aessan|aessais|aes|aeis|avea|aede|ombe|eibes|essais|aean	<i>verb</i><br><ol><li>To confer</li></ol>
cunfescion|cunfescions	<i>noun</i><br><ol><li>confession</li><li>denomination, creed</li></ol>
cunfin|cunfins	<i>noun</i><br><ol><li>border, frontier</li><li>boundary</li></ol>
cunflic	<i>noun</i><br><ol><li>conflict, dispute</li></ol>
cunforma	<i>verb</i><br><ol><li>conforms (3rd person singular, present tense)</li></ol>
cunformità	<i>noun</i><br><ol><li>conformity</li></ol>
cunfront|cunfronc	<i>noun</i><br><ol><li>comparison</li><li>confrontation</li></ol>
cunicio|cunici	<i>noun</i><br><ol><li>rabbit</li></ol>
cunlaurazion|cunlaurazions	<i>noun</i><br><ol><li>collaboration</li></ol>
cunseliera|cunselieres	<i>noun</i><br><ol><li>council</li></ol>
cunsens|cunsensc	<i>noun</i><br><ol><li>consent, permission</li><li>approval</li></ol>
cunsultazion|cunsultazions	<i>noun</i><br><ol><li>consultation</li></ol>
cunsuntif|cunsuntifs|cunsuntiva|cunsuntives	<i>adj</i><br><ol><li>final</li><li>bottom line (attributive)</li></ol>
cuntabltà	<i>noun</i><br><ol><li>accountancy; accounting</li><li>(in the plural) books, accounts</li></ol>
cuntestuel|cuntestuela|cuntestueles|cuntestuei	<i>adj</i><br><ol><li>contextual</li></ol>
cuntlujion|cuntlujiones	<i>noun</i><br><ol><li>conclusion</li></ol>
cuntrastea	<i>verb</i><br><ol><li>opposes (3rd person plural (subjunctive?))</li></ol>
cuntrat|cuntrac	<i>noun</i><br><ol><li>contract</li></ol>
cuntreda|cuntredes	<i>noun</i><br><ol><li>countryside</li><li>landscape</li></ol>
cuntrer|cuntreres|cuntrera|cuntrers	<i>adj</i><br><ol><li>contrary</li></ol>
cuntribut|cuntribuc	<i>noun</i><br><ol><li>contribution</li></ol>
cuntributif|cuntributiva|cuntributifs|cuntributives	<i>adj</i><br><ol><li>contributory</li></ol>
cuntrol|cuntroi	<i>noun</i><br><ol><li>control</li></ol>
cuntroler|esse|as|cuntroleda|é|cuntroleies|aean|aesses|cuntrolassais|cuntroleis|areis|cuntrolarà|ébe|aron|essa|ebes|ovais|cuntrolovan|arà|ae|cuntrolea|cuntrolaré|aras|esses|abù|cuntrolovais|cuntrolova|cuntroleie|cuntrolassan|cuntroles|aveais|cuntrole|cuntrolon|cuntrolove|cuntroledes|cuntrolareis|cuntrolaron|avei|cuntrolan|aré|ovan|avean|avee|cuntroloves|on|cuntrolassa|ebe|cuntrolé|cuntrolasses|cuntrolés|essan|à|oves|aesse|aon|ove|ova|avees|ombe|aessan|cuntroleia|eis|aessa|aessais|aes|aeis|avea|aede|cuntrola|cuntrolaras|cuntrolede|eibes|essais|cuntrolasse	<i>verb</i><br><ol><li>To control</li></ol>
cunvalider|esse|as|cunvalidede|aesses|é|cunvalidovais|cunvalidan|cunvalidaron|areis|cunvalidaré|cunvalidovan|cunvalidés|cunvalidaras|ébe|cunvalida|aron|cunvalideia|cunvalidassais|cunvalidasses|ebes|cunvalidareis|ovais|arà|cunvalidon|ae|essa|aras|cunvalideie|abù|esses|aveais|cunvalideda|cunvalidasse|cunvalidova|cunvalidove|cunvalidarà|avei|aré|cunvalideis|cunvalidassa|cunvalides|ovan|avee|avean|cunvalidea|cunvalidé|ebe|cunvalidoves|on|cunvalide|essan|à|oves|cunvalidedes|cunvalideies|cunvalidassan|aon|ove|avees|ova|aesse|aessan|eis|aessa|aessais|aes|aeis|avea|aede|ombe|eibes|essais|aean	<i>verb</i><br><ol><li>To validate</li><li>To confirm</li></ol>
cunvenzion|cunvenzions	<i>noun</i><br><ol><li>convention</li></ol>
cunversazion|cunversazions	<i>noun</i><br><ol><li>conversation</li></ol>
cunverscion|cunverscions	<i>noun</i><br><ol><li>conversion</li></ol>
cunvocazion|cunvocazions	<i>noun</i><br><ol><li>convocation</li></ol>
cunzeder|esse|cunzedede|as|cunzedan|aesses|é|cunzed|cunzedaron|areis|cunzedessais|cunzedovan|cunzedeis|ébe|cunzedareis|aron|essa|cunzedes|cunzedaras|ovais|arà|ae|ebes|cunzedessan|aras|esses|abù|cunzedù|aveais|cunzedesses|avei|cunzedarà|cunzedon|aré|ovan|avean|avee|on|ebe|cunzedesse|cunzedove|cunzede|avea|essan|à|oves|aesse|aon|ove|cunzedovais|avees|ova|ombe|aessan|eis|aessa|aessais|cunzedova|cunzedessa|cunzedaré|cunzedoves|aeis|aes|aede|eibes|essais|aean	<i>verb</i><br><ol><li>To allow</li><li>To concede</li></ol>
cuozient|cuozienc	<i>noun</i><br><ol><li>quotient</li><li>rate (taxes)</li></ol>
cura|cures	<i>noun</i><br><ol><li>care</li><li>treatment</li></ol>
curespuender|curespuendes|esse|curespuendovais|as|aesses|é|aean|curespuendovan|curespuendaron|areis|curespuendoves|curespuendan|curespuendaré|ébe|curespuendeies|aron|essa|ebes|ovais|ae|curespuendea|arà|curespuendareis|curespuendeia|curespuendasse|aras|esses|abù|aveais|curespuendove|curespuendassais|curespuendaras|curespuendede|avei|curespuendassan|aré|curespuendasses|curespuende|ovan|curespuendova|avee|avean|curespuendeis|curespuendé|curespuendon|ebe|curespuendassa|on|curespuenda|essan|à|oves|aesse|aon|ove|ova|avees|aessan|curespuendés|eis|aessa|curespuendedes|aessais|aes|curespuendeda|avea|aeis|ombe|aede|curespuendarà|eibes|essais|curespuendeie	<i>verb</i><br><ol><li>to coincide</li></ol>
curespundënza	<i>noun</i><br><ol><li>correspondence</li></ol>
curt|curtes|cursc|curta	<i>adj</i><br><ol><li>brief, short</li></ol>
curtina|curtines	<i>noun</i><br><ol><li>(Gherdëina) graveyard, cemetery</li></ol>
cèria|cëries|cèries|cëria	<i>noun</i><br><ol><li>load</li><li>position</li></ol>
cèsa|cèses	<i>noun</i><br><ol><li>house</li></ol>
cë|cëves	<i>noun</i><br><ol><li>(Gherdëina) head</li></ol>
cësa|cëses	<i>noun</i><br><ol><li>(Gherdëina) house, home</li></ol>
da	<i>prep</i><br><ol><li>from</li><li>At the house of</li><li>to (implying necessity)</li></ol>
dai	<i>abbrev</i><br><ol><li>from or of the (+ masculine plural noun)</li></ol>
dal	<i>abbrev</i><br><ol><li>from the (masculine singular)</li></ol>
dala	<i>abbrev</i><br><ol><li>from the (feminine singular)</li></ol>
dales	<i>abbrev</i><br><ol><li>from the (feminine plural)</li></ol>
damanda	<i>verb</i><br><ol><li>demands (3rd person singular, present tense)</li></ol>
damander|esse|damandoves|damandaras|damandeda|as|aesses|é|aean|damandea|damandaron|damandon|areis|damandasses|ébe|aron|damandaré|essa|ebes|ovais|ae|arà|damandede|damanda|aras|esses|damande|abù|damandassais|aveais|aessan|damandeie|damandovais|damandé|avei|damandareis|damandeis|damandeies|aré|ovan|damandove|avee|avean|damandeia|ebe|on|damandasse|essan|damandan|damandassa|à|oves|aon|ove|ova|damandedes|avees|damandarà|damandes|eis|aesse|aessa|damandassan|aes|aeis|avea|aessais|ombe|aede|damandés|eibes|damandovan|essais|damandova	<i>verb</i><br><ol><li>To ask</li></ol>
dan	<i>prep</i><br><ol><li>in front of, before</li></ol>
danejer|esse|danejova|danejassa|danejan|as|é|danejé|aesses|danejovan|danejaré|areis|ébe|danejeie|aron|danejeis|essa|ebes|ovais|ae|arà|danejeia|danejasses|danejaras|danejes|aras|esses|abù|aveais|danejaron|danejedes|danejarà|danejovais|danejeda|avei|danejassais|daneja|daneje|danejés|danejede|aré|danejassan|ovan|avean|danejove|avee|on|ebe|danejoves|danejea|essan|à|oves|danejasse|aesse|aon|ove|ova|avees|aessan|danejon|eis|aessa|danejareis|aes|aeis|avea|aessais|ombe|aede|danejeies|eibes|essais|aean	<i>verb</i><br><ol><li>To damage, spoil, ruin</li></ol>
danora	<i>adv</i><br><ol><li>always</li></ol>
dant	<i>adv</i><br><ol><li>at first</li><li>in front</li><li>before</li></ol><br><i>adj</i><br><ol><li>previous; preceding</li></ol>
dantaprima	<i>adv</i><br><ol><li>originally</li></ol>
danter	<i>prep</i><br><ol><li>between, among</li></ol>
dat|dac	<i>noun</i><br><ol><li>data</li><li>fact</li></ol>
data|dates	<i>noun</i><br><ol><li>date (day number of the month)</li></ol>
daviert|daviertes|davierta|davierts	<i>adj</i><br><ol><li>open</li></ol>
de	<i>prep</i><br><ol><li>of, from</li></ol>
de fat	<i>adv</i><br><ol><li>in fact</li></ol>
debant	<i>adj</i><br><ol><li>free (of charge)</li><li>gratuitous</li></ol>
debota	<i>adv</i><br><ol><li>nearly, almost</li></ol>
debujën	<i>verb</i><br><ol><li>requires</li><li>requests, demands</li></ol>
decret|decrec	<i>noun</i><br><ol><li>decree</li></ol>
dedora	<i>adv</i><br><ol><li>(Gherdëina) outside</li></ol>
defendura|defendures	<i>noun</i><br><ol><li>defense; protection</li></ol>
definitif|definitiva|definitives|definitifs	<i>adj</i><br><ol><li>definitive</li></ol>
definitivamënter	<i>adv</i><br><ol><li>definitely</li></ol>
defrent|defrentes|defrenc|defrenta	<i>adj</i><br><ol><li>different</li><li>diverse</li></ol>
defrenziazion|defrenziazions	<i>noun</i><br><ol><li>differentiation</li></ol>
defrenzier|esse|as|aesses|é|areis|defrenziessa|defrenziovan|defrenzies|ébe|aron|defrenzieis|essa|defrenziede|ovais|ae|arà|ebes|defrenzi|aras|defrenziaré|defrenziù|abù|esses|defrenziesse|aveais|defrenziessais|defrenziaras|defrenziesses|defrenziova|avei|defrenziarà|aré|ovan|avean|avee|on|ebe|defrenziaron|defrenziareis|defrenzian|defrenzion|essan|à|oves|aesse|aon|ove|ova|avees|ombe|aessan|eis|defrenzioves|aessa|defrenziessan|defrenzie|aeis|avea|defrenziovais|defrenziove|aes|aessais|eibes|aede|essais|aean	<i>verb</i><br><ol><li>To distinguish, differentiate</li></ol>
defujion|defujions	<i>noun</i><br><ol><li>diffusion, spread</li><li>circulation</li></ol>
defënd	<i>verb</i><br><ol><li>defends, protects (3rd person singular, present tense)</li></ol>
degré|degrés	<i>noun</i><br><ol><li>degree, rank</li></ol>
degun|deguna|degunes|deguni	<i>adj</i><br><ol><li>some, a few</li></ol>
dejedot	<i>adj</i><br><ol><li>eighteen</li></ol><br><i>noun</i><br><ol><li>eighteen</li></ol>
dejenuef	<i>adj</i><br><ol><li>nineteen</li></ol><br><i>noun</i><br><ol><li>nineteen</li></ol>
dejesset	<i>adj</i><br><ol><li>seventeen</li></ol><br><i>noun</i><br><ol><li>seventeen</li></ol>
dejeujament|dejeujamenc	<i>noun</i><br><ol><li>discussion (of an argument or theme)</li><li>carrying out (of a programme of work)</li></ol>
dejeujer|esse|dejëujasse|as|aesses|é|dejëujareis|areis|dejëujaron|ébe|dejëujova|aron|dejëujaré|essa|ebes|ovais|ae|arà|dejëujovais|dejëujeis|aras|esses|abù|aveais|dejëuja|dejëujasses|essan|aessan|avei|dejëujoves|dejëujes|aré|dejëujea|dejëuje|dejëujarà|dejëujassais|avee|dejëujassa|ovan|dejëujede|avean|dejëujove|ebe|dejëujassan|on|dejëujeies|dejëujan|dejëujer|dejëujovan|dejëujeia|dejëujaras|à|aon|ove|dejëujon|oves|avees|ova|dejëujé|eis|aesse|dejëujeie|aessa|aes|aeis|avea|aessais|ombe|aede|eibes|essais|aean	<i>verb</i><br><ol><li>To perform or carry out</li></ol>
dejocupazion|dejocupazions	<i>noun</i><br><ol><li>unemployment</li><li>joblessness</li></ol>
delegazion|delegazions	<i>noun</i><br><ol><li>delegation</li></ol>
delegher|esse|delegheis|deleghé|as|aesses|é|delegharé|deleghovais|areis|delegheda|deleghea|ébe|aron|essa|ebes|deleghova|ovais|delegharon|arà|ae|deleghasse|deleghove|deleghoves|delegheie|deleghes|abù|aras|esses|deleghon|aveais|delegheies|deleghovan|avei|deleghassan|aré|deleghés|delegharà|deleghede|deleghasses|deleghassa|ovan|avee|avean|deleghareis|on|ebe|deleghedes|delegheia|deleghassais|delegha|delegharas|essan|à|oves|aesse|aon|ove|ova|avees|deleghe|aessan|eis|aessa|aessais|aes|aeis|avea|aede|ombe|deleghan|eibes|essais|aean	<i>verb</i><br><ol><li>To delegate</li><li>To decompose, break down</li></ol>
delibrazion|delibrazions	<i>noun</i><br><ol><li>deliberation, decision</li></ol>
delibrer|delibra|delibreie|delibrasses|delibrés|as|esse|é|aesses|delibrareis|delibrarà|areis|delibraras|delibrovais|delibreies|delibreis|ébe|delibrea|aron|delibredes|delibraré|delibré|delibron|ovais|arà|ae|ebes|essa|delibreia|delibres|aras|esses|abù|aveais|delibrovan|delibrassan|delibrova|delibraron|avei|delibrove|delibrede|aré|delibreda|ovan|avean|avee|delibrassais|delibroves|on|ebe|delibrasse|delibre|essan|à|oves|aesse|delibrassa|aon|ove|avees|ova|aessan|eis|aessa|delibran|aes|aeis|avea|aessais|ombe|aede|eibes|essais|aean	<i>verb</i><br><ol><li>To deliberate</li></ol>
delit|delic	<i>noun</i><br><ol><li>crime, offence</li></ol>
democratich|democraticia|democratices|democratic	<i>adj</i><br><ol><li>democratic</li></ol>
deniteus|deniteusas|deniteuses|deniteusa|deniteusc	<i>adj</i><br><ol><li>dignified</li></ol>
denità	<i>noun</i><br><ol><li>dignity</li></ol>
denuminazion|denuminazions	<i>noun</i><br><ol><li>denomination</li></ol>
denunzia|denunzies	<i>noun</i><br><ol><li>denunciation</li><li>complaint</li></ol>
dependent|dependënc|dependënt|dependenc	<i>noun</i><br><ol><li>employee</li></ol>
depenjer|esse|depenjesses|as|aesses|é|depent|areis|ébe|aron|depenjovais|essa|ebes|ovais|ae|arà|depenjove|depenjaron|aras|esses|abù|depenjes|aveais|depenj|aessan|depenjede|avei|depenjessais|aré|aesse|ovan|avean|depenjan|avee|depenjon|depenjaras|depenjoves|depenjeis|ebe|on|depenjarà|depenjova|essan|depenjesse|à|oves|depenjareis|aon|depenjessa|depenjaré|ove|avees|depenje|depenjovan|depenjessan|eis|ova|aessa|aes|aeis|avea|aessais|ombe|aede|eibes|essais|aean	<i>verb</i><br><ol><li>to paint, colour</li></ol>
deputat|deputac	<i>noun</i><br><ol><li>deputy</li></ol>
depënd	<i>verb</i><br><ol><li>depends (3rd person singular/plural, present tense)</li></ol>
desbalanz|desbalanc	<i>noun</i><br><ol><li>imbalance</li></ol>
deschëuz|deschëuza|deschëuzs|deschëuzes	<i>adj</i><br><ol><li>(Gherdëina) barefoot</li></ol>
descuscion|descuscions	<i>noun</i><br><ol><li>discussion</li></ol>
desfideda|desfidedes	<i>noun</i><br><ol><li>distrust</li><li>vote of no confidence</li></ol>
desfidenza|desfidenzes	<i>noun</i><br><ol><li>mistrust</li><li>vote of no confidence</li></ol>
desgorjer|esse|desgorjoves|as|aesses|é|desgorjede|areis|desgorjesse|ébe|desgorjesses|essais|aron|desgorjessais|desgorjeis|ebes|ovais|ae|desgorjareis|arà|essa|desgorjovais|desgorje|desgorjove|desgorjaras|aras|abù|esses|aveais|desgort|avei|desgorjessa|aré|desgorjaré|ovan|avean|avee|desgorjaron|desgorjes|desgorjon|desgorjovan|ebe|on|desgorjan|essan|à|oves|aesse|aon|ove|ova|avees|ombe|aessan|eis|aessa|desgorjova|aes|aeis|avea|aessais|desgorjessan|aede|desgorj|eibes|desgorjarà|aean	<i>verb</i><br><ol><li>To dismiss, remove</li></ol>
desliament|desliamenc	<i>noun</i><br><ol><li>melting</li><li>dissolving, dissolution</li><li>annulment</li></ol>
deslier|esse|as|aesses|é|deslian|deslié|desliedes|areis|desliovan|ébe|aron|deslieies|essa|deslieia|ovais|ae|arà|deslieda|ebes|desliassa|desliareis|desliés|aras|desliede|abù|deslioves|esses|desliasse|desliove|aveais|desliova|desliasses|desliovais|desliaron|avei|desliassais|aré|ovan|avean|avee|deslie|desliarà|deslia|desliaras|ebe|deslion|on|desliaré|essan|à|oves|deslies|deslieis|desliassan|aon|ove|avees|ova|ombe|aesse|eis|aessa|aessan|deslieie|aes|aeis|avea|aessais|desliea|aede|eibes|essais|aean	<i>verb</i><br><ol><li>To untie</li><li>To detach</li><li>To dissolve</li></ol>
despusizion|despusizions	<i>noun</i><br><ol><li>disposition</li><li>direction, instruction, provision</li></ol>
dessegn|dessenies	<i>noun</i><br><ol><li>design</li></ol>
destachel|destachei|destacheles|destachela	<i>adj</i><br><ol><li>detached</li></ol>
destinazion|destinazions	<i>noun</i><br><ol><li>destination</li></ol>
destiner|esse|as|aesses|é|destineies|areis|destinassan|destineis|destinon|ébe|aron|destinés|destinasse|essa|ebes|ovais|ae|arà|destines|destinaré|destinovais|destinassais|destinova|aras|esses|abù|destiné|destinarà|aveais|destine|destinassa|avei|aré|destinareis|destineda|ovan|destinea|destinedes|destineie|avee|avean|destinasses|ebe|destinaras|on|destinoves|avea|essan|à|oves|aesse|aon|ove|destinaron|avees|destinede|ova|destinovan|eis|aessa|destinan|aessan|aes|aeis|destinove|aessais|ombe|destina|destineia|eibes|aede|essais|aean	<i>verb</i><br><ol><li>to mean, intend</li></ol>
destribuzion|destribuzions	<i>noun</i><br><ol><li>distribution</li></ol>
destumer|esse|destumeis|as|aesses|é|destumova|destumeie|destumeda|destumareis|destumé|destumarà|areis|destumes|ébe|destumaron|destume|destumaras|destumaré|destumés|destumedes|aron|ovais|ae|destuma|destumea|destumede|arà|ebes|essa|destumovais|destumove|aras|abù|esses|aveais|destuman|destumovan|destumassan|avei|aré|destumon|destumoves|ovan|avee|destumassais|avean|on|ebe|destumeies|destumeia|essan|destumasses|à|oves|destumasse|aon|destumassa|ove|avees|ova|aesse|aessan|eis|aessa|aessais|aes|aeis|avea|aede|ombe|eibes|essais|aean	<i>verb</i><br><ol><li>To decline, lapse</li></ol>
desvalivanza|desvalivanzes	<i>noun</i><br><ol><li>distinction</li><li>discrimination</li></ol>
desvier|esse|desvieis|as|aesses|é|desviaras|desviassan|desviassa|areis|desviovais|desviassais|ébe|aron|essa|ebes|ovais|ae|arà|desviaré|desvieie|desvies|desviasses|desviove|aras|esses|abù|desvieia|aveais|desvion|desviaron|essan|aessan|avei|desviasse|desviovan|aré|ovan|avean|desvié|avee|desvieda|ebe|on|desviede|desviova|desvia|desvian|à|desviedes|desvie|oves|aon|desviarà|ove|avees|ova|desviea|ombe|eis|aesse|aessa|desviareis|aes|desviés|avea|aeis|desvieies|aessais|aede|eibes|desvioves|essais|aean	<i>verb</i><br><ol><li>to deflect, divert</li><li>to distract</li></ol>
detenzion|detenzions	<i>noun</i><br><ol><li>detention</li></ol>
determinazion|determinazions	<i>noun</i><br><ol><li>determination</li></ol>
determiner|determinareis|determines|determinova|determinaré|determinaras|determinede|determinasse|determinés|determinon|determinovais|determineie|determinasses|determinassais|determinoves|determinea|determinaron|determinovan|determinedes|determinove|determineda|determineia|determinassa|determinan|determina|determinarà|determineis|determine|determinassan|determiné|avea|determineies	<i>verb</i><br><ol><li>to determine</li></ol>
detlarazion|detlarazions	<i>noun</i><br><ol><li>declaration</li></ol>
detlarer|detlarasses|detlarasse|esse|as|aesses|detlareie|é|areis|detlararà|detlare|detlareia|ébe|detlararé|detlarassa|detlares|detlaredes|aron|ebes|ovais|detlarovan|arà|ae|essa|detlareies|detlaran|aras|esses|abù|detlaré|detlarova|aveais|detlararas|detlarés|detlara|detlaron|detlarareis|detlarovais|avei|detlareda|aré|ovan|detlarove|avee|avean|detlararon|detlareis|ebe|on|detlarassan|detlarea|essan|à|oves|aesse|aon|ove|ova|avees|aessan|detlaroves|eis|aessa|aessais|aes|aeis|avea|aede|ombe|detlarassais|eibes|detlarede|essais|aean	<i>verb</i><br><ol><li>To declare, say</li></ol>
dezember|dezembers	<i>noun</i><br><ol><li>December</li></ol>
dezentramënt	<i>noun</i><br><ol><li>decentralization</li><li>devolution</li></ol>
dezijion|dezijions	<i>noun</i><br><ol><li>decision</li></ol>
dezëmber	<i>noun</i><br><ol><li>December</li></ol>
di	<i>abbrev</i><br><ol><li>of the (masculine plural)</li></ol>
diejejim	<i>noun</i><br><ol><li>tenth</li></ol>
diesc	<i>adj</i><br><ol><li>ten</li></ol><br><i>noun</i><br><ol><li>ten</li></ol>
dimiscion|dimiscions	<i>noun</i><br><ol><li>discharge</li><li>(especially in plural) resignation</li></ol>
diplomatich|diplomatices|diplomatic|diplomaticia	<i>adj</i><br><ol><li>diplomatic</li></ol>
diret|diretes|direta|direts	<i>adj</i><br><ol><li>direct</li></ol>
diretamënter	<i>adv</i><br><ol><li>directly</li></ol>
diretif|diretiva|diretives|diretifs	<i>adj</i><br><ol><li>directorial</li></ol>
direzion|direzions	<i>noun</i><br><ol><li>direction</li></ol>
disciplina|disciplines	<i>noun</i><br><ol><li>discipline</li></ol>
discipliner|disciplineres|disciplinei|disciplinera	<i>adj</i><br><ol><li>disciplinary</li></ol>
dl	<i>abbrev</i><br><ol><li>of the, from the (+ a masculine noun in singular)</li></ol>
dla	<i>abbrev</i><br><ol><li>of the, from the (+ a feminine noun in singular)</li></ol>
dlavea|dlaveies	<i>noun</i><br><ol><li>(Gherdëina) vaccine</li></ol>
dles	<i>abbrev</i><br><ol><li>of the, from the (feminine plural)</li></ol>
dlieja|dliejas	<i>noun</i><br><ol><li>church</li></ol>
do	<i>prep</i><br><ol><li>behind</li><li>before (time)</li></ol>
dodesc	<i>adj</i><br><ol><li>twelve</li></ol><br><i>noun</i><br><ol><li>twelve</li></ol>
dogana|doganes	<i>noun</i><br><ol><li>customs</li></ol>
doi	<i>adj</i><br><ol><li>two</li></ol><br><i>noun</i><br><ol><li>two</li></ol>
doman	<i>adv</i><br><ol><li>tomorrow</li></ol>
domenia|domenies	<i>noun</i><br><ol><li>Sunday</li></ol>
domizil|domizilii	<i>noun</i><br><ol><li>domicile</li><li>residence</li></ol>
donca	<i>adv</i><br><ol><li>then, afterwards</li><li>hence, therefore</li></ol>
dormir|dormissan|dormiron|é|foves|sté|fosses|dormisses|sareis|dormivan|dormian|sun|dormivais|dormide|dormisse|saras|saron|dorm|dormirà|fovais|sies|dormion|fossa|dormes|fova|fossan|fovan|dormieis|ester|steda|fosse|dormì|sarà|dormesce|fossais|dormives|stés|dormissa|dormesc|dormiré|saré|sede|dormiva|dormissais|dormesces|son|dormireis|dorme|dormiras|stedes|fove|sian|seis|sie|dormive|ies	<i>verb</i><br><ol><li>(intransitive) to sleep</li></ol>
dotazion|dotazions	<i>noun</i><br><ol><li>equiping</li><li>endowment</li></ol>
dovei|dessesses|dessessais|dessessa|dovù|desseis|dessarà|dessoves|dessù|dessovais|dess|dessova|doves|dessaron|dovessan|dessesse|desse|desses|dove|desson|dessovan|dessaras|dovesses|dessove|dovesse|dovessa|dessaré|dova|dessareis|dessessan|dovan|dover|dessan|dovessais|dovais	<i>verb</i><br><ol><li>To have to (must)</li></ol>
duc	<i>pron</i><br><ol><li>all; everybody, everyone</li></ol>
dureda|duredes	<i>noun</i><br><ol><li>duration</li></ol>
dut|duta	<i>adj</i><br><ol><li>all</li></ol>
duta|dut	<i>adj</i><br><ol><li>all</li></ol>
duvier|duvieres	<i>noun</i><br><ol><li>duty (what a person should do)</li></ol>
dé|das|daes|doves|deis|darà|dasses|dede|dae|dasse|dassa|dove|dareis|daras|don|dova|daron|dà|dovan|daré|dovais|dassais|dèr|dassan	<i>verb</i><br><ol><li>to give</li></ol>
dërt|dërc	<i>noun</i><br><ol><li>right</li></ol>
dì|dijesses|dir|dijareis|dijoves|dijes|dije|dijovan|dijesse|dijova|dijove|dijessa|dita|dites|dij|dijaras|dijeis|dit|dic|dijovais|dijede|dijon|dijessan|dijessais|dijaron|dijarà|dijaré|dis	<i>noun</i><br><ol><li>day</li></ol><br><i>verb</i><br><ol><li>To say, tell</li></ol>
dî	<i>adv</i><br><ol><li>(badiot) long (having a duration in time), for a long time</li><li>(badiot) in a long time</li></ol>
eclesiastich|eclesiastices|eclesiastic|eclesiasticia	<i>adj</i><br><ol><li>ecclesiastical</li></ol>
economia|economies	<i>noun</i><br><ol><li>economy</li></ol>
economich|economic|economices|economicia|economics	<i>adj</i><br><ol><li>economic</li></ol>
ecosistem|ecosistems	<i>noun</i><br><ol><li>ecosystem</li></ol>
educazion|educazions	<i>noun</i><br><ol><li>education</li></ol>
educher|esse|educharas|educha|educharà|as|educheia|é|aesses|areis|educhovan|educhassais|educhove|ébe|educhea|educhasse|educheda|aron|essa|eduche|ovais|educhova|arà|ae|ebes|eduches|aras|educheie|abù|esses|educhovais|aveais|educhassan|educhon|avei|educharon|educhés|aré|educhasses|ovan|avean|avee|educhan|on|ebe|educheies|eduché|educhede|educhassa|educharé|educhareis|essan|à|oves|aesse|aon|ove|ova|avees|aessan|eis|aessa|educhoves|aessais|aes|educhedes|avea|aeis|ombe|educheis|aede|eibes|essais|aean	<i>verb</i><br><ol><li>To train, educate</li></ol>
efetif|efetives|efetifs|efetiva	<i>adj</i><br><ol><li>effective</li></ol>
efetività|efetiviteies	<i>noun</i><br><ol><li>effectivity</li></ol>
ega|eghes	<i>noun</i><br><ol><li>(Cazét) water</li></ol>
eila|eiles	<i>noun</i><br><ol><li>woman</li><li>wife</li></ol>
ejam|ejams	<i>noun</i><br><ol><li>exam</li></ol>
ejaminer|esse|as|ejaminassais|é|aesses|ejaminé|ejaminova|areis|ébe|essais|aron|ejamineies|essa|ebes|ovais|ae|arà|ejaminovais|ejaminasse|aras|esses|ejaminaron|abù|aveais|ejaminedes|essan|ejaminaré|ejamines|avei|ejaminea|ejaminarà|aré|ejamina|ovan|avean|ejaminaras|ejaminassan|ejaminede|ejamine|avee|ejaminasses|on|ebe|ejamineie|ejaminareis|ejaminon|ejaminovan|ejamineda|ejaminove|à|oves|ejaminés|ejamineia|aon|ejaminan|ove|avees|ova|aesse|ejamineis|eis|aessa|aessan|aes|aeis|avea|ejaminassa|ombe|aessais|aede|eibes|ejaminoves|aean	<i>verb</i><br><ol><li>To examine</li></ol>
elaborazion|elaborazions	<i>noun</i><br><ol><li>elaboration</li></ol>
emaner|esse|as|aesses|é|emanasse|emanaron|emanassa|emanaras|emanove|emanovan|emanassan|emanovais|areis|ébe|aron|emanassais|ebes|ovais|ae|emanareis|arà|emanea|essa|emaneia|emanedes|emanan|aras|esses|abù|emane|aveais|emanoves|emanon|emanes|emaneda|avei|aré|ovan|avean|emaneis|emanova|emanasses|emanés|avee|on|ebe|emanaré|emanede|emaneie|emaneies|essan|à|oves|emanarà|aesse|aon|ove|ova|avees|aessan|eis|aessa|emana|aessais|aes|aeis|avea|emané|ombe|aede|eibes|essais|aean	<i>verb</i><br><ol><li>To give off, send out; emanate, radiate</li><li>To promulgate</li></ol>
emigrazion|emigrazions	<i>noun</i><br><ol><li>emigration</li></ol>
ena|enes	<i>noun</i><br><ol><li>week</li></ol>
ence|ënghe	<i>adv</i><br><ol><li>also, too, as well, besides</li></ol>
encontra	<i>adv</i><br><ol><li>towards</li></ol>
energia|energies	<i>noun</i><br><ol><li>energy</li></ol>
energich|energicia|energices|energic	<i>adj</i><br><ol><li>energetic</li></ol>
ent|ënt|ënc|enc	<i>noun</i><br><ol><li>entity</li><li>corporation, body</li></ol>
entant	<i>adv</i><br><ol><li>while, meanwhile</li></ol>
entenjer|esse|entenjan|as|aesses|é|entenjareis|areis|entenje|ébe|entenjova|entenjede|aron|essa|ebes|ovais|ae|arà|entenjaré|entenjaron|aras|esses|abù|entenjesses|aveais|entenjessa|entenjove|entenjessan|entenjovais|avei|entenjesse|entenjessais|aré|ovan|avean|avee|entenj|entent|on|ebe|entenjovan|entenjes|essan|à|oves|aesse|entenjoves|entenjaras|aon|entenjeis|ove|avees|ova|eis|aessa|aessan|entenjarà|aes|aeis|avea|entenjon|ombe|aessais|aede|eibes|essais|aean	<i>verb</i><br><ol><li>To colour, tint</li></ol>
enveze	<i>adv</i><br><ol><li>instead, but, whereas, on the contrary</li></ol>
erjer|esse|as|aesses|é|erjeis|erjessan|areis|erjoves|erjesses|ébe|erjessais|ert|aron|erjaré|ebes|ovais|erjon|arà|ae|essa|erjaras|erjessa|aras|esses|abù|aveais|erjan|erjove|avei|erjes|erjareis|aré|ovan|avean|avee|erje|erjovan|erjaron|on|ebe|erjede|essan|erjesse|à|oves|aesse|aon|ove|erjovais|avees|ova|ombe|erjarà|eis|erjova|aessa|aessan|aes|aeis|avea|aessais|erj|aede|eibes|essais|aean	<i>verb</i><br><ol><li>To erect</li></ol>
erma|ermes	<i>noun</i><br><ol><li>weapon, arms</li><li>force (military)</li></ol>
ert|erc	<i>noun</i><br><ol><li>art</li></ol>
esecutif|esecutives|esecutiva|esecutifs	<i>adj</i><br><ol><li>executive</li></ol>
esecuzion|esecuzions	<i>noun</i><br><ol><li>execution (all senses)</li></ol>
eserzitazion|eserzitazions	<i>noun</i><br><ol><li>exercise</li></ol>
eserzitea	<i>verb</i><br><ol><li>exercises (3rd person singular, present tense)</li></ol>
eserziter|esse|as|aesses|é|eserzite|areis|eserzitarà|eserzitovais|eserzitova|ébe|aron|essa|ebes|ovais|ae|arà|eserzitovan|eserzitasse|eserziteies|aras|esses|abù|eserziteia|eserzitan|aveais|eserzitaron|aessan|eserzitareis|eserzita|avei|eserziton|eserzitassais|eserzitaras|aré|aesse|ovan|eserzitoves|eserzites|eserzitaré|eserzitassa|avee|avean|on|ebe|eserzitedes|eserzitove|essan|eserzités|eserzité|eserzitasses|eserziteis|à|aon|eserzitea|ove|eserziteie|oves|eserzitassan|eis|avees|ova|eibes|eserziteda|aeis|avea|aes|ombe|aessa|aessais|eserzitede|aede|essais|aean	<i>verb</i><br><ol><li>To exercise</li><li>To practice, train</li></ol>
eserzité	<i>verb</i><br><ol><li>exercised</li></ol>
esigenza|esigenzes	<i>noun</i><br><ol><li>requirement, need</li></ol>
esistent|esistenti|esistenta|esistentes	<i>adj</i><br><ol><li>existing</li></ol>
espert|esperc	<i>noun</i><br><ol><li>expert</li></ol>
esplizitamënter	<i>adv</i><br><ol><li>explicitly</li></ol>
esplosif|esplosives|esplosiva|esplosifs	<i>adj</i><br><ol><li>explosive</li></ol>
esprescion|esprescions	<i>noun</i><br><ol><li>expression</li></ol>
espressamënter	<i>adv</i><br><ol><li>expressly</li></ol>
espurtazion|espurtazions	<i>noun</i><br><ol><li>exportation</li></ol>
essenziel|essenziei|essenzieles|essenziela	<i>adj</i><br><ol><li>essential</li></ol>
estenscion|estenscions	<i>noun</i><br><ol><li>extension</li></ol>
ester|é|estera|esteres|foves|sté|fosses|ie|sareis|sun|saron|saras|sies|fovais|fossa|fova|fossan|fovan|steda|fosse|sarà|esters|fossais|stés|saré|sede|son|stedes|fove|sian|seis|sie|ies	<i>adj</i><br><ol><li>foreign, overseas</li></ol><br><i>verb</i><br><ol><li>to be</li></ol>
estlusif|estlusiva|estlusives|estlusifs	<i>adj</i><br><ol><li>exclusive</li></ol>
estradizion	<i>noun</i><br><ol><li>extradition</li></ol>
europeich|europeic|europeices|europeica	<i>adj</i><br><ol><li>European</li></ol>
facultà	<i>noun</i><br><ol><li>faculty</li><li>power, authority</li></ol>
fal|fai	<i>noun</i><br><ol><li>error</li></ol>
falcon	<i>noun</i><br><ol><li>kestrel</li></ol>
familia|families	<i>noun</i><br><ol><li>family</li></ol>
fantom	<i>noun</i><br><ol><li>ghost</li></ol>
faraona	<i>noun</i><br><ol><li>guinea fowl</li></ol>
fat|fata|fac|fates|fats	<i>noun</i><br><ol><li>fact</li></ol><br><i>adj</i><br><ol><li>done</li></ol>
fauc|fauces	<i>noun</i><br><ol><li>(Gherdëina) scythe</li></ol>
fauré|faurés	<i>noun</i><br><ol><li>February</li></ol>
fazion|fazions	<i>noun</i><br><ol><li>effect, effectiveness</li></ol>
fedel|fedela|fedei|fedeles	<i>adj</i><br><ol><li>loyal</li><li>faithful</li></ol>
fedelmënter	<i>adv</i><br><ol><li>faithfully, loyally</li></ol>
fedeltà	<i>noun</i><br><ol><li>loyalty, faithfulness</li></ol>
femena|femenes	<i>noun</i><br><ol><li>woman</li><li>wife</li></ol>
feria|feries	<i>noun</i><br><ol><li>(chiefly in the plural) holiday, vacation</li></ol>
festa|festes	<i>noun</i><br><ol><li>(official) holiday</li></ol>
festide|festidesc	<i>noun</i><br><ol><li>(Gherdëina) worry</li></ol>
fin|fins	<i>noun</i><br><ol><li>aim, end, goal</li></ol>
final|finai|finales|finala	<i>adj</i><br><ol><li>final</li></ol>
finalmenter	<i>adv</i><br><ol><li>finally</li></ol>
finanza|finanzes	<i>noun</i><br><ol><li>finance</li></ol>
finanziamënt|finanziamënts	<i>noun</i><br><ol><li>financing</li></ol>
finanzier|esse|as|aesses|é|finanziaron|finanziasse|areis|finanziovais|finanziarà|ébe|essais|aron|essa|finanzieis|finanzion|finanzieia|ovais|arà|ae|ebes|finanziove|finanzie|aras|esses|abù|finanziaras|aveais|finanziede|finanzieies|finanziea|finanzies|finanziareis|finanzieie|finanzié|finanziedes|avei|finanziaré|finanziés|aré|finanziova|finanziassan|ovan|avean|avee|finanzia|finanziovan|ebe|on|avea|essan|à|oves|finanziassa|aon|finanziassais|ove|avees|ova|finanzian|aesse|eis|aessa|aessan|aessais|aes|aeis|finanziasses|aede|ombe|finanzieda|eibes|finanzioves|aean	<i>verb</i><br><ol><li>To finance</li></ol>
finanziera|finanzieres	<i>noun</i><br><ol><li>financier</li></ol>
finel|finela|fineles|finei	<i>adj</i><br><ol><li>final</li></ol>
fischel|fischela|fischei|fischeles	<i>adj</i><br><ol><li>fiscal</li></ol>
fisich|fisic|fisicia|fisices	<i>adj</i><br><ol><li>physical</li></ol>
fisser|esse|as|fissassa|aesses|é|fissaron|fissassan|fisseia|areis|fisson|fissassais|fissan|ébe|essais|aron|fissasse|essa|ebes|ovais|fissé|arà|ae|fisseis|fisse|aras|esses|abù|aveais|fisseie|fissove|fisseda|fissede|fissareis|fissaré|fissoves|avei|fissea|fissasses|aré|ovan|fissovan|avee|fissedes|avean|fisses|fissova|on|fisseies|ebe|avea|essan|fissés|à|fissa|oves|aesse|aon|ove|ova|avees|aessan|eis|aessa|aessais|aes|aeis|fissarà|aede|ombe|fissovais|eibes|fissaras|aean	<i>verb</i><br><ol><li>To fix, fasten</li></ol>
fiëura|fiëures	<i>noun</i><br><ol><li>(Gherdëina) fever</li></ol>
flagranza|flagranzes	<i>noun</i><br><ol><li>flagrancy</li></ol>
fonch|fonc	<i>noun</i><br><ol><li>(Gherdëina) mushroom</li></ol>
fond|fonds	<i>noun</i><br><ol><li>fund</li><li>bottom</li></ol>
fonz|fonc	<i>noun</i><br><ol><li>(Gherdëina) floor, ground</li></ol>
forma|formes	<i>noun</i><br><ol><li>form</li><li>shape</li></ol>
forza|forzes	<i>noun</i><br><ol><li>force</li></ol>
fosch	<i>adj</i><br><ol><li>(Gherdëina) black</li></ol>
franjer|esse|as|aesses|franjaras|franjesses|é|franjarà|franjaré|areis|ébe|aron|franjessais|franjove|franjesse|essa|franj|ovais|ae|franjede|arà|ebes|franjon|aras|esses|abù|aveais|franjareis|franjessa|franjessan|avei|franje|franjeis|aré|franjes|franjovais|ovan|avean|avee|franjovan|franjoves|on|ebe|essan|à|oves|aesse|aon|ove|ova|franjan|avees|aessan|frant|eis|aessa|franjaron|aessais|aes|aeis|avea|aede|ombe|franjova|eibes|essais|aean	<i>verb</i><br><ol><li>To break into pieces</li></ol>
fuera|fueres	<i>noun</i><br><ol><li>(Gherdëina) noise (unwanted sound)</li></ol>
fujion|fujions	<i>noun</i><br><ol><li>fusion</li></ol>
fulestier|fulestieres	<i>noun</i><br><ol><li>foreigner, alien, stranger</li></ol>
fulimant|fulimanc	<i>noun</i><br><ol><li>(Gherdëina) match (device to make fire)</li></ol>
fundamentel|fundamentela|fundamentei|fundamenteles	<i>adj</i><br><ol><li>fundamental</li></ol>
funded|fundeds|fundedes|fundeda	<i>adj</i><br><ol><li>founded, established</li></ol>
fundier|fundiers|fundiera|fundieres	<i>adj</i><br><ol><li>land (attributive)</li></ol>
funtana|funtanes	<i>noun</i><br><ol><li>fount, fountain</li></ol>
funzion|funzions|funziones	<i>noun</i><br><ol><li>function</li><li>ceremony, rite</li></ol>
funzionament|funzionamenc	<i>noun</i><br><ol><li>working, operation, functioning</li></ol>
furmazion|furmazions	<i>noun</i><br><ol><li>formation</li></ol>
furmer|esse|as|aesses|é|aean|furmes|furma|areis|furmaron|furmeda|ébe|aron|essa|furmassan|furmeies|ovais|furmova|arà|ae|ebes|furmeis|furmede|aras|esses|furmasses|abù|furmés|aveais|furmaras|furmasse|aessan|furmassa|furmove|furmassais|furmoves|avei|aré|aesse|ovan|avean|avee|furmovan|furme|on|ebe|furmaré|furman|essan|à|oves|furmedes|aon|ove|furmarà|furmovais|avees|ova|furmareis|furmeie|eis|ombe|furmea|aes|aeis|avea|furmé|furmeia|aessa|aessais|eibes|aede|essais|furmon	<i>verb</i><br><ol><li>To form, shape</li></ol>
fé|fajaron|fates|fajovais|fajessais|fajaras|fajovan|fà|fajareis|fajede|fat|feje|fèr|fajova|fejes|fajessan|fata|fac|fej|fajon|fajove|fajarà|fajesses|fajessa|fajoves|fajesse|fajaré|fajeis	<i>verb</i><br><ol><li>To do</li><li>To make</li></ol>
fën|fëns	<i>noun</i><br><ol><li>(Gherdëina) hay</li></ol>
fëna|fenans	<i>noun</i><br><ol><li>(Gherdëina) wife</li><li>(Gherdëina) lady</li></ol>
fòra	<i>adv</i><br><ol><li>out (of), outside</li></ol>
gabian	<i>noun</i><br><ol><li>common gull</li></ol>
gabinel	<i>noun</i><br><ol><li>buzzard</li></ol>
gacia	<i>noun</i><br><ol><li>Eurasian magpie, Pica pica</li></ol>
galón	<i>noun</i><br><ol><li>thigh</li></ol>
garantida	<i>adj</i><br><ol><li>guaranteed</li></ol>
garantir|esse|garantide|as|garantieis|é|aesses|garantivan|garantes|garantisse|areis|garant|garantiron|garantisses|ébe|aron|garantivais|essa|ebes|ovais|ae|arà|garantissais|garantesces|aras|abù|esses|aveais|garantì|garantissa|aessan|garante|avei|aré|garantesce|ovan|avean|avee|on|ebe|garantion|garantirà|garantiva|essan|garantiré|garantian|garantiras|à|oves|garantive|aon|ove|avees|ova|garantives|aesse|garantireis|eis|garantesc|aessa|aes|aeis|avea|garantissan|ombe|aessais|aede|eibes|essais|aean	<i>verb</i><br><ol><li>to guarantee</li></ol>
garantësc	<i>verb</i><br><ol><li>guarantees (3rd person singular, present tense)</li></ol>
garanzia|garanzies	<i>noun</i><br><ol><li>guarantee, warrant, security</li></ol>
gauje|gaujes	<i>noun</i><br><ol><li>reason</li><li>motive</li></ol>
gaujer|esse|as|gaujeie|aesses|gaujan|é|gaujeis|gaujés|gaujeia|areis|gaujede|ébe|gaujareis|aron|gaujeies|ebes|ovais|ae|arà|essa|gaujove|gaujaré|aras|abù|esses|aveais|gaujaras|gaujasses|gaujova|avei|gauje|aré|gaujaron|gaujoves|ovan|gaujovais|gaujes|avee|avean|gaujarà|gaujassa|gaujea|gaujassais|gaujovan|gaujon|ebe|gaujé|on|essan|gauja|à|gaujedes|oves|aesse|gaujassan|aon|ove|avees|ova|aessan|eis|gaujeda|aessa|aessais|aes|gaujasse|avea|aeis|ombe|aede|eibes|essais|aean	<i>verb</i><br><ol><li>To cause</li></ol>
general|generales|generai|generala	<i>adj</i><br><ol><li>general</li></ol>
generalmënter	<i>adv</i><br><ol><li>generally</li></ol>
generel|generela|genereles|generei	<i>adj</i><br><ol><li>general</li></ol>
genitor|genitores	<i>noun</i><br><ol><li>parent</li></ol>
gestion	<i>noun</i><br><ol><li>management, administration</li></ol>
ghernea|gherneies	<i>noun</i><br><ol><li>(Gherdëina) broom (usually one used outdoors)</li></ol>
gialvëija|gialvëijes	<i>noun</i><br><ol><li>(Gherdëina) blueberry</li></ol>
giapé	<i>verb</i><br><ol><li>(Gherdëina) to receive, to get, to obtain</li></ol>
giat|giac	<i>noun</i><br><ol><li>cat</li></ol>
giatolin|giatolins	<i>noun</i><br><ol><li>kitten</li></ol>
giaulon|giauloni	<i>noun</i><br><ol><li>(Gherdëina) sweet (UK), candy (US)</li></ol>
giudesc	<i>noun</i><br><ol><li>judge</li></ol>
giudicher|esse|as|aesses|giudichasses|é|aean|giudicharon|giudicheda|giudiches|giudichede|areis|giudichovais|giudicheie|giudichareis|giudicheies|giudicha|ébe|aron|essa|ebes|ovais|ae|arà|giudichea|giudichés|aras|abù|esses|giudichan|giudicheis|giudiché|aveais|giudichove|giudicharas|giudicharé|giudichassan|giudichon|avei|aré|giudichoves|ovan|avean|avee|giudichedes|giudichassais|ebe|on|giudiche|giudicheia|essan|à|giudicharà|oves|giudichova|aon|ove|ova|avees|giudichovan|aesse|aessan|eis|aessa|eibes|aes|aeis|avea|aessais|ombe|aede|giudichasse|essais|giudichassa	<i>verb</i><br><ol><li>To judge</li></ol>
giudizie|giudizies	<i>noun</i><br><ol><li>judgment (all senses)</li></ol>
giudizier|giudizieres|giudiziera|giudiziers	<i>adj</i><br><ol><li>judicial, legal</li></ol>
giuridich|giuridic|giuridicia|giuridices	<i>adj</i><br><ol><li>legal</li></ol>
giurisdizion|giurisdizions	<i>noun</i><br><ol><li>jurisdiction</li></ol>
giurisdiziunel|giurisdiziunei|giurisdiziuneles|giurisdiziunela	<i>adj</i><br><ol><li>jurisdictional</li></ol>
giust|giusc|giustes|giusta	<i>adj</i><br><ol><li>suitable, appropriate, convenient, correct</li></ol>
giustizia	<i>noun</i><br><ol><li>justice</li></ol>
giut	<i>adv</i><br><ol><li>(Gherdëina) long (having a duration in time), for a long time</li><li>(Gherdëina) in a long time</li></ol>
gloria|glories	<i>noun</i><br><ol><li>glory</li></ol>
goder|gode|esse|godeie|as|aesses|é|godassais|goda|godes|godede|godeda|areis|godareis|godés|ébe|aron|godasses|godaras|ebes|ovais|ae|godé|godon|godaron|arà|essa|godaré|aras|esses|abù|godove|godassa|aveais|godarà|godova|avei|aré|godeis|godeies|godoves|godeia|godovais|godedes|godea|avee|ovan|avean|on|ebe|essan|à|godan|oves|aesse|aon|ove|ova|avees|aessan|godasse|eis|aessa|godovan|eibes|aes|aeis|avea|aessais|ombe|aede|godassan|essais|aean	<i>verb</i><br><ol><li>To enjoy</li></ol>
gola|goles	<i>noun</i><br><ol><li>(Gherdëina) craving</li></ol>
gran|granda|grandes|gragn	<i>adj</i><br><ol><li>large; great</li></ol>
graton	<i>noun</i><br><ol><li>wheelbarrow</li></ol>
grazia|grazies	<i>noun</i><br><ol><li>grace</li><li>pardon</li></ol>
grief|grieves|grieva|griefs	<i>adj</i><br><ol><li>arduous</li><li>difficult</li><li>steep</li></ol>
grupa|grupes	<i>noun</i><br><ol><li>group</li></ol>
guant|guanc	<i>noun</i><br><ol><li>(gherdëina, badiot, fascian) dress, gown, clothes</li></ol>
gudiment|gudimenc	<i>noun</i><br><ol><li>enjoyment</li><li>possession (legal)</li></ol>
guviern|guvierns	<i>noun</i><br><ol><li>government</li></ol>
hoi	<i>intj</i><br><ol><li>(Gherdëina) A greeting acknowledging someone’s arrival or presence, comparable to English hey, hi</li></ol>
i	<i>article</i><br><ol><li>the</li></ol>
imigrazion|imigrazions	<i>noun</i><br><ol><li>immigration</li></ol>
in	<i>prep</i><br><ol><li>in</li></ol>
inant	<i>adv</i><br><ol><li>forward</li></ol><br><i>prep</i><br><ol><li>before</li><li>in front of</li></ol>
inconsolabel|inconsolabei|inconsolabeles|inconsolabela	<i>adj</i><br><ol><li>inconsolable</li></ol>
inconsolabelmenter	<i>adv</i><br><ol><li>inconsolably</li></ol>
indesc	<i>noun</i><br><ol><li>index</li><li>rating</li></ol>
iniò	<i>adv</i><br><ol><li>(Gherdëina) nowhere</li></ol>
inom|inuemes|inomes|inuem	<i>noun</i><br><ol><li>name</li></ol>
inuvazion|inuvazions	<i>noun</i><br><ol><li>innovation</li></ol>
ispezion|ispezions	<i>noun</i><br><ol><li>inspection</li></ol>
istituir|esse|as|aesses|istituesce|istituives|é|istituion|istituì|areis|istituieis|istituireis|ébe|aron|istitues|istituirà|istituissan|essa|ebes|ovais|ae|arà|istituivais|istituive|istituian|aras|istituiva|abù|istituesces|esses|aveais|istituiras|istituide|istituiré|avei|istituissa|aré|istituisse|istitue|istituiron|ovan|avee|avean|istituisses|on|ebe|essan|à|oves|aesse|aon|ove|ova|avees|istituesc|ombe|aessan|eis|aessa|istituivan|aes|aeis|avea|aessais|istituissais|istitu|aede|eibes|essais|aean	<i>verb</i><br><ol><li>To institute, found</li></ol>
istitut|istituc	<i>noun</i><br><ol><li>institute</li></ol>
istituzion|istituzions	<i>noun</i><br><ol><li>institution</li></ol>
istituzional|istituzionai|istituzionala|istituzionales	<i>adj</i><br><ol><li>institutional</li></ol>
istruir|esse|istruive|istruion|as|aesses|é|istruirà|istruiras|istruiron|istrue|areis|istruissais|istruian|istruieis|ébe|istruives|istruiva|istruissan|aron|essa|ebes|ovais|ae|arà|istru|istruì|istrues|istruivais|aras|abù|esses|istruivan|aveais|istruide|istruiré|istruisse|istruissa|avei|aré|istruesces|ovan|avean|avee|on|istruireis|ebe|istruesce|istruisses|avea|essan|à|oves|aesse|aon|ove|ova|avees|aessan|eis|aessa|aessais|aes|aeis|istruesc|aede|ombe|eibes|essais|aean	<i>verb</i><br><ol><li>To instruct, educate</li></ol>
istruzion|istruzions	<i>noun</i><br><ol><li>instruction</li></ol>
jebia|jebies	<i>noun</i><br><ol><li>Thursday</li></ol>
jegher|jegri	<i>noun</i><br><ol><li>(Gherdëina) sacristy</li></ol>
jené|jenés	<i>noun</i><br><ol><li>January</li></ol>
jita|jites	<i>noun</i><br><ol><li>journey, trip</li></ol>
jonjer|esse|jonjede|as|jonjaré|jonjaras|jonjesses|é|aesses|areis|ébe|jonjove|jont|aron|essa|jonjarà|jonjesse|ovais|arà|jonjovan|ae|ebes|jonjaron|aras|jonjova|abù|esses|aveais|jonjareis|jonjovais|avei|jonjessa|jonj|aré|ovan|avean|avee|jonjan|jonjes|on|ebe|jonjon|essan|à|oves|jonje|jonjeis|aon|ove|ova|avees|aesse|aessan|eis|jonjessais|aessa|eibes|aes|aeis|avea|aessais|ombe|jonjessan|aede|jonjoves|essais|aean	<i>verb</i><br><ol><li>To yoke</li><li>To subjugate</li></ol>
jonta|jontes	<i>noun</i><br><ol><li>council, committee, assembly</li><li>junta</li></ol>
ju	<i>adv</i><br><ol><li>down, below</li><li>downstairs</li></ol>
jugn|jugns	<i>noun</i><br><ol><li>June</li></ol>
junëza	<i>noun</i><br><ol><li>youth (state of being young)</li></ol>
jurament|juraments	<i>noun</i><br><ol><li>oath, pledge</li></ol>
jëuf|jëufes	<i>noun</i><br><ol><li>(Gherdëina) mountain pass</li></ol>
jì|jiras|jissais|jiré|va|jisses|jives|jirà|vas|jiva|jivais|jù|jisse|jiron|jireis|vaes|jieis|jivan|jissa|jide|jion|jive|jit|vae|jissan	<i>verb</i><br><ol><li>To go</li></ol>
l	<i>article</i><br><ol><li>the</li></ol>
l'	<i>article</i><br><ol><li>(before a vowel) Apocopic form of la: the</li></ol>
la	<i>article</i><br><ol><li>the</li></ol>
ladin|ladins|ladines|ladina	<i>adj</i><br><ol><li>Ladin (related to the people or language of Alpine Italy)</li></ol>
lascer|esse|lascassais|as|aesses|lascasse|é|lasceie|lascés|lascon|areis|lascede|lasceia|ébe|aron|essa|ebes|lascovais|ovais|arà|ae|lascaras|lasces|lasce|lascove|lascareis|aras|esses|abù|lascaré|aveais|lascovan|lascova|lascedes|avei|lasceis|lascé|lascaron|aré|ovan|avean|lascassan|lasca|lascea|avee|on|ebe|lascasses|essan|à|oves|aesse|lasceies|lascan|aon|lascoves|lascassa|ove|avees|eis|ova|aessa|aessan|aes|aeis|avea|aessais|ombe|lascarà|aede|eibes|essais|aean	<i>verb</i><br><ol><li>(transitive) to leave (something behind); to let (something happen) or allow (something to happen)</li></ol>
latifont|latifonc	<i>noun</i><br><ol><li>A large farm or agricultural estate</li></ol>
laurant|lauranc|lauranta	<i>noun</i><br><ol><li>worker</li></ol>
lauranta	<i>noun</i><br><ol><li>worker (female)</li></ol>
leal|leales|leai|leala	<i>adj</i><br><ol><li>loyal</li><li>honest</li></ol>
lege|leges	<i>noun</i><br><ol><li>law</li></ol>
legislatif|legislatives|legislatifs|legislativa	<i>adj</i><br><ol><li>legislative</li></ol>
legislatura|legislatures	<i>noun</i><br><ol><li>legislature</li></ol>
legislazion	<i>noun</i><br><ol><li>legislation</li></ol>
legitim|legitima|legitimes|legitims	<i>adj</i><br><ol><li>legitimate, legal, rightful</li></ol>
legitimità	<i>noun</i><br><ol><li>legitimacy</li></ol>
lerch	<i>noun</i><br><ol><li>Distance between things.</li><li>Physical extent across two or three dimensions.</li></ol>
les	<i>article</i><br><ol><li>the</li></ol>
lesier|lesiers|lesiera|lesieres	<i>adj</i><br><ol><li>(Gherdëina) light (in weight)</li><li>(Gherdëina) light (of diet, low in calories)</li></ol>
leterer|leterers|letereres|leterera	<i>adj</i><br><ol><li>literary</li></ol>
lezitent|lezitenc|lezitenta|lezitentes	<i>adj</i><br><ol><li>zealous</li></ol>
liam|liams	<i>noun</i><br><ol><li>bond, tie</li></ol>
lidëza	<i>noun</i><br><ol><li>liberty</li></ol>
liede|liedia|liedies|liedesc|liedes	<i>adj</i><br><ol><li>free</li></ol>
lim|lims	<i>noun</i><br><ol><li>limit</li></ol>
limitan	<i>verb</i><br><ol><li>limiting</li></ol>
limitazion|limitazions	<i>noun</i><br><ol><li>limitation</li></ol>
limiter|limitovais|esse|limitaras|limiteda|as|é|aesses|limitova|limitovan|limitede|areis|limité|ébe|limités|limiteies|aron|limitoves|essa|ebes|ovais|limiteia|arà|ae|limite|aras|esses|abù|limitaré|limitove|aveais|limitaron|limiteis|avei|limitassan|aré|ovan|avean|avee|limiteie|limiton|on|ebe|limitassais|limitea|limitareis|limitan|essan|à|oves|limitasse|limitedes|aon|limitarà|ove|avees|ova|ombe|aesse|eis|aessa|aessan|limitassa|limitasses|aeis|avea|limita|aes|aessais|limites|eibes|aede|essais|aean	<i>verb</i><br><ol><li>to limit</li></ol>
linciola|lincioles	<i>noun</i><br><ol><li>(Gherdëina) hazelnut</li></ol>
lingaz|lingac	<i>noun</i><br><ol><li>language, tongue</li></ol>
linguistich|linguistic|linguisticia|linguistices	<i>adj</i><br><ol><li>linguistic</li></ol>
litabl|litabla|litables|litabli	<i>adj</i><br><ol><li>elective</li></ol>
litabltà	<i>noun</i><br><ol><li>eligibility</li></ol>
litadeura|litadeures	<i>noun</i><br><ol><li>voter</li></ol>
litazion|litazions	<i>noun</i><br><ol><li>election</li><li>voting</li></ol>
litel|liteles|litei|litela	<i>adj</i><br><ol><li>electoral</li></ol>
liter|esse|as|litassais|aesses|litaras|é|aean|liteies|litea|areis|litasse|lites|ébe|liteie|aron|litassa|ebes|ovais|ae|arà|essa|liteda|litan|aras|esses|abù|aveais|litaré|litarà|litoves|litedes|aessan|avei|liton|aré|aesse|ovan|avean|litareis|avee|liteia|litasses|on|ebe|litaron|liteis|litede|essan|à|oves|litovan|litovais|lités|litassan|aon|ove|avees|lite|litove|eis|ova|litova|aessa|aes|aeis|avea|aessais|ombe|aede|lita|eibes|essais|lité	<i>verb</i><br><ol><li>To vote</li></ol>
livel|livei|livela|liveles	<i>adj</i><br><ol><li>level</li></ol>
local|locales|locai|locala	<i>adj</i><br><ol><li>local</li></ol>
lonch|lonc|longia|longes	<i>adj</i><br><ol><li>long</li></ol>
lors	<i>noun</i><br><ol><li>bear</li></ol>
luega|lueges	<i>noun</i><br><ol><li>place</li></ol>
lum|lumes	<i>noun</i><br><ol><li>(Gherdëina) light</li></ol>
lunesc	<i>noun</i><br><ol><li>Monday</li></ol>
lustrel|lustriei	<i>noun</i><br><ol><li>lynx</li></ol>
luter|lutri|lutres|lutra	<i>adj</i><br><ol><li>(Gherdëina) liquid</li></ol>
lën|lëns	<i>noun</i><br><ol><li>(Gherdëina) wood (material)</li><li>(Gherdëina) tree</li></ol>
lënga|lënghes	<i>noun</i><br><ol><li>tongue</li></ol>
lënia|lënies	<i>noun</i><br><ol><li>(Gherdëina) firewood</li></ol>
lëur|lëures	<i>noun</i><br><ol><li>work, labour</li></ol>
magistrat|magistrac	<i>noun</i><br><ol><li>magistrate</li></ol>
magistratura|magistratures	<i>noun</i><br><ol><li>magistracy</li></ol>
maiuranza|maiuranzes	<i>noun</i><br><ol><li>majority</li></ol>
majer|majeri|majeres|majera	<i>adj</i><br><ol><li>bigger, greater, larger</li><li>major</li></ol>
malatia|malaties	<i>noun</i><br><ol><li>illness, sickness, disease, ailment</li></ol>
man|mans	<i>noun</i><br><ol><li>hand</li></ol>
mancianza|mancianzes	<i>noun</i><br><ol><li>lack</li></ol>
manco	<i>adj</i><br><ol><li>less</li></ol>
mandat|mandac	<i>noun</i><br><ol><li>mandate</li></ol>
mander|manda|esse|as|mandeies|aesses|é|mandes|mandaré|mandedes|mandova|mandeia|areis|mandé|mandarà|mandaras|ébe|essais|aron|mandovais|ebes|ovais|ae|mandea|mandés|arà|mandede|mandassais|essa|mandassan|mandovan|abù|aras|esses|aveais|mandasse|mandasses|mandove|avei|mandon|mande|aré|mandareis|ovan|avean|avee|on|mandeda|ebe|essan|mandeie|à|oves|mandeis|aesse|aon|ove|ova|avees|aessan|mandan|mandassa|eis|aessa|mandoves|aeis|avea|aes|ombe|aessais|aede|eibes|mandaron|aean	<i>verb</i><br><ol><li>to send, dispatch</li></ol>
maniera|manieres	<i>noun</i><br><ol><li>manner</li></ol>
manifestazion|manifestazions	<i>noun</i><br><ol><li>manifestation; display</li></ol>
manifester|manifestes|manifestan|esse|as|aesses|é|manifestedes|aede|manifeste|manifesté|manifestassan|manifesteia|areis|ébe|aron|manifestede|manifesta|essa|ebes|ovais|manifestova|arà|ae|manifesteis|manifesteie|manifestasse|manifesteies|manifeston|abù|aras|esses|aveais|manifestassa|manifestovan|avei|manifestaré|manifestareis|manifestove|aré|manifestaras|ovan|avee|avean|manifestea|on|ebe|manifestaron|essan|manifesteda|à|oves|aesse|aon|manifestassais|ove|avees|manifestasses|ova|aessan|eis|aessa|manifestés|aes|aeis|avea|manifestovais|ombe|aessais|manifestoves|eibes|manifestarà|essais|aean	<i>verb</i><br><ol><li>to manifest, show, display</li></ol>
manteniment|mantenimenc	<i>noun</i><br><ol><li>maintenance</li></ol>
mantenir|esse|as|aesses|é|manteniré|aede|mantenives|mantenion|aessais|areis|ébe|aron|manten|mantenide|ovais|ae|arà|ebes|essa|aessa|mantenes|mantenirà|mantenive|aras|mantenisse|abù|esses|mantene|mantenissan|aveais|mantenieis|manteniron|avei|aré|mantenireis|ovan|avean|avee|mantenian|on|ebe|mantenivan|mantenì|essan|à|oves|aesse|aon|ove|ova|avees|mantenissais|ombe|aessan|manteniras|mantenisses|mantenesc|mantenesce|eis|aeis|avea|mantenivais|aes|eibes|manteniva|mantenissa|mantenesces|essais|aean	<i>verb</i><br><ol><li>To maintain</li></ol>
marcià|marcei	<i>noun</i><br><ol><li>market</li></ol>
marider|esse|as|maridé|maridedes|é|maridovais|aesses|maridova|marideis|areis|maridasse|maride|ébe|maridassa|marideies|aron|marida|maridassan|ovais|ae|arà|marides|maridon|marideia|ebes|maridarà|maridasses|maridés|aras|esses|abù|maridareis|aveais|maridan|maridassais|maridaron|essa|maridea|marideie|avei|marideda|aré|maridoves|maridede|ovan|avean|avee|maridove|on|ebe|maridaré|essan|à|oves|aesse|aon|maridaras|ove|avees|ova|aessan|eis|aessa|eibes|aes|aeis|avea|aessais|ombe|aede|maridovan|essais|aean	<i>verb</i><br><ol><li>To marry</li></ol>
marënda|marëndes	<i>noun</i><br><ol><li>(Gherdëina) lunch</li></ol>
mascim|mascimes|mascima|mascims	<i>adj</i><br><ol><li>maximum</li></ol>
mascima|mascimes	<i>noun</i><br><ol><li>maximum</li></ol>
materia|materies	<i>noun</i><br><ol><li>matter, material</li></ol>
materiel|materiela|materieles|materiei	<i>adj</i><br><ol><li>material, physical</li></ol>
maternità	<i>noun</i><br><ol><li>maternity</li></ol>
matrimone|matrimonesc	<i>noun</i><br><ol><li>marriage</li><li>wedding (ceremony)</li></ol>
medemo|medemi|medemes|medema	<i>adj</i><br><ol><li>equal, same</li></ol>
meis|meisc	<i>noun</i><br><ol><li>month</li></ol>
mender|mendri	<i>noun</i><br><ol><li>minor (young person)</li></ol>
mendr|mendres|mendra|mendrs	<i>adj</i><br><ol><li>minor</li><li>less, least</li></ol>
mendranza|mendranzes	<i>noun</i><br><ol><li>minority</li></ol>
mener|esse|as|aesses|menasse|é|areis|meines|menassan|menasses|ébe|aron|meine|ebes|ovais|ae|arà|essa|menan|menova|aras|esses|abù|menareis|meneis|mené|aveais|menassa|menaré|avei|menoves|menassais|menaras|menede|aré|ovan|avean|avee|menovan|menea|meineia|ebe|on|menarà|menovais|meina|essan|à|oves|meineis|aon|menove|ove|meineie|menon|avees|ova|eis|aesse|aessa|aessan|aes|aeis|avea|aessais|ombe|menaron|aede|eibes|essais|aean	<i>verb</i><br><ol><li>to take or lead (someone somewhere)</li></ol>
mens|mensc	<i>noun</i><br><ol><li>month</li></ol>
mercia	<i>noun</i><br><ol><li>(Gherdëina, pathology) pus</li></ol>
mercol|mercoi	<i>noun</i><br><ol><li>Wednesday</li></ol>
merit|meric	<i>noun</i><br><ol><li>merit</li></ol>
merlo	<i>noun</i><br><ol><li>blackbird</li></ol>
mertesc	<i>noun</i><br><ol><li>Tuesday</li></ol>
merz|merc	<i>noun</i><br><ol><li>March</li></ol>
mesan|mesana|mesans|mesanes	<i>adj</i><br><ol><li>average, mean, middle</li></ol>
messei|messes|messoves|messon|messer|messù|messovais|messaré|messova|messeis|messareis|messessan|messaras|messarà|messesses|mess|messe|messan|messovan|messove|messaron|messessa|messessais|messesse	<i>verb</i><br><ol><li>To have to; must</li></ol>
messel|messei	<i>noun</i><br><ol><li>July</li></ol>
mesun|mesuns	<i>noun</i><br><ol><li>means, method</li></ol>
mesura|mesures	<i>noun</i><br><ol><li>measure (all senses); rule</li><li>dose</li></ol>
meter|esse|metes|as|aesses|é|metaron|areis|metovais|metessan|meton|metede|ébe|metan|aron|met|essa|ebes|ovais|ae|arà|metove|metaré|metarà|aras|metoves|abù|esses|aveais|metareis|metessa|metù|avei|metovan|mete|metesse|aré|metessais|ovan|avee|avean|metaras|ebe|on|essan|à|oves|aesse|aon|ove|ova|avees|ombe|aessan|meteis|eis|aessa|aessais|aes|metesses|avea|metova|aeis|aede|eibes|essais|aean	<i>verb</i><br><ol><li>to put, place</li></ol>
metoda|metodes	<i>noun</i><br><ol><li>method</li></ol>
metropolitan|metropolitans|metropolitanes|metropolitana	<i>adj</i><br><ol><li>metropolitan</li></ol>
miec	<i>adj</i><br><ol><li>better</li></ol>
mil	<i>noun</i><br><ol><li>honey</li></ol>
militaristich|militaristicia|militaristices|militaristic	<i>adj</i><br><ol><li>militaristic</li></ol>
militer|militra|militres|militri	<i>adj</i><br><ol><li>military</li></ol>
minim|minims|minima|minimes	<i>adj</i><br><ol><li>least</li><li>minimum</li></ol>
minister|ministeres	<i>noun</i><br><ol><li>minister</li><li>ministry</li></ol>
minonga|minonges	<i>noun</i><br><ol><li>opinion</li></ol>
mira|mires	<i>noun</i><br><ol><li>goal, aim, end</li></ol>
mirer|esse|as|aesses|é|mirarà|miran|miroves|mirasses|mireia|areis|ébe|essais|aron|mireies|essa|ebes|ovais|mirareis|arà|miré|ae|mirasse|mira|mirea|mireda|miraras|aras|esses|abù|mirassan|mire|aveais|mirassa|mirove|miraré|miredes|mireie|avei|mirede|aré|miron|ovan|avean|avee|miraron|ebe|on|mires|mireis|essan|mirés|mirova|à|oves|aesse|aon|ove|ova|avees|aessan|eis|aessa|eibes|aes|mirovais|avea|aeis|ombe|aessais|aede|mirassais|mirovan|aean	<i>verb</i><br><ol><li>to aim</li><li>to admire</li></ol>
moda|modes	<i>noun</i><br><ol><li>fashion</li><li>disorder, untidiness, chaos, mess</li><li>manner, method, way</li></ol>
modalità|modaliteies	<i>noun</i><br><ol><li>modality</li></ol>
monopol|monopoi	<i>noun</i><br><ol><li>monopoly</li></ol>
mont|montes	<i>noun</i><br><ol><li>mountain, mount, plateau</li></ol>
moral|morala|morai|morales	<i>adj</i><br><ol><li>moral</li></ol>
morir|muer|morives|é|moriras|morisses|foves|sté|fosses|sareis|morirà|sun|saron|saras|sies|fovais|morivais|fossa|morissais|fova|morion|fovan|fossan|ester|morisse|steda|fosse|mueres|sarà|fossais|stés|morì|moriré|saré|morissan|muere|moride|morivan|sede|morireis|son|mort|morieis|morissa|moriva|moriron|stedes|sian|seis|fove|morive|sie|ies	<i>verb</i><br><ol><li>to die</li></ol>
mort|mortes	<i>noun</i><br><ol><li>death</li></ol>
mosela	<i>noun</i><br><ol><li>tit (bird)</li></ol>
mozion|mozions	<i>noun</i><br><ol><li>motion (for debate)</li></ol>
mpartir|esse|mpartives|as|mpartesces|mpartivan|mpartive|mpartiré|mpartisses|mpartirà|mpartian|mpartivais|é|aesses|areis|mpartesce|mpartisse|ébe|aron|essa|ebes|ovais|ae|arà|mpartissais|aras|esses|mpartissa|abù|aveais|mpartissan|mpartì|avei|mpartiva|aré|ovan|avean|avee|mpartieis|mpart|mpartiron|on|mpartion|ebe|mpartiras|mparte|mpartes|essan|à|oves|aesse|aon|ove|mpartesc|avees|mpartide|ova|aessan|eis|aessa|aessais|mpartireis|aeis|avea|aes|ombe|aede|eibes|essais|aean	<i>verb</i><br><ol><li>To impart, give</li></ol>
mparzialità	<i>noun</i><br><ol><li>impartiality</li></ol>
mpediment|mpedimenc	<i>noun</i><br><ol><li>impediment</li></ol>
mpedësc	<i>verb</i><br><ol><li>prohibits (3rd person singular & plural, present tense)</li></ol>
mpedì|mpedida|mpedis|mpedides	<i>adj</i><br><ol><li>hampered, encumbered</li></ol>
mperjunamënt	<i>noun</i><br><ol><li>imprisonment</li></ol>
mplizitamënter	<i>adv</i><br><ol><li>implicitly</li></ol>
mpreja|mprejes	<i>noun</i><br><ol><li>enterprise, undertaking, exploit</li><li>company, firm, business</li></ol>
mpuniazion|mpuniazions	<i>noun</i><br><ol><li>impugnation</li></ol>
mpurtanza|mpurtanzes	<i>noun</i><br><ol><li>importance</li></ol>
mpurtazion|mpurtazions	<i>noun</i><br><ol><li>importation</li></ol>
mpuscibltà	<i>noun</i><br><ol><li>impossibility</li></ol>
mputat|mputac	<i>noun</i><br><ol><li>defendant</li><li>suspect</li></ol>
mudazion|mudazions	<i>noun</i><br><ol><li>modification</li></ol>
muder|mudassais|mudan|mudasses|mudovan|as|esse|é|aesses|mudes|mudeda|areis|mudea|mudaré|mudeia|mudasse|mudassa|ébe|aron|essais|essa|ebes|mudon|ovais|arà|mudede|ae|mudedes|aras|abù|esses|aveais|mudés|mudoves|mudareis|mudove|avei|aré|mudarà|mude|mudeis|ovan|avee|avean|mudé|mudassan|muda|mudeie|ebe|on|mudovais|essan|à|oves|mudaras|aesse|aon|ove|ova|avees|aessan|eis|aessa|eibes|mudova|aeis|avea|aes|ombe|aessais|aede|mudeies|mudaron|aean	<i>verb</i><br><ol><li>To change, modify, mutate</li><li>To commute</li><li>To substitute</li><li>To modify</li><li>To exchange</li></ol>
muele|muelia|muelesc|muelies	<i>adj</i><br><ol><li>(Gherdëina) picky</li></ol>
mument|mumenc	<i>noun</i><br><ol><li>moment</li></ol>
muneida|muneides	<i>noun</i><br><ol><li>money</li></ol>
munizion|munizions	<i>noun</i><br><ol><li>(especially in plural) munitions</li></ol>
musciat|musciac	<i>noun</i><br><ol><li>(Gherdëina) donkey</li><li>(Gherdëina, colloquially) idiot</li></ol>
mut|mutons	<i>noun</i><br><ol><li>boy, child</li></ol>
muta|mutans	<i>noun</i><br><ol><li>(Gherdëina) girl</li></ol>
mutived|mutiveds|mutiveda|mutivedes	<i>adj</i><br><ol><li>motivated</li></ol>
mutiver|esse|as|aesses|é|mutivaron|mutiveis|mutives|areis|mutivova|mutivasse|ébe|aron|essa|ebes|ovais|ae|arà|mutivovan|mutivaré|aras|mutivasses|abù|esses|mutivassa|aveais|mutiveia|mutiveies|mutivea|mutivassais|avei|aré|mutivan|ovan|avean|mutivé|mutivarà|mutivede|avee|mutivoves|mutivés|mutivassan|mutivove|ebe|on|mutivovais|mutiveie|mutiva|essan|à|oves|mutivon|aon|ove|ova|avees|aesse|aessan|mutive|eis|mutivareis|aessa|mutivaras|aes|aeis|avea|aessais|ombe|aede|eibes|essais|aean	<i>verb</i><br><ol><li>To motivate</li></ol>
muton|mutons	<i>noun</i><br><ol><li>ram (male sheep)</li><li>son (or, generically, offspring)</li></ol>
mutualità	<i>noun</i><br><ol><li>mutuality</li></ol>
mé|més	<i>noun</i><br><ol><li>May (month)</li></ol>
méssel|muessel	<i>verb</i><br><ol><li>it must</li></ol>
mënder|mëndra|mëndres|mëndri	<i>adj</i><br><ol><li>smaller</li><li>less</li><li>shorter</li><li>lesser</li><li>younger</li><li>smallest</li><li>shortest</li><li>youngest</li></ol><br><i>noun</i><br><ol><li>younger</li><li>youngest</li><li>child</li><li>minor (underage person)</li></ol>
mëter pën	<i>verb</i><br><ol><li>(Gherdëina) to bet</li></ol>
n	<i>article</i><br><ol><li>a (+ masculine noun)</li></ol>
n'	<i>article</i><br><ol><li>an, a</li></ol>
na	<i>article</i><br><ol><li>an, a</li></ol>
nascer|é|foves|nascessa|sté|fosses|sareis|nascan|nascessais|sun|saron|saras|nascareis|nascovais|nascesse|nasc|fossa|fovais|sies|fova|fossan|fovan|ester|steda|fosse|nascù|sarà|nascessan|nascovan|nascon|nasce|nascaré|nascesses|stés|fossais|nasces|saré|nascoves|sede|nascaras|nascaron|nascarà|son|nascove|stedes|fove|sian|seis|nascede|nasceis|sie|nascova|ies	<i>verb</i><br><ol><li>to be born</li></ol>
natura|natures	<i>noun</i><br><ol><li>nature</li></ol>
naturel|naturela|naturei|natureles	<i>adj</i><br><ol><li>natural</li></ol>
navigazion|navigazions	<i>noun</i><br><ol><li>navigation</li></ol>
nazion|nazions	<i>noun</i><br><ol><li>nation</li></ol>
naziunel|naziuneles|naziunei|naziunela	<i>adj</i><br><ol><li>national</li></ol>
nce	<i>adv</i><br><ol><li>also, too, as well, besides</li></ol>
nceria|nceries	<i>noun</i><br><ol><li>position</li><li>charge</li><li>load</li></ol>
nchin	<i>conj</i><br><ol><li>until</li></ol>
ncomper|ncompers|ncomperes|ncompera	<i>adj</i><br><ol><li>(Gherdëina) uncomfortable</li><li>(Gherdëina) unpleasant</li></ol>
ncuei	<i>adv</i><br><ol><li>(Gherdëina) today</li></ol>
ncumpatibl|ncumpatibles|ncumpatibla|ncumpatibli	<i>adj</i><br><ol><li>incompatible</li></ol>
ncumpatibltà	<i>noun</i><br><ol><li>incompatibility</li></ol>
ncurajer|ncurajasses|esse|as|ncurajassais|ncurajan|é|aesses|ncurajeis|ncuraje|ncurajaron|areis|ncuraja|ébe|aron|ncurajeie|ncurajeda|essa|ebes|ovais|ae|arà|ncurajassa|ncurajes|ncurajeies|aras|ncurajedes|abù|esses|ncurajea|aveais|ncurajareis|ncurajés|avei|ncurajovan|aré|ncurajarà|ncurajovais|ncurajaras|ncurajove|ovan|avee|ncurajoves|avean|ncurajaré|on|ebe|ncurajova|essan|à|ncurajassan|ncurajede|oves|ncurajon|aon|ove|avees|ova|ombe|aesse|eis|aessa|ncurajé|aessan|ncurajasse|aeis|avea|ncurajeia|aes|aessais|aede|eibes|essais|aean	<i>verb</i><br><ol><li>To encourage</li></ol>
ndenisazion|ndenisazions	<i>noun</i><br><ol><li>indemnity</li><li>compensation</li></ol>
ndenità	<i>noun</i><br><ol><li>indemnity</li></ol>
ndependenza|ndependenzes	<i>noun</i><br><ol><li>independence</li></ol>
ndependënt|ndependënc|ndependëndas|ndependënda|ndependëndes	<i>adj</i><br><ol><li>independent</li></ol>
ndicazion|ndicazions	<i>noun</i><br><ol><li>indication</li></ol>
ndicher|esse|ndichova|ndicharas|as|aesses|é|ndicheis|ndiché|ndichés|ndichasse|areis|ébe|ndichassais|ndichovais|aron|ndichoves|essa|ebes|ovais|ae|arà|ndicharon|ndichea|ndicheda|abù|ndicheies|aras|esses|aveais|ndichon|avei|ndichassan|ndichede|ndicha|aré|ndichan|ndichove|ndichassa|ndicheie|avee|ovan|ndiches|avean|ndicharé|on|ebe|ndichedes|avea|essan|à|oves|aesse|aon|ove|ova|ndicheia|ndiche|avees|aessan|ndicharà|eis|aessa|aessais|aes|aeis|ndichareis|aede|ombe|ndichovan|eibes|ndichasses|essais|aean	<i>verb</i><br><ol><li>To indicate</li><li>To determine</li></ol>
ndiret|ndireta|ndiretes|ndirets	<i>adj</i><br><ol><li>indirect</li></ol>
ndiretamënter	<i>adv</i><br><ol><li>indirectly</li></ol>
ndividualmënter	<i>adv</i><br><ol><li>individually</li></ol>
ndividuazion|ndividuazions	<i>noun</i><br><ol><li>detection</li><li>individualization</li></ol>
ndividuel|ndividuela|ndividuei|ndividueles	<i>adj</i><br><ol><li>individual</li></ol>
ndrezer|esse|ndrezove|as|aesses|é|ndrezedes|ndrezede|areis|ndrezoves|ndrezan|ébe|aron|ndreza|ndrezova|essa|ebes|ovais|ndrezeie|ndrezeia|ndrezaré|arà|ae|ndrezassa|ndrezassais|ndrezé|aras|esses|abù|ndrezassan|aveais|ndrezaron|ndrezeda|ndrezea|aessan|ndrezovais|ndrezés|ndrezasse|avei|ndrezeis|aré|ndrezasses|ndreze|ovan|avean|avee|on|ebe|ndrezareis|essan|à|oves|aesse|ndrezon|ndrezes|aon|ove|avees|ova|ndrezovan|ndrezarà|ndrezaras|eis|eibes|aes|aeis|avea|aessa|ombe|aessais|aede|ndrezeies|essais|aean	<i>verb</i><br><ol><li>To address</li></ol>
ndult|ndults	<i>noun</i><br><ol><li>pardon</li><li>indult</li></ol>
ne	<i>adv</i><br><ol><li>not</li></ol>
nen	<i>pron</i><br><ol><li>some</li></ol>
nevei|nevù|nevarà|neiv|nevessa|nevova|neive	<i>verb</i><br><ol><li>(impersonal) to snow</li></ol>
nfanzia	<i>noun</i><br><ol><li>infancy, childhood</li></ol>
nfurmatich|nfurmatic|nfurmatices|nfurmaticia	<i>adj</i><br><ol><li>informatic, computing (attributive)</li></ol>
nfurmazion|nfurmazions	<i>noun</i><br><ol><li>information</li></ol>
nfurmer|esse|as|aesses|nfurmeia|nfurmassa|é|nfurmaré|aean|nfurmovan|nfurme|nfurmove|areis|ébe|aron|essa|ebes|ovais|nfurmeis|nfurmova|arà|ae|nfurmes|nfurmés|aras|abù|esses|nfurmedes|nfurma|nfurmassais|nfurmareis|aveais|nfurmaras|nfurmassan|nfurmoves|nfurmé|nfurmon|avei|nfurman|nfurmede|aré|nfurmea|ovan|avean|avee|on|ebe|nfurmarà|nfurmovais|essan|nfurmaron|à|oves|aesse|aon|ove|nfurmeie|nfurmeies|avees|ova|aessan|nfurmasses|eis|aessa|aessais|aes|aeis|avea|aede|ombe|nfurmasse|eibes|essais|nfurmeda	<i>verb</i><br><ol><li>To inform</li></ol>
nia	<i>adj</i><br><ol><li>no, not (after a negative) any</li></ol><br><i>adv</i><br><ol><li>nothing, anything</li><li>at all</li></ol>
nience	<i>adv</i><br><ol><li>neither</li></ol>
njinier|esse|as|aesses|é|njiniovan|njinioves|njiniasse|njiniasses|areis|njiniarà|njinian|ébe|aron|essa|ebes|njiniedes|ovais|arà|ae|njinie|aras|njinieies|njinié|abù|esses|aveais|njiniaré|njinieie|njiniede|avei|njiniés|njiniareis|aré|njiniassais|njiniaron|njinieis|njiniova|njinia|njiniassan|njinion|avee|ovan|avean|on|ebe|njiniea|essan|à|njinieia|njiniassa|njinies|aon|ove|oves|avees|ova|ombe|aesse|eis|njinieda|aessa|aessan|njiniove|aeis|avea|aes|njiniovais|aessais|aede|eibes|njiniaras|essais|aean	<i>verb</i><br><ol><li>To engineer</li></ol>
njont|njonta|njonts|njontes	<i>adj</i><br><ol><li>additional, extra, supplementary</li></ol>
no	<i>adv</i><br><ol><li>not</li><li>no</li></ol>
nonanta	<i>adj</i><br><ol><li>ninety</li></ol><br><i>noun</i><br><ol><li>ninety</li></ol>
nonantecater	<i>adj</i><br><ol><li>ninety-four</li></ol><br><i>noun</i><br><ol><li>ninety-four</li></ol>
nonantecinch	<i>adj</i><br><ol><li>ninety-five</li></ol><br><i>noun</i><br><ol><li>ninety-five</li></ol>
nonantedoes	<i>adj</i><br><ol><li>ninety-two</li></ol><br><i>noun</i><br><ol><li>ninety-two</li></ol>
nonantenuef	<i>adj</i><br><ol><li>ninety-nine</li></ol><br><i>noun</i><br><ol><li>ninety-nine</li></ol>
nonanteset	<i>adj</i><br><ol><li>ninety-seven</li></ol><br><i>noun</i><br><ol><li>ninety-seven</li></ol>
nonantesies	<i>adj</i><br><ol><li>ninety-six</li></ol><br><i>noun</i><br><ol><li>ninety-six</li></ol>
nonantetrei	<i>adj</i><br><ol><li>ninety-three</li></ol><br><i>noun</i><br><ol><li>ninety-three</li></ol>
nonantot	<i>adj</i><br><ol><li>ninety-eight</li></ol><br><i>noun</i><br><ol><li>ninety-eight</li></ol>
nonantun	<i>adj</i><br><ol><li>ninety-one</li></ol><br><i>noun</i><br><ol><li>ninety-one</li></ol>
norma|normes	<i>noun</i><br><ol><li>norm</li></ol>
normal|normai|normales|normala	<i>adj</i><br><ol><li>normal</li></ol>
normalmenter	<i>adv</i><br><ol><li>normally</li></ol>
normatif|normativa|normatives|normatifs	<i>adj</i><br><ol><li>normative</li></ol>
normazif|normaziva|normazifs|normazifes|normazifa|normazives	<i>adj</i><br><ol><li>normative</li></ol>
november|novembers	<i>noun</i><br><ol><li>November</li></ol>
nrescida|nrescides	<i>noun</i><br><ol><li>search, hunt</li><li>research</li><li>investigation</li></ol>
nseniament	<i>noun</i><br><ol><li>teaching, education</li></ol>
nstes|nstessa|nstesses|nstesc	<i>adj</i><br><ol><li>different</li></ol>
ntant	<i>adv</i><br><ol><li>meanwhile</li><li>anyhow</li><li>but</li></ol>
ntegratif|ntegratives|ntegrativa|ntegratifs	<i>adj</i><br><ol><li>integrative</li></ol>
ntelet|ntelec	<i>noun</i><br><ol><li>intellect, intelligence</li></ol>
nteressà|nteressedes|nteresseda|nteressé|nteressei|nteressés	<i>adj</i><br><ol><li>interested</li></ol>
nteressé|nteressei|nteressés|nteresseda|nteressedas	<i>adj</i><br><ol><li>interested</li></ol>
nterest|nteresc	<i>noun</i><br><ol><li>interest, concern</li><li>business</li></ol>
ntern|nterna|nterns|nternes	<i>adj</i><br><ol><li>inside, internal</li><li>domestic, inland (not foreign)</li></ol>
nternaziunel|nternaziunei|nternaziuneles|nternaziunela	<i>adj</i><br><ol><li>international</li></ol>
nterogazion|nterogazions	<i>noun</i><br><ol><li>interrogation</li></ol>
nterpret|nterprec	<i>noun</i><br><ol><li>interpreter</li></ol>
ntervënt|ntervënc	<i>noun</i><br><ol><li>intervention</li></ol>
nterzetazion|nterzetazions	<i>noun</i><br><ol><li>interception</li><li>wiretap</li></ol>
ntier|ntiers|ntieres|ntiera	<i>adj</i><br><ol><li>entire</li><li>intact</li></ol>
ntlëuta	<i>adv</i><br><ol><li>(Gherdëina) at that time (in the past); at the time, then</li></ol>
ntreda|ntredes	<i>noun</i><br><ol><li>entry</li><li>entrance</li></ol>
nuef|nuefs|nueva|nueves	<i>adj</i><br><ol><li>new</li><li>nine</li></ol><br><i>noun</i><br><ol><li>nine</li></ol>
numer|numers	<i>noun</i><br><ol><li>number</li></ol>
numinazion|numinazions	<i>noun</i><br><ol><li>nomination</li></ol>
numinel|numinela|numineles|numinei	<i>adj</i><br><ol><li>nominal</li></ol>
numiner|esse|as|aesses|é|numinaras|numineie|numinaré|numineia|areis|numinan|numinea|numinassais|ébe|aron|numinasse|numines|essa|ebes|ovais|ae|arà|aras|esses|abù|aveais|numinede|numinés|numineies|avei|numinovan|numinassa|numinasses|numinova|aré|aesse|numina|ovan|numine|numinareis|avee|avean|on|ebe|numinedes|numineis|numineda|avea|essan|à|numinaron|numinon|oves|aon|ove|numiné|numinove|avees|ova|ombe|numinoves|eis|aessa|aessan|numinassan|aeis|numinarà|aes|numinovais|aessais|aede|eibes|essais|aean	<i>verb</i><br><ol><li>To nominate</li></ol>
nutizia|nutizies	<i>noun</i><br><ol><li>message, notice</li></ol>
nvalidità	<i>noun</i><br><ol><li>invalidity</li></ol>
nvestiment|nvestimenc	<i>noun</i><br><ol><li>investment</li></ol>
nviulabl|nviulables|nviulabla|nviulabli	<i>adj</i><br><ol><li>inviolable</li></ol>
nzaul	<i>adv</i><br><ol><li>(Gherdëina) somewhere, anywhere</li></ol>
nzident|nzidenc	<i>noun</i><br><ol><li>accident</li><li>injury</li></ol>
nëif	<i>noun</i><br><ol><li>snow</li></ol>
o	<i>conj</i><br><ol><li>or</li></ol>
obietif|obietifs|obietiva|obietives	<i>adj</i><br><ol><li>objective</li></ol>
oget|ogec	<i>noun</i><br><ol><li>object</li></ol>
ogetif|ogetives|ogetifs|ogetiva	<i>adj</i><br><ol><li>objective</li></ol>
oma|omans	<i>noun</i><br><ol><li>mother</li></ol>
ombolt	<i>noun</i><br><ol><li>mayor</li></ol>
onjer|esse|as|aesses|é|ont|areis|onj|ébe|aron|onjon|onjareis|ovais|ae|arà|ebes|essa|onjessa|onjan|onjaras|onjes|aras|onjaré|abù|esses|onjovais|aveais|onjovan|avei|aré|onjoves|ovan|onjaron|avee|avean|onjova|onjessan|onjove|onjeis|ebe|on|onje|onjede|avea|essan|à|oves|aesse|aon|ove|ova|avees|ombe|aessan|eis|aessa|onjarà|aes|onjesse|onjessais|onjesses|aeis|aessais|aede|eibes|essais|aean	<i>verb</i><br><ol><li>To annoint</li><li>To lubricate</li><li>To flatter</li></ol>
opera|operes	<i>noun</i><br><ol><li>work</li></ol>
ora|ores	<i>noun</i><br><ol><li>hour</li></ol><br><i>prep</i><br><ol><li>except</li></ol>
orden|ordens	<i>noun</i><br><ol><li>order</li></ol>
organn|organns	<i>noun</i><br><ol><li>organ</li></ol>
ostacul|ostaculs	<i>noun</i><br><ol><li>obstacle</li></ol>
ot	<i>adj</i><br><ol><li>eight</li></ol><br><i>noun</i><br><ol><li>eight</li></ol>
otanta	<i>adj</i><br><ol><li>eighty</li></ol><br><i>noun</i><br><ol><li>eighty</li></ol>
otantecater	<i>adj</i><br><ol><li>eighty-four</li></ol><br><i>noun</i><br><ol><li>eighty-four</li></ol>
otantecinch	<i>adj</i><br><ol><li>eighty-five</li></ol><br><i>noun</i><br><ol><li>eighty-five</li></ol>
otantedoes	<i>adj</i><br><ol><li>eighty-two</li></ol><br><i>noun</i><br><ol><li>eighty-two</li></ol>
otantenuef	<i>adj</i><br><ol><li>eighty-nine</li></ol><br><i>noun</i><br><ol><li>eighty-nine</li></ol>
otanteset	<i>adj</i><br><ol><li>eighty-seven</li></ol><br><i>noun</i><br><ol><li>eighty-seven</li></ol>
otantesies	<i>adj</i><br><ol><li>eighty-six</li></ol><br><i>noun</i><br><ol><li>eighty-six</li></ol>
otantetrei	<i>adj</i><br><ol><li>eighty-three</li></ol><br><i>noun</i><br><ol><li>eighty-three</li></ol>
otantot	<i>adj</i><br><ol><li>eighty-eight</li></ol><br><i>noun</i><br><ol><li>eighty-eight</li></ol>
otantun	<i>adj</i><br><ol><li>eighty-one</li></ol><br><i>noun</i><br><ol><li>eighty-one</li></ol>
otober|otobers	<i>noun</i><br><ol><li>October</li></ol>
paeje|paejes	<i>noun</i><br><ol><li>country (nation)</li><li>village, town</li></ol>
paesc	<i>noun</i><br><ol><li>country, nation, state</li><li>town</li></ol>
parificazion|parificazions	<i>noun</i><br><ol><li>(official) recognition</li></ol>
parlament|parlaments	<i>noun</i><br><ol><li>parliament</li></ol>
parlamenter|parlamentera|parlamenteres|parlamenters	<i>adj</i><br><ol><li>parliamentary</li></ol>
parola|paroles	<i>noun</i><br><ol><li>word</li></ol>
part	<i>noun</i><br><ol><li>part</li></ol>
partezipazion	<i>noun</i><br><ol><li>participation</li></ol>
parteziper|esse|as|partezipassa|é|aesses|partezipedes|partezipova|partezipassais|areis|partezipeda|ébe|partezipea|partezipovais|aron|essais|essa|ebes|ovais|ae|arà|partezipede|aessa|partezipasses|aras|esses|abù|partezipassan|aveais|partezipeia|partezipasse|aessan|avei|partezipes|partezipove|aré|parteziparon|ovan|avean|partezipeie|avee|partezipa|ebe|on|parteziparà|parteziparé|partezipeies|essan|à|oves|ombe|aesse|partezipovan|aon|partezipoves|partezipeis|partezipan|partezipés|partezipareis|parteziparas|eis|ove|avees|ova|aeis|avea|aes|partezipe|partezipon|aessais|eibes|aede|partezipé|aean	<i>verb</i><br><ol><li>To participate</li></ol>
particuler|particuleres|particulers|particulera	<i>adj</i><br><ol><li>particular</li></ol>
partir|partide|partisse|é|perte|partiron|partisses|foves|sté|fosses|partissais|sareis|sun|saron|saras|partives|pert|sies|fovais|fossa|partiré|fova|partive|fovan|fossan|ester|steda|partiras|fosse|sarà|pertes|partion|partivan|partissan|partirà|fossais|stés|saré|partireis|partì|partissa|sede|partivais|partieis|son|partiva|stedes|fove|sian|seis|partian|sie|ies	<i>verb</i><br><ol><li>to depart, leave</li></ol>
partizion|partizions	<i>noun</i><br><ol><li>partition, division</li><li>distribution</li></ol>
passer|passove|esse|as|aesses|é|aean|passarà|passaras|passasses|areis|passaron|ébe|passeis|passés|passova|aron|essa|passede|ovais|ae|arà|ebes|passé|passassais|passan|passes|aras|passassa|abù|esses|passe|aveais|passea|passeies|avei|passovan|aré|passa|ovan|passaré|avee|passeie|passedes|avean|passeia|passovais|on|ebe|passasse|passoves|avea|essan|à|oves|aesse|aon|ove|ova|avees|aessan|eis|aessa|aessais|aes|aeis|passon|passassan|ombe|aede|eibes|passeda|essais|passareis	<i>verb</i><br><ol><li>to proceed</li></ol>
passé dant	<i>verb</i><br><ol><li>(Gherdëina) to overtake; to pass (e.g. a vehicle, a runner)</li></ol>
paternità	<i>noun</i><br><ol><li>paternity</li></ol>
patrimone	<i>noun</i><br><ol><li>estate</li><li>fortune</li><li>heritage</li></ol>
patrimuniel|patrimuniela|patrimunieles|patrimuniei	<i>adj</i><br><ol><li>patrimonial</li></ol>
paussa|pausses	<i>noun</i><br><ol><li>halt, pause</li></ol>
pavël|pavëi	<i>noun</i><br><ol><li>(Gherdëina) butterfly</li></ol>
pazificamënter	<i>adv</i><br><ol><li>peacefully</li></ol>
peina|peines	<i>noun</i><br><ol><li>sorrow</li><li>pity</li><li>penalty,punishment</li></ol>
peis|peisc	<i>noun</i><br><ol><li>weight</li></ol>
pena|penes	<i>noun</i><br><ol><li>penalty, punishment</li></ol>
penal|penai|penales|penala	<i>adj</i><br><ol><li>penal</li></ol>
pensier|pensiers	<i>noun</i><br><ol><li>thought</li><li>worry</li></ol>
per	<i>prep</i><br><ol><li>for</li><li>through</li><li>in or on</li><li>by</li><li>with</li><li>as</li></ol>
percuisizion|percuisizions	<i>noun</i><br><ol><li>search</li></ol>
perde|esse|as|perdova|perdessais|perdovais|é|perdaron|aesses|areis|perdaré|perdessan|ébe|aron|essa|perdove|perder|perdoves|ovais|arà|ae|perdovan|ebes|perdareis|perdù|perdaras|aras|esses|abù|perdeis|aveais|avei|aré|perdarà|perdede|ovan|perdesse|avee|avean|on|ebe|perdon|perdan|essan|à|oves|aesse|aon|perdesses|perd|perdessa|ove|perdes|avees|eis|ova|aessa|aessan|aes|aeis|avea|aessais|ombe|aede|eibes|essais|aean	<i>verb</i><br><ol><li>To lose</li></ol>
perder|esse|as|perdova|perdessais|perdovais|é|perdaron|aesses|areis|perdaré|perdessan|ébe|aron|essa|perdove|ovais|perdoves|arà|ae|ebes|perdovan|perdareis|perdù|perdaras|aras|esses|abù|perdeis|aveais|perde|avei|aré|perdarà|perdede|ovan|perdesse|avee|avean|on|ebe|perdon|perdan|essan|à|oves|aesse|aon|perdesses|perd|perdessa|ove|perdes|avees|eis|ova|aessa|aessan|aes|aeis|avea|aessais|ombe|aede|eibes|essais|aean	<i>verb</i><br><ol><li>to lose</li></ol>
perdujer|esse|perdujeis|as|aesses|é|perdujesses|perdut|aean|perdujaron|perdujovais|perdujovan|areis|perdujessa|ébe|perdujes|aron|perdujoves|essa|ebes|ovais|ae|perdujan|arà|perdujove|perduje|aras|esses|abù|perdujova|aveais|perdujesse|avei|aré|perdujon|ovan|avee|avean|perdujareis|perdujaré|perduj|perdujarà|ebe|on|essan|perdujede|à|oves|aesse|aon|ove|ova|avees|ombe|aessan|eis|aessa|perdujaras|aessais|aes|aeis|avea|aede|perdujessais|eibes|essais|perdujessan	<i>verb</i><br><ol><li>To lose</li></ol>
pere|peresc	<i>noun</i><br><ol><li>father</li></ol>
perecuatif|perecuatives|perecuatifs|perecuativa	<i>adj</i><br><ol><li>equalizing (in terms of taxation etc)</li></ol>
perecuazion|perecuazions	<i>noun</i><br><ol><li>equalization (of taxes etc)</li></ol>
pericul|pericui	<i>noun</i><br><ol><li>danger</li></ol>
periodich|periodices|periodicia|periodic	<i>adj</i><br><ol><li>periodic</li></ol>
permanent|permanenta|permanentes|permanents	<i>adj</i><br><ol><li>permanent</li></ol>
persona|persones	<i>noun</i><br><ol><li>person</li></ol>
personal|personales|personala|personai	<i>adj</i><br><ol><li>personal</li></ol>
persunalità	<i>noun</i><br><ol><li>personality</li></ol>
persunel|persuneles|persunela|persunei	<i>adj</i><br><ol><li>personal</li></ol>
pert|pertes	<i>noun</i><br><ol><li>part</li></ol>
pervia	<i>adv</i><br><ol><li>by way of</li></ol>
pesc	<i>noun</i><br><ol><li>peace</li><li>calm, tranquility</li></ol>
pesoch|pesoches|pesocha|pesochs	<i>adj</i><br><ol><li>(Gherdëina) heavy (in weight)</li><li>(Gherdëina) heavy (of diet, high in calories)</li></ol>
petizion|petizions	<i>noun</i><br><ol><li>petition</li><li>denunciation</li></ol>
pezuó|pezuos	<i>noun</i><br><ol><li>(Anpezan) Norway spruce (Picea abies)</li></ol>
pien|pienes|piena|piens	<i>adj</i><br><ol><li>full</li><li>full up</li></ol>
pietcuecen	<i>noun</i><br><ol><li>robin</li></ol>
pitl|mënder|mëndres|pitles|pitli|mëndra|mëndri|pitla	<i>adj</i><br><ol><li>(Gherdëina) small</li><li>(Gherdëina) little</li><li>(Gherdëina) young</li></ol>
plovei|piever|plueve|pluev|plovù|plovarà|plovessa|plovova	<i>verb</i><br><ol><li>(impersonal) to rain</li></ol>
plu	<i>adj</i><br><ol><li>more</li></ol>
plumac|plumaces	<i>noun</i><br><ol><li>(Gherdëina) pillow</li></ol>
plutost	<i>adv</i><br><ol><li>rather</li><li>somewhat</li></ol>
podei|pò|podova|podesses|posse|podù|podessais|podessa|podon|podeis|podovais|podoves|podarà|podessan|podovan|podove|podareis|podaras|pos|posses|podaré|podan|podaron|podesse	<i>verb</i><br><ol><li>can, could; be able to</li><li>may, might; be possible to</li></ol>
polach|polagia|polages|polacs	<i>adj</i><br><ol><li>Polish</li></ol>
politich|politicia|politices|politic|politiches	<i>adj</i><br><ol><li>political</li></ol>
pona	<i>adv</i><br><ol><li>then; later</li></ol>
popul|populi	<i>noun</i><br><ol><li>people</li></ol>
populazion|populazions	<i>noun</i><br><ol><li>population</li></ol>
populer|esse|popularà|as|aesses|é|popularon|populasse|populedes|populoves|areis|popule|populassa|ébe|populeda|aron|essa|populea|ovais|ae|arà|ebes|populassan|popula|populovais|populareis|populera|aras|populers|abù|populeies|populassais|aveais|populove|esses|populé|avei|populeres|popularas|populovan|aré|populan|populeie|populés|ovan|avean|avee|popules|on|populeia|populeis|ebe|populede|essan|à|oves|aesse|populon|aon|ove|avees|populova|ova|aessan|eis|aessa|popularé|aes|aeis|avea|eibes|ombe|aessais|aede|populasses|essais|aean	<i>adj</i><br><ol><li>popular, common</li></ol><br><i>verb</i><br><ol><li>To populate</li></ol>
porcel	<i>noun</i><br><ol><li>pig</li></ol>
porsona|porsones	<i>noun</i><br><ol><li>person</li></ol>
port|porc	<i>noun</i><br><ol><li>port, harbour</li></ol>
porter|esse|as|portova|porton|porteia|é|portovais|aesses|portés|portede|portoves|areis|ébe|aron|essa|portan|ovais|ae|arà|ebes|portassais|porte|portassan|portaré|porteies|portasses|porteie|portaron|portes|abù|aveais|aras|esses|avei|portarà|aré|portovan|ovan|portaras|avee|avean|porta|portassa|on|ebe|porteis|avea|essan|à|oves|aesse|portea|aon|ove|avees|ova|aessan|porteda|portedes|porté|eis|aessa|aes|aeis|portareis|portove|ombe|aessais|portasse|eibes|aede|essais|aean	<i>verb</i><br><ol><li>to carry</li></ol>
pra|pre	<i>noun</i><br><ol><li>meadow</li></ol>
pratich|pratices|pratic|praticia	<i>adj</i><br><ol><li>practical</li></ol>
precostitur	<i>verb</i><br><ol><li>To prepare</li></ol>
prejentazion|prejentazions	<i>noun</i><br><ol><li>presentation</li></ol>
prejenter|esse|as|prejentasse|aesses|é|prejenta|areis|ébe|prejenteies|aron|prejentarà|essa|ebes|ovais|ae|prejentedes|arà|prejentovan|prejenteie|prejenteia|prejentaras|aras|esses|abù|prejentaron|prejentassais|aveais|prejentan|prejentede|prejentove|avei|prejente|aré|prejentasses|ovan|avean|avee|prejenteis|prejenteda|prejentassan|prejentes|ebe|prejentaré|on|prejentova|prejentareis|prejentés|prejenté|essan|à|oves|aesse|aon|ove|prejenton|avees|ova|aessan|eis|prejentassa|aessa|eibes|aes|prejentovais|avea|aeis|ombe|aessais|aede|prejentoves|prejentea|essais|aean	<i>verb</i><br><ol><li>To direct, focus</li><li>To present</li></ol>
present|presenta|presentes|presenc	<i>adj</i><br><ol><li>present</li></ol>
president|presidenc	<i>noun</i><br><ol><li>president</li></ol>
presidenza|presidenzes	<i>noun</i><br><ol><li>presidency</li></ol>
prestazion|prestazions	<i>noun</i><br><ol><li>service, performance</li><li>showing (of a sportsman ecc.)</li></ol>
preventif|preventiva|preventifs|preventives	<i>adj</i><br><ol><li>preventive</li></ol>
previdenza|previdenzes	<i>noun</i><br><ol><li>prudence</li><li>security</li></ol>
previdenzia|previdenzies	<i>noun</i><br><ol><li>prudence</li><li>foresight</li><li>security, welfare, social security</li><li>pension</li></ol>
prim|primes|primi|prima	<i>adj</i><br><ol><li>first</li></ol>
prinzip|prinzips	<i>noun</i><br><ol><li>principle</li></ol>
privat|privadas|privac|privades|privada	<i>adj</i><br><ol><li>private</li></ol>
pro	<i>noun</i><br><ol><li>good; benefit; advantage</li></ol>
proa	<i>noun</i><br><ol><li>test, experiment</li><li>proof</li></ol>
produjer|esse|as|produjesse|produjove|é|produj|aesses|produjaron|areis|produjarà|produjessan|ébe|produjareis|aron|produjon|ebes|ovais|ae|arà|essa|aras|esses|abù|produjan|produje|aveais|produjeis|produjessa|produjaré|produjaras|avei|produjoves|aré|produjovan|produjes|ovan|produjesses|avee|avean|on|ebe|essan|à|produjessais|oves|aesse|aon|ove|produt|avees|produjova|ova|aessan|eis|aessa|aessais|aes|produjovais|avea|aeis|ombe|aede|produjede|eibes|essais|aean	<i>verb</i><br><ol><li>To produce</li></ol>
produtif|produtifs|produtiva|produtives	<i>adj</i><br><ol><li>productive</li></ol>
produzion	<i>noun</i><br><ol><li>production</li></ol>
profilassa	<i>noun</i><br><ol><li>prevention</li><li>prophylaxis</li></ol>
program|programs	<i>noun</i><br><ol><li>programme</li><li>manifesto</li></ol>
proibir|proibiron|proibion|ae|pruibissan|proibireis|pruibes|esses|abù|proibisses|pruibisses|ebe|à|pruibives|ove|avees|pruibiva|aessa|pruibesces|pruibissais|essais|esse|pruibesce|as|aesses|pruibivais|pruibesc|pruibieis|pruibiras|aron|pruibian|pruibide|proibì|pruibiré|pruib|proibes|on|proibiras|ova|aes|essan|eibes|proibivan|pruibirà|pruibiron|proibivais|proibieis|pruibir|pruibion|proibiva|essa|ebes|proibives|arà|aras|proibesc|pruibissa|proibissais|avei|aré|proibisse|ovan|avean|oves|proibesce|aon|proibissa|pruibireis|aessais|aean|proibe|é|pruibive|areis|proib|proibissan|ébe|pruibe|proibirà|ovais|proibide|proibian|aveais|pruibisse|pruibivan|proibesces|avee|proibiré|pruibì|aesse|aessan|eis|aede|aeis|avea|ombe|proibive	<i>verb</i><br><ol><li>to prohibit, forbid</li></ol>
proiet|proiec	<i>noun</i><br><ol><li>project</li></ol>
promozion|promozions	<i>noun</i><br><ol><li>promotion</li></ol>
promulgher|esse|promulghova|as|aesses|é|promulghés|promulghea|promulgharé|promulghede|promulgheie|areis|ébe|aron|promulghassan|essa|ebes|ovais|promulghassais|arà|ae|promulghon|promulgheies|promulgharà|aras|promulgha|promulghasses|abù|esses|aveais|promulghedes|promulghovan|promulghan|essan|promulgheda|promulghoves|avei|aré|promulghé|ovan|avee|avean|on|ebe|promulghasse|promulgharon|promulghe|promulghove|promulghassa|à|oves|promulghes|promulgheia|aon|ove|ova|avees|ombe|aesse|promulghareis|eis|aessa|aessan|aessais|aes|promulghovais|avea|aeis|promulgheis|aede|promulgharas|eibes|essais|aean	<i>verb</i><br><ol><li>to promulgate, proclaim</li></ol>
pronunzier|esse|pronunzioves|pronunziassan|as|aesses|pronunziassais|é|aede|pronunziovan|pronunzieda|areis|pronunziea|pronunziaron|pronunzieis|ébe|aron|essais|pronunzieia|ebes|pronunziareis|ovais|arà|pronunzian|ae|essa|pronunziede|aras|esses|abù|aveais|pronunziovais|pronunziaras|pronunzion|pronunziassa|pronunzié|avei|pronunziasse|aré|pronunziés|ovan|avean|avee|pronunzie|pronunziove|pronunzies|ebe|on|essan|à|oves|aesse|aon|ove|ova|avees|ombe|aessan|pronunziaré|pronunziedes|eis|aessa|pronunzieies|pronunziova|pronunziasses|avea|aeis|aes|eibes|aessais|pronunziarà|pronunzieie|pronunzia|aean	<i>verb</i><br><ol><li>To pronounce</li></ol>
propaganda|propagandes	<i>noun</i><br><ol><li>propaganda</li></ol>
proporzion|proporzions	<i>noun</i><br><ol><li>proportion</li></ol>
proprietà|proprieteies	<i>noun</i><br><ol><li>property</li></ol>
propunent|propunenc	<i>noun</i><br><ol><li>proposer, proponent</li></ol>
provinzia|provinzies	<i>noun</i><br><ol><li>province</li></ol>
provinzial|provinziai|provinziales|provinziala	<i>adj</i><br><ol><li>provincial</li></ol>
provinziel|provinziela|provinzieles|provinziei	<i>adj</i><br><ol><li>provincial</li></ol>
provisoriamënter	<i>adv</i><br><ol><li>provisionally, temporarily</li></ol>
provisorie|provisoriesc|provisories|provisoriia|provisoria	<i>adj</i><br><ol><li>provisional, temporary</li></ol>
prufescion|prufescions	<i>noun</i><br><ol><li>profession</li></ol>
prufescionel|prufescioneles|prufescionela|prufescionei	<i>adj</i><br><ol><li>professional</li></ol>
prufesser|esse|prufesseda|as|prufessassan|é|aesses|aede|prufessedes|prufessoves|areis|prufessovan|ébe|aron|essa|ebes|prufessove|ovais|arà|ae|prufesseies|prufessovais|prufessova|aras|esses|abù|prufesson|prufessea|prufessan|prufessasses|prufesse|aveais|aessan|prufessés|avei|prufesses|aré|ovan|avean|avee|prufessé|prufessassa|prufessareis|ebe|prufessaras|on|prufessede|avea|essan|à|oves|aesse|aon|ove|ova|avees|prufessassais|ombe|prufesseis|eis|prufessaré|aessa|prufesseie|prufessasse|prufessa|prufesseia|prufessaron|prufessarà|aeis|aes|eibes|aessais|essais|aean	<i>verb</i><br><ol><li>To profess</li></ol>
prugres	<i>noun</i><br><ol><li>progress, progression, development</li></ol>
prugressività	<i>noun</i><br><ol><li>progressivity</li></ol>
pruibid|pruibida|pruibides|pruibids	<i>adj</i><br><ol><li>prohibited</li></ol>
pruponibltà	<i>noun</i><br><ol><li>admissibility</li></ol>
pruporzionel|pruporzionela|pruporzionei|pruporzioneles	<i>adj</i><br><ol><li>proportional</li></ol>
pruposta|prupostes	<i>noun</i><br><ol><li>proposal</li></ol>
prutezion|prutezions	<i>noun</i><br><ol><li>protection</li></ol>
pruvedimënt|pruvedimënc	<i>noun</i><br><ol><li>precaution</li><li>measure, act, step</li></ol>
pruzedimënt|pruzedimënc	<i>noun</i><br><ol><li>procedure</li><li>process</li></ol>
pruzedura|pruzedures	<i>noun</i><br><ol><li>procedure, process</li></ol>
pruzessuel|pruzessuei|pruzessuela|pruzessueles	<i>adj</i><br><ol><li>Of or pertaining to the legal process</li></ol>
prëscia|prëscies	<i>noun</i><br><ol><li>(Gardenese, usually uncountable) urgency, hurry</li></ol>
publicazion|publicazions	<i>noun</i><br><ol><li>publication</li></ol>
publich|publicia|public|publices	<i>adj</i><br><ol><li>public</li></ol>
publicher|publicharon|esse|publicharé|publichede|as|é|aesses|publichea|publicheia|publichareis|publiche|areis|publichova|ébe|publiches|aron|publichovais|publicharà|essa|ebes|publichove|ovais|arà|ae|publichoves|aras|publicharas|publichassan|publicheis|abù|publicheda|publichon|aveais|esses|publichassa|publichedes|avei|aré|ovan|avean|avee|publichassais|publichan|publicheie|publichovan|on|publichasses|ebe|publicha|essan|à|publicheies|oves|aesse|aon|ove|ova|avees|publiché|aessan|eis|publichasse|aessa|aessais|aes|aeis|avea|aede|ombe|publichés|eibes|essais|aean	<i>verb</i><br><ol><li>to publish, announce</li></ol>
publizità|publiziteies	<i>noun</i><br><ol><li>publicity</li></ol>
pulëntes	<i>noun</i><br><ol><li>(Gherdëina) dandelion</li></ol>
purempò	<i>conj</i><br><ol><li>but, still</li><li>nevertheless</li></ol>
purteda|purtedes	<i>noun</i><br><ol><li>opinion</li></ol>
purter|purtan|esse|purtaras|as|aesses|é|purtareis|purteie|aede|purtasses|purteia|areis|ébe|aron|purtés|purteis|ebes|ovais|ae|purtova|arà|purtovan|essa|purtaron|purtovais|aras|esses|purtarà|abù|aveais|purtassa|purteies|purtoves|avei|purtassan|aré|ovan|avean|avee|purtasse|purtede|ebe|on|purta|purtes|essan|à|oves|aesse|aon|ove|ova|avees|aessan|purtaré|purton|purtove|purté|purte|eis|aes|purtassais|avea|aeis|ombe|aessa|aessais|eibes|purtea|essais|aean	<i>verb</i><br><ol><li>To expose, exhibit</li></ol>
puscibl|puscibli|puscibles|puscibla	<i>adj</i><br><ol><li>possible</li></ol>
puscibltà|pusciblteies	<i>noun</i><br><ol><li>possibility</li></ol>
pusizion|pusizions	<i>noun</i><br><ol><li>position</li></ol>
puzné	<i>verb</i><br><ol><li>(Gherdëina, transitive) to clean</li><li>(Gherdëina, transitive) to polish</li></ol>
raion|raions	<i>noun</i><br><ol><li>region</li></ol>
raport|raporc	<i>noun</i><br><ol><li>report, statement, account</li></ol>
rata|rates	<i>noun</i><br><ol><li>dose</li><li>instalment</li></ol>
rater|esse|as|rateie|aesses|é|rateia|rates|ratedes|areis|rate|ébe|aron|essa|ratassa|ratoves|ovais|arà|ae|ebes|rataré|aras|esses|abù|raton|raté|aveais|ratove|aessan|ratassan|avei|ratovan|ratassais|aré|ratasses|ratovais|ratareis|ovan|avean|avee|rateies|on|ratova|ebe|ratés|ratasse|rata|ratede|rataron|à|oves|essan|ratan|aon|ove|rateda|avees|ova|ratea|aesse|rateis|rataras|eis|aessa|aes|aeis|avea|aessais|ombe|ratarà|aede|eibes|essais|aean	<i>verb</i><br><ol><li>to yield (a return)</li></ol>
ratificazion|ratificazions	<i>noun</i><br><ol><li>ratification</li></ol>
ratificher|esse|ratifichassa|as|aesses|é|ratifichede|ratifichareis|ratifiches|areis|ratificheda|ratificheie|ratifichasses|ébe|ratificharon|ratifichea|ratifiche|ratificheies|ratifichon|aron|ebes|ovais|ae|arà|essa|ratificheis|aras|esses|abù|aveais|ratifichassan|ratifichove|ratifichedes|ratifichassais|ratificharas|avei|aré|ratifichés|ovan|ratificharà|avee|avean|ratificha|on|ebe|ratifiché|essan|ratifichasse|ratificheia|à|oves|ratifichovais|aon|ove|ova|ratifichan|avees|ombe|aesse|eis|ratifichovan|aessa|aessan|ratifichoves|ratifichova|avea|ratificharé|aeis|aes|aessais|eibes|aede|essais|aean	<i>verb</i><br><ol><li>to ratify</li></ol>
raza|razes	<i>noun</i><br><ol><li>race (group of people)</li></ol>
raziunel|raziunela|raziunei|raziuneles	<i>adj</i><br><ol><li>rational</li></ol>
reat|reac	<i>noun</i><br><ol><li>offence, crime</li></ol>
recostruzion|recostruzions	<i>noun</i><br><ol><li>reconstruction</li></ol>
recunesciud|recunesciudes|recunesciuda|recunesciuds	<i>adj</i><br><ol><li>recognized</li><li>acknowledged</li></ol>
recunësc	<i>verb</i><br><ol><li>recognizes (3rd person singular, present tense)</li></ol>
recurs|recursc	<i>noun</i><br><ol><li>recourse</li><li>appeal (law)</li><li>recurrence</li></ol>
redujer|esse|as|redujareis|aesses|redut|redujessais|é|aean|redujovan|redujove|redujaron|areis|reduj|redujova|ébe|aron|redujesses|essa|ebes|ovais|ae|arà|reduje|redujesse|redujede|aras|esses|abù|redujarà|redujeis|aveais|redujon|avei|redujaré|aré|ovan|avean|avee|redujes|redujoves|on|ebe|redujessa|avea|essan|à|oves|aesse|aon|redujessan|ove|avees|ova|aessan|eis|aessa|redujan|aessais|aes|aeis|redujovais|aede|ombe|eibes|essais|redujaras	<i>verb</i><br><ol><li>To reduce</li></ol>
reduzion|reduzions	<i>noun</i><br><ol><li>reduction</li></ol>
reeducazion|reeducazions	<i>noun</i><br><ol><li>reeducation</li></ol>
referendum|referendums	<i>noun</i><br><ol><li>referendum</li></ol>
referiment|referimenc	<i>noun</i><br><ol><li>reference, mention</li></ol>
region|regions	<i>noun</i><br><ol><li>region</li></ol>
registrazion|registrazions	<i>noun</i><br><ol><li>registration</li></ol>
registrer|esse|as|registraras|aesses|é|aede|registreda|registrassa|registraré|areis|registrés|registré|ébe|aron|essa|ebes|ovais|ae|arà|registrasses|registreia|registres|registrova|registron|aras|registran|abù|esses|registrassan|aveais|registreie|registraron|aessan|registrede|avei|aré|registrovais|aesse|ovan|avean|avee|registreies|on|ebe|registra|avea|essan|à|oves|ombe|registrarà|aon|registreis|ove|avees|registroves|registre|registrareis|eis|ova|registredes|registrassais|registrove|registrovan|registrea|aeis|aes|aessa|aessais|eibes|registrasse|essais|aean	<i>verb</i><br><ol><li>To register</li><li>To list</li></ol>
regiunel|regiunei|regiunela|regiuneles	<i>adj</i><br><ol><li>regional</li></ol>
regolar|regolara|regolares|regolars	<i>adj</i><br><ol><li>regular</li></ol>
regolarmenter	<i>adv</i><br><ol><li>regularly</li></ol>
regulament|regulamenc	<i>noun</i><br><ol><li>regulation, rule</li></ol>
regulamentazion|regulamentazions	<i>noun</i><br><ol><li>control, regulation</li></ol>
reguleda	<i>verb</i><br><ol><li>regulated</li></ol>
regulei	<i>verb</i><br><ol><li>regulates, controls (3rd person singular, present tense)</li></ol>
reguler|esse|as|regulovais|é|aean|aesses|areis|regules|regulassan|reguleie|ébe|regularé|regulassa|reguleia|aron|reguleis|regularon|essa|ebes|ovais|regulovan|arà|ae|regulés|reguloves|regulareis|aras|abù|esses|aveais|avei|regulasses|reguleies|aré|regule|ovan|avean|avee|regulova|regulon|regulede|on|regularà|ebe|regulea|regulé|regulan|reguledes|regularas|essan|à|regulove|oves|regula|aon|ove|ova|avees|aesse|aessan|eis|regulassais|aessa|aessais|aes|aeis|avea|aede|ombe|eibes|essais|regulasse	<i>verb</i><br><ol><li>to regulate, control</li></ol>
regulé	<i>verb</i><br><ol><li>regulated</li></ol>
rehl|rehli	<i>noun</i><br><ol><li>(gherdëina, badiot) roe deer</li></ol>
rei|reies	<i>noun</i><br><ol><li>net</li><li>network</li></ol>
rejon|rejons	<i>noun</i><br><ol><li>reason</li><li>motive</li></ol>
rejoner|esse|as|aesses|é|aean|rejonedes|rejonon|areis|rejonovais|ébe|rejonés|rejonova|essais|aron|rejoneia|essa|ebes|ovais|ae|arà|rejoné|rejones|aessa|aras|esses|rejonarà|abù|aveais|aessan|rejonasse|rejonove|rejonaras|rejonaron|avei|aré|rejoneis|rejonareis|ovan|avean|rejonasses|avee|rejoneda|rejone|ebe|on|rejonoves|essan|à|oves|rejonea|aesse|rejoneies|aon|ove|rejonovan|rejonan|rejonassa|rejonaré|rejonede|eis|avees|ova|aes|aeis|avea|eibes|ombe|rejonassais|aessais|rejoneie|aede|rejonassan|rejona	<i>verb</i><br><ol><li>To reason</li><li>To discuss</li></ol>
relatif|relativa|relatifs|relatives	<i>adj</i><br><ol><li>relative</li></ol>
religion	<i>noun</i><br><ol><li>religion</li></ol>
religëus|religëuses	<i>adj</i><br><ol><li>religious</li></ol>
remander|esse|as|remandes|é|remandon|aesses|remandeies|remandé|remandaré|areis|remandassan|remandova|ébe|aron|essa|ebes|ovais|remandaron|arà|ae|remandassa|remandasse|remandaras|remandovan|remandove|remandedes|aras|abù|esses|remandea|remandeda|remandoves|aveais|remandés|remandeie|remandareis|remande|avei|remandede|aré|remandassais|ovan|avean|avee|remandeis|on|ebe|remandarà|remanda|essan|à|oves|remandovais|aon|ove|ova|avees|aesse|aessan|remandasses|remandeia|eis|eibes|aes|aeis|avea|aessa|ombe|aessais|aede|remandan|essais|aean	<i>verb</i><br><ol><li>To remit</li></ol>
remozion|remozions	<i>noun</i><br><ol><li>removal, dismissal</li><li>clearing, clearance</li></ol>
remplazer|esse|remplazovais|as|aesses|remplazasses|remplazés|é|remplazan|remplazassais|areis|remplazasse|ébe|remplazoves|remplazovan|aron|remplazareis|remplazassa|ebes|ovais|remplazaré|arà|ae|essa|remplaza|remplazede|aras|esses|abù|remplazon|aveais|remplazedes|remplazova|remplazea|remplazove|avei|aré|ovan|avean|remplazarà|remplaze|avee|remplazeia|remplazeis|remplazaras|ebe|on|remplazeies|remplazé|essan|à|remplazaron|oves|aesse|aon|ove|ova|remplazes|avees|remplazeda|remplazassan|eis|aessa|aessan|eibes|aes|aeis|avea|aessais|ombe|aede|remplazeie|essais|aean	<i>verb</i><br><ol><li>To replace</li></ol>
rendicont|rendiconc	<i>noun</i><br><ol><li>report, account</li><li>statement (financial)</li></ol>
renunzier|renunziassais|esse|as|aesses|é|renunziedes|renunzieis|areis|ébe|renunzian|essais|aron|renunziés|essa|ebes|ovais|ae|arà|renunzia|aras|esses|abù|aveais|renunziova|renunziassa|renunziarà|renunziassan|renunziareis|renunziede|renunzié|renunzion|renunzieia|aessan|avei|renunzieies|renunziovais|aré|ovan|avean|avee|renunzies|renunziaron|on|renunzie|ebe|renunziove|avea|renunziea|à|oves|essan|aesse|aon|ove|ova|renunziovan|avees|renunziaras|ombe|renunzieie|eis|renunziasses|aessa|aes|aeis|renunziasse|aessais|renunzieda|aede|renunzioves|eibes|renunziaré|aean	<i>verb</i><br><ol><li>To renounce</li></ol>
reparazion|reparazions	<i>noun</i><br><ol><li>reparation</li></ol>
reprejentant|reprejentanc	<i>noun</i><br><ol><li>representative</li></ol>
reprejentanza|reprejentanzes	<i>noun</i><br><ol><li>representation (all senses)</li></ol>
reprejentazion|reprejentazions	<i>noun</i><br><ol><li>representation</li></ol>
reprejenter|esse|reprejentassa|as|reprejentaré|reprejenteia|reprejentaron|reprejenteda|é|reprejentaras|aesses|reprejenteies|reprejenté|reprejenteis|reprejente|areis|ébe|reprejentovais|reprejentedes|reprejentareis|aron|reprejentan|reprejentassan|essa|ebes|ovais|ae|reprejenteie|arà|reprejentasse|reprejenton|reprejentede|reprejentes|reprejentoves|reprejentasses|reprejentovan|reprejentarà|aras|abù|esses|aveais|reprejentés|reprejentassais|reprejenta|avei|aré|ovan|avean|avee|on|ebe|reprejentova|essan|à|oves|aesse|reprejentove|aon|ove|avees|ova|aessan|eis|aessa|aessais|aes|aeis|avea|reprejentea|ombe|aede|eibes|essais|aean	<i>verb</i><br><ol><li>To represent</li></ol>
republica|republicas	<i>noun</i><br><ol><li>republic</li></ol>
republican|republicana|republicanes|republicans	<i>adj</i><br><ol><li>republican</li></ol>
resident|residenc	<i>noun</i><br><ol><li>resident</li></ol>
respet	<i>noun</i><br><ol><li>respect, consideration, regard</li></ol>
respetif|respetiva|respetifs|respetives	<i>adj</i><br><ol><li>respective</li></ol>
respuender|esse|as|respuendovan|respuendoves|respuendovais|é|respuendove|aesses|areis|respuendaras|respuendés|respuenda|respuendeis|ébe|aron|respuendeies|respuendassa|respuendede|essa|ebes|ovais|ae|arà|respuendeia|respuendarà|aras|esses|abù|respuendan|aveais|respuendova|respuendasses|respuende|respuendé|avei|respuendareis|respuendassan|aré|ovan|avean|avee|respuendedes|on|ebe|respuendasse|respuendeie|respuendaron|essan|respuendaré|respuendon|à|oves|aesse|aon|ove|ova|avees|respuendea|respuendassais|aessan|eis|aessa|aessais|aes|aeis|avea|respuendes|ombe|respuendeda|aede|eibes|essais|aean	<i>verb</i><br><ol><li>To respond, reply, answer</li></ol>
respunsabl|respunsables|respunsabli|respunsabla	<i>adj</i><br><ol><li>responsible</li></ol>
respunsabltà|respunsablteies	<i>noun</i><br><ol><li>responsibility</li></ol>
resserver|resservan|esse|resservede|as|aesses|é|resservassais|resservasses|resserveis|areis|ébe|resservon|aron|resserveie|ebes|resserveia|ovais|arà|ae|essa|resserve|resserva|aras|abù|resservassa|esses|resservé|aveais|resserveies|resservaré|avei|resservedes|aré|resservarà|ovan|avean|resservovais|resservoves|resservaras|resservova|avee|on|ebe|resservaron|resservareis|resservove|essan|à|oves|resservasse|resserves|resserveda|resservovan|resservés|aon|ove|avees|ova|eis|aesse|aessa|aessan|aes|resservea|avea|aeis|ombe|resservassan|aessais|eibes|aede|essais|aean	<i>verb</i><br><ol><li>To reserve, book</li></ol>
ressolver|esse|as|aesses|é|aean|ressolvoves|ressolvea|ressolvova|areis|ressolvaras|ressolvaron|ressolvovais|ébe|aron|ressolveies|ressolveia|ebes|ressolvasse|ovais|arà|ae|essa|ressolveis|ressolvareis|ressolvovan|aras|esses|ressolvasses|abù|aveais|ressolvassan|ressolvon|avei|ressolveie|ressolvé|ressolvaré|aré|ressolves|ovan|avean|avee|ressolvassa|ressolve|on|ebe|ressolvede|essan|à|oves|ressolvan|ressolvassais|aon|ove|ova|avees|aesse|aessan|eis|aessa|ressolva|ressolvarà|aes|aeis|avea|aessais|ombe|aede|eibes|essais|ressolvove	<i>verb</i><br><ol><li>to solve</li><li>to resolve</li></ol>
ressorsa|ressorses	<i>noun</i><br><ol><li>resource</li></ol>
rest|resc	<i>noun</i><br><ol><li>rest, residue</li></ol>
rester|esse|as|aesses|é|restovan|restassais|areis|restaron|restede|reston|ébe|essais|resté|aron|restaré|resta|essa|ebes|ovais|ae|restaras|restes|arà|resteies|resteis|restovais|restea|aras|abù|esses|resteie|aveais|resteia|avei|restarà|restasse|restassa|aré|restés|restasses|restove|avee|ovan|avean|on|ebe|restareis|restedes|restan|restassan|essan|à|oves|aesse|aon|resteda|ove|avees|ova|aessan|restoves|eis|reste|aessa|aes|aeis|avea|aessais|ombe|aede|eibes|restova|aean	<i>verb</i><br><ol><li>to remain, stay</li></ol>
resultat|resultac	<i>noun</i><br><ol><li>result, outcome</li></ol>
resulter|esse|resulton|as|aesses|é|resulteda|resultasse|resultaré|areis|resultaras|resulte|resultove|ébe|resultassan|aron|essa|ebes|ovais|ae|arà|resulta|resultovais|resulteies|resultovan|aras|esses|resultarà|resultareis|abù|resulteia|aveais|resultes|resultoves|resultés|resultassa|resultan|resultasses|avei|resulté|aré|ovan|avean|resulteis|resultaron|resulteie|avee|resultassais|on|ebe|resultede|essan|resultedes|à|oves|aesse|aon|ove|ova|avees|aessan|eis|aessa|eibes|resultova|aeis|avea|aes|ombe|aessais|aede|resultea|essais|aean	<i>verb</i><br><ol><li>To result (turn out to be)</li><li>To appear, seem</li></ol>
retribuzion|retribuzions	<i>noun</i><br><ol><li>pay, remuneration</li><li>retribution</li></ol>
reunion|reunions	<i>noun</i><br><ol><li>meeting, assembly, conference</li><li>reunion, gathering, get-together</li></ol>
reurdinamënt|reurdinamënc	<i>noun</i><br><ol><li>rearrangement, reordering</li></ol>
reurganiser|esse|as|reurganiseie|aesses|é|reurganisaré|reurganise|reurganisé|reurganisede|areis|reurganisedes|reurganisaron|reurganisa|ébe|aron|reurganisovan|reurganiseda|reurganiseis|reurganisassais|reurganiseies|reurganisassa|reurganisove|ovais|arà|ae|ebes|reurganises|aras|reurganisovais|reurganisarà|abù|esses|aveais|essa|reurganisova|reurganisasses|avei|aré|reurganisoves|ovan|avean|avee|reurganisea|reurganiseia|on|ebe|reurganisaras|reurganisassan|avea|essan|reurganisés|à|oves|aesse|aon|ove|ova|avees|reurganisasse|aessan|eis|aessa|reurganisan|reurganisareis|aes|aeis|reurganison|aessais|ombe|aede|eibes|essais|aean	<i>verb</i><br><ol><li>To reorganize</li></ol>
revalutazion|revalutazions	<i>noun</i><br><ol><li>revaluation</li><li>re-evaluation</li><li>reassessment</li></ol>
reverir|esse|as|aesses|é|reveriva|areis|ébe|reverian|aron|essa|ebes|ovais|ae|arà|reverissais|reveriron|reverieis|aras|esses|abù|reverives|reverì|aveais|reverireis|reverirà|reveriras|reverissan|reverion|reverivais|avei|revere|reveresces|reverive|reverisses|aré|reverissa|ovan|avean|avee|reveriré|on|ebe|essan|reveresc|à|reveride|oves|aesse|aon|reveresce|ove|avees|ova|aessan|aede|eis|aessa|eibes|reverisse|aeis|avea|aes|ombe|reveres|aessais|reverivan|rever|essais|aean	<i>verb</i><br><ol><li>To report; To attribute</li><li>To revere</li></ol>
revijion|revijions	<i>noun</i><br><ol><li>revision</li></ol>
revucabl|revucabla|revucables|revucabli	<i>adj</i><br><ol><li>revocable</li></ol>
revuchei	<i>verb</i><br><ol><li>revokes (3rd person singular, present tense)</li></ol>
revucher|esse|revuchedes|as|revuchasses|é|revucha|aesses|areis|revucharas|revucheia|revucheda|revuchea|ébe|revucheies|aron|essa|ebes|ovais|ae|revucharon|arà|revuchovais|revuchés|revuchassan|revuchovan|revuche|aras|abù|esses|revuchassais|revuches|aveais|essan|revuchareis|avei|aré|ovan|avean|avee|revuchon|revuchove|on|revuchassa|ebe|revuchasse|revucharé|revuchoves|avea|à|revuchova|revucheis|oves|aon|ove|ova|avees|ombe|aesse|aessan|eis|aessa|revuchede|aessais|revuché|aeis|revuchan|revucharà|revucheie|aes|aede|eibes|essais|aean	<i>verb</i><br><ol><li>To revoke</li></ol>
rezever|rezevovais|esse|as|rezevù|é|aesses|rezevessa|rezeveis|areis|rezevede|rezevessan|ébe|rezevareis|aron|essa|ebes|rezevove|rezevesse|ovais|rezevovan|rezevesses|arà|ae|rezevaras|aras|abù|esses|aveais|rezevarà|avei|rezevessais|aré|rezevoves|ovan|avean|rezevaron|rezeves|rezevon|rezeve|avee|on|ebe|rezevan|essan|rezev|à|oves|aesse|aon|ove|ova|avees|ombe|aessan|eis|aessa|eibes|aes|aeis|avea|aessais|rezevova|aede|rezevaré|essais|aean	<i>verb</i><br><ol><li>To receive</li></ol>
ritual|rituai|rituala|rituales	<i>adj</i><br><ol><li>ritual</li></ol>
roa	<i>noun</i><br><ol><li>landslide</li></ol>
romper|esse|as|aesses|é|rompeis|rompessais|areis|ébe|aron|rompes|ebes|ovais|ae|arà|essa|romparà|rot|aras|esses|abù|rompessan|aveais|rompan|aessan|romparé|avei|rompova|aré|ovan|avean|avee|rompovais|romp|rompesses|rompede|ebe|on|rompovan|rompessa|essan|rompesse|rompoves|romparon|à|aon|ove|oves|rompove|rompon|avees|ova|eis|aesse|aessa|eibes|aes|aeis|avea|rompe|ombe|rompareis|aessais|romparas|aede|essais|aean	<i>verb</i><br><ol><li>to break</li></ol>
rucin|rucins	<i>noun</i><br><ol><li>(Gherdëina) earring</li></ol>
ruf|ruves	<i>noun</i><br><ol><li>(Gherdëina) river</li></ol>
rujeneda|rujenedes	<i>noun</i><br><ol><li>language</li></ol>
rujneda|rujnedes	<i>noun</i><br><ol><li>(Gherdëina) language</li></ol>
rujné	<i>verb</i><br><ol><li>(Gherdëina) to speak</li></ol>
rurel|rurela|rurei|rureles	<i>adj</i><br><ol><li>rural</li></ol>
rëjes	<i>noun</i><br><ol><li>(Gherdëina) portal, church door</li></ol>
rëm|rëms	<i>noun</i><br><ol><li>obstacle</li></ol>
sabeda|sabedes	<i>noun</i><br><ol><li>Saturday</li></ol>
saniter|saniters|saniteres|sanitera	<i>adj</i><br><ol><li>sanitary</li></ol>
sanità	<i>noun</i><br><ol><li>health</li></ol>
sant|sanc|santa|santes	<i>adj</i><br><ol><li>sacred</li></ol>
savei|esse|as|aesses|é|savessa|areis|savan|sapù|sas|sé|savovais|ébe|savessan|savova|aron|savaras|sae|ebes|ovais|ae|arà|savovan|essa|savove|savarà|aras|esses|abù|aveais|saver|savon|avei|saveis|savesse|savoves|aré|ovan|avean|avee|savaron|on|ebe|sà|savaré|essan|à|oves|aesse|aon|savareis|savesses|ove|savessais|avees|ova|eis|aessa|aessan|aessais|aes|aeis|avea|aede|ombe|savede|eibes|essais|aean	<i>verb</i><br><ol><li>To know (information)</li><li>To know how to; can</li><li>To taste</li></ol>
sce	<i>conj</i><br><ol><li>if</li><li>whether</li></ol>
schi	<i>noun</i><br><ol><li>skiing</li></ol>
schiver|esse|schivasses|as|aesses|é|schivon|schivea|schiveies|areis|schivareis|ébe|essais|aron|schivoves|essa|schiveda|ovais|ae|schive|arà|ebes|aras|esses|abù|schivova|aveais|schivé|schivovan|schivove|schiveis|schives|schivaré|schivassan|schivarà|schivassa|schiva|schiveia|avei|aré|ovan|avean|avee|schivasse|on|ebe|schivaron|essan|schivés|à|oves|aesse|aon|ove|schivede|avees|ova|schivedes|aessan|eis|schivan|schiveie|eibes|aes|aeis|avea|schivaras|ombe|aessa|aessais|schivassais|aede|schivovais|aean	<i>verb</i><br><ol><li>To dodge, avoid, evade, bypass, circumvent</li></ol>
sci	<i>adv</i><br><ol><li>yes</li></ol>
scialdi	<i>adv</i><br><ol><li>always, constantly, continuously</li></ol>
scich	<i>noun</i><br><ol><li>(Gherdëina) disorder, untidiness, chaos, mess</li></ol>
sciche	<i>conj</i><br><ol><li>so that</li><li>therefore</li></ol>
scientifich|scientific|scientificia|scientifices	<i>adj</i><br><ol><li>scientific</li></ol>
scienza|scienzes	<i>noun</i><br><ol><li>science</li></ol>
scintla|scintles	<i>noun</i><br><ol><li>(Gherdëina) shingle</li></ol>
scioper|sciopers	<i>noun</i><br><ol><li>strike (industrial dispute)</li></ol>
scola|scoles	<i>noun</i><br><ol><li>school</li></ol>
scolastich|scolasticia|scolastices|scolastic	<i>adj</i><br><ol><li>scholastic</li></ol>
scriver|esse|scrivede|as|scrivessa|é|aesses|scrivova|scrivesse|scrivaron|areis|scrivareis|scrivon|scrivan|ébe|aron|scrivesses|essa|ebes|ovais|scrives|arà|ae|scrivovais|aras|scrita|abù|esses|aveais|scrivessan|scric|scrivoves|avei|scriv|scrivessais|aré|scriveis|ovan|avean|avee|scrivove|scrivarà|scrit|on|ebe|scrivovan|scrive|scrivaras|essan|à|oves|aesse|aon|ove|ova|avees|aessan|eis|aessa|scrites|scrivaré|aes|aeis|avea|aessais|ombe|aede|eibes|essais|aean	<i>verb</i><br><ol><li>To write</li></ol>
scuac	<i>noun</i><br><ol><li>(Gherdëina) broom (usually a smaller one only used indoors)</li></ol>
scumenciadiva|scumenciadives	<i>noun</i><br><ol><li>initiative</li><li>enterprise</li></ol>
scurter|scurteis|esse|as|aesses|é|scurtasses|areis|scurtaron|scurtes|scurteie|ébe|scurtaras|aron|essa|ebes|scurteies|ovais|scurtassan|arà|ae|scurte|scurtove|aras|esses|abù|aveais|scurta|scurtassais|scurté|scurtassa|avei|scurtés|aré|scurtovan|scurton|scurtareis|ovan|avean|avee|scurtoves|scurtedes|on|ebe|scurtovais|scurtaré|scurtasse|scurtea|essan|à|oves|scurtede|scurteia|aon|ove|scurtan|avees|ova|aesse|aessan|scurtova|scurtarà|eis|eibes|aes|aeis|avea|aessa|ombe|aessais|aede|scurteda|essais|aean	<i>verb</i><br><ol><li>To shorten, abbreviate</li></ol>
scuter|esse|as|aesses|é|scutove|scutaras|areis|ébe|scouteies|scutasses|aron|essa|scuton|ovais|ae|arà|ebes|scutovan|scouteia|scoute|scutarà|abù|scutaré|scuté|scutan|aveais|aras|esses|scouta|avei|scutea|scouteis|aré|scutoves|ovan|avean|avee|scutasse|scutassa|scutareis|ebe|on|scutassais|scutova|scutaron|essan|scouteie|à|oves|aesse|aon|ove|ova|avees|aessan|aede|scutede|eis|aessa|scoutes|aes|scutassan|avea|aeis|ombe|scuteis|scutovais|eibes|aessais|essais|aean	<i>verb</i><br><ol><li>To listen</li></ol>
se	<i>pron</i><br><ol><li>(indefinite) one, you, we, they, people. Note: often translated using the passive voice in English.</li><li>(reflexive) oneself, himself, herself, itself, themselves; (reciprocal) each other, one another. Note: With some verbs, si is not translated in English.</li></ol>
secuestrazion|secuestrazions	<i>noun</i><br><ol><li>sequestration</li></ol>
secuestrer|esse|secuestrasses|as|aesses|é|aean|secuestroves|secuestrassais|areis|secuestrovan|secuestreia|ébe|secuestre|aron|secuestron|essa|ebes|ovais|ae|secuestres|arà|secuestrove|secuestrassan|secuestrova|aras|esses|abù|secuestraré|aveais|secuestra|secuestrés|secuestré|secuestredes|avei|secuestraron|secuestrarà|aré|ovan|avean|avee|secuestraras|secuestrasse|secuestreis|secuestrassa|ebe|on|secuestreies|secuestrede|secuestreda|essan|à|oves|aesse|aon|ove|ova|avees|aessan|eis|secuestran|secuestrovais|secuestreie|aes|aeis|avea|aessa|ombe|aessais|secuestrea|eibes|aede|essais|secuestrareis	<i>verb</i><br><ol><li>To sequester</li></ol>
segondo|segondes|segondi|segonda	<i>adj</i><br><ol><li>second</li></ol>
segurer|esse|as|aesses|é|segureie|segurassais|areis|segurasse|seguran|segurarà|ébe|segurove|aron|seguraré|essa|seguron|ovais|segurova|arà|ae|ebes|segurassa|segurovais|aras|esses|segureis|segurés|abù|aveais|essan|segurea|avei|seguré|aré|ovan|avean|segures|segurassan|avee|segurede|on|segura|segureda|segurovan|seguredes|segureies|ebe|seguraras|segurareis|segurasses|à|oves|aesse|aon|ove|ova|avees|aessan|segureia|seguroves|seguraron|eis|aessa|aes|aeis|avea|aessais|ombe|segure|aede|eibes|essais|aean	<i>verb</i><br><ol><li>To assure, guarantee</li><li>To ensure, insure, assure</li><li>To secure</li></ol>
segurëie	<i>verb</i><br><ol><li>guarantees</li><li>assures, ensures</li></ol>
segurëza|segurëzes	<i>noun</i><br><ol><li>safety, security</li></ol>
seidesc	<i>adj</i><br><ol><li>sixteen</li></ol><br><i>noun</i><br><ol><li>sixteen</li></ol>
senat|senac	<i>noun</i><br><ol><li>senate</li></ol>
senator|senatores	<i>noun</i><br><ol><li>senator</li></ol>
senteda|sentedes	<i>noun</i><br><ol><li>session, sitting</li></ol>
sentenza|sentenzes	<i>noun</i><br><ol><li>sentence (for a crime)</li></ol>
servije|servijes	<i>noun</i><br><ol><li>favour; service</li></ol>
servisc	<i>noun</i><br><ol><li>service</li></ol>
sessanta	<i>adj</i><br><ol><li>sixty</li></ol><br><i>noun</i><br><ol><li>sixty</li></ol>
sessantecater	<i>adj</i><br><ol><li>sixty-four</li></ol><br><i>noun</i><br><ol><li>sixty-four</li></ol>
sessantecinch	<i>adj</i><br><ol><li>sixty-five</li></ol><br><i>noun</i><br><ol><li>sixty-five</li></ol>
sessantedoes	<i>adj</i><br><ol><li>sixty-two</li></ol><br><i>noun</i><br><ol><li>sixty-two</li></ol>
sessantenuef	<i>adj</i><br><ol><li>sixty-nine</li></ol><br><i>noun</i><br><ol><li>sixty-nine</li></ol>
sessanteset	<i>adj</i><br><ol><li>sixty-seven</li></ol><br><i>noun</i><br><ol><li>sixty-seven</li></ol>
sessantesies	<i>adj</i><br><ol><li>sixty-six</li></ol><br><i>noun</i><br><ol><li>sixty-six</li></ol>
sessantetrei	<i>adj</i><br><ol><li>sixty-three</li></ol><br><i>noun</i><br><ol><li>sixty-three</li></ol>
sessantot	<i>adj</i><br><ol><li>sixty-eight</li></ol><br><i>noun</i><br><ol><li>sixty-eight</li></ol>
sessantun	<i>adj</i><br><ol><li>sixty-one</li></ol><br><i>noun</i><br><ol><li>sixty-one</li></ol>
set	<i>adj</i><br><ol><li>seven</li></ol><br><i>noun</i><br><ol><li>seven</li></ol>
setanta	<i>adj</i><br><ol><li>seventy</li></ol><br><i>noun</i><br><ol><li>seventy</li></ol>
setantecater	<i>adj</i><br><ol><li>seventy-four</li></ol><br><i>noun</i><br><ol><li>seventy-four</li></ol>
setantecinch	<i>adj</i><br><ol><li>seventy-five</li></ol><br><i>noun</i><br><ol><li>seventy-five</li></ol>
setantedoes	<i>adj</i><br><ol><li>seventy-two</li></ol><br><i>noun</i><br><ol><li>seventy-two</li></ol>
setantenuef	<i>adj</i><br><ol><li>seventy-nine</li></ol><br><i>noun</i><br><ol><li>seventy-nine</li></ol>
setanteset	<i>adj</i><br><ol><li>seventy-seven</li></ol><br><i>noun</i><br><ol><li>seventy-seven</li></ol>
setantesies	<i>adj</i><br><ol><li>seventy-six</li></ol><br><i>noun</i><br><ol><li>seventy-six</li></ol>
setantetrei	<i>adj</i><br><ol><li>seventy-three</li></ol><br><i>noun</i><br><ol><li>seventy-three</li></ol>
setantot	<i>adj</i><br><ol><li>seventy-eight</li></ol><br><i>noun</i><br><ol><li>seventy-eight</li></ol>
setantun	<i>adj</i><br><ol><li>seventy-one</li></ol><br><i>noun</i><br><ol><li>seventy-one</li></ol>
setember|setembers	<i>noun</i><br><ol><li>September</li></ol>
setemena|setemenes	<i>noun</i><br><ol><li>week</li></ol>
setor|setores	<i>noun</i><br><ol><li>sector</li></ol>
seurander|esse|seurandassais|as|aesses|seurandaras|seurandeie|é|seurandoves|seurandé|aean|areis|seurandasse|ébe|seuranda|aron|essa|ebes|ovais|seurandés|seurandon|arà|ae|seurandove|seurandareis|seurandeies|aras|esses|abù|seurandeis|aveais|seurandova|seurandaré|avei|seurandassan|seurandedes|aré|ovan|seurandovais|avee|avean|seurandede|seurandarà|seurandan|seurandovan|seurandasses|ebe|seurande|on|seurandea|essan|seurandeia|à|oves|aesse|aon|ove|ova|avees|seurandes|seurandassa|aessan|eis|aessa|seurandaron|aessais|aes|aeis|avea|aede|ombe|eibes|essais|seurandeda	<i>verb</i><br><ol><li>To surrender (to)</li><li>To confer (on)</li></ol>
seurastant|seurastanc	<i>noun</i><br><ol><li>head, chief</li><li>president</li></ol>
sezion|sezions	<i>noun</i><br><ol><li>section</li></ol>
si	<i>adj</i><br><ol><li>(possessive) his, her, hers, its, their</li></ol>
sibe|sibe ... sibe ...	<i>conj</i><br><ol><li>both ... and ...</li><li>either ... or ...</li></ol>
sies	<i>adj</i><br><ol><li>six</li></ol><br><i>noun</i><br><ol><li>six</li></ol>
sindacat|sindacac	<i>noun</i><br><ol><li>trade union</li><li>syndicate</li></ol>
singolar|singular singolara|singolares|singolars|singolara	<i>adj</i><br><ol><li>singular</li></ol>
singolarmenter	<i>adv</i><br><ol><li>singularly</li></ol>
singul|singula|singui|singules|singular singula	<i>adj</i><br><ol><li>single</li></ol>
sistem|sistems	<i>noun</i><br><ol><li>system</li></ol>
situazion|situazions	<i>noun</i><br><ol><li>situation</li></ol>
slunger|esse|slungeia|as|aesses|slungeie|slungede|é|areis|slungassa|ébe|aron|essa|slungasses|ovais|ae|arà|ebes|slungassan|slungeis|slunge|slungovais|slungan|slungeda|aras|slungea|abù|esses|aveais|slungassais|slungé|slungés|slungoves|slungarà|avei|slunga|slungaron|slungeies|aré|slungareis|ovan|avean|avee|on|ebe|slungasse|slungon|slungaré|essan|slungaras|à|slunges|oves|slungove|slungova|aon|ove|slungovan|avees|ova|eis|aesse|aessa|aessan|aes|aeis|avea|aessais|ombe|aede|eibes|slungedes|essais|aean	<i>verb</i><br><ol><li>To lengthen</li></ol>
snel	<i>adj</i><br><ol><li>(Gherdëina) fast, quick</li></ol><br><i>adv</i><br><ol><li>(Gherdëina) fast, quickly</li></ol>
sogetif|sogetiva|sogetives|sogetifs	<i>adj</i><br><ol><li>subjective</li></ol>
solidarietà	<i>noun</i><br><ol><li>solidarity</li></ol>
someter|esse|sometassa|as|someteis|aesses|é|someteia|sometasse|areis|ébe|someta|someton|aron|sometarà|sometea|sometaras|somete|sometede|sometareis|ovais|arà|ae|ebes|sometoves|someteda|someteie|aras|esses|sometovais|abù|aveais|sometassan|sometaron|someté|essa|sometan|sometes|sometaré|avei|sometasses|aré|sometove|sometés|avee|ovan|avean|on|sometova|ebe|essan|sometovan|à|sometassais|oves|aon|ove|ova|avees|aesse|aessan|sometedes|eis|aessa|aessais|aes|aeis|avea|aede|ombe|someteies|eibes|essais|aean	<i>verb</i><br><ol><li>to submit</li></ol>
sometù|sometus	<i>verb</i><br><ol><li>subjected</li></ol>
sostitutif|sostitutives|sostitutiva|sostitutifs	<i>adj</i><br><ol><li>equivalent (can be substituted for another)</li></ol>
sot|sota	<i>adv</i><br><ol><li>under, beneath</li><li>below</li></ol>
sotscriver|esse|sotscrive|sotscrit|as|aesses|sotscrivareis|sotscrivaron|é|areis|sotscriveis|sotscrivesse|ébe|sotscrives|aron|essa|ebes|sotscrivessais|ovais|arà|ae|sotscriv|aras|esses|abù|sotscrivaré|aveais|sotscrivarà|sotscrivoves|avei|sotscrivan|sotscrivon|aré|sotscrivessan|ovan|sotscrivessa|avee|avean|on|sotscrivesses|ebe|sotscrivove|sotscrivaras|essan|à|oves|aesse|aon|sotscrivovais|ove|avees|ova|sotscrivede|sotscrivova|eis|aessa|aessan|sotscrivovan|aes|aeis|avea|aessais|ombe|aede|eibes|essais|aean	<i>verb</i><br><ol><li>To sign</li></ol>
soziel|sozieles|soziela|soziei	<i>adj</i><br><ol><li>social</li></ol>
sozietà|sozieteies	<i>noun</i><br><ol><li>society (all senses)</li></ol>
sparani	<i>noun</i><br><ol><li>savings</li></ol>
spartibl|spartibla|spartibli|spartibles	<i>adj</i><br><ol><li>indivisible</li></ol>
spartir|spartissais|esse|as|aesses|é|spartieis|sparte|areis|spartiré|spartì|ébe|spartisses|spartiras|aron|essa|ebes|spartide|spartissa|ovais|arà|spartirà|ae|spartesce|spartiva|aras|esses|abù|spartesc|aveais|spartivais|spartesces|spartive|spartian|avei|aré|spart|ovan|avean|avee|on|ebe|spartissan|spartireis|spartivan|essan|spartion|à|oves|spartives|spartisse|aon|ove|avees|ova|aesse|aessan|eis|aessa|eibes|aes|spartiron|avea|aeis|ombe|aessais|aede|spartes|essais|aean	<i>verb</i><br><ol><li>To share, divide</li></ol>
speculazion|speculazions	<i>noun</i><br><ol><li>speculation</li></ol>
speisa|speises	<i>noun</i><br><ol><li>expense, expenditure</li><li>shopping</li></ol>
speziel|speziela|speziei|spezieles	<i>adj</i><br><ol><li>special</li></ol>
spidler|esse|spidlan|as|aesses|é|spidleie|spidlaras|spidlovan|areis|spidloves|spidlea|spidleda|ébe|aron|spidlareis|spidles|essa|ebes|spidle|spidlés|ovais|arà|ae|spidlassa|aras|esses|abù|aveais|spidlé|spidlovais|spidlove|spidlaron|spidlasses|avei|aré|ovan|avean|avee|spidla|spidleies|on|ebe|spidlasse|spidledes|spidleia|spidlon|spidlassan|essan|spidlova|à|oves|spidlassais|spidlede|aon|ove|ova|spidlaré|avees|aesse|aessan|eis|aessa|spidleis|aes|aeis|avea|aessais|ombe|spidlarà|aede|eibes|essais|aean	<i>verb</i><br><ol><li>to reflect</li></ol>
spiert	<i>noun</i><br><ol><li>ghost</li></ol>
spieter|esse|spietaré|as|aesses|spietedes|é|spieta|spietes|areis|spieton|spieteie|spietassan|ébe|spietasse|spieteia|aron|spietaron|spietan|spietea|ebes|ovais|ae|arà|spieté|essa|spieteies|spietasses|aras|esses|abù|spietovais|aveais|spietassa|aessan|spietarà|avei|spietova|aré|aesse|ovan|avean|spietassais|avee|spietovan|on|ebe|essan|à|oves|spieteis|ombe|aon|spietareis|spietés|ove|avees|ova|spietove|spietede|spietoves|spiete|eis|aes|aeis|avea|aessa|spietaras|aessais|spieteda|eibes|aede|essais|aean	<i>verb</i><br><ol><li>To be up to</li><li>To be due</li></ol>
spirituel|spiritueles|spirituei|spirituela	<i>adj</i><br><ol><li>spiritual</li></ol>
spirt	<i>noun</i><br><ol><li>spirit</li></ol>
sponjer|esse|as|aesses|sponjon|sponjoves|sponjovan|é|sponjove|areis|sponjede|ébe|essais|aron|sponjessais|essa|ebes|ovais|ae|arà|sponj|sponjaron|aras|esses|abù|sponjes|aveais|avei|sponjovais|sponjaras|sponjessa|aré|sponjeis|ovan|avean|avee|sponjova|sponjesses|on|ebe|sponjesse|sponjaré|sponjessan|essan|à|oves|aesse|aon|sponjareis|ove|sponjarà|avees|ova|aessan|eis|aessa|aessais|sponje|aeis|avea|aes|ombe|aede|eibes|sponjan|spont|aean	<i>verb</i><br><ol><li>To prick, sting</li></ol>
sporjer|sporjove|esse|sport|sporjon|sporjesses|é|as|aesses|sporjessan|areis|sporjeis|ébe|sporjede|aron|sporjareis|essa|ebes|ovais|ae|sporj|arà|sporjesse|sporjaré|aras|esses|abù|sporjova|aveais|sporje|sporjoves|sporjovais|avei|aré|ovan|avean|sporjan|avee|on|ebe|sporjessais|sporjaras|sporjaron|sporjovan|avea|à|oves|essan|aesse|sporjes|aon|ove|sporjarà|avees|ova|aessan|eis|aessa|aessais|aes|aeis|sporjessa|aede|ombe|eibes|essais|aean	<i>verb</i><br><ol><li>To put out</li><li>To stick out</li></ol>
sportif|sportiva|sportifs|sportives	<i>adj</i><br><ol><li>sport (attributive); sporting</li></ol>
spoz	<i>noun</i><br><ol><li>sparrow</li></ol>
spëisa|spëises	<i>noun</i><br><ol><li>(Gherdëina) expense, expenditure</li><li>(Gherdëina) food, meal</li></ol>
stabilir|stabilisses|stabil|stabiliré|stabilivais|stabiliron|stabilide|stabilirà|stabilian|stabiliras|stabilion|stabilireis|stabilides|stabilida|stabilesces|stabile|stabilieis|stabilì|stabilivan|stabilissa|stabilesce|avai|stabilis|stabiliva|stabilësc|stabilesc|stabilissan|stabilives|stabiles|stabilissais|stabilisse|stabilive	<i>verb</i><br><ol><li>To establish</li></ol>
stabilì|stabilësc|stabilis|stabilida|stabilides	<i>adj</i><br><ol><li>stabilized</li></ol>
stadiera|stadieres	<i>noun</i><br><ol><li>(Gherdëina) scales</li></ol>
stampa|stampes	<i>noun</i><br><ol><li>press (device, or printed media)</li><li>print</li><li>printing</li></ol>
stat|states|stac	<i>noun</i><br><ol><li>A state.</li></ol>
statel|statela|statei|stateles	<i>adj</i><br><ol><li>state (attributive)</li></ol>
statistich|statistices|statistic|statisticia	<i>adj</i><br><ol><li>statistical</li></ol>
statut|statuc	<i>noun</i><br><ol><li>statute</li></ol>
stes|stesses|stessa|stesc	<i>adj</i><br><ol><li>same, equal</li></ol>
stiera|stieres	<i>noun</i><br><ol><li>job, position, situation</li></ol>
stipendium|stipendiums	<i>noun</i><br><ol><li>scholarship, bursary</li></ol>
stipuler|esse|as|aesses|stipulon|stipularà|é|stipulés|areis|stipuleie|stipulove|stipulassan|ébe|aron|essa|ebes|ovais|ae|arà|stipulea|stipularas|stipulasses|stipule|stipulé|stipuleies|stipulassa|abù|stipuleia|stipulareis|aveais|aras|esses|stipules|avei|stipulovais|stipuloves|stipulassais|aré|stipulova|ovan|avean|avee|stipulovan|ebe|stipulasse|on|stipuleda|stipulede|stipuleis|stipulan|à|oves|essan|stipularon|aon|ove|ova|avees|ombe|aesse|aessan|eis|aessa|eibes|aes|stipuledes|avea|stipularé|aeis|aessais|aede|stipula|essais|aean	<i>verb</i><br><ol><li>to stipulate</li><li>to draw up (a contract)</li></ol>
storich|storicia|storices|storic	<i>adj</i><br><ol><li>historical</li></ol>
storjer|esse|storjan|storjesses|as|aesses|é|stort|areis|storjarà|ébe|storjaron|aron|essa|ebes|ovais|storjova|storjon|arà|ae|storjareis|storjovais|aras|storjove|abù|esses|aveais|storjessais|storjessan|avei|storjes|storjede|aré|storjovan|ovan|avean|avee|on|ebe|storjaré|essan|à|storj|oves|aesse|aon|ove|ova|avees|aessan|aede|storje|storjaras|eis|aessa|storjeis|storjesse|aeis|avea|aes|ombe|storjoves|eibes|storjessa|aessais|essais|aean	<i>verb</i><br><ol><li>To twist, curve</li></ol>
straport|straporc	<i>noun</i><br><ol><li>(Gherdëina) eaves (The underside of a roof that extends beyond the external walls of a building.)</li></ol>
straufonga|straufonghes	<i>noun</i><br><ol><li>sentence, penalty, punishment</li></ol>
straurdener|straurdeners|straurdeneres|straurdenera	<i>adj</i><br><ol><li>extraordinary</li></ol>
strenjer|esse|as|strenjarà|strenjede|strenjon|strenjoves|strenjareis|é|aesses|strenjes|strenjove|areis|strenjesse|ébe|strenjova|aron|essa|strenje|ovais|ae|arà|ebes|aras|esses|abù|strenjessais|aveais|strenjovan|strenjaras|strenjesses|avei|strenjeis|aré|ovan|strenj|avee|strenjaron|avean|strent|strenjan|strenjaré|on|ebe|essan|à|oves|aesse|aon|ove|ova|avees|aessan|eis|strenjessan|aessa|aessais|aes|aeis|avea|aede|ombe|strenjovais|strenjessa|eibes|essais|aean	<i>verb</i><br><ol><li>To tighten</li><li>To reduce</li></ol>
strisca|strisces	<i>noun</i><br><ol><li>band (all senses); stripe</li></ol>
strumënt|strumënc	<i>noun</i><br><ol><li>instrument (all senses)</li></ol>
sucretëza	<i>noun</i><br><ol><li>secrecy</li><li>privacy</li></ol>
sucrët|sucrëdes|sucrëc|sucrëdas|sucrëda	<i>adj</i><br><ol><li>secret</li></ol>
sun	<i>prep</i><br><ol><li>on, over</li><li>in</li></ol>
surëdl|surëdli	<i>noun</i><br><ol><li>sun</li></ol>
sussidiarietà	<i>noun</i><br><ol><li>subsidiarity</li></ol>
susten|susteni	<i>noun</i><br><ol><li>support</li></ol>
sustenir|sustenesce|esse|sustenisses|as|sustenian|aesses|é|aean|sustenive|sustenireis|areis|ébe|aron|essa|ebes|susteniré|ovais|arà|ae|sustenesc|susten|sustenì|sustenivan|aras|abù|esses|sustenisse|susteniva|aveais|sustenives|sustenissais|avei|sustenissa|sustenesces|susteniras|aré|ovan|sustene|avee|avean|sustenissan|on|ebe|sustenivais|sustenide|essan|à|susteniron|oves|aesse|aon|sustenieis|ove|sustenion|avees|ova|aessan|eis|aessa|sustenirà|aes|aeis|avea|aessais|ombe|aede|eibes|essais|sustenes	<i>verb</i><br><ol><li>To support, sustain</li></ol>
sustitutif|sustitutifs|sustitutiva|sustitutives	<i>adj</i><br><ol><li>equivalent (able to be substituted for another)</li></ol>
sustën	<i>verb</i><br><ol><li>sustains (3rd person singular, present tense)</li></ol>
suvran|suvrans|suvranes|suvrana	<i>adj</i><br><ol><li>sovereign</li></ol>
suvranità	<i>noun</i><br><ol><li>sovereignty</li></ol>
suvënz	<i>adv</i><br><ol><li>(Gherdëina) often</li></ol>
suzescion|suzescions	<i>noun</i><br><ol><li>succession</li></ol>
suënz	<i>adv</i><br><ol><li>(Gherdëina) often</li></ol>
svilup|svilups	<i>noun</i><br><ol><li>development, growth</li></ol>
svilupea	<i>verb</i><br><ol><li>develops (3rd person singular, present tense)</li></ol>
sé	<i>pron</i><br><ol><li>oneself, himself, herself</li></ol>
sés	<i>noun</i><br><ol><li>sex</li></ol>
talian|taliana|talians|talianes	<i>adj</i><br><ol><li>Italian</li></ol>
tarënt	<i>adj</i><br><ol><li>snowless, without snow</li></ol>
te	<i>prep</i><br><ol><li>in, into</li></ol>
tecnich|tecnicia|tecnic|tecnices	<i>adj</i><br><ol><li>technical</li></ol>
tecnologich|tecnologicia|tecnologic|tecnologices	<i>adj</i><br><ol><li>technological</li></ol>
temporermënter	<i>adv</i><br><ol><li>temporarily</li></ol>
tera|teres	<i>noun</i><br><ol><li>(Mareo, Badia, Fascia, Anpezo, Fodom) earth; ground; soil</li></ol>
teritore|teritoriei	<i>noun</i><br><ol><li>territory</li></ol>
terjer|esse|as|aesses|é|tert|areis|terjessan|ébe|terjaré|essais|terj|aron|essa|terjova|ovais|ae|terjoves|arà|ebes|terje|terjan|terjesses|terjareis|aras|abù|esses|aveais|terjesse|terjeis|avei|terjes|terjessais|terjon|aré|terjovan|ovan|terjaron|avee|avean|terjove|terjessa|on|ebe|terjovais|essan|à|oves|terjarà|aesse|aon|ove|ova|avees|aessan|eis|aessa|eibes|aes|aeis|avea|aessais|ombe|aede|terjede|terjaras|aean	<i>verb</i><br><ol><li>To clear (wipe clean)</li></ol>
termin|termini	<i>noun</i><br><ol><li>term, expiry, deadline</li></ol>
terminn|termign	<i>noun</i><br><ol><li>term, expiry, deadline</li></ol>
tert	<i>adv</i><br><ol><li>late, later</li></ol>
terz|terses|tersa|terc	<i>adj</i><br><ol><li>third</li></ol>
terzo|terzi	<i>noun</i><br><ol><li>third</li></ol>
test	<i>noun</i><br><ol><li>text</li></ol>
testamenter|testamentera|testamenters|testamenteres	<i>adj</i><br><ol><li>testamentary</li></ol>
ti	<i>abbrev</i><br><ol><li>in the (masculine plural)</li></ol>
tier|tieres	<i>noun</i><br><ol><li>(gherdëina, badiot) animal</li><li>A person who has a quality thought of as animalistic, such as ferocity, strength, hairiness, etc.</li></ol>
tiera|tieres	<i>noun</i><br><ol><li>(Gherdëina) earth, soil, ground, world</li><li>(Fodom) Alternative form of tera</li></ol>
tiermul|tiermuli	<i>noun</i><br><ol><li>end</li><li>limit</li></ol>
titul|tituli	<i>noun</i><br><ol><li>title</li></ol>
tl	<i>abbrev</i><br><ol><li>in or into the</li></ol>
tla	<i>abbrev</i><br><ol><li>in the (feminine singular)</li></ol>
tles	<i>abbrev</i><br><ol><li>in the, into the (feminine plural)</li></ol>
tosc	<i>adv</i><br><ol><li>(Gherdëina, Badiot) soon</li></ol>
tradiment|tradimenc	<i>noun</i><br><ol><li>betrayal, treason, treachery, cheating</li><li>adultery, infidelity</li></ol>
tradujer|tradujovan|tradujon|esse|as|aesses|é|tradujaré|traduje|tradujaras|tradujesses|areis|tradujan|tradujovais|ébe|essais|tradujede|aron|essa|ebes|ovais|ae|arà|traduj|aras|esses|abù|tradujoves|aveais|tradujaron|tradujove|avei|tradujarà|aré|ovan|tradujes|avee|avean|on|ebe|tradujessa|essan|tradujessan|tradujeis|à|oves|aesse|tradujessais|tradut|aon|ove|avees|ova|aessan|tradujesse|tradujareis|eis|aessa|aes|aeis|avea|aessais|ombe|aede|eibes|tradujova|aean	<i>verb</i><br><ol><li>To translate</li><li>To transfer</li></ol>
tramuder|esse|as|aesses|é|tramudeies|tramudovais|areis|ébe|essais|aron|tramudovan|tramudede|ebes|ovais|ae|arà|essa|tramudes|tramudoves|tramudova|aras|esses|abù|tramuda|aveais|tramudedes|tramudareis|aessan|avei|tramudove|aré|tramudeda|tramudassa|tramudés|tramude|avee|ovan|tramudaron|avean|tramudarà|on|tramudeis|tramudé|tramudea|ebe|tramudaras|tramudon|essan|à|oves|tramudassan|aesse|aon|ove|ova|tramudasses|tramudeia|avees|ombe|eis|aessa|tramudeie|eibes|aes|aeis|avea|aessais|tramudaré|aede|tramudan|tramudassais|tramudasse|aean	<i>verb</i><br><ol><li>To move or transfer</li></ol>
transit|transic	<i>noun</i><br><ol><li>transit</li></ol>
trasferiment|trasferimenc	<i>noun</i><br><ol><li>transfer</li><li>conveyancing</li></ol>
trasferir|esse|trasferiva|as|trasferisses|trasferissais|é|aesses|trasfer|trasferissa|areis|ébe|trasferesc|aron|essa|ebes|ovais|ae|arà|trasferissan|trasferì|trasfere|trasferiras|trasferion|trasferireis|trasferivais|aras|esses|abù|trasferian|trasferives|trasferes|aveais|trasferieis|trasferive|avei|trasferisse|trasferiron|aré|trasferiré|trasferesce|avee|ovan|avean|on|ebe|trasferirà|trasferesces|essan|à|oves|aesse|aon|ove|ova|avees|aessan|eis|aessa|aessais|aes|aeis|avea|aede|ombe|trasferivan|trasferide|eibes|essais|aean	<i>verb</i><br><ol><li>to transfer</li></ol>
trasfurmazion|trasfurmazions	<i>noun</i><br><ol><li>transformation</li></ol>
trasport|trasporc	<i>noun</i><br><ol><li>transport</li></ol>
trat|trac	<i>noun</i><br><ol><li>period</li><li>tract</li><li>part, section</li></ol>
tratament|tratamenc	<i>noun</i><br><ol><li>treatment (all senses)</li></ol>
tratat|tratac	<i>noun</i><br><ol><li>treaty</li><li>treatise</li></ol>
trater|esse|tratés|tratovan|as|aesses|é|trata|tratovais|trates|traton|areis|trate|ébe|tratova|aron|tratoves|tratassa|tratareis|ovais|arà|ae|tratasse|ebes|essa|tratassan|tratarà|aras|abù|esses|trateia|aveais|trataron|tratan|tratede|trateie|avei|trataras|aré|traté|ovan|avean|avee|tratea|on|ebe|essan|tratove|à|trateies|tratassais|oves|aon|ove|trataré|avees|ova|aesse|aessan|tratedes|trateda|eis|aessa|trateis|aeis|avea|aes|ombe|aessais|tratasses|eibes|aede|essais|aean	<i>verb</i><br><ol><li>To treat, handle, carry out</li></ol>
tredesc	<i>adj</i><br><ol><li>thirteen</li></ol><br><i>noun</i><br><ol><li>thirteen</li></ol>
trei	<i>adj</i><br><ol><li>three</li></ol><br><i>noun</i><br><ol><li>three</li></ol>
trenta	<i>adj</i><br><ol><li>thirty</li></ol><br><i>noun</i><br><ol><li>thirty</li></ol>
trentecater	<i>adj</i><br><ol><li>thirty-four</li></ol><br><i>noun</i><br><ol><li>thirty-four</li></ol>
trentecinch	<i>adj</i><br><ol><li>thirty-five</li></ol><br><i>noun</i><br><ol><li>thirty-five</li></ol>
trentedoes	<i>adj</i><br><ol><li>thirty-two</li></ol><br><i>noun</i><br><ol><li>thirty-two</li></ol>
trentenuef	<i>adj</i><br><ol><li>thirty-nine</li></ol><br><i>noun</i><br><ol><li>thirty-nine</li></ol>
trenteset	<i>adj</i><br><ol><li>thirty-seven</li></ol><br><i>noun</i><br><ol><li>thirty-seven</li></ol>
trentesies	<i>adj</i><br><ol><li>thirty-six</li></ol><br><i>noun</i><br><ol><li>thirty-six</li></ol>
trentetrei	<i>adj</i><br><ol><li>thirty-three</li></ol><br><i>noun</i><br><ol><li>thirty-three</li></ol>
trentot	<i>adj</i><br><ol><li>thirty-eight</li></ol><br><i>noun</i><br><ol><li>thirty-eight</li></ol>
trentun	<i>adj</i><br><ol><li>thirty-one</li></ol><br><i>noun</i><br><ol><li>thirty-one</li></ol>
tribunal|tribunai	<i>noun</i><br><ol><li>tribunal</li></ol>
triculëur	<i>noun</i><br><ol><li>tricolour</li></ol>
truep|truepa|truepes|trueps	<i>adj</i><br><ol><li>(too) much</li><li>(too) many</li></ol>
trëi	<i>num</i><br><ol><li>three</li></ol><br><i>noun</i><br><ol><li>three</li></ol>
tuesse|tuesc	<i>noun</i><br><ol><li>(Gherdëina) poison</li></ol><br><i>adj</i><br><ol><li>(Gherdëina) poisonous, toxic</li></ol>
tëmp|tëmps	<i>noun</i><br><ol><li>time</li></ol>
tò	<i>verb</i><br><ol><li>(Gherdëina) to take</li></ol>
tòch|tòc	<i>noun</i><br><ol><li>(Gherdëina) piece</li></ol>
ublianza|ublianzes	<i>noun</i><br><ol><li>obligation, duty</li></ol>
ublient|ublientes|ublients|ublienta	<i>adj</i><br><ol><li>obligatory</li></ol>
udir|esse|as|udion|é|aean|aesses|udive|udiva|areis|udisse|ébe|udesces|udieis|udes|aron|essa|ebes|ovais|ae|arà|ude|udivais|ud|udissa|udisses|aras|esses|abù|udiron|aveais|avei|udiras|aré|udirà|ovan|avean|avee|on|ebe|udiré|udì|udissais|udide|essan|udives|à|oves|aesse|aon|ove|ova|avees|ombe|aessan|eis|aessa|udesce|udivan|aes|udesc|avea|aeis|udissan|aessais|aede|eibes|udian|essais|udireis	<i>verb</i><br><ol><li>to hear</li></ol>
ufenduda	<i>noun</i><br><ol><li>offence</li></ol>
ufize|ufizesc	<i>noun</i><br><ol><li>office (all senses)</li></ol>
ufiziel|ufiziei|ufiziela|ufizieles	<i>adj</i><br><ol><li>official</li></ol>
ufizier|ufizieres	<i>noun</i><br><ol><li>officer</li></ol>
ujin|ujins	<i>noun</i><br><ol><li>neighbor</li></ol>
ulache	<i>adv</i><br><ol><li>where, wherever</li></ol>
ulenter|ulenters|ulentera|ulenteres	<i>adj</i><br><ol><li>unintentional</li><li>involuntary</li></ol>
ultim|ultima|ultimes|ultimi	<i>adj</i><br><ol><li>last</li></ol>
uman|umanes|umans|umana	<i>adj</i><br><ol><li>human</li></ol>
umanità	<i>noun</i><br><ol><li>humanity</li></ol>
un	<i>adj</i><br><ol><li>one</li></ol><br><i>noun</i><br><ol><li>one</li></ol>
una	<i>adj</i><br><ol><li>one</li></ol>
undesc	<i>adj</i><br><ol><li>eleven</li></ol><br><i>noun</i><br><ol><li>eleven</li></ol>
uneranza|uneranzes	<i>noun</i><br><ol><li>honour</li></ol>
unerer|unereres|unerera|unerei	<i>adj</i><br><ol><li>honorary</li></ol>
uneur	<i>noun</i><br><ol><li>honour</li></ol>
unfat	<i>adj</i><br><ol><li>equal</li></ol><br><i>adv</i><br><ol><li>equally</li></ol>
uni	<i>adj</i><br><ol><li>every</li></ol>
unic|uniches|unica	<i>adj</i><br><ol><li>unique</li><li>single</li></ol>
unir|esse|union|as|aesses|é|aean|unissais|areis|unireis|unive|unesce|ébe|aron|essa|univa|ovais|unieis|arà|ae|ebes|unissan|unì|unisse|unesces|aras|esses|abù|uniron|aveais|unives|unirà|avei|unes|unisses|aré|unesc|ovan|avee|avean|uniras|on|ebe|uniré|univais|unide|unian|essan|à|oves|aesse|aon|ove|ova|avees|aessan|univan|une|eis|aessa|aes|aeis|avea|aessais|ombe|aede|eibes|un|essais|unissa	<i>verb</i><br><ol><li>to unite</li></ol>
uniter|uniteres|uniters|unitera	<i>adj</i><br><ol><li>unitary</li></ol>
unitermënter	<i>adv</i><br><ol><li>unitarily, uniformly</li></ol>
unità|uniteies	<i>noun</i><br><ol><li>unity</li></ol>
uniuno|uniuna	<i>adj</i><br><ol><li>each, every</li></ol>
universel|universela|universei|universeles	<i>adj</i><br><ol><li>universal</li></ol>
università|universiteies	<i>noun</i><br><ol><li>university</li></ol>
unì	<i>adj</i><br><ol><li>united; joined</li></ol>
urdener|urdeners|urdenera|urdeneres	<i>adj</i><br><ol><li>ordinary, usual, normal</li></ol>
urdinamënt|urdinamënc	<i>noun</i><br><ol><li>order, arrangement</li><li>rule, regulation(s)</li></ol>
urganisazion|urganisazions	<i>noun</i><br><ol><li>organization</li></ol>
urganiser|esse|urganiseda|as|urganiseia|aesses|é|urganisasses|urganisaras|urganise|urganiseies|areis|ébe|urganisareis|aron|urganiseie|ebes|urganiseis|ovais|urganisarà|arà|ae|essa|urganisoves|aras|urganisedes|abù|esses|aveais|urganison|avei|urganisés|urganisea|urganisa|urganisassa|aré|urganisaron|ovan|avean|avee|urganisasse|urganisassais|urganisovan|urganisé|urganisan|ebe|on|urganisova|urganisove|essan|urganisaré|à|oves|aesse|aon|ove|urganisassan|urganisede|avees|ova|aessan|eis|aessa|aessais|aes|aeis|avea|aede|ombe|urganises|urganisovais|eibes|essais|aean	<i>verb</i><br><ol><li>To organize</li></ol>
usc|ujes	<i>noun</i><br><ol><li>voice</li><li>entrance / exit, door</li></ol>
usservanza|usservanzes	<i>noun</i><br><ol><li>observance</li></ol>
usserver|esse|usservovan|as|usserve|é|usservedes|usserves|aesses|usservon|usservaras|usservea|usservove|usservassa|areis|usservasses|ébe|usservovais|usserveies|usservassais|aron|essa|ebes|ovais|ae|arà|usserveia|usservé|usserveis|usservaré|aras|esses|abù|usservés|usserveie|aveais|usservarà|avei|usservoves|usservaron|usservareis|usservova|aré|ovan|avean|usservede|avee|usserveda|on|ebe|usservasse|usserva|usservassan|essan|à|oves|aesse|aon|ove|ova|avees|aessan|eis|aessa|aessais|aes|usservan|avea|aeis|ombe|aede|eibes|essais|aean	<i>verb</i><br><ol><li>To observe</li></ol>
utober|utobers	<i>noun</i><br><ol><li>October</li></ol>
utschac	<i>noun</i><br><ol><li>ghost</li></ol>
vacia	<i>noun</i><br><ol><li>cow</li></ol>
valeivl|valeivles|valeivli|valeivla|valeivi	<i>adj</i><br><ol><li>valid</li></ol>
valif|valiva|valives|valifs	<i>adj</i><br><ol><li>equal</li><li>equivalent</li><li>identical</li></ol>
valivanza	<i>noun</i><br><ol><li>equality</li></ol>
valor|valores	<i>noun</i><br><ol><li>value</li></ol>
valorisazion|valorisazions	<i>noun</i><br><ol><li>exploitation, utilization</li></ol>
valtoi	<i>noun</i><br><ol><li>vulture</li></ol>
valuta|valutes	<i>noun</i><br><ol><li>importance</li><li>value</li><li>currency</li></ol>
varëta|varëtes	<i>noun</i><br><ol><li>(Gherdëina) ring (round piece of metal worn around the finger)</li></ol>
vedei|esse|as|vedeis|aesses|é|veide|areis|veides|vedovais|ébe|vedesse|vedaré|aron|vedede|essa|ebes|ovais|ae|vedarà|vedaras|arà|vedessais|vedove|vedessan|aras|vedessa|abù|esses|aveais|vedesses|avei|vedon|vedan|vedoves|aré|vedova|ovan|avean|avee|on|ebe|veid|vedaron|essan|à|vedareis|oves|aesse|vedù|aon|ove|avees|ova|ombe|aessan|eis|aessa|aessais|aes|aeis|avea|aede|veder|vedovan|eibes|essais|aean	<i>verb</i><br><ol><li>To see or look at</li></ol>
vedleza|vedlezes	<i>noun</i><br><ol><li>old age</li></ol>
vegnì|vie|vegnisses|vegnirà|vegnissais|vegnes|vegnù|vegnives|vegne|vegnivan|vegniré|vegnide|vegniva|vegnivais|vegniron|vegnisse|vegn|vegnive|vegnireis|vegnissan|vegnion|gnì|vegnieis|vegniras|vegnan|vegnissa	<i>verb</i><br><ol><li>(auxiliary, followed by a past participle) forms the passive voice</li></ol>
vela|veles	<i>noun</i><br><ol><li>election</li></ol>
vender|vendres	<i>noun</i><br><ol><li>Friday</li></ol>
vertical|verticai|verticala|verticales	<i>adj</i><br><ol><li>vertical</li></ol>
vianvieda|vianviedes	<i>noun</i><br><ol><li>training</li></ol>
viera|viers	<i>noun</i><br><ol><li>war</li></ol>
vint	<i>adj</i><br><ol><li>twenty</li></ol><br><i>noun</i><br><ol><li>twenty</li></ol>
vintecater	<i>adj</i><br><ol><li>twenty-four</li></ol><br><i>noun</i><br><ol><li>twenty-four</li></ol>
vintecinch	<i>adj</i><br><ol><li>twenty-five</li></ol><br><i>noun</i><br><ol><li>twenty-five</li></ol>
vintedoes	<i>adj</i><br><ol><li>twenty-two</li></ol><br><i>noun</i><br><ol><li>twenty-two</li></ol>
vintenuef	<i>adj</i><br><ol><li>twenty-nine</li></ol><br><i>noun</i><br><ol><li>twenty-nine</li></ol>
vinteset	<i>adj</i><br><ol><li>twenty-seven</li></ol><br><i>noun</i><br><ol><li>twenty-seven</li></ol>
vintesies	<i>adj</i><br><ol><li>twenty-six</li></ol><br><i>noun</i><br><ol><li>twenty-six</li></ol>
vintetrei	<i>adj</i><br><ol><li>twenty-three</li></ol><br><i>noun</i><br><ol><li>twenty-three</li></ol>
vintot	<i>adj</i><br><ol><li>twenty-eight</li></ol><br><i>noun</i><br><ol><li>twenty-eight</li></ol>
vintun	<i>adj</i><br><ol><li>twenty-one</li></ol><br><i>noun</i><br><ol><li>twenty-one</li></ol>
vita|vites	<i>noun</i><br><ol><li>life</li></ol>
viulazion|viulazions	<i>noun</i><br><ol><li>violation</li></ol>
viuler|esse|as|aesses|é|viulan|aean|viulovan|aede|viuleis|viulove|areis|viulés|viulassa|ébe|aron|essa|ebes|ovais|ae|arà|viulovais|aras|esses|viuledes|viulon|abù|aveais|viules|viulova|aessan|viuloves|avei|aré|aesse|viularon|viulassais|viularà|viulassan|viulé|viularas|avee|ovan|avean|on|viulasse|ebe|essan|viula|viulea|viuleies|à|aon|ove|oves|viuleie|avees|ova|viule|viulareis|viularé|eis|aessa|viuleda|aeis|avea|aes|ombe|viuleia|viulasses|eibes|aessais|essais|viulede	<i>verb</i><br><ol><li>to violate</li></ol>
viulënza|viulënzes	<i>noun</i><br><ol><li>violence</li></ol>
viver|vivesse|vivù|é|vivede|vivareis|vivovan|viv|foves|sté|fosses|sareis|vivessa|sun|vivaré|saron|saras|vivove|vivan|fovais|vivessais|fossa|sies|fova|vivaron|fovan|vive|fossan|ester|steda|fosse|sarà|viveis|fossais|stés|saré|vivaras|vivova|vivessan|vivarà|vivoves|sede|son|vivon|stedes|fove|sian|seis|vivesses|vives|vivovais|sie|ies	<i>verb</i><br><ol><li>to live</li></ol>
vizepresident|vizepresidenc	<i>noun</i><br><ol><li>vice president</li></ol>
volei|esse|volessa|as|aesses|é|volesses|volarà|vuele|voloves|areis|volessan|volaré|ébe|aron|volan|essa|ebes|vues|ovais|arà|ae|volaron|volareis|aras|abù|esses|aveais|volessais|volon|vuel|volù|volovais|volaras|avei|vue|aré|ovan|avean|voleis|avee|volova|on|ebe|volovan|essan|à|oves|aesse|voler|aon|ove|avees|ova|aessan|volove|volesse|eis|aessa|aes|aeis|avea|aessais|ombe|aede|eibes|essais|aean	<i>verb</i><br><ol><li>to want (to)</li></ol>
volp	<i>noun</i><br><ol><li>fox</li></ol>
vëis	<i>noun</i><br><ol><li>(Gherdëina) Quitting time, hometime; the workday's end and the evening following it, used for relaxation or leisure.</li></ol>
vërt	<i>adj</i><br><ol><li>green</li></ol>
y	<i>conj</i><br><ol><li>and</li></ol>
zachei	<i>pron</i><br><ol><li>someone, anyone</li></ol>
zebra|zebres	<i>noun</i><br><ol><li>zebra</li></ol>
zech	<i>pron</i><br><ol><li>(Gherdëina) something, anything</li></ol>
zeche	<i>adj</i><br><ol><li>a few</li><li>some, any</li></ol>
zedola|zedoles	<i>noun</i><br><ol><li>banknote</li><li>coupon, voucher</li></ol>
zensura|zensures	<i>noun</i><br><ol><li>censorship</li><li>censure</li></ol>
zentrel|zentrei|zentrela|zentreles	<i>adj</i><br><ol><li>central</li></ol>
zenza	<i>conj</i><br><ol><li>without</li></ol>
zevil|zeviles|zevii|zevila	<i>adj</i><br><ol><li>civil</li></ol>
zircoscrizion|zircoscrizions	<i>noun</i><br><ol><li>district, area (administrative)</li><li>circumscription</li></ol>
zirculazion|zirculazions	<i>noun</i><br><ol><li>circulation</li></ol>
zitadin|zitadins	<i>noun</i><br><ol><li>citizen</li></ol>
zitadinanza	<i>noun</i><br><ol><li>citizens (collectively)</li><li>citizenship</li></ol>
zità|ziteies	<i>noun</i><br><ol><li>town, city</li></ol>
zivich|zivic|zivices|zivicia	<i>adj</i><br><ol><li>civic</li></ol>
Ë|ë	<i>character</i><br><ol><li>The open-mid central unrounded vowel as used in the Gherdëina variant of Ladin.</li></ol>
ë|Ë	<i>character</i><br><ol><li>The open-mid central unrounded vowel as used in the Gherdëina variant of Ladin.</li></ol>
ëi	<i>pron</i><br><ol><li>(Gherdëina) they</li></ol>
ëila|ëiles	<i>noun</i><br><ol><li>(Gherdëina) woman</li></ol><br><i>pron</i><br><ol><li>(Gherdëina) she</li></ol>
ëiles	<i>pron</i><br><ol><li>(Gherdëina) they</li></ol>
ël|ëi	<i>noun</i><br><ol><li>(Gherdëina) man</li></ol><br><i>pron</i><br><ol><li>(Gherdëina) he</li></ol>
ërt	<i>adj</i><br><ol><li>(Gherdëina) steep</li></ol>
ëura	<i>noun</i><br><ol><li>(Gherdëina) hour</li><li>(Gherdëina) time (of the day); hour</li><li>(Gherdëina) clock, watch (instrument used to measure or keep track of time)</li></ol>
śën	<i>adv</i><br><ol><li>(Gherdëina) now</li></ol>
