't|uch [əç]|veer|zich|heë|d'ch|ze|miener|det|e|miches|zie|v'r|'ch|doe|ózzer|m'r|mir|like dat. and acc.|ich|dir|de|hönnen|uch|'r|hön|hem|d'r|het|deë|dem|weet|m'ch|duur|ózzes|mich|dich|weer|die|vir|d'm|'m|miens|ós	<i>article</i><br><ol><li>the, it</li></ol>
Aegipdje	<i>name</i><br><ol><li>Egypt (a country in Africa)</li></ol>
Albanië	<i>name</i><br><ol><li>Albania (a country in Europe)</li></ol>
Andórre	<i>name</i><br><ol><li>Andorra (a country in Europe)</li></ol>
Apréll	<i>name</i><br><ol><li>(Eupen) April (month)</li></ol>
Attvärrep	<i>noun</i><br><ol><li>(Eupen, grammar) adverb</li></ol>
Augusst	<i>noun</i><br><ol><li>(Eupen) August (month)</li></ol>
Azerbeizjaan	<i>name</i><br><ol><li>Azerbaijan (a country in Europe and Asia)</li></ol>
Ball|Bäll|Bälltje	<i>noun</i><br><ol><li>(Eupen, Krefeld) ball (round or roundish object, most commonly used in games)</li><li>(Eupen, Krefeld, informal) testicle, nut</li><li>(Eupen, Krefeld, anatomy) ball (of the hand or foot)</li><li>(Eupen, Krefeld, chiefly in the negative) anything</li><li>(Eupen, Krefeld, dance) ball (social gathering for dancing), prom (US)</li></ol>
Bangladesj	<i>name</i><br><ol><li>Bangladesh</li></ol>
Bloutsliër	<i>noun</i><br><ol><li>haematology, hematology</li></ol>
Boot	<i>noun</i><br><ol><li>(Eupen) boat</li></ol>
Botts|Botts f trousers|Böttske|Bottse|pants	
Bouk|Böükske|Böük|Böügeltje	<i>noun</i><br><ol><li>(Eupen) book</li></ol>
Braziel	<i>name</i><br><ol><li>Brazil (a country in South America)</li></ol>
Broër|Bröër|Brörreke	<i>noun</i><br><ol><li>(Eupen) brother</li><li>(Eupen) Brother</li></ol>
Bröll|Brölltje|Brölls	<i>noun</i><br><ol><li>(Eupen, Krefeld) scream, cry, roar</li><li>(Eupen) (pair of) glasses, spectacles (frames bearing two lenses worn in front of the eyes to correct vision)</li><li>(Eupen) (pair of) goggles (protective eyewear set in a flexible frame to fit snugly against the face)</li></ol>
Bärrech|Bärrechsche	<i>noun</i><br><ol><li>(Eupen, geography) mountain, hill (refers to any elevated terrain)</li><li>(Eupen, figuratively) pile, heap</li><li>(Eupen, in the plural) mountain range</li></ol>
Bèlsj	<i>name</i><br><ol><li>Belgium (a country in Europe)</li></ol>
Bé|Béttje|Béjje	<i>noun</i><br><ol><li>(Eupen) bee</li></ol>
Béër|Béëre|Bérreke|Béërin	<i>noun</i><br><ol><li>(Eupen) beer</li><li>(Eupen) boar (male swine)</li><li>(Eupen) A bear, any member of the family Ursidae</li><li>(figuratively, Eupen) bear (someone or something bear-like, e.g. a sturdy man)</li></ol>
Bósnië	<i>name</i><br><ol><li>Bosnia</li></ol>
Bótswaan	<i>name</i><br><ol><li>Botswana (a country in Africa)</li></ol>
Bölgerië	<i>name</i><br><ol><li>Bulgaria (a country in Europe)</li></ol>
Böük|Böükske	<i>noun</i><br><ol><li>(countable, Eupen) a beech (Fagus); the common tree</li><li>(uncountable, Eupen) beech; the wood of the tree</li></ol>
Daach|Daach!|Daach	<i>noun</i><br><ol><li>(Eupen, Krefeld, countable) day (period of 24 hours)</li><li>(Eupen, Krefeld, uncountable) daytime (time between sunrise and sunset)</li></ol><br><i>intj</i><br><ol><li>(Eupen, Krefeld) hello</li><li>(Eupen, Krefeld) goodbye</li></ol>
Dakk|Daaker|Däkkske	<i>noun</i><br><ol><li>(Eupen) roof</li><li>(Eupen, mining) roof (The surface or bed of rock immediately overlying a bed of coal or a flat vein.)</li><li>(Eupen, geology) a rock layer above a seam</li></ol>
Dieënemerk	<i>name</i><br><ol><li>Denmark (a country in Europe)</li></ol>
Droon	<i>noun</i><br><ol><li>A drone; a male bee.</li></ol>
Dröpp|Dröppeltje	<i>noun</i><br><ol><li>(Eupen) drop, droplet</li></ol>
Duutsland	<i>name</i><br><ol><li>Germany (a country in Europe)</li></ol>
Détsämmber	<i>noun</i><br><ol><li>(Eupen) December (month)</li></ol>
Déër|Dérreke|Déëre	<i>noun</i><br><ol><li>(Eupen) animal</li><li>(Eupen) A person who has a quality thought of as animalistic, such as ferocity, strength, hairiness, etc.</li></ol>
Ermieënië	<i>name</i><br><ol><li>Armenia (a country in Europe and Asia)</li></ol>
Esland	<i>name</i><br><ol><li>Estonia (a country in Europe)</li></ol>
Finlandj	<i>name</i><br><ol><li>Finland (a country in Europe)</li></ol>
Frankriek	<i>name</i><br><ol><li>France (a country in Europe)</li></ol>
Fébruwaar	<i>noun</i><br><ol><li>(Eupen) February (month)</li></ol>
Genoewa	<i>name</i><br><ol><li>Genoa (the capital city of Liguria, Italy)</li><li>Genoa (a metropolitan city of Liguria, Italy)</li></ol>
Gott	<i>noun</i><br><ol><li>(Eupen) god</li></ol><br><i>name</i><br><ol><li>(Eupen, rare) God</li></ol>
Gout|Goute|Göütske	<i>noun</i><br><ol><li>(Eupen, uncountable) gold (chemical element, Au)</li><li>(Eupen, uncountable) gold (color)</li><li>(Eupen, uncountable) goodness</li><li>(Eupen) commodity, property, possession, good</li><li>(Eupen) a large farmstead, estate related to agriculture.</li></ol>
Greekslandj	<i>name</i><br><ol><li>Greece (a country in Europe)</li></ol>
Gód|Góddes|God!|Góds|Góddem|Gódde	<i>name</i><br><ol><li>(Christianity) God</li></ol>
Haundert|Haunderte	<i>noun</i><br><ol><li>(Eupen) hundred (the number)</li><li>(Eupen) hundred (unity of one hundred things)</li><li>(Eupen, in the plural) hundreds of (unspecified large quantity)</li></ol>
Haunt|Häunt|Hönntje	<i>noun</i><br><ol><li>(Eupen) dog</li><li>(Eupen, derogatory) bitch (used for draft animals)</li><li>(Eupen, derogatory) scoundrel; dog (mean or morally reprehensible person)</li></ol>
Haïnt|Hänntje	<i>noun</i><br><ol><li>(Eupen, anatomy, common variant) A hand</li></ol>
Hit	<i>noun</i><br><ol><li>(german-based spelling, slang) hit (A success, especially in the entertainment industry.)</li><li>(german-based spelling, slang) hit (A dose of an illegal or addictive drug.)</li><li>(german-based spelling, computing, Internet) hit</li></ol>
Hiër|Hiëvesch|Härr|Hiërke|Hiëre	<i>noun</i><br><ol><li>(Eupen, archaic) man, gentleman (polite term)</li><li>(Eupen, archaic) sir (title of respect)</li><li>(Eupen, archaic) Mr., mister, sir</li><li>(Eupen, archaic) gentleman</li><li>(Eupen, archaic) master, lord (generally denotes that somebody has control over something, either in a generic or in a regal sense)</li><li>(Eupen, uncommon) Lord, God</li></ol>
Hoff|Höffke|Höff	<i>noun</i><br><ol><li>(Eupen) yard, court, courtyard (open area by a house or enclosed by houses)</li><li>(Eupen) court (residence and entourage of a nobleman)</li><li>(Eupen) farmyard (central area of a farm, excluding the fields)</li><li>(Eupen, by extension) farm, agricultural enterprise</li></ol>
Huss|Huse	<i>noun</i><br><ol><li>(Eupen) cover</li></ol>
Huus|Huuser|Hüüser|Hüüske|Hüsske|Hüüs	<i>noun</i><br><ol><li>(Eupen, Krefeld) house</li><li>(Eupen, Krefeld, uncommon) home</li></ol>
Héll|Hélle|Héllke	<i>noun</i><br><ol><li>(Eupen) hell</li></ol>
Hétt	<i>noun</i><br><ol><li>(Eupen, slang) hit (A success, especially in the entertainment industry.)</li><li>(Eupen, slang) hit (A dose of an illegal or addictive drug.)</li><li>(Eupen, computing, Internet) hit</li></ol>
Héïm|Héïvesch|Héïmer|Héïmke	<i>noun</i><br><ol><li>(Eupen) home</li><li>(Eupen) house</li><li>(Eupen) asylum</li></ol>
Hóngerië	<i>name</i><br><ol><li>Hungary (a country in Europe)</li></ol>
Höll|Hölle|Höllke	<i>noun</i><br><ol><li>(Eupen, Krefeld) hell</li></ol>
Iesland	<i>name</i><br><ol><li>Iceland (a country in Europe)</li></ol>
Ieslandj	<i>name</i><br><ol><li>Iceland (a country in Europe)</li></ol>
Ietelje	<i>name</i><br><ol><li>Italy (a country in Europe)</li></ol>
Ingelandj	<i>name</i><br><ol><li>England (a constituent country of the United Kingdom)</li></ol>
Ingelsj	<i>name</i><br><ol><li>English</li></ol>
Jannewaar|Jannewaare	<i>noun</i><br><ol><li>(Eupen) January (month)</li></ol>
Jezus	<i>name</i><br><ol><li>(Christianity) Jesus</li></ol>
Jong|Jöngeltje|Jonge	<i>noun</i><br><ol><li>(Eupen, Krefeld) boy, lad</li><li>(Eupen, Krefeld) son</li></ol>
Joër|Jörreke|Joëre	<i>noun</i><br><ol><li>(Eupen) year (solar year, the time it takes the Earth to complete one revolution of the Sun)</li><li>(Eupen) year (time it takes for any astronomical object to directly orbit its star)</li><li>(Eupen) year (period between set dates that mark a year)</li><li>(Eupen) year (level or grade in school or college)</li></ol>
Joërhaundert|Joërhaunderte	<i>noun</i><br><ol><li>(Eupen) a century (period of 100 years)</li></ol>
Juss	<i>noun</i><br><ol><li>(Krefeld) August (month)</li></ol>
Juuli	<i>noun</i><br><ol><li>(Eupen) July</li></ol>
Juuni	<i>noun</i><br><ol><li>(Eupen) June</li></ol>
Kalle	<i>noun</i><br><ol><li>(Eupen) conversation, chat</li></ol>
Kanneda	<i>name</i><br><ol><li>Canada (a country in North America)</li></ol>
Kazachstan	<i>name</i><br><ol><li>Kazakhstan (a country in Asia)</li></ol>
Kaïnt|Kaïnte|Kineke|Kaïnder|Kénntje	<i>noun</i><br><ol><li>(Eupen) kid; child (young person)</li><li>(Eupen) child; offspring (person with regard to his or her parents; also a baby animal or young animal)</li><li>side, face (of an object)</li><li>side (as opposed to top or bottom)</li><li>way, direction</li></ol>
Kenië	<i>name</i><br><ol><li>Kenya (a country in Africa)</li></ol>
Koeweit	<i>name</i><br><ol><li>Kuwait (a country in Asia)</li></ol>
Kommissjuuën|Kommissjüüënke|Kommissjuuëne	<i>noun</i><br><ol><li>(Eupen) groceries</li><li>(Eupen) commission</li></ol>
Kriëk|Kriëkske|Kriëke	<i>noun</i><br><ol><li>(Eupen) creek</li></ol>
Kuuprös	<i>name</i><br><ol><li>Cyprus (an island and country in Europe)</li></ol>
Kèrwaasje	<i>name</i><br><ol><li>Croatia (a country in Europe)</li></ol>
Kózzevo	<i>name</i><br><ol><li>Kosovo (a country in Europe)</li></ol>
Lakrétts	<i>noun</i><br><ol><li>(Eupen) licorice, liquorice (confectionery)</li></ol>
Lavvabo|Lavvabos	<i>noun</i><br><ol><li>(Eupen) washbasin, sink</li><li>(Eupen, Christianity) lavabo (liturgical handwashing)</li><li>(Eupen, Christianity) lavabo (washbasin used for such handwashing)</li></ol>
Laïnt|Länntje|Haïnder|Laïnts	<i>noun</i><br><ol><li>(Eupen, countable) country (territory of a nation)</li><li>(Eupen, countable) state, province (political division of a federation retaining a notable degree of autonomy)</li><li>(Eupen, countable) land (real estate or landed property)</li><li>(Eupen, uncountable) land (part of Earth which is not covered by oceans or other bodies of water)</li><li>(Eupen, uncountable) country, countryside (rural area, as opposed to a town or city)</li></ol>
Laïntsvall|Laïntsvalle	<i>noun</i><br><ol><li>(Eupen) fall of a country/empire</li></ol>
Liechtestein	<i>name</i><br><ol><li>Liechtenstein (a country in Europe)</li></ol>
Lieëtsjebèrg	<i>name</i><br><ol><li>Luxembourg (a country in Europe)</li></ol>
Liist|Liiste|Lisske	<i>noun</i><br><ol><li>(Eupen) list</li></ol>
Limburgs	<i>adj</i><br><ol><li>Limburgish</li></ol><br><i>name</i><br><ol><li>Limburgish (language)</li></ol>
Littów	<i>name</i><br><ol><li>Lithuania (a country in Europe)</li></ol>
Lèmbörg	<i>name</i><br><ol><li>Limburg, a province of the Netherlands.</li><li>Limburg, a province of Belgium.</li></ol>
Lèmbörgsj	<i>name</i><br><ol><li>Limburgish (the Germanic language)</li></ol>
Lètlandj	<i>name</i><br><ol><li>Latvia (a country in Europe)</li></ol>
Makedonië	<i>name</i><br><ol><li>Macedonia</li></ol>
Malte	<i>name</i><br><ol><li>Malta (an island and country in Europe)</li></ol>
Marokko	<i>name</i><br><ol><li>Morocco (a country in Africa)</li></ol>
Marrmoër|Marrmoëre|Marrmöërke	<i>noun</i><br><ol><li>(Eupen, uncountable, petrology) marble</li><li>(Eupen, countable, games) marble</li></ol>
Merókko	<i>name</i><br><ol><li>Morocco (a country in Africa)</li></ol>
Mestreech	<i>name</i><br><ol><li>Maastricht (the capital and largest city of the province of Limburg, Netherlands)</li></ol>
Mofers	<i>noun</i><br><ol><li>the dialect of Limburgish spoken in the town Montfort</li></ol>
Mègkziko	<i>name</i><br><ol><li>Mexico (a country in North America)</li></ol>
Móldavië	<i>name</i><br><ol><li>Moldova (a country in Europe)</li></ol>
Mónnako	<i>name</i><br><ol><li>Monaco (a country in Europe)</li></ol>
Nieëderlandj	<i>name</i><br><ol><li>the Netherlands (a country in Europe)</li></ol>
Nórwaeg	<i>name</i><br><ol><li>Norway (a country in Europe)</li></ol>
Oeasteriek	<i>name</i><br><ol><li>Austria (a country in Europe)</li></ol>
Oekerien	<i>name</i><br><ol><li>Ukraine (a country in Europe)</li></ol>
Oesbekistan	<i>name</i><br><ol><li>Uzbekistan (a country in Asia)</li></ol>
Ogusst	<i>noun</i><br><ol><li>(Eupen) August (month)</li></ol>
Oosteriek	<i>name</i><br><ol><li>Austria (a country in Europe)</li></ol>
Poeale	<i>name</i><br><ol><li>Poland (a country in Europe)</li></ol>
Pools	<i>noun</i><br><ol><li>Polish language</li></ol>
Pruses	<i>name</i><br><ol><li>Germany</li></ol>
Pórtegal	<i>name</i><br><ol><li>Portugal (a country in Europe)</li></ol>
Remieënië	<i>name</i><br><ol><li>Romania (a country in Europe)</li></ol>
Röslandj	<i>name</i><br><ol><li>Russia (a country in Europe and Asia)</li></ol>
Rössisj	<i>name</i><br><ol><li>Russian (language)</li></ol>
Sen Merino	<i>name</i><br><ol><li>San Marino (a country in Europe)</li></ol>
Sjótlandj	<i>name</i><br><ol><li>Scotland (a constituent country of the United Kingdom)</li></ol>
Slivvenier	<i>name</i><br><ol><li>(Maastrichtian, Christianity) our dear Lord</li></ol>
Slowakië	<i>name</i><br><ol><li>Slovakia (a country in Europe)</li></ol>
Slowenië	<i>name</i><br><ol><li>Slovenia (a country in Europe)</li></ol>
Spanje	<i>name</i><br><ol><li>Spain (a country in Europe)</li></ol>
Sèrvië	<i>name</i><br><ol><li>Serbia (a country in Europe)</li></ol>
Tsigerätt|Tsigerätteke|Tsigerätte	<i>noun</i><br><ol><li>(Eupen) cigarette</li></ol>
Tsjèchië	<i>name</i><br><ol><li>the Czech Republic (a country in Europe)</li></ol>
Törkië	<i>name</i><br><ol><li>Turkey (a country in Europe and Asia)</li></ol>
Vajer|Vajereske|Vajerke|Vajereskes|Vajern|Vajeres|Vajereser|Vajerkes|Vajers|Vajere	<i>name</i><br><ol><li>Father</li><li>Lord</li></ol>
Vatikaanstad	<i>name</i><br><ol><li>Vatican City (a city-state in Southern Europe, an enclave within the city of Rome, Italy)</li></ol>
Vereinig Keuninkreik	<i>name</i><br><ol><li>the United Kingdom (a country in Europe)</li></ol>
Viëtnam	<i>name</i><br><ol><li>Vietnam (a country in Asia)</li></ol>
Wietröslandj	<i>name</i><br><ol><li>Belarus (a country in Europe)</li></ol>
Wikipedia	<i>name</i><br><ol><li>Wikipedia</li></ol>
Wiktionair	<i>name</i><br><ol><li>Wiktionary</li></ol>
Zarett	<i>noun</i><br><ol><li>(Krefeld) cigarette</li></ol>
Zierië	<i>name</i><br><ol><li>Syria (a country in Asia)</li></ol>
Zjezös|Zjezöske|Zjeze|Zjezöskes|Zjezem|Zjezemske|Zjezözes|Zjeeske	<i>name</i><br><ol><li>(Christianity) Jesus Christ</li></ol>
Zjieërzje	<i>name</i><br><ol><li>Georgia (a country in Europe and Asia)</li></ol>
Zwartberg	<i>name</i><br><ol><li>Montenegro (a country in Europe)</li></ol>
Zweitsjerlandj	<i>name</i><br><ol><li>Switzerland (a country in Europe)</li></ol>
Zwieëd	<i>name</i><br><ol><li>Sweden (a country in Europe)</li></ol>
Zwèdsj	<i>noun</i><br><ol><li>the Swedish language</li></ol>
alabonneur	<i>adv</i><br><ol><li>(Maastrichtian) General expression of approval.</li></ol>
alleminium|alleminiums|alleminieke|alleminieëskes|alleminia|alleminiumme|alleminieëser|alleminieës|alleminieëske|alleminiekes	<i>noun</i><br><ol><li>(uncountable) aluminium</li><li>A part of aluminium</li></ol>
alltiits	<i>adv</i><br><ol><li>(Eupen) always; evermore</li><li>(Eupen) constantly, continually</li></ol>
alltits	<i>adv</i><br><ol><li>(Krefeld) always; evermore</li><li>(Krefeld) constantly, continually</li></ol>
altied	<i>adv</i><br><ol><li>always; evermore</li><li>constantly, continually</li></ol>
aomezeik|aomezeikes|aomezeikske|aomezeikeske|aomezeikskes|aomezeikeskes|aomezeikskem|merezeik|aomezeikese|aomezeiksel|aomezeike	<i>noun</i><br><ol><li>(zoology, widespread, specifically in Central Limburgish, East Limburgish, Southeast Limburgish) ant</li></ol>
april	<i>noun</i><br><ol><li>April (month)</li></ol>
argon	<i>noun</i><br><ol><li>(uncountable) argon</li><li>A part of argon</li></ol>
arseen	<i>noun</i><br><ol><li>(uncountable) arsenic</li><li>A part of arsenic</li></ol>
astrein	<i>adv</i><br><ol><li>(Maastrichtian) directly, immediately</li></ol>
augustus	<i>noun</i><br><ol><li>August (month)</li></ol>
avvencere	<i>verb</i><br><ol><li>(intransitive, common in Maastrichtian, rare in Central Limburgish, East Limburgish, Southeast Limburgish) to advance</li></ol>
avventouw	<i>adv</i><br><ol><li>(idiomatic, Maastrichtian) now and then; occasionally</li></ol>
baer|paeveskes|paeves|paerke|baers|paerkes|baerkes|baerem|paerem|paers|baeveskes|paere|paerkem|baerkem|paerer|baeves|baeveske|baevese|paer|baerer|baerke|paevese|baerin|paeveske|baere	<i>noun</i><br><ol><li>A bear, any member of the family Ursidae</li><li>(figuratively) bear (someone or something bear-like, e.g. a sturdy man)</li><li>(obsolete) dog (animal), though still used for a masculine dog</li></ol>
baere|tö baere|baer!|boor|gebaorelik|bèrretj|'t gebèr n|baerem|bèrtj'r|baertj!|baer|gebaores|bèrtj!|bèrrer|bèrre|boortj|bèrs|gebaorer|boors|gebaore|bèr|höbbe gebaore|baere-n|bore|'t baere|bèr!|baerendj|baertj|bèrtj	<i>verb</i><br><ol><li>(transitive) to carry</li><li>(transitive) to bear, endure</li><li>(transitive) to give birth</li></ol>
bal|palleskes|palles|pals|balleskes|balles|pelker|bel|belkem|pal|balleske|pel|pelkem|ballem|ballese|pelke|palle|belke|belker|balle|pallese|palleske|pallem|bals|belkes|belsje|pelkes	<i>noun</i><br><ol><li>(most dialects) ball (round or roundish object, most commonly used in games)</li><li>(most dialects, informal) testicle, nut</li><li>(most dialects, anatomy) ball (of the hand or foot)</li><li>(most dialects, chiefly in the negative) anything</li></ol>
balle|baltj'r|baller|ballendj|baldje|balletj|bal|ballem|höbbe gebal|'t gebal n|gebaldjelik|gebaldje|'t balle|baldje-n|baldjes|balletj!|baltj!|gebaldj|bal!|bals|gebaldjes|baltj|gebaldjer|balle-n|tö balle	<i>verb</i><br><ol><li>(intransitive) to play with a ball</li></ol>
barium|barieëser|bariekes|bariums|barieës|bariumme|barieëske|barieëskes|baria|barieke	<i>noun</i><br><ol><li>(uncountable) barium</li><li>A part of barium</li></ol>
bats|patsese|petske|patses|betskem|patseskes|betskes|batsese|betske|batses|batseskes|petskem|patse|petskes|batse|pats|patseske|batseske	<i>noun</i><br><ol><li>(anatomy) buttock</li></ol>
beer|pereskes|peerker|baeres|beerkem|berese|peers|beerkes|bere|peerke|bereskes|bereske|baerese|perese|beerke|paerese|beres|beer|paereske|peer|baereskes|baereske|paeres|peerkes|perem|beers|pereske|paereskes|pere|berem|peerkem|beerker|peres	<i>noun</i><br><ol><li>beer</li><li>boar (male swine)</li><li>berry</li></ol>
berg|berge|pergskem|bergem|bergeskes|pergskes|pergem|pergeskes|bergs|berg|pergeske|perg|bergskem|bergeske|pergese|bergske|berges|bergskes|pergs|perge|perges|pergske|bergese	<i>noun</i><br><ol><li>(geography) mountain, hill (refers to any elevated terrain)</li><li>(figuratively) pile, heap</li><li>(in the plural) mountain range</li><li>(some dialects, including Maastrichtian, Sittard, Valkenburg) a castrated pig, swine</li></ol>
berilium|berilieës|berilieke|beriliumme|berilieëser|beriliums|beriliekes|berilia|berilieëske|berilieëskes	<i>noun</i><br><ol><li>(uncountable) berylium</li><li>A part of berylium</li></ol>
bestósse|bestósse-n|gebestósdjes|bestóssetj|gebestós|gebestósdjelik|bestósser|bestósdje|bestósdjes|bestóssendj|bestós|bestósdje-n|bestós!|'t gebestós n|'t bestósse|bestóstj|tö bestósse|höbbe gebestós|bestóssetj!|gebestósdjer|bestóssem|gebestósdje|bestóstj!	<i>verb</i><br><ol><li>to support at</li><li>to rest on</li></ol>
beuk|beukes|beuksker|beukeske|peukese|peukeske|peuk|beukskem|beukske|peuks|peukskes|peukeskes|beuks|peukske|beukese|peukskem|peuke|beukem|beukskes|peuksker|beuke|peukem|beukeskes|peukes	<i>noun</i><br><ol><li>(countable, widespread variant) a beech (Fagus); the common tree</li><li>(uncountable) beech; the wood of the tree</li></ol>
bie|piejes|biejeskes|biekem|bieke|biejeske|piejeske|bieje|piejeskes|piekem|biekes|biejes|biejese|pieje|pie|pieke|piekes|piejese	<i>prep</i><br><ol><li>(locative) by, at</li><li>(with a person, family, shop) at</li><li>(with an organization or company) for; at; in</li><li>(with a reflexive pronoun) with; on</li><li>(with an event considered certain) upon, at the time of</li><li>(with an event considered theoretical) in case of, in the event of</li><li>(with a continuing activity or condition) during; while; during the existence of</li><li>(with an item that implies an activity) over; during</li><li>(with accusative) with, to, towards</li></ol><br><i>noun</i><br><ol><li>bee</li></ol>
biewaord|piewäördeske|biewaordem|biewäördese|piewaord|piewäördje|piewäördjem|piewaorde|piewäördeskes|biewaord (n)|biewäördjes|biewäördjem|biewäördeskes|piewäördese|biewäördje|biewaorde|piewaords|piewäördjes|biewaords|biewäördes|piewäördes|piewaordem|biewäördeske	<i>noun</i><br><ol><li>(grammar) adverb</li></ol>
biezar|'t biezars|biezare|biezarder|biezarer|biezares|biezaren|biezars	<i>adj</i><br><ol><li>bizarre, strange</li></ol>
bismuth	<i>noun</i><br><ol><li>(uncountable) bismuth</li><li>A part of bismuth</li></ol>
bloodslieër	<i>noun</i><br><ol><li>haematology, hematology</li></ol>
blósse|blósdje-n|blóssetj!|geblósdjes|geblós|blóssem|geblósdje|geblósdjelik|blósdje|geblósdjer|blósser|blóstj!|blóssendj|blóssetj|blós!|höbbe geblós|blósse-n|blósdjes|blóstj|tö blósse|'t geblós n|blós|'t blósse	<i>verb</i><br><ol><li>to flourish, blossom</li></ol>
boe	<i>adv</i><br><ol><li>(Maastrichtian) Alternative form of woe (“where”)</li></ol>
boeat	<i>noun</i><br><ol><li>(uncommon variant) boat</li></ol>
boenaotouw	<i>pron</i><br><ol><li>(Maastrichtian) whither, where to</li></ol>
boerum	<i>adv</i><br><ol><li>(Maastrichtian) why</li></ol>
bomma	<i>noun</i><br><ol><li>(Maastrichtian) grandmother</li></ol>
bompa	<i>noun</i><br><ol><li>(Maastrichtian) grandfather</li></ol>
book|beuk|beukeskes|books|beuksker|beukes|beukeske|peukese|peukeske|peuk|beukskem|pokese|beukske|peuks|pokeske|peukskes|peukeskes|beuks|pokem|pooks|pokeskes|peukske|pook|beukese|peukskem|bokeskes|bokem|bokeske|peuke|beukem|beukskes|bokes|peuksker|pokes|beuke|peukem|bokese|peukes	<i>noun</i><br><ol><li>(many dialects) book</li></ol>
brazzelèt	<i>noun</i><br><ol><li>(Maastrichtian) bracelet</li></ol>
bridge	<i>noun</i><br><ol><li>(card games) bridge (card game)</li></ol>
broor|preurkes|preurs|brores|broreske|breurkem|proors|breurke|brorem|preurke|prorese|proreskes|prores|breurkes|broreskes|proreske|brorese|broors|preurkem|proor|prore|breurs|prorem|brore	<i>noun</i><br><ol><li>brother</li></ol>
bróm	<i>noun</i><br><ol><li>(uncountable) bromine</li><li>A part of bromine</li></ol>
bröl|brölke|brölleskes|pröllem|brölkem|brölle|bröls|brölste|prölle|pröls|'t brölt|brölles|bröllese|brölleske|prölleskes|brölkes|bröllem|prölkem|prölles|pröllese|prölke|prölkes|prölleske|pröl	<i>adj</i><br><ol><li>crazy, insane</li><li>savage</li></ol><br><i>noun</i><br><ol><li>scream, cry, roar</li></ol>
bäöke|tö bäöke|gebäökedjes|bäöke-n|'t gebäöke n|gebäöke|bäökendj|bäöketj|bäökedje|höbbe gebäöke|bäökedjes|bäökedje-n|bäökes|bäökem|gebäökedjer|gebäökedje|bäöke!|'t bäöke|bäöketj!|bäöker|gebäökedjelik	<i>verb</i><br><ol><li>to blubber, cry</li></ol>
bäökól	<i>noun</i><br><ol><li>A baby that cries excessively, crybaby.</li></ol>
bèdzje|gebódzjer|gebódzjelik|bètsj!|'t gebótsj n|gebódzjes|badzjes|bèdzjer|bötsjem|bèdzjendje|bètsj|bèdzjetj|höbbe gebótsj|boeatsj!|buuetsj!|bèdzjes|bötsj!|badzje|tö bèdzje|gebótsj|gebódzje|bèdzje-n|'t bèdzje|batsj	<i>verb</i><br><ol><li>to do again</li></ol>
bèdzjere|tö bèdzjere|bèdzjeredje-n|bèdzjeretj'r|bèdzjeres|bèdzjeretj|gebèdzjeredje|bèdzjerer|gebèdzjeredjelik|gebèdzjeredjes|bèdzjerem|bèdzjere!|bèdzjeredje|bèdzjeretj!|'t gebèdzjere n|gebèdzjeredjer|höbbe gebèdzjere|bèdzjere-n|gebèdzjeredj|bèdzjerendj|bèdzjeredjes|'t bèdzjere	<i>verb</i><br><ol><li>to reconsider</li></ol>
bèlle|bèllendj|bèldje|gebèldje|bèller|bèllem|'t bèlle|höbbe gebèl|'t gebèl n|bèl|gebèldjes|gebèldjelik|bèlletj|tö bèlle|bèlle-n|gebèldjer|bèldje-n|bèl!|bèltj|bèldjes|bèlletj!|gebèldj|bèltj'r|bèltj!|bèls	<i>verb</i><br><ol><li>(intransitive) to ring, chime, like using a bell</li><li>(transitive) to call, to telephone</li></ol>
béï	<i>prep</i><br><ol><li>(Eupen) Alternative form of bie</li></ol>
bór	<i>noun</i><br><ol><li>(uncountable) boron</li><li>A part of boron</li></ol>
böëke	<i>verb</i><br><ol><li>(Eupen) to blubber, cry</li></ol>
chlór|ólleskes|ólleske|ölke|ölkes|óle|ól|óls|ólleser|ólles	<i>noun</i><br><ol><li>(uncountable) chlorine</li><li>A part of chlorine</li></ol>
chrille|'t gechril n|tö chrille|gechrildj|chrildje|gechrildjes|chriltj|chrillendj|chril|chriltj!|chrille-n|'t chrille|gechrildjelik|chrilletj!|chrildjes|gechrildje|chriltj'r|chrillem|chrilletj|chril!|höbbe gechril|chrildje-n|gechrildjer|chriller|chrils	<i>verb</i><br><ol><li>to grill</li></ol>
chrèlle|tö chrèlle|gechrèldjelik|chrèltj|chrèlle-n|chrèldje-n|gechrèldje|chrèltj'r|chrèls|chrèl|chrèlletj|chrèl!|chrèltj!|höbbe gechrèl|chrèllendj|'t gechrèl n|'t chrèlle|chrèllem|gechrèldj|chrèldje|chrèller|gechrèldjes|gechrèldjer|chrèlletj!|chrèldjes	<i>verb</i><br><ol><li>to grill</li></ol>
chróm	<i>noun</i><br><ol><li>(uncountable) chromium</li><li>A part of chromium</li></ol>
crappuul	<i>noun</i><br><ol><li>(Maastrichtian) rabble; riffraff</li></ol>
da	<i>adv</i><br><ol><li>(Eupen, local) there, yonder; here</li><li>(Eupen, temporal) then; so; at that moment</li></ol>
daag|dagem|taegskes|tagese|taag|dages|daag!|tageske|tagem|taegskem|tages|tage|daag|tageskes|daegskes|dageskes|daegsje|taags|daegske|dage|daegskem|taegske|daags|dagese|dageske|deëgske|deëgsje	<i>noun</i><br><ol><li>day (period of 24 hours)</li><li>daytime (time between sunrise and sunset)</li></ol><br><i>intj</i><br><ol><li>hello</li><li>goodbye</li></ol>
daak|taekeske|daaks|taekes|daekskes|taaks|taekese|taekskem|daekes|takem|taekeskes|take|daekese|taekskes|dake|daekeskes|dakem|daekske|daekeske|taak|taekske|daekskem	<i>noun</i><br><ol><li>roof</li><li>(mining) roof (The surface or bed of rock immediately overlying a bed of coal or a flat vein.)</li><li>(geology) a rock layer above a seam</li></ol>
dabbe|höbbe gedab|dabs|gedabdje|dabdje|gedab|'t dabbe|dabtj|dabtj!|dabber|'t gedab n|dabbem|dabbendj|dab!|gedabdjes|dabdjes|tö dabbe|dabbetj|dabdje-n|gedabdjelik|gedabdjer|dabbetj!|dab|dabbe-n	<i>verb</i><br><ol><li>(transitive) to scratch</li><li>(transitive, intransitive) to burrow</li><li>(reflexive) to scrape</li></ol>
dae	<i>pron</i><br><ol><li>(personal) he</li></ol>
dao	<i>adv</i><br><ol><li>there</li><li>for that reason</li></ol>
december	<i>noun</i><br><ol><li>December (month)</li></ol>
deer|dereskes|deerke|tereskes|derem|terese|derese|tere|dere|teerkem|tereske|teer|teerkes|deres|teers|teerke|deers|teres|terem|deerkem|deerkes|dereske	<i>noun</i><br><ol><li>pet</li><li>beast, animal</li></ol>
demmele|höbbe gedemmele|demmeletj|demmele!|gedemmeledjes|demmeledjes|demmeledje-n|demmeletj!|gedemmeledjelik|tö demmele|gedemmeledj|demmeletj'r|demmeler|demmelendj|demmeledje|gedemmeledjer|gedemmeledje|demmele-n|demmelem|demmeles|'t demmele|'t gedemmele n	<i>verb</i><br><ol><li>to trample/stamp on the ground while not moving to another place</li></ol>
denieëre|tö denieëre|denieëres|'t gedenieëre n|denieëretj!|denieërem|denieëredje-n|denieëre!|denieëre-n|gedenieëredjer|denieëredjes|gedenieëredj|denieëretj|denieërer|höbbe gedenieëre|denieërendj|denieëredje|gedenieëredjelik|denieëretj'r|gedenieëredje|gedenieëredjes|'t denieëre	<i>verb</i><br><ol><li>(transitive) to donate</li></ol>
der	<i>adv</i><br><ol><li>there</li></ol>
dieëw|dieëwkes|dieëreskes|tieëwke|dieërese|dieëwem|tieëreske|tieëwkem|dieëreske|tieëwe|tieëwkes|dieëres|tieëreskes|dieëwkem|tieëwem|tieërese|tieëws|tieëres|dieëws|tieëw|dieëwe|dieëwke	<i>noun</i><br><ol><li>mysterious man</li><li>mystery guest</li></ol>
disprosium|disprosieës|disprosieke|disprosia|disprosieëske|disprosiekes|disprosiums|disprosieëskes|disprosieëser|disprosiumme	<i>noun</i><br><ol><li>(uncountable) dysprosium</li><li>A part of dysprosium</li></ol>
do	<i>adv</i><br><ol><li>(Eupen, local) there, yonder</li><li>(Eupen, temporal) at that time (in the past); at the time, then</li><li>(Eupen) then, after that</li></ol>
doe|uch [əç]|veer|zich|heë|d'ch|ze|miener|det|e|miches|zie|v'r|'ch|ózzer|'t|m'r|mir|like dat. and acc.|ich|dir|de|hönnen|uch|'r|hön|hem|d'r|het|deë|dem|weet|m'ch|duur|ózzes|mich|dich|weer|die|vir|d'm|'m|miens|ós	<i>pron</i><br><ol><li>thou, you (singular)</li></ol>
donneere	<i>verb</i><br><ol><li>(Eupen, transitive) to donate</li></ol>
doon|höbbe gedaon|di-js|di-jje|doontj|doon!|doontj!|gedaoner|deitj|tö doon|gedaone|dooch!|'t doon|'t gedoons n|gedaon|daon|donendje|daontj'r|di-jtj|daonem|deis|dootj!|gedaones|daontj|gedäöndjelik|daons|deitj'r|daone|di-j	<i>verb</i><br><ol><li>to do</li></ol>
dou|do	<i>pron</i><br><ol><li>(Eupen, Krefeld) second-person singular, informal, nominative: you, thou</li></ol>
doëne|dönnt doëne|siëge gedoëne|diëchs|sowwe doëne|doëcht doëne|doëge doëne|woërs gedoëne|siëcht gedoëne|gedoëne|doënentääre|wäarde doëne|donne|donne doëne|so doëne|hass gedoëne|diëge|déïs doëne|hann gedoëne|hat gedoëne|siëch gedoëne|déïs|woërte gedoëne|hatt gedoëne|hotts gedoëne|doëge|woërt gedoëne|doëch doëne|wärrs doëne|doëchs doëne|siëchs gedoëne|doënend|sowwt doëne|doëchs|hannt gedoëne|diëcht|hoë gedoëne|diëch|wärrt doëne|déït|dööt doëne|hott gedoëne|dönnt|döüt|dööt|ho gedoëne|sowws doëne|döü|doëcht|doëch|déit doëne	<i>verb</i><br><ol><li>(Eupen) To do (to perform or execute an action).</li><li>(Eupen, with dative) To do something (positive or negative) to someone.</li><li>(Eupen, auxiliary) Used with the infinitive of a verb to form the present and past continuous tenses.</li><li>(Eupen, with “suë” or “äss off”) To fake; to feign; to pretend.</li><li>(Eupen) To put, to place, to add.</li><li>(Eupen, with “et” or “datt”) To work, to function.</li><li>(Eupen, colloquial) Used with the preceding infinitive of another verb to emphasise this verb</li><li>(Eupen, colloquial) Used with the following infinitive of another verb, often to emphasise the statement</li></ol>
dreen	<i>noun</i><br><ol><li>A drone; a male bee.</li></ol>
dróppel|dróppele|tróppel|tróppele|dróppelkem|tróppelke|tróppelese|dróppels|dróppeleskes|dróppelem|dróppelese|tróppels|tróppelkes|dróppeles|dróppelkes|tróppelkem|dróppelke|dróppeleske|tróppeleskes|tróppelem|tróppeleske|tróppeles	<i>noun</i><br><ol><li>drop, droplet</li></ol>
déë	<i>pron</i><br><ol><li>(Eupen) who; that; which</li><li>(attributive, stressed) that</li><li>(indicative) him, he</li><li>(differential) the one, him</li></ol>
dónnieëre|dónnieërendj|dónnieëre!|dónnieëres|'t dónnieëre|'t gedónnieëre n|dónnieëretj'r|höbbe gedónnieëre|dónnieëretj!|dónnieëredje|dónnieëredjes|tö dónnieëre|dónnieëretj|dónnieërer|gedónnieëredjes|dónnieëre-n|gedónnieëredjer|dónnieëredje-n|dónnieërem|gedónnieëredj|gedónnieëredjelik|gedónnieëredje	<i>verb</i><br><ol><li>(intransitive) to die</li></ol>
dönke|getönkedjer|gedóchtjelik|tönkes|dönk|'t gedönk n|dönkendje|gedóch|tönketj'r|tönks|tönkendj|dóch|dönks|tö tönke|tönketj!|tö dönke|duuch!|dönkem|tönkedje|dóchte|duutj!|tönke!|tönkedje-n|'t tönke|tönker|tönk|'t dönke|duuetj!|gedóchtje|'t getönke n|tönkem|gedóchtjer|tönke|gedóchtjes|tönketj|getönkedjes|getönkedj|dóchs|höbbe getönke|getönkedjelik|tönktj|höbbe gedóch|tönkedjes|tönke-n|getönkedje	<i>verb</i><br><ol><li>(transitive, intransitive) to appear, seem</li></ol>
effe	<i>adv</i><br><ol><li>shortly, as in "no problem"; briefly</li><li>for a short period, for a moment</li></ol><br><i>adj</i><br><ol><li>even, opposite of odd</li></ol>
ei	<i>noun</i><br><ol><li>egg</li></ol>
erbium|erbieës|erbieëske|erbieëser|erbieke|erbiumme|erbieëskes|erbiekes|erbia|erbiums	<i>noun</i><br><ol><li>(uncountable) erbium</li><li>A part of erbium</li></ol>
estósse|estós!|estósdjes|estós|estóssendj|estósse-n|geestós|tö estósse|'t geestós n|estóssetj!|geestósdje|geestósdjelik|geestósdjer|geestósdjes|'t estósse|estóstj|estóssetj|estósdje-n|höbbe geestós|estósdje|estóstj!|estóssem|estósser	<i>verb</i><br><ol><li>to misuse support</li><li>to misuse help</li></ol>
europium|europieëskes|europieëser|europia|europieëske|europiumme|europiekes|europieës|europieke|europiums	<i>noun</i><br><ol><li>(uncountable) europium</li><li>A part of europium</li></ol>
euver	<i>prep</i><br><ol><li>over</li><li>about</li><li>above</li></ol>
euverdoonder|vajereser|vajereske|vajeres|vajern|vajer|vajere|vajerke|vajers|vajereskes|vajerkes	<i>noun</i><br><ol><li>Someone whose feelings are very easily hurt, also by trivial matters, crybaby.</li></ol>
februari	<i>noun</i><br><ol><li>February (month)</li></ol>
fibberwarie	<i>noun</i><br><ol><li>February (month)</li></ol>
fluorien|appelsien	<i>noun</i><br><ol><li>(uncountable) fluorine</li><li>A part of fluorine</li></ol>
fosfór|ólleskes|ólleske|ölke|ölkes|óle|ól|óls|ólleser|ólles	<i>noun</i><br><ol><li>(uncountable) phosphorus</li><li>A part of phosphorus</li></ol>
fókke|fóktj|fóktj!|gefók|gefókdjelik|fókdje|fókketj|gefókdje|höbbe gefók|gefókdjes|fókkem|fók!|tö fókke|fókke-n|fók|fóks|fókketj!|fókdjes|fókdje-n|fókker|gefókdjer|'t fókke|'t gefók n|fókkendj	<i>verb</i><br><ol><li>to fish</li></ol>
fökke|höbbe gefök|fökdje-n|fökkendj|gefökdjes|föktj|fök!|'t gefök n|fökketj|föktj!|fökdje|fökdjes|gefökdjelik|fökkem|fök|gefökdjer|föks|gefök|fökketj!|fökker|fökke-n|'t fökke|gefökdje|tö fökke	<i>verb</i><br><ol><li>to breed</li></ol>
gadolinium|gadolinia|gadolinieëske|gadoliniums|gadolinieke|gadolinieëskes|gadoliniumme|gadolinieëser|gadolinieës|gadoliniekes	<i>noun</i><br><ol><li>(uncountable) gadolinium</li><li>A part of gadolinium</li></ol>
gallium|gallieëske|galliums|gallia|gallieke|galliumme|galliekes|gallieës|gallieëskes|gallieëser	<i>noun</i><br><ol><li>(uncountable) gallium</li><li>A part of gallium</li></ol>
gamin|gaminke|gamins	<i>noun</i><br><ol><li>(Maastrichtian, rare in some other dialects) rascal boy, an imp particularly inclined to mischief</li></ol>
gaon|gónk|ganks|gegäöndjelik|gaontj|gegange|geganger|gank!|gènk!|geitj'r|gank|góng|geganges|gäöndje|geis|'t gegaon n|höbbe gegange|geitj|tö gaon|gange|gaonem|gónge|'t gaon|gónks	<i>verb</i><br><ol><li>to go</li><li>to leave</li></ol>
geo|geoës|geëuke|geo|geoos|geoër|geëukes|geoëskes|'t geóws|geoëske|geóws|geo's|geówer|geoëser	<i>noun</i><br><ol><li>(mathematics, slang) set square</li><li>geography</li><li>(rare) geology</li></ol><br><i>adj</i><br><ol><li>(obsolete) strange</li></ol>
germanium|germanieëskes|germaniums|germaniumme|germania|germanieës|germanieke|germanieëske|germaniekes|germanieëser	<i>noun</i><br><ol><li>(uncountable) germanium</li><li>A part of germanium</li></ol>
get	<i>adv</i><br><ol><li>some, somewhat</li><li>very</li></ol><br><i>pron</i><br><ol><li>something, anything</li><li>(indefinite pronoun) Placed before a plural noun, indicating general cases of people or things: some</li></ol>
geó|geóws|'t geóws|geówer	<i>adj</i><br><ol><li>(obsolete) strange</li></ol>
gitaar|gitaeveser|gitaeveske|Gitaar|gitaeves|Gitaarke|gitaeveskes|gitare|Gitaare|gitaerke|gitaerkes	<i>noun</i><br><ol><li>guitar</li></ol>
gkrille|gkrils|gkril!|gegkrildj|gkriltj!|gegkrildjelik|gegkrildje|gkrilletj|höbbe gegkril|gkrilletj!|gkriltj'r|gegkrildjes|'t gkrille|gkrillendj|gkriltj|gkrildje|tö gkrille|'t gegkril n|gkrillem|gkrildjes|gkriller|gkrille-n|gkril|gkrildje-n|gegkrildjer	<i>verb</i><br><ol><li>to grill</li></ol>
gkrèlle|gkrèllendj|gegkrèldjelik|gkrèltj|'t gkrèlle|gkrèller|gegkrèldjes|gkrèl!|gkrèlle-n|gkrèl|gkrèlletj|gkrèltj!|gkrèltj'r|tö gkrèlle|gegkrèldjer|gegkrèldj|gkrèlletj!|gkrèllem|gkrèldje|gegkrèldje|gkrèldje-n|'t gegkrèl n|höbbe gegkrèl|gkrèldjes|gkrèls	<i>verb</i><br><ol><li>to grill</li></ol>
glee|glöjjer|gleeër|glöj|gleeke|gleekes|glöje|gleeërn|glöjkes|glöjke	<i>noun</i><br><ol><li>something that is wet because it has been pasted together</li></ol>
good|goojes|'t 't bès|gooje|goojen|goojer|baeter|goods|bès|gooj	<i>adj</i><br><ol><li>good</li></ol>
gott|béttste|go|béëter|gouwe	<i>adj</i><br><ol><li>(Eupen) good</li></ol>
goëne|soëch gegange|géngt|siëge gegange|sowwt goëne|woërs gegange|sowws goëne|sitt gegange|seet|wärrt goëne|gonne|doëge goëne|sänn|gegange|gönnt|gänge|seet gegange|sitt|déïs goëne|siëch gegange|soëchs gegange|géïs|siss gegange|gäng|donne goëne|gängs|doëcht goëne|goënend|déit goëne|sännt gegange|soëge gegange|siëcht gegange|siëchs gegange|gangk|wärrs goëne|doëch goëne|génge|dööt goëne|gööt|géït|wäarde goëne|géngs|géng|goënentääre|dönnt goëne|so goëne|doëchs goëne|sännt|sowwe goëne|soëcht gegange|gängt|woërte gegange|siss|sänn gegange|woërt gegange	<i>verb</i><br><ol><li>(Eupen, intransitive) to go</li><li>(Eupen, intransitive) to leave</li><li>(Eupen, intransitive) to leave, to take off (of an aeroplane, train)</li><li>(Eupen, impersonal, intransitive) to be going; to be all right; indicates how the dative object fares</li><li>(Eupen, intransitive) to be possible</li><li>(Eupen, colloquial, intransitive) to work, to function (of a machine, method or the like)</li><li>(Eupen, colloquial, auxiliary) Forms the future tense of a verb, similarly to English going to future tense</li></ol>
graat	<i>adj</i><br><ol><li>(Eupen, of a number) even</li></ol><br><i>adv</i><br><ol><li>just, a short while ago</li><li>exactly</li><li>expresses the continuous aspect</li></ol>
grille|'t grille|grille-n|gril!|gril|gegrildje|grillem|grildje-n|griltj!|'t gegril n|grilletj!|höbbe gegril|griltj'r|gegrildjelik|gegrildj|grils|grildjes|gegrildjes|griltj|grilletj|griller|tö grille|grillendj|grildje|gegrildjer	<i>verb</i><br><ol><li>to grill</li></ol>
gruuedje	<i>noun</i><br><ol><li>size</li></ol>
grèlle|grèltj'r|grèllem|grèllendj|grèldje-n|grèl|gegrèldjes|grèlletj|'t gegrèl n|tö grèlle|'t grèlle|höbbe gegrèl|grèltj!|grèlletj!|grèls|grèldjes|gegrèldjelik|grèldje|grèl!|gegrèldjer|grèltj|gegrèldj|grèlle-n|gegrèldje|grèller	<i>verb</i><br><ol><li>to grill</li></ol>
grómme|grómmetj|grómmem|'t gegróm n|grómdje-n|grómme-n|grómmendj|gróm|grómtj|grómmer|gegrómp|gróms|grómp!|'t grómme|höbbe gegrómp|tö grómme|gegrómpdje|gegrómpdjelik|grómp|gróm!|grómdje|grómdjes|gegrómpdjer|gegrómpdjes|grómmetj!	<i>verb</i><br><ol><li>to growl</li></ol>
gätt	<i>adv</i><br><ol><li>(Eupen) some, somewhat</li><li>(Eupen) very</li></ol><br><i>pron</i><br><ol><li>(Eupen) something, anything</li><li>(Eupen, indefinite pronoun) Placed before a plural noun, indicating general cases of people or things: some</li></ol>
gód|gódder|góddem|gödjes|góddemske|gode|góddemsker|góddes|góddesker|góddeser|God!|góds|góddeske|Gode!|gödje|gódde	<i>noun</i><br><ol><li>god</li></ol>
góldj	<i>noun</i><br><ol><li>(uncountable) gold</li><li>A part of gold</li></ol>
haane|hann gehatt|déit haane|woërt gehatt|hott|dööt haane|hotts|wäarde haane|hétt|hätts|siëcht gehatt|hétts|hat|doëcht haane|woërte gehatt|hätt|wärrt haane|hass gehatt|hott gehatt|doëch haane|woërs gehatt|hä|hotts gehatt|héë|ha|déïs haane|hat gehatt|haanend|siëchs gehatt|wärrs haane|doëchs haane|hann|sowwe haane|hass|hé|doëge haane|hannt|ho|hatt|hoë|sowws haane|siëge gehatt|donne haane|dönnt haane|hatt gehatt|hanne|gehatt|ho gehatt|hoë gehatt|hannt gehatt|häë|so haane|siëch gehatt|sowwt haane|haanentääre	<i>verb</i><br><ol><li>(Eupen, auxiliary, with a past participle) to have (forms the perfect and past perfect tense)</li><li>(Eupen, transitive) to have; to own</li><li>(Eupen, transitive) to have; to hold</li><li>(Eupen, transitive) to have (to be afflicted with, suffer from)</li><li>(Eupen, transitive) to have (to be scheduled to attend)</li><li>(Eupen, transitive, of units of measure) to contain, be composed of, equal</li><li>(Eupen, impersonal, with et) there be, there is, there are</li><li>(Eupen, colloquial, with et and métt) to be occupied with, to like, to be into</li></ol>
hae	<i>pron</i><br><ol><li>Third-person singular, masculine, subjective: he.</li></ol>
hae vertroewtj zich wie eint haes	<i>proverb</i><br><ol><li>(figuratively) he is very reliable, he can be trusted</li></ol>
hafnium|hafniekes|hafnieëskes|hafniums|hafnieëser|hafnia|hafnieëske|hafniumme|hafnieke|hafnieës	<i>noun</i><br><ol><li>(uncountable) hafnium</li><li>A part of hafnium</li></ol>
hajje	<i>intj</i><br><ol><li>see you soon, farewell, goodbye</li></ol>
hand|hendje|hande|endese|endes|endj|hendj|endjer|endjes|endeske|hendjer|ande|hendeske|hendese|hendjem|endeskes|hendeskes|hendjes|and|endje|hendes|endjem	<i>noun</i><br><ol><li>(anatomy, common variant) A hand</li></ol>
haundert|haundertste	<i>num</i><br><ol><li>(Eupen, cardinal number) one hundred</li></ol>
heim|eim|eivese|heiveskes|heimke|eimkes|heims|heimer|eiveske|eives|heimkes|heivese|eims|eimer|eimkem|eimke|heives|heiveske|eimem|eiveskes|heimem|heimkem	<i>noun</i><br><ol><li>home</li><li>house</li></ol>
heives|'t heives|heiveser|heiveses|heivesen|heivese	<i>adj</i><br><ol><li>cosy</li></ol>
heivese|geheivesedje|heivese!|heivesetj!|geheivesedjer|höbbe geheivese|heiveser|'t geheivese n|geheivese|heivesetj|tö heivese|heivesem|geheivesedjes|heiveses|heivesendj|'t heivese|heivesedje-n|heivesedje|heivese-n|geheivesedjelik|heivesedjes	<i>verb</i><br><ol><li>to go home</li></ol>
hel|ellem|helle|elles|hellem|elke|elkes|helkem|hels|helder|hellese|elleske|helke|helleskes|'t hèls|els|ellese|elleskes|ellkes|hellkes|el|helkes|hellen|heller|helles|helleske|elkem|hells|elle	<i>noun</i><br><ol><li>hell</li><li>(figuratively) a bad place to be</li></ol><br><i>adj</i><br><ol><li>hard, tough, difficult</li><li>hard, rough, pointed</li><li>hard, heavy</li><li>hard, solid</li><li>loud</li></ol>
helium|heliumme|helia|helieëser|helieëske|heliums|helieës|helieëskes|heliekes|helieke	<i>noun</i><br><ol><li>(uncountable) helium</li><li>A part of helium</li></ol>
helle|helder|hells|hellen|'t hèls|heller|helles	<i>adj</i><br><ol><li>hard</li><li>loud</li></ol>
hiedrogenium|hiedrogenia|hiedrogenieëser|hiedrogenieëske|hiedrogenieke|hiedrogeniumme|hiedrogeniekes|hiedrogenieës|hiedrogeniums|hiedrogenieëskes	<i>noun</i><br><ol><li>(uncountable) hydrogen</li><li>A part of hydrogen</li></ol>
hieër|hieërkes|hieëveske|hieëves|hieëre|hieëveskes|her!|hieërke|hieëveser|hieëvemske|hieëvemskes|her|hieërs|herre!|hieëvem	<i>noun</i><br><ol><li>mister, man</li><li>Lord, God</li></ol>
hit|hitteskes|hittes|hitje|hitjes|hitteser|hitteske|hits	<i>noun</i><br><ol><li>(slang, Dutch) something popular (book, song, band, country)</li></ol>
hoes|huuskes|heivemskes|hoezes|hoeze|hoezeser|heiveskes|heiveser|heivemske|hoes|hoezern|heiveske|huuske|heives|hoezer	<i>noun</i><br><ol><li>house</li><li>home</li><li>building</li><li>cover</li></ol>
hoesige|'t hoesige|hoesigedjes|hoesige-n|hoesigendj|hoesigedje-n|gehoesige|tö hoesige|höbbe gehoesige|hoesigetj|hoesigetj!|'t gehoesige n|hoesige!|hoesigem|gehoesigedje|hoesiger|gehoesigedjelik|gehoesigedjes|hoesigedje|hoesiges|gehoesigedjer	<i>verb</i><br><ol><li>(East Limburgish, Southeast Limburgish) to provide a place to sleep/live</li></ol>
holmium|holmieëske|holmieëser|holmiums|holmieke|holmieëskes|holmiumme|holmieës|holmia|holmiekes	<i>noun</i><br><ol><li>(uncountable) holmium</li><li>A part of holmium</li></ol>
hoof	<i>noun</i><br><ol><li>garden (an outdoor area containing one or more types of plants)</li></ol>
huif|huive	<i>noun</i><br><ol><li>(Maastrichtian) marble (a small spherical ball of rock or glass used in children's games)</li></ol>
huusege|gehuuzecht|huusecht|huuzegde	<i>verb</i><br><ol><li>(Eupen) to house</li></ol>
häöm	<i>pron</i><br><ol><li>(Maastrichtian, Sittard, Valkenburg, Voeren, personal) Third-person singular, masculine, objective: him.</li></ol>
häör	<i>pron</i><br><ol><li>(personal) (widespread variant) Third-person singular, feminine, objective: her.</li></ol>
hèt|'n|uch [əç]|veer|zich|heë|d'ch|ze|miener|det|e|miches|dem zien|zie|v'r|'ch|doe|dies|ózzer|'t|m'r|mir|like dat. and acc.|ich|dir|de|dier|den|hönnen|dien|zee|'r|uch|hön|daer|hem|d'r|het|deë|dems|dem|weet|m'ch|ózzes|duur|mich|dich|weer|die|vir|daes|d'm|'m|miens|ós	<i>pron</i><br><ol><li>(personal) she.</li></ol>
héll|hélle|héllst	<i>adj</i><br><ol><li>(Eupen) hard</li><li>(Eupen) loud</li><li>(Eupen) clear, bright, light</li></ol>
héë|höëm	<i>pron</i><br><ol><li>(Eupen, personal) he.</li><li>(Eupen, personal) it (when the grammatical gender of the object/article/thing/animal etc., being referred to, is masculine (déë)).</li><li>(Eupen, personal) she (when the grammatical gender of the noun being referred to and designating a female person, is masculine (déë)).</li></ol>
héïvesche|héïvescht|houvesch|gehëïvesche	<i>verb</i><br><ol><li>(Eupen) to go home</li></ol>
hóndj	<i>noun</i><br><ol><li>(widespread variant) dog</li></ol>
hóngert	<i>num</i><br><ol><li>hundred</li></ol>
hóngertj	<i>noun</i><br><ol><li>hundred</li><li>(colloquial, slang) A €100 note</li></ol>
höbbe	<i>verb</i><br><ol><li>(Central Limburgish, East Limburgish) to have</li></ol>
ich|weet|ózzes|miens|veer|ózzer|mich|miener|weer|mir|miches|v'r|'ch|ós	<i>pron</i><br><ol><li>I</li></ol>
iew|iewe	<i>noun</i><br><ol><li>(Maastrichtian) century</li></ol>
iezer|iezers	<i>noun</i><br><ol><li>(uncountable) iron</li><li>A part of iron</li></ol>
ieëre|geieëredj|ieëretj|ieëredjes|'t ieëre|'t geieëre n|ieëretj'r|ieëre-n|geieëredje|tö ieëre|geieëredjelik|höbbe geieëre|ieëre!|ieërer|ieëredje-n|ieëres|geieëredjes|ieëretj!|geieëredjer|ieëredje|ieërendj|ieërem	<i>verb</i><br><ol><li>to honour</li></ol>
iich	<i>pron</i><br><ol><li>(Eupen) I (first person singular nominative (subject) pronoun)</li></ol>
iire|iirde|iirt|geiirt	<i>verb</i><br><ol><li>(Eupen) to honor</li></ol>
impassant	<i>adv</i><br><ol><li>(Maastrichtian) in passing</li></ol>
indium|indiumme|indiekes|india|indieës|indieëser|indieëske|indieke|indiums|indieëskes	<i>noun</i><br><ol><li>(uncountable) indium</li><li>A part of indium</li></ol>
integer|integerder|'t integers|integeren|integers|integere|integerer|integeres	<i>adj</i><br><ol><li>friendly</li><li>complete, whole, intact</li></ol>
iridium|iridia|iridieës|iridiekes|iridieke|iridieëske|iridiums|iridieëskes|iridiumme|iridieëser	<i>noun</i><br><ol><li>(uncountable) iridium</li><li>A part of iridium</li></ol>
itrium|itriums|itriekes|itria|itrieës|itrieëskes|itrieëske|itrieke|itrieëser|itriumme	<i>noun</i><br><ol><li>(uncountable) yttrium</li><li>A part of yttrium</li></ol>
itterbium|itterbiekes|itterbieke|itterbieëske|itterbiumme|itterbiums|itterbieës|itterbieëser|itterbia|itterbieëskes	<i>noun</i><br><ol><li>(uncountable) ytterbium</li><li>A part of ytterbium</li></ol>
jannewarie	<i>noun</i><br><ol><li>January</li></ol>
januari	<i>noun</i><br><ol><li>January (month)</li></ol>
jao	<i>intj</i><br><ol><li>yes</li></ol><br><i>adv</i><br><ol><li>of course; after all; as you know; modal particle used like German ja, which compare</li></ol>
jaor	<i>noun</i><br><ol><li>year</li></ol>
jeppe	<i>verb</i><br><ol><li>(dialectal) To drink alcohol, to consume alcoholic beverages.</li></ol>
jodium|jodieëske|jodiumme|jodiekes|jodiums|jodieës|jodieëser|jodieke|jodieëskes|jodia	<i>noun</i><br><ol><li>(uncountable) iodine</li><li>A part of iodine</li></ol>
jong|jonges	<i>adj</i><br><ol><li>(widespread variant) young</li></ol><br><i>noun</i><br><ol><li>boy, young guy</li><li>(colloquial, Maastrichtian) a colloquial term of address for a man, along the lines of e.g. mate</li><li>A young: a young being, especially an animal.</li></ol>
jonk|jungske|jonger|jönger|jong|jongste|jonge|jonges	<i>adj</i><br><ol><li>(Southeast Limburgish, including Eupen) young</li></ol><br><i>noun</i><br><ol><li>(Southeast Limburgish, uncommon) boy, young guy</li><li>(Southeast Limburgish) A young: a young being, especially an animal.</li></ol>
joë	<i>adv</i><br><ol><li>(Eupen) yes; yea, yeah, aye</li><li>(Eupen, intensifier) obviously; certainly; of course; really; just; as you know; as is generally known (indicates and emphasises that one is expressing a known fact)</li></ol><br><i>intj</i><br><ol><li>(Eupen) yes</li></ol>
juli	<i>name</i><br><ol><li>July (month)</li></ol>
juni	<i>noun</i><br><ol><li>June (month)</li></ol>
jómme|jóm|gejómpdjelik|höbbe gejómp|'t gejóm n|jómp|jóms|jómme-n|jóm!|gejómp|gejómpdje|jómdje|jómmem|jómmetj!|jómtj|'t jómme|jómdjes|jómmer|gejómpdjes|gejómpdjer|jómmetj|jómp!|jómmendj|jómdje-n|tö jómme	<i>verb</i><br><ol><li>to be patient while waiting</li></ol>
kaajd|kaajdes|kaajden|kaajde|kaajder|kaajds	<i>adj</i><br><ol><li>(Maastricht) cold, chilly, frigid</li></ol>
kadmium|kadmieës|kadmia|kadmiekes|kadmieëskes|kadmieke|kadmieëser|kadmiumme|kadmiums|kadmieëske	<i>noun</i><br><ol><li>(uncountable) cadmium</li><li>A part of cadmium</li></ol>
kalbas|kalbasse	<i>noun</i><br><ol><li>(Maastrichtian) bag</li></ol>
kalium|kalieëskes|kaliekes|kalia|kaliums|kalieëske|kalieke|kalieëser|kalieës|kaliumme	<i>noun</i><br><ol><li>(uncountable) potassium</li><li>a part of potassium</li></ol>
kalle|kallendj|gekaldj|'t kalle|kaldjes|kaltj|kals|kal|gekaldjelik|gekaldjer|'t gekal n|kaller|kallem|kalletj!|tö kalle|höbbe gekal|kalletj|kaltj!|kalle-n|kal!|gekaldje|gekaldjes|kaltj'r|kaldje|kaldje-n	<i>verb</i><br><ol><li>(widespread variant) to talk, to speak, to chat</li><li>(widespread variant, obsolete) to call</li><li>(widespread variant, obsolete) to give a name to</li></ol>
kalsium|kalsieëske|kalsiums|kalsieëser|kalsiekes|kalsia|kalsieke|kalsieëskes|kalsiumme|kalsieës	<i>noun</i><br><ol><li>(uncountable) calcium</li><li>A part of calcium</li></ol>
kaoke|gekaoke|tö kaoke|kaokedjes|kaoketj!|gekaokedjer|höbbe gekaoke|kaoker|kaokendj|kaoke-n|kaokem|gekaokedjelik|kaokedje|gekaokedjes|kaokedje-n|kaoketj|kaoke!|'t gekaoke n|kaokes|gekaokedje|'t kaoke	<i>verb</i><br><ol><li>to cook</li><li>to boil</li></ol>
kaoper	<i>noun</i><br><ol><li>(uncountable) copper</li><li>A part of copper</li></ol>
kauche|kaucht|kaugde|gekaucht	<i>verb</i><br><ol><li>(Eupen, intransitive, of a person) to cook, to prepare food (chiefly hot food for lunch or supper)</li><li>(intransitive, of a liquid) (to reach the boiling point)</li><li>(transitive) (to heat a liquid until it boils)</li><li>(transitive) (to prepare something in such a liquid)</li></ol>
kaut|kottste|koue|kauer|kou	<i>adj</i><br><ol><li>(Eupen) cold, chilly; the physical perception of something (objects, weather, body etc.) to have a low temperature</li><li>(Eupen) cold, frigid (especially when referring to emotions)</li></ol>
kebónnium|kebónnieëskes|kebónniumme|kebónnia|kebónniekes|kebónnieëser|kebónnieës|kebónnieëske|kebónniums|kebónnieke	<i>noun</i><br><ol><li>(uncountable) carbon</li><li>A part of carbon</li></ol>
kemissie|kemissies	<i>noun</i><br><ol><li>(widespread variant) groceries, shopping</li></ol>
kiksjozerij|kiksjozerije	<i>noun</i><br><ol><li>(Maastrichtian) knickknack, stuff, trifle</li></ol>
kindj|kienjerkes|kienjer|kiendje|kiendjes|kinsj|kienjers|kinjer|kienjerke|kinjern	<i>noun</i><br><ol><li>child</li><li>baby</li><li>somebody one loves</li></ol>
klang	<i>noun</i><br><ol><li>temptation</li></ol>
klein|kleins|kleine|kleiner|'t kleins|kleines|kleinen	<i>adj</i><br><ol><li>small</li></ol>
klämme|klämmde|klämmt|geklämmt|klämmp	<i>verb</i><br><ol><li>(Eupen, transitive) to jam, to clamp (make something stuck in a tight place)</li><li>(Eupen, intransitive) to be jammed, to be stuck</li></ol>
klèmme|geklèmpdjer|geklèmpdjelik|geklèmp|klèmmer|klèm|klèmp|klèmdje|höbbe geklèmp|klèmdjes|klèmmem|klèmmendj|klèmme-n|klèmmetj|'t geklèm n|tö klèmme|'t klèmme|klèms|geklèmpdje|klèmp!|klèmmetj!|geklèmpdjes|klèmdje-n|klèmtj|klèm!	<i>verb</i><br><ol><li>to trap, hold between to or more</li></ol>
kléïn|kléïne|kléï|klännder|klännste	<i>adj</i><br><ol><li>(Eupen) small, little, tiny, wee, small-scale</li><li>(Eupen) little, young (in age)</li><li>(Eupen) insignificant</li></ol>
klömme|klom|klömt|geklomme|klomm|klömmt|klömp	<i>verb</i><br><ol><li>(widespread, intransitive) to climb</li></ol>
knagge|knagtj!|tö knagge|knagge-n|geknag|knaggendj|knagdjes|knags|knagdje|'t geknag n|geknagdjes|geknagdje|'t knagge|knaggetj|höbbe geknag|knag!|knagdje-n|knagtj|geknagdjer|knaggetj!|geknagdjelik|knagger|knaggem|knag	<i>verb</i><br><ol><li>to do something wrong</li></ol>
knèlle|knèltj|knèltj!|knèllendj|knèldjes|knèller|tö knèlle|'t geknèl n|knèlletj!|knèllem|knèls|knèlle-n|knèl!|geknèldj|knèltj'r|knèldje|knèl|geknèldjer|geknèldjes|knèldje-n|höbbe geknèl|'t knèlle|knèlletj|geknèldje|geknèldjelik	<i>verb</i><br><ol><li>to pinch, squeeze, press</li></ol>
kobalt	<i>noun</i><br><ol><li>(uncountable) The metallic element and material cobalt</li><li>A part of cobalt</li></ol>
konntakkteere|konntakkteert|konntakkteerde|gekonntakkteert	<i>verb</i><br><ol><li>(Eupen, transitive) to contact (establish communication with)</li></ol>
krieëk|krieëches|krieëker|krieëks|krieëkske|krieëkskes|krieëcheser|krieëkern|krieëchem	<i>noun</i><br><ol><li>creek</li></ol>
kripton	<i>noun</i><br><ol><li>(uncountable) krypton</li><li>A part of krypton</li></ol>
krissie	<i>noun</i><br><ol><li>(Maastrichtian) liquorice</li></ol>
krolle|kröllt|gekrollt|krollde	<i>verb</i><br><ol><li>(Eupen, transitive) to curl</li></ol>
królle|króltj'r|króls|królletj!|gekróldj|gekróldje|gekróldjes|króltj!|króllem|'t gekról n|króldje-n|gekróldjelik|tö królle|króldje|króller|królle-n|króltj|królletj|król|'t królle|höbbe gekról|król!|króllendj|króldjes|gekróldjer	<i>verb</i><br><ol><li>to curl</li></ol>
krömme|gekrömpdjer|krömmendj|krömdje|gekrömp|'t krömme|gekrömpdjes|krömp|krömp!|krömdjes|krömtj|'t gekröm n|krömmetj!|krömme-n|krömmetj|krömmer|kröm!|kröm|krömdje-n|höbbe gekrömp|kröms|tö krömme|gekrömpdje|krömmem|gekrömpdjelik	<i>verb</i><br><ol><li>(obsolete) to growl</li></ol>
ksenon	<i>noun</i><br><ol><li>(uncountable) xenon</li><li>A part of xenon</li></ol>
kwik	<i>noun</i><br><ol><li>(uncountable) mercury</li><li>A part of mercury</li></ol>
kwääle|kwäält|gekwäält|kwäälde	<i>verb</i><br><ol><li>(Eupen, transitive) to torture, to torment, to agonize</li><li>(Eupen, transitive) to cause sorrow, to upset, to worry</li><li>(Eupen, transitive) to harass, to bother</li><li>(Eupen, reflexive) to toil, to struggle</li></ol>
kwèlle|kwèl!|kwèldje|kwèldje-n|'t gekwèl n|gekwèldje|kwèllem|kwèldjes|kwèlletj|gekwèldj|'t kwèlle|kwèlletj!|tö kwèlle|kwèltj|kwèltj'r|kwèls|kwèllendj|gekwèldjer|kwèller|kwèltj!|gekwèldjes|gekwèldjelik|kwèlle-n|kwèl|höbbe gekwèl	<i>verb</i><br><ol><li>to hurt</li><li>to torture</li></ol>
kèlle|kèls|gekèldj|kèldje-n|kèlle-n|tö kèlle|kèlletj!|kèltj!|kèllendj|kèldje|kèltj|kèller|'t gekèl n|kèl|kèltj'r|gekèldjelik|gekèldje|kèldjes|kèlletj|kèl!|'t kèlle|gekèldjes|höbbe gekèl|kèllem|gekèldjer	<i>verb</i><br><ol><li>to not show any emotions</li><li>to be emotionless</li></ol>
kóllèsse|kóllèssem|kóllèsser|kóllèstj|kóllèsdje-n|gekóllèsdjes|gekóllès|gekóllèsdje|gekóllèsdjer|gekóllèsdjelik|kóllèsdjes|kóllèstj!|kóllèssetj|'t gekóllès n|kóllèssendj|kóllès|kóllèssetj!|kóllès!|kóllèsdje|kóllèsse-n|höbbe gekóllès|tö kóllèsse|'t kóllèsse	<i>verb</i><br><ol><li>to cheat</li></ol>
kóntaktieëre|kóntaktieëre!|kóntaktieëre-n|kóntaktieëredje|kóntaktieëres|gekóntaktieëredjer|kóntaktieëredjes|gekóntaktieëredje|'t kóntaktieëre|gekóntaktieëredjelik|'t gekóntaktieëre n|kóntaktieëretj|kóntaktieëredje-n|höbbe gekóntaktieëre|kóntaktieërendj|kóntaktieërem|kóntaktieërer|kóntaktieëretj'r|tö kóntaktieëre|kóntaktieëretj!|gekóntaktieëredj|gekóntaktieëredjes	<i>verb</i><br><ol><li>to contact</li></ol>
köppe|köppt|geköpd|köpt|köbbde|geköppt|köpde	<i>verb</i><br><ol><li>(widespread, including Eupen, soccer, transitive) to place a ball in the goal using your head</li><li>(Eupen, transitive) to behead, to decapitate</li></ol>
kösse|kössetj!|gekösdje|'t kösse|gekös|kösdje-n|kösser|kössem|kös|gekösdjer|kössetj|kösdje|höbbe gekös|kösdjes|kös!|'t gekös n|kösse-n|köstj|köstj!|gekösdjes|gekösdjelik|tö kösse|kössendj	<i>verb</i><br><ol><li>to kiss</li></ol>
laeg|laege|laegs|laegen|'t laegs|laeger|laeges|laegder	<i>adj</i><br><ol><li>empty</li><li>dry</li><li>dead</li></ol>
laeke|gelaekedjes|laekedjes|laekem|'t laeke|laeketj!|laekendj|laeketj|laeke-n|tö laeke|gelaekedje|höbbe gelaeke|laekedje-n|gelaekedjelik|laeke!|laeker|gelaeke|'t gelaeke n|laekedje|gelaekedjer|laekes	<i>verb</i><br><ol><li>to leak</li></ol>
landj|lenjer	<i>noun</i><br><ol><li>country, land</li></ol>
landjsval	<i>noun</i><br><ol><li>(grammar) locative</li><li>fall of a country/empire</li></ol>
lanteriemenneke|lanteriemennekes	<i>noun</i><br><ol><li>(Maastrichtian) lanternlighter (a person who, before the advent of electric lighting, would light street lanterns in the evening)</li></ol>
lanthanum|lanthaneëskes|lanthanums|lanthanumme|lanthanekes|lanthaneke|lanthaneëser|lanthana|lanthaneëske|lanthaneës	<i>noun</i><br><ol><li>(uncountable) lanthanum</li><li>A part of lanthanum</li></ol>
lavvabo	<i>noun</i><br><ol><li>(Maastrichtian) lavabo, washbasin</li></ol>
leuze	<i>verb</i><br><ol><li>(Maastrichtian) to read</li></ol>
lieje|lietj!|liejer|liej|leetj|geleejes|geleeje|lietj'r|leeje|'t lieje|lieëtj|lietsj|liej!|leej|geleejer|lieëm|geleejelik|lieje-n|höbbe geleeje|tö lieje|liejendj|lieëtj!|'t geliej n|leejs|lietj	<i>verb</i><br><ol><li>to suffer</li></ol>
lies	<i>noun</i><br><ol><li>(widespread) list</li></ol>
lijje|litt|geléë|geléëge|léët|liit|loëch	<i>verb</i><br><ol><li>(Eupen, intransitive) to lie (to be in a horizontal position)</li><li>(Eupen, intransitive) to be located, to lie somewhere (of countries, towns, houses, etc.)</li><li>(Eupen, intransitive) to suffer, to experience pain, sorrow, etc.</li><li>(Eupen, transitive) to suffer, bear, endure, undergo, experience (some hardship)</li><li>(Eupen) to suffer from (a disease or condition) [+ aan (object)]</li></ol>
litium|litiumme|litiums|litiekes|litieës|litieëskes|litieëser|litieëske|litia|litieke	<i>noun</i><br><ol><li>(uncountable) lithium</li><li>A part of lithium</li></ol>
loead	<i>noun</i><br><ol><li>(uncountable) lead</li><li>A part of lead</li></ol>
lutetium|lutetieke|lutetia|lutetiekes|lutetieëskes|lutetieëser|lutetieëske|lutetieës|lutetiumme|lutetiums	<i>noun</i><br><ol><li>(uncountable) lutetium</li><li>a part of lutetium</li></ol>
läkke|läggde|läkkt|geläkkt	<i>verb</i><br><ol><li>(Eupen, transitive) to leak, illicitly release information</li><li>(Eupen, intransitive) to leak, to seep</li><li>(Eupen, transitive or intransitive) to lick</li></ol>
lègke	<i>verb</i><br><ol><li>(Maastrichtian) to lay</li></ol>
lèttergreep|lèttergreeps|lèttergreepeser|lèttergreepn|lèttergreepkes|lèttergreepke|lèttergreepe|lèttergreepes|lèttergrepe	<i>noun</i><br><ol><li>syllable</li></ol>
lèèje|lèèje-n|lèèjedje|'t lèèje|höbbe gelèèje|gelèèjedjer|lèèjedje-n|lèèjetj!|lèèjedjes|lèèjem|lèèjetj'r|lèèjetj|lèèje!|gelèèjedje|gelèèjedjes|'t gelèèje n|gelèèjedj|gelèèjedjelik|lèèjes|lèèjendj|lèèjer|tö lèèje	<i>verb</i><br><ol><li>to lead</li></ol>
léëch|léëge|léëchst|léëger	<i>adj</i><br><ol><li>(Eupen) empty</li></ol>
léëse|geléëse|lous|lösst	<i>verb</i><br><ol><li>(Eupen, transitive or intransitive) to read (look at and understand symbols, words, or data)</li></ol>
lösse|lösdje-n|löstj|'t lösse|gelösdjer|'t gelös n|gelösdje|gelösdjes|gelös|lössendj|lösse-n|löstj!|lössem|tö lösse|lösdjes|lös!|höbbe gelös|lösser|lössetj!|gelösdjelik|lösdje|lös|lössetj	<i>verb</i><br><ol><li>to knot</li><li>to practice agriculture on loess ground</li></ol>
magnesium|magnesia|magnesieëser|magnesieës|magnesiumme|magnesiums|magnesiekes|magnesieëske|magnesieëskes|magnesieke	<i>noun</i><br><ol><li>(uncountable) magnesium</li><li>A part of magnesium</li></ol>
male|gemaledjelik|gemaledj|male-n|maledje-n|males|maledje|maledjes|tö male|malendj|maletj!|maler|höbbe gemale|malem|male!|gemaledje|'t gemale n|gemaledjes|'t male|gemaledjer|maletj|maletj'r	<i>verb</i><br><ol><li>To mill.</li></ol>
manganium|mangania|manganieëske|manganiumme|manganiums|manganieëser|manganieës|manganiekes|manganieëskes|manganieke	<i>noun</i><br><ol><li>(uncountable) manganese</li><li>A part of manganese</li></ol>
manzjare|manzjaredjes|manzjaredje|manzjaretj'r|gemanzjaredjes|gemanzjaredje|manzjaredje-n|gemanzjaredj|manzjarer|manzjarendj|gemanzjaredjelik|höbbe gemanzjare|manzjare-n|manzjarem|manzjaretj|manzjare!|manzjaretj!|tö manzjare|manzjares|'t manzjare|'t gemanzjare n|gemanzjaredjer	<i>verb</i><br><ol><li>to eat a lot</li></ol>
maole|höbbe gemaole|'t gemaole n|gemaoledje|maoletj!|gemaoledjelik|maolendj|maoledje-n|'t maole|gemaoledj|maole-n|gemaoledjes|maoledje|maole!|maoledjes|maoler|tö maole|maoletj|maoletj'r|gemaoledjer|maolem|maoles	<i>verb</i><br><ol><li>to paint</li></ol>
maon|maone	<i>noun</i><br><ol><li>moon</li></ol>
mei	<i>noun</i><br><ol><li>May (month)</li></ol>
meug|meuger|meuges|meugen|meugs|'t meugs|meuge	<i>adj</i><br><ol><li>tired</li><li>enough</li><li>too much</li></ol>
meugelik|meugelikker|meugeliks|'t meugeliks	<i>adj</i><br><ol><li>tired</li><li>enough</li><li>too much</li><li>possible</li></ol><br><i>adv</i><br><ol><li>possibly</li></ol>
meule|meul|meulerskes|meules|meulke|meuler|meulers|meulerske|meulerse|meulkes	<i>noun</i><br><ol><li>mill</li></ol>
miert	<i>noun</i><br><ol><li>March (month)</li></ol>
mieëvórm	<i>noun</i><br><ol><li>comparative</li></ol>
moder|modereske|meuderke|modereskes|meuderkes|moders|modereser|moderes	<i>noun</i><br><ol><li>mother</li><li>guardian</li><li>nun</li><li>woman</li></ol>
moes|muuske|muus	<i>noun</i><br><ol><li>mouse</li></ol>
mofers|moferser|moferse|'t mofers|mofersen|moferses	<i>adj</i><br><ol><li>belonging to the city Montfort</li></ol>
mojertaal	<i>noun</i><br><ol><li>(linguistics) mother tongue</li></ol>
molibdenum|molibdeneëskes|molibdenumme|molibdeneës|molibdeneëser|molibdeneke|molibdenums|molibdena|molibdenekes|molibdeneëske	<i>noun</i><br><ol><li>(uncountable) molybdenum</li><li>A part of molybdenum</li></ol>
móndjwater	<i>noun</i><br><ol><li>mouth wash</li></ol>
mölle|gemöldjelik|'t gemöl n|tö mölle|gemöldjer|möltj|gemöldje|gemöldj|möls|möllendj|möldje-n|möltj'r|höbbe gemöl|möldjes|mölle-n|mölletj!|möl|gemöldjes|möltj!|'t mölle|mölletj|möl!|möller|möldje|möllem	<i>verb</i><br><ol><li>to mill</li></ol>
naomswaord	<i>noun</i><br><ol><li>(grammar) noun</li></ol>
naoventrint	<i>adv</i><br><ol><li>(Maastrichtian) about, roughly, approximately</li></ol>
natrium|natriumme|natrieke|natrieëske|natria|natrieës|natrieëser|natriekes|natrieëskes|natriums	<i>noun</i><br><ol><li>(uncountable) sodium</li><li>A part of sodium</li></ol>
neodimium|neodimieëser|neodimieëskes|neodimieke|neodimieëske|neodimieës|neodimiumme|neodimiums|neodimia|neodimiekes	<i>noun</i><br><ol><li>(uncountable) neodymium</li><li>A part of neodymium</li></ol>
neon	<i>noun</i><br><ol><li>(uncountable) neon</li><li>A part of neon</li></ol>
nietrogenium|nietrogenieëser|nietrogenieës|nietrogeniekes|nietrogenieëske|nietrogeniums|nietrogeniumme|nietrogenia|nietrogenieke|nietrogenieëskes	<i>noun</i><br><ol><li>(uncountable) nitrogen</li><li>A part of nitrogen</li></ol>
nikkel	<i>noun</i><br><ol><li>(uncountable) nickel</li><li>A part of nickel</li></ol>
niobium|niobieke|niobiekes|niobiums|niobieëser|niobieëske|niobieës|niobia|niobiumme|niobieëskes	<i>noun</i><br><ol><li>(uncountable) niobium</li><li>A part of niobium</li></ol>
noets	<i>adv</i><br><ol><li>(Maastrichtian) never</li></ol>
noondemieljaar	<i>intj</i><br><ol><li>(Maastrichtian) dammit</li></ol>
noondezju	<i>intj</i><br><ol><li>(Maastrichtian) expression that displays excitement, shock, awe or dismay, comparable with oh my God.</li></ol>
november	<i>noun</i><br><ol><li>November (month)</li></ol>
nögke|tö nögke|genögkedjer|nögker|genögkedjes|'t nögke|genögkedje|nögkem|nögkes|nögketj!|genögke|nögkedje|nögke-n|nögke!|nögkedje-n|nögkedjes|nögketj|'t genögke n|nögkendj|höbbe genögke|genögkedjelik	<i>verb</i><br><ol><li>to have sexual intercourse</li></ol>
obbenuits	<i>adv</i><br><ol><li>(Maastrichtian) again</li></ol>
oets	<i>adv</i><br><ol><li>(Maastrichtian) ever, always</li></ol>
oktober	<i>noun</i><br><ol><li>October (month)</li></ol>
osmium|osmieëske|osmiums|osmieëser|osmiekes|osmieës|osmia|osmieëskes|osmieke|osmiumme	<i>noun</i><br><ol><li>(uncountable) osmium</li><li>A part of osmium</li></ol>
pafferik|pafferikjes|pafferikkes|pafferikkeskes|pafferiks|pafferikjem|pafferikje|pafferikke|pafferikkem|pafferikkese|pafferikkeske	<i>noun</i><br><ol><li>(Tongeren) cigarette</li></ol>
palladium|palladiumeke|palladiuma|palladiumekes|palladiumum|palladiumeëskes|palladiumeëske|palladiumeës|palladiumeëser|palladiumums|palladiumumme	<i>noun</i><br><ol><li>(uncountable) palladium</li><li>a part of palladium</li></ol>
pappegei|pappegeie|pappegeike|pappegeis|pappegeiern|pappegeieser|pappegeier|pappegeies|pappegeikes	<i>noun</i><br><ol><li>parrot</li></ol>
pezieëre|höbbe gepezieëre|pezieëre-n|gepezieëredjelik|pezieëretj|'t gepezieëre n|pezieërem|pezieëredjes|pezieëretj'r|pezieërendj|pezieëre!|pezieëretj!|pezieëredje|pezieërer|gepezieëredje|gepezieëredjer|tö pezieëre|pezieëres|pezieëredje-n|gepezieëredjes|'t pezieëre|gepezieëredj	<i>verb</i><br><ol><li>to weigh</li></ol>
piese|piesem|piesedje|piese!|piesendj|piesedjes|gepiesedje|höbbe gepiese|gepiesedjelik|pieser|pieses|piesetj|gepiesedjes|'t piese|piese-n|tö piese|gepiese|'t gepiese n|piesetj!|piesedje-n|gepiesedjer	<i>verb</i><br><ol><li>(vulgar) to urinate, piss</li></ol>
platinum|platineëskes|platinumme|platina|platinekes|platineës|platineëser|platineëske|platinums|platineke	<i>noun</i><br><ol><li>(uncountable) platinum</li><li>A part of platinum</li></ol>
plekke|höbbe geplek|plek|plekke-n|geplekdjelik|pleks|plek!|plekdjes|plekketj!|plektj!|geplekdjes|geplekdje|plekketj|geplekdjer|plekdje-n|'t geplek n|geplek|plekkem|plekdje|'t plekke|tö plekke|plekker|plekkendj|plektj	<i>verb</i><br><ol><li>to paste, glue</li></ol>
plómb|plömbienke|plömkes|plómbeske|plömbienkes|plómbienes|plómbienesker|plómbien|plómbieneske|plómbeser|plómbiener|plómbesker|plómbieneser|plóms|plómber|plömke|plómbes	<i>noun</i><br><ol><li>Someone who does not like to act when something severe is happening.</li></ol>
pools|poolser|poolses|poolsen|poolse	<i>adj</i><br><ol><li>Polish</li></ol>
poor	<i>noun</i><br><ol><li>leek</li></ol>
praseodimium|praseodimieëske|praseodimiekes|praseodimia|praseodimiumme|praseodimieëser|praseodimieës|praseodimiums|praseodimieëskes|praseodimieke	<i>noun</i><br><ol><li>(uncountable) praseodymium</li><li>A part of praseodymium</li></ol>
preuvenemint|preuveneminte	<i>noun</i><br><ol><li>(Maastrichtian) Annual culinary festival in Maastricht.</li></ol>
promethium|promethia|promethiumme|promethieëskes|promethieëser|promethiekes|promethieke|promethieëske|promethieës|promethiums	<i>noun</i><br><ol><li>(uncountable) promethium</li><li>A part of promethium</li></ol>
pènzieëre|gepènzieëredjelik|pènzieëredje-n|gepènzieëredj|tö pènzieëre|pènzieëredjes|pènzieërer|pènzieëretj'r|pènzieëre!|pènzieëretj|gepènzieëredje|pènzieërem|pènzieëretj!|gepènzieëredjes|pènzieëres|'t gepènzieëre n|gepènzieëredjer|pènzieëredje|pènzieëre-n|'t pènzieëre|höbbe gepènzieëre|pènzieërendj	<i>verb</i><br><ol><li>to think deeply</li></ol>
pèsse|pèstj|pèstj!|pès!|pèsdje|pèssendj|pèsser|gepèsdje|pèsse-n|gepès|pèsdje-n|gepèsdjes|pèsdjes|'t gepès n|pès|pèssem|tö pèsse|'t pèsse|höbbe gepès|gepèsdjelik|pèssetj|gepèsdjer|pèssetj!	<i>verb</i><br><ol><li>(vulgar) to urinate, piss</li></ol>
pógkèsse|pógkèssetj|pógkèsdjes|pógkèstj!|höbbe gepógkès|pógkèsdje|pógkèsse-n|pógkès|pógkèssendj|gepógkèsdje|'t gepógkès n|gepógkèsdjer|gepógkèsdjes|pógkèstj|pógkèsser|pógkèssetj!|tö pógkèsse|pógkès!|'t pógkèsse|gepógkès|pógkèsdje-n|gepógkèsdjelik|pógkèssem	<i>verb</i><br><ol><li>to message</li></ol>
raenger	<i>noun</i><br><ol><li>rain</li></ol>
raengere	<i>verb</i><br><ol><li>to rain</li></ol>
rappelere	<i>verb</i><br><ol><li>(Maastrichtian, reflexive) to remember</li></ol>
renium|renieëske|reniums|reniumme|renieke|renia|reniekes|renieëser|renieëskes|renieës	<i>noun</i><br><ol><li>(uncountable) rhenium</li><li>A part of rhenium</li></ol>
rijstartel|rijstartele	<i>noun</i><br><ol><li>(Maastrichtian) shoelace</li></ol>
rodium|rodieëser|rodieës|rodieëske|rodia|rodieke|rodiumme|rodieëskes|rodiums|rodiekes	<i>noun</i><br><ol><li>(uncountable) rhodium</li><li>A part of rhodium</li></ol>
romanizieëre|geromanizieëredjes|tö romanizieëre|romanizieëre-n|geromanizieëredjelik|romanizieërem|romanizieëre!|romanizieëredje-n|romanizieëretj'r|romanizieëredje|'t geromanizieëre n|geromanizieëredjer|romanizieëredjes|romanizieëretj|höbbe geromanizieëre|romanizieëres|romanizieëretj!|geromanizieëredj|geromanizieëredje|romanizieërer|'t romanizieëre|romanizieërendj	<i>verb</i><br><ol><li>to romanize</li></ol>
rubidium|rubidieëskes|rubidieës|rubidieke|rubidieëser|rubidieëske|rubidiumme|rubidia|rubidiums|rubidiekes	<i>noun</i><br><ol><li>(uncountable) rubidium</li><li>A part of rubidium</li></ol>
ruthenium|rutheniums|ruthenieëskes|ruthenieëser|ruthenieëske|ruthenieke|rutheniekes|ruthenia|rutheniumme|ruthenieës	<i>noun</i><br><ol><li>(uncountable) ruthenium</li><li>A part of ruthenium</li></ol>
ruumdje	<i>noun</i><br><ol><li>space</li></ol>
rèlle|rèller|rèltj|höbbe gerèl|gerèldjes|gerèldje|rèldje-n|'t gerèl n|rèl|rèldje|rèltj'r|rèlle-n|rèlletj!|'t rèlle|rèl!|gerèldjelik|rèllendj|gerèldj|rèldjes|tö rèlle|rèllem|rèlletj|rèls|rèltj!|gerèldjer	<i>verb</i><br><ol><li>to rill</li></ol>
rèmme|rèm|rèmmendj|'t rèmme|rèms|rèmmetj|tö rèmme|rèmmer|rèmp!|rèmme-n|rèmdje|rèmmem|rèmdje-n|rèm!|gerèmp|'t gerèm n|gerèmpdjelik|rèmdjes|gerèmpdjes|rèmmetj!|rèmtj|rèmp|gerèmpdje|höbbe gerèmp|gerèmpdjer	<i>verb</i><br><ol><li>to put on the break</li></ol>
rómme|rómtj|gerómpdje|rómmendj|gerómpdjelik|gerómpdjer|rómmetj|rómme-n|gerómpdjes|rómmer|rómp!|höbbe gerómp|rómdjes|rómdje|rómmetj!|róms|gerómp|'t rómme|tö rómme|róm!|rómp|róm|rómdje-n|rómmem|'t geróm n	<i>verb</i><br><ol><li>(obsolete) to put on the break</li></ol>
samarium|samariums|samarieke|samariekes|samarieëske|samariumme|samarieëskes|samaria|samarieës|samarieëser	<i>noun</i><br><ol><li>(uncountable) samarium</li><li>A part of samarium</li></ol>
segrèt|segrètje|zegrètteskes|segrètteske|segrèttes|segrètteskes|zegrètteske|zegrètjem|zegrèttese|zegrètje|zegrètjes|zegrèttes|segrèttese|segrètte|zegrètte|zegrèt|zegrètjer|segrètjem|segrètjer|segrètjes|segrètsje	<i>noun</i><br><ol><li>(widespread variant) cigarette</li></ol>
seleen|appelsien	<i>noun</i><br><ol><li>(uncountable) selenium</li><li>A part of selenium</li></ol>
september	<i>noun</i><br><ol><li>September (month)</li></ol>
serium|seria|seriumme|serieëske|seriums|serieke|serieëser|serieës|serieëskes|seriekes	<i>noun</i><br><ol><li>(uncountable) cerium</li><li>A part of cerium</li></ol>
sesium|sesieëske|sesia|sesieëser|sesieëskes|sesiumme|sesiekes|sesieke|sesieës|sesiums	<i>noun</i><br><ol><li>(uncountable) caesium</li><li>A part of caesium</li></ol>
si si	<i>intj</i><br><ol><li>of course!</li></ol>
sigrèt|sigrèttes|sigrètjem|sigrètje|sigrètteske|sigrètjes|zigrètje|zigrètte|zigrèttes|zigrèt|sigrètjer|zigrètteske|zigrètteskes|zigrèttese|zigrètjem|zigrètjer|zigrètjes|sigrèttese|sigrètte|sigrètsje|sigrètteskes	<i>noun</i><br><ol><li>(Maastrichtian, Sittard, Heerlen) cigarette</li></ol>
silikón	<i>noun</i><br><ol><li>(uncountable) silicon</li><li>A part of silicon</li></ol>
sisi	<i>intj</i><br><ol><li>of course!</li></ol>
sjaop	<i>noun</i><br><ol><li>sheep</li></ol>
sjeng|sjenge	<i>noun</i><br><ol><li>A native or inhabitant of Maastricht.</li></ol>
sjevraoj|sjevraoje	<i>noun</i><br><ol><li>(Maastrichtian) a shiver, tremble</li></ol>
sji-jje	<i>verb</i><br><ol><li>to happen</li><li>to occur</li></ol>
sjiek|sjieke|sjieks|sjieker|sjieken|sjiekes	<i>adj</i><br><ol><li>elegant</li><li>nice, pleasant</li><li>appropriate</li></ol>
sjink	<i>noun</i><br><ol><li>(Maastrichtian) ham, pork from the hindquarter</li></ol>
sjinkerij	<i>noun</i><br><ol><li>(Maastrichtian) café</li></ol>
sjoen|sjoens|sjoene|sjoenen|sjoenes|sjoener	<i>adj</i><br><ol><li>beautiful, pretty, handsome</li></ol>
sjoester	<i>noun</i><br><ol><li>(Maastrichtian) shoemaker</li></ol>
sjoon	<i>noun</i><br><ol><li>shoe</li></ol>
sjotelsplak	<i>noun</i><br><ol><li>(Maastrichtian) dishcloth</li></ol>
sjouwer|sjouwereskes|sjuierkes|sjuierke|sjouwere|sjouwers|sjuierkem|sjouwerese|sjuiersje|sjouwersj|sjuiwerke|sjouweres|sjouwereske	<i>noun</i><br><ol><li>(widespread variant, especially in Dutch Limburg) shoulder</li></ol>
sjèlle|'t sjèlle|gesjèldjes|gesjèldjelik|sjèltj'r|sjèldje|sjèller|sjèlletj|sjèllem|tö sjèlle|sjèls|sjèltj|sjèl|sjèlle-n|höbbe gesjèl|gesjèldj|sjèl!|gesjèldje|sjèldjes|sjèllendj|sjèlletj!|gesjèldjer|sjèltj!|'t gesjèl n|sjèldje-n	<i>verb</i><br><ol><li>to pare, peel, blanch, shell</li></ol>
sjógkel	<i>noun</i><br><ol><li>(Maastrichtian) swing (pendulum-like object found in playgrounds)</li></ol>
skandium|skandia|skandiekes|skandieëser|skandieës|skandieke|skandieëske|skandiums|skandiumme|skandieëskes	<i>noun</i><br><ol><li>(uncountable) scandium</li><li>A part of scandium</li></ol>
slang	<i>noun</i><br><ol><li>hose (flexible tube)</li><li>slang</li></ol>
slaope	<i>verb</i><br><ol><li>to sleep</li></ol>
slivveniersbieske|slivveniersbieskes	<i>noun</i><br><ol><li>(Maastrichtian) ladybird, ladybug</li></ol>
snieje	<i>verb</i><br><ol><li>to cut</li></ol>
snierk|znierkeskes|snierkje|znierkjem|snierkeskes|znierke|znierkes|snierkeske|snierke|znierkeske|znierkese|znierkjes|snierkese|snierkes|znierk|znierkje|snierkjes|snierkjem	<i>noun</i><br><ol><li>(Venlo) cigarette</li></ol>
snieë	<i>noun</i><br><ol><li>snow</li></ol><br><i>verb</i><br><ol><li>to snow</li></ol>
spietelik	<i>intj</i><br><ol><li>expresses regret, remorse, or sorrow, sorry.</li></ol>
strontium|strontieëskes|strontieëske|strontieke|strontiumme|strontieës|strontieëser|strontiums|strontia|strontiekes	<i>noun</i><br><ol><li>(uncountable) strontium</li><li>A part of strontium</li></ol>
stèlle|stèlletj|höbbe gestèl|stèls|gestèldjelik|'t gestèl n|stèlletj!|gestèldj|tö stèlle|stèltj'r|stèl|stèlle-n|gestèldjes|'t stèlle|gestèldjer|stèldjes|stèldje|gestèldje|stèllem|stèller|stèltj|stèl!|stèltj!|stèllendj|stèldje-n	<i>verb</i><br><ol><li>to put, set, place</li><li>to make silent</li></ol>
stósse|höbbe gestós|tö stósse|'t gestós n|stós|gestósdjer|stósdje-n|stóssetj!|gestósdjelik|stóssetj|'t stósse|stósse-n|stósdje|stóssendj|gestósdjes|gestósdje|stósdjes|stóssem|stóstj|stós!|stóstj!|gestós|stósser	<i>verb</i><br><ol><li>to support</li><li>to help</li></ol>
sèsse|sès!|sèsdjes|'t gesès n|'t sèsse|sèssetj|sèsdje|sèsser|höbbe gesès|tö sèsse|sèssendj|sès|gesèsdjes|sèssetj!|gesèsdjelik|sèsdje-n|gesèsdje|sèsse-n|sèssem|sèstj!|gesès|sèstj|gesèsdjer	<i>verb</i><br><ol><li>to hiss</li></ol>
sókker	<i>noun</i><br><ol><li>sugar</li></ol>
tale	<i>noun</i><br><ol><li>languages</li></ol>
tantalum|tantaleke|tantalekes|tantaleës|tantaleëske|tantala|tantaleëskes|tantaleëser|tantalumme|tantalums	<i>noun</i><br><ol><li>(uncountable) tantalum</li><li>A part of tantalum</li></ol>
teater|teaeterkes|teaeterke|teatereske|teaters|teateres|teatereser|teaterern|teatereskes|teatere|teaterer	<i>noun</i><br><ol><li>theatre</li><li>nonsense</li></ol>
technetium|technetia|technetieke|technetiumme|technetiums|technetieëske|technetieës|technetieëser|technetieëskes|technetiekes	<i>noun</i><br><ol><li>(uncountable) technetium</li><li>A part of technetium</li></ol>
teleur	<i>noun</i><br><ol><li>(Maastrichtian) plate</li></ol>
terbium|terbieke|terbiums|terbia|terbieëske|terbieës|terbieëser|terbiekes|terbieëskes|terbiumme	<i>noun</i><br><ol><li>(uncountable) terbium</li><li>A part of terbium</li></ol>
thallium|thallieëske|thallieës|thallia|thalliekes|thalliums|thallieëser|thallieëskes|thalliumme|thallieke	<i>noun</i><br><ol><li>(uncountable) thallium</li><li>A part of thallium</li></ol>
thulium|thuliekes|thulieëser|thulieës|thulieëskes|thuliums|thulieke|thuliumme|thulia|thulieëske	<i>noun</i><br><ol><li>(uncountable) thulium</li><li>A part of thulium</li></ol>
titanium|titania|titanieës|titaniekes|titanieke|titanieëske|titanieëskes|titaniumme|titaniums|titanieëser	<i>noun</i><br><ol><li>(uncountable) titanium</li><li>A part of titanium</li></ol>
tratsj|tratsjeser|tretsjker|tretsjesker|tratsjese|tratsjem|tratsjes|tretsjeske|tretsjke|tretsjkes|tratsje	<i>noun</i><br><ol><li>trash, mess</li></ol>
trèlle|trèl|trèltj!|trèltj'r|getrèldjer|'t getrèl n|'t trèlle|trèls|getrèldje|trèllendj|getrèldj|trèlle-n|höbbe getrèl|trèldje|trèller|tö trèlle|trèlletj|trèldjes|getrèldjelik|trèllem|trèlletj!|trèltj|trèl!|trèldje-n|getrèldjes	<i>verb</i><br><ol><li>to trill, vibrate</li></ol>
tsigrèt|tsigrètsjes|tsigrèttes|tsigrètteskes|tsigrètte|tsigrèttese|tsigrètsje|tsigrètteske|tsigrètsjer|tsigrètsjem	<i>noun</i><br><ol><li>(Southeast Limburgish, except for Heerlen) cigarette</li></ol>
tuut	<i>noun</i><br><ol><li>bag</li></ol>
tèlle|tèller|tèldjes|tèl|getèldj|getèldje|tèlletj!|'t getèl n|tèllem|tèldje-n|tèltj'r|tèls|getèldjes|tèl!|tèltj!|tèlle-n|tèldje|tèltj|tèlletj|tö tèlle|tèllendj|getèldjer|getèldjelik|'t tèlle|höbbe getèl	<i>verb</i><br><ol><li>to count, calculate, reckon</li><li>to tell (a story)</li></ol>
tèn	<i>noun</i><br><ol><li>(uncountable) tin</li><li>A part of tin</li></ol>
tönke|getönkedjer|tönkes|tönketj'r|tönkendj|tö tönke|tönketj!|tönkedje|tönke!|tönkedje-n|'t tönke|tönker|'t getönke n|tönkem|tönketj|getönkedj|getönkedjes|höbbe getönke|getönkedjelik|tönkedjes|tönke-n|getönkedje	<i>verb</i><br><ol><li>to be wrong with</li></ol>
tönnel|tönneleskes|tönneleske|tönneln|tönnels|tönneles|tönneleser|tönnelkes|tönnele|tönnelke	<i>noun</i><br><ol><li>tunnel</li></ol>
urenieëre|urenieëres|'t geurenieëre n|höbbe geurenieëre|urenieëredjes|geurenieëredjes|urenieëre!|urenieërer|geurenieëredj|urenieëre-n|urenieëretj|geurenieëredjer|urenieëredje-n|tö urenieëre|urenieëretj!|geurenieëredjelik|'t urenieëre|urenieëretj'r|urenieëredje|urenieërendj|urenieërem|geurenieëredje	<i>verb</i><br><ol><li>to urinate, piss</li></ol>
vaam|vaem|vame	<i>noun</i><br><ol><li>thread, length of yarn</li></ol>
vajer|vajereske|vajeres|vajern|vajere|vajerke|vajerkes|vajers|vajereskes|vajereser	<i>noun</i><br><ol><li>father</li><li>guardian</li></ol>
vanadium|vanadia|vanadieke|vanadiumme|vanadieëske|vanadieëskes|vanadiekes|vanadieëser|vanadiums|vanadieës	<i>noun</i><br><ol><li>(uncountable) vanadium</li><li>A part of vanadium</li></ol>
varzjabel|'t varzjabels|varzjabele|varzjabeles|varzjabeler|varzjabels|varzjabelen	<i>adj</i><br><ol><li>variable</li></ol>
veerdeg|veerdeger|'t veerdegs|veerdegs	<i>adj</i><br><ol><li>(Maastrichtian) ready, done</li></ol>
vermassekrere	<i>verb</i><br><ol><li>(Maastrichtian) to trash, to break</li><li>(Maastrichtian) to spoil, to ruin (something)</li></ol>
veure|veuretj'r|veurendj|höbbe geveure|geveuredj|'t veure|geveuredjes|tö veure|veuretj!|veuredjes|veuredje|veures|'t geveure n|veurer|veure-n|veuredje-n|geveuredjer|geveuredje|geveuredjelik|veurem|veuretj|veure!	<i>verb</i><br><ol><li>to feed an animal</li><li>to lead (a compagne)</li></ol>
vrów|vrówweskes|vröjke|vrówwes|vröjkes|vrówweser|vrówwer|vrówwe|vrówweske	<i>noun</i><br><ol><li>queen, princess</li><li>(rare) woman</li></ol>
vrówmès|vrówmèsser|vrówmèveskes|vrówmèske|vrówmèveser|vrówmèveske|vrówmèskes|vrówmèves|vrówmèssern|vrówmèsses	<i>noun</i><br><ol><li>woman</li><li>wife</li></ol>
vèlle|vèller|vèltj'r|vèl|vèlletj!|tö vèlle|'t gevèl n|gevèldj|vèlletj|vèldje-n|vèlle-n|höbbe gevèl|vèltj!|gevèldjelik|vèltj|vèllem|gevèldjer|gevèldje|'t vèlle|vèl!|gevèldjes|vèls|vèldje|vèllendj|vèldjes	<i>verb</i><br><ol><li>to slaughter</li></ol>
vèsse|vèstj|'t gevès n|gevèsdjes|'t vèsse|gevèsdjer|vèssetj!|vèstj!|vèsdje-n|vèssetj|vès!|vèsdje|höbbe gevès|gevès|vèssendj|vèsser|tö vèsse|gevèsdjelik|vèsdjes|gevèsdje|vès|vèssem|vèsse-n	<i>verb</i><br><ol><li>to fish</li></ol>
vósse|höbbe gevós|vósdje-n|vósser|vóstj!|vós|'t gevós n|vóssetj|vóssetj!|gevósdjelik|vóssendj|'t vósse|vósdjes|vósse-n|vóstj|gevósdjes|gevósdje|tö vósse|gevósdjer|gevós|vósdje|vóssem|vós!	<i>verb</i><br><ol><li>to search for food</li></ol>
waek	<i>noun</i><br><ol><li>week</li></ol>
waord|wäörd	<i>noun</i><br><ol><li>word</li></ol>
waorsbook	<i>noun</i><br><ol><li>dictionary</li></ol>
water|waeterkes|waeterke|waters|watevese|watere|wateves|watevem	<i>noun</i><br><ol><li>water</li><li>body of water</li></ol>
waus|wöjskes|wauze|wauzeses|wauzeseser|wöjske|wöjzesker|wauzes|wöjzeske	<i>noun</i><br><ol><li>fool</li><li>(obsolete) fool of the village/town</li></ol>
wauzèn|wauzènneser|wöjzènneske|wauzinne|wöjzènskes|wöjzènnesker|wauzènne|wauzinnes|wauzènnes|wöjzinneske|wöjzinnesker|wöjzinskes|wöjzènke|wöjzènkes|wöjzinke|wöjzinkes|wauzinneser|wauzin	<i>noun</i><br><ol><li>fool</li><li>(obsolete) fool of the village/town</li></ol>
welkom	<i>intj</i><br><ol><li>(Venlo) welcome</li></ol>
wien|wieneser|wienkes|wiene|wienes|wiens|wienke	<i>noun</i><br><ol><li>wine</li></ol>
wientemper	<i>noun</i><br><ol><li>(Maastrichtian) dragonfly</li></ol>
wiki	<i>noun</i><br><ol><li>wiki</li></ol>
woe	<i>adv</i><br><ol><li>where</li></ol>
wèlkóm|wèlkómster|wèlkóveske|wèlkóms|wèlkóvesker|wèlkómmern|wèlkóveser|wèlkömske|wèlkóves|wèlkömskes	<i>intj</i><br><ol><li>welcome!</li></ol><br><i>noun</i><br><ol><li>welcome</li></ol>
wèlle|wèltj|gewèldje|wèltj'r|wèlletj|gewèldj|wèllem|gewèldjes|wèller|wèlletj!|wèllendj|'t gewèl n|wèldjes|wèls|wèl!|'t wèlle|wèltj!|höbbe gewèl|gewèldjelik|tö wèlle|wèlle-n|wèldje|wèl|gewèldjer|wèldje-n	<i>verb</i><br><ol><li>to get better/become healthy</li></ol>
wèrkwaord	<i>noun</i><br><ol><li>(grammar) verb</li></ol>
wólframium|wólframia|wólframiumme|wólframieës|wólframieëser|wólframieëske|wólframiekes|wólframieëskes|wólframieke|wólframiums	<i>noun</i><br><ol><li>(uncountable) tungsten</li><li>A part of tungsten</li></ol>
zeen|zeetj v'r|doe zoogs|'t zeen|bönnetj g'r|gewaes (gewaeze/gewaeze-n/gewaezer/gewaezes)|zeentj g'r|woor ich|die zeen|zeendje|waeze|wore die|zenem|gezeen (gezene/gezene-n/gezener/gezenes)|zoogs se|weer zoge|zuuetj!|tö zeen|is t'r|doe bönne|gezenelik|geer zuutj|zener-die|geer zene|woortj g'r|zuug!|zuutj g'r|ich bön|'t gezeen n|ich woor|bön!|doe bös|dae woor|woors se|dae zuutj|dae bönne|zeentj v'r|zoog ich|geer zoog|gewaezelik|weer zene|zeetj!|zener-doe|dae zene|woortj v'r|zeentj!|zener-dae|bös se|ich zene|zenetj g'r|die zeent|bönne v'r|geer zeetj|ich zoog|bönner-dae|die bönne|doe zene|geer bönne|bönner-die|die zene|bönne-n ich|die wore|dae zoog|die zoge|zeen die|zene v'r|dae is|woor d'r|höbbe gezeen|zeetj g'r|zeen|zoge die|zoge v'r|zoog t'r|bönnem|zeen ich|zoog g'r|zuutj!|bönner-doe|bön ich|ich bönne|doe zuus|eertj!|doe woors|geer zeentj|zuus se|weer zeen|weer wore|geer woortj|weer bönne|ich zeen|zuutj'r|zeen gewaes|zene-n ich	<i>verb</i><br><ol><li>to be</li><li>to see</li></ol>
ziech sjaggernere	<i>verb</i><br><ol><li>(reflexive, Maastrichtian) to be annoyed, to be irritated</li></ol>
zieë	<i>noun</i><br><ol><li>sea</li></ol>
zink	<i>noun</i><br><ol><li>(uncountable) zinc</li><li>A part of zinc</li></ol>
zirkonium|zirkoniums|zirkonieëskes|zirkoniekes|zirkonieke|zirkonieëser|zirkonieës|zirkonia|zirkoniumme|zirkonieëske	<i>noun</i><br><ol><li>(uncountable) zirconium</li><li>A part of zirconium</li></ol>
zjelous	<i>adj</i><br><ol><li>(Maastrichtian) jealous</li></ol>
zjinneraolezieëre|zjinneraolezieëre!|zjinneraolezieërem|'t zjinneraolezieëre|tö zjinneraolezieëre|zjinneraolezieëredje|zjinneraolezieëres|'t gezjinneraolezieëre n|zjinneraolezieëretj!|zjinneraolezieërendj|zjinneraolezieëre-n|gezjinneraolezieëredje|gezjinneraolezieëredjes|zjinneraolezieërer|zjinneraolezieëretj|zjinneraolezieëredje-n|höbbe gezjinneraolezieëre|gezjinneraolezieëredjelik|gezjinneraolezieëredjer|zjinneraolezieëretj'r|zjinneraolezieëredjes|gezjinneraolezieëredj	<i>verb</i><br><ol><li>to generalise</li></ol>
zjinnerieëre|gezjinnerieëredjes|zjinnerieërer|zjinnerieëretj!|'t zjinnerieëre|zjinnerieëretj|zjinnerieëredje-n|zjinnerieëre!|gezjinnerieëredjelik|gezjinnerieëredje|zjinnerieëre-n|zjinnerieërem|zjinnerieërendj|höbbe gezjinnerieëre|zjinnerieëretj'r|zjinnerieëredje|gezjinnerieëredj|gezjinnerieëredjer|zjinnerieëres|zjinnerieëredjes|'t gezjinnerieëre n|tö zjinnerieëre	<i>verb</i><br><ol><li>to generate</li></ol>
zjittieëre|gezjittieëredj|gezjittieëredjelik|zjittieëre!|zjittieëres|zjittieërem|zjittieëretj'r|zjittieëredje-n|gezjittieëredjer|zjittieërendj|tö zjittieëre|zjittieëredje|höbbe gezjittieëre|zjittieërer|zjittieëretj!|zjittieëretj|'t gezjittieëre n|'t zjittieëre|zjittieëredjes|gezjittieëredje|zjittieëre-n|gezjittieëredjes	<i>verb</i><br><ol><li>to delete</li></ol>
zjus|zjuse|zjuses|zjusen|zjuser	<i>adj</i><br><ol><li>(Maastrichtian) right, correct</li><li>just</li></ol>
zjuuere|zjuuerendj|gezjuueredj|'t zjuuere|gezjuueredjes|zjuuere!|zjuueres|zjuueredje-n|zjuuere-n|gezjuueredjelik|gezjuueredje|zjuueredjes|gezjuueredjer|'t gezjuuere n|zjuueretj|zjuuerer|zjuueredje|zjuuerem|höbbe gezjuuere|zjuueretj'r|tö zjuuere|zjuueretj!	<i>verb</i><br><ol><li>to judge</li></ol>
zjèlle|zjèltj|tö zjèlle|zjèl|gezjèldje|gezjèldjer|zjèller|'t gezjèl n|zjèllem|zjèls|zjèlle-n|zjèllendj|zjèldje-n|zjèltj!|höbbe gezjèl|zjèldjes|zjèltj'r|zjèlletj|zjèl!|gezjèldj|gezjèldjes|'t zjèlle|zjèlletj!|zjèldje|gezjèldjelik	<i>verb</i><br><ol><li>to be cold</li></ol>
zoe	<i>adv</i><br><ol><li>so</li><li>(zoe ... es) as</li><li>since, because</li><li>soon, right away</li><li>thus</li></ol>
zoon|zeuns	<i>noun</i><br><ol><li>son</li></ol>
zwaevel	<i>noun</i><br><ol><li>(uncountable) sulfur</li><li>A part of sulfur</li></ol>
zwart	<i>noun</i><br><ol><li>black</li></ol>
zwömme|gezwömpdje|zwöm!|zwömmetj!|zwömdje-n|tö zwömme|zwömtj|gezwömpdjelik|zwömmer|gezwömpdjer|zwömmem|'t gezwöm n|zwöm|zwömp!|höbbe gezwömp|zwömme-n|zwöms|'t zwömme|zwömmendj|zwömdje|zwömp|zwömmetj|gezwömp|zwömdjes|gezwömpdjes	<i>verb</i><br><ol><li>to swim</li></ol>
zèlver|vajereser|vajereske|vajeres|vajern|vajer|vajere|vajerke|vajers|vajereskes|vajerkes	<i>noun</i><br><ol><li>(uncountable) silver</li><li>A part of silver</li></ol>
zórgelik|zórgeliks|'t zórgeliks|zórgelikker|zórgeliken|zórgelike|zórgelikes|zórgeliker	<i>adj</i><br><ol><li>poor, sad, regrettable</li></ol><br><i>adv</i><br><ol><li>poorly, sadly, regrettably</li></ol>
zörgelik|zörgeliks|zörgeliker|zörgelike|zörgelikes|'t zörgeliks|zörgelikker|zörgeliken	<i>adj</i><br><ol><li>poor, sad, regrettable</li></ol><br><i>adv</i><br><ol><li>poorly, sadly, regrettably</li></ol>
Èslandj	<i>name</i><br><ol><li>Estonia (a country in Europe)</li></ol>
Èèrlandj	<i>name</i><br><ol><li>Ireland (an island and country in Europe)</li></ol>
Éï|Éjjer	<i>noun</i><br><ol><li>(Eupen) egg</li></ol>
äölentäöl	<i>noun</i><br><ol><li>elder (tree)</li></ol>
èpperglieëdjómme|èpperglieëdjómmendj|èpperglieëdjóm!|geèpperglieëdjómpdjer|èpperglieëdjómmer|höbbe geèpperglieëdjómp|geèpperglieëdjómpdjes|èpperglieëdjóm|èpperglieëdjómdjes|èpperglieëdjómdje|geèpperglieëdjómpdje|èpperglieëdjómme-n|èpperglieëdjóms|èpperglieëdjómtj|geèpperglieëdjómp|èpperglieëdjómp!|èpperglieëdjómmetj!|èpperglieëdjómmetj|èpperglieëdjómp|'t geèpperglieëdjóm n|tö èpperglieëdjómme|èpperglieëdjómdje-n|geèpperglieëdjómpdjelik|èpperglieëdjómmem|'t èpperglieëdjómme	<i>verb</i><br><ol><li>to wait for something to dry</li></ol>
énnteeger|énnteegere|énnteegerst|énnteegerder	<i>adj</i><br><ol><li>(Eupen) complete, whole, intact</li><li>(Eupen) friendly</li></ol>
éstósse|höbbe geéstós|'t éstósse|éstóssem|éstósser|éstós|geéstós|éstósdje-n|éstósse-n|geéstósdje|éstóstj!|tö éstósse|geéstósdjes|'t geéstós n|éstóstj|geéstósdjelik|éstósdjes|éstós!|éstóssetj!|éstósdje|éstóssendj|éstóssetj|geéstósdjer	<i>verb</i><br><ol><li>to rest, take a long break</li></ol>
óksegenium|óksegenieës|óksegenia|óksegeniekes|óksegenieëskes|óksegenieëser|óksegeniumme|óksegenieëske|óksegeniums|óksegenieke	<i>noun</i><br><ol><li>(uncountable) oxygen</li><li>A part of oxygen</li></ol>
ól|ólleskes|ólleske|ölke|ölkes|óle|óls|ólleser|ólles	<i>noun</i><br><ol><li>baby (a little child)</li><li>(obsolete) beer</li></ol>
ô	<i>character</i><br><ol><li>(obsolete) ó</li></ol><br><i>intj</i><br><ol><li>oh!</li></ol>
övver	<i>adv</i><br><ol><li>(Eupen) over, above</li><li>(Eupen, postpositional) over (implying motion)</li><li>(Eupen) remaining, left over</li></ol><br><i>prep</i><br><ol><li>(Eupen, accusative or dative) above, over (spatially)</li><li>(Eupen) about, concerning, over, at (in reference to)</li><li>(Eupen, accusative) via, through, by way of</li><li>(Eupen, accusative) across</li><li>(Eupen, accusative) during, for, over a time period</li><li>(Eupen, accusative) about</li></ol>
