Anuksenlinnu	<i>name</i><br><ol><li>Olonets (a town in Russia)</li></ol>
Anus	<i>name</i><br><ol><li>Olonets (a town in Russia)</li></ol>
Hospodi	<i>name</i><br><ol><li>(Christianity) God, the Lord</li></ol>
Ilomanči	<i>name</i><br><ol><li>Ilomantsi (a municipality of Finland)</li></ol>
Jovensuu	<i>name</i><br><ol><li>Joensuu (a city in Finland)</li></ol>
Karjal	<i>name</i><br><ol><li>Karelia (region of Europe)</li></ol>
Karjalan Tazavaldu	<i>name</i><br><ol><li>the Republic of Karelia (subject of the Russian Federation)</li></ol>
Kägöisalmi	<i>name</i><br><ol><li>Priozersk (town in Russia, historically in Finland)</li></ol>
Ruottši	<i>name</i><br><ol><li>Finland</li><li>Sweden</li></ol>
Ruočči	<i>name</i><br><ol><li>(often derogatory) Finland or a (Lutheran) Finn</li><li>Sweden</li></ol>
Ruoččičorta	<i>noun</i><br><ol><li>(ethnic slur, derogatory) a Finn (literally. "Finnish devil")</li><li>(Finland Karelians, derogatory) Finnish people who claim that Karelia is Finnish</li></ol>
Suomi	<i>name</i><br><ol><li>Finland (a country in Europe)</li></ol>
Ukrainu	<i>name</i><br><ol><li>Ukraine (a country in Europe)</li></ol>
Venʹa	<i>name</i><br><ol><li>Russia (a country in Europe and Asia)</li></ol>
Venʼan Federatsii	<i>name</i><br><ol><li>the Russian Federation</li></ol>
aberi|aberii|aberin	<i>noun</i><br><ol><li>primer</li></ol>
abu|abuu|avun	<i>noun</i><br><ol><li>help</li></ol>
abuniekka	<i>noun</i><br><ol><li>assistant, aide</li></ol>
abuniekku	<i>noun</i><br><ol><li>hand, assistant, aide</li></ol>
adru	<i>noun</i><br><ol><li>plough, plow</li></ol>
ahven|ahvendu|ahvenen	<i>noun</i><br><ol><li>perch</li></ol>
aidu|aidua|aijan	<i>noun</i><br><ol><li>fence</li></ol>
aigu|aijattah|aijoikse|aijoittah|aijois|aijoispäi|aijoinnu|aigoih|aijanke|aijoile|aijas|aijoinke|aigua|aijoin|aijal|aijale|aijači|aijaspäi|aijalpäi|aigoi|aijan|aijat|aijoil|aijoilpäi|aijannu|aijakse|aigah	<i>noun</i><br><ol><li>time</li><li>(grammar) tense</li></ol>
aiguine|aigustu|aiguzen	<i>adj</i><br><ol><li>adult</li></ol><br><i>noun</i><br><ol><li>adult</li></ol>
aigukauzilehti|aigukauzilehen|aigukauzilehtii	<i>noun</i><br><ol><li>magazine</li></ol>
aittu|aittua|aitan	<i>noun</i><br><ol><li>storehouse</li></ol>
aivoparaličču	<i>noun</i><br><ol><li>(medicine) stroke</li></ol>
akku	<i>noun</i><br><ol><li>wife</li></ol>
ammui	<i>adv</i><br><ol><li>long ago</li></ol>
andua	<i>verb</i><br><ol><li>(transitive) to give</li><li>(transitive) to allow</li><li>(transitive) to endow with</li><li>(intransitive) to smell, stink</li></ol>
andulu	<i>noun</i><br><ol><li>down (soft feather of a young bird)</li></ol>
anuksenvaski	<i>noun</i><br><ol><li>samovar</li></ol>
aptiekku	<i>noun</i><br><ol><li>pharmacy</li></ol>
astuo	<i>verb</i><br><ol><li>(intransitive) to go</li><li>(intransitive) to step</li></ol>
avain|avaindu|avaimen	<i>noun</i><br><ol><li>key</li></ol>
avata	<i>verb</i><br><ol><li>(transitive) to open</li><li>(transitive) to unbuckle</li><li>(transitive) to declassify</li></ol>
boba|boviilpäi|bobiih|boval|bovalpäi|boviil|bovaspäi|bovakse|boviin|boviikse|bovači|boviinke|bobah|boviile|boviittah|bobii|bovas|boviispäi|boviis|bovat|boviinnu|bovale|bovannu|bovattah|bovanke|bobua|bovan	<i>noun</i><br><ol><li>toy</li><li>flower</li></ol>
briha|brihan|brihua	<i>noun</i><br><ol><li>lad, young man</li></ol>
brihačču|brihaččuloil|brihačule|brihačul|brihačut|brihačukse|brihaččuloinnu|brihaččuloittah|brihaččuu|brihačus|brihaččulois|brihaččuh|brihačuspäi|brihačulpäi|brihačun|brihaččuloikse|brihaččuloih|brihaččuloi|brihačuttah|brihačunke|brihaččuloin|brihaččuloinke|brihačunnu|brihačuči|brihaččuloile|brihaččuloilpäi|brihaččuloispäi	<i>noun</i><br><ol><li>boy</li></ol>
buabo|buabua|buaban	<i>noun</i><br><ol><li>grandmother</li></ol>
buolu|buolua|buolan	<i>noun</i><br><ol><li>cowberry</li></ol>
burbettua	<i>verb</i><br><ol><li>(intransitive) to murmur; to grumble</li></ol>
diedʹoi|diedʹoidu|diedʹoin	<i>noun</i><br><ol><li>grandfather</li></ol>
diivie	<i>verb</i><br><ol><li>(transitive) to condemn</li><li>(transitive) to be surprised by</li></ol>
diädö|diädiä|diädän	<i>noun</i><br><ol><li>uncle</li></ol>
dogadie	<i>verb</i><br><ol><li>(transitive) to notice; see</li></ol>
doroguheiny	<i>noun</i><br><ol><li>greater plantain, Plantago major</li></ol>
eestiläine|eestiläisty|eestiläizen	<i>noun</i><br><ol><li>Estonian (person)</li></ol><br><i>adj</i><br><ol><li>Estonian</li></ol>
ehty|ehtän|ehtiä	<i>noun</i><br><ol><li>evening</li></ol>
ei|älgiä|älgäh|en|älgiämmö|et|emmo|älä|äldähes|etto	<i>verb</i><br><ol><li>not</li></ol>
eliä	<i>verb</i><br><ol><li>(intransitive) to live</li></ol>
ellendiä	<i>verb</i><br><ol><li>(transitive) to understand</li></ol>
elo|eloloin|elospäi|eloloikse|eloloilpäi|eloloispäi|eloloih|eloloittah|eloloinnu|elokse|eloh|eloloinke|elole|eloloile|elol|elot|eloči|elottah|elolois|elos|elolpäi|elonnu|elon|eloloi|eloloil|eluo|elonke	<i>noun</i><br><ol><li>life</li></ol>
eländy	<i>noun</i><br><ol><li>life</li></ol>
elätti|elätin|elättih|elätile|elätis|elätiči|elätilöilpäi|elätilöikse|elätittäh|elätilpäi|elätilöinny|elätilöile|elätikse|elätilöinke|elätilöin|elätilöil|elätilöih|elätil|elätit|elätilöis|elätinke|elätinny|elätilöi|elätispäi|elätilöittäh|elättii|elätilöispäi	<i>noun</i><br><ol><li>animal</li></ol>
enzimäinargi	<i>noun</i><br><ol><li>Monday</li></ol>
enzimäine	<i>adj</i><br><ol><li>first</li></ol>
eččie	<i>verb</i><br><ol><li>(transitive) to search for</li><li>(transitive) to solicit for</li></ol>
eččii|eččijän|eččijät|eččijöis|eččijiispäi|eččijiilpäi|eččijöil|eččijöin|eččijiä|eččijiih|eččijiinny|eččijöile|eččijöinny|eččijäl|eččijiin|eččijii|eččijäči|eččijiis|eččijäle|eččijöittäh|eččijiikse|eččijättäh|eččijiile|eččijänke|eččijöikse|eččijöih|eččijöinke|eččijäs|eččijänny|eččijöi|eččijiittäh|eččijäh|eččijöispäi|eččijäspäi|eččijälpäi|eččijäkse|eččijiil|eččijiinke|eččijöilpäi	<i>noun</i><br><ol><li>seeker, searcher</li></ol>
fatieru|fatierua|fatieran	<i>noun</i><br><ol><li>flat, apartment</li></ol>
feršali|feršalii|feršalin	<i>noun</i><br><ol><li>paramedic, male nurse</li></ol>
fuknie	<i>verb</i><br><ol><li>(transitive) to suddenly do</li><li>(transitive) to quickly do</li></ol>
garbalo|garbalon|garbaluo	<i>noun</i><br><ol><li>cranberry</li></ol>
gostie	<i>verb</i><br><ol><li>(intransitive) to be a guest; to visit</li></ol>
gostittua	<i>verb</i><br><ol><li>(transitive) to treat</li></ol>
griba|grival|grivači|grivalpäi|grivattah|grivoikse|griboih|grivakse|griboi|grivoittah|grivannu|grivat|grivoinke|grivoinnu|gribah|grivas|grivanke|grivoile|grivan|grivaspäi|grivoin|gribua|grivoilpäi|grivois|grivoispäi|grivale|grivoil	<i>noun</i><br><ol><li>bolete (type of mushroom)</li></ol>
harakku|harakois|harakoikse|harakkua|harakalpäi|harakoispäi|harakannu|harakattah|harakkoi|harakas|harakaspäi|harakal|harakale|harakat|harakakse|harakoin|harakoittah|harakkoih|harakoinnu|harakoil|harakan|harakoinke|harakoilpäi|harakanke|harakoile|harakkah|harakači	<i>noun</i><br><ol><li>magpie</li></ol>
harju|harjoi|harjat|harjas|harjači|harjakse|harjanke|harjoih|harjattah|harjoinke|harjua|harjoikse|harjoinnu|harjaspäi|harjoittah|harjoispäi|harjal|harjoin|harjoil|harjoilpäi|harjan|harjoile|harjah|harjois|harjalpäi|harjale|harjannu	<i>noun</i><br><ol><li>brush</li><li>mane (of an animal)</li><li>crest (of a bird)</li><li>top (of a mountain)</li></ol>
haudu	<i>noun</i><br><ol><li>pit</li></ol>
haukku|haukkua|haukan	<i>noun</i><br><ol><li>falcon</li></ol>
hebo|hevon|hebuo	<i>noun</i><br><ol><li>horse</li></ol>
heiny|heinän|heiniä	<i>noun</i><br><ol><li>hay</li><li>grass</li></ol>
heinykuu	<i>noun</i><br><ol><li>July</li></ol>
helsingiläine|helsingiläzen|helsingilästy	<i>adj</i><br><ol><li>Helsinkian, of Helsinki (of or pertaining to the city of Helsinki)</li></ol><br><i>noun</i><br><ol><li>A Helsinkian (person living in or originating from Helsinki)</li></ol>
hiemai|hiemualoittah|hiemuanke|hiemualoile|hiemuakse|hiemualoil|hiemualpäi|hiemual|hiemuat|hiemuan|hiemuadu|hiemuas|hiemualoi|hiemuaspäi|hiemualoispäi|hiemualoinke|hiemualoilpäi|hiemuannu|hiemuattah|hiemuah|hiemualois|hiemualoikse|hiemualoih|hiemualoin|hiemualoinnu|hiemuači|hiemuale	<i>noun</i><br><ol><li>sleeve</li></ol>
hiili|hiilenny|hiilen|hiilele|hiilespäi|hiiliis|hiiliiči|hiilii|hiiliin|hiiliispäi|hiilettäh|hiiliile|hiiliikse|hiiliinke|hiiliittäh|hiilelpäi|hiiliil|hiileh|hiilel|hiiliilpäi|hiilekse|hiilet|hiiles|hiildy|hiiliih|hiiliinny|hiilenke|hiileči	<i>noun</i><br><ol><li>charcoal (heat-transformed wood)</li></ol>
hiiri|hiiriiči|hiiriil|hiirettäh|hiiriih|hiireči|hiiret|hiirele|hiiriikse|hiirel|hiiriinke|hiirelpäi|hiirdy|hiiriinny|hiirii|hiirenke|hiiriispäi|hiirekse|hiiriile|hiireh|hiiriis|hiirenny|hiirespäi|hiiriin|hiiren|hiiriilpäi|hiires|hiiriittäh	<i>noun</i><br><ol><li>mouse</li></ol>
hobju|hobjan|hobjua	<i>noun</i><br><ol><li>silver</li></ol>
hori|horiloile|horiloin|horikse|horit|horittah|horiči|horiloikse|horiloittah|horiloih|horispäi|horil|horiloilpäi|horiloinke|horinnu|horilois|horiloil|horiloi|horinke|horile|horilpäi|horih|horiloispäi|horin|horis|horiloinnu|horii	<i>noun</i><br><ol><li>clothes moth</li></ol>
huba|huvas|huviile|huviinke|hubah|hubembi|huviilpäi|hubua|huvači|huviikse|huvakse|huvan|huviispäi|huvale|hubin|huvalpäi|huviinnu|huviil|huvattah|huviittah|huvanke|huvaspäi|hubii|huviin|huval|huvat|huviis|huvannu|hubiih	<i>adj</i><br><ol><li>small, little</li></ol>
hukku|hukas|hukiispäi|hukači|hukkii|hukiinke|hukat|hukal|hukattah|hukiittah|hukiikse|hukkua|hukkiih|hukiil|hukakse|hukalpäi|hukiilpäi|hukaspäi|hukale|hukiinnu|hukkah|hukiile|hukannu|hukiis|hukiin|hukanke|hukan	<i>noun</i><br><ol><li>wolf</li></ol>
huogavuo	<i>verb</i><br><ol><li>(intransitive) to rest</li></ol>
huomenessah	<i>intj</i><br><ol><li>see you tomorrow!</li></ol><br><i>adv</i><br><ol><li>until tomorrow</li></ol>
huondes|huondestu|huondeksen	<i>noun</i><br><ol><li>morning</li></ol>
hypätä	<i>verb</i><br><ol><li>(intransitive) to jump, leap</li><li>(intransitive) to rush</li><li>(intransitive) to meddle</li></ol>
hyö	<i>pron</i><br><ol><li>they</li></ol>
häi	<i>pron</i><br><ol><li>he, she, it</li></ol>
händy|händiä|hännän	<i>noun</i><br><ol><li>tail</li></ol>
igä|igiä|ijiil|ijäl|igäh|ijäs|ijättäh|ijän|ijänny|ijät|ijiittäh|ijäle|ijäči|ijiis|ijiinke|ijälpäi|ijiilpäi|ijiikse|ijäspäi|ijiinny|ijiile|igiih|ijänke|ijiin|ijiispäi|igii|ijäkse	<i>noun</i><br><ol><li>age</li></ol>
ikkun|ikkunoin|ikkunoinnu|ikkunoikse|ikkunattah|ikkunoilpäi|ikkunoispäi|ikkunoile|ikkunakse|ikkunaspäi|ikkunas|ikkunat|ikkunoi|ikkunan|ikkunale|ikkunoil|ikkunois|ikkunači|ikkunah|ikkunalpäi|ikkunoinke|ikkunua|ikkunanke|ikkunoittah|ikkunoih|ikkunal|ikkunannu	<i>noun</i><br><ol><li>window</li></ol>
ildu|ildua|illan	<i>noun</i><br><ol><li>evening</li></ol>
istuo	<i>verb</i><br><ol><li>(intransitive) to sit</li><li>(intransitive) to go bad</li></ol>
itkie	<i>verb</i><br><ol><li>(intransitive) to cry</li></ol>
iäni|iänen|iändy	<i>noun</i><br><ol><li>voice</li><li>sound, tone</li><li>noise, cry</li></ol>
iänioppi|iäniopin|iänioppii	<i>noun</i><br><ol><li>phonology</li></ol>
ižä|ižän	<i>noun</i><br><ol><li>father</li><li>God the Father</li><li>male (of an animal)</li></ol>
jaksavuo	<i>verb</i><br><ol><li>(intransitive) to undress; to strip</li></ol>
jalgu|jalloilpäi|jallale|jallal|jallači|jallaspäi|jalloispäi|jalloinke|jallannu|jalloinnu|jallanke|jalgoi|jallakse|jallois|jalgoih|jallan|jallas|jallalpäi|jalgah|jalloile|jallat|jalloil|jalgua|jallattah|jalloin|jalloittah|jalloikse	<i>noun</i><br><ol><li>foot, leg</li></ol>
jeyrei	<i>noun</i><br><ol><li>Jew</li></ol>
jiä tervehekse|jiägiä tervehekse	<i>intj</i><br><ol><li>bye, goodbye</li></ol>
jiägiä tervehekse|jiä tervehekse	<i>intj</i><br><ol><li>bye, goodbye</li></ol>
jiähä	<i>verb</i><br><ol><li>(intransitive) to stay</li><li>(intransitive) to lag behind</li><li>(intransitive, + allative) to lag (behind)</li></ol>
jogi|jovelpäi|jovettah|jogilois|joviispäi|joviile|jovet|jogie|jogiloilpäi|joviikse|jogiih|jovele|jogiloih|jogiloinke|joviil|jogiloinnu|jogiloi|jovenke|joveči|jogiloispäi|joviittah|jogiloikse|jogiloil|jogiloile|jogii|joven|jogiloittah|joviinke|jovekse|joviilpäi|joviis|jovennu|jovel|jovespäi|joviinnu|jogeh|joviin|jogiloin|joves	<i>noun</i><br><ol><li>river</li></ol>
jos	<i>conj</i><br><ol><li>if</li></ol>
joukko|joukon|joukkuo	<i>noun</i><br><ol><li>group, cluster</li><li>team</li><li>collective</li></ol>
julgei	<i>adj</i><br><ol><li>bold</li></ol>
juvva	<i>verb</i><br><ol><li>(transitive) to drink</li><li>(intransitive) to drink</li></ol>
järvi|järvilöikse|järvet|järveči|järvenke|järvettäh|järvie|järvilöin|järviikse|järvilöispäi|järves|järviinny|järvilöittäh|järvilöih|järvilöil|järvilöinny|järvii|järvespäi|järvilöi|järvilöilpäi|järviittäh|järvekse|järviile|järvel|järvilöinke|järvilöile|järviil|järviis|järvele|järvenny|järviinke|järvilöis|järviin|järviispäi|järviilpäi|järvelpäi|järviih|järven|järveh	<i>noun</i><br><ol><li>lake</li></ol>
jügei	<i>adj</i><br><ol><li>heavy</li></ol>
kaheksas	<i>adj</i><br><ol><li>eighth</li></ol>
kaikkie hyviä	<i>intj</i><br><ol><li>all the best!</li></ol>
kala|kalakse|kaloih|kalat|kalači|kaloil|kaloinnu|kalalpäi|kalaspäi|kaloikse|kaloin|kaloispäi|kaloilpäi|kalattah|kalois|kalale|kalua|kaloi|kalah|kalal|kalannu|kaloittah|kaloinke|kalanke|kaloile|kalas|kalan	<i>noun</i><br><ol><li>fish</li></ol>
kanzalaine|kanzalastu|kanzalazen	<i>noun</i><br><ol><li>citizen</li></ol>
kanzu	<i>noun</i><br><ol><li>people</li></ol>
karjalaine|karjalaistu|karjalaizen	<i>noun</i><br><ol><li>Karelian (person)</li></ol><br><i>adj</i><br><ol><li>Karelian</li></ol>
karjalan	<i>adj</i><br><ol><li>Karelian</li></ol>
karjalan kieli|karjalan kielen|karjalan kieldy	<i>noun</i><br><ol><li>Karelian (language)</li></ol>
kaste|kastiet|kastieloile|kastieh|kastienke|kastiel|kastieloin|kastiekse|kastiele|kastieloispäi|kasties|kastieloi|kastieloinnu|kastielois|kastiespäi|kastieloinke|kastien|kastieloikse|kastielpäi|kastettu|kastieči|kastieloih|kastieloilpäi|kastieloil|kastiennu|kastiettah|kastieloittah	<i>noun</i><br><ol><li>dew</li></ol>
keittiä	<i>verb</i><br><ol><li>(transitive) to boil</li><li>(transitive) to cook</li></ol>
keittäi|keittäjiis|keittäjöispäi|keittäjäspäi|keittäjäkse|keittäjiikse|keittäjöikse|keittäjättäh|keittäjiin|keittäjii|keittäjäs|keittäjöis|keittäjöil|keittäjiil|keittäjöinny|keittäjiih|keittäjän|keittäjöittäh|keittäjöin|keittäjöilpäi|keittäjiittäh|keittäjöile|keittäjiile|keittäjäl|keittäjiilpäi|keittäjäle|keittäjänke|keittäjänny|keittäjöinke|keittäjöi|keittäjöih|keittäjät|keittäjiispäi|keittäjälpäi|keittäjäči|keittäjäh|keittäjiinny|keittäjiinke|keittäjiä	<i>noun</i><br><ol><li>cook</li></ol>
ken	<i>pron</i><br><ol><li>who?</li></ol>
kenguru|kenguruloittah|kengurut|kengurukse|kengurun|kenguruloilpäi|kenguruspäi|kenguruu|kenguruttah|kenguruloile|kenguruloinke|kengurunnu|kengurus|kenguruči|kenguruloih|kenguruloin|kenguruh|kenguruloil|kenguruloinnu|kengurule|kengurul|kengurulois|kengurulpäi|kenguruloispäi|kenguruloikse|kenguruloi|kengurunke	<i>noun</i><br><ol><li>kangaroo</li></ol>
kevätkuu	<i>noun</i><br><ol><li>March</li></ol>
kezä|keziilpäi|keziin|kezäle|kezälpäi|keziinke|kezäkse|kezänny|kezättäh|keziinny|kezäh|keziittäh|keziis|keziih|kezän|keziikse|kezäspäi|keziä|kezät|keziispäi|kezäči|keziile|keziil|kezäl|kezii|kezäs|kezänke	<i>noun</i><br><ol><li>summer</li></ol>
kezäkuu|kezäkuun|kezäkuudu	<i>noun</i><br><ol><li>June</li></ol>
kibei	<i>adj</i><br><ol><li>sore</li></ol>
kieli|kielenke|kielii|kieliile|kielel|kieleh|kieliis|kielen|kieliih|kielettäh|kielele|kieliin|kieliittäh|kieliiči|kieliil|kieldy|kielenny|kieliispäi|kieliilpäi|kieles|kielelpäi|kielet|kieleči|kielespäi|kielekse|kieliinny|kieliikse|kieliinke	<i>noun</i><br><ol><li>tongue</li><li>language</li><li>clapper (of a bell)</li></ol>
kirjaimikko|kirjaimikkuo|kirjaimikon	<i>noun</i><br><ol><li>alphabet</li></ol>
kirju|kirjoin|kirjoikse|kirjoil|kirjua|kirjoih|kirjah|kirjat|kirjoile|kirjalpäi|kirjas|kirjaspäi|kirjoilpäi|kirjoittah|kirjoispäi|kirjoinke|kirjoi|kirjois|kirjale|kirjal|kirjannu|kirjan|kirjakse|kirjoinnu|kirjači|kirjattah|kirjanke	<i>noun</i><br><ol><li>book</li><li>literacy</li><li>pattern, embroidery</li></ol>
kirjuttua	<i>verb</i><br><ol><li>(transitive) to write</li></ol>
kivari	<i>noun</i><br><ol><li>(Salmi) rifle</li></ol>
kiändiä	<i>verb</i><br><ol><li>(transitive) to turn</li><li>(transitive) to bend</li><li>(transitive, + translative) to translate</li></ol>
kiändäi|kiändäjiispäi|kiändäjättäh|kiändäjäl|kiändäjiinke|kiändäjäle|kiändäjiilpäi|kiändäjöih|kiändäjöis|kiändäjiin|kiändäjiinny|kiändäjäči|kiändäjäkse|kiändäjän|kiändäjäspäi|kiändäjii|kiändäjöilpäi|kiändäjiä|kiändäjiikse|kiändäjäh|kiändäjiittäh|kiändäjöinke|kiändäjät|kiändäjiil|kiändäjänke|kiändäjiile|kiändäjöikse|kiändäjöil|kiändäjäs|kiändäjöi|kiändäjöinny|kiändäjöispäi|kiändäjiih|kiändäjöile|kiändäjänny|kiändäjiis|kiändäjöittäh|kiändäjälpäi|kiändäjöin	<i>noun</i><br><ol><li>translator</li></ol>
kodi|kodii|koin	<i>noun</i><br><ol><li>house, home</li></ol>
kodisorzu	<i>noun</i><br><ol><li>domesticated duck</li></ol>
kohtu	<i>noun</i><br><ol><li>place</li></ol>
koiru|koirannu|koiras|koirakse|koiriispäi|koiriikse|koiralpäi|koiriinke|koiriilpäi|koirači|koiriile|koirii|koirua|koiral|koiriis|koirale|koiriinnu|koiranke|koirah|koiriin|koiraspäi|koiriih|koiriil|koiran|koirattah|koiriittah|koirat	<i>noun</i><br><ol><li>dog</li></ol>
kolmas	<i>adj</i><br><ol><li>third</li></ol>
kolmaspäivy	<i>noun</i><br><ol><li>Wednesday</li></ol>
kondii|kondiedu|kondien	<i>noun</i><br><ol><li>bear</li></ol>
korgei	<i>adj</i><br><ol><li>high</li></ol>
kormani|kormanin|kormanii	<i>noun</i><br><ol><li>pocket</li></ol>
korvu|korvua|korvan	<i>noun</i><br><ol><li>ear</li></ol>
korvusieni|korvusiendy|korvusienen	<i>noun</i><br><ol><li>mushroom of the genus Gyromitra</li></ol>
kotku|kotkua|kotkan	<i>noun</i><br><ol><li>eagle</li></ol>
kravatti	<i>noun</i><br><ol><li>bed</li></ol>
kräkyšši	<i>noun</i><br><ol><li>common teal (Anas crecca)</li></ol>
kudžoi|kudžoinke|kudžoispäi|kudžoloikse|kudžolois|kudžoittah|kudžoiči|kudžoloin|kudžoil|kudžoin|kudžoloil|kudžois|kudžoit|kudžoilpäi|kudžoidu|kudžoikse|kudžoloispäi|kudžoloile|kudžoih|kudžoile|kudžoloilpäi|kudžoloinke|kudžoloinnu|kudžoinnu|kudžoloih|kudžoloittah|kudžoloidu	<i>noun</i><br><ol><li>ant</li></ol>
kui|kuibo	<i>adv</i><br><ol><li>how? (interrogative)</li><li>how (relative)</li><li>how! (exclamatory)</li></ol><br><i>conj</i><br><ol><li>(just) like</li></ol>
kuibo elät	<i>phrase</i><br><ol><li>how are you?</li></ol>
kuibo elät-olet	<i>phrase</i><br><ol><li>how are you?</li></ol>
kuibo sinun nimi on	<i>phrase</i><br><ol><li>(informal) what is your name?</li></ol>
kuibo sinuu kučutah	<i>phrase</i><br><ol><li>(informal) what is your name?</li></ol>
kuikku|kuikanke|kuikiinke|kuikiin|kuikiispäi|kuikkah|kuikači|kuikiilpäi|kuikiil|kuikale|kuikkiih|kuikiikse|kuikaspäi|kuikal|kuikkua|kuikattah|kuikiile|kuikan|kuikannu|kuikat|kuikiinnu|kuikakse|kuikiis|kuikas|kuikiittah|kuikkii|kuikalpäi	<i>noun</i><br><ol><li>loon, diver</li></ol>
kulli|kullin	<i>noun</i><br><ol><li>curlew</li></ol>
kulunkullankaunehuz	<i>noun</i><br><ol><li>someone who is very beautiful</li></ol><br><i>adj</i><br><ol><li>very beautiful</li></ol>
kuoppu|kuoppua|kuopan	<i>noun</i><br><ol><li>pit</li></ol>
kuorʹoi|kuorʹoin|kuorʹoidu	<i>noun</i><br><ol><li>smelt (fish of the family Osmeridae)</li></ol>
kurgi|kurgie|kurren	<i>noun</i><br><ol><li>crane</li></ol>
kurikku|kurikan|kurikkua	<i>noun</i><br><ol><li>mallet</li><li>a swelling</li></ol>
kuu|kuunnu|kuuloinke|kuukse|kuuloin|kuuloile|kuuloispäi|kuuloiči|kuuloilpäi|kuuloi|kuul|kuule|kuuči|kuuloinnu|kuunke|kuut|kuuttah|kuudu|kuus|kuuloih|kuulpäi|kuuloil|kuuh|kuuspäi|kuuloittah|kuun|kuulois|kuuloikse	<i>noun</i><br><ol><li>month</li></ol>
kuvves	<i>adj</i><br><ol><li>sixth</li></ol>
kuččuo	<i>verb</i><br><ol><li>(transitive) to call</li><li>(transitive) to name</li></ol>
kylmykuu	<i>noun</i><br><ol><li>November</li></ol>
kyly|kylylöittäh|kylylöin|kylys|kylylöi|kylyy|kylyspäi|kylylöinny|kylylöikse|kylylöis|kylynny|kylyn|kylyle|kylyttäh|kylyl|kylylöile|kylyh|kylylpäi|kylylöih|kylyt|kylylöil|kylyči|kylylöispäi|kylynke|kylylöinke|kylylöilpäi|kylykse	<i>noun</i><br><ol><li>sauna</li></ol>
kylä|kylän|kyliä	<i>noun</i><br><ol><li>village, hamlet</li></ol>
kymmenes	<i>adj</i><br><ol><li>tenth</li></ol>
kyynäl|kyynäldy|kyynälen	<i>noun</i><br><ol><li>tear</li></ol>
kyzymys|küzümüs|kyzymyksen|kyzymysty	<i>noun</i><br><ol><li>question</li></ol>
kyzyö	<i>verb</i><br><ol><li>(transitive) to ask</li><li>(transitive) to demand</li></ol>
käby|käbylöinny|kävyttäh|kävykse|käbylöi|kävylpäi|käbylöispäi|käbylöil|kävys|kävynny|kävyn|kävyči|kävyt|käbylöih|käbyh|käbylöinke|kävynke|käbylöis|käbyy|käbylöile|kävyle|kävyl|kävyspäi|käbylöilpäi|käbylöittäh|käbylöikse|käbylöin	<i>noun</i><br><ol><li>cone (of a conifer)</li></ol>
käbäl|käbäläči|käbälöilpäi|käbälänke|käbälöih|käbäläkse|käbälöinke|käbälöin|käbälät|käbälöispäi|käbäläh|käbäläl|käbälöinny|käbäläs|käbälöi|käbäläspäi|käbälänny|käbälöile|käbäliä|käbälöis|käbälälpäi|käbälöikse|käbälöil|käbäläle|käbälän|käbälättäh|käbälöittäh	<i>noun</i><br><ol><li>paw</li></ol>
käbü	<i>noun</i><br><ol><li>cone (of pine)</li></ol>
kägi	<i>noun</i><br><ol><li>(rare) cuckoo</li></ol>
kägöi	<i>noun</i><br><ol><li>cuckoo</li></ol>
kämmen|kämmendy|kämmenen	<i>noun</i><br><ol><li>(anatomy) palm</li></ol>
kävelii|kävelijän|kävelijiä	<i>noun</i><br><ol><li>walker</li></ol>
käyttäi	<i>noun</i><br><ol><li>user</li></ol>
külbüvannu	<i>noun</i><br><ol><li>bathtub</li></ol>
labju	<i>noun</i><br><ol><li>shovel</li><li>spade</li><li>peel (baking tool)</li><li>oar blade</li></ol>
lahti	<i>noun</i><br><ol><li>bay, gulf</li></ol>
lammas|lambahan|lammastu	<i>noun</i><br><ol><li>sheep</li></ol>
langu	<i>noun</i><br><ol><li>yarn</li></ol>
lapsi|lapsen|lastu	<i>noun</i><br><ol><li>child</li></ol>
late|lattieloil|lattiet|lattieloilpäi|lattieloile|lattielpäi|latettu|lattieloi|lattieh|lattiel|lattieloittah|lattieloinnu|lattieči|lattielois|lattiekse|lattieloikse|lattiespäi|lattien|lattieloih|lattiettah|lattieloinke|lattienke|lattieloin|lattieloispäi|latties|lattiennu|lattiele	<i>noun</i><br><ol><li>floor</li></ol>
laukku|laukkua|laukan	<i>noun</i><br><ol><li>onion (Allium fistulosum)</li><li>onion (the vegetable)</li><li>shop</li></ol>
lehmy|lehmü	<i>noun</i><br><ol><li>cow</li></ol>
leiby|leibiä|leivän	<i>noun</i><br><ol><li>bread</li></ol>
leikata	<i>verb</i><br><ol><li>(transitive) to cut</li><li>(transitive) to cut (hair)</li><li>(transitive) to cut out</li><li>(transitive) to cut through</li><li>(transitive, medicine) to operate (on)</li></ol>
leppy|lepät|leppiih|lepäči|lepäle|lepättäh|lepäkse|lepäs|lepiile|lepänny|lepänke|lepäl|lepiinke|lepiispäi|lepiinny|leppäh|lepiil|lepiis|lepän|lepäspäi|lepiikse|lepiilpäi|leppii|lepiin|lepiittäh|leppiä|lepälpäi	<i>noun</i><br><ol><li>alder</li></ol>
leugu	<i>noun</i><br><ol><li>chin</li></ol>
levevys|levevyön|levevytty	<i>noun</i><br><ol><li>width, breadth</li></ol>
libei	<i>adj</i><br><ol><li>slippery</li></ol>
libo	<i>conj</i><br><ol><li>or</li></ol>
ligakuu	<i>noun</i><br><ol><li>October</li></ol>
liipoi|liippoloih|liippoloittah|liippoloikse|liipoile|liipoit|liippoidu|liipoiči|liippolois|liipoikse|liippoih|liipoittah|liippoloinnu|liippoloidu|liipoinke|liippoloile|liippoloin|liippoloispäi|liipois|liippoloil|liipoil|liippoloilpäi|liipoispäi|liippoloinke|liipoilpäi|liipoin|liipoinnu	<i>noun</i><br><ol><li>butterfly</li></ol>
lindu|linduloinnu|linnuspäi|linduloilpäi|linnukse|linduloile|linduu|linduloinke|linnuči|linduh|linnulpäi|linduloikse|linduloi|linnule|linnuttah|lindulois|linnunnu|linduloih|linnus|linduloil|linnul|linnunke|linnut|linduloin|linnun|linduloispäi|linduloittah	<i>noun</i><br><ol><li>bird</li></ol>
linnu|linnua|linnattah|linnaspäi|linnoih|linnois|linnakse|linnači|linnal|linnoilpäi|linnoittah|linnat|linnah|linnoinnu|linnalpäi|linnoi|linnale|linnan|linnoikse|linnoile|linnas|linnannu|linnanke|linnoispäi|linnoinke|linnoin|linnoil	<i>noun</i><br><ol><li>town, city</li><li>castle, fortress</li></ol>
loppu	<i>noun</i><br><ol><li>end</li></ol>
luba|luvaspäi|luviil|luviinke|luviikse|luviispäi|luviinnu|lubah|luviilpäi|lubii|lubiih|luviin|luviittah|luvalpäi|luvakse|luvači|luvale|luviile|luvas|luval|luvat|luvattah|luvannu|lubua|luviis|luvan|luvanke	<i>noun</i><br><ol><li>permission</li></ol>
lugie	<i>verb</i><br><ol><li>(transitive) to read</li><li>(intransitive) to count</li></ol>
lugii|lugijiin|lugijakse|lugijanke|lugijiis|lugijoinnu|lugijoin|lugijal|lugijannu|lugijoittah|lugijiile|lugijoispäi|lugijiilpäi|lugijiikse|lugijoih|lugijale|lugijois|lugijiih|lugijoilpäi|lugijiispäi|lugijiil|lugijah|lugijattah|lugijaspäi|lugijoi|lugijoinke|lugijiinnu|lugijas|lugijan|lugijat|lugijiittah|lugijoikse|lugijua|lugijiinke|lugijalpäi|lugijii|lugijoile|lugijoil|lugijači	<i>noun</i><br><ol><li>reader</li></ol>
lugu|luvun|luguu	<i>noun</i><br><ol><li>number</li><li>chapter</li><li>count</li></ol>
luu|luunnu|luuloi|luuloinke|luudu|luuloil|luuloinnu|luuloiči|luuttah|luun|luulpäi|luuloile|luuloin|luuloittah|luus|luulois|luuloikse|luuloih|luukse|luuspäi|luuh|luut|luule|luuloispäi|luul|luuči|luunke|luuloilpäi	<i>noun</i><br><ol><li>bone</li></ol>
luzikku	<i>noun</i><br><ol><li>spoon</li></ol>
lyly|lylyy|lylyn	<i>noun</i><br><ol><li>reaction wood</li></ol>
lypsiä	<i>verb</i><br><ol><li>(transitive) to milk</li><li>(intransitive) to give milk</li></ol>
lypsäi|lypsäjiä|lypsäjiin|lypsäjöih|lypsäjiittäh|lypsäjäspäi|lypsäjöinke|lypsäjöispäi|lypsäjöil|lypsäjöin|lypsäjäh|lypsäjöile|lypsäjät|lypsäjöikse|lypsäjiilpäi|lypsäjiile|lypsäjän|lypsäjöinny|lypsäjälpäi|lypsäjäs|lypsäjänke|lypsäjöilpäi|lypsäjä|lypsäjäle|lypsäjiis|lypsäjiinke|lypsäjiih|lypsäjänny|lypsäjäkse|lypsäjöis|lypsäjäl|lypsäjiil|lypsäjöi|lypsäjättäh|lypsäjii|lypsäjiinny|lypsäjöittäh|lypsäjiispäi|lypsäjiikse|lypsäjäči	<i>noun</i><br><ol><li>milker</li></ol><br><i>adj</i><br><ol><li>milking (giving milk)</li></ol>
madal|madaloikse|madalat|madaloispäi|madalaspäi|madaloih|madaloinke|madalah|madalači|madalanke|madalale|madalin|madalattah|madalua|madalas|madalal|madaloile|madalannu|madaloittah|madaloi|madalan|madalois|madalembi|madalakse|madaloinnu|madaloil|madalalpäi|madaloin|madaloilpäi	<i>adj</i><br><ol><li>low</li><li>shallow</li><li>(acoustics) low</li></ol><br><i>noun</i><br><ol><li>shallow, shoal</li></ol>
magei|magieh|magieloittah|magieloil|magieči|magiele|magiennu|magies|magieloispäi|magieloikse|magieloi|magieloinke|magiedu|magiespäi|magiet|magieloile|magielpäi|magieloilpäi|magieloih|magienke|magiel|magieloin|magieloinnu|magiekse|magien|magielois|magiettah	<i>adj</i><br><ol><li>sweet</li><li>tasty</li></ol><br><i>noun</i><br><ol><li>sweetness, sweet</li></ol>
maido|maijole|maijolois|maijoloil|maijoloile|maijottah|maijot|maijoloispäi|maiduo|maidoh|maijoloilpäi|maijonke|maijoči|maijoloittah|maijoloinnu|maijos|maijoloinke|maijoloin|maijokse|maijoloikse|maijolpäi|maijospäi|maidoloih|maijon|maijol|maidoloi|maijonnu	<i>noun</i><br><ol><li>milk</li></ol>
mandžoi|mandžoloile|mandžoiči|mandžoinnu|mandžoloih|mandžoit|mandžois|mandžoloilpäi|mandžoin|mandžoile|mandžoloinke|mandžoilpäi|mandžoispäi|mandžoittah|mandžoikse|mandžoih|mandžoloispäi|mandžoidu|mandžoloin|mandžoloikse|mandžoloinnu|mandžoloil|mandžolois|mandžoil|mandžoloidu|mandžoinke|mandžoloittah	<i>noun</i><br><ol><li>strawberry</li></ol>
mehiläine|mehiläisty|mehiläizen	<i>noun</i><br><ol><li>wild bee</li></ol>
mennä	<i>verb</i><br><ol><li>(intransitive) to go</li><li>(intransitive) to leave</li><li>(intransitive) to fit</li><li>(intransitive, of time) to go by</li><li>(intransitive, of animals) to die</li><li>(intransitive, of foods) to become wasted</li></ol>
merki|merkii|merkin	<i>noun</i><br><ol><li>mark, sign</li><li>symbol</li><li>sign, omen</li></ol>
meččy|meččiä|mečäs|meččäh|mečiis|mečäspäi|mečiispäi|mečiikse|mečäkse|mečiittäh|mečänke|mečättäh|mečiinny|mečänny|mečän|mečiile|mečäči|mečiil|mečiin|mečäl|mečälpäi|meččii|meččiih|meččü|mečät|mečäle|mečiinke|mečiilpäi	<i>noun</i><br><ol><li>forest, woods</li></ol>
mi	<i>pron</i><br><ol><li>what?</li><li>which?</li></ol>
midä kuuluu	<i>phrase</i><br><ol><li>what's up? how are you?</li></ol>
mieletöi|mielettömile|mielettömän|mielettömilpäi|mielettömäl|mielettömäkse|mielettömittäh|mielettömih|mielettömin|mielettömäči|mielettömikse|mielettömil|mielettömis|mielettömänny|mielettöminny|mielettömättäh|mielettömiä|mielettömät|mielettömäspäi|mielettömäs|mielettöminke|mielettömäh|mielettömii|mielettömispäi|mielettömänke|mielettömäle|mielettömälpäi	<i>adj</i><br><ol><li>silly, foolish</li></ol>
mieru	<i>noun</i><br><ol><li>size</li></ol>
mies|miesty|miehen	<i>noun</i><br><ol><li>man</li><li>human</li><li>husband</li></ol>
minun nimi on	<i>phrase</i><br><ol><li>my name is</li></ol>
minuu kučutah	<i>phrase</i><br><ol><li>my name is</li></ol>
minä	<i>pron</i><br><ol><li>I</li></ol>
mua|mualois|muale|muah|mualoilpäi|mualoinke|mual|muadu|muači|mualoispäi|mualoinnu|muanke|mualoin|mualoiči|mualoittah|muan|muattah|muakse|muannu|mualoikse|mualoi|muat|mualoile|mualoil|mualoih|mua|mualpäi|muas|muaspäi	<i>noun</i><br><ol><li>earth</li><li>ground, soil</li><li>world</li><li>country</li><li>place, region</li><li>colour</li></ol>
murgin	<i>noun</i><br><ol><li>lunch</li></ol>
murreh|murrehtu|murdehen	<i>noun</i><br><ol><li>dialect</li></ol>
musta	<i>adj</i><br><ol><li>black</li></ol><br><i>noun</i><br><ol><li>black</li></ol>
musto	<i>noun</i><br><ol><li>memory</li></ol>
mustu	<i>adj</i><br><ol><li>black</li></ol>
muu|muulpäi|muuloikse|muunke|muuloilpäi|muukse|muul|muuloile|muuloinnu|muuh|muuspäi|muun|muulois|muuloin|muudu|muuloinke|muunnu|muule|muuloil|muuči|muuloi|muuloittah|muuloiči|muuttah|muuloispäi|muuloih|muus|muut	<i>pron</i><br><ol><li>the other, another</li></ol><br><i>det</i><br><ol><li>other, another</li></ol>
mučoi|mučoile|mučoin|muččoloile|muččoidu|mučoiči|mučois|muččoloispäi|mučoinnu|muččoloittah|muččoloil|muččoloinke|muččoloikse|muččoloidu|mučoinke|mučoit|mučoilpäi|muččoloilpäi|mučoittah|muččoih|muččolois|mučoil|muččoloinnu|muččoloin|mučoikse|muččoloih|mučoispäi	<i>noun</i><br><ol><li>young married woman</li></ol>
muštaa	<i>verb</i><br><ol><li>To remember.</li></ol>
myö	<i>pron</i><br><ol><li>we</li></ol>
mägry|mägryä|mägrän	<i>noun</i><br><ol><li>badger</li></ol>
mähändy	<i>noun</i><br><ol><li>roe of fish</li></ol>
mähändü	<i>noun</i><br><ol><li>roe of fish</li></ol>
mänty	<i>noun</i><br><ol><li>pine</li></ol>
naine|naistu|naizen	<i>noun</i><br><ol><li>woman</li><li>lady</li></ol>
nakkulaine	<i>noun</i><br><ol><li>(informal) a Vepsian, specifically one from the Onega area</li></ol><br><i>adj</i><br><ol><li>Vepsian, something pertaining to Vepsians, specifically to the ones from the Onega area</li></ol>
našat't'eri	<i>noun</i><br><ol><li>salty liquorice</li></ol>
nelli	<i>num</i><br><ol><li>four</li></ol>
nelläs	<i>adj</i><br><ol><li>fourth</li></ol>
nelläspäivy	<i>noun</i><br><ol><li>Thursday</li></ol>
nenä|nenäs|neniinny|nenäle|neniispäi|neniil|neniin|nenäl|nenät|nenäspäi|neniile|neniih|nenäh|nenän|neniittäh|nenäči|nenäkse|nenälpäi|neniikse|nenänke|neniis|nenättäh|nenänny|neniä|neniilpäi|nenii|neniinke	<i>noun</i><br><ol><li>nose</li></ol>
nimi|nimen|nimie	<i>noun</i><br><ol><li>name</li><li>good name</li></ol><br><i>pron</i><br><ol><li>(+ negative) nothing</li></ol>
nogi|nogii|novel|nogiih|nogilois|novennu|nogie|noviispäi|nogiloittah|novenke|nogiloile|noves|nogiloi|nogiloih|novet|noviis|nogiloispäi|nogiloilpäi|noviin|novele|novespäi|noviil|nogeh|nogiloinnu|nogiloil|noviilpäi|noven|noviittah|novettah|noviikse|noviinnu|novelpäi|nogiloin|noveči|noviile|novekse|nogiloikse|noviinke|nogiloinke	<i>noun</i><br><ol><li>soot</li></ol>
nybly	<i>noun</i><br><ol><li>button</li></ol>
nälgy	<i>noun</i><br><ol><li>hunger</li></ol>
nüblü	<i>noun</i><br><ol><li>button</li></ol>
nʹaba|nʹavale|nʹavanke|nʹabua|nʹavaspäi|nʹavois|nʹavoile|nʹavannu|nʹavan|nʹavoinnu|nʹavoinke|nʹabah|nʹavoil|nʹavakse|nʹavalpäi|nʹavoin|nʹavoispäi|nʹavat|nʹaboih|nʹavas|nʹaval|nʹavoilpäi|nʹavači|nʹavoittah|nʹaboi|nʹavoikse|nʹavattah	<i>noun</i><br><ol><li>navel</li><li>pole</li><li>rhizome</li></ol>
ogurču	<i>noun</i><br><ol><li>cucumber</li></ol>
oigei	<i>adj</i><br><ol><li>right</li></ol>
ojattilaine	<i>noun</i><br><ol><li>(outdated, possibly derogatory) a Vepsian</li></ol>
olgu	<i>noun</i><br><ol><li>shoulder</li></ol>
olla	<i>verb</i><br><ol><li>(copulative) to be</li><li>(intransitive) to be, to exist</li><li>(transitive, impersonal, subject in adessive) to have</li></ol>
opastai|opastajua|opastajiih|opastajiittah|opastajoinnu|opastajoittah|opastajoil|opastajois|opastajiil|opastajiispäi|opastajoile|opastajii|opastajiis|opastajoispäi|opastajoikse|opastajiinke|opastajakse|opastajiilpäi|opastajanke|opastajale|opastajoih|opastajiinnu|opastajači|opastajah|opastajiin|opastajaspäi|opastajiile|opastajattah|opastajoinke|opastajoi|opastajas|opastajoilpäi|opastajoin|opastajiikse|opastajalpäi|opastajannu|opastajat|opastajan|opastajal	<i>noun</i><br><ol><li>teacher</li></ol><br><i>adj</i><br><ol><li>instructive</li></ol>
opastua	<i>verb</i><br><ol><li>(transitive) to teach</li></ol>
opastui|opastujoispäi|opastujiinnu|opastujua|opastujoil|opastujaspäi|opastujanke|opastujoile|opastujois|opastujiin|opastujakse|opastujoih|opastujas|opastujiittah|opastujal|opastujiispäi|opastujoikse|opastujii|opastujiile|opastujiikse|opastujiis|opastujalpäi|opastujoilpäi|opastujoinnu|opastujiilpäi|opastujattah|opastujiil|opastujat|opastujoin|opastujiinke|opastujannu|opastujoittah|opastujah|opastujači|opastujan|opastujiih|opastujoi|opastujale|opastujoinke	<i>noun</i><br><ol><li>student</li></ol>
opastuo	<i>verb</i><br><ol><li>(transitive) to learn, study</li><li>(intransitive) to be a student</li></ol>
oppie	<i>verb</i><br><ol><li>(transitive) to try, taste, try on, touch</li><li>(intransitive) to cast a protective spell</li></ol>
oraskuu	<i>noun</i><br><ol><li>May</li></ol>
ozatoi|ozattomaspäi|ozattomas|ozattomale|ozattomii|ozattomattah|ozattoman|ozattomanke|ozattomil|ozattominnu|ozattomalpäi|ozattomah|ozattomittah|ozattomua|ozattomin|ozattomannu|ozattomakse|ozattomači|ozattomat|ozattomile|ozattomikse|ozattomih|ozattomispäi|ozattomilpäi|ozattomis|ozattominke|ozattomal	<i>adj</i><br><ol><li>unlucky</li><li>poor</li><li>ill-fated</li></ol><br><i>noun</i><br><ol><li>unfortunate (unlucky person)</li></ol>
pagan|paganan	<i>noun</i><br><ol><li>pagan, heathen</li><li>sage, seer</li></ol><br><i>adj</i><br><ol><li>dirty, unclean</li></ol>
paha|pahat|pahoi|pahoilpäi|pahoinnu|pahas|pahois|pahoikse|pahan|pahua|pahannu|pahoittah|pahoispäi|pahoin|pahači|pahin|pahanke|pahale|pahalpäi|pahaspäi|pahoile|pahembi|pahal|pahoil|pahoinke|pahattah|pahakse|pahah|pahoih	<i>adj</i><br><ol><li>bad</li><li>wicked</li></ol><br><i>noun</i><br><ol><li>grief</li><li>evil</li></ol>
paidu|paijat|paijoil|paijois|paijannu|paijan|paidoih|paijanke|paijoikse|paidoi|paijoinnu|paidua|paijaspäi|paijakse|paijalpäi|paijači|paijoile|paijal|paijas|paijale|paijoilpäi|paidah|paijoispäi|paijoinke|paijoin|paijoittah|paijattah	<i>noun</i><br><ol><li>shirt</li></ol>
paikku|paikan|paikkua	<i>noun</i><br><ol><li>place, location</li></ol>
paista	<i>verb</i><br><ol><li>(intransitive, + comitative) to chat</li><li>(intransitive, + translative) to speak</li></ol>
pajo	<i>noun</i><br><ol><li>song</li></ol>
pakkaskuu	<i>noun</i><br><ol><li>January</li></ol>
palku	<i>noun</i><br><ol><li>pay</li></ol>
pardu|pardua|parran	<i>noun</i><br><ol><li>beard</li></ol>
passibo|passiboči|passiboloile|passibospäi|passibottah|passibonnu|passibuo|passibokse|passiboloil|passiboloinke|passiboloikse|passibole|passiboloih|passibot|passiboloinnu|passiboloittah|passiboloin|passibolois|passiboloispäi|passiboh|passiboloi|passibolpäi|passibon|passibol|passibonke|passibos|passiboloilpäi	<i>intj</i><br><ol><li>thanks, thank you</li></ol><br><i>noun</i><br><ol><li>thanks, thank-you</li></ol>
pedru|pedrun|pedran	<i>noun</i><br><ol><li>wild reindeer (Rangifer tarandus)</li><li>the day of Saints Peter and Paul, 29th of June.</li></ol>
pehmei|pehmiedy|pehmien	<i>adj</i><br><ol><li>soft</li><li>(phonology) palatalised</li></ol>
pehmendiä	<i>verb</i><br><ol><li>(transitive) to soften</li><li>(phonology, transitive) to palatalise</li></ol>
pehmendys|pehmendyksen|pehmendysty	<i>noun</i><br><ol><li>softening</li><li>(phonology) palatalisation</li></ol>
pehmendysmerki|pehmendysmerkii|pehmendysmerkin	<i>noun</i><br><ol><li>palatalisation mark</li></ol>
peittosana	<i>noun</i><br><ol><li>password</li></ol>
pereh|perehty|perehen	<i>noun</i><br><ol><li>family</li></ol>
perzekyly|perzekylyn	<i>noun</i><br><ol><li>a beating</li></ol>
perčanku	<i>noun</i><br><ol><li>glove</li></ol>
piirai|piirualoih|piiruakse|piirualoikse|piirualoinnu|piiruat|piiruale|piiruan|piiruannu|piiruaspäi|piirualoinke|piirualpäi|piirual|piiruattah|piiruači|piiruas|piirualoil|piirualois|piirualoile|piirualoispäi|piiruanke|piirualoittah|piirualoi|piiruah|piirualoilpäi|piirualoin|piiruadu	<i>noun</i><br><ol><li>pie</li></ol>
piirdiä	<i>verb</i><br><ol><li>to draw, to draw up, to plot</li></ol>
piiri|piiriloi|piirilois|piiriloih|piiriloinke|piirih|piiriloin|piirit|piirittah|piirispäi|piirinnu|piiriloikse|piirinke|piirile|piirilpäi|piiriči|piiriloil|piiriloinnu|piiriloile|piirii|piiris|piiriloilpäi|piiril|piirin|piiriloittah|piirikse|piiriloispäi	<i>noun</i><br><ol><li>area, region</li><li>district</li></ol>
pimei	<i>adj</i><br><ol><li>dark</li></ol>
pitky|pitkän|pitkiä	<i>adj</i><br><ol><li>long</li><li>tall</li></ol>
piä|piädy|piäči|piälöittäh|piälöikse|piälöil|piälöinny|piälöis|piälöile|piäkse|piäs|piäle|piälöiči|piälöi|piänny|piälöilpäi|piänke|piäl|piät|piälöispäi|piättäh|piälöih|piän|piäspäi|piälpäi|piälöinke|piälöin|piäh	<i>noun</i><br><ol><li>head</li><li>chief</li><li>end, tip</li></ol>
piälinnu|piälinnoilpäi|piälinnakse|piälinnači|piälinnoinnu|piälinnal|piälinnua|piälinnan|piälinnannu|piälinnoin|piälinnattah|piälinnois|piälinnah|piälinnoispäi|piälinnat|piälinnoih|piälinnaspäi|piälinnale|piälinnanke|piälinnoikse|piälinnas|piälinnoil|piälinnoinke|piälinnoile|piälinnalpäi|piälinnoittah|piälinnoi	<i>noun</i><br><ol><li>capital city</li></ol>
piätteniččy	<i>noun</i><br><ol><li>Friday</li></ol>
poigu|poijale|poigii|poijiikse|poijat|poijiile|poigah|poijiinnu|poijalpäi|poijiin|poigua|poijiis|poijannu|poijiispäi|poijal|poijiil|poijiilpäi|poijattah|poijanke|poigiih|poijakse|poijiittah|poijiinke|poijan|poijas|poijaspäi|poijači	<i>noun</i><br><ol><li>boy</li><li>son</li></ol>
polgupüörü	<i>noun</i><br><ol><li>bicycle</li></ol>
pomo	<i>noun</i><br><ol><li>boss</li></ol>
poštu	<i>noun</i><br><ol><li>post</li><li>mail</li></ol>
poštumarku	<i>noun</i><br><ol><li>stamp, postage stamp</li></ol>
poštutoimisto	<i>noun</i><br><ol><li>post office</li></ol>
prezervatiivu	<i>noun</i><br><ol><li>condom</li></ol>
puu|puuloikse|puus|puuloih|puuloinnu|puuspäi|puulois|puuloi|puuh|puuloittah|puulpäi|puudu|puukse|puun|puuloilpäi|puuloin|puule|puuloile|puuloil|puuloispäi|puut|puuloinke|puul|puuči|puunnu|puunke|puuloiči|puuttah	<i>noun</i><br><ol><li>tree</li><li>wood</li></ol>
pučči|pučilpäi|pučilois|pučit|pučiloinnu|pučiloin|pučiloilpäi|pučiloih|pučiloile|pučinnu|puččii|puččih|pučittah|pučiloikse|pučis|pučiloispäi|pučile|pučiči|pučin|pučiloinke|pučispäi|pučiloil|pučiloittah|pučiloi|pučinke|pučikse|pučil	<i>noun</i><br><ol><li>barrel</li></ol>
pyhäpäivy|pyhäpäiviä|pyhäpäivän	<i>noun</i><br><ol><li>Sunday</li></ol>
pyy|pyylöilpäi|pyylöin|pyyle|pyylöil|pyylöinny|pyynke|pyyt|pyylöikse|pyyl|pyylöis|pyylpäi|pyys|pyyh|pyylöile|pyydy|pyyttäh|pyyči|pyylöih|pyyspäi|pyylöispäi|pyylöittäh|pyylöi|pyykse|pyynny|pyylöinke|pyylöiči|pyyn	<i>noun</i><br><ol><li>hazel grouse (Tetrastes bonasia)</li></ol>
pyöry	<i>noun</i><br><ol><li>wheel.</li></ol>
päivy|päivän|päiviä	<i>noun</i><br><ol><li>Sun</li><li>day</li></ol>
päiväine|päiväizen|päiväisty	<i>noun</i><br><ol><li>(little) Sun</li></ol>
päivänlasku	<i>noun</i><br><ol><li>sunset, sundown</li><li>west</li></ol>
päivännouzu	<i>noun</i><br><ol><li>sunrise</li><li>east</li></ol>
päre|pärielöilpäi|pärielöittäh|pärielöin|pärielöi|pärielöih|pärielöile|pärielöikse|pärien|pärettä|pärieh|pärielpäi|pärienke|pärielöispäi|pärielöinke|päriele|pärielöis|pärienny|päries|päriettäh|päriespäi|pärielöinny|pärielöil|päriekse|päriel|päriet|päretty|pärieči	<i>noun</i><br><ol><li>splinter</li></ol>
päčči|päčilöinny|päčilöis|päčil|päččii|päčilöile|päčilpäi|päčilöispäi|päčilöikse|päččih|päčilöin|päčilöil|päčilöittäh|päčiči|päčispäi|päčilöinke|päčis|päčinny|päčilöi|päčikse|päčilöih|päčittäh|päčin|päčit|päčile|päčinke|päčilöilpäi	<i>noun</i><br><ol><li>stove</li><li>oven</li></ol>
püörü	<i>noun</i><br><ol><li>wheel.</li></ol>
raadivo	<i>noun</i><br><ol><li>radio broadcast</li><li>radio set</li></ol>
rahvas|rahvastu|rahvahan	<i>noun</i><br><ol><li>people</li></ol>
randu|rannakse|rannoittah|rannan|rannoilpäi|randoih|rannal|rannalpäi|rannanke|rannoil|rannale|randoi|rannoin|rannannu|rannoispäi|rannači|rannoikse|rannat|rannaspäi|randua|randah|rannoinnu|rannattah|rannois|rannoile|rannoinke|rannas	<i>noun</i><br><ol><li>shore, coast</li><li>border, edge</li><li>territory, region</li></ol>
ranneh|rannehtu|randehen	<i>noun</i><br><ol><li>(anatomy) wrist</li></ol>
ratas|rattahan|ratastu	<i>noun</i><br><ol><li>wheel</li><li>sprocket, cogwheel</li><li>reel for a seine</li></ol>
raudu|raudua|ravvan	<i>noun</i><br><ol><li>iron</li></ol>
razvu|razvua|razvan	<i>noun</i><br><ol><li>fat</li></ol>
reboi	<i>noun</i><br><ol><li>fox</li></ol>
rekluamu	<i>noun</i><br><ol><li>advertisement, ad, commercial</li></ol>
riehtil|riehtilälpäi|riehtilättäh|riehtilöinke|riehtilöikse|riehtilöi|riehtilöispäi|riehtilänny|riehtilät|riehtiläči|riehtiläh|riehtilöittäh|riehtilän|riehtiläle|riehtiläspäi|riehtilöis|riehtilöin|riehtilöinny|riehtiläl|riehtilöil|riehtiliä|riehtilöile|riehtilöih|riehtilänke|riehtilöilpäi|riehtiläs|riehtiläkse	<i>noun</i><br><ol><li>frying pan</li></ol>
riidu	<i>noun</i><br><ol><li>quarrel</li></ol>
rindu	<i>noun</i><br><ol><li>breast</li></ol>
ristikanzu|ristikanzan|ristikanzua	<i>noun</i><br><ol><li>person</li></ol>
rohkei	<i>adj</i><br><ol><li>bold</li></ol>
ruado|ruavot|ruavol|ruavolois|ruavoloinnu|ruavoloile|ruavole|ruavokse|ruadoloih|ruavoloispäi|ruavottah|ruavos|ruaduo|ruavoloinke|ruavoloikse|ruavoloin|ruavoloittah|ruavoči|ruavon|ruavoloil|ruavolpäi|ruadoh|ruadoloi|ruavoloilpäi|ruavonke|ruavospäi|ruavonnu	<i>noun</i><br><ol><li>work (act of working)</li><li>work (result of working)</li></ol>
ruakku	<i>noun</i><br><ol><li>(pathology) cancer</li></ol>
rubi|rubii|ruven	<i>noun</i><br><ol><li>scab</li><li>(pathology) pox</li><li>vaccination</li></ol>
ruoste|ruostien|ruostettu	<i>noun</i><br><ol><li>rust</li></ol>
ruottši	<i>noun</i><br><ol><li>(often derogatory) a Finn, a Lutheran</li><li>the Finnish language</li></ol>
ruočči	<i>noun</i><br><ol><li>(ethnic slur, often derogatory) a Finn, a Lutheran</li><li>(outdated) the Finnish language</li></ol>
ruskei	<i>adj</i><br><ol><li>red</li></ol>
sada	<i>num</i><br><ol><li>hundred</li></ol>
sadu	<i>noun</i><br><ol><li>garden</li></ol>
sagei	<i>adj</i><br><ol><li>thick</li></ol>
saldattu|saldatan|saldattua	<i>noun</i><br><ol><li>soldier, warrior</li></ol>
sanakirju|sanakirjale|sanakirjua|sanakirjah|sanakirjoile|sanakirjas|sanakirjal|sanakirjoinnu|sanakirjoin|sanakirjakse|sanakirjalpäi|sanakirjoih|sanakirjoittah|sanakirjannu|sanakirjattah|sanakirjoinke|sanakirjoilpäi|sanakirjoi|sanakirjoikse|sanakirjan|sanakirjat|sanakirjois|sanakirjaspäi|sanakirjanke|sanakirjoispäi|sanakirjači|sanakirjoil	<i>noun</i><br><ol><li>Synonym of sanakniigu (“dictionary”)</li></ol>
sanakniigu|sanakniigannu|sanakniigois|sanakniigal|sanakniigoile|sanakniigači|sanakniigoikse|sanakniigua|sanakniigoispäi|sanakniigaspäi|sanakniigan|sanakniigoih|sanakniigah|sanakniigakse|sanakniigoin|sanakniigoittah|sanakniigas|sanakniigat|sanakniigoil|sanakniigoinnu|sanakniigalpäi|sanakniigoinke|sanakniigale|sanakniigoilpäi|sanakniiganke|sanakniigattah|sanakniigoi	<i>noun</i><br><ol><li>dictionary</li></ol>
sangei	<i>adj</i><br><ol><li>thick</li></ol>
sanomulehti	<i>noun</i><br><ol><li>newspaper</li></ol>
sanuo	<i>verb</i><br><ol><li>(transitive) to say</li><li>(transitive) to tell</li><li>(transitive) to call</li></ol>
savi	<i>noun</i><br><ol><li>clay</li></ol>
seiny|seiniä|seinän	<i>noun</i><br><ol><li>wall</li></ol>
seiččemes	<i>adj</i><br><ol><li>seventh</li></ol>
sel'gei	<i>adj</i><br><ol><li>clear</li></ol>
sieni|sienen|siendy	<i>noun</i><br><ol><li>fungus</li><li>mushroom</li></ol>
sildu|sillan|sildua	<i>noun</i><br><ol><li>bridge</li></ol>
silmy|silmü|silmän|silmiä	<i>noun</i><br><ol><li>(anatomy) eye</li></ol>
sinine	<i>adj</i><br><ol><li>blue (color)</li></ol>
sinä	<i>pron</i><br><ol><li>thou, you (singular)</li></ol>
sit	<i>adv</i><br><ol><li>then</li><li>when</li></ol>
sizär|sizären|sizärdy	<i>noun</i><br><ol><li>sister</li></ol>
siä|siädy|siänke|siälöil|siäs|siälöilpäi|siät|siäle|siänny|siän|siäči|siäl|siälöispäi|siälöi|siäkse|siälöile|siälöih|siälöiči|siälöis|siättäh|siälöinke|siäspäi|siälöittäh|siäh|siälöinny|siälöin|siälpäi|siälöikse	<i>noun</i><br><ol><li>weather</li></ol>
soba|soviilpäi|soviinke|sobah|soviittah|soval|sobua|soviil|sovači|soviile|sovannu|sovas|sovalpäi|sovat|sovanke|soviin|sovan|soviis|sovakse|soviikse|soviinnu|sovale|soviispäi|sovattah|sovaspäi|sobiih|sobii	<i>noun</i><br><ol><li>clothing; dress</li></ol>
sobu|sobuu|sovun	<i>noun</i><br><ol><li>agreement</li></ol>
sogei	<i>adj</i><br><ol><li>blind</li></ol>
sormi|sormiilpäi|sormiin|sormiinke|sormelpäi|sormiloikse|sormeči|sormiloin|sormiloih|sormespäi|sormiloil|sormen|sormes|sormiloispäi|sormii|sormeh|sormele|sormiile|sormettah|sormiloilpäi|sormiinnu|sormenke|sormiih|sormiloi|sormet|sormiispäi|sormiloinnu|sormiloittah|sormiloile|sormie|sormiil|sormennu|sormiis|sormilois|sormiittah|sormel|sormiikse|sormiloinke|sormekse	<i>noun</i><br><ol><li>finger</li></ol>
sorzu|sorzua|sorzan	<i>noun</i><br><ol><li>duck</li></ol>
suari|suardu|suaren	<i>noun</i><br><ol><li>island</li></ol>
suga|suvannu|sugii|suvale|suviikse|suviil|suvas|suvattah|suvaspäi|suviin|sugiih|suvan|sugua|sugah|suviispäi|suvalpäi|suviinke|suvanke|suval|suviittah|suviinnu|suvači|suviile|suviilpäi|suvat|suviis|suvakse	<i>noun</i><br><ol><li>comb</li></ol>
sukku|sukkua|sukan	<i>noun</i><br><ol><li>sock</li></ol>
sulakuu	<i>noun</i><br><ol><li>April</li></ol>
suo|suoh|suottah|suoloi|suonke|suokse|suoloile|suoloih|suonnu|suos|suoloilpäi|suoloinke|suot|suoloinnu|suolpäi|suoloil|suoloispäi|suoloin|suolois|suodu|suole|suol|suospäi|suoloikse|suoči|suoloittah|suon|suoloiči	<i>noun</i><br><ol><li>bog, swamp</li></ol>
suomelaine|suomelaizen|suomelaistu	<i>noun</i><br><ol><li>a Finn, either by ethnicity or nationality</li><li>a Lutheran</li><li>an Orthodox Christian Karelian living in Finland, a Karelian from Raja-Karjala</li></ol><br><i>adj</i><br><ol><li>Finnish</li></ol>
suomen kieli	<i>noun</i><br><ol><li>The Finnish language.</li></ol>
suovattu	<i>noun</i><br><ol><li>Saturday</li></ol>
surmu|surmua|surman	<i>noun</i><br><ol><li>death</li></ol>
suu|suukse|suuloinnu|suuloih|suuloil|suut|suuloile|suunke|suudu|suun|suuloilpäi|suus|suulpäi|suul|suuloi|suuttah|suulois|suule|suunnu|suuloittah|suuloikse|suuh|suuloiči|suuloin|suuči|suuspäi|suuloinke|suuloispäi	<i>noun</i><br><ol><li>mouth</li><li>rivermouth</li></ol>
suuri	<i>adj</i><br><ol><li>big</li></ol>
suurim|suurimakse|suurimalpäi|suurimaspäi|suurimal|suurimas|suurimat|suurimoinke|suurimah|suurimattah|suurimale|suurimači|suurimoittah|suurimoinnu|suurimoispäi|suurimua|suurimoih|suurimannu|suurimoilpäi|suurimoile|suurimanke|suuriman|suurimoin|suurimoikse|suurimois|suurimoil|suurimoi	<i>noun</i><br><ol><li>grit, groat</li></ol>
sygyzy|sügüzü|sygyzyn|sygyzyy	<i>noun</i><br><ol><li>autumn, fall</li></ol>
syvvä	<i>verb</i><br><ol><li>(transitive) to eat</li><li>(intransitive) to eat</li><li>(transitive, of fish) to bite on</li><li>(transitive, of insects) to bite</li></ol>
syvyskuu	<i>noun</i><br><ol><li>September</li></ol>
syy|syynny|syynke|syyspäi|syylöil|syyči|syylöiči|syylpäi|syyn|syylöittäh|syydy|syylöispäi|syylöilpäi|syykse|syylöis|syylöi|syyh|syylöih|syyl|syylöinke|syylöile|syyttäh|syylöin|syylöikse|syys|syyt|syyle|syylöinny	<i>noun</i><br><ol><li>reason, cause</li></ol>
sähköpoštu	<i>noun</i><br><ol><li>e-mail, electronic mail</li></ol>
särgi|särrin|särgii	<i>noun</i><br><ol><li>roach (Rutilus rutilus)</li></ol>
säveldäi	<i>noun</i><br><ol><li>composer</li></ol>
taigin|taiginattah|taiginois|taiginoih|taiginoikse|taiginoi|taiginua|taiginan|taiginoispäi|taiginale|taiginoinnu|taiginoile|taiginoin|taiginoittah|taiginanke|taiginaspäi|taiginoilpäi|taiginači|taiginat|taiginas|taiginoil|taiginakse|taiginannu|taiginal|taiginoinke|taiginalpäi|taiginah	<i>noun</i><br><ol><li>dough</li><li>kneading trough</li></ol>
taivas|taivahan|taivastu	<i>noun</i><br><ol><li>sky</li></ol>
taloi|taloin|taloidu	<i>noun</i><br><ol><li>house</li></ol>
tasku|taskun|taskuu	<i>noun</i><br><ol><li>a detached pocket attached to the waist</li></ol>
tavar	<i>noun</i><br><ol><li>goods</li></ol>
tavi|tavin	<i>noun</i><br><ol><li>common teal (Anas crecca)</li></ol>
taza|tazat|tazoil|tazoinnu|tazoispäi|tazakse|tazoilpäi|tazoinke|tazas|tazale|tazoittah|tazoikse|tazua|tazoin|tazah|tazoih|tazoile|tazal|tazois|tazalpäi|tazanke|tazači|tazattah|tazannu|tazoi|tazan|tazaspäi	<i>adj</i><br><ol><li>even, level</li><li>equal, identical</li></ol>
tazavaldu|tazavallalpäi|tazavalloilpäi|tazavaldoih|tazavalloinke|tazavallas|tazavalloile|tazavalloin|tazavallale|tazavalloil|tazavallat|tazavaldah|tazavallois|tazavalloikse|tazavallaspäi|tazavallannu|tazavalloinnu|tazavallanke|tazavallakse|tazavallattah|tazavallači|tazavaldua|tazavallal|tazavaldoi|tazavalloittah|tazavallan|tazavalloispäi	<i>noun</i><br><ol><li>republic</li></ol>
televiizor	<i>noun</i><br><ol><li>television broadcast</li><li>television set</li></ol>
terveh|tervehen|tervehty	<i>adj</i><br><ol><li>healthy</li><li>healthful</li></ol><br><i>intj</i><br><ol><li>hi, hello (informal)</li></ol>
terveh taloih	<i>intj</i><br><ol><li>hello, greetings!</li></ol>
terveh teile	<i>intj</i><br><ol><li>hello, greetings (formal)</li></ol>
tervehtie	<i>verb</i><br><ol><li>(transitive) to greet</li></ol>
tervehys|tervehytty|tervehyön	<i>noun</i><br><ol><li>health</li></ol>
tikku	<i>noun</i><br><ol><li>woodpecker</li></ol>
toinargi	<i>noun</i><br><ol><li>Tuesday</li></ol>
toine	<i>adj</i><br><ol><li>second</li></ol>
traktor|traktoran	<i>noun</i><br><ol><li>tractor</li></ol>
tuatto|tuattua|tuatan	<i>noun</i><br><ol><li>father</li></ol>
tuhukuu	<i>noun</i><br><ol><li>February</li></ol>
tukku|tukan|tukkua	<i>noun</i><br><ol><li>a hair</li></ol>
tule terveh|tulgua terveh	<i>intj</i><br><ol><li>welcome!</li></ol>
tulgua terveh|tule terveh	<i>intj</i><br><ol><li>welcome!</li></ol>
tulla|tulou	<i>verb</i><br><ol><li>(intransitive) to come; to arrive</li><li>(intransitive) to work out</li><li>(intransitive + translative) to become</li><li>(intransitive + translative) to be (related)</li><li>(intransitive + translative) to fall on</li><li>(intransitive + adessive) to smell like</li><li>(impersonal + 1st infinitive) to be needed; to be important</li></ol>
tusku	<i>noun</i><br><ol><li>pain, ache</li></ol>
tyhjy|tühjü	<i>adj</i><br><ol><li>empty</li></ol>
tyttö|tytölöinke|tytöl|tytölöilpäi|tytölöinny|tytölöin|tytölöis|tytöči|tytön|tytönny|tytölöikse|tyttöh|tytökse|tytölöile|tyttölöih|tytölöittäh|tytöspäi|tytöttäh|tyttyö|tytölpäi|tyttölöi|tytöle|tytölöispäi|tytös|tytölöil|tytönke|tytöt	<i>noun</i><br><ol><li>girl</li></ol>
työ	<i>pron</i><br><ol><li>ye, you (plural)</li></ol>
täs	<i>adv</i><br><ol><li>here</li></ol>
tʹouta|tʹoutalpäi|tʹoutattah|tʹoutat|tʹoutas|tʹoutiittah|tʹoutua|tʹoutiih|tʹoutan|tʹoutal|tʹoutiil|tʹoutakse|tʹoutiispäi|tʹoutiikse|tʹoutale|tʹoutači|tʹoutaspäi|tʹoutiis|tʹoutiinnu|tʹoutiin|tʹoutii|tʹoutah|tʹoutiilpäi|tʹoutanke|tʹoutannu|tʹoutiile|tʹoutiinke	<i>noun</i><br><ol><li>aunt</li></ol>
ukrainalaine|ukrainalaizen|ukrainalaistu	<i>noun</i><br><ol><li>Ukrainian (person)</li></ol><br><i>adj</i><br><ol><li>Ukrainian</li></ol>
uksi|uksiilpäi|uksettah|uksel|ukselpäi|uksiiči|uksiis|ukseh|uksiile|uksiil|ustu|ukset|ukseči|uksiittah|uksiinke|uksiin|uksespäi|uksiispäi|uksiih|uksiinnu|uksekse|uksen|uksenke|ukses|uksele|uksennu|uksii|uksiikse	<i>noun</i><br><ol><li>door</li></ol>
uni|unettah|uniin|uniiči|uniile|unen|unennu|unele|undu|uniikse|uniis|uneči|uniilpäi|unii|unelpäi|uniinke|unes|uniil|unekse|uniispäi|unel|uneh|unet|unespäi|unenke|uniih|uniinnu|uniittah	<i>noun</i><br><ol><li>sleep</li><li>dream</li></ol>
uuličču|uuliččua|uuličan	<i>noun</i><br><ol><li>street</li></ol>
vai	<i>conj</i><br><ol><li>or</li><li>if</li></ol><br><i>adv</i><br><ol><li>only</li></ol>
vaiku|vaigu	<i>conj</i><br><ol><li>as soon as, when</li><li>but, however</li></ol><br><i>adv</i><br><ol><li>only</li></ol>
valdu|valdua|vallan|vallat|valloile|vallois|vallannu|vallalpäi|vallattah|valloilpäi|vallas|valloikse|valloinke|valdah|valloil|vallaspäi|vallale|valloispäi|vallal|valloittah|valloin|valloinnu|vallanke|valdoi|valdoih|vallakse|vallači	<i>noun</i><br><ol><li>might, power</li></ol>
valgei|valgielpäi|valgieloikse|valgieloispäi|valgieh|valgieči|valgieloi|valgieloih|valgieloin|valgies|valgiekse|valgiet|valgielois|valgiettah|valgieloinke|valgiedu|valgien|valgieloilpäi|valgieloinnu|valgieloile|valgiespäi|valgiel|valgieloil|valgiele|valgieloittah|valgienke|valgiennu	<i>adj</i><br><ol><li>white</li><li>bright</li></ol><br><i>noun</i><br><ol><li>light</li></ol>
valgo|valguo|vallon	<i>noun</i><br><ol><li>light</li></ol>
vallita	<i>verb</i><br><ol><li>(transitive) to choose, pick, elect</li></ol>
vannu	<i>noun</i><br><ol><li>bathtub</li></ol>
vačču|vačois|vačannu|vačoittah|vačoinnu|vaččoih|vačal|vačakse|vačat|vačoikse|vačoinke|vaččah|vaččua|vačalpäi|vačattah|vačoilpäi|vačoile|vačoispäi|vačan|vačaspäi|vačoin|vaččoi|vačas|vačači|vačale|vačoil|vačanke	<i>noun</i><br><ol><li>stomach</li></ol>
velgu|velgua|vellan	<i>noun</i><br><ol><li>debt</li></ol>
vellalližus	<i>noun</i><br><ol><li>duty</li></ol>
venʹalaine|venʹalaizen|venʹalaistu	<i>noun</i><br><ol><li>Russian (person)</li></ol><br><i>adj</i><br><ol><li>Russian</li></ol>
vepsäläine|vepsäläizen|vepsäläisty	<i>noun</i><br><ol><li>Vepsian (person)</li></ol>
veri|verdy|veren	<i>noun</i><br><ol><li>blood</li></ol>
veräi|veriän|veriädy	<i>noun</i><br><ol><li>door, gate</li></ol>
vezi|veziil|viel|veziittäh|veziile|viespäi|vieči|veziinny|veziih|viet|viettäh|veziiči|veziinke|veziilpäi|viekse|vedeh|veziikse|vezii|vien|vetty|veziispäi|vienny|vienke|vielpäi|vies|veziis|viele|veziin	<i>noun</i><br><ol><li>water</li></ol>
vihmu|vihmua|vihman	<i>noun</i><br><ol><li>rain</li></ol>
viijes	<i>adj</i><br><ol><li>fifth</li></ol>
viinu|viinan|viinua	<i>noun</i><br><ol><li>wine</li><li>liquor</li></ol>
villu|villua|villan	<i>noun</i><br><ol><li>wool</li></ol>
vilu|viluloi|viluloilpäi|vilun|vilulpäi|vilunnu|vilus|viluloinnu|viluttah|viluči|viluloile|viluloil|viluh|vilulois|vilut|viluloispäi|vilunke|vilukse|viluloin|vilul|viluloih|viluspäi|viluloittah|vilule|viluloinke|viluloikse|viluu	<i>noun</i><br><ol><li>cold, coldness</li></ol><br><i>adj</i><br><ol><li>cold, cool</li><li>hardhearted, callous</li></ol>
vilʹlʹu|vilʹlʹan|vilʹlʹua	<i>noun</i><br><ol><li>bread</li><li>grain, cereal</li></ol>
virdu|virdua|virran	<i>noun</i><br><ol><li>flow, stream</li></ol>
vokali|vokalii|vokalin	<i>noun</i><br><ol><li>vowel</li></ol>
vokalisobu|vokalisobuu|vokalisovun	<i>noun</i><br><ol><li>vowel harmony</li></ol>
vuo|vuot|vuolpäi|vuoloi|vuoloih|vuoloinke|vuoloikse|vuonnu|vuoloittah|vuoloispäi|vuonke|vuol|vuoloil|vuole|vuon|vuospäi|vuoloilpäi|vuolois|vuoloinnu|vuoči|vuoloin|vuokse|vuodu|vuos|vuoh|vuoloiči|vuottah|vuoloile	<i>noun</i><br><ol><li>flow, current</li></ol>
vuozi|vuvven|vuottu	<i>noun</i><br><ol><li>year</li></ol>
vyö|vyölöispäi|vyödy|vyölöil|vyölöikse|vyönke|vyölöi|vyöt|vyölöih|vyön|vyölöittäh|vyölöin|vyölöilpäi|vyölöis|vyölöile|vyöle|vyös|vyölöinny|vyölpäi|vyönny|vyöl|vyökse|vyöttäh|vyölöiči|vyöči|vyöspäi|vyölöinke|vyöh	<i>noun</i><br><ol><li>belt</li></ol>
väitöskirju	<i>noun</i><br><ol><li>doctoral thesis, dissertation</li></ol>
värtin|värtiniä|värtinöispäi|värtinöih|värtinöin|värtinänke|värtinäči|värtinöile|värtinät|värtinän|värtinäl|värtinäh|värtinälpäi|värtinättäh|värtinäkse|värtinöittäh|värtinöi|värtinöil|värtinöikse|värtinöinke|värtinäs|värtinöilpäi|värtinäspäi|värtinöinny|värtinöis|värtinänny|värtinäle	<i>noun</i><br><ol><li>spindle</li></ol>
yheksäs	<i>adj</i><br><ol><li>ninth</li></ol>
yksi	<i>num</i><br><ol><li>one</li></ol>
ystävy|ystävän|ystäviä	<i>noun</i><br><ol><li>friend</li></ol>
yö|yölöih|yökse|yöt|yös|yöči|yölöi|yölöile|yölöinke|yönke|yölpäi|yölöis|yödy|yöl|yölöittäh|yöle|yölöin|yölöiči|yölöilpäi|yöttäh|yöh|yölöispäi|yön|yöspäi|yölöil|yönny|yölöikse|yölöinny	<i>noun</i><br><ol><li>night</li></ol>
Ühtistünnüöt Kanzukunnat	<i>name</i><br><ol><li>The United Nations, the UN</li></ol>
čakata	<i>verb</i><br><ol><li>(transitive) to reprimand</li></ol>
čidži|čidžin|čidžii	<i>noun</i><br><ol><li>big sister</li></ol>
čidžoi|čidžoidu|čidžoin	<i>noun</i><br><ol><li>big sister</li></ol>
čigan	<i>noun</i><br><ol><li>Gypsy, Romani (person)</li></ol>
čirpi|čirpin|čirpii	<i>noun</i><br><ol><li>sickle</li></ol>
čiučoi|čiuččoloilpäi|čiučoit|čiuččoloispäi|čiučoilpäi|čiuččoidu|čiučois|čiuččoih|čiuččolois|čiuččoloin|čiuččoloittah|čiuččoloih|čiuččoloidu|čiučoinnu|čiučoittah|čiuččoloile|čiuččoloinke|čiuččoloil|čiučoile|čiuččoloikse|čiučoil|čiučoinke|čiučoikse|čiuččoloinnu|čiučoispäi|čiučoin|čiučoiči	<i>noun</i><br><ol><li>sparrow</li></ol>
čuaju	<i>noun</i><br><ol><li>tea</li></ol>
čuppu|čuppuu|čupun	<i>noun</i><br><ol><li>corner</li><li>home</li><li>area, region</li></ol>
čurata	<i>verb</i><br><ol><li>(intransitive) to glide</li></ol>
čyöttö|čyötölöispäi|čyötölöinny|čyötös|čyötölöittäh|čyötönke|čyötöle|čyötölpäi|čyöttölöih|čyöttyö|čyötön|čyötökse|čyötölöil|čyötölöin|čyötönny|čyötölöikse|čyötölöile|čyötöttäh|čyötölöilpäi|čyötöt|čyötöspäi|čyötöči|čyötölöinke|čyöttöh|čyötölöis|čyötöl|čyöttölöi	<i>noun</i><br><ol><li>earthworm</li></ol>
šiikkoa	<i>verb</i><br><ol><li>(intransitive) to frequently use the š-sound in speech, especially referring to the speech of Viena Karelians</li></ol>
šokoluadu	<i>noun</i><br><ol><li>chocolate</li></ol>
žiraffu	<i>noun</i><br><ol><li>giraffe</li></ol>
žuaru	<i>noun</i><br><ol><li>(pathology) fever, temperature</li></ol>
