Alman	<i>name</i><br><ol><li>Germany</li></ol>
Zipiter	<i>name</i><br><ol><li>a Creole surname</li></ol>
a	<i>verb</i><br><ol><li>to have</li></ol>
a démin	<i>phrase</i><br><ol><li>see you tomorrow.</li></ol>
abat	<i>verb</i><br><ol><li>To discourage</li><li>To depress</li></ol>
abatwa	<i>noun</i><br><ol><li>slaughterhouse; abattoir</li></ol>
abichud	<i>noun</i><br><ol><li>habit, custom</li></ol><br><i>verb</i><br><ol><li>(auxiliary) to be used to; accustomed to</li><li>(auxiliary) (with té) marks the past habitual; "used to"</li></ol>
abitan	<i>noun</i><br><ol><li>farmer</li></ol>
abitasyon	<i>verb</i><br><ol><li>plantation,farm</li></ol>
accepté	<i>verb</i><br><ol><li>to accept</li></ol>
accouché	<i>verb</i><br><ol><li>to give birth</li></ol>
accroupi	<i>verb</i><br><ol><li>to crouch, kneel</li></ol>
accusé	<i>verb</i><br><ol><li>to accuse</li></ol>
acheté	<i>verb</i><br><ol><li>to buy</li></ol>
allé	<i>verb</i><br><ol><li>to go</li></ol>
alman	<i>noun</i><br><ol><li>German (person)</li></ol>
anfan|zanfans|zanfan	<i>noun</i><br><ol><li>child</li></ol>
apprende	<i>verb</i><br><ol><li>to learn</li></ol>
apré	<i>prep</i><br><ol><li>after.</li></ol>
apòrte	<i>verb</i><br><ol><li>to bring</li></ol>
arien	<i>pron</i><br><ol><li>nothing</li></ol>
aréwa|oréwar|aréwar	<i>intj</i><br><ol><li>goodbye.</li></ol>
assiré	<i>verb</i><br><ol><li>to assure</li></ol>
assite	<i>verb</i><br><ol><li>sit</li></ol>
astè|astœr	<i>adv</i><br><ol><li>now.</li></ol>
augmenté	<i>verb</i><br><ol><li>to augment, increase</li></ol>
babillé	<i>verb</i><br><ol><li>to scold</li></ol>
baissé	<i>verb</i><br><ol><li>to lower</li></ol>
bandonné	<i>verb</i><br><ol><li>to abandon</li></ol>
barbu	<i>noun</i><br><ol><li>catfish</li></ol>
batisé	<i>verb</i><br><ol><li>to baptize</li></ol>
baton	<i>noun</i><br><ol><li>stick</li><li>stalk</li><li>rod, pole</li><li>cane, walking stick</li></ol>
beché	<i>verb</i><br><ol><li>to dig</li></ol>
besoin	<i>verb</i><br><ol><li>to need</li></ol>
billé	<i>verb</i><br><ol><li>to dress</li></ol>
bimin	<i>verb</i><br><ol><li>to damage</li></ol>
bimmé	<i>verb</i><br><ol><li>to damage</li></ol>
blan	<i>adj</i><br><ol><li>white color.</li></ol><br><i>noun</i><br><ol><li>white (color).</li></ol>
bligé	<i>verb</i><br><ol><li>to oblige</li></ol>
blié	<i>verb</i><br><ol><li>to forget</li></ol>
blé|ble	<i>adj</i><br><ol><li>blue color.</li></ol><br><i>noun</i><br><ol><li>blue (color).</li></ol>
bo|bèl	<i>adj</i><br><ol><li>handsome, beautiful, pretty.</li></ol><br><i>noun</i><br><ol><li>boyfriend.</li><li>kiss.</li></ol><br><i>verb</i><br><ol><li>to kiss.</li></ol>
boi	<i>verb</i><br><ol><li>to drink</li></ol>
boité	<i>verb</i><br><ol><li>to limp</li></ol>
bonjou	<i>intj</i><br><ol><li>hello.</li><li>hey.</li><li>good morning.</li><li>goodbye.</li></ol>
bonnwi	<i>intj</i><br><ol><li>good night.</li></ol>
bonswa|bonswar	<i>intj</i><br><ol><li>good evening, good night</li></ol>
bouché	<i>verb</i><br><ol><li>to plug</li></ol>
boucou	<i>adv</i><br><ol><li>a lot</li></ol>
boug	<i>noun</i><br><ol><li>buddy, friend.</li><li>fellow, guy, man.</li></ol><br><i>intj</i><br><ol><li>dude!</li><li>gee!</li></ol>
bouilli	<i>verb</i><br><ol><li>to beg</li></ol>
bourbé	<i>verb</i><br><ol><li>to mire, be stuck in mud</li></ol>
bourdon	<i>noun</i><br><ol><li>bee, wasp</li></ol>
bourlé	<i>verb</i><br><ol><li>to burn</li></ol>
boyfrìnn	<i>noun</i><br><ol><li>boyfriend.</li></ol>
brulé	<i>verb</i><br><ol><li>to burn</li></ol>
brun	<i>adj</i><br><ol><li>brown color.</li></ol><br><i>noun</i><br><ol><li>brown (color).</li></ol>
bwason	<i>noun</i><br><ol><li>drink, beverage</li></ol>
bèj	<i>adj</i><br><ol><li>beige color.</li></ol><br><i>noun</i><br><ol><li>beige (color).</li></ol>
bèl	<i>noun</i><br><ol><li>girlfriend.</li></ol>
béglé	<i>verb</i><br><ol><li>to moo</li></ol>
bésoin	<i>verb</i><br><ol><li>to need</li></ol>
bété	<i>verb</i><br><ol><li>to annoy</li></ol>
c'est	<i>verb</i><br><ol><li>to be</li></ol>
caché	<i>verb</i><br><ol><li>to hide</li></ol>
capabe	<i>verb</i><br><ol><li>(auxiliary) can, to be able</li></ol>
capoté	<i>verb</i><br><ol><li>to flounder</li></ol>
caressé	<i>verb</i><br><ol><li>to caress</li></ol>
cassé	<i>verb</i><br><ol><li>to break</li></ol>
cepté	<i>prep</i><br><ol><li>except</li></ol>
chagrin	<i>verb</i><br><ol><li>to be sorry</li></ol>
changé	<i>verb</i><br><ol><li>to change</li></ol>
chanté	<i>verb</i><br><ol><li>to sing</li></ol>
chapé|chappé	<i>verb</i><br><ol><li>to escape</li></ol>
chargé	<i>verb</i><br><ol><li>to load</li></ol>
chauffé	<i>verb</i><br><ol><li>to heat</li></ol>
cherché	<i>verb</i><br><ol><li>to search</li></ol>
chimin	<i>noun</i><br><ol><li>path, way</li></ol>
chivreil	<i>noun</i><br><ol><li>deer</li></ol>
choal	<i>noun</i><br><ol><li>horse</li></ol>
chéne	<i>noun</i><br><ol><li>oak</li></ol>
cognin	<i>verb</i><br><ol><li>to knock</li></ol>
colaire	<i>verb</i><br><ol><li>to be angry</li></ol>
collé	<i>verb</i><br><ol><li>to stick</li></ol>
commence	<i>verb</i><br><ol><li>to begin, commence</li></ol>
commencé	<i>verb</i><br><ol><li>to begin, commence</li></ol>
commerce	<i>noun</i><br><ol><li>business, commerce</li></ol>
comporté	<i>verb</i><br><ol><li>to behave</li></ol>
comprende	<i>verb</i><br><ol><li>to comprehend, understand</li></ol>
compté	<i>verb</i><br><ol><li>to count</li></ol>
connin	<i>verb</i><br><ol><li>to know</li></ol>
conseillé	<i>verb</i><br><ol><li>to advise</li></ol>
consolé	<i>verb</i><br><ol><li>to console</li></ol>
content	<i>verb</i><br><ol><li>to be contented</li></ol>
continié	<i>verb</i><br><ol><li>to continue</li></ol>
continuin	<i>verb</i><br><ol><li>to continue</li></ol>
contré	<i>verb</i><br><ol><li>to encounter</li></ol>
corché	<i>verb</i><br><ol><li>to skin</li></ol>
couché	<i>verb</i><br><ol><li>to sleep</li></ol>
coupé	<i>verb</i><br><ol><li>to cut</li></ol>
couri	<i>verb</i><br><ol><li>to go</li><li>to run</li></ol>
coutime	<i>verb</i><br><ol><li>to be accustom to</li></ol>
couvri	<i>verb</i><br><ol><li>to cover</li></ol>
couvé	<i>verb</i><br><ol><li>to brood</li></ol>
crai	<i>verb</i><br><ol><li>to believe</li></ol>
craqué	<i>verb</i><br><ol><li>to break, give up</li></ol>
crever	<i>verb</i><br><ol><li>to die</li></ol>
crié	<i>verb</i><br><ol><li>to shout</li><li>to cry</li></ol>
croché	<i>verb</i><br><ol><li>to hook</li></ol>
croi	<i>verb</i><br><ol><li>to believe</li></ol>
croupion	<i>noun</i><br><ol><li>rump</li></ol>
cré	<i>verb</i><br><ol><li>to create</li></ol>
culbité	<i>verb</i><br><ol><li>to overturn</li></ol>
descende	<i>verb</i><br><ol><li>to descend</li></ol>
di	<i>num</i><br><ol><li>ten.</li></ol>
di-sèt	<i>num</i><br><ol><li>seventeen.</li></ol>
dign	<i>adj</i><br><ol><li>worthy</li></ol>
dilo|dolo|dlo	<i>noun</i><br><ol><li>water</li></ol>
dimansh	<i>noun</i><br><ol><li>Sunday.</li></ol>
dinin	<i>verb</i><br><ol><li>to dine, to lunch</li></ol><br><i>noun</i><br><ol><li>dinner, lunch</li></ol>
dis	<i>num</i><br><ol><li>ten.</li></ol><br><i>verb</i><br><ol><li>to tell.</li></ol>
disparaite	<i>verb</i><br><ol><li>to disappear</li></ol>
dit	<i>verb</i><br><ol><li>to tell</li></ol>
diven	<i>noun</i><br><ol><li>wine</li></ol>
diz	<i>num</i><br><ol><li>ten.</li></ol>
diz-nèf	<i>num</i><br><ol><li>nineteen.</li></ol>
diz-wit	<i>num</i><br><ol><li>eighteen.</li></ol>
doite	<i>verb</i><br><ol><li>to owe</li></ol>
donne	<i>verb</i><br><ol><li>to give</li></ol>
donnin	<i>verb</i><br><ol><li>to give</li></ol>
dormi	<i>verb</i><br><ol><li>to sleep</li></ol>
doré	<i>adj</i><br><ol><li>golden, gold color.</li></ol><br><i>noun</i><br><ol><li>gold (color).</li></ol>
douté	<i>verb</i><br><ol><li>to doubt</li></ol>
douz	<i>num</i><br><ol><li>twelve.</li></ol>
dressé	<i>verb</i><br><ol><li>to put up</li></ol>
drogué	<i>verb</i><br><ol><li>to drug</li></ol>
dromi	<i>verb</i><br><ol><li>to sleep</li></ol>
dròl|drol	<i>adj</i><br><ol><li>odd.</li><li>funny.</li></ol>
dé	<i>num</i><br><ol><li>two.</li></ol>
débarrassé	<i>verb</i><br><ol><li>to rid</li></ol>
débatte	<i>verb</i><br><ol><li>to struggle</li></ol>
débouché	<i>verb</i><br><ol><li>to unplug</li></ol>
débourbé	<i>verb</i><br><ol><li>to get out of mud</li></ol>
déclaré	<i>verb</i><br><ol><li>to declare</li></ol>
découvri	<i>verb</i><br><ol><li>to uncover</li></ol>
défende	<i>verb</i><br><ol><li>to prohibit</li><li>to defend</li></ol>
défoncé	<i>verb</i><br><ol><li>to smash</li></ol>
dégouté	<i>verb</i><br><ol><li>to disgust</li></ol>
déjénin	<i>verb</i><br><ol><li>to have breakfast</li></ol>
démarré	<i>verb</i><br><ol><li>to untie</li></ol>
dérangé	<i>verb</i><br><ol><li>to disturb</li></ol>
dérivé	<i>verb</i><br><ol><li>to drift</li></ol>
détaché	<i>verb</i><br><ol><li>to detach</li></ol>
détruit	<i>verb</i><br><ol><li>to destroy</li></ol>
dézef	<i>noun</i><br><ol><li>egg</li></ol>
ekri	<i>verb</i><br><ol><li>to write</li></ol>
encouragé	<i>verb</i><br><ol><li>to encourage</li></ol>
endormi	<i>verb</i><br><ol><li>to go to sleep</li></ol>
engagé	<i>verb</i><br><ol><li>to involve</li></ol>
enkyete	<i>verb</i><br><ol><li>to worry</li></ol>
enlevé	<i>verb</i><br><ol><li>to remove</li></ol>
ensi	<i>adv</i><br><ol><li>thus</li></ol>
entré	<i>verb</i><br><ol><li>to enter</li></ol>
envie	<i>verb</i><br><ol><li>to desire</li></ol>
expliqué	<i>verb</i><br><ol><li>to explain</li></ol>
faim	<i>noun</i><br><ol><li>hunger</li></ol><br><i>verb</i><br><ol><li>to be hungry</li></ol>
fais	<i>verb</i><br><ol><li>to do</li></ol>
fam	<i>noun</i><br><ol><li>woman</li></ol>
fame	<i>noun</i><br><ol><li>woman</li></ol>
famiy	<i>noun</i><br><ol><li>family.</li></ol>
faraud	<i>verb</i><br><ol><li>to dress well</li></ol>
fashé	<i>adj</i><br><ol><li>upset.</li><li>angry.</li><li>(with apré) angry at/with.</li></ol>
fatigé	<i>adj</i><br><ol><li>exhausted.</li></ol>
faut	<i>verb</i><br><ol><li>it is necessary</li></ol>
fenm|famm	<i>noun</i><br><ol><li>woman, lady.</li><li>wife.</li><li>mistress.</li></ol>
fermé	<i>verb</i><br><ol><li>to close</li></ol>
filé	<i>verb</i><br><ol><li>to get away</li></ol>
fim|fim-yé	<i>adj</i><br><ol><li>hungry.</li></ol><br><i>noun</i><br><ol><li>hunger.</li></ol><br><i>verb</i><br><ol><li>to be hungry.</li></ol>
finèt	<i>noun</i><br><ol><li>window</li></ol>
fiy	<i>noun</i><br><ol><li>girl.</li><li>daughter.</li></ol>
fié	<i>verb</i><br><ol><li>to trust</li></ol>
flève	<i>noun</i><br><ol><li>river</li></ol>
forcé	<i>verb</i><br><ol><li>to make an effort</li><li>to force</li></ol>
fou|fòl	<i>adj</i><br><ol><li>mad, crazy.</li></ol>
fouillé	<i>verb</i><br><ol><li>to dig</li></ol>
fout	<i>verb</i><br><ol><li>to mock</li><li>to give (a push)</li></ol>
foute	<i>verb</i><br><ol><li>to tease, mock</li></ol>
fransé|françé	<i>noun</i><br><ol><li>French.</li></ol>
fransé kasé	<i>noun</i><br><ol><li>A name for the Louisiana Creole French language.</li></ol>
frotté	<i>verb</i><br><ol><li>to rub</li></ol>
fyær	<i>adj</i><br><ol><li>proud.</li></ol>
gagnin	<i>verb</i><br><ol><li>to have</li></ol>
gain	<i>verb</i><br><ol><li>to have</li></ol>
galopé	<i>verb</i><br><ol><li>to run</li><li>to gallop</li></ol>
galpé	<i>verb</i><br><ol><li>to run</li></ol>
garantis	<i>verb</i><br><ol><li>to guarantee</li></ol>
gardé	<i>verb</i><br><ol><li>to regard</li></ol>
gaçon|gason	<i>noun</i><br><ol><li>boy.</li></ol>
gombo	<i>noun</i><br><ol><li>A name for the Louisiana Creole French language.</li></ol>
gouté	<i>verb</i><br><ol><li>to taste</li></ol>
grandi	<i>verb</i><br><ol><li>to grow</li></ol>
gratté	<i>verb</i><br><ol><li>to scratch</li></ol>
gri	<i>adj</i><br><ol><li>grey color.</li></ol><br><i>noun</i><br><ol><li>grey (color).</li></ol>
grimpé	<i>verb</i><br><ol><li>to climb up</li></ol>
gro	<i>adj</i><br><ol><li>fat.</li><li>thick.</li><li>important.</li></ol>
grongnin	<i>verb</i><br><ol><li>to growl</li></ol>
grosri	<i>noun</i><br><ol><li>grocery</li></ol>
guéri	<i>verb</i><br><ol><li>to heal</li></ol>
gèlfrènn	<i>noun</i><br><ol><li>girlfriend.</li></ol>
gé	<i>adj</i><br><ol><li>happy.</li></ol>
génin	<i>verb</i><br><ol><li>to bother</li></ol>
habitoué	<i>verb</i><br><ol><li>to have the habit (of)</li></ol>
halé	<i>verb</i><br><ol><li>to pull</li></ol>
hibou	<i>noun</i><br><ol><li>owl</li></ol>
hé	<i>intj</i><br><ol><li>hey, hi.</li></ol>
insilté	<i>verb</i><br><ol><li>to insult</li></ol>
invité	<i>verb</i><br><ol><li>to invite</li></ol>
jalou	<i>adj</i><br><ol><li>jealous.</li></ol>
jambalaya	<i>noun</i><br><ol><li>jambalaya (rice-based dish from Louisiana)</li></ol>
jappé	<i>verb</i><br><ol><li>to bark</li></ol>
jeté	<i>verb</i><br><ol><li>to throw</li></ol>
jigé	<i>verb</i><br><ol><li>to judge</li></ol>
joinde	<i>verb</i><br><ol><li>to join</li></ol>
jonglé	<i>verb</i><br><ol><li>to think</li></ol>
jonn|jònn	<i>adj</i><br><ol><li>yellow color.</li></ol><br><i>noun</i><br><ol><li>yellow (color).</li></ol>
joué	<i>verb</i><br><ol><li>to play</li></ol>
jènn	<i>adj</i><br><ol><li>young.</li></ol>
jédi|jèdi	<i>noun</i><br><ol><li>Thursday.</li></ol>
jété	<i>verb</i><br><ol><li>to throw</li></ol>
kabann|kabònn	<i>noun</i><br><ol><li>cabin.</li><li>house.</li></ol>
kaiman	<i>noun</i><br><ol><li>alligator</li></ol>
karant	<i>num</i><br><ol><li>forty.</li></ol>
kat	<i>num</i><br><ol><li>four.</li></ol>
katre-vin	<i>num</i><br><ol><li>eighty.</li></ol>
katre-vin-dis	<i>num</i><br><ol><li>ninety.</li></ol>
katòz	<i>num</i><br><ol><li>fourteen.</li></ol>
kinz	<i>num</i><br><ol><li>fifteen.</li></ol>
kolær|kolè	<i>adj</i><br><ol><li>angry.</li></ol>
komen lê zafær	<i>phrase</i><br><ol><li>(idiomatic) how are things?</li></ol>
komen to yê	<i>phrase</i><br><ol><li>(idiomatic) how are you?</li></ol>
komen ça va	<i>phrase</i><br><ol><li>(idiomatic) how's it going?</li></ol>
konten	<i>adj</i><br><ol><li>happy.</li></ol>
koulær|koulèr|koulè	<i>noun</i><br><ol><li>color, colour.</li></ol><br><i>adj</i><br><ol><li>(of people) colored.</li></ol>
kouri-vini	<i>noun</i><br><ol><li>A name for the Louisiana Creole French language.</li></ol>
kouvær|kouvè|kouvèr	<i>adj</i><br><ol><li>cloudy, overcast.</li></ol>
kreyòl	<i>noun</i><br><ol><li>creole</li></ol>
l'Afrique	<i>name</i><br><ol><li>Africa</li></ol>
l'aimin	<i>verb</i><br><ol><li>to like, love</li></ol>
laché	<i>verb</i><br><ol><li>to release</li></ol>
lafrik	<i>name</i><br><ol><li>Africa</li></ol>
laimin	<i>verb</i><br><ol><li>to love</li></ol>
laissé	<i>verb</i><br><ol><li>to let</li></ol>
lalyans	<i>noun</i><br><ol><li>alliance</li><li>marriage</li></ol>
lamone	<i>noun</i><br><ol><li>coin</li></ol>
lamézon	<i>noun</i><br><ol><li>house.</li></ol>
lapierre	<i>noun</i><br><ol><li>stone</li></ol>
largent	<i>noun</i><br><ol><li>money</li></ol>
larjan	<i>noun</i><br><ol><li>money</li></ol>
larjên	<i>adj</i><br><ol><li>silver color.</li></ol><br><i>noun</i><br><ol><li>silver (color).</li></ol>
larozé	<i>noun</i><br><ol><li>dew.</li></ol>
las	<i>adj</i><br><ol><li>tired.</li></ol>
lashèz|shèj|lashèj|shèz	<i>noun</i><br><ol><li>chair.</li></ol>
lasmènn|smènn	<i>noun</i><br><ol><li>week.</li></ol>
latab	<i>noun</i><br><ol><li>table.</li></ol>
lhistoire	<i>noun</i><br><ol><li>story</li></ol>
li|sô|li-chin|yê|yé	<i>pron</i><br><ol><li>he.</li><li>him.</li><li>she.</li><li>her.</li><li>it.</li></ol>
liché	<i>verb</i><br><ol><li>to lick</li></ol>
limin	<i>verb</i><br><ol><li>to light</li></ol>
liv	<i>noun</i><br><ol><li>book.</li><li>pound (unit of weight).</li><li>grade (level).</li></ol>
livè|ivèr|livær	<i>noun</i><br><ol><li>winter</li></ol>
lundi|lindi	<i>noun</i><br><ol><li>Monday.</li></ol>
légliz	<i>noun</i><br><ol><li>church.</li></ol>
lékòl	<i>noun</i><br><ol><li>school.</li></ol>
lézard	<i>noun</i><br><ol><li>lizard</li></ol>
maddi|mardi	<i>noun</i><br><ol><li>Tuesday.</li></ol>
magnin	<i>verb</i><br><ol><li>to move</li></ol>
maite	<i>noun</i><br><ol><li>master</li></ol>
mamzelle	<i>noun</i><br><ol><li>mademoiselle</li></ol>
mandé	<i>verb</i><br><ol><li>to ask</li></ol>
mangé	<i>verb</i><br><ol><li>to eat</li></ol>
manzé	<i>verb</i><br><ol><li>to eat</li></ol>
marché	<i>verb</i><br><ol><li>to walk</li></ol>
mari	<i>noun</i><br><ol><li>husband.</li></ol>
maringouin	<i>noun</i><br><ol><li>mosquito</li></ol>
marié	<i>verb</i><br><ol><li>to marry</li></ol>
maron	<i>adj</i><br><ol><li>brown color.</li></ol><br><i>noun</i><br><ol><li>brown (color).</li></ol>
marré	<i>verb</i><br><ol><li>to tie</li></ol>
massacré	<i>verb</i><br><ol><li>to be dying</li></ol>
maïs	<i>noun</i><br><ol><li>corn</li></ol>
men	<i>noun</i><br><ol><li>hand</li></ol>
mercié	<i>verb</i><br><ol><li>to thank</li></ol>
mette	<i>verb</i><br><ol><li>to put</li></ol>
metté	<i>verb</i><br><ol><li>to put</li></ol>
mil	<i>num</i><br><ol><li>thousand.</li></ol>
milyon	<i>num</i><br><ol><li>million, 10⁶.</li></ol>
minou	<i>noun</i><br><ol><li>kitty.</li><li>cat.</li></ol>
mo|nouzòt|nô|no|mò|mô|nou|mwin	<i>pron</i><br><ol><li>I.</li></ol>
monn	<i>noun</i><br><ol><li>world</li></ol>
monté	<i>verb</i><br><ol><li>to climb</li><li>to mount</li></ol>
moqué	<i>verb</i><br><ol><li>to mock</li></ol>
mordé	<i>verb</i><br><ol><li>to bite</li></ol>
moune	<i>noun</i><br><ol><li>people</li><li>everybody</li></ol>
mouri	<i>verb</i><br><ol><li>to die</li></ol>
mouton	<i>noun</i><br><ol><li>sheep</li></ol>
mæg|mèg	<i>adj</i><br><ol><li>skinny, thin.</li></ol>
mèsi|mærsi	<i>intj</i><br><ol><li>thank you, thanks.</li></ol>
mékrédi|mærkrédi|mèkrèdi	<i>noun</i><br><ol><li>Wednesday.</li></ol>
mélioré	<i>verb</i><br><ol><li>to improve</li></ol>
ménin	<i>verb</i><br><ol><li>to take</li><li>to lead</li></ol>
mò|mwin	<i>pron</i><br><ol><li>me.</li></ol>
mô|mê|mâ	<i>det</i><br><ol><li>my</li></ol>
n'homme	<i>noun</i><br><ol><li>man</li></ol>
n'invitation	<i>noun</i><br><ol><li>invitation</li></ol>
nabe	<i>noun</i><br><ol><li>tree</li></ol>
nagé	<i>verb</i><br><ol><li>to swim</li></ol>
navigué	<i>verb</i><br><ol><li>to navigate</li></ol>
neyé	<i>verb</i><br><ol><li>to drown</li></ol>
nomme	<i>noun</i><br><ol><li>man</li></ol>
nommé	<i>verb</i><br><ol><li>to name</li></ol>
nonm	<i>noun</i><br><ol><li>man.</li></ol>
norphelin	<i>noun</i><br><ol><li>orphan</li></ol>
nourri	<i>verb</i><br><ol><li>to nourish</li></ol>
nouvo|nouvèl	<i>adj</i><br><ol><li>new.</li></ol>
nouvrage	<i>noun</i><br><ol><li>work</li></ol>
nouzòt|nô|no|nou	<i>pron</i><br><ol><li>we.</li><li>us.</li></ol>
nwa|nwar	<i>adj</i><br><ol><li>black color.</li><li>dark (after nightfall).</li></ol><br><i>noun</i><br><ol><li>black (color).</li><li>black person.</li></ol>
nèf	<i>num</i><br><ol><li>nine</li></ol><br><i>adj</i><br><ol><li>new.</li></ol>
nèg	<i>noun</i><br><ol><li>eagle</li></ol>
nèv	<i>num</i><br><ol><li>nine.</li></ol>
nòm	<i>noun</i><br><ol><li>man (adult male human)</li></ol>
onz	<i>num</i><br><ol><li>eleven.</li></ol>
ordonnin	<i>verb</i><br><ol><li>to order</li></ol>
oto	<i>noun</i><br><ol><li>car.</li></ol>
oté	<i>verb</i><br><ol><li>to take off</li></ol>
otònn|lotònn	<i>noun</i><br><ol><li>autumn, fall</li></ol>
oua	<i>verb</i><br><ol><li>to see</li></ol>
ouaouaron	<i>noun</i><br><ol><li>bullfrog</li></ol>
oulé	<i>verb</i><br><ol><li>to want</li></ol>
ouvri	<i>verb</i><br><ol><li>to open</li></ol>
ouété	<i>verb</i><br><ol><li>to take off</li></ol>
pagaye	<i>verb</i><br><ol><li>to paddle</li></ol>
pair	<i>verb</i><br><ol><li>to be afraid</li></ol>
paix	<i>verb</i><br><ol><li>to quiet</li><li>to be quiet</li></ol>
panier	<i>noun</i><br><ol><li>basket</li></ol>
paraite	<i>verb</i><br><ol><li>to appear</li></ol>
pardonné	<i>verb</i><br><ol><li>to forgive</li></ol>
paren	<i>noun</i><br><ol><li>parent.</li><li>relative, kinfolk.</li></ol>
parenté|paren	<i>adj</i><br><ol><li>related, family (adjective).</li></ol>
parlé	<i>verb</i><br><ol><li>to speak</li></ol>
parti	<i>verb</i><br><ol><li>to leave</li></ol>
passé	<i>verb</i><br><ol><li>to pass</li></ol>
payé	<i>verb</i><br><ol><li>to pay</li></ol>
pende	<i>verb</i><br><ol><li>to hang</li></ol>
pensé	<i>verb</i><br><ol><li>to think</li></ol>
perde	<i>verb</i><br><ol><li>to lose</li></ol>
perdi	<i>verb</i><br><ol><li>to lose</li></ol>
personne	<i>noun</i><br><ol><li>nobody, no one</li></ol>
piqué	<i>verb</i><br><ol><li>to sting</li></ol>
piti	<i>noun</i><br><ol><li>child.</li></ol>
plainde	<i>verb</i><br><ol><li>to pity</li></ol>
plein	<i>det</i><br><ol><li>many</li></ol>
poisonin	<i>verb</i><br><ol><li>to poison</li></ol>
pokapok	<i>adj</i><br><ol><li>so-so.</li></ol>
porté	<i>verb</i><br><ol><li>to carry</li></ol>
posson	<i>noun</i><br><ol><li>fish</li></ol>
posé	<i>verb</i><br><ol><li>to rest</li></ol>
poussé	<i>verb</i><br><ol><li>to push</li></ol>
prend	<i>verb</i><br><ol><li>to take</li></ol>
prende	<i>verb</i><br><ol><li>to take</li></ol>
printem	<i>noun</i><br><ol><li>spring (season)</li></ol>
proché	<i>verb</i><br><ol><li>to approach</li></ol>
profité	<i>verb</i><br><ol><li>to take advantage</li></ol>
promenin	<i>verb</i><br><ol><li>to walk</li></ol>
promette	<i>verb</i><br><ol><li>to promise</li></ol>
protégé	<i>verb</i><br><ol><li>to protect</li></ol>
prouvé	<i>verb</i><br><ol><li>to proove</li></ol>
provision	<i>noun</i><br><ol><li>provision</li></ol>
préparé	<i>verb</i><br><ol><li>to prepare</li></ol>
prété	<i>verb</i><br><ol><li>to loan</li></ol>
pwason	<i>noun</i><br><ol><li>fish</li></ol>
pè	<i>noun</i><br><ol><li>father, dad.</li></ol>
pé	<i>verb</i><br><ol><li>to be able</li></ol>
péché	<i>verb</i><br><ol><li>to prevent</li></ol>
pélé	<i>verb</i><br><ol><li>to call</li></ol>
pœr|pè	<i>adj</i><br><ol><li>scared, afraid</li></ol><br><i>verb</i><br><ol><li>to be scared.</li></ol>
quichose	<i>noun</i><br><ol><li>thing</li></ol>
quilbité	<i>verb</i><br><ol><li>to fall over</li></ol>
quitté	<i>verb</i><br><ol><li>to leave</li><li>to let</li></ol>
raconté	<i>verb</i><br><ol><li>to recount</li></ol>
raide	<i>adj</i><br><ol><li>hard, stiff</li></ol>
raison	<i>verb</i><br><ol><li>to be right</li></ol>
ramassé	<i>verb</i><br><ol><li>to gather</li></ol>
rangé	<i>verb</i><br><ol><li>to fix</li></ol>
rappelé	<i>verb</i><br><ol><li>to remember</li></ol>
raté	<i>verb</i><br><ol><li>to miss</li></ol>
recommencé	<i>verb</i><br><ol><li>to recommence</li></ol>
reconnaite	<i>verb</i><br><ol><li>to recognize</li></ol>
remercié	<i>verb</i><br><ol><li>to thank</li></ol>
remué	<i>verb</i><br><ol><li>to move</li></ol>
rende	<i>verb</i><br><ol><li>to give</li><li>to give back</li></ol>
rendi	<i>verb</i><br><ol><li>to arrive</li></ol>
renvoyé	<i>verb</i><br><ol><li>to send back</li></ol>
respiré	<i>verb</i><br><ol><li>to breathe</li></ol>
resté	<i>verb</i><br><ol><li>to kill</li></ol>
retournin	<i>verb</i><br><ol><li>to return</li></ol>
revini	<i>verb</i><br><ol><li>to return</li></ol>
rish	<i>adj</i><br><ol><li>rich (possessing wealth).</li></ol><br><i>noun</i><br><ol><li>beehive.</li></ol>
risqué	<i>verb</i><br><ol><li>to risk</li></ol>
rouj	<i>adj</i><br><ol><li>red color.</li></ol><br><i>noun</i><br><ol><li>red (color).</li></ol>
roulé	<i>verb</i><br><ol><li>to roll</li></ol>
réclamé	<i>verb</i><br><ol><li>to claim</li></ol>
récommencé	<i>verb</i><br><ol><li>to recommence</li></ol>
réfisé	<i>verb</i><br><ol><li>to refuse</li></ol>
régalé	<i>verb</i><br><ol><li>to have a great meal</li></ol>
réglé	<i>verb</i><br><ol><li>to settle</li></ol>
réissi	<i>verb</i><br><ol><li>to succeed</li></ol>
réjété	<i>verb</i><br><ol><li>to reject</li></ol>
rémarqué	<i>verb</i><br><ol><li>to remark</li></ol>
réponde	<i>verb</i><br><ol><li>to respond</li></ol>
réponne	<i>verb</i><br><ol><li>to respond</li></ol>
répété	<i>verb</i><br><ol><li>to repeat</li></ol>
résonné	<i>verb</i><br><ol><li>to resonate</li></ol>
réveillé	<i>verb</i><br><ol><li>to awaken</li></ol>
ròz|roz	<i>adj</i><br><ol><li>pink color.</li></ol><br><i>noun</i><br><ol><li>pink (color).</li></ol>
salié	<i>verb</i><br><ol><li>to greet</li></ol>
sanmdi|sammdi	<i>noun</i><br><ol><li>Saturday.</li></ol>
sauté	<i>verb</i><br><ol><li>to jump</li></ol>
sauvé	<i>verb</i><br><ol><li>to save</li></ol>
sayé	<i>verb</i><br><ol><li>to try</li></ol>
semble	<i>verb</i><br><ol><li>to resemble</li></ol>
sen	<i>num</i><br><ol><li>hundred.</li></ol>
senti	<i>verb</i><br><ol><li>to feel</li></ol>
servi	<i>verb</i><br><ol><li>to serve</li></ol>
seyé	<i>verb</i><br><ol><li>to try</li></ol>
sha	<i>noun</i><br><ol><li>cat.</li></ol>
shar	<i>noun</i><br><ol><li>car.</li><li>train.</li></ol>
shawi	<i>noun</i><br><ol><li>raccoon.</li></ol>
shin|shyin	<i>noun</i><br><ol><li>dog.</li></ol>
sho	<i>adj</i><br><ol><li>hot.</li></ol>
si	<i>num</i><br><ol><li>six.</li></ol>
sicé	<i>verb</i><br><ol><li>to suck</li></ol>
sifflé	<i>verb</i><br><ol><li>to whistle</li></ol>
sink	<i>num</i><br><ol><li>five.</li></ol>
sinkant	<i>num</i><br><ol><li>fifty.</li></ol>
sipplié	<i>verb</i><br><ol><li>to beg</li></ol>
sis	<i>num</i><br><ol><li>six.</li></ol>
siz	<i>num</i><br><ol><li>six.</li></ol>
soleil	<i>noun</i><br><ol><li>sun</li></ol>
sou	<i>adj</i><br><ol><li>drunk.</li></ol><br><i>noun</i><br><ol><li>cent.</li></ol>
soufflé	<i>verb</i><br><ol><li>to blow</li></ol>
souffri	<i>verb</i><br><ol><li>to suffer</li></ol>
soulé	<i>verb</i><br><ol><li>to inebriate</li></ol>
surprende	<i>verb</i><br><ol><li>to surprise</li></ol>
surveillé	<i>verb</i><br><ol><li>to monitor, survey</li></ol>
swaf	<i>adj</i><br><ol><li>thirsty.</li></ol><br><i>verb</i><br><ol><li>to be thirsty.</li></ol>
swar	<i>noun</i><br><ol><li>evening</li></ol>
swasant	<i>num</i><br><ol><li>sixty.</li></ol>
swasant-dis	<i>num</i><br><ol><li>seventy.</li></ol>
swat	<i>conj</i><br><ol><li>or</li></ol>
sèrsèl	<i>adj</i><br><ol><li>teal color.</li></ol><br><i>noun</i><br><ol><li>teal (color).</li><li>teal (duck).</li></ol>
sèt	<i>num</i><br><ol><li>seven.</li></ol>
sèz	<i>num</i><br><ol><li>sixteen.</li></ol>
sécoué	<i>verb</i><br><ol><li>to shake</li></ol>
sériyé|sériyé-yé	<i>adj</i><br><ol><li>serious.</li></ol><br><i>noun</i><br><ol><li>emergency.</li></ol>
sézon	<i>noun</i><br><ol><li>season (quarter of a year)</li></ol>
sô|sê|sâ	<i>det</i><br><ol><li>his.</li><li>her.</li><li>its.</li></ol>
taché	<i>verb</i><br><ol><li>to attach</li></ol>
taillé	<i>verb</i><br><ol><li>to whip</li></ol>
taqué	<i>verb</i><br><ol><li>to attack</li></ol>
tcheu	<i>noun</i><br><ol><li>tail</li></ol>
tchoué	<i>verb</i><br><ol><li>to kill</li></ol>
tchui	<i>verb</i><br><ol><li>to cook</li></ol>
tchullé	<i>verb</i><br><ol><li>to step back</li></ol>
tchué	<i>verb</i><br><ol><li>to kill</li></ol>
teigné	<i>verb</i><br><ol><li>to put out</li></ol>
tende	<i>verb</i><br><ol><li>to wait</li></ol>
tendé	<i>verb</i><br><ol><li>to hear</li></ol>
timid	<i>adj</i><br><ol><li>shy, timid.</li></ol>
tiré	<i>verb</i><br><ol><li>to pull</li></ol>
to|tô|twa	<i>pron</i><br><ol><li>you (singular), thou</li></ol>
tombe	<i>verb</i><br><ol><li>to fall</li></ol>
tombé	<i>verb</i><br><ol><li>to fall</li></ol>
tonbe	<i>verb</i><br><ol><li>to start to, to begin (doing something)</li></ol>
tordé	<i>verb</i><br><ol><li>to twist</li></ol>
tortie	<i>noun</i><br><ol><li>turtle</li></ol>
tortillé	<i>verb</i><br><ol><li>to twist</li></ol>
touché	<i>verb</i><br><ol><li>to touch</li></ol>
tournin	<i>verb</i><br><ol><li>to return</li></ol>
tracassé	<i>verb</i><br><ol><li>to bother</li><li>to worry</li></ol>
trahi	<i>verb</i><br><ol><li>to betray</li></ol>
trainin	<i>verb</i><br><ol><li>to drag</li></ol>
traité	<i>verb</i><br><ol><li>to treat</li></ol>
trappé	<i>verb</i><br><ol><li>to catch</li></ol>
travaille	<i>verb</i><br><ol><li>to work</li></ol>
tremblé	<i>verb</i><br><ol><li>to tremble</li></ol>
trent	<i>num</i><br><ol><li>thirty.</li></ol>
tripé	<i>verb</i><br><ol><li>to trap</li></ol>
tris	<i>adj</i><br><ol><li>sad.</li></ol>
tro	<i>adv</i><br><ol><li>too much</li></ol>
trouvé	<i>verb</i><br><ol><li>to find</li></ol>
trèz	<i>num</i><br><ol><li>thirteen.</li></ol>
trò|trwa	<i>num</i><br><ol><li>three.</li></ol>
twa	<i>pron</i><br><ol><li>(informal) you.</li></ol>
tâté	<i>verb</i><br><ol><li>to feel</li></ol>
té	<i>particle</i><br><ol><li>past tense marker</li></ol>
tô	<i>pron</i><br><ol><li>your.</li></ol>
un|ènn|in|unn	<i>article</i><br><ol><li>a, an.</li></ol><br><i>num</i><br><ol><li>one</li></ol>
unn|ènn|in|un	<i>article</i><br><ol><li>a, an.</li></ol><br><i>num</i><br><ol><li>one</li></ol>
va	<i>verb</i><br><ol><li>(auxiliary) to go</li><li>to go</li></ol>
vanté	<i>verb</i><br><ol><li>to boast</li></ol>
vayan	<i>adj</i><br><ol><li>nice.</li><li>beautiful, pretty, handsome.</li><li>awesome.</li></ol><br><i>adv</i><br><ol><li>nicely.</li></ol>
vende	<i>verb</i><br><ol><li>to sell</li></ol>
vendredi|vendrédi	<i>noun</i><br><ol><li>Friday.</li></ol>
vengé	<i>verb</i><br><ol><li>to avenge</li></ol>
verti	<i>verb</i><br><ol><li>to notify</li></ol>
vidé	<i>verb</i><br><ol><li>to empty</li></ol>
vin	<i>num</i><br><ol><li>twenty.</li></ol>
vin-ché-un	<i>num</i><br><ol><li>twenty-one.</li></ol>
vini	<i>verb</i><br><ol><li>to come</li><li>to become</li></ol>
vini pli mal	<i>verb</i><br><ol><li>to worsen</li></ol>
vive	<i>verb</i><br><ol><li>to live</li></ol>
vlopé	<i>verb</i><br><ol><li>to envelop</li></ol>
voltizé	<i>verb</i><br><ol><li>to fly</li></ol>
volé	<i>verb</i><br><ol><li>to steal</li><li>to fly</li></ol>
voudré	<i>verb</i><br><ol><li>to wish</li></ol>
vouzòt|zòt|vô|ouzòt|zo	<i>pron</i><br><ol><li>(formal, polite) you.</li><li>you all, y'all.</li></ol>
voyé	<i>verb</i><br><ol><li>to send</li></ol>
vyolé|vyolèt	<i>adj</i><br><ol><li>purple color.</li></ol><br><i>noun</i><br><ol><li>purple (color).</li></ol>
vyé|vye	<i>adj</i><br><ol><li>old.</li></ol>
vè|væt|vèr|vær	<i>adj</i><br><ol><li>green color.</li></ol><br><i>noun</i><br><ol><li>green (color).</li><li>glass.</li></ol>
vé	<i>verb</i><br><ol><li>to want</li></ol>
vô	<i>det</i><br><ol><li>(formal, polite) your.</li><li>y'all's.</li></ol>
wit	<i>num</i><br><ol><li>eight.</li></ol>
yé|yê	<i>pron</i><br><ol><li>they.</li><li>them.</li></ol>
yê	<i>pron</i><br><ol><li>their.</li></ol>
zaffair	<i>noun</i><br><ol><li>business, affair</li></ol>
zami|zamis	<i>noun</i><br><ol><li>friend</li></ol>
zanimo	<i>noun</i><br><ol><li>animal</li></ol>
zoranj	<i>adj</i><br><ol><li>orange color.</li></ol><br><i>noun</i><br><ol><li>orange (color).</li><li>orange (fruit).</li></ol>
zozo	<i>noun</i><br><ol><li>bird</li></ol>
zéro	<i>num</i><br><ol><li>zero, nought.</li></ol>
ç’apé kouri	<i>phrase</i><br><ol><li>(idiomatic) is it going well?</li></ol>
èrè	<i>adj</i><br><ol><li>happy.</li></ol>
èté	<i>noun</i><br><ol><li>summer (season)</li></ol>
éksité	<i>adj</i><br><ol><li>excited</li></ol>
épouz	<i>noun</i><br><ol><li>wife.</li></ol>
étonné	<i>verb</i><br><ol><li>to astonish</li></ol>
étouffé	<i>verb</i><br><ol><li>to smother</li></ol>
òdomobìl	<i>noun</i><br><ol><li>car.</li></ol>
