A	<i>character</i><br><ol><li>The first letter of the Maori alphabet, written in the Latin script.</li></ol>
Ahitereiria	<i>name</i><br><ol><li>Australia (a continent and country in Oceania)</li></ol>
Ahuriri	<i>name</i><br><ol><li>Napier (a city in New Zealand)</li></ol>
Airangi	<i>name</i><br><ol><li>Ireland (a country in Europe)</li></ol>
Airani	<i>name</i><br><ol><li>Ireland (a country in Europe)</li></ol>
Anakora	<i>name</i><br><ol><li>Angola (a country in Africa)</li></ol>
Aoraki	<i>name</i><br><ol><li>(southern dialect) Mount Cook (tallest mountain in New Zealand)</li></ol>
Aotearoa	<i>name</i><br><ol><li>(obsolete) North Island (of New Zealand)</li><li>New Zealand</li><li>The Māori name for the national anthem of New Zealand, God Defend New Zealand</li></ol>
Apārangi	<i>name</i><br><ol><li>Mercury (planet)</li></ol>
Aranga	<i>name</i><br><ol><li>(holiday) (Te ~) Easter</li></ol>
Arapeinia	<i>name</i><br><ol><li>Albania (a country in Europe)</li></ol>
Aratiria	<i>name</i><br><ol><li>Algeria (a country in Africa)</li></ol>
Atepaihānia	<i>name</i><br><ol><li>Azerbaijan (a country in Europe and Asia)</li></ol>
Ateria	<i>name</i><br><ol><li>Austria (a country in Europe)</li></ol>
Ekuatoa	<i>name</i><br><ol><li>Ecuador (a country in South America)</li></ol>
Eritēria	<i>name</i><br><ol><li>Eritrea (a country in Africa)</li></ol>
Etiopia	<i>name</i><br><ol><li>Ethiopia (a country in Africa)</li></ol>
Etonia	<i>name</i><br><ol><li>Estonia (a country in Europe)</li></ol>
Haimona	<i>name</i><br><ol><li>Simon (biblical)</li></ol>
Haina	<i>name</i><br><ol><li>China (a country in Asia)</li></ol>
Haipara	<i>name</i><br><ol><li>Cyprus (a country in Europe)</li></ol>
Hakihea	<i>name</i><br><ol><li>The seventh month of the maramataka (lunar calendar), corresponding to November–December of the Gregorian calendar.</li><li>Alpha Centauri</li></ol>
Hanekeria	<i>name</i><br><ol><li>Hungary (a country in Europe)</li></ol>
Hapani	<i>name</i><br><ol><li>Japan (a country in Asia)</li></ol>
Harare|harare	<i>adj</i><br><ol><li>bleary-eyed</li></ol>
Haratua	<i>name</i><br><ol><li>The twelfth month of the maramataka (lunar calendar), corresponding to April–May of the Gregorian calendar.</li></ol>
Hawaiki	<i>name</i><br><ol><li>(mythology) Hawaiki, the legendary homeland of the Maori before their arrival at Aotearoa (New Zealand), and also the underworld.</li></ol>
Henekara	<i>name</i><br><ol><li>Senegal (a country in Africa)</li></ol>
Hepetema	<i>name</i><br><ol><li>September (month)</li></ol>
Here-turi-kōkā|Hereturikōkā	<i>name</i><br><ol><li>The third month of the maramataka (lunar calendar), corresponding to July–August of the Gregorian calendar.</li></ol>
Heretaunga	<i>name</i><br><ol><li>Hastings (a city in New Zealand)</li></ol>
Herewini	<i>name</i><br><ol><li>Selwyn (surname; place name)</li></ol>
Himiona	<i>name</i><br><ol><li>Simeon (biblical)</li></ol>
Hina	<i>name</i><br><ol><li>personification of the Moon</li></ol>
Hineitīweka	<i>name</i><br><ol><li>Jupiter (planet)</li></ol>
Hinekōrako	<i>noun</i><br><ol><li>moonbow</li></ol>
Hingapoa	<i>name</i><br><ol><li>Singapore (a country in Asia)</li></ol>
Hiri	<i>name</i><br><ol><li>Chile (a country in South America)</li></ol>
Hiri Rānaka	<i>name</i><br><ol><li>Sri Lanka (a country in Asia)</li></ol>
Hiria	<i>name</i><br><ol><li>Syria (a country in Asia)</li></ol>
Hironga	<i>name</i><br><ol><li>Geelong (a city in Victoria, Australia)</li></ol>
Hoana	<i>name</i><br><ol><li>Joanna (biblical)</li></ol>
Hoani	<i>name</i><br><ol><li>John (biblical)</li></ol>
Hongonui	<i>name</i><br><ol><li>The second month of the maramataka (lunar calendar), corresponding to June–July of the Gregorian calendar.</li></ol>
Hononga-o-Amerika	<i>name</i><br><ol><li>the United States (a country in North America)</li></ol>
Hopatāone	<i>name</i><br><ol><li>Hobart (the capital of Tasmania, Australia)</li></ol>
Horowākia	<i>name</i><br><ol><li>Slovakia</li></ol>
Hui-tanguru|Huitanguru|Rūhī-te-rangi	<i>name</i><br><ol><li>The ninth month of the maramataka (lunar calendar), corresponding to January–February of the Gregorian calendar.</li></ol>
Huitene	<i>name</i><br><ol><li>Sweden</li></ol>
Huiterangi	<i>name</i><br><ol><li>Switzerland</li></ol>
Hune	<i>name</i><br><ol><li>June (month)</li></ol>
Hurinamo	<i>name</i><br><ol><li>Suriname (a country in South America)</li></ol>
Hurināme	<i>name</i><br><ol><li>Suriname (a country in South America)</li></ol>
Huwa	<i>name</i><br><ol><li>Suva (the capital of Fiji)</li></ol>
Hāmoa	<i>name</i><br><ol><li>Samoa (a country in Oceania)</li></ol>
Hāmuera	<i>name</i><br><ol><li>Samuel (biblical)</li></ol>
Hānuere	<i>name</i><br><ol><li>January (month)</li></ol>
Hātarei	<i>noun</i><br><ol><li>Saturday</li></ol>
Hēmi	<i>name</i><br><ol><li>James (biblical)</li></ol>
Hōhepa	<i>name</i><br><ol><li>Joseph (biblical)</li></ol>
Hōrana	<i>name</i><br><ol><li>The Netherlands</li></ol>
Hōrano	<i>name</i><br><ol><li>Jordan (a country in Asia)</li></ol>
Hōria	<i>name</i><br><ol><li>Georgia (a country in Europe and Asia)</li></ol>
Hūhana	<i>name</i><br><ol><li>Susanna (biblical)</li></ol>
Hūmārie	<i>name</i><br><ol><li>Somalia (a country in Africa)</li></ol>
Hūrae	<i>name</i><br><ol><li>July (month)</li></ol>
Hūtāne	<i>name</i><br><ol><li>Sudan (a country in Africa)</li></ol>
Ihowā	<i>name</i><br><ol><li>Jehovah, the Lord</li></ol>
Ingarihi	<i>name</i><br><ol><li>English (nationality)</li></ol>
Initonīhia	<i>name</i><br><ol><li>Indonesia (a country in Asia)</li></ol>
Irāia	<i>name</i><br><ol><li>Elijah (biblical character).</li></ol>
Itāria	<i>name</i><br><ol><li>Italy</li></ol>
Kaiana	<i>name</i><br><ol><li>Guyana (a country in South America)</li><li>Guiana (a region of South America)</li></ol>
Kaiana Wīwī	<i>name</i><br><ol><li>French Guiana (an overseas department and region of France in South America)</li></ol>
Kaikōura	<i>name</i><br><ol><li>A town on the east coast of the South Island of New Zealand.</li></ol>
Kamapōtia	<i>name</i><br><ol><li>Cambodia (a country in Asia)</li></ol>
Kamarūna	<i>name</i><br><ol><li>Cameroon (a country in Africa)</li></ol>
Karapōnia	<i>name</i><br><ol><li>California (a state of the United States)</li></ol>
Katatānga	<i>name</i><br><ol><li>Kazakhstan (a country in Asia)</li></ol>
Katā	<i>name</i><br><ol><li>Qatar (a country in Asia)</li></ol>
Kehitāna	<i>name</i><br><ol><li>Kyrgyzstan (a country in Asia)</li></ol>
Kini	<i>name</i><br><ol><li>Guinea (a country in Africa)</li></ol>
Kini Ekuatoria	<i>name</i><br><ol><li>Equatorial Guinea (a country in Africa)</li></ol>
Kini Pihō	<i>name</i><br><ol><li>Guinea-Bissau (a country in Africa)</li></ol>
Kirihi	<i>name</i><br><ol><li>Greece (a country in Europe)</li></ol>
Kirihimete	<i>name</i><br><ol><li>Christmas</li></ol>
Kirikiriroa	<i>name</i><br><ol><li>Hamilton (a city in New Zealand)</li></ol>
Kiripāti	<i>name</i><br><ol><li>Kiribati (a country in Oceania)</li></ol>
Kohi-tātea|Kohitātea|Rehua	<i>name</i><br><ol><li>The eighth month of the maramataka (lunar calendar), corresponding to December–January of the Gregorian calendar.</li></ol>
Komoro	<i>name</i><br><ol><li>Comoros (a country in Africa)</li></ol>
Koramia	<i>name</i><br><ol><li>Columbia River (a river in the United States)</li></ol>
Koria	<i>name</i><br><ol><li>Korea</li></ol>
Koromōpia	<i>name</i><br><ol><li>Colombia (a country in South America)</li></ol>
Koroātia	<i>name</i><br><ol><li>Croatia (a country in Europe)</li></ol>
Kotahitanga o ngā Whenua Ārapi	<i>name</i><br><ol><li>United Arab Emirates (a country in Asia)</li></ol>
Kuamu	<i>name</i><br><ol><li>Guam (a country in Oceania)</li></ol>
Kuki Airani	<i>name</i><br><ol><li>Cook Islands (a country in Oceania)</li></ol>
Kāmaka	<i>name</i><br><ol><li>Gibraltar</li></ol>
Kāna	<i>name</i><br><ol><li>Ghana (a country in Africa)</li></ol>
Kānapera	<i>name</i><br><ol><li>Canberra (the capital of Australia)</li></ol>
Kānata	<i>name</i><br><ol><li>Canada (a country in North America)</li></ol>
Kāpona	<i>name</i><br><ol><li>Gabon (a country in Africa)</li></ol>
Kāta	<i>name</i><br><ol><li>Chad (a country in Africa)</li></ol>
Kēnia	<i>name</i><br><ol><li>Kenya (a country in Africa)</li></ol>
Kēpa Weriti	<i>name</i><br><ol><li>Cape Verde (a country in Africa)</li></ol>
Kīngitanga Kotahi	<i>name</i><br><ol><li>The United Kingdom</li></ol>
Kōngo	<i>name</i><br><ol><li>Congo (a country in Africa)</li><li>Democratic Republic of the Congo (a country in Africa)</li></ol>
Kōpū	<i>name</i><br><ol><li>Venus (planet)</li></ol>
Kōpūnui	<i>name</i><br><ol><li>Jupiter (planet)</li></ol>
Mahuru	<i>name</i><br><ol><li>The fourth month of the maramataka (lunar calendar), corresponding to August–September of the Gregorian calendar.</li><li>Alphard (star)</li></ol>
Makanui	<i>name</i><br><ol><li>A Big Mac, a type of hamburger.</li></ol>
Mane|Manei	<i>noun</i><br><ol><li>Monday</li></ol>
Marako	<i>name</i><br><ol><li>Morocco (a country in Africa)</li></ol>
Marakāhia	<i>name</i><br><ol><li>Madagascar (a country in Africa)</li></ol>
Marāwi	<i>name</i><br><ol><li>Malawi (a country in Africa)</li></ol>
Marēhia	<i>name</i><br><ol><li>Malaysia (a country in Asia)</li></ol>
Matakahaka	<i>name</i><br><ol><li>Madagascar (a country in Africa)</li></ol>
Matawhero	<i>name</i><br><ol><li>Mars (planet)</li></ol>
Matiu	<i>name</i><br><ol><li>Matthew (biblical)</li></ol>
Mauritānia	<i>name</i><br><ol><li>Mauritania (a country in Africa)</li></ol>
Mei	<i>name</i><br><ol><li>May (month)</li></ol>
Meri	<i>name</i><br><ol><li>Mary (biblical)</li></ol>
Mihi	<i>name</i><br><ol><li>(obsolete) A title given to a white female</li></ol>
Mihinare	<i>noun</i><br><ol><li>Anglican</li></ol>
Mikaere	<i>name</i><br><ol><li>Michael (Archangel)</li></ol>
Miki Kiore	<i>name</i><br><ol><li>Mickey Mouse</li></ol>
Miriama	<i>name</i><br><ol><li>Miriam (biblical)</li></ol>
Mohapiki	<i>name</i><br><ol><li>Mozambique (a country in Africa)</li></ol>
Mohi	<i>name</i><br><ol><li>Moses (biblical)</li></ol>
Mohikau	<i>name</i><br><ol><li>Moscow (the capital of Russia)</li></ol>
Mongōria	<i>name</i><br><ol><li>Mongolia (a country in Asia)</li></ol>
Moroko	<i>name</i><br><ol><li>Morocco (a country in Africa)</li></ol>
Morotawa	<i>name</i><br><ol><li>Moldova</li></ol>
Māehe	<i>name</i><br><ol><li>March (month)</li></ol>
Māka	<i>name</i><br><ol><li>Mark (biblical)</li></ol>
Māori	<i>name</i><br><ol><li>the Māori culture or ethnicity</li><li>a member of the Māori culture or ethnicity, a Māori person</li></ol>
Māoritanga	<i>noun</i><br><ol><li>Maoriness, Maoritanga</li></ol>
Māri	<i>name</i><br><ol><li>Mali (a country in Africa)</li></ol>
Māta|Maata	<i>name</i><br><ol><li>Martha (biblical)</li></ol>
Māui	<i>name</i><br><ol><li>(mythology) A trickster and a hero who had his superhuman strength and shapeshifting, believed to have created the islands of New Zealand from a great fish that he caught.</li></ol>
Namīpia	<i>name</i><br><ol><li>Namibia (a country in Africa)</li></ol>
Nepōra	<i>name</i><br><ol><li>Nepal (a country in Asia)</li></ol>
Ngā Motu Horomona	<i>name</i><br><ol><li>Solomon Islands (a country in Oceania)</li></ol>
Ngāika	<i>name</i><br><ol><li>Niger (a country in Africa)</li></ol>
Ngāitiria	<i>name</i><br><ol><li>Nigeria (a country in Africa)</li></ol>
Ngāmotu	<i>name</i><br><ol><li>Ngāmotu (a city in New Zealand)</li></ol>
Ngāti	<i>noun</i><br><ol><li>Prefix for an iwi or hapū; tribal group.</li></ol>
Nipono	<i>name</i><br><ol><li>Japan</li></ol>
Niukāhera	<i>name</i><br><ol><li>Newcastle (a city in New South Wales, Australia)</li><li>Any other city called Newcastle</li></ol>
Noema	<i>name</i><br><ol><li>November (month)</li></ol>
Nāhinara	<i>name</i><br><ol><li>National (National Party)</li></ol>
Nōwei	<i>name</i><br><ol><li>Norway</li></ol>
Oketopa	<i>name</i><br><ol><li>October (month)</li></ol>
Paenga-whāwhā|Paengawhāwhā	<i>name</i><br><ol><li>The eleventh month of the maramataka (lunar calendar), corresponding to March–April of the Gregorian calendar.</li><li>Pegasus (consellation)</li></ol>
Pakangakite	<i>name</i><br><ol><li>Warsaw</li></ol>
Pakitāne	<i>name</i><br><ol><li>Pakistan (a country in Asia)</li></ol>
Papua Nūkini	<i>noun</i><br><ol><li>(location) Papua New Guinea</li></ol>
Paraire	<i>noun</i><br><ol><li>Friday</li></ol>
Parakai	<i>name</i><br><ol><li>Paraguay (a country in South America)</li></ol>
Paramata	<i>name</i><br><ol><li>Parramatta (a city in New South Wales, Australia)</li></ol>
Pararata	<i>name</i><br><ol><li>Ballarat (a city in Victoria, Australia)</li></ol>
Paratipotoka	<i>name</i><br><ol><li>Vladivostok (a city in Russia, Asia)</li></ol>
Pareārau	<i>name</i><br><ol><li>Jupiter (planet)</li><li>Saturn (planet)</li></ol>
Parihitini	<i>name</i><br><ol><li>Palestine (a country in Asia)</li></ol>
Parī	<i>name</i><br><ol><li>Paris (the capital of France)</li></ol>
Parīhi	<i>name</i><br><ol><li>Brazil (a country in South America)</li></ol>
Pearīni	<i>name</i><br><ol><li>Berlin (the capital of Germany)</li></ol>
Pehiamu	<i>name</i><br><ol><li>Belgium (a country in Europe)</li></ol>
Penehūera	<i>name</i><br><ol><li>Venezuela (a country in South America)</li></ol>
Peraha	<i>noun</i><br><ol><li>(location) Perth, a city in Australia</li></ol>
Perū	<i>name</i><br><ol><li>Peru (a country in South America)</li></ol>
Pipiri	<i>name</i><br><ol><li>The first month of the maramataka (lunar calendar), corresponding to May–June of the Gregorian calendar. Begins after the rising of Matariki.</li></ol>
Pirihira	<i>name</i><br><ol><li>Priscilla (biblical)</li></ol>
Piripane	<i>name</i><br><ol><li>Brisbane (the capital of Queensland, Australia)</li></ol>
Piripi	<i>name</i><br><ol><li>Philip (biblical)</li></ol>
Piripīni	<i>name</i><br><ol><li>Philippines (a country in Asia)</li></ol>
Pita	<i>name</i><br><ol><li>Peter (biblical)</li></ol>
Poho o Pita	<i>name</i><br><ol><li>Vatican</li></ol>
Poihākena	<i>name</i><br><ol><li>Sydney, Port Jackson (the capital of New South Wales, Australia)</li></ol>
Poipiripi	<i>name</i><br><ol><li>Melbourne, Port Philip (the capital of Victoria, Australia)</li></ol>
Poriwana	<i>name</i><br><ol><li>Botswana (a country in Africa)</li></ol>
Poriwia	<i>name</i><br><ol><li>Bolivia (a country in South America)</li></ol>
Poronai	<i>name</i><br><ol><li>Brunei (a country in Asia)</li></ol>
Potukara	<i>name</i><br><ol><li>Portugal (a country in Europe)</li></ol>
Poutū-te-rangi|Poutūterangi	<i>name</i><br><ol><li>The tenth month of the maramataka (lunar calendar), corresponding to February–March of the Gregorian calendar.</li><li>Altair (star in Aquila)</li></ol>
Pukamata	<i>noun</i><br><ol><li>Facebook</li></ol>
Purukāria	<i>name</i><br><ol><li>Bulgaria (a country in Europe)</li></ol>
Puruniti	<i>name</i><br><ol><li>Burundi (a country in Africa)</li></ol>
Pākaratēhi	<i>name</i><br><ol><li>Bangladesh (a country in Asia)</li></ol>
Pāniora	<i>name</i><br><ol><li>Spain</li></ol>
Pāora	<i>name</i><br><ol><li>Paul (biblical)</li></ol>
Pārau	<i>name</i><br><ol><li>Palau (a country in Oceania)</li></ol>
Pēnina	<i>name</i><br><ol><li>Benin (a country in Africa)</li></ol>
Pēpuere	<i>name</i><br><ol><li>February (month)</li></ol>
Pērara	<i>name</i><br><ol><li>Belarus (a country in Europe)</li></ol>
Pōhutukawa	<i>name</i><br><ol><li>Sterope</li></ol>
Pōngia-Herekōmina	<i>name</i><br><ol><li>Bosnia and Herzegovina (a country in Europe)</li></ol>
Pōrana	<i>name</i><br><ol><li>Poland</li></ol>
Pūkina	<i>name</i><br><ol><li>Burkina Faso (a country in Africa)</li></ol>
Raipiri	<i>name</i><br><ol><li>Liberia (a country in Africa)</li></ol>
Rakiura	<i>name</i><br><ol><li>Stewart Island</li></ol>
Rangawhenua	<i>name</i><br><ol><li>Jupiter (planet)</li></ol>
Rehua	<i>name</i><br><ol><li>star Antares in Scorpius</li></ol>
Reipa	<i>name</i><br><ol><li>Labour (Labour Party)</li></ol>
Repanona	<i>name</i><br><ol><li>Lebanon (a country in Asia)</li></ol>
Rerehu	<i>name</i><br><ol><li>Antares, the brightest star in the constellation Scorpius</li></ol>
Riria	<i>name</i><br><ol><li>Lydia (biblical)</li></ol>
Rituānia	<i>name</i><br><ol><li>Lithuania</li></ol>
Romeinia	<i>name</i><br><ol><li>Romania</li></ol>
Rotorua	<i>name</i><br><ol><li>Rotorua (a city in New Zealand)</li></ol>
Rutu	<i>name</i><br><ol><li>Ruth (biblical).</li></ol>
Rāapa	<i>name</i><br><ol><li>Wednesday</li></ol>
Rāhera	<i>name</i><br><ol><li>Rachel (biblical)</li></ol>
Rāhina	<i>name</i><br><ol><li>Monday</li></ol>
Rāhoroi	<i>name</i><br><ol><li>Saturday</li></ol>
Rāmere	<i>name</i><br><ol><li>Friday</li></ol>
Rāniera	<i>name</i><br><ol><li>Daniel (biblical)</li></ol>
Rāoho	<i>name</i><br><ol><li>Laos (a country in Asia)</li></ol>
Rāpare	<i>name</i><br><ol><li>Thursday</li></ol>
Rārima	<i>name</i><br><ol><li>Friday</li></ol>
Rārua	<i>name</i><br><ol><li>Tuesday</li></ol>
Rātahi	<i>name</i><br><ol><li>Monday</li></ol>
Rātapu	<i>noun</i><br><ol><li>Sunday</li></ol>
Rātoru	<i>name</i><br><ol><li>Wednesday</li></ol>
Rātū	<i>name</i><br><ol><li>Tuesday</li></ol>
Rāwana	<i>name</i><br><ol><li>Rwanda (a country in Africa)</li></ol>
Rāwhia	<i>name</i><br><ol><li>Latvia</li></ol>
Rāwhā	<i>name</i><br><ol><li>Thursday</li></ol>
Rāwiri	<i>name</i><br><ol><li>David (biblical)</li></ol>
Rīpeka	<i>name</i><br><ol><li>Rebekah (biblical)</li></ol>
Rīpia	<i>name</i><br><ol><li>Libya (a country in Africa)</li></ol>
Rōpū Kākāriki	<i>name</i><br><ol><li>Green Party</li></ol>
Rōpū Nāhinara	<i>name</i><br><ol><li>National Party</li></ol>
Rōpū Reipa	<i>name</i><br><ol><li>Labour Party</li></ol>
Rōtihia	<i>name</i><br><ol><li>Rhodesia (a country in Africa)</li></ol>
Rūhia	<i>name</i><br><ol><li>Russia (a country in Europe and Asia)</li></ol>
Rūhī-te-rangi	<i>name</i><br><ol><li>star in Scorpius</li></ol>
Tahikitāna	<i>name</i><br><ol><li>Tajikistan (a country in Asia)</li></ol>
Taina	<i>name</i><br><ol><li>China (a country in Asia)</li></ol>
Tairana	<i>name</i><br><ol><li>Thailand (a country in Asia)</li></ol>
Taiwana	<i>name</i><br><ol><li>Taiwan (a country in Asia)</li></ol>
Takero	<i>name</i><br><ol><li>Mercury (planet)</li></ol>
Tangaroa	<i>name</i><br><ol><li>Neptune (Roman god)</li><li>Neptune (planet)</li></ol>
Tauranga	<i>name</i><br><ol><li>Tauranga (a city in New Zealand)</li></ol>
Te Araone	<i>name</i><br><ol><li>Sierra Leone (a country in Africa)</li></ol>
Te Kamopia	<i>name</i><br><ol><li>The Gambia (a country in Africa)</li></ol>
Te Kūrae Matomato	<i>name</i><br><ol><li>Cape Verde (a country in Africa)</li></ol>
Te Moana-a-Toi	<i>name</i><br><ol><li>Bay of Plenty (a sea and bay of the Bay of Plenty Region, North Island, New Zealand)</li><li>Bay of Plenty (an administrative region in the North Island, New Zealand, surrounding the eponymous bay)</li></ol>
Te Papa-i-Oea	<i>name</i><br><ol><li>Palmerston North (a city in New Zealand)</li></ol>
Te Puku o Āwherika	<i>name</i><br><ol><li>Central African Republic (a country in Africa)</li></ol>
Te Pāpaka-a-Māui	<i>name</i><br><ol><li>Australia (a country in Oceania)</li></ol>
Te Rotorua-nui-a-Kahumatamomoe	<i>name</i><br><ol><li>Rotorua (a city in New Zealand)</li></ol>
Te Tai Rei	<i>name</i><br><ol><li>Côte d'Ivoire (a country in Africa)</li></ol>
Te Whanganui-a-Tara	<i>name</i><br><ol><li>Wellington (the capital city of New Zealand)</li></ol>
Tenemāka	<i>name</i><br><ol><li>Denmark (a country in Europe)</li></ol>
Teroto	<i>name</i><br><ol><li>Lesotho (a country in Africa)</li></ol>
Tiaina	<i>name</i><br><ol><li>China (a country in Asia)</li></ol>
Tiamana	<i>name</i><br><ol><li>Germany (a country in Europe)</li></ol>
Timuwawe	<i>name</i><br><ol><li>Zimbabwe (a country in Africa)</li></ol>
Tiorangi	<i>name</i><br><ol><li>Iceland (a country in Europe)</li></ol>
Tipūti	<i>name</i><br><ol><li>Djibouti (a country in Africa)</li></ol>
Tiriporī	<i>name</i><br><ol><li>Tripoli (a city in Libya, Africa)</li></ol>
Toko	<i>name</i><br><ol><li>Togo (a country in Africa)</li></ol>
Tukumanatānga	<i>name</i><br><ol><li>Turkmenistan (a country in Asia)</li></ol>
Tuna	<i>name</i><br><ol><li>(Maori mythology) An eel-god, the son of Manga-wai-roa, one of the lesser Maori deities who lived in a water hole called Muri-wai-o-ata.</li></ol>
Tāhuna	<i>name</i><br><ol><li>Queenstown (a city in New Zealand)</li></ol>
Tāite	<i>name</i><br><ol><li>Thursday</li></ol>
Tāke	<i>name</i><br><ol><li>Turkey (a country in Asia and Europe)</li></ol>
Tāmaki Makaurau|Tāmaki Makau Rau	<i>name</i><br><ol><li>Auckland (a city in New Zealand)</li></ol>
Tāmati	<i>name</i><br><ol><li>Thomas (biblical)</li></ol>
Tāmipia	<i>name</i><br><ol><li>Zambia (a country in Africa)</li></ol>
Tānahia	<i>name</i><br><ol><li>Tanzania (a country in Africa)</li></ol>
Tāonewhīra	<i>name</i><br><ol><li>Townsville (a city in Queensland, Australia)</li></ol>
Tāwini	<i>name</i><br><ol><li>Darwin (the capital of the Northern Territory, Australia)</li></ol>
Tēpene	<i>name</i><br><ol><li>Stephen (biblical)</li></ol>
Tīekia	<i>name</i><br><ol><li>Czechia (a country in Europe)</li></ol>
Tīhema	<i>name</i><br><ol><li>December (month)</li></ol>
Tīmoa	<i>name</i><br><ol><li>Timor Leste (a country in Asia)</li></ol>
Tīmoti	<i>name</i><br><ol><li>Timothy (biblical)</li></ol>
Tōkio	<i>name</i><br><ol><li>Tokyo (a city in Japan, Asia)</li></ol>
Tūnihia	<i>name</i><br><ol><li>Tunisia (a country in Africa)</li></ol>
Tūranga-nui-a-Kiwa	<i>name</i><br><ol><li>Gisborne (a city in New Zealand)</li></ol>
Tūrei	<i>name</i><br><ol><li>Tuesday</li></ol>
Tūwaru	<i>name</i><br><ol><li>Tuvalu (a country in Oceania)</li></ol>
Tūwehe Tīeke	<i>name</i><br><ol><li>Czech Republic (a country in Europe)</li></ol>
Uhipeketāne	<i>name</i><br><ol><li>Uzbekistan (a country in Asia)</li></ol>
Ukanata	<i>name</i><br><ol><li>Uganda (a country in Africa)</li></ol>
Ukāna	<i>name</i><br><ol><li>Uganda (a country in Africa)</li></ol>
Ukānga	<i>name</i><br><ol><li>Uganda (a country in Africa)</li></ol>
Urukoi	<i>name</i><br><ol><li>Uruguay (a country in South America)</li></ol>
Urukuai	<i>name</i><br><ol><li>Uruguay (a country in South America)</li></ol>
Waiharakeke	<i>name</i><br><ol><li>Blenheim (a city in New Zealand)</li></ol>
Waihōpai	<i>name</i><br><ol><li>Invercargill (a city in New Zealand)</li></ol>
Waitangi	<i>name</i><br><ol><li>A locality in the Bay of Islands on the North Island of New Zealand.</li><li>A town on the west coast of the Chatham Islands, New Zealand.</li></ol>
Warerangi	<i>name</i><br><ol><li>Eswatini (a country in Africa)</li><li>Swaziland (a country in Africa)</li></ol>
Wenehūera	<i>name</i><br><ol><li>Venezuela (a country in South America)</li></ol>
Wenerei	<i>name</i><br><ol><li>Wednesday</li></ol>
Whakatū	<i>name</i><br><ol><li>Nelson (a city in New Zealand)</li></ol>
Whangārei	<i>name</i><br><ol><li>Whangarei (a city in New Zealand)</li></ol>
Whenuatū	<i>name</i><br><ol><li>Vanuatu (a country in Oceania)</li></ol>
Whinirana|Whinarana	<i>name</i><br><ol><li>Finland (a country in Europe)</li></ol>
Whiringa ki Tawhiti	<i>noun</i><br><ol><li>Pluto</li></ol>
Whiringa-ā-nuku	<i>name</i><br><ol><li>The fifth month of the maramataka (lunar calendar), corresponding to September–October of the Gregorian calendar.</li></ol>
Whiringa-ā-rangi	<i>name</i><br><ol><li>The sixth month of the maramataka (lunar calendar), corresponding to October–November of the Gregorian calendar.</li></ol>
Whitināma	<i>name</i><br><ol><li>Vietnam (a country in Asia)</li></ol>
Whitināmu	<i>name</i><br><ol><li>Vietnam (a country in Asia)</li></ol>
Whērangi	<i>name</i><br><ol><li>Uranus (planet)</li></ol>
Whītī	<i>name</i><br><ol><li>Fiji (a country in Oceania)</li><li>Fijian</li></ol>
Wīwī	<i>name</i><br><ol><li>France (a country in Europe)</li></ol><br><i>noun</i><br><ol><li>Frenchman; the French</li></ol><br><i>adj</i><br><ol><li>French</li></ol>
Wūrongikongi	<i>name</i><br><ol><li>Wollongong (a city in New South Wales, Australia)</li></ol>
a	<i>particle</i><br><ol><li>of</li></ol>
aha	<i>pron</i><br><ol><li>what (interrogative pronoun)</li></ol>
ahakoa	<i>conj</i><br><ol><li>although</li></ol>
ahi	<i>noun</i><br><ol><li>fire (oxidation reaction)</li></ol>
aho	<i>noun</i><br><ol><li>fishing line; string</li></ol>
ahoroa	<i>noun</i><br><ol><li>moon</li><li>bright moonlight</li></ol>
ahu	<i>verb</i><br><ol><li>to care for</li></ol>
ahunga	<i>noun</i><br><ol><li>bearing, heading</li><li>generation</li><li>heap</li></ol>
ahurewa	<i>noun</i><br><ol><li>oracle, shrine, sacred place</li><li>throne</li></ol>
ahuwhenua	<i>adj</i><br><ol><li>industrious, hard-working</li></ol><br><i>noun</i><br><ol><li>agriculture</li></ol>
aihe	<i>noun</i><br><ol><li>The short-beaked common dolphin, Delphinus delphis</li></ol>
aihi	<i>noun</i><br><ol><li>dolphin</li></ol>
aihikirīmi	<i>noun</i><br><ol><li>ice cream</li></ol>
aikiha	<i>noun</i><br><ol><li>handkerchief</li></ol>
aitanga	<i>noun</i><br><ol><li>progeny, descendants</li></ol>
aitu	<i>noun</i><br><ol><li>(mythology) atua of disaster and death</li><li>demons</li><li>sickness</li><li>calamity, misery</li><li>grief, sorrow</li><li>woe</li></ol><br><i>adj</i><br><ol><li>sorrowful</li><li>woeful</li></ol>
aitua	<i>noun</i><br><ol><li>accident, bad luck</li></ol>
aka	<i>noun</i><br><ol><li>root (of plant)</li></ol>
akaaka	<i>noun</i><br><ol><li>fibrous vines or roots</li><li>nerve</li><li>state of turmoil</li></ol>
ake nei	<i>particle</i><br><ol><li>Indicates an expression is related to a future time.</li></ol>
akiaki	<i>noun</i><br><ol><li>red-billed gull</li></ol>
akiri|akiria|akiritia|akiringia	<i>noun</i><br><ol><li>rejection, disposal, discarding</li></ol><br><i>verb</i><br><ol><li>to discard, reject</li></ol>
ako	<i>verb</i><br><ol><li>to learn</li></ol>
akonga	<i>noun</i><br><ol><li>pupil</li></ol>
akoranga	<i>noun</i><br><ol><li>learning, lesson</li></ol>
aku|tō mātou|ō māua|ōna|ā mātou|alienable possession|ā kōrua|ā koutou|ō tāua|ō rāua|tāna|ōu|inalienable possession|tōna|tā mātou|tā rātou|tā koutou|ō rātou|tō koutou|ō tātou|ō koutou|tōku|tō tātou|taku|tā tāua|ō mātou|tō kōrua|tō tāua|āku|tana|tō māua|ō kōrua|tō rāua|tā tātou|ō|possessor has control of the relationship.|tāku|ā tāua|tō|possessor has no control over the relationship.|ā rāua|tō rātou|ā rātou|ā māua|tā kōrua|aku|tā rāua|ā tātou|ōku|tāu|tōu|tā māua|ana|āu|āna	<i>pron</i><br><ol><li>my (when talking of more than one thing)</li></ol>
amana	<i>noun</i><br><ol><li>almond</li></ol>
amapaea	<i>noun</i><br><ol><li>umpire</li></ol>
amio	<i>verb</i><br><ol><li>to wander</li></ol>
amo	<i>verb</i><br><ol><li>carry (on a litter)</li><li>charge, attack</li></ol>
amokura	<i>noun</i><br><ol><li>red-tailed tropicbird</li></ol>
amorangi	<i>noun</i><br><ol><li>priest</li><li>leader</li><li>emblem</li></ol>
ana	<i>noun</i><br><ol><li>cave</li></ol>
anahe	<i>adj</i><br><ol><li>alone, only</li></ol>
anahere	<i>noun</i><br><ol><li>angel, archangel</li></ol>
anaterope	<i>noun</i><br><ol><li>antelope</li></ol>
anga	<i>noun</i><br><ol><li>shell</li></ol><br><i>verb</i><br><ol><li>face, begin</li></ol>
angaanga	<i>noun</i><br><ol><li>shell, seashell</li><li>skeleton, skull</li><li>chief</li></ol>
angaangamate	<i>noun</i><br><ol><li>back</li></ol>
anganui	<i>verb</i><br><ol><li>to face towards</li></ol>
angengi	<i>noun</i><br><ol><li>a type of fish</li></ol>
angi	<i>verb</i><br><ol><li>to float through the air</li></ol>
angiangi	<i>noun</i><br><ol><li>gentle breeze</li></ol>
angina	<i>noun</i><br><ol><li>death</li></ol>
anipā	<i>adj</i><br><ol><li>anxious, uneasy</li><li>solicitous</li></ol>
aniroro	<i>adj</i><br><ol><li>giddy, dizzy</li></ol>
anu	<i>adj</i><br><ol><li>cold</li></ol>
anuanu	<i>noun</i><br><ol><li>aversion</li></ol>
anuhe	<i>noun</i><br><ol><li>caterpillar of the convolvulus hawk-moth (Agrius convolvuli)</li></ol>
anō	<i>adv</i><br><ol><li>again</li></ol>
ao	<i>noun</i><br><ol><li>daytime</li><li>world</li><li>cloud</li></ol>
aonga	<i>noun</i><br><ol><li>dawn</li></ol>
apa|aparia	<i>verb</i><br><ol><li>to heap; layer; stack</li></ol><br><i>noun</i><br><ol><li>layer; level</li><li>servant; slave</li><li>spiritual beings; ancestral spirits</li></ol>
apakura	<i>noun</i><br><ol><li>lament, dirge</li></ol>
aponga	<i>noun</i><br><ol><li>stack, pile</li></ol>
apārangi	<i>noun</i><br><ol><li>group of noble people</li></ol>
ara|arahia|aratia|araia	<i>noun</i><br><ol><li>path (a trail for the use of, or worn by, pedestrians)</li><li>path (a course taken)</li><li>path (a metaphorical course)</li><li>path (a method or direction of proceeding)</li><li>road (a way for travel)</li><li>road (a path in life)</li><li>street (paved part of road in a village or a town)</li><li>track (beaten path)</li><li>track (course; way)</li><li>track (path or course laid out for a race or exercise)</li><li>track (permanent way; the rails)</li><li>way (wide path)</li></ol><br><i>verb</i><br><ol><li>to rise up, awake, arise, revive</li></ol>
araheke	<i>noun</i><br><ol><li>stairs</li></ol>
arapiki	<i>noun</i><br><ol><li>stairs</li></ol>
araroa	<i>noun</i><br><ol><li>corridor, passage</li></ol>
arata	<i>noun</i><br><ol><li>lettuce</li></ol>
arawhata	<i>noun</i><br><ol><li>stairs</li><li>ladder</li><li>bridge</li></ol>
areinga	<i>noun</i><br><ol><li>cricket (sport)</li></ol>
arero	<i>noun</i><br><ol><li>(anatomy) tongue</li></ol>
arewhana	<i>noun</i><br><ol><li>elephant</li></ol>
ariki	<i>noun</i><br><ol><li>paramount chief of a tribe, the most senior by descent of the rangatira (chiefs) of the tribe</li><li>first-born male or female in a family of high rank</li><li>leader</li></ol>
aro|arohia|arotia|arongia	<i>noun</i><br><ol><li>front (facing side)</li><li>front (weather)</li></ol><br><i>verb</i><br><ol><li>(transitive) to turn toward something or someone</li></ol>
aroaro	<i>noun</i><br><ol><li>presence</li><li>front of a person</li></ol>
aroha	<i>noun</i><br><ol><li>Love.</li></ol>
aromaunga	<i>noun</i><br><ol><li>mountain face</li></ol>
aronga	<i>noun</i><br><ol><li>definition</li></ol>
aronga hōkaka	<i>noun</i><br><ol><li>sexual orientation</li></ol>
aronga taera	<i>noun</i><br><ol><li>sexual orientation</li></ol>
aronui	<i>noun</i><br><ol><li>fathom</li></ol><br><i>adj</i><br><ol><li>suitable</li></ol>
aroākapa	<i>noun</i><br><ol><li>foreboding, bad omen</li><li>row, rank; front row</li></ol>
aru|arumia	<i>noun</i><br><ol><li>chase</li><li>pursuit</li></ol><br><i>verb</i><br><ol><li>to chase</li><li>to follow, pursue</li></ol>
arua|ārua	<i>adj</i><br><ol><li>entangled</li></ol>
aruhe	<i>noun</i><br><ol><li>fern, root</li></ol>
ata	<i>noun</i><br><ol><li>shadow</li><li>morning</li></ol>
ata mārie	<i>intj</i><br><ol><li>good morning</li></ol>
ataarangi	<i>noun</i><br><ol><li>shadow</li></ol>
atamira	<i>noun</i><br><ol><li>stage, platform, dais</li></ol>
atanga	<i>noun</i><br><ol><li>(computing) interface</li></ol>
atarau	<i>noun</i><br><ol><li>moonlight</li></ol>
atawhai|atawhaingia|atawhaitia	<i>noun</i><br><ol><li>kindness, generosity</li></ol><br><i>verb</i><br><ol><li>to show kindness to</li></ol><br><i>adj</i><br><ol><li>kind, generous</li></ol>
ate	<i>noun</i><br><ol><li>(anatomy) liver (organ of the body)</li></ol>
atekōkiri	<i>noun</i><br><ol><li>driver (program acting as interface between an application and hardware)</li></ol>
ato|atohia|atotia|atoa	<i>verb</i><br><ol><li>to thatch</li><li>to fence in, enclose</li></ol>
atua	<i>noun</i><br><ol><li>god (deity)</li></ol>
au|ahau	<i>pron</i><br><ol><li>I (personal pronoun)</li><li>me (direct object of a verb)</li><li>me (object of a preposition)</li><li>me (indirect object of a verb)</li></ol><br><i>noun</i><br><ol><li>current (water)</li><li>whirlpool; rapid</li><li>wake (of a canoe, etc.)</li><li>sea; ocean</li><li>gall; gall bladder</li><li>smoke</li><li>cloud</li><li>mist; fog</li></ol><br><i>verb</i><br><ol><li>to howl, bark (of a dog)</li></ol>
aua	<i>noun</i><br><ol><li>yellow-eye mullet, (Aldrichetta forsteri)</li></ol><br><i>particle</i><br><ol><li>Negative imperative particle: no! don't!</li></ol>
auahi	<i>adj</i><br><ol><li>smoky</li></ol><br><i>noun</i><br><ol><li>smoke</li></ol><br><i>verb</i><br><ol><li>to be smoky</li></ol>
auau|auautia	<i>noun</i><br><ol><li>bark (of a dog)</li><li>frequency, rate</li></ol><br><i>verb</i><br><ol><li>to bark</li><li>(stative) to be frequent, recurring</li></ol><br><i>adv</i><br><ol><li>frequently, again and again</li></ol>
auheke	<i>verb</i><br><ol><li>surrender, cave</li><li>to surf</li><li>climb down</li></ol>
aukati	<i>verb</i><br><ol><li>bar, restrict, prohibit, block</li><li>ambush</li></ol><br><i>noun</i><br><ol><li>barrier</li></ol>
aumoana	<i>noun</i><br><ol><li>clay</li><li>open sea</li></ol><br><i>verb</i><br><ol><li>oceanic</li></ol>
aupatu	<i>noun</i><br><ol><li>bundle</li></ol>
auporo	<i>noun</i><br><ol><li>strike</li><li>stoppage</li></ol><br><i>verb</i><br><ol><li>curtail, truncate, cut short</li><li>strike</li></ol>
aupuru	<i>noun</i><br><ol><li>cushion, pad</li></ol>
aurere	<i>verb</i><br><ol><li>moan, groan</li></ol>
autaia	<i>noun</i><br><ol><li>bloke, fellow, guy, chap</li><li>contraption</li><li>wonder</li></ol><br><i>adj</i><br><ol><li>wondrous, uncanny, extraordinary</li></ol>
aute	<i>noun</i><br><ol><li>mulberry bark</li></ol>
autui	<i>noun</i><br><ol><li>brooch, cloak pin</li></ol>
autō	<i>noun</i><br><ol><li>magnet</li></ol>
auē	<i>intj</i><br><ol><li>wow</li><li>alas</li></ol>
awa	<i>noun</i><br><ol><li>river, creek, stream</li></ol>
awa kōpaka	<i>noun</i><br><ol><li>glacier</li></ol>
awairānei	<i>pron</i><br><ol><li>anyone, someone</li></ol>
awakeri	<i>noun</i><br><ol><li>drain, ditch</li></ol>
awarua	<i>noun</i><br><ol><li>trench, drain</li><li>corridor, passageway</li></ol>
awatea	<i>noun</i><br><ol><li>daylight</li></ol>
awe	<i>noun</i><br><ol><li>soot</li><li>white feather</li></ol>
aweke	<i>adj</i><br><ol><li>perverse</li><li>trivial</li><li>frivolous, idle</li></ol><br><i>verb</i><br><ol><li>misrepresent, falsify, forge</li></ol>
awhenga	<i>noun</i><br><ol><li>vassal, subordinate</li><li>conquered people</li></ol>
awhitu	<i>verb</i><br><ol><li>to feel hurt</li></ol><br><i>adj</i><br><ol><li>vigilant</li></ol>
e noho rā	<i>intj</i><br><ol><li>goodbye (said by one going to one staying)</li></ol>
ehu	<i>noun</i><br><ol><li>muddy water</li></ol><br><i>verb</i><br><ol><li>disinter, exhume</li></ol><br><i>adj</i><br><ol><li>turbid</li></ol>
eke	<i>verb</i><br><ol><li>to embark</li></ol>
epa	<i>noun</i><br><ol><li>wall post</li></ol>
ewe	<i>noun</i><br><ol><li>afterbirth</li></ol>
haeana	<i>noun</i><br><ol><li>iron</li></ol>
haeana rāti	<i>noun</i><br><ol><li>harpoon</li></ol>
haeata	<i>noun</i><br><ol><li>beam, ray of light</li><li>dawn, daybreak</li></ol>
haeatatanga	<i>noun</i><br><ol><li>ray of light through a chink in a wall</li></ol>
haere	<i>verb</i><br><ol><li>go</li><li>come</li></ol>
haere atu	<i>verb</i><br><ol><li>leave, go away, farewell</li></ol>
haere mai|haeremai	<i>verb</i><br><ol><li>come</li></ol><br><i>intj</i><br><ol><li>welcome</li></ol>
haere ra	<i>verb</i><br><ol><li>go, depart</li></ol><br><i>intj</i><br><ol><li>goodbye (said by one staying to one going)</li></ol>
haereere	<i>verb</i><br><ol><li>stroll about</li></ol>
haerenga	<i>noun</i><br><ol><li>journey</li><li>departure</li></ol>
haeroa	<i>noun</i><br><ol><li>grave for the spirits of enemies</li></ol>
haha	<i>verb</i><br><ol><li>look for</li></ol>
hahae	<i>verb</i><br><ol><li>to erode</li></ol>
hahaetanga	<i>noun</i><br><ol><li>first gleam of light</li></ol>
hahake	<i>adj</i><br><ol><li>naked, unbecoming</li></ol>
hahana	<i>verb</i><br><ol><li>glow, gleam, radiate</li></ol>
hahani	<i>verb</i><br><ol><li>disparage</li></ol>
hahu	<i>verb</i><br><ol><li>to disinter</li><li>to exhume</li></ol>
hahunga	<i>noun</i><br><ol><li>disinterment, exhumation</li></ol>
hai	<i>noun</i><br><ol><li>ace (card)</li></ol>
haihana	<i>noun</i><br><ol><li>sergeant</li></ol>
haika	<i>noun</i><br><ol><li>anchor</li></ol>
hainatanga	<i>noun</i><br><ol><li>signature</li></ol>
haka	<i>noun</i><br><ol><li>A war dance; a haka.</li></ol>
hakahaka	<i>adj</i><br><ol><li>low</li><li>squat</li></ol><br><i>verb</i><br><ol><li>rant, rave</li></ol>
hakari	<i>noun</i><br><ol><li>feast, gift</li><li>fish roe</li></ol>
hake	<i>adj</i><br><ol><li>crooked, naked</li></ol>
haki	<i>noun</i><br><ol><li>flag</li></ol>
hakihaki	<i>noun</i><br><ol><li>scabies, itch, rash</li></ol>
hakikoko	<i>noun</i><br><ol><li>shoulderblade</li></ol>
hakirara	<i>verb</i><br><ol><li>annoy, insult</li></ol><br><i>adv</i><br><ol><li>slovenly</li></ol><br><i>adj</i><br><ol><li>sloppy</li></ol>
hakiri	<i>verb</i><br><ol><li>hear</li></ol>
hako	<i>noun</i><br><ol><li>monkey</li></ol><br><i>adj</i><br><ol><li>ugly</li></ol>
hakoko	<i>adj</i><br><ol><li>bent, concave</li></ol>
haku	<i>noun</i><br><ol><li>yellowtail amberjack (Seriola lalandi)</li></ol>
hakuturi	<i>noun</i><br><ol><li>birds</li></ol>
hama|hamatia|hamaia	<i>noun</i><br><ol><li>hammer</li><li>malleus (hammer ear bone)</li></ol><br><i>verb</i><br><ol><li>to hammer</li></ol>
hamama	<i>verb</i><br><ol><li>shout</li><li>open wide]</li></ol>
hamana	<i>noun</i><br><ol><li>salmon</li></ol>
hamarara	<i>noun</i><br><ol><li>umbrella</li></ol>
hameme	<i>noun</i><br><ol><li>mutter</li></ol>
hamu	<i>verb</i><br><ol><li>glean</li></ol>
hamumu	<i>verb</i><br><ol><li>speak softly</li></ol>
hamuti	<i>noun</i><br><ol><li>dung</li></ol>
hana	<i>noun</i><br><ol><li>heat, warmth</li><li>radiance, glow, flame</li></ol><br><i>verb</i><br><ol><li>to shine, glow</li><li>to give out heat</li></ol>
hanahana	<i>noun</i><br><ol><li>garment</li></ol><br><i>verb</i><br><ol><li>shine</li></ol>
hanake	<i>verb</i><br><ol><li>grow</li></ol>
hanatu	<i>verb</i><br><ol><li>go forwards, go away</li></ol>
hanehane	<i>noun</i><br><ol><li>decay, rot</li></ol>
hanga	<i>verb</i><br><ol><li>To make; to create</li><li>To build</li></ol><br><i>noun</i><br><ol><li>group of people</li><li>the manner in which something is made or built</li><li>construction</li><li>thing; object which has been made; product</li></ol>
hangahanga	<i>adj</i><br><ol><li>frivolous</li></ol>
hanganoa	<i>noun</i><br><ol><li>insignificant, inconsequential</li></ol>
hangarau	<i>noun</i><br><ol><li>food</li><li>joke</li><li>technology</li></ol><br><i>verb</i><br><ol><li>fool</li></ol>
hanumi	<i>verb</i><br><ol><li>merge; be swallowed up</li></ol>
hapa	<i>noun</i><br><ol><li>tea (meal)</li></ol>
hapanga	<i>noun</i><br><ol><li>default</li></ol>
hape	<i>adj</i><br><ol><li>deformed</li><li>disabled</li></ol>
hapoko	<i>adj</i><br><ol><li>swampy</li></ol>
hapori	<i>noun</i><br><ol><li>community</li></ol>
hapui	<i>adj</i><br><ol><li>engaged to be married</li></ol>
hapū	<i>adj</i><br><ol><li>pregnant</li></ol><br><i>noun</i><br><ol><li>clan or subtribe</li></ol>
hara	<i>verb</i><br><ol><li>to be in violation of a tapu</li><li>to transgress</li><li>to commit a sin</li><li>to violate the law</li><li>to offend</li></ol><br><i>noun</i><br><ol><li>sin</li><li>foul</li><li>crime, offence, transgression, wrongdoing</li><li>gaffe</li><li>infringement</li><li>fault</li><li>problem</li></ol>
harakeke	<i>noun</i><br><ol><li>New Zealand flax, Phormium tenax</li></ol>
haramai	<i>noun</i><br><ol><li>welcome</li></ol><br><i>verb</i><br><ol><li>come</li></ol>
harapaki	<i>noun</i><br><ol><li>hillside, slopes</li></ol>
harapuku	<i>adj</i><br><ol><li>puzzled</li></ol>
haratau	<i>adj</i><br><ol><li>suitable, fit</li></ol>
harawene	<i>noun</i><br><ol><li>envy, jealousy</li></ol><br><i>adj</i><br><ol><li>envious, jealous</li></ol>
hari	<i>noun</i><br><ol><li>happiness, elation, joy</li></ol><br><i>verb</i><br><ol><li>to carry</li></ol>
harirū	<i>verb</i><br><ol><li>shake hands</li></ol>
harore	<i>noun</i><br><ol><li>fungus, mushrooms</li></ol>
haruru	<i>noun</i><br><ol><li>rumble, roar</li></ol>
hau	<i>noun</i><br><ol><li>essence</li></ol><br><i>adj</i><br><ol><li>famous</li></ol>
hauangi	<i>adj</i><br><ol><li>cool, airy</li></ol>
hauarea	<i>adj</i><br><ol><li>insignificant</li></ol>
hauhanga	<i>noun</i><br><ol><li>frost</li></ol>
hauhau	<i>noun</i><br><ol><li>whip</li></ol><br><i>adj</i><br><ol><li>windy</li></ol>
haukaha	<i>adj</i><br><ol><li>very windy</li></ol><br><i>verb</i><br><ol><li>reinforce, bolster</li><li>amend</li></ol>
haukai	<i>noun</i><br><ol><li>feast</li></ol>
haukoti	<i>verb</i><br><ol><li>intercept</li><li>abort</li></ol>
hauku|haukū	<i>noun</i><br><ol><li>dew</li></ol><br><i>adj</i><br><ol><li>damp</li></ol>
haukāinga	<i>noun</i><br><ol><li>true home</li><li>homepage</li></ol>
haumākū	<i>verb</i><br><ol><li>get wet</li></ol><br><i>adj</i><br><ol><li>moist</li></ol>
haunga	<i>noun</i><br><ol><li>stench, stink</li></ol>
hauora	<i>noun</i><br><ol><li>health</li></ol>
haurahi	<i>noun</i><br><ol><li>dew</li></ol>
haurangi	<i>adj</i><br><ol><li>drunk</li></ol>
hauraro	<i>noun</i><br><ol><li>north wind</li></ol><br><i>verb</i><br><ol><li>surrender</li></ol>
haututū	<i>adj</i><br><ol><li>insubordinate; naughty, noncompliant</li></ol>
hautū	<i>noun</i><br><ol><li>leader</li></ol><br><i>verb</i><br><ol><li>lead</li></ol>
hauwai	<i>noun</i><br><ol><li>hydrogen</li></ol>
hauware	<i>noun</i><br><ol><li>saliva</li></ol>
hauāuru	<i>noun</i><br><ol><li>west</li><li>west wind</li></ol>
hauʻa|haua	<i>adj</i><br><ol><li>disabled</li></ol>
haïra	<i>noun</i><br><ol><li>scythe</li></ol>
he	<i>article</i><br><ol><li>a, an, some: indefinite article</li></ol>
hea	<i>verb</i><br><ol><li>grieve</li></ol>
heahea	<i>adj</i><br><ol><li>crazy, stupid, inane</li></ol>
hei	<i>particle</i><br><ol><li>Future locative particle</li></ol>
heihei	<i>adj</i><br><ol><li>to be related to a chicken</li></ol><br><i>noun</i><br><ol><li>chicken</li></ol>
heira	<i>noun</i><br><ol><li>birthmark</li></ol>
heke	<i>noun</i><br><ol><li>thigh</li><li>rafter</li></ol>
heketua	<i>noun</i><br><ol><li>toilet</li></ol>
hema	<i>noun</i><br><ol><li>genitalia</li></ol>
hemo	<i>verb</i><br><ol><li>die</li></ol>
hemokai	<i>noun</i><br><ol><li>hunger</li></ol><br><i>verb</i><br><ol><li>starve</li></ol>
hemorere	<i>adj</i><br><ol><li>sudden</li></ol><br><i>adv</i><br><ol><li>suddenly</li></ol>
hepara	<i>noun</i><br><ol><li>shepherd; herdsman</li><li>zebra</li></ol><br><i>verb</i><br><ol><li>to shepherd</li></ol>
herehere	<i>noun</i><br><ol><li>prisoner</li></ol>
hereumu	<i>noun</i><br><ol><li>kitchen</li></ol>
heru	<i>noun</i><br><ol><li>comb</li></ol>
heu	<i>noun</i><br><ol><li>razor</li></ol><br><i>adj</i><br><ol><li>overgrown</li></ol>
heuheu	<i>noun</i><br><ol><li>brushwood</li></ol><br><i>verb</i><br><ol><li>shave</li></ol>
hewa	<i>adj</i><br><ol><li>mistaken</li></ol>
hiainu	<i>noun</i><br><ol><li>thirst</li></ol><br><i>adj</i><br><ol><li>thirsty</li></ol>
hihi	<i>noun</i><br><ol><li>feeler, antenna</li></ol>
hiki	<i>verb</i><br><ol><li>to carry (in the arms)</li></ol>
hiko	<i>adj</i><br><ol><li>electric</li></ol><br><i>noun</i><br><ol><li>lightning</li><li>electricity</li></ol>
hinehī	<i>noun</i><br><ol><li>transsexual</li></ol>
hipi	<i>noun</i><br><ol><li>sheep</li></ol>
hiriwa	<i>noun</i><br><ol><li>silver</li></ol>
hoa|hoaina	<i>noun</i><br><ol><li>friend, companion, mate, partner, spouse, ally</li><li>pitch (of a roof)</li><li>charm, spell, enchantment</li></ol><br><i>verb</i><br><ol><li>to lay out, to plan arrange</li></ol>
hoari	<i>noun</i><br><ol><li>sword</li></ol>
hoariri	<i>noun</i><br><ol><li>enemy</li></ol>
hoe	<i>noun</i><br><ol><li>oar</li><li>paddle</li></ol><br><i>verb</i><br><ol><li>to row</li><li>to paddle</li></ol>
hoka	<i>verb</i><br><ol><li>to soar, fly</li><li>to lift; to hold aloft</li></ol>
hongi	<i>noun</i><br><ol><li>The Maori greeting of touching noses.</li></ol><br><i>verb</i><br><ol><li>To perform the Maori greeting of touching noses.</li></ol>
hono	<i>verb</i><br><ol><li>add</li><li>join</li></ol>
honu	<i>noun</i><br><ol><li>turtle</li></ol>
hope	<i>noun</i><br><ol><li>waist</li><li>hip (ringa hope)</li></ol>
hopi	<i>noun</i><br><ol><li>soap</li></ol>
hopu	<i>verb</i><br><ol><li>to record (make an audio or video recording of)</li><li>to detect</li></ol>
hore	<i>noun</i><br><ol><li>scrofula</li></ol>
horoi|horoia	<i>verb</i><br><ol><li>wash, clean</li></ol><br><i>noun</i><br><ol><li>washing</li><li>soap</li></ol>
horonga	<i>name</i><br><ol><li>avalanche</li></ol>
hou	<i>adj</i><br><ol><li>new (recently made or created)</li></ol>
hua	<i>noun</i><br><ol><li>fruit</li><li>product, outcome</li><li>egg, roe</li><li>benefit, gain, asset</li></ol><br><i>verb</i><br><ol><li>to bear fruit, be abundant, accrue</li><li>to flower, bloom, blossom</li></ol>
hua whenua	<i>noun</i><br><ol><li>vegetable</li></ol>
huarere	<i>noun</i><br><ol><li>weather</li></ol>
huatau	<i>adj</i><br><ol><li>elegant, graceful</li></ol><br><i>noun</i><br><ol><li>comment, thought</li></ol><br><i>verb</i><br><ol><li>to comment</li><li>to realize</li></ol>
hue	<i>noun</i><br><ol><li>A gourd (plant)</li></ol>
hui	<i>verb</i><br><ol><li>to gather, congregate, assemble, meet</li></ol><br><i>noun</i><br><ol><li>gathering, meeting, assembly, seminar, conference</li></ol>
huka	<i>noun</i><br><ol><li>snow, foam, froth, any white form of precipitation</li><li>sugar</li></ol>
hukapapa|hukapapatia	<i>noun</i><br><ol><li>frost</li><li>ice</li></ol><br><i>verb</i><br><ol><li>to have a frost</li></ol>
humuhumu	<i>verb</i><br><ol><li>(stative) to be amputated</li></ol>
hunga	<i>noun</i><br><ol><li>people</li><li>slave</li></ol>
hunga whakaruru	<i>noun</i><br><ol><li>refugee</li></ol>
huripari	<i>noun</i><br><ol><li>hurricane</li></ol>
huru	<i>noun</i><br><ol><li>hair</li></ol><br><i>verb</i><br><ol><li>to glow</li></ol>
huruhuru	<i>noun</i><br><ol><li>feather</li><li>coarse hair or fur (as opposed to hair on the head, for example: hair on an animal or pubic hair)</li></ol>
hángài	<i>adj</i><br><ol><li>in line with</li></ol><br><i>verb</i><br><ol><li>step across</li></ol>
hā|ha|hāngia	<i>noun</i><br><ol><li>breath, breathing, essence, taste.</li><li>sound, tone, tenor, timbre, intonation.</li></ol><br><i>verb</i><br><ol><li>to breathe</li></ol><br><i>intj</i><br><ol><li>what! oh! hey! (expression of surprise or disapproval)</li></ol>
hāhore	<i>adj</i><br><ol><li>bare, simple</li></ol>
hāka	<i>noun</i><br><ol><li>jug</li><li>groundsel</li><li>hack (horse)</li><li>butterweed</li></ol>
hākinakina	<i>verb</i><br><ol><li>to play sport</li><li>to enjoy oneself</li></ol><br><i>noun</i><br><ol><li>sport, game</li></ol>
hākoakoa	<i>noun</i><br><ol><li>bliss</li><li>skua</li></ol><br><i>adj</i><br><ol><li>happy</li></ol>
hākoro	<i>noun</i><br><ol><li>old man</li></ol>
hākui	<i>noun</i><br><ol><li>old woman</li></ol>
hākure	<i>noun</i><br><ol><li>lice</li></ol><br><i>verb</i><br><ol><li>search for lice</li></ol>
hāmanu	<i>noun</i><br><ol><li>ammunition</li></ol>
hānara	<i>noun</i><br><ol><li>handlebar</li></ol>
hāparangi	<i>verb</i><br><ol><li>shout, scream, bawl</li></ol>
hāpoki	<i>noun</i><br><ol><li>den</li><li>pit</li></ol>
hārapa	<i>verb</i><br><ol><li>lead the way</li></ol>
hārau	<i>verb</i><br><ol><li>win</li><li>fumble; grasp</li></ol>
hārewa	<i>verb</i><br><ol><li>to take off (of an aircraft)</li></ol>
hāro	<i>verb</i><br><ol><li>scrape</li></ol><br><i>adj</i><br><ol><li>low</li></ol>
hāroto	<i>noun</i><br><ol><li>pool, pond</li></ol>
hātakēhi	<i>adj</i><br><ol><li>comical</li></ol>
hāte	<i>noun</i><br><ol><li>shirt</li></ol>
hāwini	<i>noun</i><br><ol><li>servant</li></ol>
hē	<i>noun</i><br><ol><li>fault</li></ol><br><i>verb</i><br><ol><li>to err</li></ol><br><i>adj</i><br><ol><li>wrong</li></ol>
hēkena	<i>noun</i><br><ol><li>second</li></ol>
hēki	<i>noun</i><br><ol><li>egg</li></ol>
hēmanawa	<i>adj</i><br><ol><li>breathless; stressed</li></ol>
hēmanawatanga	<i>noun</i><br><ol><li>frustration</li><li>depression</li></ol>
hī ika	<i>verb</i><br><ol><li>to fish with a hook and line</li></ol><br><i>noun</i><br><ol><li>angling, line fishing.</li></ol>
hīoi	<i>verb</i><br><ol><li>(stative) be a glossy green</li></ol><br><i>noun</i><br><ol><li>New Zealand mint (Mentha cunninghamii)</li><li>New Zealand pipit (Anthus novaeseelandiae)</li></ol>
hīti	<i>noun</i><br><ol><li>sheet, bedsheet</li></ol>
hōiho	<i>noun</i><br><ol><li>horse</li></ol>
hōiho uha	<i>noun</i><br><ol><li>a mare, a female horse</li></ol>
hōkaka	<i>noun</i><br><ol><li>desire, wish</li></ol><br><i>verb</i><br><ol><li>to desire, to want, to yearn</li></ol>
hōkakatanga	<i>noun</i><br><ol><li>sexual orientation, sexuality</li></ol>
hōtēra	<i>noun</i><br><ol><li>hotel</li></ol>
hōu|hoou	<i>adj</i><br><ol><li>new (recently made or created)</li></ol>
hū	<i>verb</i><br><ol><li>to make a loud noise</li><li>to call (out to), signal, cooey</li></ol><br><i>intj</i><br><ol><li>(onomatopoeia) boom!</li></ol>
hūtuki	<i>verb</i><br><ol><li>to bump</li></ol>
i	<i>particle</i><br><ol><li>from</li><li>past-tense verbal particle</li><li>particle indicating the direct object of a transitive sentence</li><li>past-tense particle indicating location</li></ol>
ia	<i>pron</i><br><ol><li>they / he / she / it (genderless third person pronoun)</li></ol>
ihu	<i>noun</i><br><ol><li>nose (organ of the face)</li></ol>
ika	<i>noun</i><br><ol><li>fish, marine animal, aquatic animal - any creature that swims in fresh or salt water including marine mammals such as whales</li><li>slain warrior, victim</li><li>(figuratively) prized possession</li><li>cluster, band, troop, group, company, heap</li></ol>
ikura	<i>noun</i><br><ol><li>menstruation</li></ol>
inanga|īnanga|īnaka	<i>noun</i><br><ol><li>A fish, the jollytail (Galaxias maculatus).</li><li>The grass tree, a shrub in the genus Dracophyllum.</li><li>bamboo</li><li>white greenstone</li></ol>
ingoa	<i>noun</i><br><ol><li>name</li></ol>
inoi	<i>noun</i><br><ol><li>a prayer</li></ol><br><i>verb</i><br><ol><li>to pray, beg, request, appeal</li></ol>
inu|inu-mia	<i>noun</i><br><ol><li>liquid, drink</li></ol><br><i>verb</i><br><ol><li>to drink</li></ol>
inu mirumiru	<i>noun</i><br><ol><li>Coke (Coca Cola)</li></ol>
iohere punga	<i>noun</i><br><ol><li>Achilles tendon</li></ol>
ipurangi	<i>noun</i><br><ol><li>source (of a stream)</li><li>(Internet) Internet</li></ol>
iro|iroiro	<i>noun</i><br><ol><li>maggot</li></ol>
iuana	<i>noun</i><br><ol><li>iguana</li></ol>
iwa	<i>num</i><br><ol><li>nine</li></ol>
iwa tekau	<i>num</i><br><ol><li>ninety</li></ol>
iwi	<i>noun</i><br><ol><li>extended kinship group, tribe, nation, people, nationality, race (often refers to a large group of people descended from a common ancestor and associated with a distinct territory)</li><li>strength, bone</li></ol>
ka	<i>particle</i><br><ol><li>Marks an event as occurring at some time or as existing</li><li>when; used before a verb to indicate the start of an action or state</li><li>Marks a verb as being in future tense</li><li>Used when counting numbers</li><li>Used in commands with taua and tātou</li><li>now (for the first time); when used after kātahi anō</li></ol>
ka kite anō|ka kite	<i>phrase</i><br><ol><li>(proscribed) I'll see you again.</li></ol>
kaha	<i>noun</i><br><ol><li>strength, power, energy</li><li>rope, noose</li><li>lineage</li></ol><br><i>verb</i><br><ol><li>to be strong, be courageous</li></ol>
kaho	<i>noun</i><br><ol><li>crossbar; crossbeam</li><li>roof batten</li><li>fence rail</li><li>horizontal wall batten in a meeting house</li></ol>
kahurangi	<i>noun</i><br><ol><li>dark blue</li></ol>
kai|kainga	<i>verb</i><br><ol><li>to eat (consume)</li></ol><br><i>noun</i><br><ol><li>food</li></ol>
kai hamuti	<i>intj</i><br><ol><li>(vulgar, idiomatic) eat shit (a vulgar expression)</li></ol>
kaihao	<i>noun</i><br><ol><li>fisher, fisherman (using a net)</li></ol>
kaikōrero	<i>noun</i><br><ol><li>speaker (one who speaks)</li></ol>
kaimahi	<i>noun</i><br><ol><li>worker, employee</li></ol>
kaimoana|kai moana	<i>noun</i><br><ol><li>seafood, shellfish</li></ol>
kainga	<i>noun</i><br><ol><li>The refuse of a meal.</li></ol><br><i>verb</i><br><ol><li>To be consumed; passive form of kai</li></ol>
kaitiaki	<i>noun</i><br><ol><li>guardian, trustee</li></ol>
kaitiakitanga	<i>noun</i><br><ol><li>guardianship; trusteeship</li><li>trust</li></ol>
kakakaka	<i>verb</i><br><ol><li>to stutter, stammer</li></ol>
kakara	<i>noun</i><br><ol><li>scent</li><li>odour</li></ol>
kaki roa	<i>noun</i><br><ol><li>giraffe</li></ol>
kamo	<i>noun</i><br><ol><li>eyelash</li></ol>
kangarū	<i>noun</i><br><ol><li>kangaroo</li></ol>
kaniawheatanga	<i>noun</i><br><ol><li>remorse</li></ol>
kano	<i>noun</i><br><ol><li>color, pigment, hue, sort, kind</li><li>seed, bean, grain, ovule</li></ol>
kano ārai mate	<i>noun</i><br><ol><li>(immunology) vaccine</li></ol>
kapa	<i>noun</i><br><ol><li>team, group</li><li>row, line</li><li>copper</li></ol>
kapua	<i>noun</i><br><ol><li>cloud</li></ol>
kapuni	<i>noun</i><br><ol><li>natural gas</li></ol>
karae	<i>noun</i><br><ol><li>seabird of unknown species</li></ol>
karaihe	<i>noun</i><br><ol><li>glass (substance)</li></ol>
karaihe whakanui	<i>noun</i><br><ol><li>microscope</li></ol>
karaka	<i>noun</i><br><ol><li>A leafy evergreen tree (Corynocarpus laevigatus) with bright orange fruit endemic to New Zealand.</li><li>orange</li><li>clock</li></ol>
karakia|karakiatia	<i>verb</i><br><ol><li>to recite ritual chants or a prayer, to say grace, to pray</li></ol><br><i>noun</i><br><ol><li>an incantation, ritual chant, spell (related to Maori traditions)</li><li>a prayer, grace, blessing (related to introduced religions)</li></ol>
karakotaera	<i>noun</i><br><ol><li>crocodile</li></ol>
karani	<i>noun</i><br><ol><li>currant</li></ol>
karehākoa	<i>noun</i><br><ol><li>red-billed gull</li></ol>
katatē	<i>noun</i><br><ol><li>red-billed gull</li></ol>
kato	<i>noun</i><br><ol><li>flow</li><li>current</li></ol><br><i>adj</i><br><ol><li>flowing (of the tide)</li><li>flooding (of the tide)</li></ol>
kau|kauhoe-tia|rākau	<i>verb</i><br><ol><li>tree; wood</li><li>stick</li><li>to swim</li></ol><br><i>noun</i><br><ol><li>a cow</li></ol>
kau aihe	<i>noun</i><br><ol><li>butterfly stroke</li></ol>
kaumātua	<i>noun</i><br><ol><li>An elder</li></ol>
kaupapa ture	<i>noun</i><br><ol><li>constitution</li></ol>
kauri	<i>noun</i><br><ol><li>A conifer of the genus Agathis, family Araucariaceae, found in Australasia and Melanesia.</li><li>(New Zealand) Agathis australis, a large conifer of the family Araucariaceae.</li></ol>
kautona	<i>noun</i><br><ol><li>wart</li></ol>
kauwae	<i>noun</i><br><ol><li>chin</li></ol>
kawa	<i>adj</i><br><ol><li>sour</li></ol><br><i>noun</i><br><ol><li>a ceremony to remove tapu from a new house or canoe</li><li>karakia (“ritual chants”) and customs for the opening of new houses, canoes and other events</li><li>marae protocol - customs of the marae and wharenui, particularly those related to formal activities such as pōhiri, speeches and mihimihi</li><li>acid</li><li>bitterness</li></ol><br><i>verb</i><br><ol><li>to perform the kawa ceremony, open a new house</li></ol>
kawakawa	<i>noun</i><br><ol><li>kawakawa (Piper excelsum)</li></ol>
kawereo	<i>noun</i><br><ol><li>telephone</li></ol>
kawhe	<i>noun</i><br><ol><li>coffee</li></ol>
kawhi	<i>noun</i><br><ol><li>coffee</li></ol>
kea	<i>noun</i><br><ol><li>snot</li><li>the kea, Nestor notabilis</li></ol>
keakea	<i>noun</i><br><ol><li>quack (of a duck)</li></ol><br><i>verb</i><br><ol><li>to quack (as a duck)</li></ol>
kei	<i>particle</i><br><ol><li>At, in (present locative particle)</li></ol>
keke	<i>noun</i><br><ol><li>cake</li></ol>
kererū	<i>noun</i><br><ol><li>The New Zealand pigeon (species Hemiphaga novaeseelandiae).</li></ol>
keri|keri-a	<i>verb</i><br><ol><li>to dig (to move hard-packed earth out of the way)</li></ol>
kete	<i>noun</i><br><ol><li>basket</li></ol>
ki	<i>particle</i><br><ol><li>to, toward.</li></ol>
kia	<i>particle</i><br><ol><li>when; until (used for a future time)</li><li>to; that (indicates a purpose, wish or effect) (used if second verb is passive or stative, or if the subject of the subordinate clause is different to the main clause)</li><li>(let) be (indicates desirability)</li><li>specifies an amount</li><li>not yet</li><li>so that</li><li>so that ... will not</li><li>shouldn't</li></ol>
kia kaha	<i>phrase</i><br><ol><li>be strong (used as an affirmation or motto)</li><li>A term of comfort or solace (equivalent of the English phrase "be strong, my thoughts are with you").</li><li>An interjection during a speech to indicate support or approval (similar to "hear, hear!").</li></ol>
kia ora	<i>intj</i><br><ol><li>A greeting (salutation) said when meeting someone or acknowledging someone’s arrival or presence.</li><li>An expression of gratitude (similar to cheers!).</li><li>An expression of support or agreement (similar to hear hear).</li></ol>
kiekie	<i>noun</i><br><ol><li>A vine used by the Maori for food and as material for mats, Freycinetia banksii</li></ol>
kihirua	<i>verb</i><br><ol><li>to change one’s mind</li></ol>
kikohunga	<i>noun</i><br><ol><li>gangrene</li></ol>
kikorangi	<i>noun</i><br><ol><li>light blue</li><li>(colour/color) sky blue</li></ol>
kina	<i>noun</i><br><ol><li>sea urchin</li></ol>
kini	<i>verb</i><br><ol><li>to pinch, to nip</li><li>to pinch off</li></ol><br><i>noun</i><br><ol><li>a guinea (the coin)</li></ol>
kino	<i>adj</i><br><ol><li>bad</li><li>gory</li></ol><br><i>noun</i><br><ol><li>harm</li><li>hate</li></ol>
kiore	<i>noun</i><br><ol><li>rat</li></ol>
kipa	<i>noun</i><br><ol><li>spur (horse prod attached to heel)</li></ol>
kiri	<i>noun</i><br><ol><li>(anatomy) skin</li><li>peel, bark, rind</li><li>hide, leather</li><li>surface</li></ol>
kiri taratara|kiritaratara	<i>noun</i><br><ol><li>echinoderm</li></ol>
kirikiri	<i>noun</i><br><ol><li>gravel</li><li>sand</li><li>shingle</li></ol><br><i>verb</i><br><ol><li>to incorporate gravel</li></ol>
kiripaka	<i>noun</i><br><ol><li>flint, quartz</li><li>asbestos</li></ol>
kiritona	<i>noun</i><br><ol><li>pimple, wart</li></ol>
kite|kite-a	<i>verb</i><br><ol><li>to see</li></ol>
kiwi	<i>noun</i><br><ol><li>kiwi (bird)</li></ol>
kiwikiwi	<i>noun</i><br><ol><li>grey</li><li>Blechnum fluviatile, the star fern or creek fern.</li></ol>
ko	<i>particle</i><br><ol><li>Placed at the beginning of nominative phrases to signify that they are declarative</li></ol>
koe	<i>pron</i><br><ol><li>you (singular)</li></ol><br><i>verb</i><br><ol><li>(of a bird or animal) to squeak, scream, squawk or cry</li></ol>
koeko-tapaono	<i>noun</i><br><ol><li>hexagonal pyramid</li></ol>
koekoe|koekoea	<i>verb</i><br><ol><li>(of a bird or animal) to squeak, scream, squawk or cry</li></ol>
kohu	<i>noun</i><br><ol><li>fog</li></ol>
kohuke	<i>noun</i><br><ol><li>mineral</li></ol>
koi	<i>adj</i><br><ol><li>sharp</li></ol><br><i>noun</i><br><ol><li>spike</li></ol>
kokoru	<i>noun</i><br><ol><li>bay (gulf)</li></ol>
konene	<i>noun</i><br><ol><li>refugee</li></ol>
kongakonga	<i>noun</i><br><ol><li>shrapnel, crumb</li><li>(computing) fragment</li></ol><br><i>verb</i><br><ol><li>(stative) to be crumbled</li><li>(computing) to be fragmented</li></ol><br><i>adj</i><br><ol><li>insignificant</li></ol>
kopa	<i>noun</i><br><ol><li>space in front of a house</li><li>floor space and corner on the left on entering a wharenui – normally the place where the local people of the marae sit or sleep</li><li>cripple, disabled person</li><li>wallet, satchel (with a flap lid), sandal</li></ol><br><i>verb</i><br><ol><li>to pass by, disappear</li><li>to fly away, fly</li><li>to be bent, folded</li><li>to be crippled, lame</li></ol><br><i>adj</i><br><ol><li>crippled, lame</li></ol>
kore	<i>adj</i><br><ol><li>without (not having)</li></ol><br><i>num</i><br><ol><li>zero</li></ol>
koro|koro-a	<i>noun</i><br><ol><li>grandfather</li></ol>
koromiko	<i>noun</i><br><ol><li>koromiko shrub</li></ol>
kororā	<i>noun</i><br><ol><li>The little penguin</li></ol>
korukoru	<i>noun</i><br><ol><li>turkey</li></ol>
kotiate	<i>noun</i><br><ol><li>short weapon of wood or bone with a notch on both edges of the flat blade</li></ol>
kotoreke	<i>noun</i><br><ol><li>marsh crake (Porzana pusilla affinis)</li></ol>
koura	<i>noun</i><br><ol><li>gold</li><li>koura (freshwater crayfish of the genus Paranephrops, endemic to New Zealand)</li></ol>
koutou	<i>pron</i><br><ol><li>you (plural; three or more people)</li></ol>
koāra	<i>noun</i><br><ol><li>(noun) koala</li></ol>
kuihi	<i>noun</i><br><ol><li>goose</li><li>Canada goose</li></ol>
kuihipere	<i>noun</i><br><ol><li>gooseberry</li></ol>
kupu	<i>noun</i><br><ol><li>word</li><li>vocabulary</li><li>saying</li><li>talk</li><li>message</li><li>statement</li><li>utterance</li><li>lyric</li></ol><br><i>verb</i><br><ol><li>(intransitive) to speak</li></ol>
kuru|kurua|kurungia|kurutia	<i>noun</i><br><ol><li>breadfruit</li><li>mallet; fragment; hammer-head stone</li></ol><br><i>verb</i><br><ol><li>to strike with a fist; to pound or thump</li></ol>
kurī	<i>noun</i><br><ol><li>dog</li></ol>
kutikuti	<i>noun</i><br><ol><li>scissors, shears, clippers</li></ol><br><i>verb</i><br><ol><li>To cut with scissors etc</li></ol>
kutu	<i>noun</i><br><ol><li>louse (insect)</li></ol>
kā	<i>verb</i><br><ol><li>to burn</li><li>to screech</li></ol>
kāhu	<i>noun</i><br><ol><li>swamp harrier (Circus approximans), a species of harrier hawk</li></ol>
kāinga	<i>noun</i><br><ol><li>the burning (of a fire)</li><li>a place of residence (literally, a place where a fire has been lit)</li><li>an unfortified place of residence or village (in contrast to a pā, which is fortified)</li><li>a country</li><li>home</li></ol>
kākā	<i>noun</i><br><ol><li>a parrot (especially the kaka)</li></ol>
kākāpō	<i>noun</i><br><ol><li>kakapo</li></ol>
kākāriki	<i>noun</i><br><ol><li>green</li><li>a New Zealand parakeet of genus Cyanoramphus</li><li>a green species of gecko</li><li>cantaloupe</li></ol><br><i>verb</i><br><ol><li>to become green</li></ol><br><i>adj</i><br><ol><li>green</li></ol>
kāmera	<i>noun</i><br><ol><li>camera</li><li>camel</li></ol>
kānga	<i>noun</i><br><ol><li>maize, corn</li></ol>
kāo	<i>particle</i><br><ol><li>no</li></ol>
kārearea	<i>noun</i><br><ol><li>Falco novaeseelandiae, the only falcon endemic to New Zealand.</li></ol>
kārohirohi	<i>verb</i><br><ol><li>to shimmer (of light or heat waves)</li></ol>
kātoa	<i>noun</i><br><ol><li>Any of the red variety of Leptospermum scoparium, a shrub or small tree native to New Zealand and southeast Australia.</li></ol>
kāwana	<i>noun</i><br><ol><li>A governor.</li></ol><br><i>verb</i><br><ol><li>To govern.</li></ol>
kāwanatanga	<i>noun</i><br><ol><li>Government.</li></ol>
kēkē	<i>noun</i><br><ol><li>armpit</li><li>quack (of a duck)</li></ol><br><i>verb</i><br><ol><li>to quack (as a duck)</li></ol>
kī	<i>verb</i><br><ol><li>to say, speak, express, utter, call, mention, tell, designate</li><li>to lock</li><li>(stative) to be locked</li></ol><br><i>noun</i><br><ol><li>saying, word</li><li>(stative) to be full</li><li>key</li></ol>
kōauau	<i>noun</i><br><ol><li>cross-blown flute made of wood, bone or a species of kelp</li><li>bull kelp (Durvillaea antarctica)</li></ol>
kōhanga	<i>noun</i><br><ol><li>nest, nursery</li><li>birthplace, cradle, homeland, stronghold, bastion</li></ol>
kōhua|kōhuatia	<i>noun</i><br><ol><li>boiler, pot (for boiling food)</li></ol><br><i>verb</i><br><ol><li>to cook by boiling, to boil, to poach</li></ol>
kōhue|kōhuetia	<i>noun</i><br><ol><li>boiler, pot (for boiling food)</li></ol><br><i>verb</i><br><ol><li>to cook by boiling, to boil</li></ol>
kōrero	<i>verb</i><br><ol><li>To speak; to talk.</li></ol><br><i>noun</i><br><ol><li>A story.</li><li>A conversation.</li><li>A discussion.</li></ol>
kōrua	<i>pron</i><br><ol><li>you two (dual; two people)</li></ol>
kōtare	<i>noun</i><br><ol><li>The kotare, a kingfisher Halcyon sancta.</li></ol>
kōtuku ngutupapa	<i>noun</i><br><ol><li>royal spoonbill (Platalea regia)</li></ol>
kōtuku-ngutupapa	<i>noun</i><br><ol><li>royal spoonbill (Platalea regia)</li></ol>
kōura	<i>noun</i><br><ol><li>crayfish; lobster</li><li>gold</li></ol>
kōuraura	<i>noun</i><br><ol><li>shrimp (decapod crustacean)</li></ol>
kōwhai	<i>noun</i><br><ol><li>Any of several small woody legume trees in the genus Sophora native to New Zealand that have yellow flowers. The national flower of New Zealand.</li><li>yellow</li></ol>
kūkupa	<i>noun</i><br><ol><li>A pigeon.</li></ol>
kūkū	<i>noun</i><br><ol><li>pigeon</li></ol>
kūmara	<i>noun</i><br><ol><li>A sweet potato</li></ol>
maha	<i>noun</i><br><ol><li>abundance, bounty, majority</li></ol>
mahana	<i>adj</i><br><ol><li>cordial, warm</li></ol>
mahi|mahia|mahingia	<i>verb</i><br><ol><li>to work, do, perform, make, accomplish, practise, raise (money)</li></ol><br><i>noun</i><br><ol><li>work, job, employment, trade (work), practice, occupation, activity, exercise, operation, function</li><li>abundance, lots of, many, heaps of</li></ol>
mahuru	<i>verb</i><br><ol><li>(stative) settled; calmed; soothed</li></ol>
mai	<i>adv</i><br><ol><li>hither</li></ol>
maika	<i>noun</i><br><ol><li>banana.</li></ol>
maina	<i>noun</i><br><ol><li>(military) mine (explosive device)</li><li>myna (species of bird)</li></ol><br><i>verb</i><br><ol><li>to lay mines</li></ol>
maitai	<i>noun</i><br><ol><li>metal</li></ol>
makariri	<i>verb</i><br><ol><li>(stative) cold</li></ol><br><i>adj</i><br><ol><li>cold</li></ol>
maki	<i>verb</i><br><ol><li>to afflict (of an illness)</li></ol><br><i>noun</i><br><ol><li>sick person</li><li>sore (injured, infected, inflamed, or diseased patch of skin)</li><li>ape</li><li>monkey</li></ol><br><i>adv</i><br><ol><li>invalid</li></ol>
maki nui	<i>noun</i><br><ol><li>gorilla</li></ol>
makimaki	<i>noun</i><br><ol><li>monkey</li><li>ape</li></ol><br><i>verb</i><br><ol><li>afflict with an illness</li></ol>
mako	<i>adj</i><br><ol><li>to be peeled</li><li>stripped off</li></ol>
makorā	<i>noun</i><br><ol><li>red-billed gull</li></ol>
mamae	<i>noun</i><br><ol><li>pain</li></ol>
mana	<i>noun</i><br><ol><li>power; mana</li></ol>
mana tōrangapū	<i>noun</i><br><ol><li>political power</li></ol>
manaaki|manaakitia	<i>verb</i><br><ol><li>to support, take care of, look out for</li></ol><br><i>noun</i><br><ol><li>support, caring for</li></ol>
manaakitanga	<i>noun</i><br><ol><li>showing kindness, generosity, respect to others</li></ol>
manaia	<i>noun</i><br><ol><li>a manaia (a figure often seen in art, generally depicted as a man with a bird's head)</li><li>a seahorse</li></ol>
manatū	<i>noun</i><br><ol><li>government</li><li>authority</li></ol>
manawa	<i>noun</i><br><ol><li>heart (of a person)</li><li>heart (seat of affections)</li><li>breath</li><li>mind</li><li>spirit</li></ol>
manga	<i>noun</i><br><ol><li>stream, creek</li></ol>
mangamangaiatua	<i>intj</i><br><ol><li>abracadabra</li></ol>
mangu	<i>adj</i><br><ol><li>black</li></ol>
mangō	<i>noun</i><br><ol><li>shark</li></ol>
mangō pare	<i>noun</i><br><ol><li>hammerhead shark, hammerhead</li></ol>
mangō taniwha	<i>noun</i><br><ol><li>great white shark</li></ol>
mano	<i>num</i><br><ol><li>thousand</li><li>multitude</li></ol><br><i>noun</i><br><ol><li>host</li><li>creed</li></ol>
mano miriona	<i>num</i><br><ol><li>billion</li></ol>
manu	<i>noun</i><br><ol><li>bird (animal)</li><li>(figuratively) a person held in high esteem</li></ol>
manu kōrero	<i>noun</i><br><ol><li>orator</li></ol>
manuhiri	<i>noun</i><br><ol><li>guest, visitor</li></ol>
marae	<i>noun</i><br><ol><li>The courtyard of a wharenui or meeting-house and the buildings around it.</li></ol>
marama	<i>noun</i><br><ol><li>moon</li><li>month</li></ol>
maramataka	<i>noun</i><br><ol><li>the traditional Maori lunar calendar</li><li>calendar</li><li>almanac</li></ol>
marangai	<i>adj</i><br><ol><li>north</li><li>north wind</li><li>northerly</li></ol><br><i>noun</i><br><ol><li>bad weather</li><li>east wind</li><li>east</li><li>rainstorm</li></ol>
marangai kirikiri	<i>noun</i><br><ol><li>sandstorm</li></ol>
marino	<i>adj</i><br><ol><li>calm</li></ol><br><i>noun</i><br><ol><li>fine weather, tranquility</li></ol><br><i>verb</i><br><ol><li>to be calm or still (usually of the sea)</li></ol>
mata	<i>adj</i><br><ol><li>raw (uncooked)</li></ol><br><i>noun</i><br><ol><li>eye (organ)</li></ol>
mata ipurangi	<i>noun</i><br><ol><li>internet browser</li><li>media browser</li></ol>
mataku	<i>adj</i><br><ol><li>afraid</li></ol><br><i>verb</i><br><ol><li>to fear (feel fear about (something))</li></ol>
matangi	<i>noun</i><br><ol><li>wind</li><li>breeze</li></ol>
matatangitangi	<i>noun</i><br><ol><li>lament</li><li>dirge</li></ol>
matau	<i>noun</i><br><ol><li>hook</li></ol>
mate	<i>noun</i><br><ol><li>death</li><li>sickness, illness, disease</li><li>misfortune, calamity, defect</li><li>desire, need, want</li></ol><br><i>verb</i><br><ol><li>(stative) to be dead, deceased, killed</li><li>(stative) to be sick, ill, unwell, diseased</li><li>(stative) to be defeated, conquered, beaten, overcome</li><li>(stative) to be in want of, deeply in love</li></ol>
mate hukapuri	<i>noun</i><br><ol><li>frostbite</li></ol>
mate pāpōuri	<i>noun</i><br><ol><li>(psychology) depression</li></ol>
matea ako	<i>noun</i><br><ol><li>learning needs</li></ol>
matira	<i>verb</i><br><ol><li>To fish (with a rod)</li></ol><br><i>adj</i><br><ol><li>lookout</li></ol><br><i>noun</i><br><ol><li>fishing rod</li><li>lookout</li></ol>
matira auahi	<i>noun</i><br><ol><li>fire alarm</li></ol>
matomato	<i>adj</i><br><ol><li>lush, verdant</li></ol><br><i>noun</i><br><ol><li>lushness</li></ol><br><i>verb</i><br><ol><li>to be green (of foliage)</li><li>aesthetically pleasing</li></ol>
matua|mātua	<i>noun</i><br><ol><li>elder</li><li>parent</li></ol>
matua kēkē	<i>noun</i><br><ol><li>uncle</li></ol>
matā	<i>noun</i><br><ol><li>lead</li><li>bullet</li></ol>
mauka	<i>noun</i><br><ol><li>(dialectal) mountain</li></ol>
maunga	<i>noun</i><br><ol><li>mountain</li></ol>
mauri	<i>noun</i><br><ol><li>life principle; metaphorical soul; source of life</li></ol>
mauī	<i>adj</i><br><ol><li>left (the west side of the body when one is facing north)</li></ol><br><i>adv</i><br><ol><li>on the left side</li></ol>
me	<i>particle</i><br><ol><li>and (joins two noun phrases)</li><li>with (indicates people or things present when an event occurs)</li><li>must, should (used before verbs to form a weak command)</li><li>must be (used before nouns and adjectives)</li><li>how should it be done (used before pēhea and a clause)</li><li>if only (reverses what is stated)</li><li>as if, like (simile)</li><li>to see whether</li></ol>
mea	<i>noun</i><br><ol><li>thing</li></ol>
mea ngaro	<i>noun</i><br><ol><li>mystery</li></ol>
merekara	<i>noun</i><br><ol><li>miracle</li></ol>
mihi	<i>noun</i><br><ol><li>A welcome</li><li>A speech made to welcome somebody</li></ol><br><i>verb</i><br><ol><li>To welcome.</li></ol>
mina|minaia|minahia|minatia	<i>noun</i><br><ol><li>desire; wish</li><li>aspiration</li><li>longing</li><li>appetite</li></ol><br><i>verb</i><br><ol><li>to desire</li><li>to feel an inclination</li><li>to wish</li><li>to have a craving for</li></ol>
miraka	<i>noun</i><br><ol><li>milk</li></ol><br><i>verb</i><br><ol><li>to milk</li></ol>
miriona	<i>num</i><br><ol><li>million</li></ol>
miware	<i>noun</i><br><ol><li>young snail whelk (Haustrum haustorium, brown rock shell or dark rock shell)</li></ol>
moa	<i>noun</i><br><ol><li>moa a bird (extinct, Dinornis)</li></ol>
moana	<i>noun</i><br><ol><li>ocean, sea</li></ol>
moe	<i>verb</i><br><ol><li>to sleep</li></ol>
moemoeā	<i>noun</i><br><ol><li>dream</li></ol>
moenanu	<i>noun</i><br><ol><li>nightmare</li></ol>
moeone	<i>noun</i><br><ol><li>bass (fish)</li><li>toheroa (an edible mollusc)</li></ol>
moepapa	<i>noun</i><br><ol><li>nightmare</li></ol>
moeriki	<i>noun</i><br><ol><li>Dieffenbach's rail</li></ol>
moho-pererū	<i>noun</i><br><ol><li>buff-banded rail</li></ol>
moko	<i>noun</i><br><ol><li>Polynesian tattoo</li><li>lizard, gecko</li></ol>
mokomoko	<i>noun</i><br><ol><li>gecko</li><li>lizard</li></ol>
mokonui	<i>noun</i><br><ol><li>dinosaur</li></ol>
mokopuna	<i>noun</i><br><ol><li>grandchild</li></ol>
momo	<i>noun</i><br><ol><li>a type, a kind, a species, a breed, a variety, a race, a genre</li></ol>
moni	<i>noun</i><br><ol><li>money, cash</li></ol>
more	<i>noun</i><br><ol><li>taproot</li></ol>
morehu	<i>noun</i><br><ol><li>Followers of the Ratana Church, remnants of tribes, survivors.</li></ol>
motokā	<i>noun</i><br><ol><li>car, automobile</li></ol>
motopaika	<i>noun</i><br><ol><li>motorcycle</li></ol>
motu	<i>noun</i><br><ol><li>island, country, land, nation, clump of trees, ship - anything separated or isolated</li><li>cut, wound</li></ol><br><i>verb</i><br><ol><li>to sever, cut, cut off, set free, separate</li><li>to be separated, moved to a distance - especially in the phrase motu ki te ara</li><li>to be set free, escape</li><li>(stative) to be cut, severed</li></ol>
motumotu	<i>verb</i><br><ol><li>divided, broken up, cut</li></ol><br><i>adj</i><br><ol><li>separated</li><li>(mathematics) discrete</li></ol><br><i>noun</i><br><ol><li>firebrand</li><li>piece of burning wood</li><li>a dumpling or doughboy</li></ol>
moutere	<i>noun</i><br><ol><li>(geography) island</li></ol>
muri	<i>adv</i><br><ol><li>after</li></ol>
mutu	<i>verb</i><br><ol><li>to cease</li></ol>
mutunga	<i>noun</i><br><ol><li>end; finish; conclusion</li></ol>
mutunga wiki	<i>noun</i><br><ol><li>weekend</li></ol>
mā	<i>noun</i><br><ol><li>(colour/color) white</li></ol>
māhū	<i>verb</i><br><ol><li>to be gentle</li></ol>
mākutu	<i>noun</i><br><ol><li>sorcery</li><li>curse</li></ol><br><i>adj</i><br><ol><li>magical</li><li>supernatural</li></ol>
māngoingoi|māngoingoihia|māngoingoitia	<i>verb</i><br><ol><li>(fishing) surfcasting</li><li>(intransitive) to fish with a line from the shore</li></ol>
mānu	<i>verb</i><br><ol><li>(stative) be floating, launch, afloat</li><li>(stative) be flooded, overflow</li></ol>
mānuka	<i>noun</i><br><ol><li>Leptospermum scoparium, a shrub or small tree native to New Zealand and southeast Australia.</li></ol>
māori	<i>adj</i><br><ol><li>normal, usual, natural, common, ordinary</li><li>native, indigenous, fresh (of water), belonging to Aotearoa/New Zealand, clear, intelligible</li><li>freely, without restraint, without ceremony, without object, unannounced</li></ol><br><i>noun</i><br><ol><li>aboriginal inhabitant, indigenous person, native (especially of the Pacific islands)</li></ol>
māramatanga	<i>noun</i><br><ol><li>clarity</li><li>enlightenment</li></ol>
mārena	<i>verb</i><br><ol><li>to marry</li></ol><br><i>noun</i><br><ol><li>marriage, wedding</li></ol>
mārenatanga	<i>noun</i><br><ol><li>marriage</li></ol>
mātanga	<i>noun</i><br><ol><li>experienced person, expert, professional</li></ol><br><i>adj</i><br><ol><li>sophisticated, experienced</li></ol>
mātau	<i>noun</i><br><ol><li>knowledge, understanding</li></ol><br><i>verb</i><br><ol><li>to know, to understand</li></ol>
mātauranga	<i>noun</i><br><ol><li>knowledge, wisdom</li><li>education</li></ol>
mātou	<i>pron</i><br><ol><li>First person plural exclusive</li></ol>
mātātoka	<i>noun</i><br><ol><li>fossil</li></ol>
māua	<i>pron</i><br><ol><li>First person dual exclusive</li></ol>
māwhero	<i>noun</i><br><ol><li>(colour/color) pink</li></ol>
mētara	<i>noun</i><br><ol><li>metal</li></ol>
mīhini turaki	<i>noun</i><br><ol><li>artillery</li></ol>
mīti	<i>noun</i><br><ol><li>meat</li></ol>
mīti hipi	<i>noun</i><br><ol><li>mutton, lamb</li></ol>
mīti kau	<i>noun</i><br><ol><li>beef</li></ol>
mōkō	<i>noun</i><br><ol><li>smoko</li></ol>
mōrearea	<i>adj</i><br><ol><li>dangerous</li></ol>
mōrena	<i>intj</i><br><ol><li>good morning</li></ol>
mūhore	<i>adj</i><br><ol><li>futile, pointless</li><li>unproductive</li></ol>
nama	<i>noun</i><br><ol><li>number, numeral</li><li>bill, invoice</li></ol>
namu	<i>noun</i><br><ol><li>sandfly of the genus Austrosimulium.</li></ol>
nanenane	<i>noun</i><br><ol><li>goat</li></ol>
nau mai	<i>intj</i><br><ol><li>welcome</li></ol>
neke	<i>noun</i><br><ol><li>snake</li></ol>
ngahuru	<i>num</i><br><ol><li>(dated) ten</li></ol><br><i>noun</i><br><ol><li>autumn</li></ol>
nganga	<i>noun</i><br><ol><li>hail</li><li>stone of a fruit</li><li>core of a boil</li><li>shell or husk</li></ol>
ngaupuku	<i>noun</i><br><ol><li>stomachache</li></ol>
ngeru	<i>noun</i><br><ol><li>cat (Felis silvestris catus)</li></ol>
ngutoro	<i>noun</i><br><ol><li>bass (fish)</li></ol>
ngā	<i>article</i><br><ol><li>the (plural)</li></ol>
ngā tae	<i>noun</i><br><ol><li>color(s)</li></ol>
ngārara	<i>noun</i><br><ol><li>lizard</li></ol>
ngāwhā	<i>noun</i><br><ol><li>geyser, fumarole, hot spring</li></ol><br><i>adj</i><br><ol><li>geothermal</li></ol>
ngāwhāriki	<i>noun</i><br><ol><li>hot spring</li><li>sulfur; sulfur-rich volcanic rock</li></ol><br><i>adj</i><br><ol><li>geothermal</li></ol>
ngū	<i>noun</i><br><ol><li>broad squid</li></ol>
niho	<i>noun</i><br><ol><li>tooth</li><li>sharp edge</li></ol>
niu	<i>noun</i><br><ol><li>coconut</li></ol>
noa	<i>particle</i><br><ol><li>merely, suddenly, unintentionally, etc. Denotes an absence of limitations or conditions. (Follows immediately after the word.)</li></ol><br><i>verb</i><br><ol><li>to be unrestricted</li></ol>
noho|nohoia	<i>verb</i><br><ol><li>to sit</li><li>(transitive) to reside, dwell</li><li>(transitive) to reign</li></ol>
noke	<i>noun</i><br><ol><li>worm</li></ol>
nui	<i>adj</i><br><ol><li>big</li></ol>
nūpepa	<i>noun</i><br><ol><li>newspaper</li></ol>
o	<i>particle</i><br><ol><li>of</li></ol>
oka	<i>noun</i><br><ol><li>yam</li></ol>
oki	<i>noun</i><br><ol><li>rest</li></ol>
oma	<i>verb</i><br><ol><li>run, race, flee, escape, move quickly, run away</li></ol>
one	<i>noun</i><br><ol><li>beach</li><li>sand, mud</li><li>soil, earth</li></ol>
onehunga	<i>noun</i><br><ol><li>alluvial soil</li><li>beach composed of mixed sand and mud</li></ol>
onika	<i>noun</i><br><ol><li>onyx</li></ol>
ono	<i>num</i><br><ol><li>six</li></ol>
ono tekau	<i>num</i><br><ol><li>sixty</li></ol>
ora	<i>verb</i><br><ol><li>to exist</li><li>to be alive, well, safe, cured, recovered, healthy</li><li>to survive</li></ol><br><i>noun</i><br><ol><li>life</li><li>existence</li></ol>
oroi	<i>verb</i><br><ol><li>to hone, sharpen</li></ol>
orokohanga	<i>noun</i><br><ol><li>origin</li><li>creation</li></ol>
ota	<i>verb</i><br><ol><li>to eat raw</li></ol>
oti	<i>adj</i><br><ol><li>finished</li><li>completed</li></ol>
otinga	<i>noun</i><br><ol><li>result, product, quotient</li></ol>
paea	<i>noun</i><br><ol><li>swordfish (Xiphias gladius)</li><li>flint</li></ol>
pai	<i>adv</i><br><ol><li>good</li><li>excellent</li><li>suitable</li><li>nice</li><li>pleasant</li></ol><br><i>noun</i><br><ol><li>goodness</li><li>excellence</li><li>suitability</li></ol>
paihamu	<i>noun</i><br><ol><li>brushtail possum (Trichosurus vulpecula)</li></ol>
paihikara	<i>noun</i><br><ol><li>bicycle</li></ol>
pakakina	<i>adj</i><br><ol><li>glowing</li></ol>
pakanga	<i>noun</i><br><ol><li>war; battle</li></ol>
paki	<i>verb</i><br><ol><li>To slap</li></ol>
pakiaka	<i>noun</i><br><ol><li>root (of a tree)</li></ol>
pakini	<i>noun</i><br><ol><li>nick (small cut in a surface)</li><li>(punctuation) apostrophe (the character ’)</li></ol><br><i>verb</i><br><ol><li>to pinch (to squeeze a small amount of skin)</li><li>to nick (to make a nick or notch in)</li></ol>
pamakaranete	<i>noun</i><br><ol><li>pomegranate</li></ol>
panana	<i>noun</i><br><ol><li>banana</li></ol>
panata	<i>noun</i><br><ol><li>panther</li></ol>
pango	<i>noun</i><br><ol><li>black (colour/color)</li></ol>
papa	<i>noun</i><br><ol><li>board, plank</li><li>chart</li><li>slab</li><li>floor</li></ol>
papa mahi	<i>noun</i><br><ol><li>(computing) desktop</li></ol>
papahū	<i>verb</i><br><ol><li>to ignite, flare up, burst into flame</li></ol>
papakupu	<i>noun</i><br><ol><li>dictionary</li><li>lexicon, vocabulary</li></ol>
papamahi	<i>noun</i><br><ol><li>(computing) desktop</li></ol>
parai	<i>verb</i><br><ol><li>to fry</li></ol>
parakuihi	<i>noun</i><br><ol><li>breakfast</li></ol><br><i>verb</i><br><ol><li>to have breakfast</li></ol>
parauri	<i>noun</i><br><ol><li>brown</li></ol>
parāoa	<i>noun</i><br><ol><li>sperm whale (Physeter macrocephalus)</li><li>whale</li><li>whalebone</li><li>weapon made of whalebone</li><li>flour</li><li>bread</li></ol>
pata	<i>noun</i><br><ol><li>granule, drip</li></ol>
patu	<i>verb</i><br><ol><li>to strike, to beat, to kill</li></ol><br><i>noun</i><br><ol><li>beating, assault, killing</li><li>weapon, club</li></ol>
pea	<i>noun</i><br><ol><li>bear</li></ol>
peka	<i>noun</i><br><ol><li>bat (the flying mammal)</li></ol>
pekapeka	<i>noun</i><br><ol><li>bat (animal)</li></ol>
penapena	<i>verb</i><br><ol><li>to save up (accumulate money for a specific purpose)</li></ol>
peopeo	<i>adj</i><br><ol><li>slippery</li></ol>
pepa	<i>noun</i><br><ol><li>paper</li></ol>
pepe tunga	<i>noun</i><br><ol><li>huhu beetle or Prionoplus reticularis, a longhorn beetle species of the Cerambycidae family which is the largest endemic beetle found in New Zealand.</li></ol>
pepeha	<i>noun</i><br><ol><li>an introductory speech detailing one's ancestry</li><li>proverb; motto; slogan</li></ol>
pepeke nguturoa	<i>noun</i><br><ol><li>weevil</li></ol>
pera	<i>noun</i><br><ol><li>pillow</li></ol>
pere tapaono	<i>noun</i><br><ol><li>chevron</li></ol>
pewa	<i>noun</i><br><ol><li>eyebrow</li></ol>
piana	<i>noun</i><br><ol><li>piano</li></ol>
piapia	<i>adj</i><br><ol><li>viscid; glairy</li></ol>
pihapiha	<i>noun</i><br><ol><li>a blowhole (of a cetacean)</li><li>a gill (of an aquatic animal)</li></ol>
piki	<i>noun</i><br><ol><li>fig tree</li><li>fig</li></ol>
pine	<i>noun</i><br><ol><li>pin, tack, brooch</li></ol>
piopio	<i>noun</i><br><ol><li>piopio (Turnagra spp.)</li><li>double-banded plover (Charadrius bicinctus)</li><li>New Zealand blueberry (Dianella nigra)</li></ol>
pirau	<i>adj</i><br><ol><li>rotten</li></ol>
pirihimana	<i>noun</i><br><ol><li>police</li><li>police officer, constable</li></ol>
pirikoko	<i>noun</i><br><ol><li>mystery</li></ol>
piriona	<i>num</i><br><ol><li>billion</li></ol>
pito	<i>noun</i><br><ol><li>navel</li></ol>
poaka	<i>noun</i><br><ol><li>pig</li><li>pork</li></ol>
poka tōrere	<i>noun</i><br><ol><li>abyss, bottomless pit, chasm</li></ol>
poke	<i>adj</i><br><ol><li>grimy</li></ol>
ponga	<i>noun</i><br><ol><li>silver fern (Alsophila dealbata)</li></ol>
pono	<i>noun</i><br><ol><li>truth, non-fiction, validity</li></ol><br><i>adj</i><br><ol><li>true, valid, honest, genuine, sincere</li></ol>
poporokaiwhiri	<i>noun</i><br><ol><li>pigeonwood (Hedycarya arborea)</li></ol>
poro-tapaono	<i>noun</i><br><ol><li>hexagonal prism</li></ol>
poro-tapawhā rite	<i>noun</i><br><ol><li>square prism</li></ol>
pota	<i>noun</i><br><ol><li>sample</li></ol>
poti	<i>noun</i><br><ol><li>cat (Felis silvestris catus)</li></ol>
pou	<i>noun</i><br><ol><li>pillar</li></ol>
pouako	<i>noun</i><br><ol><li>teacher</li><li>tutor</li></ol>
pounamu	<i>adj</i><br><ol><li>dark green</li></ol><br><i>noun</i><br><ol><li>greenstone, nephrite</li><li>glass bottle</li></ol>
pounemu	<i>noun</i><br><ol><li>(South Island) greenstone, nephrite</li></ol>
puha	<i>noun</i><br><ol><li>gill (of fish)</li><li>the sow thistle, also called rareke, or raraki</li></ol>
pukapuka	<i>noun</i><br><ol><li>book</li></ol>
puke	<i>noun</i><br><ol><li>(geography) hill</li></ol>
puku	<i>noun</i><br><ol><li>(anatomy) stomach, belly</li></ol>
pune	<i>noun</i><br><ol><li>spoon</li></ol>
punua	<i>adj</i><br><ol><li>small.</li></ol><br><i>noun</i><br><ol><li>a baby animal.</li></ol>
punua ngeru	<i>noun</i><br><ol><li>a small cat; a kitten</li></ol>
puta	<i>noun</i><br><ol><li>hole</li><li>anus</li></ol><br><i>verb</i><br><ol><li>to pass through and out</li><li>to graduate</li><li>to run off; to escape</li><li>to be born</li></ol>
putiputi	<i>noun</i><br><ol><li>flower</li></ol>
putoko	<i>noun</i><br><ol><li>slug</li></ol>
pā	<i>verb</i><br><ol><li>to touch, strike, hit (as by a stone), tag, affect</li><li>to reach</li><li>to be connected with, relate to, pertaining to, regarding</li><li>to be heard, reach one's ears, hold personal communication with</li><li>to blow (as the wind)</li><li>to participate, act together, act in concert, join in (an undertaking)</li><li>to have sex</li><li>to block up</li></ol><br><i>noun</i><br><ol><li>fortified place</li><li>fortified village, usually on steep-sided raised ground that facilitates defence and affords good view of approaching attackers, such as a hilltop, promontory or small island</li><li>screen or blockade</li><li>clump, group or flock</li><li>contact (netball, etc.)</li></ol>
pākaha	<i>adj</i><br><ol><li>strict, severe</li></ol>
pākaukau	<i>noun</i><br><ol><li>wing</li></ol>
pākehā	<i>noun</i><br><ol><li>New Zealander of European descent</li><li>foreigner, alien</li></ol><br><i>verb</i><br><ol><li>to become pākehā, to become westernised or influenced by British culture</li></ol>
pākete	<i>noun</i><br><ol><li>pocket</li></ol>
pāmu wēra	<i>noun</i><br><ol><li>sperm whale (Physeter macrocephalus)</li></ol>
pāngarau	<i>noun</i><br><ol><li>mathematics</li></ol>
pāpaka	<i>noun</i><br><ol><li>paddle crab</li><li>crab</li><li>scab</li></ol>
pāpā	<i>noun</i><br><ol><li>father, dad</li><li>uncle</li></ol>
pāreti	<i>noun</i><br><ol><li>porridge</li></ol>
pātai	<i>noun</i><br><ol><li>a question</li></ol><br><i>verb</i><br><ol><li>to ask, to question</li></ol>
pātata	<i>adj</i><br><ol><li>neighbouring</li></ol>
pāteke	<i>noun</i><br><ol><li>The brown teal, a species of dabbling duck.</li></ol>
pāua	<i>noun</i><br><ol><li>Any of the three species of large edible sea snails, marine gastropod molluscs of the family Haliotidae (sole genus Haliotis), known in the United States and Australia as abalone, and in the United Kingdom as ormer shells.</li></ol>
pēhea|pēheatia	<i>verb</i><br><ol><li>(interrogative) how?; of what sort?; in what way?</li><li>(interrogative) what way?; in which direction?</li></ol>
pēke	<i>noun</i><br><ol><li>bank</li></ol>
pī	<i>adj</i><br><ol><li>sodden</li></ol><br><i>noun</i><br><ol><li>snub</li></ol><br><i>verb</i><br><ol><li>to ignore, to slight, to neglect</li></ol>
pīata	<i>verb</i><br><ol><li>to be shiny, bright, polished, glossy</li></ol><br><i>noun</i><br><ol><li>brightness, shine, gloss finish</li></ol>
pīkake	<i>noun</i><br><ol><li>peacock</li></ol>
pīne-ā-Wīwī|pīneā{l}}	<i>noun</i><br><ol><li>French bean</li></ol>
pīokeoke	<i>noun</i><br><ol><li>spiny dogfish (Squalus acanthias)</li><li>spotted estuary smooth-hound (Mustelus lenticulatus)</li></ol>
pītau	<i>noun</i><br><ol><li>frond, shoot</li><li>figurehead on a canoe with such a carving</li><li>canoe with such a figurehead</li></ol>
pīwakawaka	<i>noun</i><br><ol><li>New Zealand fantail (Rhipidura fuliginosa)</li></ol>
pō	<i>noun</i><br><ol><li>night</li></ol>
pōhutukawa	<i>noun</i><br><ol><li>Metrosideros excelsa</li></ol>
pōhēhē|pōhēhētia	<i>verb</i><br><ol><li>to misunderstand</li><li>to be bewildered</li></ol><br><i>particle</i><br><ol><li>(modifier) mistaken, confused, misguided</li></ol><br><i>noun</i><br><ol><li>mistake, misunderstanding, error</li></ol>
pōkiha	<i>noun</i><br><ol><li>fox (animal in genus Vulpes)</li></ol>
pōkokohua	<i>noun</i><br><ol><li>(literally) boiled head</li><li>(vulgar, offensive, derogatory) cunt, motherfucker, a highly offensive insult for an unpleasant person</li></ol>
pōti	<i>verb</i><br><ol><li>vote, elect</li></ol>
pōtitanga	<i>noun</i><br><ol><li>election</li></ol>
pū	<i>noun</i><br><ol><li>origin, source</li><li>base, foundation</li><li>gun, firearm, musket</li></ol>
pū mīhini	<i>noun</i><br><ol><li>machine gun</li></ol>
pūkeko	<i>noun</i><br><ol><li>pūkeko, purple swamphen</li></ol>
pūmanamārō	<i>noun</i><br><ol><li>(computing) firmware</li></ol>
pūmanawa	<i>noun</i><br><ol><li>natural talent</li><li>(computing) software</li></ol><br><i>verb</i><br><ol><li>to draw a long breath</li><li>(stative) talented, gifted</li></ol>
pūmārō	<i>noun</i><br><ol><li>(computing) hardware</li></ol>
pūnaha	<i>noun</i><br><ol><li>system</li></ol>
pūpū	<i>noun</i><br><ol><li>snail</li></ol>
pūrere	<i>noun</i><br><ol><li>appliance, device</li></ol>
pūtaiao	<i>noun</i><br><ol><li>science</li></ol>
pūtiro tukutuku	<i>noun</i><br><ol><li>web browser</li></ol>
pūtāhono	<i>noun</i><br><ol><li>driver (program acting as interface between an application and hardware)</li></ol>
rae	<i>noun</i><br><ol><li>(anatomy) forehead (part of face above eyebrows)</li><li>(geography) headland</li></ol>
rahi	<i>verb</i><br><ol><li>to be big, many, plentiful, numerous</li><li>(modifier) big, large</li></ol><br><i>noun</i><br><ol><li>size, greatness</li><li>importance, (important person, important people)</li></ol>
rai	<i>noun</i><br><ol><li>rye</li></ol>
raino	<i>noun</i><br><ol><li>rhino</li></ol>
raiona	<i>noun</i><br><ol><li>lion (big cat)</li></ol>
raka	<i>noun</i><br><ol><li>lock</li></ol>
rama	<i>noun</i><br><ol><li>torch</li><li>light</li><li>rum</li></ol>
rangatahi	<i>noun</i><br><ol><li>youth</li><li>younger generation</li><li>fishing net about 20 meters long that is smaller than a kaharoa</li></ol>
rangatira	<i>noun</i><br><ol><li>chief, chieftain, chieftainess, though of lesser rank than an ariki (paramount chief)</li><li>highborn person</li><li>master, mistress</li><li>leader, boss</li></ol><br><i>adj</i><br><ol><li>chiefly</li><li>highborn</li><li>high-ranking</li></ol>
rangatiratanga	<i>noun</i><br><ol><li>chieftainship</li><li>right to exercise authority</li><li>kingdom</li><li>self-determination</li><li>independence</li></ol>
rangi	<i>noun</i><br><ol><li>sky, heaven</li><li>day</li><li>weather</li><li>tune, air, melody</li></ol>
rangitoto	<i>noun</i><br><ol><li>lava</li><li>volcano</li></ol>
rango	<i>noun</i><br><ol><li>fly (insect)</li><li>blowfly</li></ol>
rapunga	<i>noun</i><br><ol><li>search</li><li>investigation</li></ol>
rapunga whakaaro	<i>noun</i><br><ol><li>philosophy</li></ol>
rara	<i>verb</i><br><ol><li>to spread out, to scatter</li><li>to rush in disorder, to stampede</li></ol><br><i>noun</i><br><ol><li>rib</li></ol>
raro	<i>noun</i><br><ol><li>the underworld</li><li>bottom</li><li>north</li></ol><br><i>prep</i><br><ol><li>below</li><li>under</li></ol>
rata	<i>adj</i><br><ol><li>tame</li><li>quiet</li></ol>
rau	<i>noun</i><br><ol><li>leaf</li></ol><br><i>num</i><br><ol><li>hundred</li></ol>
raupō	<i>noun</i><br><ol><li>Typha orientalis; bulrush</li></ol>
raurau	<i>noun</i><br><ol><li>foliage</li></ol>
rautupu	<i>noun</i><br><ol><li>thunderstorm</li></ol>
rehurehu	<i>adj</i><br><ol><li>obscure</li></ol>
reka	<i>adj</i><br><ol><li>nice</li></ol>
reo	<i>noun</i><br><ol><li>voice</li><li>speech, utterance</li><li>language</li></ol>
reo tupu	<i>noun</i><br><ol><li>mother tongue</li></ol>
repo	<i>noun</i><br><ol><li>swamp</li></ol>
rewa	<i>verb</i><br><ol><li>to get under way, to depart, to set off</li></ol>
riha	<i>noun</i><br><ol><li>nit</li></ol>
riki	<i>adj</i><br><ol><li>small, little</li></ol>
rima|lima	<i>num</i><br><ol><li>five</li></ol>
rima tekau	<i>num</i><br><ol><li>fifty</li></ol>
rimu	<i>noun</i><br><ol><li>moss (plants of the division Bryophyta)</li><li>a large tree native to New Zealand, Dacrydium cupressinum; see English rimu.</li></ol>
ringa|as ringaringa	<i>noun</i><br><ol><li>hand</li></ol>
rironga	<i>noun</i><br><ol><li>asset, receipt, acquisition</li></ol>
riroriro	<i>noun</i><br><ol><li>A species of bird, the grey warbler.</li></ol>
rite	<i>verb</i><br><ol><li>to resemble; to be like, similar, alike</li></ol>
roa	<i>adj</i><br><ol><li>long</li><li>tall</li><li>slow</li></ol>
roanga	<i>noun</i><br><ol><li>continuation</li></ol>
roha|rohaina	<i>verb</i><br><ol><li>to spread out, to extend out, to stretch out</li><li>to expand</li></ol>
rona	<i>noun</i><br><ol><li>a binder (for holding papers together)</li></ol><br><i>verb</i><br><ol><li>to bind, to tie together, to confine or tie down with cord</li></ol>
rongo	<i>noun</i><br><ol><li>fame</li><li>news</li></ol>
rongoā|rongoātia	<i>noun</i><br><ol><li>medicine; drug; medication; treatment; remedy; tonic</li><li>solution (to a problem)</li></ol><br><i>verb</i><br><ol><li>to treat; to apply medicines</li><li>to preserve</li></ol>
rongoā āraimate	<i>noun</i><br><ol><li>(immunology) vaccine</li><li>vaccination (inoculation with a vaccine)</li></ol>
rore	<i>noun</i><br><ol><li>rainbow</li></ol>
rorohiko	<i>noun</i><br><ol><li>computer</li></ol>
roto	<i>noun</i><br><ol><li>interior</li><li>lake</li></ol>
rourou	<i>noun</i><br><ol><li>a basket for food</li></ol>
rua	<i>num</i><br><ol><li>two</li></ol><br><i>noun</i><br><ol><li>pit</li><li>cavity</li></ol>
rua tekau	<i>num</i><br><ol><li>twenty</li></ol>
ruaki	<i>verb</i><br><ol><li>to vomit</li></ol>
ruku	<i>verb</i><br><ol><li>to dive</li></ol>
rupe	<i>noun</i><br><ol><li>New Zealand pigeon</li></ol>
ruru	<i>noun</i><br><ol><li>a morepork (type of owl (Ninox novaeseelandiae novaeseelandiae))</li></ol>
rā	<i>noun</i><br><ol><li>(nautical) sail (a piece of fabric attached to a boat)</li><li>sun</li><li>day</li></ol>
rāhui	<i>noun</i><br><ol><li>restriction of access to a place (as a form of taboo)</li><li>bundle</li><li>flock, herd, mob, swarm, cluster</li></ol><br><i>verb</i><br><ol><li>(stative) be reserved, be restricted</li></ol>
rāhuitanga	<i>noun</i><br><ol><li>lockdown (confinement of people as a security measure)</li></ol>
rākau	<i>noun</i><br><ol><li>A weapon; a club or bat.</li><li>A tree, stick, spar, or mast.</li><li>Wood or timber.</li></ol>
rākau whai hua	<i>noun</i><br><ol><li>fruit tree</li></ol>
rāpeti	<i>noun</i><br><ol><li>rabbit</li></ol>
rārangi	<i>noun</i><br><ol><li>list; queue, line</li></ol>
rārā	<i>noun</i><br><ol><li>small branch, twig</li></ol><br><i>adv</i><br><ol><li>over there, there, yonder</li></ol>
rātou	<i>pron</i><br><ol><li>they, them (plural; three or more people)</li></ol>
rātāhuihui	<i>noun</i><br><ol><li>Southern sunfish (Mola alexandrini, syn. Mola ramsayi)</li></ol>
rāua	<i>pron</i><br><ol><li>they two, them two (dual; two people)</li></ol>
rāwhiti	<i>noun</i><br><ol><li>east</li></ol>
rēpara	<i>noun</i><br><ol><li>leopard (Panthera pardus)</li></ol>
rēparo	<i>noun</i><br><ol><li>leopard (Panthera pardus)</li></ol>
rīngi mārena	<i>noun</i><br><ol><li>wedding ring</li></ol>
rō	<i>noun</i><br><ol><li>mantis, praying mantis; stick insect</li></ol>
rōpū	<i>noun</i><br><ol><li>An organized group of people; party, organisation, committee, etc.</li></ol>
rōpū tōrangapū	<i>noun</i><br><ol><li>political party</li></ol>
rōtō	<i>noun</i><br><ol><li>lotto</li></ol>
rūma	<i>noun</i><br><ol><li>room (of a building)</li></ol>
taera	<i>noun</i><br><ol><li>sexual desire</li></ol>
taeratanga	<i>noun</i><br><ol><li>sexual orientation, sexuality</li></ol>
tahepuia	<i>noun</i><br><ol><li>lava</li></ol>
tahi	<i>num</i><br><ol><li>one, single</li></ol><br><i>adv</i><br><ol><li>together, as one, in unison.</li></ol><br><i>noun</i><br><ol><li>sweeping action</li></ol><br><i>verb</i><br><ol><li>to sweep, clear away</li></ol>
tahua	<i>noun</i><br><ol><li>fund</li><li>courtyard</li><li>stencil</li></ol>
tai	<i>noun</i><br><ol><li>sea</li></ol>
tai āniwhaniwha	<i>noun</i><br><ol><li>tidal wave</li></ol>
taiaha	<i>noun</i><br><ol><li>taiaha</li></ol>
taihoa	<i>intj</i><br><ol><li>wait, don't (do something) yet</li></ol>
taika	<i>noun</i><br><ol><li>tiger (Panthera tigris)</li></ol>
taikaha	<i>adj</i><br><ol><li>strict, severe</li><li>violent</li></ol>
takahē	<i>noun</i><br><ol><li>takahe, takahē</li></ol>
takai	<i>verb</i><br><ol><li>To wrap up, wrap round.</li><li>To wind round.</li></ol><br><i>noun</i><br><ol><li>A wrapper; a covering.</li></ol>
takakaha	<i>noun</i><br><ol><li>tibia, shinbone</li></ol>
takatakahi	<i>verb</i><br><ol><li>to trample</li></ol>
takatāpui	<i>noun</i><br><ol><li>close friend of the same gender</li><li>gay person. Usually used in the context of LGBT Māori people</li></ol>
takeketonga	<i>noun</i><br><ol><li>striped marlin (Kajikia audax)</li></ol>
takiuru	<i>verb</i><br><ol><li>to log in</li></ol>
takiwā	<i>noun</i><br><ol><li>territory, area, region</li><li>time, period, season</li><li>(outer) space</li><li>setting</li></ol>
takiwātanga	<i>noun</i><br><ol><li>autism</li></ol>
takoha	<i>noun</i><br><ol><li>pledge</li></ol>
taku|tō mātou|ō māua|ōna|ā mātou|alienable possession|ā kōrua|ā koutou|ō tāua|ō rāua|tāna|ōu|inalienable possession|tōna|tā mātou|tā rātou|tā koutou|ō rātou|tō koutou|ō tātou|ō koutou|tōku|tō tātou|tā tāua|taku|ō mātou|tō kōrua|tō tāua|āku|tana|tō māua|ō kōrua|tō rāua|tā tātou|ō|possessor has control of the relationship.|tāku|ā tāua|tō|possessor has no control over the relationship.|ā rāua|aku|tō rātou|ā māua|tā kōrua|ā rātou|tā rāua|ā tātou|ōku|tāu|tōu|tā māua|ana|āu|āna	<i>pron</i><br><ol><li>my</li></ol>
tamahine|tamāhine	<i>noun</i><br><ol><li>girl</li><li>daughter</li></ol><br><i>adj</i><br><ol><li>girlish</li></ol>
tamaiti|tamariki	<i>noun</i><br><ol><li>child</li></ol>
tamāhine	<i>noun</i><br><ol><li>daughter</li><li>girl</li></ol><br><i>adj</i><br><ol><li>girlish</li></ol>
tangaroa wae whitu	<i>noun</i><br><ol><li>Astrostole scabra - a large starfish with only seven arms.</li></ol>
tangata|tāngata	<i>noun</i><br><ol><li>human being, person, man</li></ol>
tangata ira tāne	<i>noun</i><br><ol><li>a person assigned female at birth who behave as a man</li></ol>
tangata māori|tāngata māori	<i>noun</i><br><ol><li>human being (as opposed to supernatural being)</li></ol>
tangata tiriti	<i>noun</i><br><ol><li>"People of the Treaty", or New Zealanders of non-Maori origin.</li><li>Originally, Europeans who have a right to live New Zealand under the Treaty of Waitangi but now including peoples of other ethnic origins who live in New Zealand.</li></ol>
tangata whenua	<i>noun</i><br><ol><li>indigenous people</li><li>hosts</li></ol>
tangi|tangihia	<i>noun</i><br><ol><li>weeping, mourning, lament</li><li>sound, intonation</li><li>(music) pitch</li></ol><br><i>verb</i><br><ol><li>(intransitive) to cry (to weep)</li><li>to sing, make a sound</li></ol>
tangihanga	<i>noun</i><br><ol><li>funeral</li></ol>
tangitangi|tangitangihia	<i>noun</i><br><ol><li>sound</li><li>salute</li><li>wave</li></ol><br><i>verb</i><br><ol><li>to cry</li><li>to mourn</li><li>to make a sound</li></ol>
tangiweto	<i>noun</i><br><ol><li>crybaby</li></ol><br><i>verb</i><br><ol><li>to fret</li><li>to cry</li></ol>
taniwha	<i>noun</i><br><ol><li>taniwha</li></ol>
tao	<i>noun</i><br><ol><li>spear</li></ol>
taonga	<i>noun</i><br><ol><li>property</li><li>anything treasured or highly prized</li></ol>
tapa	<i>noun</i><br><ol><li>rim, edge, boundary</li><li>split</li><li>labia</li></ol>
tapaono	<i>noun</i><br><ol><li>hexagon</li></ol>
tapatoru	<i>noun</i><br><ol><li>triangle</li></ol>
tapu	<i>adj</i><br><ol><li>holy, sacred, consecrated</li><li>restricted, prohibited, forbidden</li></ol><br><i>noun</i><br><ol><li>taboo, restriction (as a spiritual or supernatural condition)</li></ol>
tarakihi	<i>noun</i><br><ol><li>A grey and black saltwater fish, Nemadactylus macropterus, found off the coast of Australia, New Zealand and South America.</li></ol>
taraute	<i>noun</i><br><ol><li>trout</li></ol>
tari	<i>noun</i><br><ol><li>plaiting of several strands</li><li>noose (for catching birds)</li></ol><br><i>verb</i><br><ol><li>to ensnare</li></ol>
taro	<i>noun</i><br><ol><li>taro</li><li>bread</li></ol>
taru	<i>noun</i><br><ol><li>weed, grass; small vegetation</li></ol>
tarākona	<i>noun</i><br><ol><li>dragon</li></ol>
tarāpunga	<i>noun</i><br><ol><li>red-billed gull</li><li>black-billed gull</li></ol>
tatauranga	<i>noun</i><br><ol><li>statistics (mathematical science)</li></ol>
tau|mātau	<i>noun</i><br><ol><li>year (time it takes for the Earth to complete one revolution of the Sun)</li><li>year (time it takes for any planetary body to make one revolution around another body)</li><li>year (a period between set dates that mark a year)</li><li>year (scheduled part of a calendar year spent in a specific activity)</li><li>year (Julian year)</li><li>year (level or grade at school or college)</li><li>knowledge</li></ol><br><i>verb</i><br><ol><li>to settle</li><li>(stative) to know</li></ol>
tauhou	<i>noun</i><br><ol><li>silvereye; wax-eye, waxeye.</li></ol>
tauiwi	<i>noun</i><br><ol><li>foreigner, European, non-Māori, colonist</li><li>person coming from afar</li><li>Gentile, heathen</li><li>outsider</li></ol>
tauoranga	<i>noun</i><br><ol><li>existence</li></ol>
taurumarumaki	<i>verb</i><br><ol><li>to duck someone else into the water</li></ol>
tauwhere	<i>verb</i><br><ol><li>to bind</li></ol>
te|ngā	<i>article</i><br><ol><li>the</li></ol><br><i>det</i><br><ol><li>Referring to a whole class of things or people designated by the noun that follows.</li><li>Mr, mister, sir (capitalised)</li><li>Used in front of another verb following a stative.</li><li>Used in front of another verb following taea.</li><li>Used before the names for the days of the week.</li><li>Sometimes used before numbers with a following noun.</li><li>Used before ordinal numbers including those using tua-.</li></ol>
te Whenua o Kōngo	<i>name</i><br><ol><li>Democratic Republic of the Congo (a country in Africa)</li></ol>
te reo	<i>name</i><br><ol><li>The Māori language.</li><li>Used other than figuratively or idiomatically: see te, reo.</li></ol>
te reo Māori	<i>noun</i><br><ol><li>the Maori language</li></ol>
te reo Pākehā	<i>noun</i><br><ol><li>English language</li></ol>
tea	<i>adj</i><br><ol><li>white</li></ol>
teina|tēina	<i>noun</i><br><ol><li>younger brother of a male</li><li>younger sister of a female</li></ol>
tekau	<i>num</i><br><ol><li>ten</li><li>(archaic) twenty</li></ol>
tekau mā iwa	<i>num</i><br><ol><li>nineteen</li></ol>
tekau mā ono	<i>num</i><br><ol><li>sixteen</li></ol>
tekau mā rima	<i>num</i><br><ol><li>fifteen</li></ol>
tekau mā rua	<i>num</i><br><ol><li>twelve</li></ol>
tekau mā tahi	<i>num</i><br><ol><li>eleven</li></ol>
tekau mā toru	<i>num</i><br><ol><li>thirteen</li></ol>
tekau mā waru	<i>num</i><br><ol><li>eighteen</li></ol>
tekau mā whitu	<i>num</i><br><ol><li>seventeen</li></ol>
tekau mā whā	<i>num</i><br><ol><li>fourteen</li></ol>
temepara	<i>noun</i><br><ol><li>temple</li></ol>
tenga	<i>noun</i><br><ol><li>goitre</li></ol>
terepōno	<i>noun</i><br><ol><li>(obsolete) telephone</li></ol>
terewhōno	<i>noun</i><br><ol><li>(obsolete) telephone</li></ol>
tia	<i>noun</i><br><ol><li>abdomen, stomach</li><li>umbilical cord</li><li>deer</li><li>steering</li></ol><br><i>verb</i><br><ol><li>to steer</li></ol>
tiaki	<i>verb</i><br><ol><li>guard or keep</li></ol><br><i>noun</i><br><ol><li>jack (playing card)</li></ol>
tiara	<i>noun</i><br><ol><li>vagabond</li></ol>
tikanga	<i>noun</i><br><ol><li>custom, convention, correct manner of doing things</li><li>traditional lore and protocols</li><li>reason, purpose</li><li>meaning</li></ol>
tiki	<i>noun</i><br><ol><li>Figurine.</li></ol>
tikinare	<i>noun</i><br><ol><li>dictionary</li></ol>
tina	<i>verb</i><br><ol><li>be firm, hard, steadfast</li><li>be constipated</li><li>have lunch</li></ol><br><i>noun</i><br><ol><li>constipation</li><li>lunch, dinner (midday meal)</li></ol>
tino	<i>adj</i><br><ol><li>most, more (intensifier)</li></ol>
tino mate nui ki	<i>verb</i><br><ol><li>to have a great desire for</li></ol>
tino tāone	<i>noun</i><br><ol><li>capital city, capital</li></ol>
tio	<i>noun</i><br><ol><li>oyster</li></ol>
tipua	<i>noun</i><br><ol><li>demon</li></ol>
tiriti	<i>noun</i><br><ol><li>street</li><li>treaty</li></ol>
tiro	<i>verb</i><br><ol><li>to observe</li><li>to inspect</li></ol>
tiā	<i>noun</i><br><ol><li>jar (cylindrical container)</li></ol>
toa	<i>adj</i><br><ol><li>brave.</li></ol><br><i>noun</i><br><ol><li>a warrior.</li><li>courage</li><li>a male.</li><li>a store or shop.</li></ol><br><i>verb</i><br><ol><li>to win</li></ol>
tohorā	<i>noun</i><br><ol><li>right whale</li></ol>
tohumate	<i>noun</i><br><ol><li>symptom</li></ol>
tohuto	<i>noun</i><br><ol><li>macron</li></ol>
toke	<i>noun</i><br><ol><li>worm</li></ol>
tokerau	<i>noun</i><br><ol><li>north</li><li>autumn</li></ol>
toki	<i>noun</i><br><ol><li>axe</li></ol>
tomo|tomo-kia	<i>verb</i><br><ol><li>to enter</li></ol>
tonga	<i>noun</i><br><ol><li>south</li></ol>
toru	<i>num</i><br><ol><li>three</li></ol>
toru tekau	<i>num</i><br><ol><li>thirty</li></ol>
toto	<i>noun</i><br><ol><li>blood</li></ol>
tuahine|tuāhine	<i>noun</i><br><ol><li>sister (of a man)</li></ol>
tuakana|tuākana	<i>noun</i><br><ol><li>older brother of a male</li><li>older sister of a female</li></ol>
tuanui	<i>noun</i><br><ol><li>roof</li></ol>
tuatara	<i>noun</i><br><ol><li>tuatara</li></ol>
tuhi	<i>verb</i><br><ol><li>to draw</li><li>to write</li><li>to point at</li></ol>
tuhinga	<i>noun</i><br><ol><li>writing</li></ol>
tuitui	<i>verb</i><br><ol><li>to sew</li></ol>
tuna	<i>noun</i><br><ol><li>eel of various species, including the longfin eel (Anguilla dieffenbachii) and shortfin eel (Anguilla australis)</li></ol>
tungāne	<i>noun</i><br><ol><li>brother (of a female)</li><li>male cousin (of a female)</li></ol>
tunu|tunua	<i>verb</i><br><ol><li>to broil, roast, bake, cook</li></ol>
tupu	<i>verb</i><br><ol><li>to grow</li></ol>
tupua	<i>adj</i><br><ol><li>strange</li></ol><br><i>noun</i><br><ol><li>demon</li><li>foreigner</li><li>strange being</li></ol>
tupuna|tūpuna|tīpuna|tipuna	<i>noun</i><br><ol><li>A grandparent, or any ancestor more remote than one's parents.</li></ol>
ture	<i>noun</i><br><ol><li>law</li></ol>
turi	<i>adj</i><br><ol><li>deaf (not hearing)</li></ol><br><i>noun</i><br><ol><li>(anatomy) knee</li></ol>
tute	<i>noun</i><br><ol><li>masculine equivalent of tūī</li></ol>
tutū	<i>noun</i><br><ol><li>disobedience, offending; hooligan</li></ol><br><i>verb</i><br><ol><li>to be mischievous, disobedient, mutinous, rebellious, undisciplined, or disruptive.</li></ol>
tā	<i>verb</i><br><ol><li>to dump, strike, beat, thump, throw down, tackle</li><li>to apply tattoo</li><li>to carve, cut, etch, fashion</li></ol>
tāhono	<i>noun</i><br><ol><li>(computing) interface</li></ol><br><i>verb</i><br><ol><li>to connect</li></ol>
tāku|tō mātou|ō māua|ōna|ā mātou|alienable possession|ā kōrua|ā koutou|ō tāua|ō rāua|tāna|ōu|inalienable possession|tōna|tā mātou|tā rātou|tā koutou|ō rātou|tō koutou|ō tātou|ō koutou|tōku|tō tātou|taku|tā tāua|ō mātou|tō kōrua|tō tāua|āku|tana|tō māua|ō kōrua|tō rāua|tā tātou|ō|possessor has control of the relationship.|tāku|ā tāua|tō|possessor has no control over the relationship.|ā rāua|aku|tō rātou|ā māua|tā kōrua|ā rātou|tā rāua|ā tātou|ōku|tāu|tōu|tā māua|ana|āu|āna	<i>pron</i><br><ol><li>my</li><li>mine</li></ol>
tāmure	<i>noun</i><br><ol><li>Australasian snapper, New Zealand snapper, silver seabream (Pagrus auratus, syn. Chrysophrys auratus), a silvery pinkish to golden fish with numerous bright blue spots over upper sides.</li></ol>
tāne	<i>noun</i><br><ol><li>man (adult male human)</li></ol>
tāone	<i>noun</i><br><ol><li>town, city, urban area</li></ol><br><i>verb</i><br><ol><li>to establish towns, lay out as a town</li></ol>
tāone matua	<i>noun</i><br><ol><li>capital city, capital</li></ol>
tāpu	<i>noun</i><br><ol><li>a tub, a vat</li></ol>
tāra	<i>noun</i><br><ol><li>dollar, especially a New Zealand dollar</li></ol>
tārere	<i>noun</i><br><ol><li>swing, hanging seat</li><li>pendulum</li></ol><br><i>verb</i><br><ol><li>to swing, to ride on a swing</li></ol>
tāriana	<i>noun</i><br><ol><li>stallion</li></ol>
tātahi	<i>noun</i><br><ol><li>beach</li></ol>
tātou	<i>pron</i><br><ol><li>First person plural inclusive</li></ol>
tāua	<i>pron</i><br><ol><li>First person dual inclusive</li></ol>
tēnei	<i>det</i><br><ol><li>this (referring to something near to the speaker)</li></ol>
tēneti	<i>noun</i><br><ol><li>tent</li></ol>
tēnā	<i>det</i><br><ol><li>that (referring to something near the listener)</li></ol>
tēnā koe	<i>intj</i><br><ol><li>hello (to one person)</li></ol>
tēnā koutou	<i>intj</i><br><ol><li>hello (to three or more people)</li></ol>
tēnā kōrua	<i>intj</i><br><ol><li>hello (to two people)</li></ol>
tērā	<i>det</i><br><ol><li>that, yonder (referring to something distant from both speaker and listener)</li></ol>
tētē	<i>noun</i><br><ol><li>frond, shoot</li><li>(figuratively, by extension) chief</li><li>armless, legless figurehead on a canoe</li></ol>
tī	<i>noun</i><br><ol><li>tea (drink)</li></ol>
tīeke	<i>noun</i><br><ol><li>saddleback (Philesturnus spp.)</li></ol>
tīhi	<i>noun</i><br><ol><li>cheese</li></ol>
tīra	<i>noun</i><br><ol><li>steel</li></ol>
tō	<i>det</i><br><ol><li>(posessive, neutral/informal) your (singular) (Must be followed by a noun.)</li><li>belonging to (combines with dual and plural pronouns)</li><li>(posessive) Denotes ownership of.</li><li>that of, the one of</li></ol><br><i>noun</i><br><ol><li>plant stem/stalk</li><li>dragging</li><li>portage</li><li>stove (Transliteration of English stove)</li></ol><br><i>verb</i><br><ol><li>to vibrate, tingle</li><li>to be calm, peaceful, tranquil</li><li>to set (of an astronomical body)</li><li>to drag or open/shut (incl. both physical and computer windows)</li></ol>
tōhi	<i>noun</i><br><ol><li>toast (bread)</li><li>toast (salutation)</li></ol><br><i>verb</i><br><ol><li>toast (salutation)</li></ol>
tōku|tō mātou|ō māua|ōna|ā mātou|alienable possession|ā kōrua|ā koutou|ō tāua|ō rāua|tāna|ōu|inalienable possession|tōna|tā mātou|tā rātou|tā koutou|ō rātou|tō koutou|ō tātou|ō koutou|tōku|tō tātou|taku|tā tāua|ō mātou|tō kōrua|tō tāua|āku|tana|tō māua|ō kōrua|tō rāua|tā tātou|ō|possessor has control of the relationship.|tāku|ā tāua|tō|possessor has no control over the relationship.|ā rāua|aku|tō rātou|ā māua|tā kōrua|ā rātou|tā rāua|ā tātou|ōku|tāu|tōu|tā māua|ana|āu|āna	<i>pron</i><br><ol><li>my</li><li>mine</li></ol>
tōmato	<i>noun</i><br><ol><li>tomato</li></ol>
tōpito	<i>noun</i><br><ol><li>end</li><li>extremity</li></ol>
tōpito kōpaka	<i>noun</i><br><ol><li>polar ice caps</li></ol>
tōpū	<i>verb</i><br><ol><li>to be assembled in group</li></ol>
tōrangapū	<i>noun</i><br><ol><li>politics</li></ol><br><i>adj</i><br><ol><li>political</li></ol>
tōāpapa	<i>noun</i><br><ol><li>gravity</li></ol>
tūhura	<i>verb</i><br><ol><li>investigate, disclose, discover</li></ol>
tūhāhā	<i>adj</i><br><ol><li>unique, isolated</li></ol><br><i>noun</i><br><ol><li>individuality</li></ol>
tūmanako	<i>verb</i><br><ol><li>to expect, to hope</li></ol>
tūnga	<i>noun</i><br><ol><li>wound</li></ol>
tūnga waka	<i>noun</i><br><ol><li>parking lot</li></ol>
tūpara	<i>noun</i><br><ol><li>double-barrelled shotgun</li></ol>
tūrangawaewae	<i>noun</i><br><ol><li>Spiritual connection with the land.</li></ol>
tūtae	<i>noun</i><br><ol><li>excrement, dung, feces</li></ol>
tūwhaitara	<i>noun</i><br><ol><li>giraffe weevil</li></ol>
tūāuri	<i>noun</i><br><ol><li>indigo</li></ol>
tūī	<i>noun</i><br><ol><li>tui (Prosthemadera novaeseelandiae) a New Zealand bird</li></ol>
ua|uaina|uaua	<i>noun</i><br><ol><li>rain (condensed water from a cloud)</li><li>(anatomy) vein (blood vessel)</li></ol><br><i>verb</i><br><ol><li>to rain</li></ol>
ua kirikiri	<i>noun</i><br><ol><li>sandstorm</li></ol>
uhi	<i>noun</i><br><ol><li>yam (Dioscorea)</li><li>a chisel-like tool used to puncture Maori tattoos (moko)</li></ol>
umu	<i>noun</i><br><ol><li>oven</li></ol>
unahiroa	<i>noun</i><br><ol><li>comet</li><li>will o' the wisp</li></ol>
unu|unumia|unuhia	<i>noun</i><br><ol><li>withdrawal, extraction</li></ol><br><i>verb</i><br><ol><li>pull out, withdraw, draw out, extract</li><li>to pull off, put off, take off (clothes, etc.)</li><li>to exempt, discharge, exclude</li><li>to surrender</li><li>(dialectal) to drink</li></ol>
ura	<i>noun</i><br><ol><li>krill (small marine crustacean)</li><li>whalefeed, Munida gregaria</li><li>shrimp (decapod crustacean)</li></ol>
uranga	<i>noun</i><br><ol><li>glow</li><li>sunrise</li><li>sunset</li></ol>
uraura	<i>noun</i><br><ol><li>krill (small marine crustacean)</li><li>whalefeed, Munida gregaria</li><li>shrimp (decapod crustacean)</li></ol>
uru|urua|uruhina	<i>verb</i><br><ol><li>to enter, go in</li><li>to possess</li><li>to enlist, enrol, join, be included</li></ol><br><i>noun</i><br><ol><li>head (in the singular)</li><li>chief, leader</li><li>top, upper end</li><li>point (of a weapon, etc.)</li><li>hair (of the head, in the plural)</li><li>west</li></ol>
urumaranga	<i>noun</i><br><ol><li>ambush</li></ol>
urupā	<i>noun</i><br><ol><li>a burial ground or cemetery</li></ol>
urupū	<i>adj</i><br><ol><li>diligent</li></ol>
uruwhenua	<i>noun</i><br><ol><li>a passport (official document)</li></ol>
uta|utaina	<i>noun</i><br><ol><li>interior (the inside regions of a country or island)</li><li>land (from a sea or water perspective)</li><li>the shore</li><li>load</li><li>contribution</li><li>import; export</li></ol><br><i>adj</i><br><ol><li>inland (from a coastal perspective)</li><li>ashore</li></ol><br><i>verb</i><br><ol><li>to load on, put on</li></ol>
utauta|utautaina	<i>verb</i><br><ol><li>to load things</li></ol><br><i>noun</i><br><ol><li>equipment, tools, property</li></ol>
utu|utua|utungia	<i>noun</i><br><ol><li>pay; payment; salary</li><li>revenge; payback</li></ol><br><i>verb</i><br><ol><li>to pay</li><li>to reply; to answer</li></ol>
utu-a	<i>noun</i><br><ol><li>to pay</li></ol>
utuutu|utuutuhia|utuutua	<i>noun</i><br><ol><li>(a number of) repayments</li></ol><br><i>verb</i><br><ol><li>to fill a container (with liquid) a number of times</li></ol>
uwhi	<i>noun</i><br><ol><li>yam; Dioscorea alata</li></ol>
wae|waetia|waea	<i>noun</i><br><ol><li>(anatomy) leg</li><li>(anatomy) foot</li></ol><br><i>verb</i><br><ol><li>(mathematics) to divide</li><li>to separate</li><li>to clear away</li></ol>
waea	<i>verb</i><br><ol><li>to be weary</li><li>to telephone, ring</li><li>to send a telegram, wire</li></ol><br><i>noun</i><br><ol><li>telephone, phone</li><li>telegram, telephone message, cable, wire</li></ol>
waha	<i>noun</i><br><ol><li>mouth</li></ol>
wahine|wāhine	<i>noun</i><br><ol><li>woman</li></ol>
wahine mārena	<i>noun</i><br><ol><li>bride, married woman</li></ol>
wai	<i>noun</i><br><ol><li>water (clear liquid H₂O)</li><li>liquid</li></ol><br><i>pron</i><br><ol><li>who?</li></ol>
wai māori	<i>noun</i><br><ol><li>fresh water</li></ol>
waiata	<i>noun</i><br><ol><li>song</li></ol><br><i>verb</i><br><ol><li>to sing</li></ol>
waikato	<i>noun</i><br><ol><li>flowing water</li></ol>
waikura	<i>noun</i><br><ol><li>rust</li></ol>
waimārie	<i>adj</i><br><ol><li>lucky</li><li>fortuitous</li></ol><br><i>noun</i><br><ol><li>good fortune</li><li>luck</li></ol><br><i>verb</i><br><ol><li>to be lucky</li></ol>
waipiro	<i>noun</i><br><ol><li>alcohol, liquor</li></ol>
waiporoporo	<i>noun</i><br><ol><li>purple</li></ol>
waiū	<i>noun</i><br><ol><li>milk</li></ol>
waka	<i>noun</i><br><ol><li>boat, canoe</li><li>vehicle, conveyance</li><li>transport</li></ol>
wani	<i>noun</i><br><ol><li>swan</li></ol>
warapī	<i>noun</i><br><ol><li>wallaby</li></ol>
ware	<i>adj</i><br><ol><li>ignorant</li></ol><br><i>noun</i><br><ol><li>saliva</li></ol>
waro	<i>noun</i><br><ol><li>coal</li></ol>
waru	<i>num</i><br><ol><li>eight</li></ol>
waru tekau	<i>num</i><br><ol><li>eighty</li></ol>
wehe	<i>verb</i><br><ol><li>to separate</li></ol>
wehe atu	<i>verb</i><br><ol><li>to depart, to leave</li></ol>
wehi|wehingia	<i>noun</i><br><ol><li>dread, fear</li></ol><br><i>verb</i><br><ol><li>to be terrible</li><li>to be afraid, fearful</li></ol><br><i>adj</i><br><ol><li>terrific, awful</li></ol>
weta	<i>noun</i><br><ol><li>filth; excrement</li><li>(idiomatic) no way; never!</li></ol>
whaea	<i>noun</i><br><ol><li>mother</li><li>aunt</li></ol>
whaea kēkē	<i>noun</i><br><ol><li>aunty, aunt</li></ol>
whai|whāia	<i>noun</i><br><ol><li>stingray</li><li>skate (fish of family Rajidae)</li><li>pursuit</li></ol><br><i>verb</i><br><ol><li>to follow, chase, pursue</li><li>to look for, search</li></ol>
whaikaha	<i>adj</i><br><ol><li>having strength</li><li>concentrated</li><li>disabled</li></ol><br><i>noun</i><br><ol><li>disability</li></ol><br><i>verb</i><br><ol><li>to have strength</li><li>to be strong enough</li></ol>
whakahohe	<i>verb</i><br><ol><li>to activate (to make something active)</li><li>to enable (to activate a function of an electronic or mechanical device)</li></ol>
whakamaheni	<i>verb</i><br><ol><li>to polish, to burnish</li></ol>
whakamauī	<i>adv</i><br><ol><li>towards the left</li></ol>
whakamā	<i>verb</i><br><ol><li>be ashamed, shy, bashful, embarrassed</li></ol><br><i>adj</i><br><ol><li>ashamed, shy, bashful, embarrassed</li></ol><br><i>noun</i><br><ol><li>shame, embarrassment</li></ol>
whakanau	<i>verb</i><br><ol><li>to decline, refuse</li></ol>
whakapakotanga	<i>noun</i><br><ol><li>banishment</li><li>exile</li></ol>
whakapapa	<i>verb</i><br><ol><li>To lie flat or to lay flat.</li><li>To lay low or to strike down.</li><li>To place in layers or to lay one upon another.</li><li>To recite in order (genealogies, legends, etc.)</li></ol><br><i>noun</i><br><ol><li>Genealogy, genealogical table, descent, lineage.</li></ol>
whakaraka	<i>verb</i><br><ol><li>to walk</li><li>to step out</li></ol>
whakaririka	<i>adj</i><br><ol><li>impassive</li></ol><br><i>verb</i><br><ol><li>to ignore</li></ol>
whakarongo|whakarongona|whakarangona	<i>verb</i><br><ol><li>to hear, to listen</li><li>to obey</li></ol>
whakataurekareka	<i>verb</i><br><ol><li>To treat with contempt.</li></ol>
whakatewhatewha	<i>verb</i><br><ol><li>to investigate</li></ol>
whakatewhatewha pānga	<i>noun</i><br><ol><li>contact tracing</li></ol>
whakatōpū	<i>noun</i><br><ol><li>amalgamation, consolidation</li></ol><br><i>verb</i><br><ol><li>to amalgamate, consolidate, assemble (in a group)</li></ol>
whakatōpū kongakonga	<i>noun</i><br><ol><li>(computing) defragmentation</li></ol><br><i>verb</i><br><ol><li>to defragment</li></ol>
whakawahine|whakawāhine	<i>verb</i><br><ol><li>to act or be as a woman or wahine</li></ol>
whakawhanaungatanga	<i>noun</i><br><ol><li>The process of establishing relationships.</li></ol>
whana	<i>verb</i><br><ol><li>to revolt, rebel, mutiny, rise up, riot</li><li>to spring back, kick (backwards), impel</li><li>to rush, charge</li><li>to travel, come, go</li></ol><br><i>noun</i><br><ol><li>bow (archery)</li><li>revolt, rebellion, mutiny, uprising, riot, insurrection</li><li>jerking, recoiling, springing back</li></ol>
whanaunga	<i>noun</i><br><ol><li>familial relative</li></ol>
whanaungatanga	<i>noun</i><br><ol><li>close relationship</li></ol>
whanga	<i>noun</i><br><ol><li>bay, gulf</li><li>stretch of water</li></ol>
whao	<i>noun</i><br><ol><li>chisel (iron tool)</li><li>nail (metal)</li></ol><br><i>verb</i><br><ol><li>to chisel out</li><li>to go into; to enter</li><li>to put into; to fill</li></ol>
whara	<i>noun</i><br><ol><li>Any of the several plants in the families Asteliaceae and Xanthorrhoeaceae.</li></ol>
wharau	<i>verb</i><br><ol><li>to travel (particularly by sea)</li></ol>
wharaunga	<i>noun</i><br><ol><li>voyage</li></ol>
whare	<i>noun</i><br><ol><li>house</li><li>building</li></ol>
whare herehere	<i>noun</i><br><ol><li>prison</li></ol>
whare karakia	<i>noun</i><br><ol><li>a religious building: a church, a synagogue, a mosque, a house of prayer</li></ol>
whare noho	<i>noun</i><br><ol><li>hostel</li></ol>
whare wānanga	<i>noun</i><br><ol><li>a type of traditional Maori school.</li><li>university, polytechnic</li></ol>
wharenui	<i>noun</i><br><ol><li>wharenui</li></ol>
whata	<i>noun</i><br><ol><li>shelf</li></ol>
whatu	<i>noun</i><br><ol><li>stone</li><li>hailstone</li><li>(anatomy) eye; pupil</li><li>(botany) kernel (of a fruit)</li><li>to weave; to knit</li></ol>
whatura	<i>noun</i><br><ol><li>vulture</li></ol>
whatutoto	<i>adj</i><br><ol><li>advanced</li></ol><br><i>noun</i><br><ol><li>red heartwood</li></ol><br><i>verb</i><br><ol><li>to be advanced</li><li>to mature</li></ol>
whau	<i>noun</i><br><ol><li>corkwood, Entelea arborescens</li><li>five-finger, Pseudopanax arboreus</li></ol>
whawhai	<i>verb</i><br><ol><li>fight</li></ol><br><i>noun</i><br><ol><li>war</li></ol>
wheke	<i>noun</i><br><ol><li>octopus, squid</li></ol>
wheketere	<i>noun</i><br><ol><li>arrow squid</li></ol>
whenu	<i>noun</i><br><ol><li>strand (each of the strings that make up a rope, etc.)</li><li>(weaving) warp</li></ol>
whenua	<i>noun</i><br><ol><li>land</li><li>country</li><li>ground</li><li>placenta, afterbirth</li></ol>
whero	<i>noun</i><br><ol><li>red</li></ol><br><i>adj</i><br><ol><li>red</li></ol>
whetū	<i>noun</i><br><ol><li>star (luminous celestial body)</li></ol>
whiri	<i>verb</i><br><ol><li>to twist</li><li>to weave</li><li>to spin</li><li>to choose, to select, to elect</li><li>to pick</li><li>to decide</li></ol>
whiriwhiri	<i>verb</i><br><ol><li>to negotiate</li></ol>
whiti|whitikia|whitingia|whitikina|whitia	<i>verb</i><br><ol><li>to be alarmed</li><li>(transitive) to exchange, transfer, swap</li><li>(intransitive) to cross over to reach the other side</li><li>to shine (of the sun)</li><li>to be fit</li></ol><br><i>noun</i><br><ol><li>shock, alarm, fright</li><li>cross beam, crossbar</li><li>shining</li><li>verse, stanza, paragraph, clause</li><li>wheat</li><li>fitness</li></ol>
whitu	<i>num</i><br><ol><li>seven</li></ol>
whitu tekau	<i>num</i><br><ol><li>seventy</li></ol>
whā	<i>num</i><br><ol><li>four</li></ol>
whā tekau	<i>num</i><br><ol><li>forty</li></ol>
whāmere	<i>noun</i><br><ol><li>family, household</li></ol>
whānau	<i>verb</i><br><ol><li>to give birth</li><li>to be born</li></ol><br><i>noun</i><br><ol><li>an extended family; a group of family members</li></ol>
whē	<i>noun</i><br><ol><li>mantis, praying mantis; stick insect</li></ol>
wiki	<i>verb</i><br><ol><li>to form circular ripples on the surface of a fluid</li></ol><br><i>noun</i><br><ol><li>week</li><li>wick; fuse</li></ol>
wiri	<i>verb</i><br><ol><li>to bore, twist, drill</li><li>to tremble, shiver, shudder</li></ol><br><i>noun</i><br><ol><li>gimlet, auger, drill, screwdriver, anything for boring holes</li><li>(music) trembling of the hands in Maori singing to indicate the interface between the mind and the body (the wiri represents the shimmering of the ocean water, the heat waves rising from the ground, the wind rustling the tree leaves)</li></ol>
wuruhi	<i>noun</i><br><ol><li>wolf (Canis lupus)</li></ol>
wuruwhi	<i>noun</i><br><ol><li>wolf (Canis lupus)</li></ol>
wā	<i>noun</i><br><ol><li>time</li></ol>
wāhanga	<i>noun</i><br><ol><li>piece</li></ol>
wāhi	<i>verb</i><br><ol><li>to break</li></ol><br><i>noun</i><br><ol><li>a part, a portion</li><li>a place, a location</li><li>an opening, an open area</li></ol>
wāna	<i>noun</i><br><ol><li>swan</li></ol>
wānanga|wānangahia|wānangatia	<i>noun</i><br><ol><li>traditional knowledge, lore</li><li>person who is knowledgeable in the traditional lore</li><li>seminar</li><li>instructor</li></ol><br><i>verb</i><br><ol><li>to meet</li><li>to consider</li></ol>
wāwā|wawā	<i>verb</i><br><ol><li>to be scattered</li></ol><br><i>noun</i><br><ol><li>(with wīwī) somewhere; hither and thither</li></ol>
wētā	<i>noun</i><br><ol><li>weta</li></ol>
wīwī	<i>noun</i><br><ol><li>sea rush, clubrush</li><li>(with wāwā) somewhere; hither and thither</li></ol>
Āketina	<i>name</i><br><ol><li>Argentina (a country in South America)</li></ol>
Ākuhata	<i>name</i><br><ol><li>August (month)</li></ol>
Āmenia	<i>name</i><br><ol><li>Armenia (a country in Europe and Asia)</li></ol>
Ānaru	<i>name</i><br><ol><li>Andrew (biblical)</li></ol>
Āperire	<i>name</i><br><ol><li>April (month)</li></ol>
Ārama	<i>name</i><br><ol><li>Adam (biblical)</li></ol>
Ātaraita	<i>name</i><br><ol><li>Adelaide (the capital of South Australia, Australia)</li></ol>
Āwhekenetāna	<i>name</i><br><ol><li>Afghanistan (a country in Asia)</li></ol>
Āwherika ki te Tonga	<i>name</i><br><ol><li>South Africa (a country in Africa)</li></ol>
ā|āngia|Ā|āia	<i>character</i><br><ol><li>The second letter of the Maori alphabet, written in the Latin script.</li></ol><br><i>noun</i><br><ol><li>collarbone</li></ol><br><i>verb</i><br><ol><li>to drive something, such as cattle or other livestock</li><li>to urge or compel something to move</li></ol><br><i>intj</i><br><ol><li>yeah, yes</li></ol>
āe	<i>particle</i><br><ol><li>yes</li></ol>
āheahea	<i>noun</i><br><ol><li>rainbow</li></ol>
āhuatanga	<i>noun</i><br><ol><li>situation, circumstances</li></ol>
āhumehume	<i>noun</i><br><ol><li>petticoat</li></ol>
āhuru	<i>adj</i><br><ol><li>snug, cozy, comfortable</li><li>warm</li></ol>
āhuruhuru	<i>noun</i><br><ol><li>goatfish</li></ol>
āianei	<i>adv</i><br><ol><li>today, soon, now</li></ol>
āinga	<i>noun</i><br><ol><li>violence</li><li>impetus</li></ol>
āio	<i>noun</i><br><ol><li>halcyon, calm</li></ol><br><i>adj</i><br><ol><li>peaceful, calm</li></ol>
ākau	<i>noun</i><br><ol><li>reef, coast, river bank</li></ol>
āku	<i>abbrev</i><br><ol><li>Contraction of a suffixed with -ku: of me</li></ol>
ākuanei	<i>adv</i><br><ol><li>presently, shortly, soon</li></ol>
ānau	<i>noun</i><br><ol><li>curve</li></ol><br><i>verb</i><br><ol><li>wander, ramble</li></ol>
āngi	<i>noun</i><br><ol><li>air</li></ol>
ānini	<i>noun</i><br><ol><li>sensation</li><li>headache</li></ol>
āniwa	<i>adj</i><br><ol><li>bright</li><li>reckless</li></ol>
āniwaniwa	<i>noun</i><br><ol><li>rainbow</li></ol>
āpaka	<i>noun</i><br><ol><li>alpaca</li></ol>
āpiha	<i>noun</i><br><ol><li>officer, official</li></ol>
āporo	<i>noun</i><br><ol><li>apple</li></ol>
ārahi	<i>verb</i><br><ol><li>to lead</li><li>to escort</li><li>to herald (as the appearance of a particular star signals the beginning of a particular month)</li></ol>
ārai|āraitia|āraihia|āraia	<i>noun</i><br><ol><li>obstacle; barricade</li><li>screen (physical divider)</li><li>insulator</li><li>barrier</li><li>veil; curtain</li><li>apron</li></ol><br><i>verb</i><br><ol><li>to prevent; to forbid; to prohibit; to obstruct; to hinder</li><li>to shield; to block out; to screen</li><li>to insulate</li></ol>
āraimate|ārai mate	<i>noun</i><br><ol><li>(medicine) immunity</li></ol>
ārikarika	<i>adj</i><br><ol><li>restrained</li></ol>
ārohirohi	<i>adj</i><br><ol><li>shimmering, glistening</li></ol><br><i>noun</i><br><ol><li>shimmering heat</li><li>feeling, sense</li></ol><br><i>verb</i><br><ol><li>to hover, quiver or shimmer</li><li>to turn round and round; to feel giddiness.</li></ol>
āta	<i>noun</i><br><ol><li>altar (Christian)</li></ol>
ātaahua	<i>verb</i><br><ol><li>to be beautiful, pretty, good-looking, gorgeous, lovely</li><li>to be handsome, good-looking, gorgeous</li><li>to be pleasant</li></ol><br><i>noun</i><br><ol><li>beauty</li></ol>
ātea	<i>noun</i><br><ol><li>space</li></ol>
āwaawa	<i>noun</i><br><ol><li>valley</li><li>creeks</li></ol>
āwangawanga	<i>noun</i><br><ol><li>distress, worry</li><li>doubt</li></ol>
āwhato	<i>noun</i><br><ol><li>lettuce caterpillar</li></ol>
āwhiowhio	<i>noun</i><br><ol><li>whirlwind</li></ol><br><i>adj</i><br><ol><li>circuitous</li></ol>
āwhā	<i>noun</i><br><ol><li>gale</li><li>storm</li><li>heavy rain</li><li>torrential rain</li></ol>
ē	<i>character</i><br><ol><li>a lengthened form of the letter e</li></ol>
ēkara	<i>noun</i><br><ol><li>eagle (bird of prey)</li></ol>
Īemene	<i>name</i><br><ol><li>Yemen (a country in Asia)</li></ol>
Īhaka	<i>name</i><br><ol><li>Isaac (biblical)</li></ol>
Īhipa	<i>name</i><br><ol><li>Egypt (a country in Africa)</li></ol>
Īhāia	<i>name</i><br><ol><li>Isaiah (biblical)</li></ol>
Īnia	<i>name</i><br><ol><li>India (a country in Asia)</li></ol>
Īrāki	<i>name</i><br><ol><li>Iraq (a country in Asia)</li></ol>
Īrāna	<i>name</i><br><ol><li>Iran (a country in Asia)</li></ol>
ī|Ī	<i>character</i><br><ol><li>The seventh letter of the Maori alphabet, written in the Latin script.</li></ol><br><i>verb</i><br><ol><li>to ferment, to sour, to spoil</li></ol>
īkara	<i>noun</i><br><ol><li>eagle (bird of prey)</li></ol>
Ōtautahi	<i>name</i><br><ol><li>Christchurch (a city in New Zealand)</li></ol>
Ōtepoti	<i>name</i><br><ol><li>Dunedin (a city in New Zealand)</li></ol>
ō|Ō	<i>character</i><br><ol><li>The twelfth letter of the Maori alphabet, written in the Latin script.</li></ol><br><i>noun</i><br><ol><li>food, provisions</li></ol>
ōi	<i>noun</i><br><ol><li>muck</li><li>quicksand</li></ol>
ōku	<i>abbrev</i><br><ol><li>Contraction of o suffixed with -ku: of me</li></ol>
ōritetanga	<i>noun</i><br><ol><li>equality (equal treatment of people)</li></ol>
Ūkareinga	<i>name</i><br><ol><li>Ukraine</li></ol>
ū|Ū	<i>character</i><br><ol><li>The seventeenth letter of the Maori alphabet, written in the Latin script.</li></ol><br><i>noun</i><br><ol><li>breast</li><li>udder, teat</li></ol><br><i>verb</i><br><ol><li>to strike home, to hit the mark (as of a weapon)</li><li>to land (as of a vessel), to come ashore</li><li>to comply</li><li>(stative) to be firm, fixed, unyielding</li></ol>
ʻanakē	<i>adj</i><br><ol><li>alone, only</li></ol>
