Afgan|Afgann	<i>noun</i><br><ol><li>an Afghan</li></ol>
Afganistan	<i>name</i><br><ol><li>Afghanistan (a country in Asia)</li></ol>
Albane|Albanez	<i>noun</i><br><ol><li>an Albanian</li></ol>
Albani	<i>name</i><br><ol><li>Albania (a country in Europe)</li></ol>
Alman|Almand	<i>noun</i><br><ol><li>German person</li></ol>
Alzeri	<i>name</i><br><ol><li>Algeria (a country in Africa)</li></ol>
Alzerien|Alzerienn	<i>noun</i><br><ol><li>an Algerian</li></ol>
Amerikin|Amerikenn	<i>noun</i><br><ol><li>American person</li></ol>
Andor	<i>name</i><br><ol><li>Andorra (a country in Europe)</li></ol>
Andoran|Andorann	<i>noun</i><br><ol><li>an Andorran</li></ol>
Angle|Anglez	<i>noun</i><br><ol><li>English person</li></ol>
Angola	<i>name</i><br><ol><li>Angola (a country in Africa)</li></ol>
Angole|Angolez	<i>noun</i><br><ol><li>an Angolan</li></ol>
Antigwa	<i>name</i><br><ol><li>Antigua (an island)</li></ol>
Antigwa e Barbida	<i>name</i><br><ol><li>Antigua and Barbuda (a country in North America)</li></ol>
Antigwayen|Antigwayenn	<i>noun</i><br><ol><li>an Antiguan</li></ol>
Armeni	<i>name</i><br><ol><li>Armenia (a country in Europe and Asia)</li></ol>
Armenien|Armenienn	<i>noun</i><br><ol><li>an Armenian</li></ol>
Arzantin|Arzantinn	<i>noun</i><br><ol><li>an Argentine</li></ol>
Arzantinn	<i>name</i><br><ol><li>Argentina (a country in South America)</li></ol>
Azerbaijan	<i>name</i><br><ol><li>Azerbaijan (a country in Europe and Asia)</li></ol>
Azeri	<i>noun</i><br><ol><li>an Azerbaijani</li></ol>
Baamas	<i>name</i><br><ol><li>Bahamas (an archipelago and country in the Caribbean)</li></ol>
Baameen|Baameenn	<i>noun</i><br><ol><li>a Bahamian</li></ol>
Barbida	<i>name</i><br><ol><li>Barbuda (an island)</li></ol>
Bareyn	<i>name</i><br><ol><li>Bahrain (a country in Asia)</li></ol>
Bareyni	<i>noun</i><br><ol><li>a Bahraini</li></ol>
Bondie	<i>noun</i><br><ol><li>God.</li></ol>
Bondye	<i>noun</i><br><ol><li>God</li></ol>
Franse|Fransez	<i>noun</i><br><ol><li>French person</li></ol>
Lafrans	<i>name</i><br><ol><li>France</li></ol>
Lafrik	<i>name</i><br><ol><li>Africa</li></ol>
Lamerik	<i>name</i><br><ol><li>America</li></ol>
Lasinn	<i>name</i><br><ol><li>China</li></ol>
Lerop	<i>name</i><br><ol><li>Europe</li></ol>
Moris	<i>name</i><br><ol><li>Mauritius</li></ol>
Ostrali	<i>name</i><br><ol><li>Australia (a continent and country in Oceania)</li></ol>
Ostralien|Ostralienn	<i>noun</i><br><ol><li>an Australian</li></ol>
Otrish	<i>name</i><br><ol><li>Austria (a country in Europe)</li></ol>
Otrishien|Otrishienn	<i>noun</i><br><ol><li>an Austrian</li></ol>
Rodrig	<i>noun</i><br><ol><li>Rodrigues island</li></ol>
Rodrige|Rodrigez	<i>noun</i><br><ol><li>A person from Rodrigues island</li></ol>
Sidafrikin|Sidafrikenn	<i>noun</i><br><ol><li>South African person</li></ol>
abazour	<i>noun</i><br><ol><li>lampshade</li></ol>
abdomenn	<i>noun</i><br><ol><li>abdomen, the part of the body of a vertebrate containing the digestive and reproductive organs</li></ol>
abese|form abes|abes	<i>verb</i><br><ol><li>to demean oneself, belittle, abase, denigrate, humiliate</li></ol>
abime|abim|form abim	<i>verb</i><br><ol><li>to damage</li><li>to spoil</li></ol>
adverb	<i>noun</i><br><ol><li>adverb</li></ol>
adverbial	<i>adj</i><br><ol><li>adverbial</li></ol>
afgan	<i>noun</i><br><ol><li>any of the languages native to Afghanistan.</li></ol><br><i>adj</i><br><ol><li>Afghan</li></ol>
agrikilter	<i>noun</i><br><ol><li>One that does agriculture; a planter</li></ol>
agrikiltir	<i>noun</i><br><ol><li>agriculture</li></ol>
aja	<i>noun</i><br><ol><li>grandfather</li></ol>
aji	<i>noun</i><br><ol><li>grandmother</li></ol>
akseptab	<i>adj</i><br><ol><li>acceptable.</li></ol>
akseptabilite	<i>noun</i><br><ol><li>acceptability</li></ol>
akseptans	<i>noun</i><br><ol><li>acceptance</li></ol>
aksepte|form aksepte	<i>verb</i><br><ol><li>to accept.</li></ol>
albane	<i>noun</i><br><ol><li>the Albanian language</li></ol><br><i>adj</i><br><ol><li>Albanian</li></ol>
ale|form al|al	<i>verb</i><br><ol><li>To go</li></ol>
alouda	<i>noun</i><br><ol><li>a popular drink made with rose syrup, milk and jelly</li></ol>
alvida	<i>intj</i><br><ol><li>goodbye</li></ol>
alzerien	<i>noun</i><br><ol><li>the Algerian Arabic language</li></ol><br><i>adj</i><br><ol><li>Algerian</li></ol>
amerikin	<i>adj</i><br><ol><li>American</li></ol>
amiz	<i>verb</i><br><ol><li>amused, entertained</li></ol>
amize|amiz|form amiz	<i>verb</i><br><ol><li>to amuse, to entertain</li><li>to have fun, to enjoy oneself</li></ol>
anba	<i>adj</i><br><ol><li>downstairs</li></ol><br><i>adv</i><br><ol><li>downstairs</li></ol><br><i>prep</i><br><ol><li>under; below; underneath</li></ol>
andomaze|form andomaz|andomaz	<i>verb</i><br><ol><li>to damage</li></ol>
andomazman	<i>noun</i><br><ol><li>damage</li></ol>
andoran	<i>adj</i><br><ol><li>Andorran</li></ol>
angaze	<i>adj</i><br><ol><li>engaged (of phone lines)</li></ol>
angiy	<i>noun</i><br><ol><li>eel</li></ol>
angle	<i>noun</i><br><ol><li>English language</li></ol><br><i>adj</i><br><ol><li>English</li></ol>
angole	<i>adj</i><br><ol><li>Angolan</li></ol>
anons	<i>noun</i><br><ol><li>announcement</li><li>advertisement</li></ol>
anonse|form anons|anons	<i>verb</i><br><ol><li>to announce</li></ol>
antere|form anter|anter	<i>verb</i><br><ol><li>to bury; inter</li></ol>
anvi|anvi auxiliary	<i>verb</i><br><ol><li>To feel like (doing something) (a conditional marker)</li></ol>
anvole	<i>verb</i><br><ol><li>to fly</li></ol>
ape|form ape	<i>verb</i><br><ol><li>(auxiliary) Used to indicate present progressive tense or the continuous tense in general, commonly shortened to "pe" in speech.</li></ol>
arzantin	<i>adj</i><br><ol><li>Argentine</li></ol>
aste	<i>verb</i><br><ol><li>to buy</li></ol>
aster	<i>adv</i><br><ol><li>now</li><li>at this moment</li></ol><br><i>noun</i><br><ol><li>buyer</li></ol>
aswar	<i>adv</i><br><ol><li>tonight</li><li>this evening</li></ol>
ato	<i>noun</i><br><ol><li>paternal aunt</li></ol>
avantyer	<i>adv</i><br><ol><li>the day before yesterday</li></ol>
aveg	<i>adj</i><br><ol><li>blind</li></ol><br><i>noun</i><br><ol><li>a blind person</li></ol>
avoye	<i>verb</i><br><ol><li>to send</li></ol>
avril	<i>noun</i><br><ol><li>April</li></ol>
avyon	<i>noun</i><br><ol><li>airplane</li></ol>
bachara	<i>noun</i><br><ol><li>(vulgar) dickhead, bastard</li><li>a stupid person</li><li>thug</li></ol>
badin	<i>noun</i><br><ol><li>cane, walking stick</li></ol>
badinaz	<i>noun</i><br><ol><li>joke, gag</li><li>trick, prank</li></ol>
badine	<i>verb</i><br><ol><li>to joke</li><li>to trick, wind up</li></ol>
bagar	<i>noun</i><br><ol><li>quarrel, fight</li></ol>
balanse	<i>verb</i><br><ol><li>to swing</li><li>to balance</li><li>to hang (from)</li></ol>
balye	<i>noun</i><br><ol><li>broom</li></ol><br><i>verb</i><br><ol><li>to sweep</li></ol>
banan	<i>noun</i><br><ol><li>banana</li></ol>
banbara|bambara	<i>noun</i><br><ol><li>sea slug</li><li>sea cucumber</li><li>(vulgar) penis</li></ol>
bann-la	<i>pron</i><br><ol><li>they, them (third-person plural personal pronoun)</li></ol>
bann-la mem	<i>pron</i><br><ol><li>themselves (third-person plural reflexive pronoun)</li></ol>
baobab	<i>noun</i><br><ol><li>the baobab tree</li><li>a type of concrete</li></ol>
batay	<i>noun</i><br><ol><li>quarrel, fight</li></ol>
batimen	<i>noun</i><br><ol><li>building</li></ol>
bato	<i>noun</i><br><ol><li>boat</li></ol>
baton	<i>noun</i><br><ol><li>stick</li></ol>
baton zalimet	<i>noun</i><br><ol><li>matchstick</li></ol>
bavet	<i>noun</i><br><ol><li>bib</li></ol>
bayo|baya	<i>noun</i><br><ol><li>brother</li><li>friend, mate</li></ol>
bebet	<i>noun</i><br><ol><li>insect, bug</li></ol>
bef	<i>noun</i><br><ol><li>bull</li><li>beef</li></ol>
belfi	<i>noun</i><br><ol><li>daughter-in-law</li></ol>
belmer	<i>noun</i><br><ol><li>mother-in-law</li></ol>
belna	<i>noun</i><br><ol><li>a rolling pin</li></ol>
belna chawki	<i>noun</i><br><ol><li>a rolling-board</li></ol>
belser	<i>noun</i><br><ol><li>sister-in-law</li></ol>
benediksyon	<i>noun</i><br><ol><li>blessing</li><li>benediction</li></ol>
benitye	<i>noun</i><br><ol><li>the vessel used for storing Holy Water in Roman Catholic churches</li></ol>
bezwin	<i>noun</i><br><ol><li>wants</li><li>needs</li><li>excrement</li></ol>
bienelve	<i>adj</i><br><ol><li>well-mannered</li></ol>
bigorno	<i>noun</i><br><ol><li>sea snail</li></ol>
bilenbi	<i>noun</i><br><ol><li>the fruit Averrhoa bilimbi</li></ol>
bisiklet	<i>noun</i><br><ol><li>bicycle</li></ol>
bizin|form bizin	<i>adv</i><br><ol><li>maybe; perhaps</li></ol><br><i>verb</i><br><ol><li>to need</li></ol>
bofis	<i>noun</i><br><ol><li>son-in-law (dialectal)</li></ol>
bofrer	<i>noun</i><br><ol><li>brother-in-law</li></ol>
bomaten	<i>noun</i><br><ol><li>morning</li></ol>
bombli	<i>noun</i><br><ol><li>Bombay duck, Harpadon nehereus</li></ol>
bonnwi	<i>intj</i><br><ol><li>good night.</li></ol>
bonom|bolom	<i>noun</i><br><ol><li>gentleman</li><li>old man</li><li>husband</li></ol>
bonswar	<i>intj</i><br><ol><li>good evening</li></ol>
bonzour	<i>intj</i><br><ol><li>hello</li><li>good morning</li></ol>
bonzur	<i>intj</i><br><ol><li>good morning</li></ol>
boper	<i>noun</i><br><ol><li>father-in-law</li></ol>
boug	<i>noun</i><br><ol><li>guy, chap, fellow</li></ol>
boukou	<i>adj</i><br><ol><li>many, numerous</li></ol>
boulanzeri	<i>noun</i><br><ol><li>bakeri</li></ol>
briani	<i>noun</i><br><ol><li>biryani</li></ol>
buyon	<i>noun</i><br><ol><li>bouillon</li></ol>
bwar	<i>verb</i><br><ol><li>to drink</li></ol>
bwat	<i>noun</i><br><ol><li>box</li><li>can, tin</li></ol>
bye	<i>intj</i><br><ol><li>bye, goodbye</li></ol>
byen	<i>adj</i><br><ol><li>good</li></ol><br><i>adv</i><br><ol><li>well</li></ol>
chabi	<i>noun</i><br><ol><li>key</li></ol>
chacha	<i>noun</i><br><ol><li>uncle</li></ol>
chawki	<i>noun</i><br><ol><li>a rolling-board</li></ol>
cheri	<i>noun</i><br><ol><li>darling, sweetheart</li></ol>
chombo	<i>intj</i><br><ol><li>stop</li></ol><br><i>verb</i><br><ol><li>to hold on</li><li>to grab hold of</li></ol>
chor	<i>noun</i><br><ol><li>thief; robber; fraudster</li></ol>
chula	<i>noun</i><br><ol><li>fireplace</li><li>fire</li></ol>
chup	<i>noun</i><br><ol><li>silent, quiet</li><li>still</li></ol><br><i>intj</i><br><ol><li>keep quiet, shush</li><li>shut up</li></ol>
chupchap	<i>intj</i><br><ol><li>shut up</li><li>stay quiet</li></ol>
churel	<i>noun</i><br><ol><li>witch</li><li>ghost</li></ol>
dada	<i>noun</i><br><ol><li>paternal grandfather</li><li>older brother</li></ol>
dadi	<i>noun</i><br><ol><li>paternal grandmother</li></ol>
dal	<i>noun</i><br><ol><li>any of many dried husked pulses (legume), including peas, beans and lentils; dahl</li><li>a dish made from lentils, cooked with spices, tomatoes and onions etc.</li></ol>
dan	<i>prep</i><br><ol><li>in</li><li>within</li></ol>
dan le bezwin	<i>phrase</i><br><ol><li>desperately poor, needy</li></ol>
de	<i>num</i><br><ol><li>two</li></ol>
de trwa	<i>det</i><br><ol><li>a few; a couple; some</li></ol>
defakto	<i>noun</i><br><ol><li>de facto, in fact or in practice</li></ol>
defans	<i>noun</i><br><ol><li>defense</li></ol>
defigire|defigir|form defigir	<i>verb</i><br><ol><li>to disfigure; deface</li><li>to distort</li><li>to be disfigured</li></ol>
deg	<i>noun</i><br><ol><li>large cooking pot</li></ol>
dega	<i>noun</i><br><ol><li>damage</li></ol>
degou	<i>noun</i><br><ol><li>disgust</li><li>repugnance</li><li>hatred</li></ol>
degti	<i>noun</i><br><ol><li>cooking vessel</li><li>cooking pot</li></ol>
deklare	<i>verb</i><br><ol><li>to declare, announce</li><li>to show off</li></ol>
deksi	<i>noun</i><br><ol><li>cooking vessel</li><li>cooking pot</li></ol>
delwil	<i>noun</i><br><ol><li>oil</li></ol>
denigre|form denigre	<i>verb</i><br><ol><li>to denigrate, humiliate, criticize</li></ol>
depans	<i>noun</i><br><ol><li>expense</li></ol>
desam	<i>noun</i><br><ol><li>December</li></ol>
devet	<i>adv</i><br><ol><li>maybe; perhaps</li></ol>
devire	<i>verb</i><br><ol><li>to overturn, topple</li><li>to upset</li></ol>
devlope	<i>adj</i><br><ol><li>refined</li></ol><br><i>verb</i><br><ol><li>to develop, progress</li></ol>
deziem	<i>noun</i><br><ol><li>second</li></ol>
diab	<i>noun</i><br><ol><li>ghost</li><li>evilness</li><li>devil</li></ol>
diber	<i>noun</i><br><ol><li>butter</li></ol>
dibwa	<i>noun</i><br><ol><li>wood</li></ol>
didi	<i>noun</i><br><ol><li>sister</li></ol>
difil	<i>noun</i><br><ol><li>thread, string</li></ol>
diksioner|diksyoner	<i>noun</i><br><ol><li>dictionary</li></ol>
dilo|delo	<i>noun</i><br><ol><li>water</li></ol>
dimande|form demann|demann	<i>verb</i><br><ol><li>To ask</li></ol>
dimans	<i>noun</i><br><ol><li>Sunday</li></ol>
dipen	<i>noun</i><br><ol><li>bread</li></ol>
dipwav	<i>noun</i><br><ol><li>pepper (spice)</li></ol>
diri|duri	<i>noun</i><br><ol><li>rice</li></ol>
dis	<i>num</i><br><ol><li>ten</li></ol>
disab	<i>noun</i><br><ol><li>sand</li></ol>
disan	<i>noun</i><br><ol><li>blood</li></ol>
disel	<i>noun</i><br><ol><li>salt</li></ol>
disik	<i>noun</i><br><ol><li>sugar</li></ol>
dite	<i>noun</i><br><ol><li>tea</li></ol>
divan	<i>prep</i><br><ol><li>before</li><li>ahead</li><li>the wind</li></ol>
dizef	<i>noun</i><br><ol><li>egg</li></ol>
dodo	<i>noun</i><br><ol><li>dodo bird</li></ol><br><i>verb</i><br><ol><li>to sleep (childish)</li></ol>
douk|duk	<i>noun</i><br><ol><li>distress</li></ol>
douz|duz	<i>num</i><br><ol><li>twelve</li></ol>
drom	<i>noun</i><br><ol><li>a membranophone</li><li>a large cylindrical container for liquid transport and storage</li></ol>
dyab	<i>noun</i><br><ol><li>demon, devil, ghost</li></ol>
e	<i>character</i><br><ol><li>the fifth letter of the modern Latin alphabet</li></ol><br><i>conj</i><br><ol><li>and</li></ol>
egzanp	<i>noun</i><br><ol><li>example</li></ol>
ek	<i>conj</i><br><ol><li>and</li></ol><br><i>prep</i><br><ol><li>with</li></ol>
ekrir|form ekrir	<i>verb</i><br><ol><li>to write</li></ol>
ekrivin	<i>noun</i><br><ol><li>writer</li><li>author</li></ol>
elevasion	<i>noun</i><br><ol><li>elevation</li></ol>
elve|form elve	<i>adj</i><br><ol><li>high</li></ol><br><i>verb</i><br><ol><li>to raise</li><li>to heighten</li><li>to bring up</li></ol>
emplante	<i>verb</i><br><ol><li>to implant</li></ol>
emportan	<i>adj</i><br><ol><li>important</li></ol>
ena|form ena	<i>verb</i><br><ol><li>to have</li><li>(impersonal) there is; there are</li></ol>
enn	<i>num</i><br><ol><li>one</li></ol><br><i>article</i><br><ol><li>a, an</li></ol>
enn kou|enn ku	<i>adv</i><br><ol><li>suddenly</li><li>now</li></ol>
enzenyer	<i>noun</i><br><ol><li>engineer</li></ol>
eski	<i>particle</i><br><ol><li>Marks a question when placed at the beginning of a sentence</li></ol>
esplike	<i>verb</i><br><ol><li>to explain</li></ol>
etranze	<i>noun</i><br><ol><li>stranger</li><li>foreigner</li></ol><br><i>adj</i><br><ol><li>strange</li><li>foreign</li><li>unknown</li></ol>
exkreman	<i>noun</i><br><ol><li>excrement, defecation</li></ol>
fakter	<i>noun</i><br><ol><li>factor</li><li>reason</li><li>postman</li></ol>
fam	<i>noun</i><br><ol><li>(derogatory) woman</li></ol>
farata	<i>noun</i><br><ol><li>paratha</li></ol>
fatigan	<i>adj</i><br><ol><li>tiresome, troublesome</li></ol>
fatige	<i>adj</i><br><ol><li>tired</li></ol>
feb	<i>adj</i><br><ol><li>weak</li></ol>
febles	<i>noun</i><br><ol><li>weakness</li></ol>
fenomenal	<i>adj</i><br><ol><li>phenomenal</li></ol>
fenomenn	<i>noun</i><br><ol><li>phenomenon</li></ol>
fer|form fer	<i>verb</i><br><ol><li>To make</li><li>To do</li></ol>
fer so bezwin|form fer so bezwin	<i>verb</i><br><ol><li>to do one's business, go to the toilet</li></ol>
fess	<i>noun</i><br><ol><li>bottom, buttock, arse</li></ol>
fevriye	<i>noun</i><br><ol><li>February</li></ol>
figir	<i>noun</i><br><ol><li>face</li></ol>
figire|form figir|figir	<i>verb</i><br><ol><li>to appear</li><li>to figure</li></ol>
filling	<i>noun</i><br><ol><li>facility which sells fuel and lubricants for motor vehicles; gas station</li></ol>
fineray	<i>noun</i><br><ol><li>funeral</li></ol>
fini|form fini	<i>verb</i><br><ol><li>to finish</li></ol>
finn|form finn	<i>verb</i><br><ol><li>(auxiliary) Used to indicate present perfect tense or past tense, commonly contracted to "inn" in speech.</li></ol>
fizi	<i>noun</i><br><ol><li>rifle, gun</li></ol>
fler	<i>noun</i><br><ol><li>flower</li></ol>
fleri|form fleri	<i>verb</i><br><ol><li>to flower, blossom, bloom</li></ol>
fleris	<i>noun</i><br><ol><li>florist</li></ol>
floral	<i>adj</i><br><ol><li>floral</li></ol>
fol|fou	<i>noun</i><br><ol><li>(feminine) mad, crazy person</li></ol><br><i>adj</i><br><ol><li>(feminine) mad, crazy, insane</li></ol>
fou|fol	<i>noun</i><br><ol><li>(masculine) mad, crazy person</li></ol><br><i>adj</i><br><ol><li>(masculine) mad, crazy, insane</li></ol>
fourmi	<i>noun</i><br><ol><li>ant</li></ol>
fouye	<i>verb</i><br><ol><li>to dig</li></ol>
frambwaz	<i>noun</i><br><ol><li>raspberry</li></ol>
fre	<i>adj</i><br><ol><li>chilly</li><li>chilled</li><li>cold</li><li>fresh</li></ol>
frer	<i>noun</i><br><ol><li>brother</li></ol>
freser	<i>noun</i><br><ol><li>chilliness</li><li>coldness</li><li>freshness</li></ol>
frez	<i>noun</i><br><ol><li>strawberry</li></ol>
frisiter	<i>noun</i><br><ol><li>Spondias dulcis</li></ol>
frizider	<i>noun</i><br><ol><li>refrigerator</li></ol>
fromaz	<i>noun</i><br><ol><li>cheese</li></ol>
fwa	<i>noun</i><br><ol><li>time (an instance of something happening)</li></ol>
gagne|form gagn|gagn	<i>verb</i><br><ol><li>to be.</li><li>to have.</li><li>to win.</li><li>to gain; obtain.</li></ol>
gajak	<i>noun</i><br><ol><li>a snack; appetizer; starter</li></ol>
galoupe	<i>verb</i><br><ol><li>to run</li></ol>
gaon	<i>noun</i><br><ol><li>village</li><li>countryside</li></ol>
garson	<i>noun</i><br><ol><li>boy</li><li>son</li></ol>
gate|form gat|gat	<i>noun</i><br><ol><li>gate</li><li>entrance door</li><li>darling, sweetheart</li></ol><br><i>adj</i><br><ol><li>spoilt</li><li>stale, expired</li></ol><br><i>verb</i><br><ol><li>to spoil, ruin</li></ol>
gato	<i>noun</i><br><ol><li>cake</li></ol>
gazon	<i>noun</i><br><ol><li>grass, turf</li></ol>
gete|form get|get	<i>verb</i><br><ol><li>To look at</li></ol>
ghin	<i>noun</i><br><ol><li>disgust</li><li>repugnance</li><li>hatred</li></ol>
gid	<i>noun</i><br><ol><li>a guide</li></ol>
gide|form gid|gid	<i>verb</i><br><ol><li>to guide</li></ol>
glason	<i>noun</i><br><ol><li>ice</li></ol>
gogot	<i>noun</i><br><ol><li>(vulgar) penis</li></ol>
gogotri	<i>noun</i><br><ol><li>stupidity</li></ol>
gramaten	<i>noun</i><br><ol><li>morning</li></ol>
gramatin	<i>noun</i><br><ol><li>morning</li></ol>
gramer	<i>noun</i><br><ol><li>grammar</li></ol>
gran	<i>adj</i><br><ol><li>great</li><li>grown-up</li><li>big</li><li>tall</li></ol>
granmama	<i>noun</i><br><ol><li>grandmother, great-grandmother</li></ol>
granmer	<i>noun</i><br><ol><li>grandmother</li></ol>
granpapa	<i>noun</i><br><ol><li>grandfather, great-grandfather</li></ol>
granper	<i>noun</i><br><ol><li>grandfather</li></ol>
gri	<i>adj</i><br><ol><li>grey</li></ol>
grigri	<i>noun</i><br><ol><li>black magic</li></ol>
gunga	<i>noun</i><br><ol><li>mute (a person who cannot speak)</li></ol>
horni	<i>noun</i><br><ol><li>a shawl; scarf</li><li>a veil</li></ol>
ibiskis	<i>noun</i><br><ol><li>hibiscus</li></ol>
ibou	<i>noun</i><br><ol><li>owl</li></ol>
imilian	<i>adj</i><br><ol><li>humiliating</li></ol>
imiliasion	<i>noun</i><br><ol><li>humiliation</li></ol>
imilie|form imilie	<i>verb</i><br><ol><li>humiliate</li></ol>
informasion	<i>noun</i><br><ol><li>broadcast news</li><li>news, information</li></ol>
inn|form inn	<i>verb</i><br><ol><li>(auxiliary) Used to indicate present perfect tense or past tense.</li></ol>
interesan	<i>adj</i><br><ol><li>interesting</li></ol>
interese|form interes	<i>verb</i><br><ol><li>To interest; to be interested.</li></ol>
ipnotize	<i>verb</i><br><ol><li>to hypnotise</li></ol>
ipokrit	<i>noun</i><br><ol><li>hypocrite</li></ol>
itilizasion	<i>noun</i><br><ol><li>utilisation, use</li></ol>
itilizater	<i>noun</i><br><ol><li>user</li></ol>
itilize|itiliz|form itiliz	<i>verb</i><br><ol><li>to use, utilise</li></ol>
ivwar	<i>noun</i><br><ol><li>ivory</li></ol>
jafran	<i>noun</i><br><ol><li>saffron</li></ol>
jangli	<i>adj</i><br><ol><li>wild</li></ol>
jos	<i>noun</i><br><ol><li>pleasure; happiness</li></ol>
kabri	<i>noun</i><br><ol><li>goat</li></ol>
kadav	<i>noun</i><br><ol><li>corpse, cadaver</li></ol>
kaka|form kaka	<i>noun</i><br><ol><li>poo, excrement</li></ol><br><i>verb</i><br><ol><li>to poo, defecate</li></ol>
kakatwa	<i>noun</i><br><ol><li>cockatoo, parrot</li></ol>
kalamindas	<i>noun</i><br><ol><li>candy floss</li></ol>
kalash	<i>noun</i><br><ol><li>(Hinduism) a kalasha</li></ol>
kali	<i>noun</i><br><ol><li>cactus</li></ol>
kalot	<i>noun</i><br><ol><li>slap</li></ol>
kamaleyon	<i>noun</i><br><ol><li>chameleon</li></ol>
kamaron	<i>noun</i><br><ol><li>prawn</li></ol>
kamli	<i>noun</i><br><ol><li>blanket</li></ol>
kan	<i>adv</i><br><ol><li>when</li></ol>
kana	<i>noun</i><br><ol><li>food</li></ol>
kanar	<i>noun</i><br><ol><li>duck</li></ol>
kanguru	<i>noun</i><br><ol><li>kangaroo</li></ol>
kankrela	<i>noun</i><br><ol><li>cockroach</li></ol>
kanpagn	<i>noun</i><br><ol><li>campaign</li></ol>
kanpagnar	<i>noun</i><br><ol><li>countryside dweller</li></ol>
kapav|form kapav	<i>adv</i><br><ol><li>maybe; perhaps</li></ol><br><i>verb</i><br><ol><li>(auxiliary) can; to be able to</li></ol>
karanbol	<i>noun</i><br><ol><li>star fruit</li></ol>
karapat	<i>noun</i><br><ol><li>tick (arthropod)</li></ol>
karay	<i>noun</i><br><ol><li>a cooking pan, frying pan</li></ol>
kari	<i>noun</i><br><ol><li>curry</li></ol>
karipule	<i>noun</i><br><ol><li>curry leaf (Murraya koenigii)</li></ol>
karot	<i>noun</i><br><ol><li>carrot</li></ol>
karote	<i>verb</i><br><ol><li>to pinch, squeeze</li></ol>
kas	<i>noun</i><br><ol><li>money</li><li>cash</li></ol>
kasbol	<i>noun</i><br><ol><li>praying mantis</li></ol>
kase|form kas|kas	<i>verb</i><br><ol><li>to break</li></ol>
kaskad	<i>noun</i><br><ol><li>waterfall</li></ol>
kasrol	<i>noun</i><br><ol><li>saucepan</li></ol>
kasyet	<i>verb</i><br><ol><li>to hide</li></ol>
kat	<i>num</i><br><ol><li>four</li></ol>
katedral	<i>noun</i><br><ol><li>(Christianity) cathedral</li></ol>
katorz	<i>num</i><br><ol><li>fourteen</li></ol>
katriem	<i>adj</i><br><ol><li>The ordinal form of the number kat.</li></ol>
kav|form kav	<i>verb</i><br><ol><li>(auxiliary) can; to be able to</li></ol>
kenz|kinz	<i>num</i><br><ol><li>fifteen</li></ol>
kestard	<i>noun</i><br><ol><li>custard</li></ol>
khala	<i>noun</i><br><ol><li>aunt</li></ol>
ki	<i>pron</i><br><ol><li>(relative) who</li><li>(relative) what</li></ol><br><i>particle</i><br><ol><li>than</li><li>that</li></ol>
kifer	<i>adv</i><br><ol><li>why</li></ol>
kikfwa	<i>adv</i><br><ol><li>maybe</li></ol>
kisann-la|kisanla	<i>pron</i><br><ol><li>(interrogative) who</li></ol>
kitsoz|kiksoz	<i>pron</i><br><ol><li>something</li></ol>
kler	<i>adj</i><br><ol><li>clear</li></ol>
klun	<i>noun</i><br><ol><li>clown</li></ol>
kodak	<i>noun</i><br><ol><li>camera</li></ol>
koka	<i>noun</i><br><ol><li>Coca Cola</li><li>any soft drink</li></ol>
koki	<i>noun</i><br><ol><li>shell</li></ol>
kokin|form kokin	<i>verb</i><br><ol><li>to steal; rob.</li></ol>
kokiyaz	<i>noun</i><br><ol><li>shell</li></ol>
kokom	<i>noun</i><br><ol><li>cucumber</li></ol>
koltar	<i>noun</i><br><ol><li>asphalt</li></ol>
koltare	<i>verb</i><br><ol><li>to pave with asphalt</li></ol>
komie|komye	<i>adv</i><br><ol><li>how much, how many</li></ol>
koneksion|konexion	<i>noun</i><br><ol><li>connection</li></ol>
konekte|form konekte	<i>verb</i><br><ol><li>to connect</li></ol>
konfi	<i>adj</i><br><ol><li>preserved</li><li>pickled</li></ol>
kongolo	<i>noun</i><br><ol><li>craziness; insanity</li></ol>
kontan|form kontan	<i>adj</i><br><ol><li>happy; pleased</li></ol><br><i>verb</i><br><ol><li>To like; to be pleased by</li></ol>
koral	<i>noun</i><br><ol><li>choir</li></ol>
kot	<i>adv</i><br><ol><li>where</li></ol>
kou|ku	<i>noun</i><br><ol><li>neck</li><li>blow; strike</li></ol>
kouler	<i>noun</i><br><ol><li>colour</li></ol>
kouma|kuma	<i>adv</i><br><ol><li>how</li><li>like</li></ol>
kourpa	<i>noun</i><br><ol><li>giant African land snail</li></ol>
kouver|form kouver	<i>adj</i><br><ol><li>covered</li><li>cloudy</li></ol><br><i>verb</i><br><ol><li>to cover</li></ol>
kouvertir|kuvertir	<i>noun</i><br><ol><li>cover, covering</li></ol>
kouyon	<i>noun</i><br><ol><li>(vulgar) dickhead, bastard</li><li>a stupid person</li></ol>
kouzen	<i>noun</i><br><ol><li>(male) cousin</li></ol>
kouzin	<i>noun</i><br><ol><li>(female) cousin</li></ol>
koze|form koz|koz	<i>verb</i><br><ol><li>To talk, to speak</li><li>To cause</li></ol><br><i>noun</i><br><ol><li>speech; talk; talking</li></ol>
krap|krab	<i>noun</i><br><ol><li>crab</li></ol>
krapo	<i>noun</i><br><ol><li>frog, toad</li></ol>
krayon papye	<i>noun</i><br><ol><li>pencil</li></ol>
kreol	<i>noun</i><br><ol><li>A creole language.</li></ol><br><i>name</i><br><ol><li>(informal) Mauritian Creole</li></ol>
kreol morisien|kreol morisyen	<i>noun</i><br><ol><li>Mauritian Creole</li></ol>
krevet	<i>noun</i><br><ol><li>shrimp, prawn</li></ol>
kreyon	<i>noun</i><br><ol><li>pencil</li></ol>
kreyon kouler	<i>noun</i><br><ol><li>drawing pencil</li></ol>
kriye	<i>verb</i><br><ol><li>to scream, shout</li></ol>
krokodil	<i>noun</i><br><ol><li>crocodile</li></ol>
kwet	<i>noun</i><br><ol><li>duvet, quilt</li><li>blanket</li></ol>
labalenn	<i>noun</i><br><ol><li>whale</li></ol>
labarb	<i>noun</i><br><ol><li>beard</li></ol>
labou	<i>noun</i><br><ol><li>mud</li></ol>
labouzi	<i>noun</i><br><ol><li>candle</li><li>spark plug</li></ol>
labriz	<i>noun</i><br><ol><li>wind, air, breeze</li></ol>
lafarin	<i>noun</i><br><ol><li>flour</li></ol>
lafnet	<i>noun</i><br><ol><li>window</li></ol>
lafore	<i>noun</i><br><ol><li>forest</li></ol>
lagazet	<i>noun</i><br><ol><li>newspaper</li></ol>
lagorz	<i>noun</i><br><ol><li>throat</li></ol>
lakanpagn|kanpagn	<i>noun</i><br><ol><li>countryside</li></ol>
lakaz	<i>noun</i><br><ol><li>house</li></ol>
lake	<i>noun</i><br><ol><li>tail</li><li>queue</li></ol>
lakesunga	<i>noun</i><br><ol><li>a character from Mauritian folklore similar to the Pied Piper</li></ol>
lakle	<i>noun</i><br><ol><li>key</li></ol>
laklos	<i>noun</i><br><ol><li>bell</li></ol>
lakol	<i>noun</i><br><ol><li>glue</li></ol>
lakord	<i>noun</i><br><ol><li>rope, string</li></ol>
lakot	<i>noun</i><br><ol><li>coast</li></ol>
lalang	<i>noun</i><br><ol><li>tongue</li></ol>
lalimyer	<i>noun</i><br><ol><li>light</li></ol>
lalin	<i>noun</i><br><ol><li>moon</li><li>line</li></ol>
lalkol	<i>noun</i><br><ol><li>alcohol</li></ol>
lamant	<i>noun</i><br><ol><li>mint</li></ol>
lame	<i>noun</i><br><ol><li>hand</li></ol>
lamer	<i>noun</i><br><ol><li>sea</li></ol>
lamizik	<i>noun</i><br><ol><li>music</li></ol>
lamizman	<i>noun</i><br><ol><li>fun</li><li>amusement</li></ol>
lamok	<i>noun</i><br><ol><li>large mug, goblet</li></ol>
lampoul	<i>noun</i><br><ol><li>light bulb</li></ol>
langaz	<i>noun</i><br><ol><li>language</li></ol>
lanterman	<i>noun</i><br><ol><li>burial</li><li>funeral</li></ol>
lao	<i>adj</i><br><ol><li>upstairs</li></ol><br><i>adv</i><br><ol><li>upstairs</li></ol><br><i>prep</i><br><ol><li>over</li></ol>
lapat	<i>noun</i><br><ol><li>paw</li><li>(animal) leg</li></ol>
lapay	<i>noun</i><br><ol><li>straw</li></ol>
lapen	<i>noun</i><br><ol><li>rabbit</li></ol>
lapenn	<i>noun</i><br><ol><li>effort</li><li>pain, suffering</li></ol>
laplaz	<i>noun</i><br><ol><li>beach</li></ol>
laplenn	<i>noun</i><br><ol><li>plain, field</li></ol>
lapli	<i>noun</i><br><ol><li>rain</li></ol>
lapolis	<i>noun</i><br><ol><li>police</li></ol>
laport	<i>noun</i><br><ol><li>door</li></ol>
lapousyer	<i>noun</i><br><ol><li>dust</li></ol>
larak	<i>noun</i><br><ol><li>alcoholic beverage</li></ol>
larenn	<i>noun</i><br><ol><li>queen</li><li>female ruler</li></ol>
larivyer	<i>noun</i><br><ol><li>river</li></ol>
larou	<i>noun</i><br><ol><li>wheel</li></ol>
larzan	<i>noun</i><br><ol><li>money</li></ol>
lasam	<i>noun</i><br><ol><li>room</li></ol>
lasours	<i>noun</i><br><ol><li>source</li><li>foundation</li></ol>
latab	<i>noun</i><br><ol><li>table</li></ol>
later	<i>noun</i><br><ol><li>land, earth, soil</li></ol>
latet	<i>noun</i><br><ol><li>head</li></ol>
latwal	<i>noun</i><br><ol><li>material, cloth, fabric</li></ol>
lavarang	<i>noun</i><br><ol><li>veranda</li></ol>
lavyan	<i>noun</i><br><ol><li>meat</li></ol>
lay	<i>noun</i><br><ol><li>garlic</li><li>moth</li></ol>
lazou	<i>noun</i><br><ol><li>cheek</li></ol>
lazwa	<i>noun</i><br><ol><li>happiness</li></ol>
le	<i>article</i><br><ol><li>(definite) the</li></ol>
lebra	<i>noun</i><br><ol><li>arm</li></ol>
ledan	<i>noun</i><br><ol><li>tooth</li></ol>
ledwa	<i>noun</i><br><ol><li>finger</li></ol>
lefwa	<i>noun</i><br><ol><li>liver</li></ol>
legliz	<i>noun</i><br><ol><li>church</li></ol>
leker	<i>noun</i><br><ol><li>heart</li></ol>
lekleraz	<i>noun</i><br><ol><li>light, lighting</li><li>sunlight</li></ol>
lekor	<i>noun</i><br><ol><li>human body</li><li>corpse</li></ol>
lemond	<i>noun</i><br><ol><li>the Earth</li><li>world, planet</li></ol>
lempresyon	<i>noun</i><br><ol><li>impression, view, idea</li></ol>
lenor	<i>noun</i><br><ol><li>north</li></ol>
lepap	<i>noun</i><br><ol><li>pope</li></ol>
lera	<i>noun</i><br><ol><li>rat</li></ol>
leres	<i>noun</i><br><ol><li>rest, remainder, leftover</li></ol>
lerwa	<i>noun</i><br><ol><li>king</li><li>male ruler</li></ol>
lesiel	<i>noun</i><br><ol><li>sky</li></ol>
lespri	<i>noun</i><br><ol><li>mind</li></ol>
lezar	<i>noun</i><br><ol><li>lizard</li></ol>
li	<i>pron</i><br><ol><li>he, she, it (third-person singular personal pronoun)</li></ol>
lili	<i>noun</i><br><ol><li>bed</li></ol>
limem	<i>pron</i><br><ol><li>himself, herself, itself, oneself (third-person singular reflexive pronoun)</li></ol>
limero	<i>noun</i><br><ol><li>number</li></ol>
limon	<i>noun</i><br><ol><li>lemon, lime</li></ol>
limonad	<i>noun</i><br><ol><li>lemonade</li></ol>
lindi|lendi	<i>noun</i><br><ol><li>Monday</li></ol>
linz	<i>noun</i><br><ol><li>clothes</li></ol>
lipye	<i>noun</i><br><ol><li>foot</li></ol>
lisans	<i>noun</i><br><ol><li>licence; driving licence.</li><li>permit</li></ol>
lisyen	<i>noun</i><br><ol><li>dog</li></ol>
liv	<i>noun</i><br><ol><li>book</li><li>pound (unit of measure)</li><li>pound (currency)</li></ol>
lizie	<i>noun</i><br><ol><li>eye</li></ol>
lizien	<i>noun</i><br><ol><li>hygiene</li></ol>
lizye	<i>noun</i><br><ol><li>eye</li></ol>
loke	<i>verb</i><br><ol><li>to hiccup</li></ol>
lombraz	<i>noun</i><br><ol><li>shade</li><li>shadow</li></ol>
lopital	<i>noun</i><br><ol><li>hospital</li></ol>
lor	<i>noun</i><br><ol><li>Gold</li></ol><br><i>prep</i><br><ol><li>on</li></ol>
loraz	<i>noun</i><br><ol><li>thunder</li></ol>
lortograf	<i>noun</i><br><ol><li>orthography</li></ol>
lorye	<i>noun</i><br><ol><li>pillow</li></ol>
los	<i>noun</i><br><ol><li>slug</li></ol>
losean	<i>noun</i><br><ol><li>sea, ocean</li></ol>
loto	<i>noun</i><br><ol><li>car</li></ol>
lotorite	<i>noun</i><br><ol><li>Variation of otorite; authority.</li></ol>
lougarou	<i>noun</i><br><ol><li>werewolf</li></ol>
lours	<i>noun</i><br><ol><li>bear</li></ol>
lulu	<i>noun</i><br><ol><li>wolf</li><li>werewolf</li></ol>
lyon	<i>noun</i><br><ol><li>lion</li></ol>
maharaja	<i>noun</i><br><ol><li>king</li><li>male ruler</li></ol>
maharani	<i>noun</i><br><ol><li>queen</li></ol>
maja	<i>noun</i><br><ol><li>fun</li><li>joy, pleasure</li></ol>
makadam	<i>noun</i><br><ol><li>macadam</li><li>small stone, pebble</li></ol>
makiye	<i>verb</i><br><ol><li>to dress up</li></ol>
malad	<i>adj</i><br><ol><li>ill, unwell, sick</li></ol>
maladi	<i>noun</i><br><ol><li>illness</li></ol>
malelve	<i>adj</i><br><ol><li>ill-mannered</li></ol>
mama	<i>noun</i><br><ol><li>mother</li><li>uncle</li></ol>
mami	<i>noun</i><br><ol><li>grandmother</li><li>aunt, particularly maternal uncle's wife</li></ol>
manter	<i>noun</i><br><ol><li>liar (masculine)</li></ol>
mantez	<i>noun</i><br><ol><li>liar (feminine)</li></ol>
manze|form manz|manz	<i>verb</i><br><ol><li>To eat</li></ol><br><i>noun</i><br><ol><li>food, meal</li></ol>
maraz	<i>noun</i><br><ol><li>(Hinduism) someone who performs a puja; a Hindu priest</li></ol>
mardi	<i>noun</i><br><ol><li>Tuesday</li></ol>
mars	<i>noun</i><br><ol><li>March</li></ol>
marto	<i>noun</i><br><ol><li>hammer</li></ol>
maryaz	<i>noun</i><br><ol><li>wedding</li></ol>
mason	<i>noun</i><br><ol><li>fruit of the Ziziphus jujuba (syn. Ziziphus vulgaris)</li></ol>
matant	<i>noun</i><br><ol><li>aunt</li></ol>
matapan	<i>noun</i><br><ol><li>a creature similar to a zombie or a werewolf</li><li>a thug who roams the countryside</li><li>a clown, fool</li></ol>
mawsi	<i>noun</i><br><ol><li>maternal aunt</li></ol>
me	<i>noun</i><br><ol><li>May</li></ol>
mem	<i>adj</i><br><ol><li>same</li></ol><br><i>adv</i><br><ol><li>even</li></ol>
mem si	<i>conj</i><br><ol><li>even if</li></ol>
memwar	<i>noun</i><br><ol><li>memory</li></ol>
merkredi	<i>noun</i><br><ol><li>Wednesday</li></ol>
mersi	<i>intj</i><br><ol><li>thanks</li></ol>
met chula|form met chula	<i>verb</i><br><ol><li>to cause a fight between other people</li></ol>
mete|met|form met	<i>verb</i><br><ol><li>to put; put on</li><li>to set</li><li>to wear</li></ol>
milpat	<i>noun</i><br><ol><li>millipede</li></ol>
min	<i>noun</i><br><ol><li>noodle</li></ol>
minapolo	<i>noun</i><br><ol><li>noodle</li></ol>
minis prens	<i>noun</i><br><ol><li>a spirit that inhabits yards and to which offerings are made</li></ol>
miray	<i>noun</i><br><ol><li>wall</li></ol>
mirwar	<i>noun</i><br><ol><li>mirror</li></ol>
mo|mwa	<i>pron</i><br><ol><li>I (first-person singular nominative personal pronoun)</li></ol><br><i>noun</i><br><ol><li>word</li></ol>
mo kontan twa	<i>phrase</i><br><ol><li>I love you</li></ol>
molton	<i>noun</i><br><ol><li>blanket</li><li>quilt</li></ol>
momem	<i>pron</i><br><ol><li>myself (first-person singular reflexive pronoun)</li></ol>
montany	<i>noun</i><br><ol><li>mountain</li></ol>
monte	<i>verb</i><br><ol><li>to climb</li><li>to rise</li></ol>
montre	<i>verb</i><br><ol><li>to show</li><li>to demonstrate</li></ol>
morisien|morisyen	<i>adj</i><br><ol><li>Mauritian</li></ol><br><i>noun</i><br><ol><li>Mauritian</li></ol>
mouswar	<i>noun</i><br><ol><li>handkerchief</li></ol>
mus	<i>noun</i><br><ol><li>fly</li></ol>
mus zon	<i>noun</i><br><ol><li>wasp</li></ol>
mustik	<i>noun</i><br><ol><li>mosquito</li></ol>
mwa|mo	<i>pron</i><br><ol><li>me (first-person singular objective personal pronoun)</li></ol>
nani	<i>noun</i><br><ol><li>maternal grandmother</li></ol>
nasta	<i>noun</i><br><ol><li>breakfast</li></ol>
naze	<i>verb</i><br><ol><li>to swim</li></ol>
nazwar	<i>noun</i><br><ol><li>fin</li><li>flipper</li></ol>
nef	<i>num</i><br><ol><li>nine</li></ol><br><i>adj</i><br><ol><li>new</li></ol>
neglize	<i>adj</i><br><ol><li>careless</li></ol>
nene	<i>noun</i><br><ol><li>nose</li></ol>
nepli|napli	<i>adv</i><br><ol><li>no longer</li></ol>
neve	<i>noun</i><br><ol><li>nephew</li></ol>
neviem	<i>adj</i><br><ol><li>The ordinal form of the number nef.</li></ol>
news	<i>noun</i><br><ol><li>news, information</li></ol>
nimero	<i>noun</i><br><ol><li>number</li></ol>
nisa	<i>adj</i><br><ol><li>drunk; intoxicated</li></ol>
non	<i>noun</i><br><ol><li>name</li></ol><br><i>adv</i><br><ol><li>no; a word used to indicate disagreement or negation</li></ol>
nonsense	<i>noun</i><br><ol><li>nonsense</li></ol>
nou|nu	<i>pron</i><br><ol><li>we; us (first-person plural personal pronoun)</li></ol>
nouvel	<i>noun</i><br><ol><li>news, information</li></ol><br><i>adj</i><br><ol><li>new</li></ol>
nouvo	<i>adj</i><br><ol><li>new</li></ol>
novam	<i>noun</i><br><ol><li>November</li></ol>
numem	<i>pron</i><br><ol><li>ourselves (first-person plural reflexive pronoun)</li></ol>
nwar	<i>adj</i><br><ol><li>black</li></ol>
nyaz	<i>noun</i><br><ol><li>cloud</li></ol>
nyes	<i>noun</i><br><ol><li>niece</li></ol>
nyouz	<i>noun</i><br><ol><li>news</li></ol>
oktob	<i>noun</i><br><ol><li>October</li></ol>
omar	<i>noun</i><br><ol><li>lobster</li></ol>
onz	<i>num</i><br><ol><li>eleven</li></ol>
oranz	<i>adj</i><br><ol><li>orange (colour)</li></ol>
orevwar	<i>intj</i><br><ol><li>goodbye</li></ol>
ostralien	<i>noun</i><br><ol><li>Australian English</li></ol><br><i>adj</i><br><ol><li>Australian</li></ol>
ot	<i>adj</i><br><ol><li>high</li></ol>
oter	<i>noun</i><br><ol><li>author; writer</li><li>height</li></ol>
otorite	<i>noun</i><br><ol><li>authority</li><li>power</li></ol>
otoriter	<i>adj</i><br><ol><li>authoritarian</li></ol>
otorizasion	<i>noun</i><br><ol><li>autorisation</li><li>permission</li></ol>
otorize|otoriz|form otoriz	<i>verb</i><br><ol><li>to autorise.</li></ol>
otrishien	<i>noun</i><br><ol><li>Austrian German</li></ol><br><i>adj</i><br><ol><li>Austrian</li></ol>
ou|to|twa|ou|u	<i>pron</i><br><ol><li>you (second-person singular formal personal pronoun)</li></ol>
oule|ule|oule auxiliary	<i>verb</i><br><ol><li>To want (to do something)</li></ol>
oumem|tomem	<i>pron</i><br><ol><li>yourself (second-person singular formal reflexive pronoun)</li></ol>
out	<i>noun</i><br><ol><li>August</li></ol>
ouver|form ouver	<i>adj</i><br><ol><li>open</li><li>open-minded (of a person)</li></ol><br><i>verb</i><br><ol><li>to open</li></ol>
ouvertir|uvertir	<i>noun</i><br><ol><li>opening</li></ol>
pagla|pagli	<i>noun</i><br><ol><li>(masculine) mad, crazy person</li></ol><br><i>adj</i><br><ol><li>(masculine) mad, crazy</li></ol>
pagli|pagla	<i>noun</i><br><ol><li>(feminine) mad, crazy person</li></ol><br><i>adj</i><br><ol><li>(feminine) mad, crazy</li></ol>
pagn	<i>noun</i><br><ol><li>loincloth</li><li>sari</li></ol>
paisa	<i>noun</i><br><ol><li>money</li></ol>
palab	<i>noun</i><br><ol><li>gossip</li><li>one who gossips</li></ol>
palto	<i>noun</i><br><ol><li>coat, jacket</li></ol>
pamplemus	<i>noun</i><br><ol><li>grapefruit</li></ol>
pandit	<i>noun</i><br><ol><li>a scholar, learned man, pundit</li><li>(Hinduism) someone who performs a puja; a Hindu priest</li></ol>
pangar	<i>conj</i><br><ol><li>lest; in case</li></ol>
panse|form pans|pans	<i>verb</i><br><ol><li>To think</li></ol>
papa	<i>noun</i><br><ol><li>father</li></ol>
papay	<i>noun</i><br><ol><li>papaya</li></ol>
papi	<i>noun</i><br><ol><li>grandfather</li></ol>
papiyon	<i>noun</i><br><ol><li>butterfly</li></ol>
papye	<i>noun</i><br><ol><li>paper</li></ol>
parasol	<i>noun</i><br><ol><li>umbrella</li></ol>
pares	<i>noun</i><br><ol><li>laziness</li></ol>
parese|paresez	<i>noun</i><br><ol><li>lazy person</li></ol>
parey	<i>adj</i><br><ol><li>same</li></ol>
parking	<i>noun</i><br><ol><li>area where cars or other vehicles are parked; car park</li></ol>
parsadi	<i>noun</i><br><ol><li>(Hinduism, Sikhism) a type of food that is served as a religious offering in both Hinduism and Sikhism</li></ol>
partaze	<i>verb</i><br><ol><li>to share, divide</li></ol>
paryaz	<i>noun</i><br><ol><li>a race</li></ol>
paspor	<i>noun</i><br><ol><li>passport</li></ol>
patol	<i>noun</i><br><ol><li>Trichosanthes cucumerina</li></ol>
pe|form pe	<i>verb</i><br><ol><li>(auxiliary) Used to indicate present progressive tense or the continuous tense in general.</li></ol>
pepsi	<i>noun</i><br><ol><li>Pepsi</li><li>any soft drink</li></ol>
perdi|form perdi	<i>verb</i><br><ol><li>(transitive) To lose</li></ol>
permet|form permet	<i>verb</i><br><ol><li>to allow; to permit</li></ol>
permi	<i>noun</i><br><ol><li>permit</li></ol>
permisib	<i>adj</i><br><ol><li>permissible; tolerable, acceptable.</li></ol>
permision	<i>noun</i><br><ol><li>permission</li></ol>
peroke	<i>noun</i><br><ol><li>parrot</li></ol>
piblisite	<i>noun</i><br><ol><li>publicity</li><li>advertisement</li></ol>
pima	<i>noun</i><br><ol><li>chilli</li><li>spice</li></ol>
pipangay	<i>noun</i><br><ol><li>luffa (fruit)</li></ol>
plant	<i>noun</i><br><ol><li>a plant</li></ol>
plantasion	<i>noun</i><br><ol><li>plantation; crop</li></ol>
plante|form plant|plant	<i>verb</i><br><ol><li>to plant</li></ol>
planter	<i>noun</i><br><ol><li>a planter; one that plants something</li></ol>
plezir	<i>noun</i><br><ol><li>pleasure</li></ol>
pli	<i>adv</i><br><ol><li>more</li></ol>
plis	<i>noun</i><br><ol><li>plus</li><li>addition</li><li>benefit, advantage</li></ol>
plise|form plis|plis	<i>verb</i><br><ol><li>to peel</li></ol>
plore|form plore	<i>verb</i><br><ol><li>to cry (shed tears)</li></ol>
pom	<i>noun</i><br><ol><li>apple</li></ol>
pomdamur	<i>noun</i><br><ol><li>tomato (usually referring to local varieties)</li></ol>
pomdeter	<i>noun</i><br><ol><li>potato</li></ol>
portab	<i>noun</i><br><ol><li>mobile phone</li></ol><br><i>adj</i><br><ol><li>portable</li></ol>
portmone	<i>noun</i><br><ol><li>purse</li></ol>
pou|form pou	<i>prep</i><br><ol><li>for</li></ol><br><i>verb</i><br><ol><li>(auxiliary) Used to indicate future tense.</li></ol>
poul	<i>noun</i><br><ol><li>hen</li><li>chicken</li></ol>
pran|form pran	<i>verb</i><br><ol><li>to take</li></ol>
prasad	<i>noun</i><br><ol><li>(Hinduism, Sikhism) a type of food that is served as a religious offering in both Hinduism and Sikhism</li></ol>
prononse|pronons|form pronons	<i>verb</i><br><ol><li>to pronounce</li></ol>
prononsiasion	<i>noun</i><br><ol><li>pronunciation</li></ol>
puja	<i>noun</i><br><ol><li>(Hinduism) a religious ritual performed as an act of worship.</li></ol>
pujari	<i>noun</i><br><ol><li>(Hinduism) someone who performs a puja; a Hindu priest</li></ol>
pwason	<i>noun</i><br><ol><li>fish</li></ol>
rafine	<i>adj</i><br><ol><li>refined</li></ol>
rakhi	<i>noun</i><br><ol><li>An ornamental wristband given by a young woman to a brother</li><li>Raksha Bandhan; religious ceremony</li></ol>
raki	<i>noun</i><br><ol><li>An ornamental wristband given by a young woman to a brother</li><li>Raksha Bandhan; religious ceremony</li></ol>
rani	<i>noun</i><br><ol><li>queen</li><li>female ruler</li></ol>
razwar	<i>noun</i><br><ol><li>rasoir</li></ol>
realizasion	<i>noun</i><br><ol><li>creation; realization</li></ol>
realizater	<i>noun</i><br><ol><li>creator</li><li>director</li></ol>
realize|form realiz|realiz	<i>verb</i><br><ol><li>to realize.</li></ol>
regrete	<i>verb</i><br><ol><li>to regret</li></ol>
reken	<i>noun</i><br><ol><li>shark</li></ol>
reklam	<i>noun</i><br><ol><li>advertisement</li><li>advertising</li></ol>
reklame|reklam|form reklam	<i>verb</i><br><ol><li>to claim</li></ol>
resif	<i>noun</i><br><ol><li>reef</li></ol>
reste	<i>verb</i><br><ol><li>to stay, remain</li></ol>
revey	<i>noun</i><br><ol><li>clock</li></ol>
rezen	<i>noun</i><br><ol><li>grape</li></ol>
rezon	<i>noun</i><br><ol><li>reason</li><li>reasoning</li></ol>
ridikil	<i>adj</i><br><ol><li>ridiculous</li></ol>
ridikilize|ridikiliz|form ridikiliz	<i>verb</i><br><ol><li>to ridicule; to make fun of.</li></ol>
rido	<i>noun</i><br><ol><li>curtain</li></ol>
riye	<i>verb</i><br><ol><li>to laugh</li></ol>
romi	<i>noun</i><br><ol><li>rummy (card game)</li></ol>
ronfle	<i>verb</i><br><ol><li>to snore</li></ol>
ros	<i>noun</i><br><ol><li>A rock, stone.</li></ol>
rosban	<i>noun</i><br><ol><li>construction workers</li></ol>
rougay	<i>noun</i><br><ol><li>a tomato-based dish</li></ol>
royos	<i>noun</i><br><ol><li>hipster</li></ol><br><i>adj</i><br><ol><li>hipster</li></ol>
roz	<i>noun</i><br><ol><li>a rose</li></ol><br><i>adj</i><br><ol><li>the colour rose</li></ol>
ruz	<i>adj</i><br><ol><li>red</li></ol>
rwine|form rwinn|rwinn	<i>verb</i><br><ol><li>to ruin, damage</li></ol>
rwinn	<i>noun</i><br><ol><li>ruin</li></ol>
salam	<i>intj</i><br><ol><li>A greeting.</li></ol>
saler	<i>noun</i><br><ol><li>heat</li></ol>
samachar	<i>noun</i><br><ol><li>broadcast news</li><li>news, information</li></ol>
samdi	<i>noun</i><br><ol><li>Saturday</li></ol>
samousa	<i>noun</i><br><ol><li>samosa</li></ol>
sanpye	<i>noun</i><br><ol><li>centipede</li></ol>
sari	<i>noun</i><br><ol><li>sari</li></ol>
sat	<i>noun</i><br><ol><li>cat</li></ol>
satini	<i>noun</i><br><ol><li>chutney</li></ol>
savat	<i>noun</i><br><ol><li>slipper</li></ol>
semen	<i>noun</i><br><ol><li>road, street</li></ol>
semenn	<i>noun</i><br><ol><li>week</li></ol>
semiz	<i>noun</i><br><ol><li>shirt</li></ol>
senk|sink	<i>num</i><br><ol><li>five</li></ol>
senkiem	<i>adj</i><br><ol><li>The ordinal form of the number senk.</li></ol>
septam	<i>noun</i><br><ol><li>September</li></ol>
ser	<i>noun</i><br><ol><li>sister</li></ol><br><i>adj</i><br><ol><li>dear</li><li>expensive</li></ol>
serf	<i>noun</i><br><ol><li>deer</li></ol>
serom	<i>noun</i><br><ol><li>serum</li></ol>
serpan	<i>noun</i><br><ol><li>snake</li></ol>
servi|form servi	<i>verb</i><br><ol><li>to use, utilise</li><li>to serve</li></ol>
set	<i>num</i><br><ol><li>seven</li></ol>
setiem	<i>adj</i><br><ol><li>The ordinal form of the number set.</li></ol>
seval	<i>noun</i><br><ol><li>horse</li></ol>
sevret	<i>noun</i><br><ol><li>shrimp, prawn</li></ol>
sez	<i>num</i><br><ol><li>sixteen</li></ol><br><i>noun</i><br><ol><li>chair</li></ol>
shok samachar	<i>noun</i><br><ol><li>mourning news</li></ol>
si	<i>conj</i><br><ol><li>if</li></ol><br><i>intj</i><br><ol><li>yes (used to contradict a negative statement)</li></ol>
simen	<i>noun</i><br><ol><li>road</li></ol>
simityer	<i>noun</i><br><ol><li>cemetery</li></ol>
sinon	<i>conj</i><br><ol><li>otherwise</li><li>besides</li></ol>
sis	<i>num</i><br><ol><li>six</li></ol>
sitron	<i>noun</i><br><ol><li>lemon, lime</li><li>citrus fruit</li></ol>
siziem	<i>adj</i><br><ol><li>The ordinal form of the number sis.</li></ol>
so	<i>pron</i><br><ol><li>(possessive) his, her, its, one's</li></ol><br><i>adj</i><br><ol><li>hot, warm.</li></ol>
sok	<i>noun</i><br><ol><li>shock</li></ol>
soley	<i>noun</i><br><ol><li>the sun</li><li>sunlight</li></ol>
somey	<i>noun</i><br><ol><li>sleep, nap</li></ol>
sori	<i>adj</i><br><ol><li>sorry</li></ol>
sorsier|sorsie	<i>noun</i><br><ol><li>witch, female sorcerer</li></ol>
soulye	<i>noun</i><br><ol><li>shoe</li></ol>
souri	<i>noun</i><br><ol><li>mouse</li></ol>
sourir	<i>noun</i><br><ol><li>a smile</li></ol>
souriye	<i>verb</i><br><ol><li>to smile</li></ol>
sovaz	<i>noun</i><br><ol><li>An uncivilized, mannerless human</li></ol><br><i>adj</i><br><ol><li>wild, untamed</li><li>mannerless</li></ol>
sovsouri	<i>noun</i><br><ol><li>bat (mammal)</li></ol>
stasionnman	<i>noun</i><br><ol><li>car park</li></ol>
sulye	<i>noun</i><br><ol><li>shoe</li></ol>
sunuk	<i>noun</i><br><ol><li>snoek (usually dried and salted)</li></ol>
swazire	<i>verb</i><br><ol><li>to choose</li></ol>
taba	<i>noun</i><br><ol><li>tobacco</li></ol>
tabazi	<i>noun</i><br><ol><li>tobacconist</li></ol>
takamaka	<i>noun</i><br><ol><li>the plant Calophyllum tacamahaca</li></ol>
take	<i>noun</i><br><ol><li>power switch.</li></ol>
takine	<i>verb</i><br><ol><li>to tease</li><li>to irritate</li></ol>
talak	<i>noun</i><br><ol><li>talaq, divorce</li></ol>
taler	<i>adv</i><br><ol><li>later</li></ol>
tamaren	<i>noun</i><br><ol><li>tamarind fruit</li></ol>
tamasa	<i>noun</i><br><ol><li>show</li><li>scene, fuss</li></ol>
tambour	<i>noun</i><br><ol><li>drum</li></ol>
tande|tann|form tann	<i>verb</i><br><ol><li>To hear</li></ol>
tang	<i>noun</i><br><ol><li>tenrec</li></ol>
tantinn	<i>noun</i><br><ol><li>aunt</li></ol>
tanto	<i>adv</i><br><ol><li>later</li><li>this evening</li></ol>
tapaz	<i>noun</i><br><ol><li>noise, sound</li></ol>
tarif	<i>noun</i><br><ol><li>rate</li></ol>
tata|form tata	<i>noun</i><br><ol><li>grandfather</li><li>(usually childish) poo, excrement</li></ol><br><i>verb</i><br><ol><li>(usually childish) to poo, defecate</li></ol>
termozen	<i>noun</i><br><ol><li>a type of methanolated ointment made with petrolatum gel, used as body rub</li></ol>
ti|form ti	<i>verb</i><br><ol><li>(auxiliary) Used to indicate past tense.</li></ol>
ti ape|form ti ape	<i>verb</i><br><ol><li>(auxiliary) Used to indicate past progressive tense.</li></ol>
ti finn|form ti finn	<i>verb</i><br><ol><li>(auxiliary) Used to indicate pluperfect tense.</li></ol>
ti pe|form ti pe	<i>verb</i><br><ol><li>(auxiliary) Used to indicate past progressive tense.</li></ol>
ti pou|ti pou auxiliary	<i>verb</i><br><ol><li>Used to indicate future perfect tense.</li></ol>
ti'nn|form ti'nn	<i>verb</i><br><ol><li>(auxiliary) Used to indicate pluperfect tense.</li></ol>
tipti	<i>adj</i><br><ol><li>small</li></ol>
to|to|twa|ou|u	<i>pron</i><br><ol><li>you (second-person singular nominative personal pronoun)</li></ol>
tolerab	<i>adj</i><br><ol><li>tolerable, acceptable.</li></ol>
tolerans	<i>noun</i><br><ol><li>tolerance</li></ol>
tolere|toler|form toler	<i>verb</i><br><ol><li>to tolerate</li></ol>
tomat	<i>noun</i><br><ol><li>tomato</li><li>tinned mackerel in sauce</li></ol>
tombe	<i>noun</i><br><ol><li>to fall</li></ol>
tomem|oumem	<i>pron</i><br><ol><li>yourself (second-person singular informal reflexive pronoun)</li></ol>
tonton	<i>noun</i><br><ol><li>uncle</li></ol>
torti	<i>noun</i><br><ol><li>turtle, tortoise</li></ol>
trankil	<i>adj</i><br><ol><li>silent, quiet</li><li>still</li><li>calm</li></ol><br><i>intj</i><br><ol><li>keep quiet, shush</li><li>shut up</li></ol>
tretwar	<i>noun</i><br><ol><li>pavement</li></ol>
trez	<i>num</i><br><ol><li>thirteen</li></ol>
trouve|truve|form truv|trouv|truv|form trouv	<i>verb</i><br><ol><li>To find</li><li>To see</li></ol>
trwa	<i>num</i><br><ol><li>three</li></ol>
trwaziem	<i>adj</i><br><ol><li>The ordinal form of the number trwa.</li></ol>
twa|to|ou|u	<i>pron</i><br><ol><li>You. (second-person singular objective personal pronoun)</li></ol>
twalet	<i>noun</i><br><ol><li>toilet</li></ol>
tyingam	<i>noun</i><br><ol><li>chewing gum</li></ol>
urit|orit	<i>noun</i><br><ol><li>octopus</li></ol>
vakans	<i>noun</i><br><ol><li>holiday</li></ol>
vaksen	<i>noun</i><br><ol><li>vaccine</li></ol>
valer	<i>noun</i><br><ol><li>value, worth</li></ol>
vanakam	<i>intj</i><br><ol><li>hello (greeting)</li></ol>
vande|form vann|vann	<i>verb</i><br><ol><li>To sell</li></ol>
vandredi	<i>noun</i><br><ol><li>Friday</li></ol>
vant	<i>noun</i><br><ol><li>belly, stomach</li></ol>
vantilater	<i>noun</i><br><ol><li>fan</li></ol>
vas	<i>noun</i><br><ol><li>cow</li></ol>
veye	<i>noun</i><br><ol><li>to watch over, look after</li></ol>
vilaz	<i>noun</i><br><ol><li>village</li></ol>
vilazwa	<i>noun</i><br><ol><li>villager</li><li>countryside dweller</li></ol>
vini|form vinn|vinn	<i>verb</i><br><ol><li>to come</li></ol>
vol	<i>noun</i><br><ol><li>theft; robbery.</li></ol>
voler	<i>noun</i><br><ol><li>thief; robber.</li></ol>
vomi	<i>verb</i><br><ol><li>to vomit</li></ol>
waterlili	<i>noun</i><br><ol><li>water lily</li></ol>
wi	<i>adv</i><br><ol><li>yes; a word used to indicate agreement or acceptance</li></ol>
wit	<i>num</i><br><ol><li>eight</li></ol>
witiem	<i>adj</i><br><ol><li>The ordinal form of the number wit.</li></ol>
yer	<i>adv</i><br><ol><li>yesterday</li></ol>
yev|lyev	<i>noun</i><br><ol><li>hare</li></ol>
zafer	<i>noun</i><br><ol><li>thing</li><li>affair, business</li></ol>
zako	<i>noun</i><br><ol><li>monkey</li></ol>
zalimet	<i>noun</i><br><ol><li>matchstick</li></ol>
zanana	<i>noun</i><br><ol><li>pineapple</li></ol>
zanblon	<i>noun</i><br><ol><li>fruit of the plant Syzygium cumini</li></ol>
zanfan	<i>noun</i><br><ol><li>child</li></ol>
zanimo	<i>noun</i><br><ol><li>animal</li></ol>
zann	<i>noun</i><br><ol><li>son-in-law</li></ol>
zannon	<i>noun</i><br><ol><li>earring</li></ol>
zanvie	<i>noun</i><br><ol><li>January</li></ol>
zarenye	<i>noun</i><br><ol><li>spider</li></ol>
zariko	<i>noun</i><br><ol><li>bean</li></ol>
zasar	<i>noun</i><br><ol><li>pickle</li></ol>
zavoka	<i>noun</i><br><ol><li>avocado</li></ol>
zedi	<i>noun</i><br><ol><li>Thursday</li></ol>
zekler	<i>noun</i><br><ol><li>lightning</li></ol>
zepeng	<i>noun</i><br><ol><li>pin</li></ol>
zepol	<i>noun</i><br><ol><li>shoulder</li></ol>
zetwal	<i>noun</i><br><ol><li>star</li></ol>
zil	<i>noun</i><br><ol><li>island</li></ol>
zilie	<i>noun</i><br><ol><li>July</li></ol>
zilwa	<i>noun</i><br><ol><li>islander</li></ol>
zimaz	<i>noun</i><br><ol><li>picture</li></ol>
zin	<i>noun</i><br><ol><li>June</li></ol>
ziromon	<i>noun</i><br><ol><li>pumpkin</li></ol>
zistwar	<i>noun</i><br><ol><li>story</li></ol>
zoli	<i>adj</i><br><ol><li>beautiful</li></ol>
zon	<i>adj</i><br><ol><li>yellow</li></ol>
zong	<i>noun</i><br><ol><li>finger nail; toe nail.</li></ol>
zoranz	<i>noun</i><br><ol><li>orange (fruit)</li></ol>
zorey	<i>noun</i><br><ol><li>ear</li></ol>
zot	<i>pron</i><br><ol><li>you, y'all (second-person plural personal pronoun)</li><li>they, them (third-person plural personal pronoun)</li></ol>
zotmem	<i>pron</i><br><ol><li>yourselves (second-person plural reflexive pronoun)</li><li>themselves (third-person plural reflexive pronoun)</li></ol>
zour	<i>noun</i><br><ol><li>day</li></ol>
zoure|form zour|zour	<i>verb</i><br><ol><li>to curse, to swear</li></ol>
zournal	<i>noun</i><br><ol><li>broadcast news</li><li>news, information</li><li>newspaper</li></ol>
zournalis	<i>noun</i><br><ol><li>journalist</li></ol>
zournalism	<i>noun</i><br><ol><li>journalism</li></ol>
zoyon	<i>noun</i><br><ol><li>onion</li></ol>
zwazo|zozo	<i>noun</i><br><ol><li>bird</li></ol>
