a|â	<i>noun</i><br><ol><li>(rare) river, stream, water</li></ol>
achte|acht	<i>num</i><br><ol><li>eight</li></ol><br><i>noun</i><br><ol><li>vigilance</li><li>state (of being)</li><li>prosecution</li></ol>
achten|achts|acht|achtet|achtende|achte|achtes|achtene|achtens	<i>verb</i><br><ol><li>to consider, to think</li><li>to pay attention to</li><li>to expect</li><li>to discuss</li><li>to esteem, to value</li></ol>
achtende|achte	<i>adj</i><br><ol><li>eighth</li></ol>
achter|dative]|achter [+accusative	<i>prep</i><br><ol><li>behind</li><li>through, past</li><li>after (in time, order)</li></ol><br><i>adv</i><br><ol><li>behind, at the back</li><li>backwards</li><li>after (in time)</li></ol>
achternoene	<i>noun</i><br><ol><li>(Flemish, rare) afternoon</li></ol>
acker	<i>noun</i><br><ol><li>field (for agriculture)</li><li>acre</li></ol>
adem|âdem	<i>noun</i><br><ol><li>breath</li></ol>
ademen|âdemens|âdems|âdemet|âdemes|âdeme|âdemen|âdem|âdemt|âdemende|âdemene	<i>verb</i><br><ol><li>to breathe</li></ol>
adere|âdere	<i>noun</i><br><ol><li>blood vein</li><li>groundwater</li><li>ore</li><li>leaf</li><li>stone</li></ol>
ael|âel	<i>noun</i><br><ol><li>eel</li></ol>
aelst	<i>noun</i><br><ol><li>Aalst (a city in modern Belgium)</li></ol>
aemstelredam	<i>noun</i><br><ol><li>Amsterdam (a city in the modern Netherlands)</li></ol>
aer|āer|âer	<i>noun</i><br><ol><li>ear (of corn, grain etc.)</li><li>eagle</li></ol>
aes|âes	<i>noun</i><br><ol><li>carrion</li><li>bait</li></ol>
af|of	<i>adv</i><br><ol><li>off, out, away</li><li>of, about</li></ol>
after	<i>prep</i><br><ol><li>(Holland) Alternative form of achter</li></ol><br><i>adv</i><br><ol><li>(Holland) Alternative form of achter</li></ol>
aken|âken	<i>noun</i><br><ol><li>Aachen (a city in modern Germany)</li></ol>
al|alles|alle	<i>det</i><br><ol><li>all, all of</li></ol><br><i>adv</i><br><ol><li>completely</li></ol><br><i>conj</i><br><ol><li>even though, no matter whether</li></ol>
albrecht	<i>noun</i><br><ol><li>Albertus Magnus</li></ol>
alcmaer|alcmāer	<i>noun</i><br><ol><li>Alkmaar (a city in the modern Netherlands)</li></ol>
aldus	<i>adv</i><br><ol><li>so, to that degree</li><li>so, in this/that way</li></ol>
ale|āle	<i>noun</i><br><ol><li>ale</li></ol>
alf	<i>noun</i><br><ol><li>elf, evil spirit</li></ol>
alijc|ālijc	<i>adj</i><br><ol><li>whole, complete</li></ol>
allame|allâme|allâmen	<i>noun</i><br><ol><li>tool</li><li>house gear</li><li>army supplies</li></ol>
allene|allêene|alleene|allêne	<i>adv</i><br><ol><li>only, just</li></ol>
alse	<i>conj</i><br><ol><li>if, in the case that</li><li>when, whenever</li></ol><br><i>adv</i><br><ol><li>as, (just) like</li><li>as if</li></ol>
also|alsô	<i>adv</i><br><ol><li>so, thus</li><li>also, to the same degree</li></ol>
ambrosius	<i>noun</i><br><ol><li>Aurelius Ambrosius</li></ol>
amen|āmen	<i>intj</i><br><ol><li>amen, so be it</li></ol>
ander|andre	<i>adj</i><br><ol><li>second</li><li>other</li><li>(nominalised) another, someone else, others</li><li>further, more</li></ol>
andersins	<i>adv</i><br><ol><li>differently, in another way/manner</li><li>on the other hand</li><li>otherwise</li><li>elsewhere</li></ol>
ane|āen|âne|āne|an|aen	<i>prep</i><br><ol><li>on, on top of</li><li>on, on the side of</li><li>beside, alongside</li><li>to, towards (also as strengthening of the dative case)</li><li>during</li><li>without</li><li>against, without regard for</li></ol><br><i>adv</i><br><ol><li>towards, closer</li></ol>
antwerpen	<i>noun</i><br><ol><li>Antwerp (a city in modern Belgium)</li></ol>
antworde	<i>noun</i><br><ol><li>answer</li><li>affirmation</li><li>accountability (in the sense of "answer to")</li></ol>
antworden|antwordene|antworts|antwordes|antworde|antwordet|antwort|antwordens|antwordende	<i>verb</i><br><ol><li>to answer</li><li>to answer to</li><li>to agree with</li></ol>
appel	<i>noun</i><br><ol><li>apple</li></ol>
arch	<i>adj</i><br><ol><li>bad, depraved</li><li>wrong, evil</li><li>shameful</li><li>bad, worthless, of low quality</li></ol><br><i>noun</i><br><ol><li>evil</li><li>disaster, misfortune</li></ol>
arde	<i>adv</i><br><ol><li>(Flemish) Alternative form of harde</li></ol>
argeren	<i>verb</i><br><ol><li>to make/become worse</li><li>to break, to damage, to ruin</li><li>to defile</li><li>to devalue</li><li>to harm</li><li>to annoy</li></ol>
aristotiles	<i>noun</i><br><ol><li>Aristotle</li></ol>
arm|arms|armen|ārem|arme|armer|arem	<i>noun</i><br><ol><li>arm</li></ol><br><i>adj</i><br><ol><li>poor, having few possessions</li><li>unfortunate, pitiable</li></ol>
aventure|avontuere|avonture	<i>noun</i><br><ol><li>event</li><li>dangerous situation, adventure</li><li>happenstance</li><li>fate</li><li>story, account</li></ol>
avont|âvont	<i>noun</i><br><ol><li>evening (starting an hour before sunset, considered the start of a new day)</li></ol>
axele	<i>noun</i><br><ol><li>Axel (a city in the modern Netherlands)</li></ol>
bachten|bachten [+dative|accusative]	<i>prep</i><br><ol><li>(chiefly Flemish) behind, at the back/rear</li></ol>
backen|bact|backende|backet|backes|backe|backene|bacs|bac|backens	<i>verb</i><br><ol><li>to bake</li><li>to cling</li></ol>
baden|bādet|bāde|bādens|bāets|bādes|bāet|bādene|bāden|bādende	<i>verb</i><br><ol><li>to bathe, to wash</li></ol>
baert|bāert	<i>noun</i><br><ol><li>beard</li></ol>
bal	<i>noun</i><br><ol><li>ball (round object), sphere</li><li>something worthless</li></ol>
balch	<i>noun</i><br><ol><li>belly</li><li>abdomen</li><li>leather bag</li><li>bellows</li><li>skin, peel (of fruits)</li></ol>
balke	<i>noun</i><br><ol><li>(wooden) beam</li></ol>
banc	<i>noun</i><br><ol><li>bench, seat</li><li>judicial bench</li></ol>
bane|bāne	<i>noun</i><br><ol><li>open field, battlefield</li><li>lane, track (for playing balls)</li><li>road, way, path</li><li>harm, pain</li></ol>
bannen	<i>verb</i><br><ol><li>to summon (of a lord to his vassal)</li><li>to call together solemnly</li><li>to subpoena</li><li>to enforce with a solemn declaration</li><li>to ban, to drive out</li></ol>
barbecane|barbecāne	<i>noun</i><br><ol><li>barbican</li></ol>
bare|bâre	<i>noun</i><br><ol><li>bier, stretcher</li></ol>
baren|bāren	<i>verb</i><br><ol><li>to bear, to carry</li><li>to give birth to</li></ol><br><i>noun</i><br><ol><li>child</li><li>hero</li></ol>
basilius|bazelis	<i>noun</i><br><ol><li>Basil of Caesarea</li></ol>
bat|bet	<i>noun</i><br><ol><li>bath</li></ol><br><i>adv</i><br><ol><li>better; comparative degree of wel</li></ol>
becomen|becōmen	<i>verb</i><br><ol><li>to catch up to, to reach</li><li>to recover, to come to</li><li>to grow up (mostly of plants)</li><li>to become</li><li>to happen, to befall [+dative]</li><li>to please, to satisfy [+dative]</li><li>to befit [+dative]</li></ol>
bedanken	<i>verb</i><br><ol><li>to oblige to thank</li></ol>
bedde	<i>noun</i><br><ol><li>bed</li><li>bedding, mattress, pillow</li></ol>
bede|bēde|beede|bêde	<i>noun</i><br><ol><li>prayer</li><li>plea, request</li></ol><br><i>det</i><br><ol><li>(Flemish) Alternative form of beide</li></ol>
bedecken	<i>verb</i><br><ol><li>to cover</li><li>to hide, to conceal</li><li>to keep secret</li></ol>
bedehuus	<i>noun</i><br><ol><li>house of worship, temple, church</li></ol>
bedenken|bedocht	<i>verb</i><br><ol><li>to consider, to decide</li><li>to think of, to make up</li><li>(reflexive) to think, to ponder</li><li>(reflexive) to realise</li><li>(reflexive) to reconsider, to change one's mind</li></ol>
bederven	<i>verb</i><br><ol><li>to ruin, to kill</li><li>to damage, to destroy</li><li>to perish</li><li>to die</li></ol>
bedieden	<i>verb</i><br><ol><li>to explain, to make clear</li><li>to tell</li><li>to dictate, to prescribe</li><li>to mean, to indicate, to signify</li></ol>
bedienen	<i>verb</i><br><ol><li>to serve, to be useful</li></ol>
bedriegen|bedroghen|bedrogen|bedrōgen|bedrieghen	<i>verb</i><br><ol><li>to deceive, to mislead</li><li>to tempt</li><li>to disappoint</li></ol>
bedriven	<i>verb</i><br><ol><li>to carry out, to perform</li><li>to lead, to regulate</li><li>to force, to necessitate</li></ol>
bedroeven	<i>verb</i><br><ol><li>to disturb, to confuse</li><li>to make sad</li></ol>
beeder	<i>det</i><br><ol><li>feminine genitive/dative singular</li><li>genitive plural</li></ol>
beelde|bēelde	<i>noun</i><br><ol><li>sculpture</li><li>image</li></ol>
beelden|bēelts|bēeldens|bēelt|bēeldes|bēeldende|bēelde|bēeldet|bēeldene|bēelden	<i>verb</i><br><ol><li>to form, to shape</li><li>to depict</li></ol>
been|bêen	<i>noun</i><br><ol><li>leg</li><li>foot</li><li>bone</li></ol>
beene	<i>noun</i><br><ol><li>dative singular</li><li>nominative/accusative/genitive plural</li></ol>
beer|bêer	<i>noun</i><br><ol><li>boar, male pig</li></ol>
begeten|begēten	<i>verb</i><br><ol><li>(rare) to think of, to think up</li></ol>
begeven|begheven|beghēven|begēven	<i>verb</i><br><ol><li>to abandon, to forsake</li><li>to leave</li><li>to stop, to cease</li><li>to retreat (into a convent)</li></ol>
beghinne	<i>verb</i><br><ol><li>first-person singular present indicative</li><li>first/third-person singular present subjunctive</li></ol>
begin|beghin	<i>noun</i><br><ol><li>beginning, start</li><li>origin, source</li></ol>
beginnen|beginne|began|begonsten|beghinnen|beghinne|begonnen|begonste	<i>verb</i><br><ol><li>to begin, to start</li><li>to arise, to originate</li></ol>
begraven|begrāven	<i>verb</i><br><ol><li>to bury</li><li>to delimit (land) with a ditch</li><li>to fortify</li></ol>
begripen|begripe	<i>verb</i><br><ol><li>to grab hold of, to grasp</li><li>to encompass, to contain</li><li>to catch, to apprehend</li><li>to reprimand</li><li>to undertake, to perform</li></ol>
begripic	<i>abbrev</i><br><ol><li>Contraction of begripe ic.</li></ol>
behelen|behēlen	<i>verb</i><br><ol><li>(rare) to hide, to keep secret</li></ol>
behouden|behoude	<i>verb</i><br><ol><li>to keep, to not lose</li><li>to keep, to preserve, to protect</li><li>to have left over</li><li>to have power over, to rule over</li><li>to get, to receive</li></ol>
beide	<i>det</i><br><ol><li>both</li><li>(beide ... ende) both ... and</li></ol><br><i>noun</i><br><ol><li>waiting time, delay</li><li>abode</li></ol>
bejach	<i>noun</i><br><ol><li>kill, catch (from a hunt)</li><li>spoil, loot</li><li>gain</li><li>property, what one has gained</li><li>bread, livelihood</li></ol>
beke|bēke	<i>noun</i><br><ol><li>brook</li></ol>
bekennen|bekinnen	<i>verb</i><br><ol><li>to get to know, to learn of</li><li>to notice</li><li>to see</li><li>to recognise</li><li>to know</li><li>to acknowledge, to discern</li></ol>
belgen|bolchs|belgene|bolge|belcht|belgens|belgende|belget|belch|belges|bolges|bolcht|bolget|bolgen|gebolgen|belge|balch|belchs	<i>verb</i><br><ol><li>to swell</li><li>to get angry</li></ol>
benemen|benēmen	<i>verb</i><br><ol><li>to take away [+dative = from]</li><li>to withhold</li><li>to cause to end, to stop</li><li>to prevent, to hinder</li></ol>
beraden|berâden	<i>verb</i><br><ol><li>to advise, to counsel</li><li>to arrange, to bring about (through advice)</li><li>to grant</li><li>to provide with what is necessary</li><li>to protect, to shelter against</li></ol>
berch	<i>noun</i><br><ol><li>mountain, hill</li></ol>
bere|beere|bēre	<i>noun</i><br><ol><li>bear</li><li>berry</li></ol>
bereiken	<i>verb</i><br><ol><li>to reach, to arrive at</li></ol>
beren|bēren	<i>verb</i><br><ol><li>(rare) to bear, to carry</li></ol>
bergen|borgen|borcht|borchs|bergene|berget|borget|geborgen|borge|bercht|berge|berch|bergende|barch|bergens|berges|berchs|borges	<i>verb</i><br><ol><li>to get to safety, to keep safe</li><li>to stash away, to hide</li><li>to store, to keep</li></ol>
bergen op den soom|bergen op den sôom	<i>noun</i><br><ol><li>Bergen op Zoom (a city in the modern Netherlands)</li></ol>
berke	<i>noun</i><br><ol><li>birch</li></ol>
bernen|borns|berne|bernt|bornt|gebornen|bernens|bernet|bern|berns|barn|bernes|bornet|barnen|bernende|borne|bornen|bernene|bornes	<i>verb</i><br><ol><li>(intransitive) to burn, to be on fire</li><li>(transitive) to burn, to cause to be on fire or consumed by fire</li></ol>
berste	<i>noun</i><br><ol><li>crack, defect</li><li>lack, want, need</li></ol>
bersten|borstes|berstet|berstens|borstet|berstes|borsts|borste|berst|borsten|barsten|bersts|berstende|geborsten|borst|berstene|barst|berste	<i>verb</i><br><ol><li>to burst, to break apart</li><li>to come forth, to arise</li></ol>
beschuldich|beschuldigh|besculdich	<i>adj</i><br><ol><li>guilty</li></ol>
beseiken|besêkede|beseekede|besêken|beseken|besekede	<i>verb</i><br><ol><li>to urinate on</li></ol>
besich|bēsich	<i>adj</i><br><ol><li>busy, doing work</li><li>busy, having a lot to do</li><li>useful, necessary</li></ol>
bespreken|besprēken	<i>verb</i><br><ol><li>to talk about, to discuss</li><li>to agree, to make an agreement</li></ol>
best|beste	<i>adj</i><br><ol><li>best; superlative degree of goet</li></ol><br><i>adv</i><br><ol><li>best; superlative degree of wel</li></ol>
beswiken	<i>verb</i><br><ol><li>to abandon, to forsake</li><li>to succumb, to collapse</li></ol>
bet	<i>prep</i><br><ol><li>with, together with</li><li>with, by means of, using</li><li>(rare) up to</li></ol>
bete|bēte	<i>noun</i><br><ol><li>bite</li></ol>
beter|bēter	<i>adj</i><br><ol><li>better; comparative degree of goet</li></ol><br><i>adv</i><br><ol><li>better; comparative degree of wel</li></ol>
beteren|bēteren	<i>verb</i><br><ol><li>to better, to make/become better</li><li>to reimburse</li><li>to punish, to make pay</li><li>to increase, to make/become larger</li></ol>
bevaen|bevâen	<i>verb</i><br><ol><li>to grab, to seize</li><li>to get within reach</li><li>to acquire</li><li>to surround, to encompass</li><li>to understand, to grasp</li><li>to cover, to fill</li></ol>
bevelen|bevēlen	<i>verb</i><br><ol><li>to recommend, to advise</li><li>to entrust with (knowledge)</li><li>to entrust (into someone's care)</li><li>to order, to command</li></ol>
beven|bēven|bēvende|bēef|bēvet|bēves|bēvene|bēeft|bēve|bēefs|bēvens	<i>verb</i><br><ol><li>to shake, to shiver, to tremble</li></ol>
bever|bēver	<i>noun</i><br><ol><li>beaver</li></ol>
bewanen|bewânen	<i>verb</i><br><ol><li>to expect</li></ol>
bi	<i>prep</i><br><ol><li>by, near, around</li><li>beside, alongside</li><li>at, with</li><li>among</li><li>during</li><li>by (the work of)</li><li>because of</li></ol><br><i>adv</i><br><ol><li>by, near, around</li></ol>
bidden|biddes|bâet|gebēden|ghebeden|biddene|bâdet|bit|bâden|bâde|gebeden|bâdes|bat|bits|biddet|biddende|bâets|biddens|bidde	<i>verb</i><br><ol><li>to pray</li><li>to ask, to request</li><li>to beg</li><li>to invite</li></ol>
biddic	<i>abbrev</i><br><ol><li>Contraction of bidde ic.</li></ol>
biden|bēet|bides|bêet|gebēden|bēets|bidene|bidens|bēdet|bēde|bidende|bijts|bide|ghebeden|bēdes|bēden|bidet|bijt	<i>verb</i><br><ol><li>to wait [+accusative or genitive = for]</li></ol>
bie|bië	<i>noun</i><br><ol><li>bee</li></ol>
bieden|biedens|biede|biedene|bōden|bōde|gheboden|biedet|bôot|bōot|biets|gebōden|biedes|biet|bōots|bōdes|bōdet|geboden|biedende	<i>verb</i><br><ol><li>to offer, to present</li><li>to promise</li><li>to point, to direct (towards someone)</li><li>to notify</li></ol>
bier	<i>noun</i><br><ol><li>beer</li></ol>
binden|bindende|bonde|bonden|bondes|binde|bindet|gebonden|bints|bindene|bondet|bant|bindes|bint|bont|bonts|bindens	<i>verb</i><br><ol><li>To bind, tie.</li><li>To tie up.</li><li>To bind (to an obligation).</li></ol>
binnen|genitive]|binnen [+dative	<i>prep</i><br><ol><li>within, inside</li><li>within (a time span)</li><li>during</li><li>on, at (a time)</li></ol><br><i>adv</i><br><ol><li>inside</li></ol>
biten|bites|bijt|bēet|bêet|bitens|bēets|bēte|gebeten|gebēten|bite|bijts|bētet|bitet|bēten|bitende|bitene|ghebeten|bētes	<i>verb</i><br><ol><li>to bite</li></ol>
bitter	<i>adj</i><br><ol><li>bitter (taste)</li><li>sad, painful</li></ol>
blaken|blākene|blākes|blāken|blāket|blāecs|blāec|blāke|blākens|blāect|blākende	<i>verb</i><br><ol><li>to burn</li><li>to catch fire</li><li>to glow, to shine</li></ol>
blanden|blandende|blande|blandes|blandens|blant|blandet|blants|blandene	<i>verb</i><br><ol><li>(rare) to mix, to prepare (only of mead)</li></ol>
blankenberge	<i>noun</i><br><ol><li>Blankenberge (a city in modern Belgium)</li></ol>
blasen|blâsen|bliesen|bliese|blâsende|blâses|blieses|blâest|geblâsen|bliest|blieset|blâse|blies|blâsene|blâsens|blâes|blâset	<i>verb</i><br><ol><li>to blow</li><li>to blow on a wind instrument, to toot</li><li>to sound (of a wind instrument)</li><li>to brag</li></ol>
blat	<i>noun</i><br><ol><li>leaf</li><li>page (of a book)</li><li>panel (in a door)</li><li>tongue, blade</li><li>any flat surface or object</li></ol>
blau|blâeu|blaeu	<i>adj</i><br><ol><li>blue</li></ol><br><i>noun</i><br><ol><li>the colour blue</li></ol>
blayen|blâyen	<i>verb</i><br><ol><li>to blow (of wind)</li><li>to flutter, to wave in the wind</li><li>to wave, to go back and forth</li></ol>
bleec|blêec|blêken|blêke|blêker|blêecs	<i>adj</i><br><ol><li>pale, colourless</li></ol>
bleken|blêkende|blêkens|blêkes|blêec|blêken|blêket|blêke|blêecs|blêkene|blêect	<i>verb</i><br><ol><li>to pale, to become/be white</li><li>to bleach, to make white</li></ol>
bleves	<i>abbrev</i><br><ol><li>Contraction of blēvet es.</li></ol>
bli	<i>noun</i><br><ol><li>lead</li></ol>
blide	<i>adj</i><br><ol><li>happy, cheerful, joyous</li></ol><br><i>noun</i><br><ol><li>catapult</li></ol>
bliken|blēecs|blijct|blijc|blikens|blikes|blêec|blēkes|blēke|blikene|geblēken|bliket|blikende|blēken|blēket|blēect|blike|blijcs	<i>verb</i><br><ol><li>to shine, to glitter</li><li>to appear (come into sight)</li><li>to appear (have a certain appearance)</li><li>to show, to demonstrate</li><li>to be evident</li></ol>
blinken|blinkende|blinkes|blinkens|blincs|blinket|blinke|blinkene|blinc|blinct	<i>verb</i><br><ol><li>to shine, to glitter (reflect light)</li></ol>
blint|blinder|blints|blinden|blinde	<i>adj</i><br><ol><li>blind, unable to see</li></ol>
bliven|blive|blēve|blijfs|blijft|blēvet|blēves|blijf|blivet|blevet|blēeft|blivende|blēefs|bleven|blivene|blivens|blēven|blêef|geblēven|blives	<i>verb</i><br><ol><li>to become</li><li>to stay, to remain</li><li>to die, to perish</li><li>to give birth</li></ol>
bloeme|bloemen	<i>noun</i><br><ol><li>flower</li></ol>
bloet	<i>noun</i><br><ol><li>blood</li></ol>
bloeyen	<i>verb</i><br><ol><li>to bloom, to blossom</li></ol>
blouwen	<i>verb</i><br><ol><li>to hit, to beat</li><li>to beat up</li></ol>
blusschen|bluschs|blusschene|bluscht|blusschens|blusch|blusschende|blussche|blusschet|blussches	<i>verb</i><br><ol><li>to extinguish, to put out</li><li>to quench</li><li>to stop, to put an end to</li></ol>
boc|buc	<i>noun</i><br><ol><li>buck, male goat</li></ol>
bocken|bockens|bockende|bockene|bocket|bocke|bocs|boct|boc|bockes	<i>verb</i><br><ol><li>to bend, to stoop</li><li>to bow</li></ol>
bode|bōden|bōde	<i>noun</i><br><ol><li>messenger</li><li>servant</li></ol>
boec|boucken|bouc|boeken	<i>noun</i><br><ol><li>book</li><li>book, tome, volume (of a larger work)</li></ol>
boech	<i>noun</i><br><ol><li>forearm</li><li>front shank (of an animal)</li></ol>
boecweit	<i>noun</i><br><ol><li>buckwheat</li></ol>
boergoenie	<i>noun</i><br><ol><li>Burgundy (a duchy)</li></ol>
boeten|boets|boetene|boetes|boetende|boet|boete|boetet|boetens	<i>verb</i><br><ol><li>to improve, to make better</li><li>to still, to satisfy</li><li>to repair</li><li>to compensate, to reimburse</li></ol>
boge|bōge	<i>noun</i><br><ol><li>bow (weapon)</li><li>arch</li></ol>
bone|bône	<i>noun</i><br><ol><li>bean</li></ol>
boom|bôom	<i>noun</i><br><ol><li>tree</li><li>beam, pole</li><li>boom barrier</li></ol>
borch|burch	<i>noun</i><br><ol><li>fortress, castle</li><li>city</li></ol>
boren|bōors|bōres|bōor|bōre|bōrende|bōrens|bōort|bōrene|bōren|bōret	<i>verb</i><br><ol><li>to drill</li></ol>
borst	<i>noun</i><br><ol><li>chest</li><li>breast</li></ol>
borstel	<i>noun</i><br><ol><li>hair of a pig, bristle</li></ol>
bosch|busch	<i>noun</i><br><ol><li>forest, wood</li></ol>
boter|bōter	<i>noun</i><br><ol><li>butter</li></ol>
bouwen	<i>verb</i><br><ol><li>to build, to found</li><li>to till, to work (land)</li><li>to inhabit, to dwell</li><li>to cultivate, to cherish</li></ol>
brabant|brâbant	<i>noun</i><br><ol><li>Brabant (a duchy)</li></ol>
braden|brâdende|brâdet|brâde|gebrâden|brâdens|briets|brieden|briedet|briede|brâden|brâdene|briet|briedes|brâets|brâet|brâdes	<i>verb</i><br><ol><li>to roast, to broil</li><li>to heat</li><li>to burn</li></ol>
branden|brandes|brandende|brande|brandene|brandet|brants|brant|brandens	<i>verb</i><br><ol><li>Synonym of bernen</li></ol>
brant	<i>noun</i><br><ol><li>fire</li><li>burning piece of wood, brand</li><li>firewood, fuel</li><li>burn (mark on the skin or something else)</li></ol>
breda|brêdâ	<i>noun</i><br><ol><li>Breda (a city in the modern Netherlands)</li></ol>
breet|brêet|brêden|brêder|brêets|brêde	<i>adj</i><br><ol><li>broad, wide</li></ol>
breiden|breidene|breit|breides|breidet|breidende|breiden|breits|breidens|breide	<i>verb</i><br><ol><li>to weave, to braid</li><li>to broaden</li><li>to expand, to extend</li><li>to enlarge, to increase</li></ol>
breken|brâect|brâket|brâken|brēke|brēec|brēken|brac|brēecs|brēkes|brâecs|gebroken|brâkes|brēkens|brēect|brēket|brēkende|brec|brēkene|brâke	<i>verb</i><br><ol><li>to break, to break into pieces</li><li>to break, to be broken</li><li>to destroy</li><li>to break in</li><li>to end, to diminish, to weaken</li><li>to break, to overcome resistance, to subdue</li></ol>
bringen|bringe|bringes|bringet|bringende|brinct|brengen|bringens|brocht|brincs|bringene|bringhen|brinc	<i>verb</i><br><ol><li>to bring</li></ol>
broec	<i>noun</i><br><ol><li>trousers, pants, breeches</li><li>low land, wetland, marsh</li></ol>
broeder	<i>noun</i><br><ol><li>brother</li><li>colleague</li><li>friar</li></ol>
broet	<i>noun</i><br><ol><li>brood, young of a bird</li><li>(act of) brooding</li></ol>
broeyen	<i>verb</i><br><ol><li>to scorch, to burn</li></ol>
broot|brôot	<i>noun</i><br><ol><li>bread</li><li>livelihood</li></ol>
brouwen	<i>verb</i><br><ol><li>to brew</li><li>(figuratively) to think up, to come up with</li></ol>
brugge	<i>noun</i><br><ol><li>bridge</li><li>Bruges (a city in modern Belgium)</li></ol>
bruken|bruket|bruucs|brukens|brukende|brukes|bruuct|bruuc|brukene|bruke	<i>verb</i><br><ol><li>to use</li><li>to enjoy (the use/benefit of)</li><li>to lease (of land)</li><li>to sell (of small things)</li></ol>
bruun	<i>adj</i><br><ol><li>brown</li></ol><br><i>noun</i><br><ol><li>A bear character in the story of Reynard the fox.</li></ol>
bueren|bueres|buerende|buer|buerens|buers|bueret|buerene|buert|buere	<i>verb</i><br><ol><li>to raise</li><li>to collect (money)</li></ol>
bugen|bugens|buges|bugene|bōges|buuch|bugende|buuchs|bōochs|buucht|buget|bōgen|gebōgen|bōget|bôoch|bōge|bōocht|buge	<i>verb</i><br><ol><li>to bend</li><li>to bow (in submission)</li><li>to yield, to give way (to a force)</li></ol>
busse	<i>noun</i><br><ol><li>round box, tin, jar</li><li>firelock</li></ol>
buuc	<i>noun</i><br><ol><li>belly</li><li>abdomen</li><li>half of a slaughtered animal</li></ol>
buur	<i>noun</i><br><ol><li>inhabitant (one who shares in rights and obligations as an inhabitant of a place)</li><li>(rare) neighbour</li><li>(rare) house, shed, building</li></ol>
calf	<i>noun</i><br><ol><li>calf</li></ol>
callen|callens|callende|cals|calles|calle|calt|callet|cal|callene	<i>verb</i><br><ol><li>to talk about, to tell</li><li>to talk rubbish</li></ol>
camere|cāmere	<i>noun</i><br><ol><li>vault</li><li>chamber, room that holds a fireplace</li><li>chamber (of a firearm)</li></ol>
capellaen|cāpellāen|capelaen	<i>noun</i><br><ol><li>chaplain</li></ol>
cappen|cappende|cappet|cap|capt|cappene|cappens|cappes|caps|cappe	<i>verb</i><br><ol><li>to chop, to cleave</li></ol>
case|câse	<i>noun</i><br><ol><li>cheese</li></ol>
cassel	<i>noun</i><br><ol><li>Kassel (a city in modern France)</li></ol>
casteel|castêel	<i>noun</i><br><ol><li>castle</li><li>fortified town, fortification</li></ol>
castien|castiën|castyen	<i>verb</i><br><ol><li>to correct, to reprimand</li><li>to discipline</li><li>to teach the truth</li></ol>
cater|cāter	<i>noun</i><br><ol><li>tomcat</li></ol>
catte	<i>noun</i><br><ol><li>cat</li></ol>
clage|clāge|claghe	<i>noun</i><br><ol><li>yammering, lamentation</li><li>complaint</li></ol>
clagen|clāgen|clāge|clāechs|clāecht|clāech|clāgene|claghen|clāgens|clāgende|clāges|claghet|claghene|clāget	<i>verb</i><br><ol><li>to complain, to issue a complaint</li></ol>
claghet	<i>verb</i><br><ol><li>third-person singular present indicative</li><li>second-person plural present indicative/subjunctive</li><li>plural imperative</li></ol>
claghic	<i>abbrev</i><br><ol><li>Contraction of clāge ic.</li></ol>
clappen|clappes|clappene|clappens|clap|claps|clappet|clappende|clappe|clapt	<i>verb</i><br><ol><li>to clap, to make a clapping sound</li><li>to knock</li><li>to chatter</li><li>to tell</li></ol>
cleden|clêden|clêdes|clêde|clêdet|clêdende|clêets|clêdene|clêet|clêdens	<i>verb</i><br><ol><li>to clothe</li><li>to cover (in cloth)</li></ol>
cleet|clêet	<i>noun</i><br><ol><li>piece of cloth</li><li>piece of clothing</li></ol>
cleine|clêne|clene|cleene	<i>adj</i><br><ol><li>small</li><li>short</li><li>unimportant</li><li>fine, finely ground</li></ol>
clemmen|clemmes|clemt|clemmens|clems|clemmet|clemmene|clem|clemme|clemmende	<i>verb</i><br><ol><li>to be stuck, jamed</li><li>to hold, to clamp</li></ol>
cleven|clēven	<i>verb</i><br><ol><li>to stick, to adhere</li></ol>
clieven|clievet|clōven|clieve|clōvet|geclōven|clievende|cliefs|clievene|clieves|clōoft|clōves|clief|clōve|clôof|clōofs|clieft|clievens	<i>verb</i><br><ol><li>(transitive) to cleave, to split</li><li>(intransitive) to split, to be split</li></ol>
climmen|clam|clommes|cloms|climmet|geclommen|clommet|climmende|climme|climmens|clims|clomt|clomme|clommen|clim|climmes|climt|climmene	<i>verb</i><br><ol><li>to climb</li><li>to rise, to go up</li><li>to increase</li></ol>
clingen|clingen|clingene|clingende|clinges|clinge|clinget|clinc|clincs|clinct|clingens	<i>verb</i><br><ol><li>to sound, to resound</li><li>to cling, to stick</li><li>to wither, to wilt</li></ol>
cliven|clēven|clēves|clivene|clivende|clēeft|clēve|clijf|clijfs|clēefs|clēvet|geclēven|clive|clives|clêef|clijft|clivens|clivet	<i>verb</i><br><ol><li>to rise, to climb</li><li>to increase</li><li>to stick, to cling</li></ol>
clocke	<i>noun</i><br><ol><li>bell</li><li>something bell-shaped</li></ol>
cloppen|clop|cloppes|cloppet|clopt|clops|cloppene|cloppe|cloppens|cloppende	<i>verb</i><br><ol><li>to knock, to hit</li><li>to knock (on a door)</li></ol>
cnagen|cnāgen	<i>verb</i><br><ol><li>to gnaw</li><li>to eat away</li></ol>
cneden|cnēden	<i>verb</i><br><ol><li>to knead</li></ol>
cnie	<i>noun</i><br><ol><li>knee</li></ol>
cnielen	<i>verb</i><br><ol><li>to kneel</li></ol>
cnoop|cnôop	<i>noun</i><br><ol><li>knot (tied in rope)</li><li>knot, knob, lump</li><li>joint</li></ol>
cnopen|cnôpen|cnôpes|cnôops|cnôop|cnôpens|cnôpet|cnôpene|cnôpende|cnôopt|cnôpe	<i>verb</i><br><ol><li>to tie with a knot</li><li>to bind</li></ol>
coe|kuo	<i>noun</i><br><ol><li>cow</li></ol>
coeke	<i>noun</i><br><ol><li>cake</li></ol>
coel	<i>adj</i><br><ol><li>cool</li></ol>
coken|cōkes|cōkende|cōke|cōoct|cōoc|cōken|cōocs|cōket|cōkens|cōkene	<i>verb</i><br><ol><li>to cook</li><li>to boil</li></ol>
colne	<i>noun</i><br><ol><li>Cologne (a city in modern Germany)</li></ol>
comen|cōmen|commen	<i>verb</i><br><ol><li>to come</li></ol>
conden|conts|cont|condes|condens|condene|conde|conden|condende|condet	<i>verb</i><br><ol><li>to announce, to make known</li><li>to season, to add herbs to</li></ol>
coninc|coninghen|cōninc|coninghe|conincs	<i>noun</i><br><ol><li>king</li><li>leader, important person</li></ol>
connen|conste|can|conde	<i>verb</i><br><ol><li>to know, to be familiar with, to understand</li><li>(of a language) to speak</li><li>(auxiliary) can, to be able to, to have the ability to</li></ol>
conte	<i>noun</i><br><ol><li>vagina, also generally sex organ</li></ol>
copen|côop|côpe|côpene|côpes|côpende|côops|côpen|côpens|côpet|côopt	<i>verb</i><br><ol><li>to buy</li><li>to trade</li><li>to buy off</li></ol>
cortois|cortoys	<i>adj</i><br><ol><li>courteous, well-mannered</li></ol><br><i>noun</i><br><ol><li>A dog character in the story of Reynard the fox.</li></ol>
coude	<i>noun</i><br><ol><li>cold, coldness</li><li>cold (disease), fever</li></ol>
cout	<i>adj</i><br><ol><li>cold</li><li>coolheaded</li></ol>
couwen	<i>verb</i><br><ol><li>to chew</li></ol>
cracht	<i>noun</i><br><ol><li>strength</li><li>force</li></ol>
craken|crāke|crāecs|crāken|crāec|crāect|crākes|crākende|crākene|crākens|crāket	<i>verb</i><br><ol><li>to creak, to crack</li></ol>
cranc|cranken|crancken	<i>adj</i><br><ol><li>sick</li><li>weak, strengthless</li><li>vulnerable</li><li>not potent (of medicine)</li><li>insignificant</li><li>bad, miserable</li></ol>
crancken	<i>adj</i><br><ol><li>masculine accusative/dative singular</li><li>neuter dative singular</li><li>dative plural</li></ol>
craye|crâye	<i>noun</i><br><ol><li>crow</li></ol>
crayen|crâyen	<i>verb</i><br><ol><li>to crow (of birds)</li></ol>
crayeren|crâyēren	<i>verb</i><br><ol><li>to shout, to call around</li><li>to make known, to announce</li></ol>
creature	<i>noun</i><br><ol><li>creature, being</li></ol>
crede|crēde	<i>noun</i><br><ol><li>creed</li></ol>
crigen|crigende|crige|crijch|crijcht|crēechs|crēgen|crêech|crēge|gecrēgen|crigene|crēget|crēecht|crighen|crēges|crigens|criges|criget|crijchs	<i>verb</i><br><ol><li>to acquire, to gain (through effort)</li><li>to get, to receive, to be given</li></ol>
crimpen|crompt|crompet|crimpende|crimpes|crimpt|crompen|gecrompen|crimps|crimpens|cramp|cromps|crimpet|crompe|crompes|crimpene|crimp|crimpe	<i>verb</i><br><ol><li>to shrink, to become smaller</li><li>to contract</li></ol>
cringen|cronges|crincs|cringes|cringe|crinct|cringens|cronct|cronge|crongen|cranc|cringet|gecrongen|cringene|cringende|croncs|crinc|cronget	<i>verb</i><br><ol><li>(intransitive) to turn oneself (in a direction)</li><li>(intransitive) to turn away</li></ol>
crischen	<i>verb</i><br><ol><li>to scream, to shriek</li></ol>
criten|critende|crêet|critene|crites|critens|crēets|critet|crijt|crēten|crēet|crētes|crijts|gecrēten|crite|crētet|crēte	<i>verb</i><br><ol><li>to scream, to cry</li></ol>
crom	<i>adj</i><br><ol><li>bent, not straight</li><li>wrong (morally)</li></ol>
crommen|crom|cromme|cromt|crommene|crommes|crommet|crommens|crommende|croms	<i>verb</i><br><ol><li>to bend, to make/become bent</li></ol>
crone|crône	<i>noun</i><br><ol><li>crown, wreath</li></ol>
cronen|crôon|crônene|crônet|crônende|crônens|crôons|crônes|crôont|crône|crônen	<i>verb</i><br><ol><li>to groan, to moan</li><li>(transitive) to crown, to top, to put a crown/wreath on</li><li>(transitive) to coronate</li></ol>
cruden	<i>verb</i><br><ol><li>to push, to press</li><li>to push forward</li></ol>
crullen|crult|crullene|cruls|crulle|crullens|crullet|crullende|crul|crulles	<i>verb</i><br><ol><li>to curl, to be/make curly (mostly of hair)</li></ol>
crune	<i>noun</i><br><ol><li>crown (top of the head)</li></ol>
crupen|crōops|crupe|crōopt|gecropen|crupens|cruupt|crōpet|cruups|gecrōpen|crōpen|crōpes|crupet|crupene|crōpe|cruup|crupes|ghecropen|crupende|crôop	<i>verb</i><br><ol><li>to crawl, to move close to the ground (on hands and feet etc.)</li><li>to creep, to move slowly</li></ol>
cruut	<i>noun</i><br><ol><li>plant, vegetation, herb (as opposed to a tree)</li><li>edible plant, vegetable</li><li>medicinal plant</li></ol>
cul	<i>noun</i><br><ol><li>a testicle, male genital ball</li><li>a vegetal reproductive bulb</li><li>a marble (for games)</li><li>the male member, penis</li></ol>
cule	<i>noun</i><br><ol><li>hole in the ground, dip, pit</li></ol>
culenborch	<i>noun</i><br><ol><li>Culemborg (a city in the modern Netherlands)</li></ol>
cume	<i>adv</i><br><ol><li>barely, only just</li><li>almost, nearly</li></ol>
cumen|cumene|cumende|cumens|cumet|cuums|cume|cumes|cuumt|cuum	<i>verb</i><br><ol><li>to groan, to moan (in pain)</li><li>to sigh</li><li>to be sad, unhappy</li></ol>
cussen|cussens|cust|cussende|cusse|cusses|cussene|cusset|cus	<i>verb</i><br><ol><li>to kiss</li></ol>
cust	<i>noun</i><br><ol><li>choice, what is chosen</li></ol>
cuwaert|cuwāert	<i>noun</i><br><ol><li>A hare character in the story of Reynard the fox.</li></ol>
dac	<i>noun</i><br><ol><li>roof</li></ol>
dach|dages|dāge|dagen|dage	<i>noun</i><br><ol><li>day</li></ol>
daer|dâer	<i>adv</i><br><ol><li>there</li><li>to there, thither</li><li>then</li><li>where</li><li>to where, whither</li><li>whereupon, after which</li><li>where, with who</li><li>wherewith</li><li>about which</li></ol><br><i>conj</i><br><ol><li>if, when</li><li>because</li><li>while</li><li>when</li></ol>
daet|dâet	<i>noun</i><br><ol><li>deed, act</li></ol>
dagen|dāges|dāget|dāgene|dāecht|daghe|dāgen|dāge|dāech|dāgende|dāgens|dāechs	<i>verb</i><br><ol><li>to dawn, to become day</li><li>to rest (a horse)</li><li>to let someone wait, to delay</li><li>to summon to appear on a certain day</li><li>to summon to a court</li></ol>
daghe	<i>noun</i><br><ol><li>dative singular</li><li>nominative/accusative/genitive plural</li></ol>
dal	<i>noun</i><br><ol><li>valley</li><li>dip, lower area in the landscape</li><li>hole</li></ol>
dalen|dāle|dāels|dālen|dāelt|dālene|dāel|dāles|dālende|dālens|dālet	<i>verb</i><br><ol><li>to go down, to descend</li><li>to lessen, to become less</li></ol>
dan	<i>adv</i><br><ol><li>then, after that</li><li>then, in that case</li><li>thus, therefore</li></ol><br><i>conj</i><br><ol><li>than (in comparisons)</li><li>other than (with negation)</li></ol><br><i>abbrev</i><br><ol><li>Contraction of dat ne.</li></ol>
danc	<i>noun</i><br><ol><li>thanks, gratitude</li><li>praise, honour</li><li>will, desire</li><li>thought</li></ol>
dandre	<i>abbrev</i><br><ol><li>Contraction of die andre.</li></ol>
danken|danke|dankes|dankens|dankene|dancs|danc|danket|danct|dankende	<i>verb</i><br><ol><li>to thank [+accusative = for]</li></ol>
dansen|dansende|danse|danses|dansene|danset|dansens|dans|danst	<i>verb</i><br><ol><li>to dance (around)</li></ol>
darven|derven	<i>verb</i><br><ol><li>to lack, to want</li><li>to lose</li></ol>
das	<i>noun</i><br><ol><li>(mustelids) badger, European badger</li></ol>
dat	<i>pron</i><br><ol><li>that</li></ol><br><i>conj</i><br><ol><li>that</li><li>then, while</li><li>if, when</li><li>because</li><li>so that</li><li>insofar as</li></ol><br><i>abbrev</i><br><ol><li>Contraction of dat het.</li></ol>
dats	<i>abbrev</i><br><ol><li>Contraction of dat is.</li></ol>
datsi	<i>abbrev</i><br><ol><li>Contraction of dat si.</li></ol>
datter	<i>abbrev</i><br><ol><li>Contraction of dat dāer.</li></ol>
dattie	<i>abbrev</i><br><ol><li>Contraction of dat die.</li></ol>
decken|decs|deckende|decket|deckene|decke|deckes|deckens|dec|dect	<i>verb</i><br><ol><li>to roof, to build/repair a roof</li><li>to cover</li><li>to protect by covering</li><li>to erase, to make invisible</li><li>to hide</li><li>to keep secret</li></ol>
dedi	<i>abbrev</i><br><ol><li>Contraction of dēde hi.</li></ol>
dedine	<i>abbrev</i><br><ol><li>Contraction of dēde hi -ene.</li></ol>
delen|dêelt|dêlens|dêel|dêlende|dêlen|dêlene|dêlet|dêels|dêles|dêle	<i>verb</i><br><ol><li>to share, to distribute</li><li>to give, to gift</li><li>to share (a punishment)</li><li>to have a share in</li><li>to separate</li></ol>
delf	<i>noun</i><br><ol><li>Delft (a city in the modern Netherlands)</li></ol>
delven|delvet|dolvet|dalf|delvens|delves|dolven|gedolven|delvende|delf|delvene|dolve|dolves|dolfs|delft|delve|delfs|dolft	<i>verb</i><br><ol><li>to delve, to dig, to excavate (create by digging)</li><li>to bury</li></ol>
denken|denkende|dincken|denct|denket|dinken|denkene|denke|denkes|dencs|denc|denkens|dinct	<i>verb</i><br><ol><li>to think</li></ol>
derde	<i>adj</i><br><ol><li>third</li></ol>
deren|dēres|dēret|dēers|dēert|dērende|dēer|dērens|dērene|dēre|dēren	<i>verb</i><br><ol><li>to harm, to hurt</li><li>to hurt emotionally</li><li>to damage</li></ol>
derschen|dorschs|derschet|dorscht|derschs|darsch|dorsche|dersches|derschens|dersche|dorsches|dorschet|dersch|dorschen|gedorschen|derschene|derschende|derscht	<i>verb</i><br><ol><li>to thresh</li></ol>
dertich	<i>num</i><br><ol><li>thirty</li></ol>
descepenen	<i>abbrev</i><br><ol><li>Contraction of de schēpenen.</li></ol>
dese|dit|deser|desen|deses	<i>det</i><br><ol><li>this, these</li></ol>
dichten|dichte|dichtende|dichtes|dichtens|dichts|dicht|dichtene|dichtet	<i>verb</i><br><ol><li>to dictate</li><li>to write down, to arrange in writing</li></ol>
dichtere	<i>noun</i><br><ol><li>writer (of prose or poetry)</li></ol>
dicke|dicken|dicker|dics	<i>adj</i><br><ol><li>thick, fat</li><li>thick, viscous (of a liquid)</li><li>dense</li><li>cloudy</li></ol><br><i>noun</i><br><ol><li>thickness</li></ol><br><i>adv</i><br><ol><li>thickly, compactly</li><li>often</li></ol>
die|des|der|dier|dies|de|den|dat|diere|dien|dië	<i>article</i><br><ol><li>the; definite article.</li></ol><br><i>det</i><br><ol><li>that, those</li><li>who, which, that</li></ol><br><i>noun</i><br><ol><li>thigh</li></ol>
die hage|die hāge	<i>noun</i><br><ol><li>The Hague (a city in the modern Netherlands)</li></ol>
dieden|diede|diedet|diedende|diedene|diets|diedes|diedens|diet	<i>verb</i><br><ol><li>to explain</li><li>to mean, to signify</li><li>to tell</li><li>(with a negative) to be valid</li><li>(with a negative) to be helpful, useful</li></ol>
dief	<i>noun</i><br><ol><li>thief</li></ol>
diefte|dieften	<i>noun</i><br><ol><li>theft</li></ol>
dien|diën	<i>verb</i><br><ol><li>to grow, to mature</li><li>to grow (in size), to expand, to lengthen</li><li>to increase</li><li>to multiply, to become larger in number</li></ol>
dienen|diende|diën|dienet|dienens|dienende|dienene|dient|dienes|diens|diene|dien	<i>verb</i><br><ol><li>to serve, to obey</li><li>to be in service of</li><li>to serve (food)</li><li>to help, to take care of</li><li>to provide with</li></ol>
dier|diere	<i>noun</i><br><ol><li>animal</li></ol>
diere|dure	<i>adj</i><br><ol><li>valuable</li><li>expensive</li><li>dear, precious</li><li>excellent</li></ol>
dies	<i>adv</i><br><ol><li>therefore, because of that, for that reason</li></ol><br><i>conj</i><br><ol><li>until</li><li>because</li></ol><br><i>abbrev</i><br><ol><li>Contraction of die es.</li></ol>
diet	<i>abbrev</i><br><ol><li>Contraction of die dat.</li><li>Contraction of die het.</li></ol>
dietsch|dietschen|dietsche|dietschs|dietscher	<i>adj</i><br><ol><li>German, Germanic, Dutch</li><li>Dutch specifically</li><li>(substantive) Dutch language</li></ol>
dijn|dijns|dine|dinen|diere	<i>det</i><br><ol><li>thy, your (singular, informal)</li></ol>
dinc	<i>noun</i><br><ol><li>case, subject, what has been discussed</li><li>case (of law)</li><li>matter, affair, question, what one is involved in</li><li>thing, object</li></ol>
dingen|dinge|dingens|dinges|dingene|dinc|dinget|dincs|dingende|dinct	<i>verb</i><br><ol><li>to hold a trial in court</li><li>to try, to judge</li><li>to plead for</li><li>to strive</li><li>to speak formally</li><li>to chatter, to talk back and forth</li></ol>
dinsen|dinses|donses|dinst|dinset|donset|donst|donsen|dinsens|dons|gedonsen|donse|dins|dinsene|dinsende|dans|dinse	<i>verb</i><br><ol><li>(eastern) to drag, to drag around</li></ol>
dit	<i>pron</i><br><ol><li>this</li></ol>
dochter	<i>noun</i><br><ol><li>daughter</li></ol>
doden|dôdet|dôdes|dôdens|dôots|dôdende|dôot|dôde|dôden|doet|dôdene	<i>verb</i><br><ol><li>to kill</li><li>to murder</li></ol>
doe|doen|toe	<i>adv</i><br><ol><li>then, at that time, at the time</li><li>then, after that</li></ol><br><i>conj</i><br><ol><li>when, at the time that</li></ol>
doec	<i>noun</i><br><ol><li>cloth</li></ol>
doen|dede|gedaen|deden|dadet|dedes|dēden|dâden|ghedaen|doene|doende|daden|dade|gedāen|daets|doet|does|doe|dēde	<i>verb</i><br><ol><li>to do</li><li>to cause</li><li>to put, to place</li></ol>
dogen|dōgen	<i>verb</i><br><ol><li>to be useful, to be appropriate</li><li>to perform well (in its purpose)</li><li>(of food) to keep for a long time</li></ol>
dom	<i>adj</i><br><ol><li>dumb, unwise, stupid</li></ol>
donre|dunre	<i>noun</i><br><ol><li>thunder</li></ol>
doof|dôof	<i>adj</i><br><ol><li>deaf</li><li>without feeling, harsh</li><li>crazy, foolish</li><li>useless</li><li>dull, not shining</li><li>dull, not giving sound</li><li>dead, having died off, dry (of plants)</li></ol>
doot|dôder|dôots|dôot|dôde|dôden	<i>adj</i><br><ol><li>dead</li><li>lifeless</li><li>invalid, void</li></ol><br><i>noun</i><br><ol><li>death</li><li>death penalty</li></ol>
dordrecht	<i>noun</i><br><ol><li>Dordrecht (a city in the modern Netherlands)</li></ol>
dore|dôre|dor|duere|dōre	<i>prep</i><br><ol><li>through</li><li>by, through the action of</li><li>because of</li><li>within (a time)</li></ol><br><i>adv</i><br><ol><li>through</li><li>very, thoroughly</li><li>throughout (a space, time)</li></ol><br><i>noun</i><br><ol><li>door</li><li>fool</li></ol>
dorn|doren|dōren	<i>noun</i><br><ol><li>thorn</li><li>thornbush</li></ol>
dorpere|dorpre|dorperen|dorpren	<i>noun</i><br><ol><li>villager</li><li>unsophisticated person</li></ol>
dorren|dorste	<i>verb</i><br><ol><li>to dare, to have the courage to</li><li>to be allowed to</li></ol>
dorst	<i>noun</i><br><ol><li>thirst</li><li>longing</li></ol>
dorven	<i>verb</i><br><ol><li>(impersonal) to be required [+dative = person]</li><li>(intransitive) to need, to require [+genitive]</li></ol>
douwen|douwende|douwene|dous|dôyen|doyen|douwes|dout|douwe|douwet|dou|douwens	<i>verb</i><br><ol><li>to die off, to die out</li></ol>
doyen|dôyen	<i>verb</i><br><ol><li>to thaw, to melt</li></ol>
dracht	<i>noun</i><br><ol><li>act of carrying</li><li>what is carried, load, freight</li><li>things brought to fill or raise ground (in e.g. a defence)</li><li>pregnancy</li><li>progeny, young, child</li><li>move (in a game)</li><li>while, time</li><li>clothes worn</li></ol>
draet|drâet	<i>noun</i><br><ol><li>thread</li></ol>
draf	<i>noun</i><br><ol><li>animal food</li><li>dregs</li><li>trot (of horses)</li></ol>
dragen|drāges|droechs|drouch|drāech|droech|drāecht|droecht|drāget|droeget|drāgene|drāgen|droeges|drach|drāge|drāechs|droege|drāgende|draghen|drāgens|droughen|gedrāgen|droegen	<i>verb</i><br><ol><li>to carry</li><li>to wear</li></ol>
drake|drāke	<i>noun</i><br><ol><li>dragon, wyrm</li></ol>
draven|drāven	<i>verb</i><br><ol><li>to trot, to move at a steady pace</li></ol>
drayen|drâyen	<i>verb</i><br><ol><li>to turn, to rotate</li></ol>
dreigen|dreigens|dreige|dreichs|dreich|dreiget|dreiges|dreicht|dreigene|dreigende	<i>verb</i><br><ol><li>to threaten, to intimidate</li><li>to warn</li></ol>
drepen|drēpen	<i>verb</i><br><ol><li>(rare) to hit (not miss), to strike</li></ol>
dri	<i>num</i><br><ol><li>(Brabant) Alternative form of drie</li></ol>
drie	<i>num</i><br><ol><li>three</li></ol>
drieconingendach|driecōningendach	<i>noun</i><br><ol><li>Epiphany</li></ol>
driegen|driegens|driegende|driegene|drōge|drieget|drōget|drōgen|driege|drōges|drôoch|drōochs|driecht|gedrōgen|drieges|driech|drōocht|driechs	<i>verb</i><br><ol><li>to deceive</li><li>to sew, to stitch</li></ol>
dringen|drinc|dronges|dringens|drincs|droncs|dringet|dronct|dringende|dranc|dringe|drongen|dronget|dronge|drinct|dringes|gedrongen|dringene	<i>verb</i><br><ol><li>to press, to push</li><li>to force one's way</li><li>to pressure, to bother</li><li>to extort</li></ol>
drinken|drinket|drinc|drincs|droncs|drinke|dronken|dronkes|dronct|dronke|gedronken|drinkens|dranc|drinkende|drinkes|drinct|drinkene|dronket	<i>verb</i><br><ol><li>to drink</li></ol>
driten|drijts|drēets|drēten|drites|drēet|dritens|drêet|drētes|dritene|drijt|drēte|drite|drētet|dritende|dritet|gedrēten	<i>verb</i><br><ol><li>to defecate</li></ol>
driven|drēeft|drives|drēve|drivet|drive|drēefs|drivene|drijfs|drêef|drijf|drivende|gedrēven|drivens|drēvet|drijft|drēves|drēven	<i>verb</i><br><ol><li>to drive, to push (forward)</li><li>to drive (to do something)</li><li>to do, to perform</li><li>to float</li></ol>
droeven|droeft|droevens|droevene|droefs|droevende|droeves|droevet|droeve|droef	<i>verb</i><br><ol><li>to be sad, to mourn</li></ol>
droge|drôge	<i>adj</i><br><ol><li>dry</li><li>plain, bare, without anything else</li><li>dry, unfriendly (of a person)</li><li>died off, lame, unusable (of severely diseased limbs)</li></ol>
drogen|drôgene|drôget|drôochs|drôgens|drôges|drôocht|drôoch|drôgende|drôge|drôgen	<i>verb</i><br><ol><li>to dry, to make/become dry</li></ol>
dromen|drôme|drôoms|drôomt|drômet|drômende|drômens|drômene|drômes|drôom|drômen	<i>verb</i><br><ol><li>to dream</li></ol>
droom|drôom	<i>noun</i><br><ol><li>dream</li><li>something incredible, wondrous</li><li>falsehood</li></ol>
dropel|drōpel	<i>noun</i><br><ol><li>drop</li></ol>
drucken|druct|druckes|druckende|drucket|drucke|druckens|drucs|druckene|druc	<i>verb</i><br><ol><li>to press</li></ol>
du|mijns|ju|sie|si|dijns|het|ghi|di|gi|haer|se|hij|it|es|dijn|ons|ic|hen|mijn|mi|wi|sijn|du|hit|u|hi|onse|uwe|hem|zi|et	<i>pron</i><br><ol><li>thou, you (singular, informal)</li></ol>
duken|gedōken|duuct|dōocs|dōoct|duucs|dukens|dukene|dukes|dôoc|dōket|dōkes|dōken|duket|dukende|duke|dōke|duuc	<i>verb</i><br><ol><li>to dive (go under water)</li><li>to dive, to leap</li><li>to duck</li><li>to hide oneself</li></ol>
dunken|dunct|duncs|dunkene|dunc|dinken|dunket|dunkens|dunkes|dunke|dunkende	<i>verb</i><br><ol><li>to deem, to judge</li><li>to seem</li></ol>
duren|durene|duurt|duurs|durens|dure|durende|dures|duur|duret	<i>verb</i><br><ol><li>to continue, to persist</li><li>to keep (in good condition)</li><li>to be durable</li><li>to continue, to stretch out</li><li>to stay, to reside</li><li>to endure, to hold out</li><li>to wait</li></ol>
dus	<i>adv</i><br><ol><li>thus, in this way</li><li>therefore</li></ol>
dusent	<i>num</i><br><ol><li>thousand</li></ol>
duve	<i>noun</i><br><ol><li>pigeon, dove</li></ol>
duvel	<i>noun</i><br><ol><li>devil, demon</li><li>Devil, Satan</li></ol>
dwaen|dwâen	<i>verb</i><br><ol><li>to wash, to clean</li><li>to rinse</li></ol>
dwale|dwâle	<i>noun</i><br><ol><li>cloth</li><li>towel</li></ol>
dwellen|dwels|dwel|dwellet|dwelle|dwellene|dwelles|dwelt|dwellens|dwellende	<i>verb</i><br><ol><li>to make stray, to put on the wrong track</li><li>to torment</li></ol>
dwinen|dwijnt|gedwēnen|dwinene|dwēnen|dwēnet|dwine|dwinens|dwines|dwēens|dwēne|dwijns|dwēnes|dwijn|dwinende|dwinet|dwēent|dwêen	<i>verb</i><br><ol><li>to dwindle, to decline in number or size</li><li>to decrease</li><li>to disappear</li></ol>
dwingen|dwinges|dwingens|dwongen|dwonget|dwincs|dwonges|dwonge|dwinget|gedwongen|dwingene|dwanc|dwinct|dwinc|dwinge|dwoncs|dwingende|dwonct	<i>verb</i><br><ol><li>to press tight, to squeeze, to pinch</li><li>to hurt, to torment</li><li>to pressure (mentally)</li><li>to subdue, to impose one's will on, to have under one's control</li><li>to force, to compel</li></ol>
ebbe	<i>noun</i><br><ol><li>ebb, low tide</li></ol>
edel|ēdel	<i>adj</i><br><ol><li>noble, of high birth</li><li>excellent, distinguished</li><li>morally noble, righteous</li></ol>
edelen|ēdelet|ēdele|ēdelens|ēdelene|ēdelen|ēdeles|ēdel|ēdelende|ēdelt|ēdels	<i>verb</i><br><ol><li>to ennoble</li><li>to legitimate</li></ol>
edelheit|ēdelheit	<i>noun</i><br><ol><li>nobility, nobleness</li><li>generosity</li><li>excellency</li></ol>
edic|ēdic	<i>noun</i><br><ol><li>vinegar</li></ol>
een|êen	<i>article</i><br><ol><li>a (indefinite article)</li><li>a certain (before people's names)</li></ol><br><i>num</i><br><ol><li>one</li></ol><br><i>pron</i><br><ol><li>one, someone, a certain person</li><li>something</li><li>one (indefinite)</li></ol>
eencoren|êencōren	<i>noun</i><br><ol><li>squirrel, red squirrel</li></ol>
eenvoudich|êenvoudich	<i>adj</i><br><ol><li>simple, uncomplicated</li><li>simple-minded, innocent</li></ol>
eenvout|êenvout	<i>adj</i><br><ol><li>onefold, simple</li><li>plain</li></ol>
eer|êre|ere|êer	<i>adv</i><br><ol><li>earlier, previously</li><li>formerly</li><li>first, beforehand</li></ol><br><i>conj</i><br><ol><li>ere, before</li></ol><br><i>prep</i><br><ol><li>before</li></ol>
eerst|êerst	<i>adj</i><br><ol><li>first</li><li>foremost</li></ol><br><i>adv</i><br><ol><li>first, firstly</li><li>formerly, previously</li><li>at first, before all else</li></ol>
ei	<i>noun</i><br><ol><li>egg</li></ol>
eigen	<i>verb</i><br><ol><li>to receive</li><li>to be required to have, to be owed</li><li>(auxiliary, with te) must, to be obliged to</li></ol><br><i>adj</i><br><ol><li>subordinate, in servitude</li><li>owned, belonging (to someone else)</li><li>own, of oneself, proper</li></ol>
eike	<i>noun</i><br><ol><li>oak</li></ol>
eischen	<i>verb</i><br><ol><li>to ask, to request</li><li>to demand</li><li>to require</li></ol>
el	<i>det</i><br><ol><li>other, another</li></ol><br><i>adv</i><br><ol><li>else, otherwise</li><li>elsewhere</li></ol>
els	<i>adv</i><br><ol><li>elsewhere</li></ol>
emmer|immer	<i>adv</i><br><ol><li>always</li><li>at least, in any case</li><li>at all costs</li><li>ever</li></ol>
ende|en	<i>conj</i><br><ol><li>and</li></ol><br><i>noun</i><br><ol><li>end</li></ol>
enden|ent|endet|ents|endens|geënt|endende|ende|endene|geent|endes|ghehent	<i>verb</i><br><ol><li>to end, to make end</li><li>to end, to come to an end</li></ol>
engel	<i>noun</i><br><ol><li>angel, servant of God</li><li>fallen angel</li></ol>
engelant	<i>noun</i><br><ol><li>England (a kingdom)</li></ol>
enich|ênich|eenich	<i>det</i><br><ol><li>any</li><li>a bit of</li><li>whichever</li></ol><br><i>pron</i><br><ol><li>anyone, whoever</li><li>anything, whichever</li></ol><br><i>adj</i><br><ol><li>unique</li><li>special</li><li>lonely</li></ol>
enigen|ênigen	<i>verb</i><br><ol><li>to unite, to make/become one</li></ol>
enten|ente|ent|geënt|ents|entende|entene|entens|entes|entet|geent|ghehent	<i>verb</i><br><ol><li>(transitive) to graft</li></ol><br><i>abbrev</i><br><ol><li>Contraction of ende den.</li></ol>
entie	<i>abbrev</i><br><ol><li>Contraction of ende die.</li></ol>
erde|āerden|eerde|erden|aerde|āerde|ēerde|ēerden	<i>noun</i><br><ol><li>the Earth</li><li>soil, ground</li></ol>
ere|êre|eere	<i>noun</i><br><ol><li>glory, fame</li><li>honour, respect</li><li>worship</li><li>decency, etiquette</li></ol>
eren|êrens|êrene|êers|ērene|ērende|ērens|êret|eeren|êre|êert|ēers|êren|ēer|êres|êer|êrende|ēren|ēres|ēret|ēert|ēre	<i>verb</i><br><ol><li>to honour, to dignify</li><li>to worship</li><li>to plough</li></ol>
ernst	<i>noun</i><br><ol><li>combativeness</li><li>eagerness, zeal</li><li>seriousness</li></ol>
errisen	<i>verb</i><br><ol><li>to arise, to raise oneself</li></ol>
erve	<i>noun</i><br><ol><li>heritage, patrimony</li><li>real estate, unmovable property (i.e. land and house), which belongs to oneself and can be inherited</li><li>land, property</li></ol>
erven|erve|erft|ervens|erf|ervene|ervende|ervet|erfs|erves	<i>verb</i><br><ol><li>to bequeath</li><li>to grant, to assign (ownership of)</li><li>to grant a place/parcel to, to take in</li><li>to inherit</li><li>to be inherited, to be granted through inheritance</li><li>to be in charge, act as an owner</li></ol>
erwete	<i>noun</i><br><ol><li>pea</li></ol>
esel|ēsel	<i>noun</i><br><ol><li>donkey</li><li>fool, idiot</li></ol>
eten|ēten	<i>verb</i><br><ol><li>to eat</li></ol>
even|ēven	<i>adj</i><br><ol><li>even, equal</li></ol><br><i>adv</i><br><ol><li>just as, equally</li></ol>
evenkerstin	<i>noun</i><br><ol><li>fellow Christian</li></ol>
ewe|êwe	<i>noun</i><br><ol><li>era</li><li>eternity</li><li>moral law</li><li>nature</li></ol>
feeste|fêeste	<i>noun</i><br><ol><li>feast, holiday</li><li>happiness, amusement</li><li>loud show of joy, noise, commotion</li></ol>
fel|fellen|felle	<i>adj</i><br><ol><li>cruel, harsh</li><li>evil</li><li>terrible</li><li>dangerous</li></ol>
fransois|francsoys	<i>noun</i><br><ol><li>French language</li></ol>
gaderen|gāderen	<i>verb</i><br><ol><li>to gather, to bring/come together</li><li>to gather, to collect</li></ol>
gaen|ghinc|gaet|ginges|ginget|gegâen|gâ|gâet|ghegaen|gaes|gingen|gâen|ginc|ginge|ghinghen|gegaen|ga|gaende|gings	<i>verb</i><br><ol><li>to go</li></ol>
gaet|gâet	<i>abbrev</i><br><ol><li>Contraction of gâet het.</li></ol>
gay	<i>adj</i><br><ol><li>cheerful, happy</li></ol><br><i>noun</i><br><ol><li>jay</li><li>parrot</li></ol>
gebruken	<i>verb</i><br><ol><li>to enjoy</li><li>to have free use of, to have at one's disposal, to reap all the rewards of</li><li>to use</li></ol>
gebueren	<i>verb</i><br><ol><li>to happen, to take place</li><li>to happen, to befall [+dative = to]</li><li>to belong, to be due [+dative = to]</li><li>to belong, to fit</li></ol>
gebuur	<i>noun</i><br><ol><li>neighbour, someone who lives nearby</li><li>fellow citizen</li></ol>
gedoen|ghedede|gedede|gedēde	<i>verb</i><br><ol><li>to do, to carry out</li><li>(auxiliary) to cause, to make</li></ol>
geer|gêer	<i>noun</i><br><ol><li>spear</li></ol>
gelden	<i>verb</i><br><ol><li>to pay, to satisfy (a payment)</li><li>to buy</li><li>to compensate, to give recompense</li><li>to yield, to produce</li><li>(of a promise) to keep, to come through on</li></ol>
gelede|gheleede|gelêde	<i>noun</i><br><ol><li>(Flemish) Alternative form of geleide</li></ol>
geleide	<i>noun</i><br><ol><li>lead, leadership</li><li>leader</li><li>escort, entourage</li></ol>
geliken|liken	<i>verb</i><br><ol><li>(with dative) to appear similar to</li><li>(with dative) to compare to</li></ol>
gelingen	<i>verb</i><br><ol><li>to succeed</li><li>to happen to befall</li><li>to be pleasing, to be satisfying</li></ol>
gellen	<i>verb</i><br><ol><li>to yell, scream</li></ol>
geloven|gelôven	<i>verb</i><br><ol><li>to promise</li><li>to trust</li><li>to believe</li></ol>
gelre	<i>noun</i><br><ol><li>Geldern (a city in modern Germany)</li><li>Guelders (a duchy and county)</li></ol>
genade|genâde|ghenade	<i>noun</i><br><ol><li>favour</li><li>help, support</li><li>mercy</li><li>forgiveness</li><li>pity</li><li>permission</li></ol>
gene|ghene|gêne	<i>det</i><br><ol><li>that over there, yonder</li></ol>
genemen|genēmen	<i>verb</i><br><ol><li>to take</li><li>to accept, to receive</li></ol>
genesen|genēsen|ghenesen	<i>verb</i><br><ol><li>to survive (lethal danger)</li><li>to save (from death)</li><li>to get better, to heal, to recover (from a disease)</li><li>to heal, to cure, to rid of disease</li></ol>
genieten	<i>verb</i><br><ol><li>to eat, to consume</li><li>to withstand, to endure [+genitive]</li><li>to profit from, to enjoy the benefit of [+genitive]</li></ol>
gent|ghent	<i>noun</i><br><ol><li>Ghent (a city in modern Belgium)</li></ol>
gerne|gherne	<i>adv</i><br><ol><li>with pleasure, gladly, willingly</li><li>usually, often</li></ol>
geschien|ghesciet|geschiet	<i>verb</i><br><ol><li>to happen, to occur, to take place</li></ol>
geschriven|geschreef|geschreeft|geschrēeft|ghescreeft|geschrêef	<i>verb</i><br><ol><li>to write down</li><li>to describe in detail</li></ol>
gest	<i>noun</i><br><ol><li>yeast</li></ol>
gestille|ghestille	<i>noun</i><br><ol><li>silence, calmth</li></ol>
gevadere|ghevadere|gevādere	<i>noun</i><br><ol><li>godfather</li></ol>
geval|gheval	<i>noun</i><br><ol><li>fate</li><li>fortune, luck</li><li>event, occurrence</li><li>case</li></ol>
gevallen|gheviel|geviel	<i>verb</i><br><ol><li>to fall</li><li>to decay, to collapse</li><li>to end, to expire</li><li>to happen, to befall</li><li>to please, to satisfy</li></ol>
geven|ghevet|gâven|gēves|gēvende|gēvene|gâefs|gâve|gēeft|gēvet|gegēven|gheven|gēefs|gef|gaf|gēve|gâvet|gēef|gâeft|gēven|gâves|gēvens	<i>verb</i><br><ol><li>to give</li></ol>
gewagen|gewāgen	<i>verb</i><br><ol><li>to tell, to report, to say</li></ol>
gewinnen|ghewinnen|ghewonnen|ghewan|gewinnet|gewinnes|gewinnende|gewont|gewinne|gewonnes|gewonnen|gewan|gewins|gewonnet|gewons|gewin|gewint|gewonne|gewinnene|gewinnens	<i>verb</i><br><ol><li>to win, obtain, acquire</li></ol>
gewreken|gewrēken	<i>verb</i><br><ol><li>to avenge, to take vengeance for</li></ol>
ghesciet	<i>verb</i><br><ol><li>third-person singular present indicative</li><li>second-person plural present indicative/subjunctive</li><li>plural imperative</li></ol>
ghescreeft	<i>abbrev</i><br><ol><li>Contraction of geschrêef het.</li></ol>
ghevet	<i>verb</i><br><ol><li>third-person singular present indicative</li><li>second-person plural present indicative/subjunctive</li><li>plural imperative</li></ol>
ghighe	<i>noun</i><br><ol><li>fiddle</li></ol>
gi|mijns|ju|sie|si|dijns|het|ghi|di|gi|haer|se|hij|it|es|dijn|ons|ic|hen|mijn|mi|wi|sijn|du|hit|u|hi|onse|uwe|hem|zi|et	<i>pron</i><br><ol><li>you (nominative, plural)</li><li>you (nominative, singular, informal)</li></ol>
gien	<i>verb</i><br><ol><li>to declare</li><li>to admit, to acknowledge</li></ol>
gieten|gōten|giets|gôot|gōots|gietes|gōtet|gietens|giete|gōtes|gietende|giet|gōte|gegōten|gietene|gietet|gōot	<i>verb</i><br><ol><li>(transitive) to pour</li><li>(intransitive) to flow, to stream</li></ol>
gifte	<i>noun</i><br><ol><li>gift, present</li><li>gift, talent</li></ol>
gisteren|ghistren|gistren	<i>adv</i><br><ol><li>yesterday</li></ol>
glas	<i>noun</i><br><ol><li>glass (substance)</li></ol>
gliden|glidens|glidende|glēdes|glēde|geglēden|glide|glēets|glijt|glidene|glijts|glēden|glēet|glidet|glēdet|glêet|glides	<i>verb</i><br><ol><li>to slide, to slip</li></ol>
glimmen|glam|glomt|gloms|glim|glimme|glimmet|glimmes|glomme|glimmene|glims|geglommen|glommen|glommes|glommet|glimt|glimmens|glimmende	<i>verb</i><br><ol><li>to shine, to shimmer</li></ol>
gloeyen	<i>verb</i><br><ol><li>to glow</li></ol>
goet|best|goede|goets|bēter|goeder|goeden|beste|beter	<i>adj</i><br><ol><li>good</li></ol>
gomen|gôomt|gôoms|gôom|gômene|gômes|gômens|gôme|gômet|gômende|gômen	<i>verb</i><br><ol><li>to observe closely</li><li>to care for</li><li>to take care of</li><li>to arrange</li></ol>
gonnen|jonnen	<i>verb</i><br><ol><li>to allow</li><li>to grant, to allow to have, to be eager to see having or receiving</li></ol>
got|god	<i>noun</i><br><ol><li>god</li><li>the Christian God</li></ol>
gout	<i>noun</i><br><ol><li>gold</li></ol>
gracht	<i>noun</i><br><ol><li>(neuter) grave</li><li>ditch, canal, dug watercourse</li><li>groove</li></ol>
gram	<i>adj</i><br><ol><li>angry</li><li>sad, upset</li></ol>
gras|gers	<i>noun</i><br><ol><li>grass</li></ol>
graven|grāven|groeve|grāves|groevet|groef|gegrāven|groeven|grāvene|groefs|groeves|grāvens|grāeft|grāefs|grāvende|grāef|groeft|grāvet|grāve|graf	<i>verb</i><br><ol><li>To dig.</li><li>To bury.</li></ol>
grijs|grijsen|grisen	<i>adj</i><br><ol><li>grey (generally of hair)</li></ol>
grijsen	<i>adj</i><br><ol><li>masculine accusative/dative singular</li><li>neuter dative singular</li><li>dative plural</li></ol>
grimmen|grimmens|grimme|grimmes|grimmet|grimmene|grimmende|grims|grim|grimt	<i>verb</i><br><ol><li>to be angry, to rage</li><li>to growl, to snarl</li><li>to grin or smile (at something not humorous, or to hide displeasure)</li></ol>
grinen|grinet|grēne|grijn|grēent|grinens|grēnes|grēnet|grēens|grinende|grijnt|grijns|grine|grines|grêen|grinene|grēnen|gegrēnen	<i>verb</i><br><ol><li>to grin</li><li>to grimace</li><li>to cry, to weep</li><li>to grunt (of a pig or other animal)</li></ol>
gripen|grêep|gripende|grēpes|grēpe|gripes|gegrēpen|gripens|grijp|gripe|grijpt|grijps|grēept|grēpet|grēeps|grēpen|gripet|gripene	<i>verb</i><br><ol><li>to grab</li><li>to attack, to overwhelm</li><li>to understand</li></ol>
groene|groener|groenen|groens	<i>adj</i><br><ol><li>green</li><li>(figuratively) unripe, young</li></ol>
groete	<i>adj</i><br><ol><li>masculine nominative singular</li><li>feminine/neuter nominative/accusative singular</li><li>nominative/accusative plural</li></ol>
groeten|groets|groetet|groet|groetende|groetene|groetens|groetes|groete	<i>verb</i><br><ol><li>to greet</li><li>(possibly ironic) to attack</li></ol><br><i>adj</i><br><ol><li>masculine accusative/dative singular</li><li>neuter dative singular</li><li>dative plural</li></ol>
groeyen	<i>verb</i><br><ol><li>to become/be green, to grow</li><li>to increase</li></ol>
grof	<i>adj</i><br><ol><li>thick</li><li>large, great</li><li>course, rough</li></ol>
grommen|grom|gromt|groms|grommet|gromme|grommende|grommes|grommene|grommens	<i>verb</i><br><ol><li>to growl</li></ol>
gronjaert|gronjāert	<i>noun</i><br><ol><li>grumbler, grognard</li></ol>
gront	<i>noun</i><br><ol><li>ground</li><li>bottom</li><li>detail, everything particular about something (as in "to get to the bottom of")</li><li>spirit, character, the foundation of someone's being</li></ol>
groot|grôte|grôten|grôter|groeter|grôots|grôot|groeten|groet|groete	<i>adj</i><br><ol><li>big, large</li><li>tall</li><li>adult</li><li>important, great</li></ol><br><i>adv</i><br><ol><li>greatly, very</li></ol>
grote|grôte	<i>noun</i><br><ol><li>size</li></ol>
hacken|hackene|hackens|hackes|hacs|hacke|hact|hacket|hackende|hac	<i>verb</i><br><ol><li>to hack, to chop</li><li>to delve, to dig</li></ol>
hadder	<i>abbrev</i><br><ol><li>Contraction of hadde dāer.</li></ol>
hads	<i>abbrev</i><br><ol><li>Contraction of hadde es.</li></ol>
hadse	<i>abbrev</i><br><ol><li>Contraction of hadde se.</li></ol>
haer|hāer|hâer	<i>det</i><br><ol><li>her</li></ol><br><i>noun</i><br><ol><li>hair</li></ol>
haerlem|hāerlem	<i>noun</i><br><ol><li>Haarlem (a city in the modern Netherlands)</li></ol>
hage|haghe|hāge	<i>noun</i><br><ol><li>hedge, bush</li></ol>
hagedorn|hāgedorn	<i>noun</i><br><ol><li>hawthorn</li></ol>
hagel|hāgel	<i>noun</i><br><ol><li>hail (frozen rain)</li><li>hail storm</li></ol>
hake|hāke|hâke	<i>noun</i><br><ol><li>hook</li></ol>
hals	<i>noun</i><br><ol><li>neck</li></ol>
hamer|hāmer	<i>noun</i><br><ol><li>A hammer.</li></ol>
handelen	<i>verb</i><br><ol><li>to handle (take in the hand)</li><li>to act, to carry out</li><li>to handle, to treat (a subject)</li><li>to treat, to behave towards</li></ol>
hangen|hinge|hinghe|hinc	<i>verb</i><br><ol><li>to hang (up)</li><li>to hang, to be hanging</li><li>to hang (on gallows)</li><li>to be hanged (on gallows)</li></ol>
hant	<i>noun</i><br><ol><li>hand</li><li>person</li><li>side</li></ol>
hanthave|hanthāve	<i>noun</i><br><ol><li>(late) handle</li></ol>
harde|haerde|hāerde	<i>adv</i><br><ol><li>strongly</li><li>very, a great deal</li></ol>
harinc|hârinc	<i>noun</i><br><ol><li>herring</li></ol>
harpe	<i>noun</i><br><ol><li>harp, lyre</li></ol>
hart	<i>adj</i><br><ol><li>hard (not soft)</li><li>solid, sturdy</li><li>hard, harsh, cruel</li></ol>
hase|hāse	<i>noun</i><br><ol><li>hare</li></ol>
hebben|heeft|hēeft|hēvet|hebt|haddet|hadden|hadde|hebbe|hevet	<i>verb</i><br><ol><li>to have</li></ol>
hebdi	<i>abbrev</i><br><ol><li>Contraction of hebt gi.</li></ol>
hechten|hechtene|hechte|hechtes|hechtende|hechts|hechtet|hechtens|hecht	<i>verb</i><br><ol><li>to attach, to bind</li><li>to incarcerate</li></ol>
heel|hêel	<i>adj</i><br><ol><li>whole, full</li><li>undamaged, unbroken</li><li>healthy, healed</li><li>honest, sincere, pure</li></ol>
heem|hêem	<i>noun</i><br><ol><li>home place</li></ol>
heerschen|hêerschens|hêersche|hêerschet|hêersch|hêerschene|hêerschen|hêerschs|hêersches|hêerschende|hêerscht	<i>verb</i><br><ol><li>(late) to command, to rule</li></ol>
heet|hêet	<i>adj</i><br><ol><li>hot</li><li>passionate</li></ol>
heffen	<i>verb</i><br><ol><li>to lift, to raise</li><li>to begin (of a letter)</li><li>to collect, to receive (money)</li></ol>
heilich	<i>adj</i><br><ol><li>holy, sacred</li></ol>
heilige	<i>noun</i><br><ol><li>saint</li><li>(in the plural) relic, figure of a saint</li></ol>
hekelen|hēkelen	<i>verb</i><br><ol><li>to prickle, to irritate</li></ol>
helden|helt|heldens|helts|heldende|heldet|helde|heldes|heldene	<i>verb</i><br><ol><li>to incline, to lean</li></ol>
helen|hêlet|hêelt|hêel|hêles|hêle|hêlen|hêlene|hêels|hēlen|hêlens|hêlende	<i>verb</i><br><ol><li>to hide, to conceal, to keep secret, to keep quiet</li><li>to heal, to make better</li><li>to fix, to mend, to repair</li><li>to make whole</li></ol>
helige|hêlige|heleghe	<i>noun</i><br><ol><li>(Flemish) Alternative form of heilige</li></ol>
helle|hellen	<i>noun</i><br><ol><li>Hell</li><li>underworld</li></ol>
hellen|helt|helle|hellene|hel|helles|hels|hellende|hellens|hellet	<i>verb</i><br><ol><li>to sound, resound</li></ol>
helpe|hulpen|hulpe	<i>noun</i><br><ol><li>help, assistance</li><li>help, helper</li></ol>
helpen|helpende|holps|helpt|helpe|halp|helps|helpes|helpet|helpens|holpes|holpt|holpet|holpe|geholpen|holpen|helpene|help	<i>verb</i><br><ol><li>to help, to aid, to assist</li><li>to be helpful, to be beneficial</li></ol>
helsen|helsende|helst|helsene|helsens|helse|hels|helses|helset	<i>verb</i><br><ol><li>to hug, to embrace</li></ol>
hemel|hēmel	<i>noun</i><br><ol><li>heaven, sky</li><li>Heaven</li></ol>
henegouwen|hênegouwen	<i>noun</i><br><ol><li>Hainaut (a county)</li></ol>
henne	<i>noun</i><br><ol><li>hen, chicken</li></ol>
here|heere|hēre|hêre	<i>noun</i><br><ol><li>lord, high-ranked person</li><li>God, the Lord</li><li>ruler</li><li>leader</li><li>gentleman (respectful title for a male)</li><li>army, band of troops</li></ol>
hert	<i>noun</i><br><ol><li>deer</li><li>hearth, fireplace</li></ol>
herte|harte	<i>noun</i><br><ol><li>heart</li><li>heart as seat of emotion</li><li>heart, middle</li></ol>
het|mijns|ju|sie|si|dijns|het|ghi|di|gi|haer|se|it|hij|es|dijn|ons|ic|hen|mijn|mi|wi|sijn|du|hit|u|hi|onse|uwe|hem|zi|et	<i>pron</i><br><ol><li>it</li></ol>
heten|hieten|hêets|hêtes|hête|gehêten|hêten|hiet|hêtens|hietes|hêtende|hietet|hêtet|hiets|hêet|hiete|heeten|hêtene	<i>verb</i><br><ol><li>to proclaim, to declare</li><li>to call (use the voice)</li><li>to call, to name</li><li>to be called, to have as name</li><li>to command, to order</li></ol>
hets	<i>abbrev</i><br><ol><li>Contraction of het is.</li></ol>
hi|mijns|ju|sie|si|dijns|het|ghi|di|gi|haer|se|hij|it|es|dijn|ons|ic|hen|mijn|mi|wi|sijn|du|hit|u|hi|onse|uwe|hem|zi|et	<i>pron</i><br><ol><li>he</li></ol>
hier	<i>adv</i><br><ol><li>here, in this place</li><li>to here, hither</li><li>now, at this time</li></ol>
hijs	<i>abbrev</i><br><ol><li>Contraction of hi es.</li></ol>
hine	<i>abbrev</i><br><ol><li>Contraction of hi ne.</li></ol>
hinken|hinkes|hinke|hinc|hinct|hinkene|hinket|hincs|hinkende|hinkens	<i>verb</i><br><ol><li>to limp, to hobble (walk with difficulty due to injury)</li></ol>
hinne|hinnen	<i>noun</i><br><ol><li>(Flemish) Alternative form of henne</li></ol>
hire	<i>abbrev</i><br><ol><li>Contraction of hi dāer.</li></ol>
hise	<i>abbrev</i><br><ol><li>Contraction of hi se.</li></ol>
historie|histōrien|histōrie	<i>noun</i><br><ol><li>history</li><li>account, story</li></ol>
hoe	<i>adv</i><br><ol><li>how, in what way/manner</li><li>how, to what degree</li></ol>
hoendi	<i>abbrev</i><br><ol><li>Contraction of hôonde hi.</li></ol>
hoerdic	<i>abbrev</i><br><ol><li>Contraction of hôorde ic.</li></ol>
hoere	<i>noun</i><br><ol><li>whore, prostitute</li></ol>
hoert	<i>verb</i><br><ol><li>third-person singular present indicative</li><li>second-person plural present indicative/subjunctive</li><li>plural imperative</li></ol>
hoet	<i>abbrev</i><br><ol><li>Contraction of hoe dat.</li><li>Contraction of hoe het.</li></ol>
hof|hoven|hove|hoves|hōve	<i>noun</i><br><ol><li>court, enclosed space</li><li>garden</li><li>farmstead</li><li>castle (court of the nobility)</li></ol>
hollant	<i>noun</i><br><ol><li>Holland (a county)</li></ol>
hondert	<i>num</i><br><ol><li>hundred</li></ol>
honen|hônes|hôont|hône|hôon|hôons|hônende|hônet|hoenen|hônens|hônen|hônene	<i>verb</i><br><ol><li>to mistreat, to harm, to dishonour</li><li>to deceive, to mislead</li></ol>
honger	<i>noun</i><br><ol><li>hunger</li><li>famine</li></ol>
hont|hondekijn|hondekin	<i>noun</i><br><ol><li>dog</li><li>(derogatory) despicable, worthless person</li><li>an area of 100 square rods, approximately 0.14 hectares or 1400 m²</li></ol>
hoop|hôop	<i>noun</i><br><ol><li>heap, pile</li><li>group of people or animals, troop, herd</li><li>meeting</li></ol>
hopen|hôop|hōpes|hōpet|hōpens|hōops|hôpes|hôpen|hôpens|hōpen|hōpende|hôpe|hōopt|hōpe|hôopt|hôpende|hôpet|hôops|hōpene|hôpene|hōop	<i>verb</i><br><ol><li>To hope</li><li>To expect.</li><li>To heap, to pile up in a heap.</li></ol>
horen|hôort|hôrene|hôres|hôret|hoert|hôrende|hôre|hôor|hôors|hôrens|hôren	<i>verb</i><br><ol><li>to hear (perceive audibly)</li><li>to hear, to learn of (audibly or otherwise)</li><li>to listen</li><li>to listen to, to obey</li><li>to belong to</li><li>to be subservient to</li><li>to be part of</li><li>to be necessary for</li></ol>
horich|hôrich	<i>adj</i><br><ol><li>obedient, subservient</li><li>subject, under the power of another</li></ol>
houden|hieldet|hout|houdende|hielden|hielts|houdene|hieldes|gehouden|houdet|hielt|hielde|houdes|houts|houdens|houde	<i>verb</i><br><ol><li>to hold</li><li>to keep</li></ol><br><i>adj</i><br><ol><li>masculine accusative/dative singular</li><li>neuter dative singular</li><li>dative plural</li></ol>
hout	<i>noun</i><br><ol><li>wood (material of trees)</li><li>piece of wood; branch, stick, beam</li><li>tree</li><li>wood, forest</li></ol><br><i>adj</i><br><ol><li>lame, crippled, halt</li></ol>
houwen|hiewet|hous|hout|gehouwen|hieu|houwende|hieus|hiewen|houwens|houwene|houwet|hieut|houwe|hiewes|hou|houwes|hiewe	<i>verb</i><br><ol><li>to chop, to hew</li><li>to chop down, to fell</li><li>to chop into pieces</li><li>to slash</li></ol>
hovesch|hōvesch	<i>adj</i><br><ol><li>courtly</li></ol>
hoveschelijc|hōveschelijc	<i>adj</i><br><ol><li>courteous, civilised, well-mannered</li></ol>
hoveschelike|hoofschelike|hōofschelike|hōveschelike	<i>adv</i><br><ol><li>courteously, civilisedly, well-manneredly</li></ol>
hoveschheit|hōveschheit	<i>noun</i><br><ol><li>courtliness, way of acting in a noble court</li></ol>
hovesscheden	<i>noun</i><br><ol><li>genitive/dative singular</li><li>dative plural</li></ol>
hovet|hôoft|hooft|hôvet|hoeft	<i>noun</i><br><ol><li>head</li></ol>
hovetstat|hôvetstat	<i>noun</i><br><ol><li>the most prominent town or city in a region</li></ol>
hulen|hulet|hules|huul|hulene|huult|hule|huuls|hulens|hulende	<i>verb</i><br><ol><li>to cry, to weep</li><li>to howl, to screech, to whine (of animals)</li></ol>
hullen|hullene|hullens|hult|hulles|hullet|hul|huls|hulle|hullende	<i>verb</i><br><ol><li>to cover, to wrap</li></ol>
huren|huret|hurene|huurs|huur|hurens|hures|huurt|hurende|hure	<i>verb</i><br><ol><li>to rent</li><li>to hire</li></ol>
huus|husen|Term?|huse|huses	<i>noun</i><br><ol><li>house</li><li>castle</li><li>court, place where a formal gathering is held</li></ol>
huwe	<i>det</i><br><ol><li>feminine nominative/accusative singular</li><li>nominative/accusative plural</li></ol>
huwen|huut|huwet|huwes|huwende|huwens|huus|hu|huwene|huwe	<i>verb</i><br><ol><li>to marry, to wed</li></ol><br><i>det</i><br><ol><li>masculine accusative/dative singular</li><li>neuter dative singular</li><li>dative plural</li></ol>
ic|mijns|ju|sie|si|dijns|het|ghi|di|gi|haer|se|hij|it|es|dijn|ons|ic|hen|mijn|mi|wi|sijn|du|hit|u|hi|onse|uwe|hem|zi|et	<i>pron</i><br><ol><li>I</li></ol>
iet|yewet|iewet	<i>pron</i><br><ol><li>something, anything</li></ol><br><i>adv</i><br><ol><li>to any degree, in any way, at all</li><li>a little, somewhat</li><li>sometimes, perhaps</li></ol>
ijs	<i>noun</i><br><ol><li>ice</li></ol>
iken|īken	<i>verb</i><br><ol><li>to gauge</li></ol>
in|in [+accusative|dative]	<i>prep</i><br><ol><li>in, inside, within</li><li>into</li><li>within (a time period)</li><li>in (a condition)</li></ol><br><i>abbrev</i><br><ol><li>Contraction of ic ne.</li></ol>
inne	<i>adv</i><br><ol><li>in, inwards, inside</li></ol><br><i>noun</i><br><ol><li>inside, one's inner consciousness</li></ol><br><i>abbrev</i><br><ol><li>Contraction of ic ne.</li></ol>
innen|in|int|ins|innene|innens|innes|inne|innet|innende	<i>verb</i><br><ol><li>to bring in</li><li>to collect (money)</li></ol>
ir	<i>pron</i><br><ol><li>ye, you (plural) (only in Southeastern texts)</li></ol>
isengrijn|ysengrijn|isingrijn	<i>noun</i><br><ol><li>A wolf character in the story of Reynard the fox.</li></ol>
iser	<i>noun</i><br><ol><li>iron</li></ol>
isidorus	<i>noun</i><br><ol><li>Isidore of Seville</li></ol>
jaer|jâer	<i>noun</i><br><ol><li>year (one cycle of the seasons)</li><li>calendar year</li></ol>
jagen|jāgen	<i>verb</i><br><ol><li>to hunt, to chase, to pursue</li><li>to hunt (animals)</li><li>to drive forward, to impel</li><li>to persue (a goal), to strive for</li><li>to hurry</li></ol>
janken	<i>verb</i><br><ol><li>to whine, to make a whining sound</li><li>to whine, to whinge</li></ol>
jegen|jegen [+accusative]	<i>prep</i><br><ol><li>opposite</li><li>towards</li><li>up to against</li><li>close to (time)</li><li>against, in opposition to</li><li>in exchange for</li></ol>
jonc	<i>adj</i><br><ol><li>young</li><li>(in the superlative) most recent</li></ol>
kegel|kêgel|kēgel	<i>noun</i><br><ol><li>cone, wedge</li><li>bowling pin</li></ol>
kegelen|kēgelen|kêgelen	<i>verb</i><br><ol><li>(late) to play bowling</li></ol>
kemmen|kem|kemmene|kemmes|kemt|kemmende|kemme|kemmet|kemmens|kems	<i>verb</i><br><ol><li>to comb</li></ol>
kennen|kent	<i>verb</i><br><ol><li>to know, to be familiar with</li><li>to recognise, to know who/what someone/something is</li><li>to recognise, to acknowledge (a fact)</li><li>to admit</li><li>to consider (to be)</li><li>to establish (as fact)</li></ol>
keren|kêer|kēer|kēers|kêert|kêren|kēert|kêret|kēren|keeren|kērene|kêrene|kêrende|kēre|kēres|kēret|kêrens|kêers|kêre|kêres|kērende|kērens	<i>verb</i><br><ol><li>(transitive, intransitive) To turn, to turn over, to turn around</li><li>(transitive) To turn, to change</li><li>(transitive) To translate</li><li>(transitive) To spend (of money)</li><li>(transitive) To return, to reimburse</li><li>(intransitive) To go</li><li>(intransitive) To return, to come back</li><li>To sweep (up).</li></ol>
kerke	<i>noun</i><br><ol><li>church (building)</li><li>church (institute)</li></ol>
kerse	<i>noun</i><br><ol><li>candle</li><li>cherry</li><li>cress, garden cress</li></ol>
kersmisse	<i>noun</i><br><ol><li>Christmas</li></ol>
kerst	<i>noun</i><br><ol><li>Christ.</li></ol>
kerstin	<i>adj</i><br><ol><li>Christian</li></ol><br><i>noun</i><br><ol><li>Christian</li></ol>
kerven|korven|korvet|kerf|kervens|gekorven|korves|karf|korft|korfs|kervene|kervet|kerves|kerfs|kerve|kervende|kerft|korve	<i>verb</i><br><ol><li>to carve, to cut out</li><li>to cut through, to cut into pieces</li><li>to destroy, to break</li></ol>
kiede	<i>noun</i><br><ol><li>A sprout</li></ol>
kiesen|kiesens|cōren|gecōren|cōort|kiese|côos|kieset|kiesende|kieses|cōors|cōres|cōre|cōret|kies|kiest|kiesene	<i>verb</i><br><ol><li>to test, to inspect, to assess</li><li>to choose, to select</li></ol>
kiken|kike|kikes|kēect|kiket|kēke|kikende|gekēken|kijc|kēkes|kijct|kikens|kêec|kēket|kikene|kijcs|kēecs|kēken	<i>verb</i><br><ol><li>to look, to direct the eyes</li></ol>
kille|killen	<i>noun</i><br><ol><li>riverbed, channel</li></ol>
kinen|kijn|kêen|kēnet|kēens|kinene|gekēnen|kines|kinens|kēnes|kēnen|kine|kinende|kijnt|kēne|kinet|kēent|kijns	<i>verb</i><br><ol><li>(eastern) to split open (of the ground)</li></ol>
kinne	<i>noun</i><br><ol><li>chin</li></ol>
kint|kindre	<i>noun</i><br><ol><li>child (young person)</li><li>child, offspring</li></ol>
lachen	<i>verb</i><br><ol><li>to laugh</li><li>to smile</li><li>to be happy</li></ol>
lachter	<i>noun</i><br><ol><li>shame, dishonour</li><li>slander, vilification</li></ol>
lade|lāde	<i>noun</i><br><ol><li>box, case</li><li>(eastern) plank, beam</li></ol>
laden|lāden	<i>verb</i><br><ol><li>to load (goods)</li><li>to load (onto a beast of burden)</li><li>to burden (with a task)</li><li>(eastern) to call, to summon</li></ol>
laet|lâet	<i>noun</i><br><ol><li>serf</li></ol>
laetti	<i>abbrev</i><br><ol><li>Contraction of lâet gi.</li></ol>
lage|laghe|lâge	<i>adj</i><br><ol><li>low, close to the ground</li><li>low in rank/stature, unimportant</li></ol><br><i>noun</i><br><ol><li>position, lie</li><li>lodge, place to sleep</li><li>layer</li><li>trap, snare</li><li>ambush</li><li>treachery</li><li>condition, situation</li></ol>
laken|lāken	<i>noun</i><br><ol><li>broadcloth</li></ol><br><i>verb</i><br><ol><li>to decrease, to diminish, to become less</li><li>to lack, to be insufficient</li><li>to criticise, to denounce</li><li>to stain, to soil, to violate (honour or value)</li></ol>
lam	<i>noun</i><br><ol><li>lamb</li></ol><br><i>adj</i><br><ol><li>lame</li><li>weak, strengthless</li></ol>
langen	<i>verb</i><br><ol><li>to be/become long</li><li>to lengthen, to make longer</li><li>to touch</li><li>to hand, to pass, to reach in order to give</li><li>(impersonal) to long [+dative = subject]</li></ol>
lant	<i>noun</i><br><ol><li>(dry) land</li><li>(piece of) land</li><li>country, region</li><li>ground, earth</li></ol>
last	<i>noun</i><br><ol><li>load, weight</li><li>task, duty, obligation</li><li>tax (money)</li><li>(emotional) difficulty, sorrow</li><li>a unit of volume</li></ol>
laten|lâtens|lâte|lâet|lietes|liets|lâtes|lâtet|liete|lâets|lâten|liet|lâtende|gelâten|lieten|lietet|lâtene	<i>verb</i><br><ol><li>to leave, to cause to remain in the same position or state</li><li>to release</li><li>to let, to lose (of bodily fluids)</li><li>to leave, to let remain, to leave behind</li><li>to leave, to depart from</li><li>to not do, to refrain from</li><li>to stop doing, to cease doing</li><li>(auxiliary) to allow, to not prevent</li><li>(auxiliary) to cause to, to make</li></ol>
latijn	<i>noun</i><br><ol><li>Latin language</li></ol>
laven|lāven	<i>verb</i><br><ol><li>to freshen, refresh, give food or drink as a refresher (to someone who is exhausted)</li></ol>
lecken	<i>verb</i><br><ol><li>to lick</li><li>Synonym of lēken</li></ol>
leckernie|leckernië|leckerniën	<i>noun</i><br><ol><li>delicacy, snack</li></ol>
ledich|lēdich	<i>adj</i><br><ol><li>free, unrestricted</li><li>workless</li><li>available</li><li>empty, vacant</li></ol>
leet|lêet	<i>adj</i><br><ol><li>loathsome, abhorrent</li></ol><br><i>noun</i><br><ol><li>damage, harm</li><li>suffering, sadness</li><li>sickness</li></ol>
leggen|leide	<i>verb</i><br><ol><li>to lay (down), to place</li><li>to lay (eggs)</li><li>to build, to make</li><li>to station (armies)</li></ol>
legioen	<i>noun</i><br><ol><li>legion</li></ol>
leiden|leidens|leit|leidet|leits|leide|leides|leidende|leidene	<i>verb</i><br><ol><li>to lead, to bring</li><li>to lead, to guide, to conduct</li></ol><br><i>noun</i><br><ol><li>Leiden (a city in the modern Netherlands)</li></ol>
leken|lēken	<i>verb</i><br><ol><li>to leak, to be leaky</li><li>to leak away, to flow away (of a liquid)</li></ol>
leme	<i>noun</i><br><ol><li>fishbone</li><li>(generally prickly) stalk or other part of a plant</li></ol>
lenen|lênen	<i>verb</i><br><ol><li>To lend</li><li>To borrow</li><li>To grant, to allow.</li></ol>
lengen	<i>verb</i><br><ol><li>to lengthen, to extend, to make/become longer</li></ol>
lepel|lēpel	<i>noun</i><br><ol><li>spoon</li></ol>
lere|lêre	<i>noun</i><br><ol><li>teaching</li><li>instruction</li></ol>
leren|lêret|lêrene|lêers|lêres|lêrende|lêrens|lêren|lêer|lêre|lêert	<i>verb</i><br><ol><li>to learn</li><li>to teach</li><li>to tell</li></ol>
lesen|lēsen	<i>verb</i><br><ol><li>to gather, to collect</li><li>to read</li><li>to read out loud (to an audience)</li></ol>
lesschen	<i>verb</i><br><ol><li>to go out (of fire)</li><li>to extinguish</li><li>to quench</li><li>to calm, to ease</li><li>to lessen, to reduce</li></ol>
letten|lette	<i>verb</i><br><ol><li>to hinder, to slow</li><li>to stop, to halt</li><li>to delay, to wait</li><li>to disadvantage, to harm</li></ol>
lettere	<i>noun</i><br><ol><li>letter (of the alphabet)</li><li>literal meaning</li><li>(sometimes plural only) letter (written note)</li><li>Bible</li><li>sources (collective)</li></ol>
leven|lēvende|lēven|lēvet|lēef|lēvens|lēve|lēves|lēefs|lēvene|lēeft	<i>verb</i><br><ol><li>to live, to be alive</li><li>to live one's life</li><li>to live, to dwell</li></ol>
levic	<i>abbrev</i><br><ol><li>Contraction of lēve ic.</li></ol>
lewe|lêwe	<i>noun</i><br><ol><li>lion</li></ol>
licht	<i>adj</i><br><ol><li>light, not heavy</li><li>lighthearted</li><li>light, easy</li><li>light, not dark</li><li>shining, luminous</li><li>light in colour</li></ol><br><i>noun</i><br><ol><li>light</li><li>daylight</li><li>illumination</li><li>sight, ability to see</li><li>insight, knowledge</li></ol>
lichtvat	<i>noun</i><br><ol><li>lamp, lantern</li></ol>
liden|lidens|lidende|lēde|lêet|lides|lēdet|lijden|lidene|gelēden|lidet|lēet|lēets|lide|lēden|lijts|lijt|lēdes	<i>verb</i><br><ol><li>(intransitive) to go, to pass</li><li>(transitive, intransitive) to pass by, to go by</li><li>(transitive, intransitive) to pass, to go by (time)</li><li>(transitive) to endure, to bear, to tolerate</li><li>(transitive) to suffer, to undergo</li></ol>
lief	<i>adj</i><br><ol><li>loved, dear</li><li>sweet, nice</li></ol>
liegen|lieghen|lōge|liege|lōocht|gheloghen|liegens|lōgen|gelogen|liecht|lōget|lōochs|liegende|lôoch|liegene|liechs|gelōgen|lieges|lieget|lōges|liech	<i>verb</i><br><ol><li>(intransitive) to lie (to tell lies)</li></ol>
lien|liën	<i>verb</i><br><ol><li>(transitive) to admit</li><li>(transitive) to acknowledge, to be convinced</li><li>(transitive) to declare</li><li>(intransitive) to assent</li><li>(eastern) to lend</li></ol>
lieven	<i>verb</i><br><ol><li>to love</li></ol>
liggen|lach|leget|lagen|lâgen|leghet|lēget|laghen	<i>verb</i><br><ol><li>to lie, be lying horizontal</li><li>to lie, to have been placed</li><li>to be located, to be present</li><li>to live (in a place)</li></ol>
lijf	<i>noun</i><br><ol><li>body</li><li>life (being alive)</li><li>life (course of life)</li><li>life force</li></ol>
lijm	<i>noun</i><br><ol><li>mud, sludge, clay</li><li>slime, spit, saliva</li><li>glue</li></ol>
lijste	<i>noun</i><br><ol><li>edge, hem</li><li>edge (of woodwork or stonework)</li></ol>
liken	<i>verb</i><br><ol><li>to please, (in archaic English usage) to like</li></ol>
limborch	<i>noun</i><br><ol><li>Limburg (a duchy)</li></ol>
limen	<i>verb</i><br><ol><li>to glue, to make stick with glue</li></ol>
lo|lô	<i>noun</i><br><ol><li>clearing in a forest</li></ol>
locken	<i>verb</i><br><ol><li>to lure</li></ol>
loeyen	<i>verb</i><br><ol><li>to low</li><li>to roar</li></ol>
lof|lōve|love	<i>noun</i><br><ol><li>praise</li><li>prestige</li></ol>
lonen|lônen	<i>verb</i><br><ol><li>to reward</li><li>to repay</li></ol>
loof|lôof	<i>noun</i><br><ol><li>leaf</li><li>foliage, leaves</li></ol>
loon|lôon	<i>noun</i><br><ol><li>wage, payment for services or work</li><li>reward</li><li>value</li><li>Borgloon (a city in modern Belgium)</li><li>Loon (a county)</li></ol>
loot|lôot	<i>noun</i><br><ol><li>lead (metal)</li></ol>
lopen|lôpen	<i>verb</i><br><ol><li>to run (on foot)</li><li>to go, to run, to move</li><li>to run, to flow</li><li>to go, to stretch (of roads, rivers etc.)</li></ol>
los	<i>adj</i><br><ol><li>loose, free</li><li>free, not encumbered</li><li>having lost, robbed</li></ol>
loven|lōve|lōvende|lōoft|lōofs|lōof|lōvens|lōven|lōves|lōvet|lōvene	<i>verb</i><br><ol><li>to praise</li></ol>
loyen|lôyen	<i>verb</i><br><ol><li>to tan (leather)</li></ol>
lucht	<i>noun</i><br><ol><li>air</li><li>sky</li><li>smell, odour</li></ol>
lude	<i>adv</i><br><ol><li>loudly</li></ol>
ludeke	<i>noun</i><br><ol><li>Liège (a city in modern Belgium)</li><li>Liège (a former bishopric in the Holy Roman Empire)</li></ol>
luken|lôoc|luke|lōocs|luuc|lukende|lukens|lōkes|lōken|lukene|gelōken|lōket|lukes|lōoct|lōke|luket|luuct|luucs	<i>verb</i><br><ol><li>(transitive) to close, to shut</li><li>(intransitive) to close, to become closed</li></ol>
lust	<i>noun</i><br><ol><li>enjoyment, pleasure</li><li>lust, desire</li><li>hunger, desire to eat</li></ol>
lute	<i>noun</i><br><ol><li>lute</li></ol>
luusteren	<i>verb</i><br><ol><li>to listen</li><li>to whisper</li></ol>
luut	<i>adj</i><br><ol><li>loud</li></ol><br><i>noun</i><br><ol><li>sound</li><li>noise, shouting</li><li>voice</li></ol>
made|mâde|māde	<i>noun</i><br><ol><li>worm, maggot</li><li>meadow</li></ol>
maech|mâech	<i>noun</i><br><ol><li>blood relative</li></ol>
maendach|mâendach	<i>noun</i><br><ol><li>Monday</li></ol>
maent|mâent	<i>noun</i><br><ol><li>month</li></ol>
mage|maghe|māge	<i>noun</i><br><ol><li>stomach</li></ol>
maghe	<i>noun</i><br><ol><li>dative singular</li><li>nominative/accusative/dative plural</li></ol>
maken|māecs|mākende|mākene|māke|māket|mākens|māect|māec|mākes|māken	<i>verb</i><br><ol><li>to make</li><li>to make, to cause to be</li></ol>
maledien|mālediën	<i>verb</i><br><ol><li>to curse, to maledict</li></ol>
malen|mālen|mâlen	<i>verb</i><br><ol><li>to grind</li><li>to mill</li><li>to paint</li><li>to sculpt</li></ol>
malsch|malschen|malscher|malsche|malschs	<i>adj</i><br><ol><li>overconfident</li><li>stubborn</li><li>(late) soft, weak</li></ol>
man	<i>noun</i><br><ol><li>human</li><li>person</li><li>man, male</li><li>husband</li><li>subordinate</li></ol>
mane|māne|mâne	<i>noun</i><br><ol><li>moon</li><li>moonshine, moonlight</li><li>(usually in the plural) mane</li></ol>
manlijc ander|malcander|mallic ander|melcander	<i>pron</i><br><ol><li>each other</li></ol>
mare|māre|mâre	<i>adj</i><br><ol><li>famous, famed</li><li>honoured, prestigious</li><li>well-known</li></ol><br><i>noun</i><br><ol><li>fame, famousness</li><li>rumour</li><li>message</li><li>mare, nightmare (evil spirit)</li></ol>
marter	<i>noun</i><br><ol><li>marten</li></ol>
mase|māse	<i>noun</i><br><ol><li>Meuse (a river)</li></ol>
materie	<i>noun</i><br><ol><li>matter, raw material</li><li>matter, subject</li></ol>
mayen|mâyen	<i>verb</i><br><ol><li>to mow, to cut</li></ol>
mede|mēde|mēden	<i>adv</i><br><ol><li>together, with</li><li>in accordance</li><li>furthermore, with that also</li></ol><br><i>noun</i><br><ol><li>mead (drink)</li><li>madder (Rubia tinctorum)</li><li>Mede (inhabitant of Media)</li><li>A measure of volume, consisting of half an ame, or around 75 litres.</li></ol>
mee|mere|meer|mêe|mêer|mêre	<i>pron</i><br><ol><li>more</li></ol><br><i>adv</i><br><ol><li>more, to a greater degree</li><li>more often, more frequently</li><li>better</li><li>rather</li><li>later, further on in time</li><li>also, furthermore</li></ol>
meest|mêest	<i>adj</i><br><ol><li>greatest, largest</li><li>most prominent</li><li>most frequent, most numerous</li></ol><br><i>det</i><br><ol><li>most</li></ol><br><i>adv</i><br><ol><li>most</li><li>very, to the highest degree</li></ol>
meester|mêester	<i>noun</i><br><ol><li>A master, teacher</li><li>A master, expert</li><li>A scientist, doctor</li><li>A master, manager, person at the head of something</li><li>A master, one who controls.</li></ol>
melc	<i>noun</i><br><ol><li>milk</li></ol>
melden	<i>verb</i><br><ol><li>to betray, to rat on, to report</li><li>to announce, to make known</li><li>to note, to notify</li></ol>
melken|gemolken|molct|melkene|melcs|melke|melkes|molcs|melct|malc|molke|melkende|molken|melket|molket|melkens|molkes|melc	<i>verb</i><br><ol><li>To milk.</li><li>To draw in, to pull.</li><li>To lure.</li></ol>
men	<i>pron</i><br><ol><li>someone</li><li>one, they, you, people; impersonal pronoun.</li></ol>
menen|mênen	<i>verb</i><br><ol><li>to mean, to signify</li><li>to intend</li><li>to mean, to stand for</li><li>to think, to be of the opinion</li></ol>
mengen	<i>verb</i><br><ol><li>to mix</li><li>to unify</li><li>to confuse</li></ol>
menich|mēnich	<i>det</i><br><ol><li>many, many a</li><li>various</li></ol>
mere|mēre|mêre|meere	<i>adj</i><br><ol><li>greater, larger</li><li>older</li></ol><br><i>det</i><br><ol><li>more</li></ol><br><i>noun</i><br><ol><li>lake (fresh water)</li><li>sea (salt water)</li></ol>
merken	<i>verb</i><br><ol><li>to mark, to put a mark on, to give a mark to</li><li>to watch attentively</li><li>to watch, to pay attention to, to notice</li></ol>
mesprisen|mesprijsen	<i>verb</i><br><ol><li>(Flemish) Alternative form of misprisen</li></ol>
messe|misse	<i>noun</i><br><ol><li>mass (church service)</li></ol>
mesvoert	<i>verb</i><br><ol><li>third-person singular present indicative</li><li>second-person plural present indicative/subjunctive</li><li>plural imperative</li></ol>
met|met [+dative]	<i>prep</i><br><ol><li>with</li><li>by means of, using (a tool, material etc.)</li><li>at the same time as, at</li><li>with, under circumstances of</li><li>concerning</li></ol>
meten|mēten	<i>verb</i><br><ol><li>to measure</li><li>to determine</li><li>to investigate</li></ol>
metten	<i>abbrev</i><br><ol><li>Contraction of met den.</li></ol>
mewe|mêwe	<i>noun</i><br><ol><li>seagull</li></ol>
micken	<i>verb</i><br><ol><li>to peer, to look sharply</li><li>to try, to attempt</li><li>to aim, to strive</li><li>to pay attention</li><li>to think</li><li>to tax</li></ol>
midde	<i>adj</i><br><ol><li>(rare) middle, in the middle</li></ol>
middelbaer|middelbāer	<i>adj</i><br><ol><li>average, mediocre, in the middle</li></ol>
middesomer|middesōmer	<i>noun</i><br><ol><li>midsummer</li><li>summer solstice</li></ol>
middewinter	<i>noun</i><br><ol><li>midwinter</li><li>winter solstice</li></ol>
miden|mēet|mēde|mēden|midende|mijt|gemēden|mēdes|mêet|midens|mēdet|mide|midene|mēets|mijts|mides|midet	<i>verb</i><br><ol><li>to avoid</li></ol>
miere	<i>noun</i><br><ol><li>ant</li></ol>
migen	<i>verb</i><br><ol><li>to urinate</li></ol>
mijn|mijns|minen|miere|mine	<i>det</i><br><ol><li>my</li></ol>
min|minre	<i>pron</i><br><ol><li>less</li></ol><br><i>adv</i><br><ol><li>less, to a smaller degree</li></ol>
mine	<i>noun</i><br><ol><li>ore vein, mine</li></ol>
minen	<i>verb</i><br><ol><li>to buy in a public sale</li></ol>
minne|minnen	<i>noun</i><br><ol><li>love</li><li>(rare) remembrance (possibly from a different etymology)</li></ol>
minre	<i>adj</i><br><ol><li>smaller, lesser</li></ol><br><i>det</i><br><ol><li>less</li></ol>
minst	<i>adj</i><br><ol><li>smallest</li><li>least numerous</li></ol>
misdoen|misdāen|misdaen|mesdāen|mesdaen	<i>verb</i><br><ol><li>to misdo, to do wrong</li></ol>
misprisen	<i>verb</i><br><ol><li>to disapprove</li><li>to blame</li></ol>
misraken|mesrāken|misrāken|mesraken	<i>verb</i><br><ol><li>to miss (a target)</li><li>to err, to stray from the right path</li><li>to fail, to not succeed, to turn out bad</li></ol>
misselijc	<i>adj</i><br><ol><li>different, various</li><li>diverse, varied, motley</li><li>variable, unsure, unpredictable</li><li>confused</li><li>unfitting, wrong, shameful</li></ol>
missen	<i>verb</i><br><ol><li>to miss, to not hit</li><li>to miss, to lack, to not have</li><li>to lose, to no longer have</li><li>to fail</li></ol>
misvoeren|misvoert|mesvoert	<i>verb</i><br><ol><li>to abuse (physically)</li></ol>
mochtire	<i>abbrev</i><br><ol><li>Contraction of mochte hi dāer.</li></ol>
moeder	<i>noun</i><br><ol><li>mother</li></ol>
moeten|moete|moet|moeste	<i>verb</i><br><ol><li>(auxiliary) to have to, must, to be obliged to</li><li>(auxiliary) to be allowed to, to have permission to</li><li>(auxiliary) will, shall</li><li>to meet, to come upon</li><li>to meet with hostility</li></ol>
moeye	<i>noun</i><br><ol><li>aunt, sister of one's parent</li></ol>
moeyen	<i>verb</i><br><ol><li>to hinder, to make it difficult for</li><li>to hurt, to torment</li><li>to annoy, to bother</li><li>to tire, to exhaust</li></ol>
mogen|mōgen	<i>verb</i><br><ol><li>to be capable of</li><li>can, to be able (in given circumstances)</li><li>(in questions) may, can, be allowed to</li><li>to be allowed, to be permitted</li><li>shall, to be expected to</li><li>to be required to</li></ol>
moghense	<i>abbrev</i><br><ol><li>Contraction of mōgen se.</li></ol>
mol	<i>noun</i><br><ol><li>mole (animal)</li></ol>
molen|mōlen	<i>noun</i><br><ol><li>mill</li></ol>
molenman|mōlenman	<i>noun</i><br><ol><li>miller</li></ol>
mont	<i>noun</i><br><ol><li>mouth (opening in the head)</li></ol>
mordenare|mordenere|mordeneere|mordenāre|mordenēre	<i>noun</i><br><ol><li>murderer</li></ol>
morseel|morsēel|morzeel	<i>noun</i><br><ol><li>morsel, piece</li></ol>
museel|musēel	<i>noun</i><br><ol><li>muzzle, snout</li></ol>
muur	<i>noun</i><br><ol><li>wall</li></ol>
muus	<i>noun</i><br><ol><li>mouse</li></ol>
na|nâ	<i>prep</i><br><ol><li>towards</li><li>behind</li><li>after, following, later than</li><li>in accordance with, based on</li></ol><br><i>adv</i><br><ol><li>afterwards, later</li><li>close, near</li></ol><br><i>adj</i><br><ol><li>close</li></ol>
nacht|nachte	<i>noun</i><br><ol><li>night</li></ol>
nagel|nāgel	<i>noun</i><br><ol><li>A nail (hard part of fingers and toes)</li><li>A nail (metal spike)</li><li>A clove (spice).</li></ol>
naken|nâken	<i>verb</i><br><ol><li>to approach, to near</li></ol>
name|nâme|nāme	<i>noun</i><br><ol><li>name</li><li>fame, reputation</li><li>taking</li><li>receiving</li></ol>
namen|nāmen	<i>verb</i><br><ol><li>To name, to give a name to.</li><li>To name, to mention.</li></ol><br><i>noun</i><br><ol><li>Namur (a city and county in modern Belgium)</li></ol>
nature	<i>noun</i><br><ol><li>nature, force of nature</li><li>laws of nature, natural order</li><li>nature, innate characteristics</li><li>kind, sort</li><li>origin</li><li>sexual fertility, sex drive</li></ol>
nayen|nâyen	<i>verb</i><br><ol><li>to sew</li></ol>
ne	<i>adv</i><br><ol><li>not</li></ol>
neder|nēder	<i>adv</i><br><ol><li>down, downwards</li><li>down low</li></ol><br><i>prep</i><br><ol><li>below, beneath</li></ol><br><i>adj</i><br><ol><li>low, close to the ground</li><li>lowly, inferior</li></ol>
negen|nēgen|neghen	<i>num</i><br><ol><li>nine</li></ol>
negende|nēgende	<i>adj</i><br><ol><li>ninth</li></ol>
negentich|nēgentich	<i>num</i><br><ol><li>ninety</li></ol>
neigen	<i>verb</i><br><ol><li>to (cause to) bend down</li><li>to lay down, to rest (the head)</li><li>to incline</li></ol>
nemen|nēmen	<i>verb</i><br><ol><li>to take</li><li>to take hold of, to grasp</li><li>to cut down (trees, plants), to harvest</li><li>to pluck (fruits)</li><li>to take away</li><li>to elect, to appoint</li><li>to receive, to accept</li></ol>
nennen	<i>verb</i><br><ol><li>(transitive) to name; to give a name to (someone)</li></ol>
nesen|nēsen	<i>verb</i><br><ol><li>(rare) Synonym of genēsen</li></ol>
neve|nēve	<i>noun</i><br><ol><li>male cousin</li><li>nephew</li><li>grandson</li></ol>
nevel|nēvel	<i>noun</i><br><ol><li>fog, mist</li></ol>
nichte	<i>noun</i><br><ol><li>female cousin</li><li>niece</li><li>granddaughter</li></ol>
nieman|niemene|niemen	<i>pron</i><br><ol><li>no one, nobody</li></ol>
niesen|fnieses|fniesene|fniese|fniesens|nieses|niest|niesende|fnieset|nieset|fniesen|fnies|fniesende|niesens|fniest|niesene|niese|nies	<i>verb</i><br><ol><li>to sneeze</li></ol>
niet	<i>adv</i><br><ol><li>not</li></ol><br><i>pron</i><br><ol><li>nothing</li></ol>
nieten|niets|nietes|nōot|nietende|nōte|nōots|nōtes|nōten|nôot|genōten|niet|nietene|nōtet|nietet|nietens|niete	<i>verb</i><br><ol><li>to employ, to use (to one's advantage)</li><li>to enjoy (the use of)</li></ol>
niewe	<i>adj</i><br><ol><li>new</li></ol>
nigen|nigens|nigene|nēge|niget|nēget|nige|nijcht|nēecht|nigende|niges|nēgen|nēechs|genēgen|nēges|nijch|nijchs|nêech	<i>verb</i><br><ol><li>to bow</li></ol>
nipen|nipene|nēept|nipes|genēpen|nipende|nipens|nipet|nijps|nēpes|nijpt|nipe|nēeps|nēpet|nijp|nēpen|nêep|nēpe	<i>verb</i><br><ol><li>to pinch, to squeeze</li></ol>
niten	<i>verb</i><br><ol><li>to knock, to butt against</li></ol>
nobel|nōbel	<i>adj</i><br><ol><li>noble, of noble birth</li></ol>
noch|nō|no	<i>adv</i><br><ol><li>still, as before</li><li>later, after all</li><li>yet again</li><li>additionally</li><li>(with a comparative) even, yet</li></ol><br><i>conj</i><br><ol><li>neither, nor</li></ol>
nochtan	<i>adv</i><br><ol><li>still then</li><li>even then</li><li>moreover, furthermore, on top of that</li></ol>
noemen	<i>verb</i><br><ol><li>to name, to give a name to</li><li>to call, to refer to by name</li><li>to mention</li></ol>
noene	<i>noun</i><br><ol><li>three o'clock in the afternoon</li><li>mass at this time</li></ol>
noit|noyt|noint	<i>adv</i><br><ol><li>never</li></ol>
nomen|nōmen	<i>verb</i><br><ol><li>(Flemish) Alternative form of noemen</li></ol>
nommer	<i>noun</i><br><ol><li>number</li></ol>
nortsee|nortsêe	<i>noun</i><br><ol><li>North Sea (a sea)</li></ol>
note|nōte	<i>noun</i><br><ol><li>nut (fruit)</li></ol>
nu	<i>adv</i><br><ol><li>now, currently</li><li>today</li><li>here</li><li>just now</li></ol><br><i>conj</i><br><ol><li>now that</li><li>since, because</li></ol>
oder	<i>conj</i><br><ol><li>or</li></ol>
oeven	<i>verb</i><br><ol><li>to practice</li></ol>
oever	<i>noun</i><br><ol><li>bank, shore, waterside</li></ol>
of	<i>conj</i><br><ol><li>if, whether</li></ol>
ofte	<i>conj</i><br><ol><li>or</li><li>(ofte ... ofte) either ... or</li><li>if, when</li><li>as if</li><li>if, whether</li></ol>
oge|ôge	<i>noun</i><br><ol><li>eye</li><li>gaze</li><li>(in the plural) sight, ability to see</li><li>eye (of a needle)</li><li>eye (on a peacock's tail)</li></ol>
oken|ôken	<i>verb</i><br><ol><li>to increase, to enlarge</li></ol>
olie|ōlie	<i>noun</i><br><ol><li>oil</li></ol>
omme|om|ombe	<i>prep</i><br><ol><li>around, about</li><li>at around (a time)</li><li>for, for the purpose of</li><li>(sometimes with te) in order to</li><li>in exchange for</li></ol><br><i>adv</i><br><ol><li>around, about</li></ol>
onberecht|omberecht	<i>adj</i><br><ol><li>without supervision or leadership</li><li>untried, not subjected to justice</li></ol>
onbeschaven|onbescaven|onbeschāven	<i>adj</i><br><ol><li>untouched, not disturbed</li></ol>
ongemaect	<i>adj</i><br><ol><li>unmade</li><li>unfixed</li></ol>
ongewroken|ongewrōken|onghewroken	<i>adj</i><br><ol><li>unpunished</li><li>unavenged</li></ol>
onhout	<i>adj</i><br><ol><li>hostile, unfriendly</li></ol>
onlust	<i>noun</i><br><ol><li>tedium, weakness, nausea</li><li>unrest</li><li>burden</li></ol>
onnen	<i>verb</i><br><ol><li>to grant, to bestow (out of kindness or generosity)</li></ol>
onnutte	<i>adj</i><br><ol><li>useless</li><li>worthless</li><li>dangerous, creating unrest</li><li>horrible</li><li>wrong, sinful</li></ol>
onschult|onsculde|onschulde	<i>noun</i><br><ol><li>innocence</li><li>oath of innocence</li><li>excuse</li></ol>
onsculde	<i>noun</i><br><ol><li>dative singular</li><li>nominative/accusative/dative plural</li></ol>
onse	<i>det</i><br><ol><li>our</li></ol>
ontberen|ontbēren	<i>verb</i><br><ol><li>to avoid doing</li><li>to neglect, to put aside</li><li>to lack</li></ol>
ontbieden|ombieden	<i>verb</i><br><ol><li>to inform</li><li>to command</li><li>to summon, to order someone to come</li></ol>
ontbinden	<i>verb</i><br><ol><li>to loosen, to unbind</li><li>to free</li><li>to tell, to set out</li></ol>
ontfaermen|ontfāermen	<i>verb</i><br><ol><li>(Flemish) Alternative form of ontfarmen</li></ol>
ontfaren|ontfāren	<i>verb</i><br><ol><li>to leave, to depart, to go away [+dative = from]</li><li>to escape, to flee [+dative = from]</li></ol>
ontfarmen	<i>verb</i><br><ol><li>(sometimes reflexive) to have/show compassion, pity [+genitive = for]</li></ol>
ontsien|ontsiet	<i>verb</i><br><ol><li>to fear, to be afraid</li><li>to be in awe of</li></ol>
ontvaen|ontvâen	<i>verb</i><br><ol><li>to catch (in a container)</li><li>to receive, to be given, to accept</li><li>to receive, to act as host for</li><li>to consume, to imbibe</li></ol>
onverswegen|onversweghen|onverswēgen	<i>adj</i><br><ol><li>not kept quiet about, not unmentioned</li></ol>
ooc|oec|ôoc	<i>adv</i><br><ol><li>also, too</li><li>furthermore</li></ol>
oom|oem|ôom	<i>noun</i><br><ol><li>uncle, brother of one's parent (originally specifically one's mother)</li></ol>
oostsee|ôostsêe	<i>noun</i><br><ol><li>Baltic Sea (a sea)</li></ol>
op|dative]|op [+accusative|up	<i>prep</i><br><ol><li>on, on top of</li><li>at, in the direction of</li><li>at, by</li></ol><br><i>adv</i><br><ol><li>up, upwards</li><li>up, upright</li><li>open</li></ol>
open|ōpen	<i>adj</i><br><ol><li>open, not closed</li><li>open, accessible</li><li>freely accessible, public</li></ol>
openen|ōpenen	<i>verb</i><br><ol><li>to open, to make open</li></ol>
ore|ôre	<i>noun</i><br><ol><li>ear</li></ol>
ors	<i>noun</i><br><ol><li>horse, steed</li></ol>
osen|ôsen	<i>verb</i><br><ol><li>to draw (liquid), to scoop</li><li>to pour water on</li></ol>
otter	<i>noun</i><br><ol><li>otter, European otter</li></ol>
ouden|houden	<i>verb</i><br><ol><li>to become older, to age</li></ol>
ouder	<i>noun</i><br><ol><li>age</li><li>old age</li><li>old person, senior</li><li>(in the plural) ancestors, elders</li><li>(in the plural) parents</li></ol>
out|ouder|hout|ouden|outs|oude|outst	<i>adj</i><br><ol><li>old</li></ol>
over|ōver	<i>prep</i><br><ol><li>over, above</li><li>across</li><li>towards</li><li>during</li><li>ago, some duration in the past</li><li>after, following (a duration)</li><li>about, concerning</li><li>due to, because of</li></ol><br><i>adv</i><br><ol><li>over</li><li>across, on the other side</li><li>plenty, more than enough</li><li>used up, finished</li><li>once again</li></ol>
overdaet|ōverdâet	<i>noun</i><br><ol><li>excess, what is beyond acceptable</li><li>overconfidence, reckless behaviour</li><li>misdeed, crime</li></ol>
packen	<i>verb</i><br><ol><li>to pack</li></ol>
paerkement|pāerkement	<i>noun</i><br><ol><li>(Flemish) Alternative form of percament</li></ol>
panne	<i>noun</i><br><ol><li>pan</li><li>firepan</li><li>roof tile</li></ol>
panser|pancer	<i>noun</i><br><ol><li>armour</li><li>A beaver character in the story of Reynard the fox.</li></ol>
papinne	<i>noun</i><br><ol><li>The (former) wife of a Catholic priest.</li><li>A pagan priestess.</li></ol>
parijs	<i>noun</i><br><ol><li>Paris (a city in modern France)</li></ol>
pastoor|pastôor	<i>noun</i><br><ol><li>priest, pastor</li></ol>
pensen	<i>verb</i><br><ol><li>to think, to ponder</li><li>to wonder</li><li>to consider</li></ol>
percament	<i>noun</i><br><ol><li>parchment</li></ol>
pere|pēre	<i>noun</i><br><ol><li>pear</li></ol>
persijn	<i>noun</i><br><ol><li>parsley</li></ol>
pert	<i>noun</i><br><ol><li>horse</li></ol>
pipen	<i>verb</i><br><ol><li>to chirp, to peep (of birds)</li><li>to squeak</li><li>to yelp</li><li>to play a wind instrument</li></ol>
pissen	<i>verb</i><br><ol><li>to piss</li></ol>
plaetse|plāetse|plâetse	<i>noun</i><br><ol><li>courtyard, place</li><li>square, open area</li><li>battlefield</li><li>place, location</li></ol>
plagen|plâgen	<i>verb</i><br><ol><li>to punish</li><li>to torment, to torture</li></ol>
planten	<i>verb</i><br><ol><li>to plant (seeds, plants)</li><li>to plant, to secure in the ground</li></ol>
plegen|plēgen|pleghen|plien	<i>verb</i><br><ol><li>to care for</li><li>to carry out, to do, to engage in</li><li>to do habitually</li><li>to use</li></ol>
plinius	<i>noun</i><br><ol><li>Pliny the Elder</li></ol>
ploech	<i>noun</i><br><ol><li>plough</li><li>team</li></ol>
ploegen	<i>verb</i><br><ol><li>to plough</li></ol>
poreye|poret	<i>noun</i><br><ol><li>leek</li></ol>
portere	<i>noun</i><br><ol><li>citizen, burgher</li></ol>
pot	<i>noun</i><br><ol><li>pot, jar</li><li>can, jug</li></ol>
pote|pôte	<i>noun</i><br><ol><li>paw, claw</li></ol>
poten|pōten	<i>verb</i><br><ol><li>to plant, to put (into the ground, usually of plants)</li></ol>
prediken|prēdiken	<i>verb</i><br><ol><li>to preach</li></ol>
prisen|prisende|prijs|prisens|prise|prises|prisene|prijst|priset	<i>verb</i><br><ol><li>to value, to esteem, to judge the value of</li><li>to value, to regard highly</li><li>to praise</li></ol>
proeven	<i>verb</i><br><ol><li>to prove, to show</li><li>to realise, to see</li><li>to test, to inspect</li><li>to try, to attempt</li><li>to taste</li></ol>
putten	<i>verb</i><br><ol><li>to extract (water) from a well</li><li>to dig a pit</li></ol>
puyl	<i>noun</i><br><ol><li>bag</li></ol>
quaet|quâet	<i>adj</i><br><ol><li>evil</li><li>bad</li><li>wrong</li><li>criminal</li><li>angry</li><li>bad, of low quality</li><li>sick, ill</li></ol><br><i>noun</i><br><ol><li>evil</li><li>badness</li><li>misfortune, disaster</li><li>disease</li></ol>
quast	<i>noun</i><br><ol><li>branch with leaves, to cool oneself or swat insects</li><li>brush</li></ol>
quedden	<i>verb</i><br><ol><li>to address</li><li>to greet</li></ol>
quelen|quēlen	<i>verb</i><br><ol><li>to suffer, to be in pain</li><li>to hurt, to torture</li></ol>
quellen	<i>verb</i><br><ol><li>to torment, to hurt, to torture</li></ol>
querne	<i>noun</i><br><ol><li>quern</li></ol>
quiten|quitende|quites|quits|quitens|quite|quit|quitet|quitene	<i>verb</i><br><ol><li>to free (of debt, obligation etc.), to acquit</li></ol>
raden|râden	<i>verb</i><br><ol><li>to ponder, to think over</li><li>to discuss, to plan</li><li>to advise</li><li>to guess</li></ol>
raer|raerer|raere|raers|raeren|râer	<i>adj</i><br><ol><li>(rare) rare, unusual</li></ol>
raken|rāken	<i>verb</i><br><ol><li>to touch</li><li>to reach</li><li>to acquire</li><li>to hit (not miss)</li></ol>
ramp	<i>noun</i><br><ol><li>epilepsy, (human) cramp</li><li>bird claw disease, bird cramp</li><li>disaster, misfortune</li></ol>
rapen|rāpen	<i>verb</i><br><ol><li>to pick up</li><li>to gather, to collect</li></ol>
rasen|râsen	<i>verb</i><br><ol><li>to rage, to be wild, passionate</li><li>to be crazy</li><li>to rave, to talk nonsense</li></ol>
rat	<i>noun</i><br><ol><li>wheel</li></ol><br><i>adj</i><br><ol><li>fast, quick</li></ol>
ratte	<i>noun</i><br><ol><li>rat</li></ol>
raven|rāven	<i>noun</i><br><ol><li>raven</li></ol>
recht	<i>adj</i><br><ol><li>straight, not bent</li><li>upright</li><li>right, exact</li><li>righteous</li><li>lawful, rightful</li><li>true</li></ol><br><i>noun</i><br><ol><li>law, right, duty</li><li>righteousness, justness</li><li>justice, jurisprudence, law</li><li>jurisdiction</li><li>right, what one is entitled to by law</li><li>truth</li></ol>
recken	<i>verb</i><br><ol><li>to stretch, to reach out (of limbs)</li><li>to stretch</li><li>to govern, to control</li></ol>
redden	<i>verb</i><br><ol><li>to save, to rescue</li></ol>
reden|rêden|rēden	<i>verb</i><br><ol><li>to ready, to get ready</li><li>(rare) to speak</li></ol>
regen|rēgen	<i>noun</i><br><ol><li>rain</li></ol>
regenen|rēgenen	<i>verb</i><br><ol><li>to rain</li></ol>
reiken	<i>verb</i><br><ol><li>to stretch</li><li>to reach, to stretch the arm (to something)</li><li>to hand</li><li>to bring out, to produce</li></ol>
reine|rêne|reinen|rene|reins|reiner	<i>adj</i><br><ol><li>clean, pure, untainted</li><li>noble, pure of heart</li><li>free of sin</li><li>of excellent quality</li></ol><br><i>adv</i><br><ol><li>neatly, properly, according to custom</li><li>cleanly, completely</li></ol>
reinen	<i>verb</i><br><ol><li>to clean, to cleanse</li><li>to purify</li></ol>
reise	<i>noun</i><br><ol><li>trip, journey</li><li>military expedition</li></ol>
reisen	<i>verb</i><br><ol><li>to travel, to go on a journey</li><li>to go on a (military) expedition</li></ol>
reke|rēke	<i>noun</i><br><ol><li>row, line</li><li>line (of text)</li><li>rake</li></ol>
reken|rēken	<i>verb</i><br><ol><li>to bring together, to gather into a heap, to rake</li><li>to produce, to bring out</li></ol>
rekenen|rēkenen	<i>verb</i><br><ol><li>to put in order (an account, bill etc)</li><li>to settle, to pay (a debt)</li><li>to charge, to ask payment for</li><li>to manage money</li><li>to count, to be included in an account, also a group</li><li>to calculate, to reckon</li><li>to reckon, to consider</li></ol>
reye	<i>noun</i><br><ol><li>canal</li></ol>
ribbe	<i>noun</i><br><ol><li>rib</li></ol>
richten	
riden|ridens|rêet|rides|ridene|gerēden|rēdes|ridet|ridende|rēden|rēdet|rēet|rijts|rēde|ride|rēets|rijt	<i>verb</i><br><ol><li>to ride (on a horse or vehicle)</li><li>to travel</li><li>to suffer (a disease)</li><li>(figuratively, of land) to be flooded from time to time (up and down, as if on a horse)</li><li>(of an animal) to copulate, to have sexual intercourse</li></ol>
rien|riën	<i>verb</i><br><ol><li>to sew together, to put a thread through</li></ol>
rigen	<i>verb</i><br><ol><li>(late) Alternative form of rien</li></ol>
rijn	<i>noun</i><br><ol><li>Rhine (a river)</li></ol>
rike	<i>noun</i><br><ol><li>lordship, dominion</li><li>realm</li></ol><br><i>adj</i><br><ol><li>powerful, mighty</li><li>important</li><li>rich</li></ol>
rime|rijme	<i>noun</i><br><ol><li>line of poetry, verse</li><li>rhyme</li></ol>
rimen|rimens|rijm|rijmt|rimende|rime|rijms|rimet|rimene|rimes	<i>verb</i><br><ol><li>to rhyme, to compose a rhyme</li><li>to write poetry in general</li></ol>
rinc	<i>noun</i><br><ol><li>ring</li><li>circle</li><li>circle of people</li><li>gathering of people</li><li>entourage, escort</li></ol>
rinen|rinene|rinende|rines|rine|rijnt|rinet|rijns|rijn|rinens	<i>verb</i><br><ol><li>to touch, to stir</li></ol>
rinnen|rons|geronnen|ront|rins|ronnen|ronne|rin|rinnene|ronnes|rinnet|rinnende|rinnes|ronnet|gheronnen|rinnens|rinne|ran|rint	<i>verb</i><br><ol><li>to flow, to stream, to run</li><li>to run, to move quickly</li><li>to move generally</li><li>to coagulate</li></ol>
rint	<i>noun</i><br><ol><li>cow, bovine</li></ol>
risen|risens|risene|rēse|gerēsen|rise|rêes|rēes|rēses|riset|rēsen|rēest|rēset|rijst|risende|rijs|rises	<i>verb</i><br><ol><li>to rise, to go up</li><li>to arise, to appear</li></ol>
riten|rêet|ritens|ritende|rēte|rites|rēten|rētet|rētes|gerēten|rēet|rijts|ritet|rite|rēets|ritene|rijt	<i>verb</i><br><ol><li>to rip, to tear</li></ol>
roec	<i>noun</i><br><ol><li>rook</li></ol>
roeken	<i>verb</i><br><ol><li>(transitive) to focus on, to long for</li><li>(transitive) to care about, to worry about</li></ol>
roepen|riepet|riep|roepende|riepe|roeps|roepens|roepes|riept|riepen|roep|roepe|roepet|geroepen|riepes|roept|roepene|rieps	<i>verb</i><br><ol><li>to call, to shout</li></ol>
roeyen	<i>verb</i><br><ol><li>to row (with oars)</li></ol>
roken|rôken	<i>verb</i><br><ol><li>to smoke, to give off smoke</li><li>to smoke, to preserve by treating with smoke</li></ol>
rollen	<i>verb</i><br><ol><li>to roll</li><li>to tumble</li></ol>
rome|rōme	<i>noun</i><br><ol><li>Rome (a city in modern Italy)</li></ol>
rooc|rôoc	<i>noun</i><br><ol><li>smoke</li><li>vapour</li></ol>
roosten|rôosten	<i>verb</i><br><ol><li>to roast</li></ol>
root|rôot	<i>adj</i><br><ol><li>red</li></ol>
rotterdam	<i>noun</i><br><ol><li>Rotterdam (a city in the modern Netherlands)</li></ol>
rouwen	<i>verb</i><br><ol><li>(impersonal) to regret [+dative = person regretting] [+accusative = thing regretted]</li></ol>
roven|rôven	<i>verb</i><br><ol><li>to rob, to plunder, to pillage</li><li>to rob, to take violently</li><li>to rob, to take violently the possessions of</li></ol>
rucken	<i>verb</i><br><ol><li>to jerk, to tug with sudden force</li></ol>
rugge	<i>noun</i><br><ol><li>back</li></ol>
ruken|rōke|rōkes|rukende|ruke|rōken|rukene|rukes|rōocs|ruuc|rieken|gerōken|ruuct|rukens|rōket|ruket|rōoct|ruucs|rôoc	<i>verb</i><br><ol><li>to smell, to perceive a smell</li><li>to smell, to emit a smell</li></ol>
rune	<i>noun</i><br><ol><li>(rare) secretive whispering</li></ol>
ruste	<i>noun</i><br><ol><li>rest, pause, after physical exertion</li><li>peace, calmness, tranquility</li><li>place for resting</li></ol>
rusten	<i>verb</i><br><ol><li>to rest, to recuperate</li><li>to be somewhere in rest, quietly</li><li>to rest, to be dead</li><li>to stop, to cease</li></ol>
sac	<i>noun</i><br><ol><li>sack</li></ol>
sachte	<i>adj</i><br><ol><li>soft</li><li>mild</li><li>smooth</li><li>light, easy</li><li>slow</li></ol>
saelt	<i>abbrev</i><br><ol><li>Contraction of sal het.</li></ol>
saen|sâen	<i>adv</i><br><ol><li>quickly, soon</li><li>immediately, right away</li><li>suddenly, unexpectedly</li><li>just now</li></ol>
sake|sāke	<i>noun</i><br><ol><li>case, matter, affair</li><li>thing</li><li>cause, reason</li></ol>
sanc|zanc	<i>noun</i><br><ol><li>singing, chanting</li><li>song</li></ol>
sayen|sâyen	<i>verb</i><br><ol><li>to sow</li><li>to spread, to disperse</li></ol>
schade|schāde|scade	<i>noun</i><br><ol><li>A damage, injury, loss.</li><li>A harm, suffering.</li><li>A shame, pity (something regrettable).</li><li>shadow, shade</li></ol>
schaec|schâec	<i>noun</i><br><ol><li>chess</li><li>chessboard</li><li>chess piece</li><li>check (threatening the king)</li></ol>
schaetse|schāetse	<i>noun</i><br><ol><li>peg leg, crutch</li><li>stilt</li></ol>
schaken|schâken	<i>verb</i><br><ol><li>to play chess</li><li>to put in check</li></ol>
schamen|schāmen	<i>verb</i><br><ol><li>(reflexive or intransitive) to be ashamed</li><li>(reflexive or intransitive) to be shy</li></ol>
scharp	<i>adj</i><br><ol><li>sharp (cutting easily)</li><li>rough, harsh to the skin</li><li>sharp (of the senses or mind)</li><li>fierce, intense</li><li>cruel, nasty</li><li>strict</li></ol>
schat	<i>noun</i><br><ol><li>(amount of) money</li><li>treasure, large amount of wealth</li><li>treasury</li><li>valuable</li><li>estimate, appraisal</li></ol>
schatten	<i>verb</i><br><ol><li>to collect taxes, tribute</li><li>to estimate, to appraise</li></ol>
schaven|schāven	<i>verb</i><br><ol><li>to plane</li><li>to scrape</li><li>to shave</li><li>to grind, to pulverise</li></ol>
scheiden	<i>verb</i><br><ol><li>to separate</li><li>to dissolve, to break up</li><li>to divide (up)</li><li>to decide, to put an end to</li></ol>
schelden	<i>verb</i><br><ol><li>to call, to name</li><li>to proclaim, to declare</li><li>to scold, to reprimand</li><li>to swear at, to call names</li><li>to argue, to fight</li></ol>
schelt	<i>noun</i><br><ol><li>Scheldt (a river)</li></ol>
schenden	<i>verb</i><br><ol><li>to stain, to dishonour</li><li>to ruin (someone's standing, happiness)</li></ol>
schepen|schēpen	<i>noun</i><br><ol><li>alderman</li></ol>
scheppen	<i>verb</i><br><ol><li>to create, to make</li><li>to shape, to form</li><li>to scoop</li></ol>
scheren|schēren	<i>verb</i><br><ol><li>to shave</li></ol>
scherm	<i>noun</i><br><ol><li>protective screen</li><li>protection, cover</li></ol>
scherpen	<i>verb</i><br><ol><li>to sharpen, to make/become sharp</li></ol>
schicken	<i>verb</i><br><ol><li>to arrange, to carry out, to get done</li><li>to create, to bring to life</li><li>to direct</li><li>to determine, to assign</li><li>(late) to send, to delegate</li></ol>
schien	<i>verb</i><br><ol><li>Synonym of geschien</li></ol>
schieten|schietene|schiets|schiet|schôot|schietet|schōten|schōot|schietens|schōtet|schietende|schōte|schiete|geschōten|schietes|schōots|schōtes	<i>verb</i><br><ol><li>(intransitive) to shoot, to move quickly in some direction</li><li>(transitive) to shoot, to propel quickly</li><li>(transitive) to shoot (a target), to kill</li></ol>
schildere	<i>noun</i><br><ol><li>(rare, uncertain) shield maker</li><li>someone who paints the coat of arms on a shield</li><li>painter, someone who paints</li></ol>
schilderen	<i>verb</i><br><ol><li>to paint a shield</li><li>(late) to paint (in general)</li></ol>
schilt	<i>noun</i><br><ol><li>shield</li><li>shield bearing one's coat of arms</li></ol>
schinen|schinet|schēnes|schinens|schēent|schēnet|schines|schêen|schēnen|scinen|schijnt|schijn|schine|schinene|schinende|schēens|schēne|geschēnen|schijns	<i>verb</i><br><ol><li>to shine</li><li>to be visible</li><li>to appear, to look, to seem</li><li>to become apparent</li></ol>
schiten|schêet|schitet|geschēten|schijt|schēten|schēet|schētes|sciten|schijts|schitene|schites|schitens|schēets|schēte|schitende|schētet|schite	<i>verb</i><br><ol><li>to shit, to defecate</li></ol>
schoe	<i>noun</i><br><ol><li>shoe</li></ol>
schole|schôle|schōle	<i>noun</i><br><ol><li>school (institute of learning)</li><li>school, throng, swarm</li><li>gathering, meeting</li></ol>
schone|schône|schôons|schôner|scone|schônen	<i>adj</i><br><ol><li>beautiful</li><li>shining, bright, glittering</li><li>clean, not dirty, pure</li><li>friendly, nice</li></ol><br><i>noun</i><br><ol><li>beauty</li></ol>
schonen|schônen|sconen	<i>verb</i><br><ol><li>to make/become beautiful, to decorate</li><li>to improve, to make/become better</li></ol><br><i>noun</i><br><ol><li>Scania (a region)</li></ol>
schoppe	<i>noun</i><br><ol><li>spade, shovel</li></ol>
schoppen	<i>verb</i><br><ol><li>to shovel</li></ol>
schotlant	<i>noun</i><br><ol><li>Scotland (a kingdom)</li></ol>
schraven|scraven	<i>verb</i><br><ol><li>to root, to scratch at the ground</li><li>to throw up (earth, dust) by rooting</li></ol>
schrewen|schrêwen	<i>verb</i><br><ol><li>to scream</li></ol>
schricken	<i>verb</i><br><ol><li>to stride, to take a long, wide step</li><li>to be frightened, startled</li></ol>
schriden|schrēdes|scriden|schridene|schridens|geschrēden|schridende|schride|schrijts|schrēden|schrēdet|schrides|schrēets|schrēde|schrêet|schrēet|schrijt|schridet	<i>verb</i><br><ol><li>to stride</li></ol>
schrien|schriën	<i>verb</i><br><ol><li>to scream</li><li>to cry, to weep loudly</li></ol>
schriven|schrivene|schrivens|geschrēven|schrēven|schrēvet|schrijft|schrēeft|schrijfs|schrives|schrēefs|schrive|schrēves|schrivet|schrēve|scriven|schrêef|geschreven|ghescreven|schrivende|schrijf	<i>verb</i><br><ol><li>to write</li><li>to notify in writing</li><li>to note down</li><li>to engrave</li></ol>
schroden|schrôden	<i>verb</i><br><ol><li>to cut to pieces</li><li>to grind roughly</li><li>to cut, to chop (with a weapon)</li></ol>
schudden	<i>verb</i><br><ol><li>to shake, to cause to move strongly back and forth</li></ol>
schulen	<i>verb</i><br><ol><li>to be hidden</li><li>to take shelter</li></ol>
schult	<i>noun</i><br><ol><li>duty</li><li>debt</li><li>fault, crime</li><li>guilt</li></ol>
schure	<i>noun</i><br><ol><li>shed, barn, storage building</li></ol>
schuren	<i>verb</i><br><ol><li>to scour, to scrub</li></ol>
schuven|schuvet|schuve|schuvens|schuvene|geschōven|schōven|schuuft|schôof|schōves|schuufs|schuves|schuvende|schōoft|schōvet|schōofs|schuuf|schōve	<i>verb</i><br><ol><li>(transitive) to slide, to move smoothly over a surface</li><li>(transitive) to shove, to push roughly</li><li>(intransitive) to slide, to move oneself</li></ol>
schuwen|schu|scuwede|schuwet|schuwens|schuwe|schuwes|schuwede|schuwende|schude|schuwene|schuus|schuut	<i>verb</i><br><ol><li>to be afraid (of)</li><li>to shy away from, to avoid</li></ol>
sconen	<i>adj</i><br><ol><li>masculine accusative/dative singular</li><li>neuter dative singular</li><li>dative plural</li></ol>
sconinx|scōninx	<i>abbrev</i><br><ol><li>Contraction of des cōninx.</li></ol>
scuwedi	<i>abbrev</i><br><ol><li>Contraction of schuwede hi.</li></ol>
sechdi	<i>abbrev</i><br><ol><li>Contraction of secht gi.</li></ol>
sede|sēde	<i>noun</i><br><ol><li>habit, custom</li><li>behaviour, way in which one acts</li><li>nature, character</li></ol>
see|sêe|sêwen	<i>noun</i><br><ol><li>sea</li></ol>
seelant|sêelant	<i>noun</i><br><ol><li>Zeeland (a county)</li></ol>
seem|sêem	<i>noun</i><br><ol><li>honey</li></ol>
seer|sêer	<i>adj</i><br><ol><li>painful, sore</li><li>sick</li></ol><br><i>noun</i><br><ol><li>pain, ache</li><li>sorrow, emotional pain</li></ol>
sege|sēge	<i>noun</i><br><ol><li>victory, triumph</li></ol>
segel|sēgel	<i>noun</i><br><ol><li>seal (stamp)</li><li>seal, closure of a space</li></ol>
seggen|segghen|seit|segge|secht|seide|segghene|seggene	<i>verb</i><br><ol><li>to say</li><li>to tell, to make known</li><li>to tell, to instruct</li><li>to say in writing, to write/be in writing</li><li>to call, to name</li></ol>
segghic	<i>abbrev</i><br><ol><li>Contraction of segge ic.</li></ol>
seidi	<i>abbrev</i><br><ol><li>Contraction of seide hi.</li></ol>
seiken	<i>verb</i><br><ol><li>to urinate</li></ol>
seil|segel|sēgel	<i>noun</i><br><ol><li>sail</li></ol>
seilen	<i>verb</i><br><ol><li>to sail</li></ol>
selve|selver	<i>pron</i><br><ol><li>self (myself, yourself etc.)</li></ol><br><i>adj</i><br><ol><li>same, particular</li></ol>
senden	<i>verb</i><br><ol><li>to send</li></ol>
senken	<i>verb</i><br><ol><li>to cause to sink</li></ol>
ser	<i>noun</i><br><ol><li>(title and pronoun) sir, lord</li></ol>
sere|sêre	<i>adv</i><br><ol><li>strongly, very, to a great degree</li><li>hard, forcefully</li><li>fast, with speed</li></ol>
ses	<i>num</i><br><ol><li>six</li></ol>
seste	<i>adj</i><br><ol><li>sixth</li></ol>
sestich	<i>num</i><br><ol><li>sixty</li></ol>
setten|settens|sets|set|sette|settene|settet|settes|settende	<i>verb</i><br><ol><li>to set, to place</li></ol>
seven|sēve|sēves|sēeft|sēef|sēvene|sēefs|sēven|sēvens|sēvende|sēvet	<i>num</i><br><ol><li>seven</li></ol><br><i>verb</i><br><ol><li>to sift, to sieve</li></ol>
sevende|sēvende	<i>adj</i><br><ol><li>seventh</li></ol>
seventich|sēventich	<i>num</i><br><ol><li>seventy</li></ol>
sever|sêver	<i>noun</i><br><ol><li>drool, saliva</li></ol>
severen|sêveren	<i>verb</i><br><ol><li>to drool</li></ol>
si|mijns|ju|sie|si|dijns|het|ghi|di|gi|haer|se|hij|it|es|dijn|ons|ic|hen|mijn|mi|wi|sijn|du|hit|u|hi|onse|uwe|hem|zi|et	<i>pron</i><br><ol><li>she</li><li>they (all genders)</li></ol>
sieden|sōdet|siedens|siedene|siedende|siedet|siede|siets|siet|sōot|sōdes|siedes|sōots|gesōden|sōde|sōden|sôot	<i>verb</i><br><ol><li>(transitive) to boil</li><li>(transitive) to prepare by boiling</li><li>(intransitive) to boil</li></ol>
siele|sielen	<i>noun</i><br><ol><li>soul</li></ol>
sien|sach|siën|saghen|siet|sâgen|sagen	<i>verb</i><br><ol><li>to see</li><li>to filter, to seep</li></ol>
sigen|sêech|siges|sēechs|sēget|sēge|sijchs|siget|sijch|sēecht|sēges|sighen|gesēgen|sēgen|sigene|sijcht|sigende|sigens|sige	<i>verb</i><br><ol><li>to sink, to drop</li><li>to drip out, to drain</li><li>to slope downwards</li></ol>
sijn|ziere|sijns|sijt|sinen|sine|zijn|zijt|siere	<i>det</i><br><ol><li>his</li><li>its</li></ol>
silver	<i>noun</i><br><ol><li>silver</li></ol>
sin|sinne|zin	<i>noun</i><br><ol><li>direction</li><li>attention</li><li>sense, intellect, reason</li><li>feeling, emotion</li><li>sense, perception</li><li>meaning</li></ol>
singen|sanc|songen|singens|singene|singes|sonct|sinct|sincs|songes|zinghen|singe|songet|zinghene|songe|sinc|gesongen|singende|soncs|singet	<i>verb</i><br><ol><li>to sing</li></ol>
sinken|sanc|sinkes|sonkes|sinkene|sonken|sinc|sinkende|sinke|sinkens|soncs|sinct|sonct|sinket|sonke|gesonken|sincs|sonket	<i>verb</i><br><ol><li>(intransitive) to sink (in water)</li><li>(intransitive) to drop, to go down</li><li>(intransitive) to collapse</li></ol>
sint|sent	<i>adv</i><br><ol><li>since then, from then onwards</li><li>afterwards</li></ol><br><i>conj</i><br><ol><li>after</li></ol>
sinter claes|sinter clâes	<i>name</i><br><ol><li>Saint Nicholas, Sinterklaas</li></ol>
sinxene|sinxen	<i>noun</i><br><ol><li>Pentecost</li></ol>
sise	<i>abbrev</i><br><ol><li>Contraction of si se.</li></ol>
sitten	<i>verb</i><br><ol><li>to sit, to be seated</li><li>to sit down</li><li>to settle (of a sore)</li><li>to be located, to be present</li><li>to reside, to live</li></ol>
slachten|slachtes|slachten|slachtene|slachts|slachte|slachtet|slacht|slachtens|slachtende	<i>verb</i><br><ol><li>to slaughter, to kill</li><li>to resemble, to look like (with dative or na)</li></ol>
slaen|slaes|sloeges|slaende|slaet|slâen|sloegen|sloechs|sloege|sloeget|gheslaghen|sloech|sla	<i>verb</i><br><ol><li>to hit, to strike</li></ol>
slange	<i>noun</i><br><ol><li>snake</li></ol>
slapen|sliept|slâept|sliepe|sliepes|slâpet|slâpende|geslâpen|sliepen|slâpen|sliep|slâpe|slâpens|slâpene|slâpes|sliepet|slâep|slâeps|slieps	<i>verb</i><br><ol><li>to sleep</li></ol>
slecke	<i>noun</i><br><ol><li>snail</li></ol>
slede|slēde	<i>noun</i><br><ol><li>sled, sleigh</li><li>any vehicle without wheels</li></ol>
slicken	<i>verb</i><br><ol><li>to swallow</li></ol>
slinken	<i>verb</i><br><ol><li>to cave, to collapse inwards (especially of the body)</li></ol>
slipen|slipene|geslēpen|slipes|slēpen|slēpet|slēept|slēeps|slipende|slipe|slipens|slijp|slijps|slēpes|slijpt|slēpe|slipet|slêep	<i>verb</i><br><ol><li>to sharpen</li><li>to grind, to abrade</li></ol>
sliten|slijt|slētet|slētes|slitens|slēets|slitet|slites|slēet|slēte|slijts|slite|slēten|geslēten|slêet|slitende|slitene	<i>verb</i><br><ol><li>to wear, to erode, to deteriorate with use, to slite</li><li>to tear apart, to destroy</li></ol>
slopen|slôpen	<i>verb</i><br><ol><li>to drag forth</li><li>to take apart, to dismantle</li></ol>
slotel|sluetel|slōtel	<i>noun</i><br><ol><li>key</li></ol>
sluten|slutens|slōots|geslōten|sluut|slutes|slute|slōtet|slutende|slōot|slōten|slutene|slutet|slôot|slōte|sluuts|slōtes	<i>verb</i><br><ol><li>to close, to shut</li><li>to close off</li><li>to lock up</li><li>to establish, to confirm</li><li>to end, to put an end to</li></ol>
smake|smāke	<i>noun</i><br><ol><li>taste, act of tasting</li><li>taste, flavour</li></ol>
smeden|smēden	<i>verb</i><br><ol><li>To forge.</li></ol>
smeken|smeeken|smêken	<i>verb</i><br><ol><li>to flatter, to sweet-talk</li></ol>
smelten	<i>verb</i><br><ol><li>(intransitive) to melt</li><li>(intransitive) to dissolve (in a liquid)</li><li>(intransitive) to defecate</li><li>(transitive) to melt, to make liquid</li><li>(transitive) to reform (into something else)</li><li>(transitive) to dissolve (in a liquid)</li></ol>
smerten	<i>verb</i><br><ol><li>(intransitive) to hurt, to smart</li></ol>
smit|smet|smits|smede|smeden	<i>noun</i><br><ol><li>smith</li></ol>
smiten|smijt|smētet|smêet|smitene|smijts|smitens|smites|smitet|smētes|smēte|smēten|gesmēten|smēet|smite|smitende|smēets	<i>verb</i><br><ol><li>to smite, to hit, to beat</li><li>to fling, to throw</li></ol>
smout	<i>noun</i><br><ol><li>melted animal fat</li><li>any type of oil or semi-liquid fat</li></ol>
smugen	<i>verb</i><br><ol><li>to creep, to sneak</li></ol>
snee|snêe	<i>noun</i><br><ol><li>snow</li></ol>
sneeclute|snêeclute	<i>noun</i><br><ol><li>snowball</li></ol>
sneevlocke|snêevlocke	<i>noun</i><br><ol><li>snowflake</li><li>snowball</li></ol>
snel|snelre	<i>adj</i><br><ol><li>fast, quick, rapid</li></ol>
sniden|snijts|snijt|gesnēden|snidene|snēden|snides|snidens|snēets|snēdet|snêet|snēde|snidet|snēet|snide|snēdes|snidende	<i>verb</i><br><ol><li>to cut</li><li>to cut short</li><li>to divide</li></ol>
snode|snôde	<i>adj</i><br><ol><li>poor, needy</li><li>paltry, of little value</li><li>bad, worthless</li><li>low in standing</li><li>lowly, despised</li><li>miserable, pitiful</li></ol>
snotte	<i>noun</i><br><ol><li>snot</li></ol>
snuten	<i>verb</i><br><ol><li>to blow one's nose</li></ol>
snuwen|snuwende|snuwes|snuus|snuut|snuwet|snuwene|snuwens|snuwe|snu	<i>verb</i><br><ol><li>to snow</li></ol>
so|sô|soe	<i>adv</i><br><ol><li>so, like that, in that manner</li><li>so, to such a degree</li><li>(so ... alse) as</li><li>then, in that case</li><li>so, therefore</li></ol><br><i>conj</i><br><ol><li>if, in the case that</li><li>like, as</li><li>(so ... so) both ... and</li></ol><br><i>pron</i><br><ol><li>(chiefly Flemish) Alternative form of si (“she”)</li></ol>
soe	<i>pron</i><br><ol><li>(Flemish) Alternative form of si (“feminine singular”)</li></ol>
soeken|soekens|soekene|soec|soucken|soeke|soekes|soect|soeket|soekende|soecs	<i>verb</i><br><ol><li>to seek, to look for</li><li>to seek to, to strive to</li></ol>
sogen|sôgen	<i>verb</i><br><ol><li>to breastfeed, to suckle</li><li>to imbue</li></ol>
solinus	<i>noun</i><br><ol><li>Gaius Julius Solinus</li></ol>
som	<i>det</i><br><ol><li>some</li></ol>
somer|sōmer|sômer	<i>noun</i><br><ol><li>summer</li><li>beast of burden, especially a horse</li><li>pack, case (which is loaded onto and carried by a horse)</li></ol>
somersch|sōmersch	<i>adj</i><br><ol><li>of the summer</li><li>summery</li></ol>
sonde	<i>noun</i><br><ol><li>sin, transgression</li></ol>
sonder|sonder [+accusative]	<i>prep</i><br><ol><li>without</li><li>except (for)</li></ol>
sone|sōne	<i>noun</i><br><ol><li>son</li></ol>
sonne	<i>noun</i><br><ol><li>sun</li><li>sunshine, sunlight</li></ol>
soom|sôom	<i>noun</i><br><ol><li>seam (of fabric)</li><li>edge, border in general</li></ol>
sorgen|sorget|zorghet	<i>verb</i><br><ol><li>to worry, to be concerned</li><li>to fear</li><li>to care for, to take care of (a sick person)</li><li>to make sure, to be involved/concerned</li></ol>
soudene	<i>abbrev</i><br><ol><li>Contraction of soude -ene.</li></ol>
soudens	<i>abbrev</i><br><ol><li>Contraction of souden es.</li></ol>
souten	<i>verb</i><br><ol><li>to salt</li></ol>
spaen	<i>noun</i><br><ol><li>piece of wood</li><li>wood chip</li></ol>
spannen|spant|spiens|spannens|spien|spans|spienen|spienes|spienet|spannes|spient|spannene|spannet|span|spannende|spanne|gespannen|spiene	
spelen|spēlen	<i>verb</i><br><ol><li>to play, to have fun</li><li>to play a game</li><li>to play (an instrument)</li></ol>
spellen	<i>verb</i><br><ol><li>to explain</li><li>to spell, to predict</li><li>to mean, to indicate</li><li>to spell (a word)</li></ol>
spere	<i>noun</i><br><ol><li>spear, lance</li><li>spearman, lancer</li></ol>
sperren	<i>verb</i><br><ol><li>to close off, to block</li><li>to stretch, to put tension on</li><li>to span, to spread</li></ol>
spinnen|spint|spont|sponne|gesponnen|spinnene|sponnet|spins|spin|spons|sponnen|span|spinnet|spinne|spinnende|sponnes|spinnens|spinnes	<i>verb</i><br><ol><li>to spin, to make yarn by twisting and winding fibres together</li><li>to spin (web, silk etc.)</li></ol>
spiten|spite|spijts|spitende|spitens|spitet|spites|spitene|spijt	<i>verb</i><br><ol><li>(late) to spite, to annoy, to anger</li><li>(late) to grief, to cause pain to</li></ol>
spliten|splitens|splijts|splēets|splēten|splites|splēet|splēte|splêet|splētes|splitende|splijt|splitet|splitene|gesplēten|splite|splētet	<i>verb</i><br><ol><li>to split</li></ol>
spoeden	<i>verb</i><br><ol><li>to speed, to go quickly</li><li>to hurry, to make haste</li></ol>
spoet	<i>noun</i><br><ol><li>progress, success, good outcome</li><li>luck, prosperity</li><li>speed, progressing fast, haste</li></ol>
spot	<i>noun</i><br><ol><li>joke, jest</li><li>mockery, derision</li></ol>
spotten	<i>verb</i><br><ol><li>to mock, to deride</li></ol>
spreken|sprēken	<i>verb</i><br><ol><li>to speak, to say</li><li>to speak/talk to</li></ol>
springen|sprincs|spranc|springene|spronges|spronct|sproncs|spronget|spronge|sprinct|sprinc|gesprongen|springende|springens|springet|springes|springe|sprongen	<i>verb</i><br><ol><li>to jump, to spring</li><li>to jump around, to dance</li><li>to explode into pieces, to shatter</li></ol>
sproeyen	<i>verb</i><br><ol><li>(rare) to spread, to disperse</li></ol>
spruten	<i>verb</i><br><ol><li>to sprout</li><li>to arise, to form</li></ol>
spuwen	<i>verb</i><br><ol><li>to spit, to spew</li><li>to vomit</li></ol>
staen|stâen	<i>verb</i><br><ol><li>to stand</li></ol>
staerblent|stāerblent	<i>adj</i><br><ol><li>(East Flemish) Alternative form of stāerblint</li></ol>
staerblint|stāerblint	<i>adj</i><br><ol><li>completely blind</li></ol>
stal	<i>noun</i><br><ol><li>(act of) standing</li><li>market stall</li><li>stable</li><li>leg of furniture or some other object</li><li>theft</li></ol>
stappen	<i>verb</i><br><ol><li>to step</li></ol>
stat	<i>noun</i><br><ol><li>place</li><li>position, station (of duty)</li><li>rank, status</li><li>space, room</li><li>city</li></ol>
stede|stēde	<i>noun</i><br><ol><li>(Flemish, Holland) Alternative form of stat</li></ol>
steen|stêen	<i>noun</i><br><ol><li>stone</li><li>stone house or castle</li><li>prison</li></ol>
steken|stâect|stēect|stac|stēket|stēke|stēkene|stēkens|stâket|stēkende|stēecs|stâkes|stec|stâken|stâke|stâecs|stēkes|stēec|stēken|gestōken	<i>verb</i><br><ol><li>to prick, sting</li><li>to stab, thrust (with a sharp instrument such as a dagger)</li><li>to stick, to push (into something)</li><li>to drive off, to chase away</li><li>to light (fire)</li><li>to place, to position, to bring</li></ol>
stelen|stēel|stâelt|gestōlen|stēels|stēlens|stēlet|stal|ghestolen|stâle|stâlen|stēlene|stēlende|stâels|stēlen|gestolen|stel|stēelt|stēle|stâlet|stēles|stâles	<i>verb</i><br><ol><li>to steal</li></ol>
stellen	
stemmen	<i>verb</i><br><ol><li>to stem, to stop, to block</li></ol>
stenen|stēnen	<i>verb</i><br><ol><li>to sigh, to groan</li></ol>
sterken	<i>verb</i><br><ol><li>to strengthen, to make/become stronger</li></ol>
sterre	<i>noun</i><br><ol><li>star</li></ol>
stert	<i>noun</i><br><ol><li>tail</li><li>behind, backside (of a human)</li><li>back part of something</li></ol>
sterven|sterf|gestorven|starf|storves|storve|sterves|stervende|storft|stervene|storvet|sterft|stervens|stervet|storven|storfs|sterfs|sterve	<i>verb</i><br><ol><li>to die</li></ol>
stichten	<i>verb</i><br><ol><li>to found, to build</li><li>to found, to institute</li><li>to cause</li><li>to undertake</li><li>to put into practice, to do</li></ol>
stide	<i>adj</i><br><ol><li>(chiefly Flemish) stiff, rigid</li></ol>
stigen|stigene|stige|stigens|stiget|stijch|stijchs|stēgen|stēge|stēges|stijcht|gestēgen|stiges|stēecht|stēget|stêech|stēechs|stigende	<i>verb</i><br><ol><li>to ascend, to climb</li></ol>
stinken|stonke|stinc|stonken|stonkes|stinkes|gestonken|stinkene|stinkens|stoncs|stinke|stonct|stinkende|stinket|stincs|stanc|stonket|stinct	<i>verb</i><br><ol><li>to stink, to smell bad</li><li>to be abhorrent</li></ol>
stoel	<i>noun</i><br><ol><li>chair, seat</li><li>throne</li></ol>
stoet	<i>noun</i><br><ol><li>procession</li></ol>
stoom|stôom	<i>noun</i><br><ol><li>steam</li></ol>
storen|stôren	<i>verb</i><br><ol><li>to disturb, to bother</li><li>to disturb, to distress</li><li>to confuse</li><li>to upset</li><li>to destroy</li></ol>
storm	<i>noun</i><br><ol><li>storm, violent weather</li><li>storm, heavy wind</li><li>storm, assault</li></ol>
stoten|stôten	<i>verb</i><br><ol><li>to push, to bump, to knock</li><li>to drive out, to eject</li><li>(reflexive) to be bothered</li></ol>
straffen	<i>verb</i><br><ol><li>to scold, to reprimand</li><li>to refute</li><li>to punish</li></ol>
strale|strâle	<i>noun</i><br><ol><li>arrow</li><li>stinger (of an insect)</li><li>point of a weapon</li><li>(rare) ray, beam</li></ol>
stralen|strâlen	<i>verb</i><br><ol><li>to shoot, to penetrate (originally with an arrow)</li><li>to sting, to prick (of insects)</li><li>to radiate</li></ol>
strate|strâte	<i>noun</i><br><ol><li>street, paved road</li></ol>
strecken	<i>verb</i><br><ol><li>to stretch, to stretch out</li><li>to spread</li><li>to stretch out (of land)</li><li>to reach</li><li>to suffice</li><li>to last (a certain time)</li></ol>
streke|strēke	<i>noun</i><br><ol><li>stroking</li><li>streak, stripe</li><li>strike, lash</li><li>ruse, trick, prank</li><li>measuring, measurement (of fabric)</li></ol>
stremmen	<i>verb</i><br><ol><li>to repel, to prevent</li><li>to staunch</li><li>to curdle</li></ol>
streven|strēven	<i>verb</i><br><ol><li>to strive</li><li>to struggle, to resist</li></ol>
striden|gestrēden|strēet|stridet|stridens|stride|strijts|stridene|strijt|stridende|strēets|strēde|strēden|strides|strēdes|strēdet|strêet	<i>verb</i><br><ol><li>to fight, to battle</li><li>to counter, to resist</li></ol>
striderinne	<i>noun</i><br><ol><li>female warrior; warrioress</li></ol>
striken|strēke|strēket|gestrēken|strikene|strēken|strijc|strijcs|strikende|strikens|strēkes|strēect|strikes|strēecs|strike|strijct|striket|strêec	<i>verb</i><br><ol><li>to stroke, to pass (something) over gently</li><li>to smoothen</li></ol>
striven	<i>verb</i><br><ol><li>to strive</li></ol>
stromen|strômen	<i>verb</i><br><ol><li>to stream, to flow</li></ol>
stroom|strôom	<i>noun</i><br><ol><li>A stream.</li></ol>
sturen	<i>verb</i><br><ol><li>to steer</li><li>to direct</li><li>to bring</li><li>to send</li><li>to lead, to guide</li></ol>
stuven	<i>verb</i><br><ol><li>to give off or throw up dust</li></ol>
suchten	<i>verb</i><br><ol><li>to sigh</li><li>to moan</li></ol>
sudersee|sudersêe	<i>noun</i><br><ol><li>Zuiderzee (a sea)</li></ol>
sugen|sugende|gesōgen|suuch|sōgen|suken|sugene|suges|suget|sōocht|suge|sōochs|sōges|suuchs|sugens|sōget|sôoch|suucht|sōge	<i>verb</i><br><ol><li>(transitive) to suck (up)</li><li>(transitive) to suck from, to suckle from</li><li>(intransitive) to suck, to suckle</li></ol>
sulc|sulker|sulke|sulken	<i>det</i><br><ol><li>such (a)</li><li>(substantive) such a person, such a thing</li><li>one or other, some</li></ol>
sullen|soude|souden|sal	<i>verb</i><br><ol><li>(auxiliary) must, to have to</li><li>(auxiliary, negated) may, be allowed to</li><li>(auxiliary) will, shall, be going to (future tense)</li><li>(auxiliary, in the past tense) to be about to (inchoative)</li><li>(modal auxiliary) indicates a possible or hypothetical situation</li><li>(modal auxiliary) indicates information garnered from a third party that may or may not be reliable</li></ol>
supen|supe|supens|sōpen|suupt|sōpet|suup|sōopt|sôop|supes|sōpe|suups|gesōpen|sōops|supene|supet|supende|sōpes	<i>verb</i><br><ol><li>to drink, to slurp</li></ol>
suster	<i>noun</i><br><ol><li>sister</li><li>sister, nun</li></ol>
sutfen	<i>noun</i><br><ol><li>Zutphen (a city and county in the modern Netherlands)</li></ol>
suver	<i>adj</i><br><ol><li>pure, uncontaminated</li><li>clean, spotless</li><li>morally pure</li><li>virgin</li></ol>
suveren	<i>verb</i><br><ol><li>to clean</li><li>to cleanse, to purify</li><li>to purge, to remove undesirable things from</li></ol>
swaer|swâer	<i>adj</i><br><ol><li>heavy</li></ol>
swager|swâger	<i>noun</i><br><ol><li>brother-in-law</li><li>son-in-law</li><li>father-in-law</li></ol>
swart	<i>adj</i><br><ol><li>black</li></ol>
sweer|swêer	<i>noun</i><br><ol><li>male in-law</li><li>father-in-law</li></ol>
sweet|swêet	<i>noun</i><br><ol><li>sweat, perspiration</li></ol>
swelgen|swelge|swolges|swolchs|geswolgen|swalch|swolgen|swelchs|swelges|swelgene|swelgende|swelgens|swolget|swelcht|swolcht|swelch|swelget|swolge	<i>verb</i><br><ol><li>to swallow</li><li>to devour</li></ol>
swellen	<i>verb</i><br><ol><li>to swell</li></ol>
swelten|swolt|swelte|swoltes|swelt|sweltende|sweltene|swelts|swolte|geswolten|swalt|sweltet|swolts|sweltens|swoltet|swolten|sweltes	<i>verb</i><br><ol><li>to succumb, to collapse</li><li>to be exhausted</li><li>to waste away</li></ol>
swemmen|swemmene|swemmet|swomt|swommet|swoms|swommen|geswommen|swemt|swam|swemme|swemmes|swems|swemmens|swommes|swomme|swem|swemmende	<i>verb</i><br><ol><li>(intransitive) to swim</li><li>(intransitive) to float</li><li>(intransitive, figuratively) to overflow, to have (a thing or feeling) in abundance</li></ol>
sweren|swēren	<i>verb</i><br><ol><li>to swear, to declare solemnly</li><li>to swear, to curse</li><li>to hurt, to be painful</li></ol>
swert|swaert	<i>noun</i><br><ol><li>A sword.</li><li>(figurative) A type of legal power or privilege.</li><li>The male line.</li></ol>
sweten|swêten	<i>verb</i><br><ol><li>to sweat, to perspire</li></ol>
swevel|swāvel|swavel|swēvel	<i>noun</i><br><ol><li>sulphur</li></ol>
sweven|swēven	<i>verb</i><br><ol><li>to move back and forth</li><li>to wander</li><li>to float (on water)</li><li>to float (through the air)</li><li>to remain, to be (in a particular state)</li></ol>
swigen|swēgen|swighen|geswēgen|swigene|swiges|swēge|swigende|swigens|swige|swijcht|swiget|swēecht|swijchs|swēget|swijch|swēechs|swēges|swêech	<i>verb</i><br><ol><li>not to speak, to be silent</li></ol>
swijn	<i>noun</i><br><ol><li>pig, swine</li></ol>
swiken|swijc|swikes|swēecs|geswēken|swiket|swikende|swijct|swēkes|swijcs|swikene|swêec|swēken|swēket|swēect|swikens|swēke|swike	<i>verb</i><br><ol><li>to fall short</li><li>(of night) to fall over, to come over</li><li>to give way, to succumb</li><li>to weaken, to exhaust</li></ol>
swinden	<i>verb</i><br><ol><li>to dwindle</li><li>to disappear</li></ol>
swingen|swinc|geswongen|swinget|swongen|swonges|swingene|swonge|swinges|swoncs|swingens|swonget|swanc|swinct|swonct|swinge|swingende|swincs	<i>verb</i><br><ol><li>(intransitive) to swing, to sway</li><li>(intransitive) to fall, to topple</li><li>(transitive) to swing, to sway</li><li>(transitive) to fling outwards</li></ol>
tachtich	<i>num</i><br><ol><li>eighty</li></ol>
taerte|tāerte	<i>noun</i><br><ol><li>pie, cake</li></ol>
tafele|tâfele	<i>noun</i><br><ol><li>table (flat surface with legs)</li><li>care for the poor</li><li>banker's table</li><li>wooden board</li><li>wax tablet for writing</li><li>plate, cover</li><li>table, list</li></ol>
taken|tāken	<i>verb</i><br><ol><li>to take, to grab</li><li>to get, to achieve</li></ol>
tale|tāle	<i>noun</i><br><ol><li>spoken or written words, that which someone says</li><li>language</li></ol>
talen|tālen	<i>verb</i><br><ol><li>to speak, to talk</li><li>to say</li><li>to tell, to narrate</li><li>to speak in court, to appeal</li><li>(eastern) to pay</li></ol>
te	<i>prep</i><br><ol><li>at, in (a place)</li><li>to, towards</li><li>at, during (a time)</li><li>for (the purpose of)</li><li>in accordance with</li><li>with, from (a means, such as language)</li><li>(with gerund) to, for</li></ol><br><i>adv</i><br><ol><li>very, particularly</li><li>too, to an excessive degree</li></ol>
tebreken|tebrēken	<i>verb</i><br><ol><li>to break apart</li><li>to break, to fracture (of body parts)</li><li>to break down, to destroy</li><li>to break (laws, promises, commandments etc)</li></ol>
tee|têe	<i>noun</i><br><ol><li>toe</li></ol>
teken|têken	<i>noun</i><br><ol><li>mark, sign</li><li>gesture</li><li>signal</li><li>sign, indication</li><li>mark, wound</li></ol>
tekenen|têkenen	<i>verb</i><br><ol><li>to mark, to put a mark or sign on</li><li>to brand (as punishment)</li><li>to draw, to paint</li><li>to write down, to annotate</li><li>to give a sign, to signal</li></ol>
telch	<i>noun</i><br><ol><li>branch of a tree</li><li>branch of an antler</li><li>branching of blood vessels, muscles and such</li><li>arm</li></ol>
telen|tēlen	<i>verb</i><br><ol><li>To bring forth, to produce.</li><li>To effect, to implement.</li><li>To cultivate, to foster, to raise (crops, young).</li><li>To till (land).</li></ol>
tellen	<i>verb</i><br><ol><li>to count, to calculate</li><li>to count as, to consider as</li><li>to tell, to say</li></ol>
temen|tēmen	<i>verb</i><br><ol><li>to fit</li><li>to suit, to look good (of clothes)</li></ol>
ten	<i>abbrev</i><br><ol><li>Contraction of te den.</li></ol>
ter	<i>abbrev</i><br><ol><li>Contraction of te der.</li></ol>
teren|tēren	<i>verb</i><br><ol><li>to consume, to use up</li><li>to eat</li><li>to digest</li></ol>
tes	<i>abbrev</i><br><ol><li>Contraction of te des.</li></ol>
tesamen|tesāmen	<i>adv</i><br><ol><li>together, with each other</li><li>at the same time, simultaneously</li><li>all in all, taken together</li><li>in the end</li><li>completely, thoroughly</li></ol>
tevoorst|tevōorst	<i>adv</i><br><ol><li>first and foremost</li></ol>
thoeft	<i>abbrev</i><br><ol><li>Contraction of dat hôoft.</li></ol>
tibeert|tibēert|tybeert	<i>noun</i><br><ol><li>A cat character in the story of Reynard the fox.</li></ol>
tien|tiën	<i>num</i><br><ol><li>ten</li></ol><br><i>verb</i><br><ol><li>to pull, draw</li><li>to go</li><li>to raise or nurture</li><li>to accuse, blame</li><li>to prosecute</li></ol>
tiende	<i>adj</i><br><ol><li>tenth</li></ol><br><i>noun</i><br><ol><li>tithe</li></ol>
tiger	<i>noun</i><br><ol><li>tiger</li></ol>
tijden	<i>noun</i><br><ol><li>dative singular</li><li>nominative/accusative/genitive/dative plural</li></ol>
tijt|tijden|tiden	<i>noun</i><br><ol><li>time (as a concept)</li><li>time, moment</li><li>right, appointed time</li><li>moment</li><li>period of time</li><li>life, lifetime</li></ol>
timmer	<i>noun</i><br><ol><li>building, construction (especially of wood)</li><li>act of building</li><li>material that a building is built out of</li></ol>
timmeren	<i>verb</i><br><ol><li>to build (especially out of wood)</li></ol>
tlaken	<i>abbrev</i><br><ol><li>Contraction of dat lāken.</li></ol>
toe	<i>adv</i><br><ol><li>to, towards</li><li>up to</li><li>until</li><li>in relation with</li><li>in addition, furthermore</li><li>shut, closed (especially the eyes)</li></ol><br><i>prep</i><br><ol><li>(eastern) Alternative form of te</li></ol>
tonen|tônen	<i>verb</i><br><ol><li>To show</li><li>To reveal, to lay bare</li><li>To demonstrate, to prove.</li></ol>
tonge	<i>noun</i><br><ol><li>tongue</li><li>speech, language</li></ol>
tote|tōte|toete	<i>prep</i><br><ol><li>up to, towards, to (a specific destination or point in time)</li><li>at (a specific point in time)</li><li>with respect to</li></ol>
tover|tôver	<i>noun</i><br><ol><li>(rare) magic, sorcery, spell</li></ol>
toveren|tôveren	<i>verb</i><br><ol><li>to perform magic</li></ol>
trachten	<i>verb</i><br><ol><li>to think of, to make up, to invent</li></ol>
traen|trâen	<i>noun</i><br><ol><li>moisture, liquid</li><li>tear (in the eye)</li><li>drop (of liquid)</li></ol>
trage|trâge	<i>adj</i><br><ol><li>slow, sluggish</li><li>slow, lazy</li><li>weak</li></ol>
tranen|trânen	<i>verb</i><br><ol><li>to tear, to shed tears</li><li>to be/become moist</li><li>to drip, to leak</li></ol>
trecken|tracken	<i>verb</i><br><ol><li>(transitive) to pull or draw to oneself</li><li>(intransitive) to go to another place</li></ol>
treden|terden|trēden	<i>verb</i><br><ol><li>to tread, to step</li><li>to tread/step on</li></ol>
trekere|trēkere	<i>noun</i><br><ol><li>crook, fraudster</li></ol>
trillen	<i>verb</i><br><ol><li>to tremble (especially of the voice)</li></ol>
trouwe	<i>noun</i><br><ol><li>sincerity, reliability, trustworthiness, honesty</li><li>firmness, unwaveringness</li><li>trust</li><li>word of honor</li><li>wedding vow</li></ol><br><i>adj</i><br><ol><li>faithful, loyal</li><li>trustworthy</li></ol>
trouwen|trouwet|trouwene|trouwes|trout|trouwen|trou|trous|trouwens|trouwende|trouwe	<i>verb</i><br><ol><li>to marry</li><li>to arrange the marriage of, to marry off</li><li>(rare) to trust</li></ol>
tsinen	<i>abbrev</i><br><ol><li>Contraction of te sinen.</li></ol>
tsinxen	<i>abbrev</i><br><ol><li>Contraction of te sinxen.</li></ol>
tusschen|tusschen [+accusative|dative]	<i>prep</i><br><ol><li>between (in place, time, value)</li><li>between (of a relation between one person and another)</li></ol>
twee|twêe|twe	<i>num</i><br><ol><li>two</li></ol>
twintich	<i>num</i><br><ol><li>twenty</li></ol>
twivel	<i>noun</i><br><ol><li>doubt, uncertainty</li><li>ambiguity</li><li>desperation, hopelessness</li></ol>
twivelen	<i>verb</i><br><ol><li>to doubt, to be uncertain</li><li>to hesitate</li></ol>
u|uwen|uwe|hu|huwe|huwen	<i>det</i><br><ol><li>your (plural)</li><li>your (singular, informal)</li></ol>
utrecht	<i>noun</i><br><ol><li>Utrecht (a city in the modern Netherlands)</li><li>Utrecht (a bishopric)</li></ol>
vader|vāder	<i>noun</i><br><ol><li>father</li></ol>
vaen|vâen	<i>verb</i><br><ol><li>to catch, to capture</li><li>to seize, to grab</li><li>to catch, to intercept (something in the air)</li><li>to imprison</li><li>to conquer (of a city)</li></ol>
vaert|vāert	<i>noun</i><br><ol><li>going</li><li>trip, journey</li><li>way, path</li><li>waterway</li><li>speed</li></ol>
vallen	<i>verb</i><br><ol><li>to fall</li><li>to drop</li><li>to let oneself fall, to throw oneself</li><li>to collapse</li><li>to fall, to occur, to happen</li><li>to fall, to be located, to be part</li></ol>
valsch|valschen	<i>adj</i><br><ol><li>untrustworthy, treacherous</li><li>false, not authentic</li><li>untrue</li><li>foul, unclean</li></ol>
van	<i>prep</i><br><ol><li>of</li><li>from (a place, person)</li><li>from (a time)</li><li>out of</li><li>from, out of, because of</li></ol>
vandic	<i>abbrev</i><br><ol><li>Contraction of vant ic.</li></ol>
varen|vâren|vāren	<i>verb</i><br><ol><li>to go, to fare, to travel</li><li>to go, to move</li><li>to leave, to depart</li><li>to go away, to disappear</li><li>to ride</li><li>to sail, to go by boat</li><li>(auxiliary) to go</li><li>to fear, to be afraid</li><li>to scare, to frighten</li></ol>
varwe	<i>noun</i><br><ol><li>colour</li><li>paint, dye</li></ol>
varwen	<i>verb</i><br><ol><li>to colour, to dye</li><li>to paint</li></ol>
vaste	<i>adv</i><br><ol><li>tightly, securely</li><li>reliably</li><li>with urge, with drive</li><li>strongly</li><li>fast, quickly, hastily</li></ol>
vasten	<i>verb</i><br><ol><li>to fast</li></ol>
vechten|vechtene|vochten|vechtens|gevochten|vechte|vacht|vechts|vocht|vochtet|vechtende|vechtet|vochte|vecht|vochtes|vochts|vechtes	<i>verb</i><br><ol><li>to fight</li><li>to battle</li></ol>
vee|vêe	<i>noun</i><br><ol><li>livestock (collectively)</li><li>animal of livestock</li></ol>
vegen|vēgen	<i>verb</i><br><ol><li>to sweep, to clean</li></ol>
vele|vēle	<i>pron</i><br><ol><li>many, much [+genitive = of]</li></ol><br><i>adv</i><br><ol><li>often</li><li>many times</li><li>very, strongly</li></ol>
velen|vēlen	<i>verb</i><br><ol><li>(rare) to endure, to bear, to tolerate</li></ol>
velge	<i>noun</i><br><ol><li>rim (of a wheel)</li></ol>
velseke	<i>noun</i><br><ol><li>Velzeke (a village)</li></ol>
vene|vēne	<i>noun</i><br><ol><li>mire, bog</li></ol>
venne	<i>noun</i><br><ol><li>mire, bog</li><li>wetland, marshy heath</li><li>(northern Brabant) small lake in a forest or heath</li></ol>
vensen	<i>verb</i><br><ol><li>to make up, to think of</li><li>to make up, to fantasize</li><li>to feign, to pretend</li><li>to lie</li></ol>
verbieden	<i>verb</i><br><ol><li>to prohibit</li><li>to deny, to refuse to give</li><li>to prevent, to act against</li><li>to announce publicly</li></ol>
verbiten|verbeet|verbêet	<i>verb</i><br><ol><li>to bite to pieces</li><li>to bite dead</li><li>to destroy</li></ol>
vercopen|vercôpen	<i>verb</i><br><ol><li>to sell</li><li>to sell out, to betray</li></ol>
verdragen|verdrāgen	<i>verb</i><br><ol><li>to carry, to transport</li><li>to lift up</li><li>to refuse, to reject</li><li>to postpone, to delay</li><li>to write off (a debt), to not collect</li><li>to endure, to bear, to suffer</li><li>to tolerate, to bear</li><li>to allow, to tolerate, to leave unpunished</li></ol>
verdrieten	<i>verb</i><br><ol><li>(intransitive) to be annoying</li><li>(intransitive) to feel reluctant to, to feel annoyed by [+genitive = thing]</li></ol>
vergelden	<i>verb</i><br><ol><li>to pay what is due</li><li>to reward</li><li>to pay back, to punish (for a bad deed)</li></ol>
vergeten|vergēten	<i>verb</i><br><ol><li>to forget</li></ol>
vergeven|vergēven|vergheven	<i>verb</i><br><ol><li>to forgive</li><li>to poison</li></ol>
verhoeren|verhoert	<i>verb</i><br><ol><li>to make into a whore, to dishonour</li><li>to cheat on (a man)</li></ol>
verlies	<i>noun</i><br><ol><li>loss, losing something</li><li>disadvantage</li><li>misery</li></ol>
verliesen|verloren|verlore|verloos|verloes|verlôos|verlōre|verlōren	<i>verb</i><br><ol><li>to lose (possession)</li><li>to lose, to be defeated</li><li>to ruin, to destroy</li></ol>
vermaledien|vermālediën|vermālendiën|vermalendien|vermalendyen	<i>verb</i><br><ol><li>to curse, to maledict</li></ol>
vernemen|vernēmen	<i>verb</i><br><ol><li>to pick up</li><li>to take in (into the mind, senses)</li><li>to see, to perceive</li><li>to notice</li><li>to hear (about), to learn of</li><li>to understand</li></ol>
vernoyen|vernōyen	<i>verb</i><br><ol><li>(impersonal or intransitive) to annoy, to bother</li><li>(impersonal or intransitive) to sadden</li></ol>
verre	<i>adv</i><br><ol><li>far, at great distance</li><li>far, towards a great distance</li><li>far into the future</li><li>far, to a great extent</li></ol><br><i>adj</i><br><ol><li>far, faraway, at great distance</li></ol>
versaken|versāken	<i>verb</i><br><ol><li>to deny</li><li>to disavow, to renounce</li></ol>
versamen|versāmen	<i>verb</i><br><ol><li>to gather, to come/bring together</li><li>to compose</li></ol>
verstaen|verstâen	<i>verb</i><br><ol><li>to be responsible for</li><li>to understand</li><li>to hear (what is being said)</li><li>to listen, to pay attention</li><li>to notice</li></ol>
verswigen|verswegen|verswēgen	<i>verb</i><br><ol><li>to be silent about</li><li>to conceal (information), to not reveal</li></ol>
vervaren|vervâren|vervāren	<i>verb</i><br><ol><li>to go away, to leave</li><li>to disappear</li><li>to perish</li><li>to spoil, to rot</li><li>to be ruined</li><li>to investigate</li><li>Synonym of vâren</li></ol>
verwerden	<i>verb</i><br><ol><li>to perish</li><li>to ruin</li></ol>
veste	<i>noun</i><br><ol><li>reliability</li><li>fortification, bulwark</li><li>castle, fort</li></ol>
vet	<i>adj</i><br><ol><li>fat, large (of humans or animals)</li><li>(rich in) fat</li><li>fatty, greasy</li><li>fertile, rich in nutrients (of land)</li></ol><br><i>noun</i><br><ol><li>fat</li><li>grease</li></ol>
viant	<i>noun</i><br><ol><li>enemy, opponent</li><li>devil</li><li>monster</li></ol><br><i>adj</i><br><ol><li>hostile, inimical</li></ol>
vier	<i>num</i><br><ol><li>four</li></ol><br><i>noun</i><br><ol><li>(Flemish, sometimes Brabant) Alternative form of vuur</li></ol>
vierde	<i>adj</i><br><ol><li>fourth</li></ol>
vieren	<i>verb</i><br><ol><li>to celebrate (a religious holiday), to fulfill the duties of a holiday</li><li>to take rest to celebrate</li><li>to rest, to take vacation</li><li>to rest, to wait, to delay</li></ol>
viertich	<i>num</i><br><ol><li>forty</li></ol>
vijf	<i>num</i><br><ol><li>five</li></ol>
vijfte	<i>adj</i><br><ol><li>fifth</li></ol>
vijftich	<i>num</i><br><ol><li>fifty</li></ol>
villen	<i>verb</i><br><ol><li>to skin (remove the skin from)</li></ol>
vilt	<i>noun</i><br><ol><li>felt</li></ol>
vinden|vont|vonden|vant|vinde|vondet|vindet|vindene|vindens|vint|vindes|vonts|gevonden|vondes|vonde|vindende|vints	<i>verb</i><br><ol><li>to find (after searching)</li><li>to find, to come across, to encounter</li><li>to discover</li><li>to judge, to deem</li><li>to think of, to come up with</li></ol>
vinger	<i>noun</i><br><ol><li>finger</li><li>finger, digit (unit of measure)</li></ol>
visch|fisches|fische|fisch|fischen	<i>noun</i><br><ol><li>fish</li></ol>
visschen	<i>verb</i><br><ol><li>to fish, to (try to) catch fish</li></ol>
vite|vijte	<i>noun</i><br><ol><li>life</li><li>lifestyle, more</li><li>life story</li></ol>
vlade|vlāde	<i>noun</i><br><ol><li>flat cake</li></ol>
vlaemsch|vlâemsch	<i>adj</i><br><ol><li>Flemish</li></ol>
vlaen|vlâen	<i>verb</i><br><ol><li>to flay, to skin</li></ol>
vlaendren|vlâendren	<i>noun</i><br><ol><li>Flanders (a county)</li></ol>
vlamme	<i>noun</i><br><ol><li>flame</li></ol>
vlechten|vlochten|vlechts|vlochts|vlacht|vlochtet|vlecht|vlochtes|vlechte|vlechtene|vlechtes|vlochte|vlechtens|vlocht|vlechtet|gevlochten|vlechtende	<i>verb</i><br><ol><li>to braid</li><li>to tangle together</li></ol>
vleder|vlēder	<i>noun</i><br><ol><li>wing</li></ol>
vledermuus|vlēdermuus	<i>noun</i><br><ol><li>bat (animal)</li></ol>
vleesch|vlêesch	<i>noun</i><br><ol><li>meat</li><li>flesh</li><li>body</li></ol>
vliegen|vliechs|vliecht|vlōgen|vlōget|vliegende|vlōocht|vlieget|gevlōgen|vlôoch|vliegens|vlōochs|vliege|vliegene|vlieges|vliech|vlōges|vlōge	<i>verb</i><br><ol><li>to fly</li><li>to soar</li><li>to move quickly</li></ol>
vlien	<i>verb</i><br><ol><li>to flee</li><li>to depart</li><li>to avoid</li></ol>
vlies	<i>noun</i><br><ol><li>fleece</li><li>thin skin, membrane (in a human)</li></ol>
vlieten|vlietene|vlōots|vlōtes|gevlōten|vliet|vlietet|vliets|vlôot|vlōten|vlietens|vlōot|vlōte|vlietende|vlōtet|vliete|vlietes	<i>verb</i><br><ol><li>to flow</li><li>to float</li><li>to swim</li><li>to travel over water (by boat)</li></ol>
vliten	<i>verb</i><br><ol><li>(reflexive) to make an effort [+genitive = towards]</li></ol>
vloeken	<i>verb</i><br><ol><li>to curse, to wish misfortune upon</li><li>to curse, to express discontent over</li></ol>
vloer	<i>noun</i><br><ol><li>ground</li><li>floor</li><li>floor, storey</li></ol>
vloet	<i>noun</i><br><ol><li>(act of) flowing</li><li>flow, stream</li><li>flood</li><li>high tide</li><li>water generally</li></ol>
vloeyen	<i>verb</i><br><ol><li>to flow</li><li>to flow from the body (of blood)</li><li>to be in abundance</li><li>to overflow, to be full</li></ol>
vloten|vlōten	<i>verb</i><br><ol><li>to flow</li><li>to float</li><li>to swim</li><li>to travel (over water, of a boat)</li></ol>
vlucht	<i>noun</i><br><ol><li>flight, escape</li><li>flight, act of flying</li><li>speed</li><li>swarm (of birds)</li></ol>
vluchten	<i>verb</i><br><ol><li>to bring to a safe place</li><li>to hide, to conceal</li><li>to flee, to hide oneself</li></ol>
voeden	<i>verb</i><br><ol><li>to feed</li><li>to raise (children)</li></ol>
voeder	<i>noun</i><br><ol><li>food, fodder (especially for animals)</li><li>lining</li><li>(cart)load, freight</li><li>large winebarrel</li></ol>
voederen	<i>verb</i><br><ol><li>to feed</li><li>to line, to cover the inner surface of</li></ol>
voegen	<i>verb</i><br><ol><li>to join, to unite</li><li>to fit, to adjust/align oneself [+ āne (object) = with]</li><li>to fit, to have the right size</li><li>to fit, to suit, to behoove</li></ol>
voelen	<i>verb</i><br><ol><li>to feel (by touch)</li><li>to feel, to experience a feeling</li><li>to feel, to have an opinion</li><li>to see, to understand</li></ol>
voeren	<i>verb</i><br><ol><li>to bring, to carry, to transport</li><li>to lead (a person)</li><li>to take (a person, under force)</li><li>to carry on one's person, to have on oneself</li><li>to carry out</li><li>to export, to bring out of the city or land</li></ol>
voet	<i>noun</i><br><ol><li>foot (bottom of the leg)</li><li>paw (foot of an animal)</li><li>foot, bottom part, base</li><li>foot, leg, support</li><li>foot (unit of measure)</li></ol>
vogel|vōgel	<i>noun</i><br><ol><li>bird</li></ol>
vol	<i>adj</i><br><ol><li>full</li><li>whole, complete</li></ol>
volc|folke|folcs|folken|folc	<i>noun</i><br><ol><li>people, folk</li></ol>
volgen	<i>verb</i><br><ol><li>to follow</li><li>to pursue</li><li>to follow (advice, rules, customs)</li><li>to follow (a judgement)</li><li>to follow, to come after</li></ol>
volschriven|vulscreven|volschreven|volschrēven	<i>verb</i><br><ol><li>(transitive) to describe completely, to the end</li><li>(transitive) to finish writing, to write completely</li></ol>
vore|voer|dative]|vōre|vōre [+accusative	<i>prep</i><br><ol><li>before, in front of</li><li>before (in time)</li><li>before, in preference to</li><li>against (as protection)</li><li>for, directed at, for the benefit of</li><li>for, in exchange for</li></ol><br><i>adv</i><br><ol><li>in front</li><li>before, earlier</li></ol><br><i>noun</i><br><ol><li>furrow</li><li>ditch, trench</li></ol>
vorke	<i>noun</i><br><ol><li>fork (pronged tool, sometimes for eating)</li><li>fork (in an object), branching, split</li></ol>
vorme	<i>noun</i><br><ol><li>form, shape, outward appearance</li><li>way, manner</li><li>manifestation, way in which something manifests</li></ol>
vormen	<i>verb</i><br><ol><li>to form, to create</li></ol>
vorst	<i>noun</i><br><ol><li>The frost, icy cold.</li></ol>
vort	<i>noun</i><br><ol><li>ford</li><li>escape route</li></ol>
vorten|vorte|vort|vortens|vortes|vortet|vorts|vortene|vortende	<i>verb</i><br><ol><li>to fart</li></ol>
vos	<i>noun</i><br><ol><li>fox, red fox</li></ol>
vossinne	<i>noun</i><br><ol><li>vixen, female fox</li></ol>
vouden	<i>verb</i><br><ol><li>to fold</li></ol>
vracht|vrecht	<i>noun</i><br><ol><li>payment for cargo</li><li>freight, load, cargo</li></ol>
vrachten	<i>verb</i><br><ol><li>To fraught</li></ol>
vrage	<i>noun</i><br><ol><li>question</li></ol>
vragen|vrâgen	<i>verb</i><br><ol><li>to ask</li><li>to ask for, to request</li><li>to ask a question</li></ol>
vrankerike	<i>noun</i><br><ol><li>France (a kingdom)</li></ol>
vrede|vrēden|vrēde	<i>noun</i><br><ol><li>peace</li></ol>
vresen|vrêsen	<i>verb</i><br><ol><li>to fear</li><li>to threaten, to endanger</li></ol>
vreten|vrēten	<i>verb</i><br><ol><li>to eat savagely or greedily</li></ol>
vrien|vriën	<i>verb</i><br><ol><li>to love</li><li>to propose, to declare one's love</li><li>to free, to release</li></ol>
vrient	<i>noun</i><br><ol><li>friend</li><li>ally</li><li>relative</li></ol><br><i>adj</i><br><ol><li>friendly</li></ol>
vriesen|gevrōren|vriesende|vriesene|vrieset|vriesens|vrōort|vrōret|vrôos|vrōre|vrōres|vrōors|vrōren|vriest|vrieses|vriese|vries	<i>verb</i><br><ol><li>(intransitive) to freeze</li></ol>
vroe|vroech	<i>adv</i><br><ol><li>early</li></ol><br><i>adj</i><br><ol><li>early</li></ol>
vrouwe	<i>noun</i><br><ol><li>lady, noblewoman</li><li>lady, any woman of prestige</li><li>woman in general</li></ol>
vrucht	<i>noun</i><br><ol><li>produce, product, profit</li><li>fruit</li><li>fetus</li></ol>
vruchten	<i>verb</i><br><ol><li>to fear</li></ol>
vrāge	<i>noun</i><br><ol><li>question</li></ol>
vulen	<i>verb</i><br><ol><li>to make/become foul, stinking, rotten</li><li>to become worthless</li></ol>
vullen	<i>verb</i><br><ol><li>to fill, to make full</li><li>to fulfill</li><li>to bring into practice</li></ol>
vulschriven|vulscriven	<i>verb</i><br><ol><li>(Flemish) Alternative form of volschriven</li></ol>
vuur	<i>noun</i><br><ol><li>fire</li><li>bonfire</li><li>passion</li></ol>
wachten|wacht	<i>verb</i><br><ol><li>to guard, to be on guard</li><li>to guard, to protect</li><li>to observe, to respect (a rule)</li><li>to wait</li></ol>
waden|wāden	<i>verb</i><br><ol><li>to go, to step</li><li>to wade</li><li>to flow</li><li>to penetrate (of a weapon)</li></ol>
waen|wâen	<i>noun</i><br><ol><li>hope, expectation</li><li>opinion, feeling, hunch (without evidence)</li><li>suspicion</li><li>doubt</li></ol>
waer|wâer|wāer	<i>adv</i><br><ol><li>(interrogative, relative) where, in which place</li><li>(interrogative, relative) to where</li><li>(interrogative, relative) from where, whither</li><li>(relative) wherever, anywhere that</li></ol><br><i>adj</i><br><ol><li>true, real, authentic</li></ol>
waernen|wāernen	<i>verb</i><br><ol><li>to equip, to provide with what is needed</li><li>to keep, to protect, to guard</li><li>to warn</li></ol>
wage|wâge	<i>noun</i><br><ol><li>weight</li><li>a certain weight, of which the exact value varied</li><li>weighing scale</li><li>weighhouse</li></ol>
wagen|wāgens|wâget|wâgens|waghen|wāgene|wāechs|wâgende|wāech|wâechs|wāecht|wâge|wagens|wāges|wāgen|wâgen|wâecht|wâges|wāget|wâech|wāge|wāgende|wâgene|wagene|wagenen	<i>noun</i><br><ol><li>A wagon, cart.</li></ol><br><i>verb</i><br><ol><li>To venture.</li><li>To weigh, to determine the weight of.</li></ol>
waken|wāect|wākens|wāken|wāec|wākes|wāecs|wāke|wākende|wākene|wāket	<i>verb</i><br><ol><li>(intransitive) to wake, to be awake</li><li>(intransitive) to not be or fall asleep, to stay awake</li><li>(intransitive) to awaken, to wake up</li><li>(transitive) to guard</li></ol>
walgen	<i>verb</i><br><ol><li>to be nauseated</li><li>to be abhorred</li></ol>
walken	<i>verb</i><br><ol><li>to knead</li></ol>
wallen	<i>verb</i><br><ol><li>to well up</li><li>to boil</li></ol>
walsch|walscher|walschs|walschen|walsche	<i>adj</i><br><ol><li>Wallonian, French, Romance</li><li>Wallonian/French-speaking</li></ol>
walvisch	<i>noun</i><br><ol><li>whale</li></ol>
wandelen	<i>verb</i><br><ol><li>to go back and forth</li><li>to walk</li><li>to wander, to travel</li><li>to dwell</li><li>to change</li></ol>
wanden	<i>verb</i><br><ol><li>(rare) to travel</li></ol>
wanen|wānen|wânen	<i>verb</i><br><ol><li>to expect</li><li>to think, to be of the opinion</li><li>to suspect</li><li>to wane</li></ol>
wanic	<i>abbrev</i><br><ol><li>Contraction of wâne ic.</li></ol>
want	<i>conj</i><br><ol><li>because, for</li></ol><br><i>noun</i><br><ol><li>A glove, mitten.</li></ol>
ware|wāren|wāre	<i>noun</i><br><ol><li>merchandise, product</li></ol>
warm	<i>adj</i><br><ol><li>warm, hot</li><li>warm, keeping the wearer warm (of clothes)</li><li>warm (of emotions)</li></ol>
wasschen	<i>verb</i><br><ol><li>to wash</li></ol>
wassen	<i>verb</i><br><ol><li>to grow, to wax</li><li>to increase</li></ol>
wat	<i>pron</i><br><ol><li>what</li></ol>
water|wāter	<i>noun</i><br><ol><li>water</li></ol>
wayen|wâyen	<i>verb</i><br><ol><li>to blow (of wind)</li></ol>
wech	<i>noun</i><br><ol><li>way, road, path</li><li>journey</li><li>direction, approach</li><li>way, manner</li></ol>
wecken	<i>verb</i><br><ol><li>to wake, to cause to wake up</li></ol>
wede|wêde|wēde	<i>noun</i><br><ol><li>dyer's woad (Isatis tinctoria)</li><li>bush, thicket</li></ol>
weder|wēder [+accusative|dative]|wēder	<i>prep</i><br><ol><li>against, in opposition to, counter to</li><li>contrary to</li></ol><br><i>adv</i><br><ol><li>back</li><li>again</li><li>against</li></ol><br><i>pron</i><br><ol><li>who/what of two</li><li>one of two, either of two</li><li>(with negation) neither of two</li></ol><br><i>conj</i><br><ol><li>either</li><li>neither</li><li>whether</li></ol><br><i>noun</i><br><ol><li>weather</li><li>storm, strong wind</li><li>air, sky</li><li>castrated ram, wether</li></ol>
wederlonen|wēderlônen	<i>verb</i><br><ol><li>to repay, to pay back</li></ol>
wee|wêe	<i>intj</i><br><ol><li>woe!</li></ol><br><i>adj</i><br><ol><li>unpleasant, painful</li></ol><br><i>noun</i><br><ol><li>pain</li></ol>
weec|wêec	<i>adj</i><br><ol><li>weak, soft</li></ol>
weerwolf|wēerwolf|weerwolven|weerwolve|weerwolfs	<i>noun</i><br><ol><li>werewolf</li></ol>
weetic	<i>abbrev</i><br><ol><li>Contraction of wêet ic.</li></ol>
wegen|wēgen	<i>verb</i><br><ol><li>to weigh, to have a certain weight</li><li>to weigh, to determine the weight of</li><li>to weigh, to consider</li></ol>
weke|wēke	<i>noun</i><br><ol><li>week</li></ol>
weken|wêken	<i>verb</i><br><ol><li>to soften, to make/become soft (generally through soaking)</li></ol>
wel|best|wāle|bēter|bat|wale|beter	<i>adv</i><br><ol><li>well</li></ol>
welc	<i>det</i><br><ol><li>which</li></ol>
wellen	<i>verb</i><br><ol><li>to well up</li><li>to boil</li></ol>
welp	<i>noun</i><br><ol><li>whelp</li></ol>
welven	<i>verb</i><br><ol><li>to vault, to arch, to roof over</li><li>to cover (under an arched object)</li></ol>
wenen|wêent|wêen|wênene|wênet|wênende|wênen|wêne|wênens|wêens|wênes	<i>verb</i><br><ol><li>to cry, to weep</li></ol>
wenken|wenkene|wenkes|wenket|wenc|wenke|wenkens|wenct|wencs|wenkende	<i>verb</i><br><ol><li>to sway</li><li>to forsake, to become unfaithful</li><li>to give a sign</li><li>to wink, to give a sign with the eyes</li></ol>
wenschen|wenscht|wensches|wenschens|wenschende|wensche|wenschs|wensch|wenschene|wenschet	<i>verb</i><br><ol><li>to wish, to desire</li><li>to wish, to hope (towards someone)</li></ol>
werden|wert|werdende|werdes|wordes|wordet|wart|wort|werdet|worden|geworden|werts|werde|worts|worde|werdene|werdens	<i>verb</i><br><ol><li>to become</li><li>to happen, to occur</li><li>to arise, to form</li></ol>
weren|wēren	<i>verb</i><br><ol><li>to hold back, to keep out, to resist</li><li>to prevent</li><li>to protect</li><li>to fight against, to oppose</li><li>to object (in court)</li><li>to refuse, to deny</li><li>to continue, to persist</li></ol>
werken	<i>verb</i><br><ol><li>to act</li><li>to work</li><li>to practice</li></ol>
wernen	<i>verb</i><br><ol><li>to refuse</li><li>to prevent</li></ol>
werpen|werpet|geworpen|werpens|werpe|worps|werpes|worpen|worpe|werp|werpende|warp|worpt|werpene|werps|werpt|worpet|worpes	<i>verb</i><br><ol><li>to throw</li><li>to cast off, to lose</li><li>to give birth (of animals)</li><li>to damage, to hurt by throwing something (such as stones)</li><li>to stone, to kill by throwing something (such as stones)</li></ol>
werren|werrende|wors|wert|worret|geworren|worren|werret|worre|war|wort|werrens|wers|werre|werres|werrene|worres|wer	<i>verb</i><br><ol><li>(transitive) to tangle, to bring into disarray</li><li>(transitive) to confuse</li><li>(transitive) to destroy</li><li>(transitive) to hinder</li><li>(intransitive) to damage, to harm [+dative]</li><li>(intransitive) to cause worry or pain</li><li>(intransitive) to quarrel, to dispute</li></ol>
wers	<i>adv</i><br><ol><li>worse</li></ol>
wert|wāert|waert	<i>noun</i><br><ol><li>host</li><li>innkeeper</li></ol>
werven|worvet|werft|geworven|worft|wervens|worfs|werf|wervet|werves|werve|worves|wervende|worven|worve|werfs|wervene|warf	<i>verb</i><br><ol><li>to work hard (towards a goal)</li><li>to make happen</li></ol>
wesel|wēsel	<i>noun</i><br><ol><li>weasel, least weasel</li></ol>
wesen|ziere|sijns|wēsen|sijt|sinen|sine|zijn|zijt|siere|sijn	<i>verb</i><br><ol><li>to be</li></ol>
weten|wēten	<i>verb</i><br><ol><li>to know (knowledge)</li><li>to know (person)</li><li>to get to know, to learn of, to be made aware of (a fact)</li><li>(auxiliary, with te) to be able to</li></ol>
weven|wēven	<i>verb</i><br><ol><li>to weave</li></ol>
wi|mijns|ju|sie|si|dijns|het|ghi|di|gi|haer|se|hij|it|es|dijn|ons|ic|hen|mijn|mi|wi|sijn|du|hit|u|hi|onse|uwe|hem|zi|et	<i>pron</i><br><ol><li>we</li></ol>
wie	<i>pron</i><br><ol><li>who</li></ol>
wiel	<i>noun</i><br><ol><li>wheel</li><li>maelstrom, vortex, bottomless spiral</li><li>hole caused by a break in a dyke</li></ol>
wien|wiën	<i>verb</i><br><ol><li>to bless, to sanctify</li><li>to consecrate</li><li>to dedicate</li></ol>
wigen|wijchs|wiges|wigens|wigende|wigene|wige|wiget|wijch|wijcht	<i>verb</i><br><ol><li>to fight, to battle, to war</li></ol>
wijf|wives	<i>noun</i><br><ol><li>woman</li><li>wife, married woman</li></ol>
wijn	<i>noun</i><br><ol><li>wine</li></ol>
wiken|wēken|wēect|wikende|wêec|wiket|wijcs|gewēken|wijct|wijc|wike|wēket|wēke|wikens|wikene|wēecs|wēkes|wikes	<i>verb</i><br><ol><li>to move away, to flee, to retreat</li><li>to yield, to make way, to make room</li></ol>
wildi	<i>abbrev</i><br><ol><li>Contraction of wilt gi.</li></ol>
wilen|wijlen	<i>adv</i><br><ol><li>before, in the past</li><li>once, at one time in the past</li><li>late, deceased</li><li>formerly</li></ol>
wileneer|wilenêre|wilenere|wilenêer	<i>adv</i><br><ol><li>in earlier times, formerly</li></ol>
wille	<i>noun</i><br><ol><li>will, wish</li><li>want, desire</li><li>inclination, disposition</li><li>what one desires, wants</li></ol>
willen|wilt|wilde|woude|wouden|wille	<i>verb</i><br><ol><li>to want, to desire</li><li>(auxiliary) to want to</li><li>to demand, to order</li></ol>
willic	<i>abbrev</i><br><ol><li>Contraction of wille ic.</li></ol>
winden|want|wont|gewonden|windes|wint|wondet|windende|windene|wondes|winde|wonden|wonde|windens|wints|windet|wonts	<i>verb</i><br><ol><li>to turn, to bend</li><li>to wring, to twist</li><li>to wrap</li><li>to wind</li><li>to lift, to hoist</li></ol>
winnen|winnene|wonnes|wons|winne|wont|ghewonnen|wonne|wins|wint|winnens|winnes|winnet|wonnet|wonnen|winnende|wan|win|gewonnen	<i>verb</i><br><ol><li>to win, to acquire through effort, to earn</li><li>to acquire, to get</li><li>to gain</li><li>to delve, to mine</li><li>to conquer, to take</li><li>(of a male) to beget (a child), to sire</li><li>(of a female) to give birth to</li></ol>
wint	<i>noun</i><br><ol><li>wind (movement of air)</li><li>cardinal direction</li><li>air</li><li>smell, odour</li><li>wind, flatulence</li></ol>
winter	<i>noun</i><br><ol><li>winter</li></ol>
wintercoude	<i>noun</i><br><ol><li>winter cold</li></ol>
winterdach	<i>noun</i><br><ol><li>winter day</li></ol>
wintersch	<i>adj</i><br><ol><li>of the winter</li><li>wintery</li></ol>
wise	<i>abbrev</i><br><ol><li>Contraction of wi se.</li></ol>
wisen|wisende|wisene|wijst|wise|wijs|wiset|wijsen|wises|wisens	<i>verb</i><br><ol><li>to point out, to indicate</li><li>to lead</li><li>to teach</li><li>to assign</li><li>to determine</li></ol>
wisschen	<i>verb</i><br><ol><li>to sweep (away), to clean</li></ol>
wissel	<i>noun</i><br><ol><li>swap, exchange</li><li>currency exchange</li><li>commission (for exchanging currency)</li></ol>
wisselen	<i>verb</i><br><ol><li>to swap, to exchange</li><li>to confuse</li><li>to change</li></ol>
wit	<i>adj</i><br><ol><li>white</li><li>clean</li><li>pale (of skin)</li></ol>
witen|gewēten|wêet|wētet|witende|wijt|wites|wēte|wēets|witene|witet|wite|wijts|wētes|witens|wēten|wēet	<i>verb</i><br><ol><li>to blame, to hold accountable</li><li>to cause harm</li></ol>
woe	<i>adv</i><br><ol><li>(eastern) Alternative form of hoe</li></ol>
wolf|wolve|wolfs|wolven	<i>noun</i><br><ol><li>wolf, grey wolf</li></ol>
wolke	<i>noun</i><br><ol><li>cloud</li></ol>
wonen|wōnen	<i>verb</i><br><ol><li>to live, to have a home</li><li>to remain, to dwell</li></ol>
worst	<i>noun</i><br><ol><li>sausage</li></ol>
wort|wōort|woort	<i>noun</i><br><ol><li>word</li><li>diction, what someone says or writes</li><li>prescription, order</li></ol>
wortele	<i>noun</i><br><ol><li>root (of a plant)</li><li>edible root</li></ol>
wouden	
wout	<i>noun</i><br><ol><li>forest</li></ol>
wreken|wrēken	<i>verb</i><br><ol><li>to avenge</li><li>to punish</li></ol>
wringen|wringes|wringens|gewrongen|wronges|wrinct|wrongen|wronct|wranc|wrinc|wringene|wringende|wringet|wringe|wronget|wroncs|wronge|wrincs	<i>verb</i><br><ol><li>(transitive) to wring</li><li>(transitive) to wrest</li><li>(transitive) to twist</li><li>(intransitive) to wrestle, to struggle</li></ol>
writen|wrijts|wrētet|writens|wrēet|gewrēten|writet|wrēte|wrēets|writes|wrēten|wrêet|wrētes|writende|write|writene|wrijt	<i>verb</i><br><ol><li>to turn, to twist</li><li>to wrap</li></ol>
wriven|wrijf|wrijft|wrēves|wrēve|wrivende|wrēeft|gewrēven|wrēven|wrive|wrijfs|wrivet|wrives|wrivene|wrêef|wrēvet|wrivens|wrēefs	<i>verb</i><br><ol><li>(transitive) to rub</li></ol>
wroegen|wroegene|wroughene	<i>verb</i><br><ol><li>to make known, to reveal</li><li>to bring a charge (for judgement)</li><li>to accuse, to sue</li><li>to torment, to torture</li><li>to condemn, to disapprove of</li></ol>
wroeten	<i>verb</i><br><ol><li>to root, to grub</li></ol>
zorghet	<i>verb</i><br><ol><li>third-person singular present indicative</li><li>second-person plural present indicative/subjunctive</li><li>plural imperative</li></ol>
zwijghics	<i>abbrev</i><br><ol><li>Contraction of swige ic es.</li></ol>
ûre	<i>noun</i><br><ol><li>hour</li></ol>
