ᄀᆞᄅᆞᄫᅵ|kòlòWí|ᄀᆞᄅᆞᄫᅵ〮	<i>noun</i><br><ol><li>drizzle (light rain)</li></ol>
ᄀᆞᄅᆞᆷ|kòlóm|ᄀᆞᄅᆞᆷ〮|ᄀᆞᄅᆞ〮매〮	<i>noun</i><br><ol><li>river</li><li>lake</li></ol>
ᄀᆞᄅᆞ치다|ᄀᆞᄅᆞ치〮거〮시다〮|ᄀᆞᄅᆞ치〮시ᄂᆞᆫ〮|ᄀᆞᄅᆞ치〮면〮|ᄀᆞᄅᆞ치〮ᄂᆞᆫ고〮|ᄀᆞᄅᆞ치〮리〮ᅌᅵ다〮|ᄀᆞᄅᆞ치〮시ᄂᆞ〮니라〮|ᄀᆞᄅᆞ치〮다〮|ᄀᆞᄅᆞ치〮던고〮|ᄀᆞᄅᆞ쵸〮마〮|ᄀᆞᄅᆞ치〮며〮|ᄀᆞᄅᆞ치〮뇨〮|ᄀᆞᄅᆞ치〮노라〮|ᄀᆞᄅᆞ쳐〮|ᄀᆞᄅᆞ치〮시ᄂᆞ〮ᅌᅵ다〮|ᄀᆞᄅᆞ치〮니〮ᅌᅵᆺ고〮|ᄀᆞᄅᆞ쵸〮려〮|ᄀᆞᄅᆞ치〮ᄂᆞ니〮ᅌᅵ다〮|ᄀᆞᄅᆞ치〮니라〮|ᄀᆞᄅᆞ쵸〮리라〮|ᄀᆞᄅᆞ치〮ᄂᆞ〮ᅌᅵ다〮|ᄀᆞᄅᆞ치〮ᄂᆞᆫ다〮|ᄀᆞᄅᆞ치〮시〮ᄂᆞ니〮ᅌᅵ다〮|kòlòchítá|ᄀᆞᄅᆞ치〮ᄂᆞ〮니라〮|ᄀᆞᄅᆞ치〮시니〮ᅌᅵ다〮|ᄀᆞᄅᆞ치〮니〮ᅌᅵᆺ가〮|ᄀᆞᄅᆞ치〮니〮|ᄀᆞᄅᆞ치ᇙ〮다〮|ᄀᆞᄅᆞ치〮ᄂᆞᆫ가〮|ᄀᆞᄅᆞ치〮ᄂᆞ니〮ᅌᅵᆺ가〮|ᄀᆞᄅᆞ친〮다〮|ᄀᆞᄅᆞ치예〮라〮|ᄀᆞᄅᆞ친〮|ᄀᆞᄅᆞ치〮ᅌᅵ다〮|ᄀᆞᄅᆞ치〮거ᄂᆞᆯ〮|ᄀᆞᄅᆞ치〮더라〮|ᄀᆞᄅᆞ치ᇙ〮가〮|ᄀᆞᄅᆞ치〮져〮|ᄀᆞᄅᆞ치〮더〮니라〮|ᄀᆞᄅᆞ치〮시〮ᅌᅵ다〮|ᄀᆞᄅᆞ치〮더시〮ᅌᅵ다〮|ᄀᆞᄅᆞ칠〮ᄊᆡ〮|ᄀᆞᄅᆞ치〮려〮|ᄀᆞᄅᆞ치〮거〮시니〮ᅌᅵ다〮|ᄀᆞᄅᆞ치〮시〮ᄂᆞ다〮|ᄀᆞᄅᆞ치〮쇼셔〮|ᄀᆞᄅᆞ친〮고〮|ᄀᆞᄅᆞ치〮건댄〮|ᄀᆞᄅᆞ치〮료〮|ᄀᆞᄅᆞ치〮과뎌〮 (kòlòchíkwàtyé, desires other's action)|ᄀᆞᄅᆞ쵸〮라〮|ᄀᆞᄅᆞ치〮리〮ᅌᅵᆺ가〮|ᄀᆞᄅᆞ치〮더녀〮|ᄀᆞᄅᆞ치〮다가〮|ᄀᆞᄅᆞ치〮돗다〮|ᄀᆞᄅᆞ치〮관ᄃᆡ〮|ᄀᆞᄅᆞ치〮ᄂᆞᆫ〮|ᄀᆞᄅᆞ치〮시〮니라〮|ᄀᆞᄅᆞ치〮시다〮|ᄀᆞᄅᆞ치〮리〮ᅌᅵᆺ고〮|ᄀᆞᄅᆞ치〮거시〮니라〮|ᄀᆞᄅᆞ치〮거든〮|ᄀᆞᄅᆞ쵸〮ᄃᆡ〮|ᄀᆞᄅᆞ치〮ᄂᆞ뇨〮|ᄀᆞᄅᆞ치〮건〮마ᄅᆞᆫ〮|ᄀᆞᄅᆞ치〮녀〮|ᄀᆞᄅᆞ치예〮ᅌᅵ다〮|ᄀᆞᄅᆞ치〮고져〮|ᄀᆞᄅᆞ치〮시리〮ᅌᅵ다〮|ᄀᆞᄅᆞ치〮더〮시니〮ᅌᅵ다〮|ᄀᆞᄅᆞ치〮사〮ᅌᅵ다〮|ᄀᆞᄅᆞ치〮시〮리라〮|ᄀᆞᄅᆞ치〮던가〮|ᄀᆞᄅᆞ치〮거시〮ᅌᅵ다〮|ᄀᆞᄅᆞ칠〮쎠〮|ᄀᆞᄅᆞ치〮던다〮|ᄀᆞᄅᆞ쵸〮ᅌᅵ다〮|ᄀᆞᄅᆞ치〮다라〮|ᄀᆞᄅᆞ치〮신〮|ᄀᆞᄅᆞ치〮니〮ᅌᅵ다〮|ᄀᆞᄅᆞ치〮ᄂᆞ녀〮|ᄀᆞᄅᆞ치〮더시〮니라〮|ᄀᆞᄅᆞ치〮라〮|ᄀᆞᄅᆞ친〮대〮|ᄀᆞᄅᆞ치〮시ᇙ〮|ᄀᆞᄅᆞ치〮고라〮|no separate forms|ᄀᆞᄅᆞ쵼〮|ᄀᆞᄅᆞ치〮리라〮|ᄀᆞᄅᆞ치〮ᄂᆞ니〮ᅌᅵᆺ고〮|ᄀᆞᄅᆞ쵸〮리〮ᅌᅵ다〮|ᄀᆞᄅᆞ치〮도다〮|ᄀᆞᄅᆞ친〮ᄃᆞᆯ〮|ᄀᆞᄅᆞ친〮가〮|ᄀᆞᄅᆞ치ᇙ〮고〮|ᄀᆞᄅᆞ치〮샴〮|ᄀᆞᄅᆞ치〮고〮|ᄀᆞᄅᆞ치〮노〮ᅌᅵ다〮|ᄀᆞᄅᆞ춈〮|ᄀᆞᄅᆞ치ᇙ〮|ᄀᆞᄅᆞ치〮논〮|ᄀᆞᄅᆞ치〮더〮시다〮|ᄀᆞᄅᆞ친〮뎌〮|ᄀᆞᄅᆞ치〮ᄂᆞ다〮|ᄀᆞᄅᆞ치〮나〮|ᄀᆞᄅᆞ치〮더뇨〮|ᄀᆞᄅᆞ쵸ᇙ〮	<i>verb</i><br><ol><li>to point towards</li><li>to teach</li><li>to command</li></ol>
ᄀᆞᅀᆞᆶ|ᄀᆞᅀᆞᆯᄒᆡ〮|ᄀᆞᅀᆞᆯ|kòzòlh|kozol	<i>noun</i><br><ol><li>autumn, fall</li></ol>
ᄀᆞᆫ쟈ᇰ|koncyang	<i>noun</i><br><ol><li>soy sauce made from soybean</li></ol>
ᄀᆞᆲ|kolp	<i>noun</i><br><ol><li>fold; layer</li></ol>
ᄀᆞᆲ다|ᄀᆞᆯᄫᅡ〮|ᄀᆞᆲ〯ᄉᆞᆸ〯ᄂᆞ〮니라〮|ᄀᆞᆲ〯더녀〮|ᄀᆞᆯᄫᆞᆫ〮가〮|ᄀᆞᆯᄫᆞᆫ〮고〮|ᄀᆞᆯᄫᆞ〮시〮리라〮|ᄀᆞᆲ〯과뎌〮 (kǒlpkwàtyé, desires other's action)|ᄀᆞᆲ〯ᄂᆞ녀〮|ᄀᆞᆯᄫᅢ〮라〮|ᄀᆞᆯᄫᆞ〮시〮ᄂᆞ다〮|ᄀᆞᆯᄫᆞ〮리〮ᅌᅵ다〮|ᄀᆞᆲ〯돗다〮|ᄀᆞᆯᄫᅩ〮려〮|ᄀᆞᆯᄫᆞ〮쇼셔〮|ᄀᆞᆯᄫᅩ〮ᅌᅵ다〮|ᄀᆞᆯᄫᆞ〮뇨〮|ᄀᆞᆯᄫᅩ〮마〮|ᄀᆞᆲ〯다라〮|ᄀᆞᆯᄫᆞᆫ〮뎌〮|ᄀᆞᆯᄫᆞᆯ〮ᄊᆡ〮|ᄀᆞᆲ〯논〮|ᄀᆞᆲ〯ᄂᆞ〮니라〮|ᄀᆞᆲ〯ᄂᆞᆫ다〮|ᄀᆞᆲ〯ᄉᆞᄫᅡ〮니라〮|ᄀᆞᆲ〯더〮시니〮ᅌᅵ다〮|ᄀᆞᆯᄫᆞ〮료〮|ᄀᆞᆲ〯더시〮니라〮|ᄀᆞᆯᄫᆞᆫ〮대〮|ᄀᆞᆯᄫᆞ〮니〮|ᄀᆞᆯᄫᆞ〮시ᇙ〮|ᄀᆞᆯᄫᆞ〮면〮|ᄀᆞᆯᄫᅩ〮라〮|ᄀᆞᆲ〯다〮|ᄀᆞᆲ〯더라〮|ᄀᆞᆲ〯ᄉᆞᄫᆞ〮리라〮|ᄀᆞᆲ〯노〮ᅌᅵ다〮|ᄀᆞᆯᄫᆞᆫ〮다〮|ᄀᆞᆯᄫᅩᆷ〮|ᄀᆞᆲ〯고져〮|ᄀᆞᆯᄫᆞᇙ〮가〮|ᄀᆞᆯᄫᆞ〮며〮|ᄀᆞᆲ〯건댄〮|ᄀᆞᆲ〯고〮|ᄀᆞᆯᄫᆞ〮녀〮|ᄀᆞᆯᄫᅩ〮리〮ᅌᅵ다〮|ᄀᆞᆲ〯거시〮ᅌᅵ다〮|ᄀᆞᆲ〯ᄂᆞ니〮ᅌᅵ다〮|ᄀᆞᆲ〯더시〮ᅌᅵ다〮|ᄀᆞᆲ〯던다〮|ᄀᆞᆲ〯도다〮|ᄀᆞᆲ〯거〮시다〮|ᄀᆞᆲ〯다가〮|ᄀᆞᆯᄫᆞ〮라〮|ᄀᆞᆯᄫᆞ〮니라〮|ᄀᆞᆲ〯고라〮|kǒlptá|ᄀᆞᆲ〯노라〮|ᄀᆞᆲ〯ᄉᆞᆸ〯ᄂᆞ다〮|ᄀᆞᆯᄫᆞ〮신〮|ᄀᆞᆲ〯져〮|ᄀᆞᆯᄫᅩ〮ᄃᆡ〮|ᄀᆞᆯᄫᆞ〮려〮|ᄀᆞᆯᄫᅩ〮리라〮|ᄀᆞᆯᄫᆞ〮샴〮|ᄀᆞᆲ〯ᄂᆞ니〮ᅌᅵᆺ가〮|ᄀᆞᆲ〯ᄉᆞᆸ〯다〮|ᄀᆞᆯᄫᆞ〮시ᄂᆞ〮니라〮|ᄀᆞᆲ〯사〮ᅌᅵ다〮|ᄀᆞᆲ〯ᄂᆞ다〮|ᄀᆞᆲ〯더〮니라〮|ᄀᆞᆯᄫᆞ〮니〮ᅌᅵᆺ고〮|ᄀᆞᆯᄫᆞ〮시니〮ᅌᅵ다〮|ᄀᆞᆯᄫᆞ〮나〮|ᄀᆞᆲ〯ᄉᆞᄫᆞ〮니라〮|ᄀᆞᆯᄫᆞᇙ〮다〮|ᄀᆞᆯᄫᅩᇙ〮|ᄀᆞᆯᄫᆞ〮니〮ᅌᅵᆺ가〮|ᄀᆞᆲ〯거시〮니라〮|ᄀᆞᆲ〯더뇨〮|ᄀᆞᆲ〯ᄂᆞ뇨〮|ᄀᆞᆯᄫᆞ〮시ᄂᆞᆫ〮|ᄀᆞᆯᄫᆞ〮니〮ᅌᅵ다〮|ᄀᆞᆯᄫᆞᆫ〮|ᄀᆞᆲ〯ᄉᆞᆸ〯더〮니라〮|ᄀᆞᆯᄫᆞ〮ᅌᅵ다〮|ᄀᆞᆲ〯ᄉᆞᄫᅡ〮다〮|ᄀᆞᆯᄫᆞᆫ〮ᄃᆞᆯ〮|ᄀᆞᆯᄫᅩᆫ〮|ᄀᆞᆯᄫᅢ〮ᅌᅵ다〮|ᄀᆞᆲ〯건〮마ᄅᆞᆫ〮|ᄀᆞᆲ〯ᄂᆞᆫ〮|ᄀᆞᆯᄫᆞᇙ〮고〮|ᄀᆞᆲ〯거〮시니〮ᅌᅵ다〮|ᄀᆞᆯᄫᆞ〮시ᄂᆞ〮ᅌᅵ다〮|no separate forms|ᄀᆞᆯᄫᆞᆯ〮쎠〮|ᄀᆞᆯᄫᆞ〮리〮ᅌᅵᆺ고〮|ᄀᆞᆲ〯던가〮|ᄀᆞᆯᄫᆞ〮리라〮|ᄀᆞᆲ〯거든〮|ᄀᆞᆯᄫᆞ〮시다〮|ᄀᆞᆯᄫᆞᇙ〮|ᄀᆞᆯᄫᆞ〮시〮ᅌᅵ다〮|ᄀᆞᆲ〯ᄂᆞᆫ가〮|ᄀᆞᆲ〯관ᄃᆡ〮|ᄀᆞᆲ〯더〮시다〮|ᄀᆞᆯᄫᆞ〮시〮ᄂᆞ니〮ᅌᅵ다〮|ᄀᆞᆲ〯ᄂᆞᆫ고〮|ᄀᆞᆯᄫᆞ〮시〮니라〮|ᄀᆞᆯᄫᆞ〮시리〮ᅌᅵ다〮|ᄀᆞᆲ〯던고〮|ᄀᆞᆯᄫᆞ〮리〮ᅌᅵᆺ가〮|ᄀᆞᆲ〯ᄂᆞ〮ᅌᅵ다〮|ᄀᆞᆲ〯거ᄂᆞᆯ〮|ᄀᆞᆲ〯ᄂᆞ니〮ᅌᅵᆺ고〮|ᄀᆞᆲ〯ᄉᆞᆸ〯더라〮	<i>verb</i><br><ol><li>(transitive) to make parallel</li><li>(intransitive) to be equal</li></ol>
ᄀᆞᆷᄌᆞᆨ|komcok|금즉|kumcuk	<i>noun</i><br><ol><li>while closing one's eyes</li><li>budgingly; while moving one's body in a single motion</li><li>shockedly; in an emotionally agitated manner</li></ol>
ᄀᆞᆷ다|komta	<i>verb</i><br><ol><li>to close one's eyes</li><li>to wash oneself; to bathe</li></ol>
ᄀᆞᆺ다|kǒztá|ᄀᆞᇫ다|kǒstá|ᄀᆞᅀᅡ〮|ᄀᆞᇫ〯다〮|ᄀᆞᆺ〯다〮|ᄀᆞᅀᆞ〮니〮	<i>verb</i><br><ol><li>to cut</li></ol>
ᄀᆞᇫ|ᄀᆞᇫ〯|ᄀᆞ〯ᅀᅢ〮|ᄀᆞᆺ|ᄀᆞᆺ〯|kǒs|ᄀᆞ〯ᅀᆡ〮|kǒz	<i>noun</i><br><ol><li>edge; boundary</li></ol>
ᄀᆞᇫ애|kòzGáy|ᄀᆞᇫ애〮	<i>noun</i><br><ol><li>scissors</li></ol>
ᄀᆞ옳|ᄀᆞ올|ᄀᆞ올ᄒᆡ〮|kòwòl|kòwòlh|ᄀᆞ올해〮	<i>noun</i><br><ol><li>(geographic) district</li></ol>
ᄀᆞ티|kothi	<i>adv</i><br><ol><li>with, together</li></ol>
ᄀᆡ약고|koyyakkwo	<i>noun</i><br><ol><li>gayageum, A long zither with bridges and between 12 and 25 strings; used primarily in Korean traditional and classical music.</li></ol>
ᄂᆞᄆᆞᆶ|nòmòlh	<i>noun</i><br><ol><li>edible plants; greens; herbs</li></ol>
ᄂᆞᆶ|ᄂᆞᆯ|ᄂᆞᆯ〮|ᄂᆞᆯ해〮|nól|nólh|ᄂᆞᆶ〮	<i>noun</i><br><ol><li>blade, edge</li></ol>
ᄂᆞᆾ|ᄂᆞᄎᆡ〮|nòs|ᄂᆞᆺ|nòch	<i>noun</i><br><ol><li>face</li></ol>
ᄂᆞ올|nowol	<i>noun</i><br><ol><li>poison</li></ol>
ᄂᆡᅀᅵᆯ|noyzil	<i>noun</i><br><ol><li>tomorrow</li></ol>
ᄃᆞᆯ|tól|ᄃᆞᆯ〮|ᄃᆞ〮래〮	<i>noun</i><br><ol><li>moon</li><li>month</li></ol>
ᄃᆞᆺ다|tǒstá|ᄃᆞᅀᆞ〮니〮|ᄃᆞᅀᅡ〮|tozta|ᄃᆞᇫ다|ᄃᆞᆺ〯다〮	<i>verb</i><br><ol><li>to love, especially non-romantically or excessively</li><li>to long for</li></ol><br><i>adj</i><br><ol><li>to be warm</li></ol>
ᄃᆞ리다|ᄃᆞ리〮다〮|ᄃᆞ리〮니〮|ᄃᆞ려〮|tòlítá	<i>verb</i><br><ol><li>(transitive) to bring along, to take with oneself</li></ol>
ᄆᆞᅀᆞᆶ|mòzòlh|ᄆᆞᅀᆞᆯᄒᆡ〮|ᄆᆞᅀᆞᆯ해〮	<i>noun</i><br><ol><li>village</li></ol>
ᄆᆞᅀᆞᆷ|mozom	<i>noun</i><br><ol><li>mind, heart (emotional state)</li><li>heart (physical organ)</li></ol>
ᄆᆞ니다|ᄆᆞ니〮면〮|ᄆᆞ니〮고〮|ᄆᆞ녀〮|ᄆᆞ니〮다〮|mònítá	<i>verb</i><br><ol><li>to touch (with the hand)</li></ol>
ᄆᆡᅀᅵᆯ|moyzil	<i>adv</i><br><ol><li>every day</li></ol><br><i>noun</i><br><ol><li>every day</li></ol>
ᄆᆡᆸ다|mòyptá|ᄆᆡᆸ다〮	<i>adj</i><br><ol><li>(to be) spicy, hot</li><li>(to be) fierce</li></ol>
ᄆᆡᇰᄀᆞ다|mòyngkóltá|ᄆᆡᇰᄀᆞ〮라〮|ᄆᆡᇰᄀᆞ〮다〮|ᄆᆡᇰᄀᆞ〮니〮|ᄆᆡᇰᄀᆞᆯ다|ᄆᆡᇰᄀᆞᆯ〮다〮|mòyngkótá	<i>verb</i><br><ol><li>to make, to create</li></ol>
ᄇᆞᄅᆞᆷ|polom	<i>noun</i><br><ol><li>wind, air, draft</li><li>wall, enclosure, surrounding</li></ol>
ᄇᆞᅀᆞ다|pozota	<i>verb</i><br><ol><li>to break</li><li>to crush</li></ol>
ᄇᆞᆯ|ᄇᆞ〮래〮|ᄇᆞᆯ〮|pól|pòl	<i>noun</i><br><ol><li>field, plain (open area of land)</li></ol>
ᄇᆞᆲ다|ᄇᆞᆲ〯다〮|pǒlp-tá	<i>verb</i><br><ol><li>to step (on)</li></ol>
ᄇᆞᆶ|ᄇᆞᆯᄒᆡ〮|ᄇᆞᆯ|pòlh|pòl|ᄇᆞᆯ해〮	<i>noun</i><br><ol><li>arm</li></ol>
ᄇᆡᄎᆡ|pǒychóy|ᄇᆡ〯ᄎᆡ〮	<i>noun</i><br><ol><li>napa cabbage</li></ol>
ᄇᆡᆨ|ᄇᆡᆨ〮|póyk	<i>num</i><br><ol><li>hundred</li></ol>
ᄇᆡ얌|poyyam	<i>noun</i><br><ol><li>snake</li></ol>
ᄇᆡ호다|poyhwota	<i>verb</i><br><ol><li>to learn</li></ol>
ᄉᆞ|sò|四	<i>num</i><br><ol><li>(Sino-Korean numeral) four</li></ol>
ᄉᆞᄌᆞ|soco	<i>noun</i><br><ol><li>lion</li></ol>
ᄉᆞᅀᅵ|sòzí|ᄉᆞᅀᅵ〮예〮|ᄉᆞᅀᅵ〮	<i>noun</i><br><ol><li>space between; gap</li></ol>
ᄉᆞᆱ다|solmta	<i>verb</i><br><ol><li>to boil</li></ol>
ᄉᆞᆶ|ᄉᆞᆶ〮|sólh	<i>noun</i><br><ol><li>flesh</li></ol>
ᄉᆞ과|sokwa	<i>noun</i><br><ol><li>apple</li></ol>
ᄉᆞ나희|ᄮᅡᄒᆡ|sonahuy|snahoy	<i>noun</i><br><ol><li>man</li></ol>
ᄉᆞ라ᇰᄒᆞᆸ다|sòlàng-hóptá|ᄉᆞ라ᇰᄒᆞᆸ〮다〮	<i>adj</i><br><ol><li>(to be) lovely</li></ol>
ᄉᆞ라ᇰᄒᆞ다|solang-hota	<i>verb</i><br><ol><li>to think about</li><li>to love</li></ol>
ᄉᆞ시|sosi	<i>noun</i><br><ol><li>(Gyeongsang) gap; space between</li><li>(Gyeongsang) relationship</li></ol>
ᄉᆡᇰ각|ᄉᆡᇰ〮각〮|sóyngkák	<i>noun</i><br><ol><li>idea; thought</li></ol>
ᄉᆡᇰ각ᄒᆞ다|sóyngkák-hòtá|ᄉᆡᇰ〮각〮ᄒᆞ다〮	<i>verb</i><br><ol><li>to think about</li></ol>
ᄌᆞᄂᆞᆨᄌᆞᄂᆞᆨ|cònòkcònòk	<i>noun</i><br><ol><li>slowly and gently</li></ol>
ᄌᆡ|coy	<i>noun</i><br><ol><li>ash</li></ol>
ᄌᆡ조|coycwo	<i>noun</i><br><ol><li>talent; skill</li><li>trick; way</li></ol>
ᄍᆞᆼ|ccó|ᄍᆞᆼ〮	<i>noun</i><br><ol><li>letter, character</li></ol>
ᄎᆞᄆᆡ|chomoy	<i>noun</i><br><ol><li>the Korean melon, (Cucumis melo Makuwa Group) or its fruit.</li></ol>
ᄎᆞᆷ|chom	<i>noun</i><br><ol><li>truth</li></ol>
ᄎᆡᆨ|choyk	<i>noun</i><br><ol><li>book</li></ol>
ᄑᆞᆯ|phól|ᄑᆞᆯ〮	<i>noun</i><br><ol><li>fly (insect)</li></ol>
ᄑᆞᆾ|phoch	<i>noun</i><br><ol><li>the red bean or azuki bean, Vigna angularis.</li></ol>
ᄒᆞᄅᆞ|form: ᄒᆞᆯㄹ|holo	<i>noun</i><br><ol><li>one day</li></ol>
ᄒᆞᄫᆞᅀᅡ|hoWoza	<i>noun</i><br><ol><li>solitude</li></ol>
ᄒᆞᆫᄢᅴ|hònpskúy|ᄒᆞᆫᄢᅴ〮	<i>adv</i><br><ol><li>at the same time</li></ol>
ᄒᆞᆰ|ᄒᆞᆯ개〮|hòlk|ᄒᆞᆯᄀᆡ〮	<i>noun</i><br><ol><li>dirt, soil</li></ol>
ᄒᆞ낳|ᄒᆞ낳〮|hònáh	<i>num</i><br><ol><li>one</li></ol>
ᄒᆞ다|hòtá|ᄒᆞ다〮|ᄒᆞ〮야〮|ᄒᆞ니〮	<i>verb</i><br><ol><li>to do</li><li>to say</li><li>A light verb attached to various non-verbs to derive verbs and adjectives.</li></ol>
ᄒᆞ다가|hotaka	<i>adv</i><br><ol><li>if, in the event that.</li></ol>
ᄒᆞ야디다|ᄒᆞ〮야〮디여〮|ᄒᆞ〮야〮디니〮|ᄒᆞ〮야〮디다〮|hóyá-tìtá	<i>verb</i><br><ol><li>to become destroyed, to become ruined</li><li>to become harmed, to become injured</li></ol>
ᄒᆡ|ᄒᆡ〮예〮|ᄒᆡ〮|hóy	<i>noun</i><br><ol><li>sun</li><li>year</li></ol>
ᄒᆡ골|hoykwol	<i>noun</i><br><ol><li>skeleton</li></ol>
ᄒᆡ다|hoyta	<i>adj</i><br><ol><li>(to be) white, light gray</li></ol>
ᄠᅡᆯ기|ptálkí|ᄠᅡᆯ〮기〮	<i>noun</i><br><ol><li>berry (fruit)</li><li>strawberry (fruit)</li></ol>
ᄠᅳᆮ|ptut	<i>noun</i><br><ol><li>meaning; sense</li></ol>
ᄠᅳᆮ다|ptut.ta	<i>verb</i><br><ol><li>to tear, pick, pluck</li><li>to graze (grass)</li><li>to play (a stringed instrument)</li><li>to disassemble, disintegrate, dismantle</li><li>to extort, levy (fine, penalty, tax, tenth)</li></ol>
ᄠᅳᆶ|ᄠᅳᆶ〮|ᄠᅳᆯ헤〮|ptúl|ptúlh|ᄠᅳᆯ|ᄠᅳᆯ〮	<i>noun</i><br><ol><li>court, garden</li></ol>
ᄡᅳᆯ게|psulkey	<i>noun</i><br><ol><li>gall bladder</li></ol>
ᄡᅵ|psí|ᄡᅵ〮	<i>noun</i><br><ol><li>seed, kernel</li><li>semen</li><li>breed, offspring</li><li>gene</li><li>woof, weft</li><li>part of speech</li></ol>
ᄡᆞᆯ|psól|ᄡᆞ〮래〮|ᄡᆞᆯ〮	<i>noun</i><br><ol><li>rice</li></ol>
ᄡᆞ눈|psónwǔn|ᄡᆞ〮눈〯	<i>noun</i><br><ol><li>small hail</li></ol>
ᄢᅮᆯ|ᄭᅮᆯ〮|skwúl|ᄢᅮ〮레〮|ᄭᅮᆯ|pskwúl|ᄢᅮᆯ〮	<i>noun</i><br><ol><li>honey</li></ol>
ᄢᅵ니|pskini	<i>noun</i><br><ol><li>meal</li></ol>
ᄣᅢ|pstáy|ᄣᅢ〮	<i>noun</i><br><ol><li>time</li></ol>
ᄣᅵ르다|pstiluta	<i>verb</i><br><ol><li>to prick; to stab</li></ol>
ᄭᅮᆷ|ᄭᅮ〮메〮|skwúm|ᄭᅮᆷ〮	<i>noun</i><br><ol><li>dream</li></ol>
ᄯᅡᇂ|ᄯᅡᇂ〮|ᄯᅡ〮|ᄯᅡ해〮|ᄯᅡ|stá|stáh	<i>noun</i><br><ol><li>earth; land</li></ol>
ᄯᅥᆨ|sték|ᄯᅥᆨ〮	<i>noun</i><br><ol><li>rice cake</li></ol>
ᄯᅩᇰ|stwòng	<i>noun</i><br><ol><li>feces</li></ol>
ᄯᅴ|ᄯᅴ〮|stúy	<i>noun</i><br><ol><li>belt, band</li></ol>
ᄯᆞᆯ|ᄯᆞᆯ〮|stól	<i>noun</i><br><ol><li>daughter</li></ol>
ᄲᅡ이다|spa.ita	<i>verb</i><br><ol><li>to remove, to take out</li></ol>
ᄲᅢ다|spay.ta	<i>verb</i><br><ol><li>to remove, to take out</li></ol>
ᄲᅢ티다|spaythita	<i>verb</i><br><ol><li>to remove, to take out</li></ol>
ᄲᅧ|ᄲᅧ〮|spyé	<i>noun</i><br><ol><li>bone</li></ol>
ᄲᅮᆫ|ᄲᅮᆫ〯|spwǔn	<i>noun</i><br><ol><li>only</li></ol>
ᄲᅳᆯ|spul	<i>noun</i><br><ol><li>horn</li></ol>
ᄲᆞᄅᆞ다|ᄲᆞᄅᆞ다〮|spòlòtá	<i>adj</i><br><ol><li>(to be) fast, quick, soon, early</li></ol>
ᅀᅭᇂ|zyoh	<i>noun</i><br><ol><li>bedspread</li></ol>
ᅀᅲᆺ|zyus	<i>noun</i><br><ol><li>Yut, a traditional Korean board game.</li><li>4 points (made by a cast of yut sticks).</li></ol>
ᅀᅵ|zǐ|ᅀᅵ〯	<i>noun</i><br><ol><li>two</li></ol>
ᅀᅵᆫ|zin	<i>noun</i><br><ol><li>person; people</li></ol>
ᅀᅵᆫ간|zinkan	<i>noun</i><br><ol><li>human world, human society</li></ol>
ᅀᅵᆯ|zíl|ᅀᅵᆯ〮	<i>noun</i><br><ol><li>day</li></ol>
ᇮ|ngng	<i>character</i><br><ol><li>A digraph of doubled ㆁ (ng).</li></ol>
〮	<i>symbol</i><br><ol><li>pitch accent</li></ol>
〯	<i>symbol</i><br><ol><li>pitch accent</li></ol>
ㅥ|nn	<i>character</i><br><ol><li>A digraph of ㄴ (n) and ㄴ (n).</li></ol>
ㅦ|nt	<i>character</i><br><ol><li>A digraph of ㄴ (n) and ㄷ (t).</li></ol>
ㅧ|ns	<i>character</i><br><ol><li>A digraph of ㄴ (n) and ㅅ (s).</li></ol>
ㅨ|nz	<i>character</i><br><ol><li>A digraph of ㄴ (n) and ㅿ (z).</li></ol>
ㅩ|lks	<i>character</i><br><ol><li>A trigraph of ㄹ (l), ㄱ (k), and ㅅ (s).</li></ol>
ㅪ|lt	<i>character</i><br><ol><li>A digraph of ㄹ (l) and ㄷ (t).</li></ol>
ㅫ|lps	<i>character</i><br><ol><li>A trigraph of ㄹ (l), ㅂ (p), and ㅅ (s).</li></ol>
ㅬ|lz	<i>character</i><br><ol><li>A digraph of ㄹ (l) and ㅿ (z).</li></ol>
ㅭ	<i>suffix</i><br><ol><li>Post-vocalic allomorphic form of 으ᇙ〮 (-úlq, irrealis gerundive/adnominal suffix)</li></ol>
ㅮ|mp	<i>character</i><br><ol><li>A digraph of ㅁ (m) and ㅂ (p).</li></ol>
ㅰ|mz	<i>character</i><br><ol><li>A digraph of ㅁ (m) and ㅿ (z).</li></ol>
ㅱ|w	<i>character</i><br><ol><li>Used solely to transcribe the phoneme /w/ in Middle Chinese; used neither in native Middle Korean nor in Sino-Korean as actually pronounced.</li></ol>
ㅳ|pt	<i>character</i><br><ol><li>A digraph of ㅂ (p) and ㄷ (t).</li></ol>
ㅴ|psk	<i>character</i><br><ol><li>A trigraph of ㅂ (p), ㅅ (s), and ㄱ (k).</li></ol>
ㅵ|pst	<i>character</i><br><ol><li>A trigraph of ㅂ (p), ㅅ (s), and ㄷ (t).</li></ol>
ㅶ|pc	<i>character</i><br><ol><li>A digraph of ㅂ (p) and ㅈ (c).</li></ol>
ㅷ|pth	<i>character</i><br><ol><li>A digraph of ㅂ (p) and ㅌ (th).</li></ol>
ㅸ|W	<i>character</i><br><ol><li>The sound known as 가벼운비읍 (gabyeounbieup), a voiced bilabial fricative; /β/. This vanished around 1480 when /β/ became /w/.</li></ol>
ㅹ|WW	<i>character</i><br><ol><li>A digraph intended to transcribe [v~β] in various forms of Chinese.</li></ol>
ㅺ|sk	<i>character</i><br><ol><li>A digraph of ㅅ (s) and ㄱ (k).</li></ol>
ㅻ|sn	<i>character</i><br><ol><li>A digraph of ㅅ (s) and ㄴ (n).</li></ol>
ㅼ|st	<i>character</i><br><ol><li>A digraph of ㅅ (s) and ㄷ (t).</li></ol>
ㅽ|sp	<i>character</i><br><ol><li>A digraph of ㅅ (s) and ㅂ (p).</li></ol>
ㆀ	<i>character</i><br><ol><li>A digraph of ㅇ (G) and ㅇ (G).</li></ol>
ㆁ|ng	<i>character</i><br><ol><li>A letter representing the velar nasal, /ŋ/. Called 옛이응 (yesieung) in Modern Korean.</li></ol>
ㆂ|ngs	<i>character</i><br><ol><li>A digraph of ㆁ (ng) and ㅅ (s).</li></ol>
ㆃ|ngz	<i>character</i><br><ol><li>A digraph of ㆁ (ng) and ㅿ (z).</li></ol>
ㆄ	<i>character</i><br><ol><li>(not used after 1490) The voiceless bilabial fricative, /ɸ/. Used solely in representing the pronunciation of Chinese characters.</li></ol>
ㆅ|hh	<i>character</i><br><ol><li>A digraph of ㅎ (h) and ㅎ (h).</li></ol>
ㆆ|q	<i>character</i><br><ol><li>Transcribes [ʔ] in Chinese. This was not a sound in Middle Korean.</li><li>Used to represent an archiphoneme which tenses the subsequent consonant.</li></ol>
ㆇ|ywa	<i>character</i><br><ol><li>A digraph of ㅛ (ywo) and ㅑ (ya).</li></ol>
ㆈ|yway	<i>character</i><br><ol><li>A trigraph of ㅛ (ywo), ㅑ (ya), and ㅣ (i).</li></ol>
ㆉ|ywoy	<i>character</i><br><ol><li>A digraph of ㅛ (ywo) and ㅣ (i).</li></ol>
ㆊ|ywe	<i>character</i><br><ol><li>A digraph of ㅠ (ywu) and ㅕ (ye), intended to transcribe certain triphthongs in Chinese without Korean equivalent, e.g. Middle Chinese [iuᴇ], [wiæ].</li></ol>
ㆋ|ywey	<i>character</i><br><ol><li>A trigraph of ㅠ (ywu), ㅕ (ye), and ㅣ (i), intended to transcribe certain triphthongs in Chinese without Korean equivalent, e.g. Middle Chinese [wei].</li></ol>
ㆌ|ywuy	<i>character</i><br><ol><li>A digraph of ㅠ (ywu) and ㅣ (i).</li></ol>
가ᄉᆞᆷ|가ᄉᆞ〮매〮|kàsóm|가ᄉᆞᆷ〮	<i>noun</i><br><ol><li>chest</li></ol>
가ᄫᆞᆫᄃᆡ|가ᄫᆞᆫ〮ᄃᆡ〮|kàWóntóy	<i>noun</i><br><ol><li>center; the middle</li></ol>
가ᇰ아지|kang.aci	<i>noun</i><br><ol><li>puppy</li></ol>
가개|가〯개〮|kǎkáy	<i>noun</i><br><ol><li>store, stop</li></ol>
가다|가〮더라〮|가〮|가리〮ᅌᅵᆺ가〮|가〯ᄃᆡ〮|가〮시〮ᄂᆞ다〮|가고〮져〮|가관〮ᄃᆡ〮|간ᄃᆞᆯ〮|가〮던다〮|가ᇙ〯|가〮신〮|가료〮|가리〮ᅌᅵᆺ고〮|가〯ᅌᅵ다〮|가며〮|가ᇙ가〮|가〮ᄂᆞ니〮ᅌᅵᆺ고〮|가ᇙ다〮|가〮시리〮ᅌᅵ다〮|가과〮뎌〮 (kàkwátyé, desires other's action)|가뇨〮|가〮시〮ᄂᆞ니〮ᅌᅵ다〮|가〮시ᄂᆞ〮니라〮|가려〮|가〮시〮니라〮|가〮샴〮|가〮ᄂᆞ〮니라〮|가〮시ᄂᆞ〮ᅌᅵ다〮|가니〮라〮|갈쎠〮|가〮거〮시니〮ᅌᅵ다〮|가〮논〮|가〮노라〮|가〮ᄂᆞᆫ가〮|가니〮|가〯라〮|가〮던가〮|가〮ᄂᆞ뇨〮|간가〮|가〮던고〮|가〮거〮시다〮|가〮거ᄂᆞᆯ〮|가고〮라〮|가〮애라〮|갈ᄊᆡ〮|가니〮ᅌᅵᆺ가〮|가〮건〮마ᄅᆞᆫ〮|가〮시ᄂᆞᆫ〮|가〮노〮ᅌᅵ다〮|가〮도다〮|가라〮|가〮ᄂᆞ〮ᅌᅵ다〮|가다〮|가〮시ᇙ〮|가나〮|가ᇙ|가〮ᄂᆞ녀〮|감〯|가녀〮|가〮거시〮ᅌᅵ다〮|가〮쇼셔〮|가〮시〮ᅌᅵ다〮|가〮더뇨〮|간〯|가니〮ᅌᅵᆺ고〮|가〮거든〮|가〮시니〮ᅌᅵ다〮|가ᇙ고〮|가〮더녀〮|가〮애ᅌᅵ다〮|간|가〯마〮|가리〮ᅌᅵ다〮|가〮시〮리라〮|가〮ᄂᆞ니〮ᅌᅵᆺ가〮|간대〮|간고〮|가〯리라〮|가〮ᄂᆞ다〮|가〮더〮니라〮|가〮거시〮니라〮|가사〮ᅌᅵ다〮|간다〮|가〯리〮ᅌᅵ다〮|no separate forms|가〮더〮시다〮|가〮시다〮|가〮더시〮니라〮|가〮ᄂᆞᆫ고〮|가〮ᄂᆞᆫ다〮|간뎌〮|가〮다라〮|kàtá|가리〮라〮|가니〮ᅌᅵ다〮|가져〮|가ᅌᅵ다〮|가〮다가〮|가면〮|가〮돗다〮|가〮ᄂᆞᆫ〮|가〯려〮|가〮더〮시니〮ᅌᅵ다〮|가〮건댄〮|가고〮|가〮ᄂᆞ니〮ᅌᅵ다〮|가〮더〮시〮ᅌᅵ다〮	<i>verb</i><br><ol><li>(intransitive) to go (especially somewhere for a certain purpose)</li><li>(auxiliary, with 어〮 (-é)) Marks a continuous action that either stretches from the present into the future, or involves physical movement away from the speaker.</li></ol>
가마괴|가마괴〮|kàmàkwóy	<i>noun</i><br><ol><li>crow, raven</li></ol>
가븨얍다|kapuyyapta	<i>adj</i><br><ol><li>(to be) light (not heavy)</li></ol>
가큰도ᇰ|가큰〮도ᇰ|加斤洞|Kàkhúntwòng	<i>name</i><br><ol><li>a mountain ford over the Han River in Yeongwol County</li></ol>
가히|개〯|개〯예〮|가히〮예〮|kǎy|개|가히〮|kàhí	<i>noun</i><br><ol><li>dog</li></ol>
각시|각시〮|kàksí	<i>noun</i><br><ol><li>woman (especially beautiful and young)</li><li>bride</li><li>wife</li></ol>
갈두|Kàltwú|갈두〮	<i>name</i><br><ol><li>A peak in Anju, modern North Korea</li><li>Jeoldu-san, a rocky promontory in Seoul</li></ol>
갊다|갊〯논〮|갈ᄆᆞᆫ〮뎌〮|갈ᄆᆞ〮신〮|갈ᄆᆞ〮시〮니라〮|갊〯던가〮|갈마〮ᄂᆞᆯ〮|갈ᄆᆞ〮시ᄂᆞᆫ〮|갈ᄆᆞ〮시다〮|갈ᄆᆞᆯ〮ᄊᆡ〮|갈ᄆᆞ〮나〮|갈ᄆᆞᆫ〮다〮|갈모〮마〮|갈ᄆᆞ〮라〮|갊〯ᄂᆞ니〮ᅌᅵ다〮|갊〯ᄂᆞ뇨〮|갊〯ᄂᆞᆫ고〮|갈모〮려〮|갊〯관ᄃᆡ〮|kǎlmtá|갊〯ᅀᆞᄫᆞ〮니라〮|갈ᄆᆞ〮시ᄂᆞ〮ᅌᅵ다〮|갊〯ᅀᆞᄫᆞ〮리라〮|갊〯ᅀᆞᄫᅡ〮다〮|갊〯더뇨〮|갊〯돗다〮|갈매〮ᅌᅵ다〮|갈마〮시〮ᅌᅵ다〮|갈ᄆᆞ〮니〮ᅌᅵᆺ고〮|갊〯ᄂᆞ니〮ᅌᅵᆺ가〮|갈ᄆᆞᇙ〮|갈ᄆᆞ〮쇼셔〮|갈모〮ᄃᆡ〮|갈ᄆᆞ〮시〮ᄂᆞ니〮ᅌᅵ다〮|갈모〮라〮|갈ᄆᆞ〮ᅌᅵ다〮|갈ᄆᆞ〮니〮ᅌᅵ다〮|갊〯ᄂᆞ니〮ᅌᅵᆺ고〮|갈ᄆᆞ〮리〮ᅌᅵᆺ가〮|갊〯ᅀᆞᄫᅡ〮니라〮|갊〯노〮ᅌᅵ다〮|갊〯져〮|갈마〮시〮니라〮|갊〯ᄂᆞ녀〮|갈마〮시다〮|갈ᄆᆞᆫ〮|갊〯더〮시니〮ᅌᅵ다〮|갊〯ᄂᆞᆫ다〮|갈ᄆᆞ〮시ᄂᆞ〮니라〮|갈ᄆᆞᆫ〮대〮|갈마〮|갈모〮ᅌᅵ다〮|갊〯ᅀᆞᆸ〯다〮|갊〯ᄂᆞᆫ가〮|갈ᄆᆞᆫ〮가〮|갈몸〮|갊〯ᅀᆞᆸ〯더〮니라〮|갊〯ᄂᆞ〮니라〮|갊〯ᄂᆞ〮ᅌᅵ다〮|갈ᄆᆞᆫ〮고〮|갊〯고져〮|갈ᄆᆞ〮려〮|갊〯과뎌〮 (kǎlmkwàtyé, desires other's action)|갊〯다라〮|갈ᄆᆞ〮리〮ᅌᅵ다〮|갊〯던고〮|갈ᄆᆞᆯ〮쎠〮|갊〯더시〮ᅌᅵ다〮|갈ᄆᆞ〮며〮|갊〯고〮|갊〯고라〮|갈ᄆᆞ〮면〮|갊〯ᅀᆞᆸ〯ᄂᆞ다〮|갊〯도다〮|갊〯사〮ᅌᅵ다〮|갈모ᇙ〮|갈ᄆᆞᇙ〮가〮|갈ᄆᆞ〮시니〮ᅌᅵ다〮|갈ᄆᆞ〮시〮ᄂᆞ다〮|갈ᄆᆞᇙ〮다〮|갈모〮리라〮|갊〯ᅀᆞᆸ〯ᄂᆞ〮니라〮|갊〯더시〮니라〮|갈만〮댄〮|갈ᄆᆞ〮리라〮|갈ᄆᆞ〮니라〮|갈ᄆᆞᇙ〮고〮|갈ᄆᆞ〮리〮ᅌᅵᆺ고〮|갈마〮시니〮ᅌᅵ다〮|갊〯던다〮|no separate forms|갊〯ᅀᆞᆸ〯더라〮|갈ᄆᆞ〮시〮리라〮|갊〯더〮니라〮|갊〯더〮시다〮|갈ᄆᆞ〮녀〮|갈ᄆᆞ〮시〮ᅌᅵ다〮|갈ᄆᆞ〮뇨〮|갊〯다〮|갈몬〮|갈모〮리〮ᅌᅵ다〮|갈만〮마ᄅᆞᆫ〮|갊〯ᄂᆞᆫ〮|갈ᄆᆞ〮니〮ᅌᅵᆺ가〮|갈ᄆᆞ〮시리〮ᅌᅵ다〮|갈ᄆᆞᆫ〮ᄃᆞᆯ〮|갊〯ᄂᆞ다〮|갈ᄆᆞ〮샴〮|갊〯다가〮|갈ᄆᆞ〮시ᇙ〮|갈ᄆᆞ〮니〮|갈ᄆᆞ〮료〮|갊〯더라〮|갈매〮라〮|갊〯더녀〮|갊〯노라〮|갈마〮든〮	<i>verb</i><br><ol><li>to conceal, to hide, to secrete</li><li>to safeguard; to arrange or put in order, so as to safeguard for the future</li><li>to dress a corpse for burial</li></ol>
갏|갈해〮|kálh|갏〮	<i>noun</i><br><ol><li>knife, sword</li></ol>
갓가ᄫᅵ|갓가ᄫᅵ〮|kàskàWí	<i>adv</i><br><ol><li>closely; close together</li></ol>
갓갑다|갓가ᄫᆞ〮리〮ᅌᅵ다〮|갓갑〯노〮ᅌᅵ다〮|갓가ᄫᆞ〮녀〮|갓가ᄫᆞ〮려〮|갓가ᄫᆞᆫ〮고〮|갓갑〯ᄉᆞᄫᆞ〮니라〮|갓갑〯ᄉᆞᆸ〯거다〮|갓갑〯노라〮|갓가ᄫᆞ〮시ᄂᆞᆫ〮|갓갑〯더〮니라〮|갓갑〯ᄂᆞ녀〮|갓가ᄫᅩ〮라〮|갓가ᄫᆞᆫ〮대〮|갓가ᄫᅩ〮ᄃᆡ〮|갓갑〯ᄉᆞᆸ〯다〮|갓갑〯다가〮|갓갑〯ᄂᆞᆫ〮|갓갑〯져〮|갓갑〯ᄂᆞᆫ고〮|갓갑〯ᄉᆞᆸ〯더〮니라〮|갓갑〯ᄉᆞᆸ〯거〮니라〮|갓가ᄫᆞ〮니〮|갓갑〯던다〮|갓가ᄫᅩ〮리라〮|갓가ᄫᆞ〮신〮|갓가ᄫᆞ〮니라〮|갓갑〯더녀〮|갓가ᄫᅩᆷ〮|갓가ᄫᆞᆫ〮가〮|갓가ᄫᆞᇙ〮다〮|갓가ᄫᆞ〮면〮|갓가ᄫᆞ〮시ᇙ〮|갓가ᄫᆞ〮니〮ᅌᅵ다〮|갓갑〯돗다〮|갓갑〯더〮시니〮ᅌᅵ다〮|갓갑〯다〮|갓가ᄫᆞ〮시〮ᄂᆞ다〮|갓갑〯고〮|갓갑〯건댄〮|갓가ᄫᆞ〮리라〮|갓가ᄫᆞ〮니〮ᅌᅵᆺ가〮|갓갑〯도다〮|갓가ᄫᅩ〮마〮|갓가ᄫᆞᆯ〮쎠〮|갓가ᄫᆞ〮시ᄂᆞ〮ᅌᅵ다〮|갓갑〯거〮시다〮|갓갑〯거든〮|갓가ᄫᆞ〮시〮ᄂᆞ니〮ᅌᅵ다〮|갓갑〯던고〮|갓갑〯논〮|갓가ᄫᆞ〮나〮|갓갑〯ᄂᆞ뇨〮|갓갑〯ᄂᆞ〮니라〮|갓갑〯더시〮니라〮|갓갑〯ᄂᆞ니〮ᅌᅵᆺ가〮|갓갑〯고라〮|갓갑〯더뇨〮|갓가ᄫᅩᆫ〮|갓가ᄫᆞ〮리〮ᅌᅵᆺ고〮|갓가ᄫᆞ〮시니〮ᅌᅵ다〮|갓가ᄫᆞ〮뇨〮|갓가ᄫᆞ〮료〮|갓가ᄫᆞᆫ〮뎌〮|갓갑〯사〮ᅌᅵ다〮|갓갑〯거시〮ᅌᅵ다〮|갓갑〯ᄉᆞᆸ〯더라〮|갓가ᄫᅩᇙ〮|갓가ᄫᆞ〮ᅌᅵ다〮|갓가ᄫᆞᆯ〮ᄊᆡ〮|갓갑〯더라〮|갓가ᄫᆞ〮샴〮|갓가ᄫᆞᆫ〮|갓가ᄫᆞ〮시ᄂᆞ〮니라〮|갓가ᄫᅩ〮ᅌᅵ다〮|갓가ᄫᆞᇙ〮가〮|갓가ᄫᆞ〮시〮ᅌᅵ다〮|갓가ᄫᆞ〮시다〮|갓가ᄫᆞ〮시리〮ᅌᅵ다〮|갓갑〯관ᄃᆡ〮|갓가ᄫᆞ〮며〮|갓갑〯ᄂᆞᆫ가〮|갓가ᄫᅡ〮|갓갑〯던가〮|갓갑〯더시〮ᅌᅵ다〮|갓갑〯다라〮|갓갑〯ᄂᆞᆫ다〮|갓갑〯더〮시다〮|갓가ᄫᅢ〮라〮|갓갑〯건〮마ᄅᆞᆫ〮|갓갑〯거〮시니〮ᅌᅵ다〮|갓갑〯고져〮|갓가ᄫᆞ〮니〮ᅌᅵᆺ고〮|갓갑〯과뎌〮 (kàskǎpkwàtyé, desires other's action)|갓가ᄫᆞᇙ〮|갓갑〯거ᄂᆞᆯ〮|갓가ᄫᆞ〮리〮ᅌᅵᆺ가〮|no separate forms|갓가ᄫᆞᇙ〮고〮|갓갑〯ᄉᆞᄫᆞ〮리라〮|갓갑〯ᄉᆞᆸ〯ᄂᆞ다〮|갓가ᄫᆞ〮쇼셔〮|갓가ᄫᆞᆫ〮다〮|갓가ᄫᅩ〮리〮ᅌᅵ다〮|갓가ᄫᆞᆫ〮ᄃᆞᆯ〮|갓갑〯ᄂᆞ니〮ᅌᅵᆺ고〮|갓가ᄫᆞ〮시〮니라〮|kàskǎptá|갓갑〯ᄂᆞ다〮|갓갑〯거시〮니라〮|갓갑〯ᄂᆞ〮ᅌᅵ다〮|갓가ᄫᆞ〮라〮|갓가ᄫᅩ〮려〮|갓갑〯ᄂᆞ니〮ᅌᅵ다〮|갓가ᄫᅢ〮ᅌᅵ다〮|갓가ᄫᆞ〮시〮리라〮|갓갑〯ᄉᆞᆸ〯ᄂᆞ〮니라〮	<i>adj</i><br><ol><li>to be close, near; (verbally) to become close, near; to approach</li></ol>
개|개〯|개〮예〮|개〯예〮|kǎy|káy|개〮	<i>noun</i><br><ol><li>inlet; estuary</li></ol>
거ᅀᅴ|kezuy	<i>noun</i><br><ol><li>almost, nearly</li></ol>
거리|kèlí|거리〮|거리〮예〮	<i>noun</i><br><ol><li>road, street</li></ol>
거믜|kèmúy|거믜〮	<i>noun</i><br><ol><li>spider</li></ol>
거우루|거우〮루	<i>noun</i><br><ol><li>mirror</li></ol>
거유|거유〮|kèyú	<i>noun</i><br><ol><li>goose</li></ol>
거즛말|kecusmal	<i>noun</i><br><ol><li>a lie; a false statement</li></ol>
것ᄫᅡᅀᅵ|것ᄫᅡᅀᅵ〮|kèsWàzí	<i>noun</i><br><ol><li>beggar</li></ol>
겨ᅀᅳᆶ|kyèzúl|kyèzúlh|겨ᅀᅳᆯ〮헤〮|kyezol|겨ᅀᅳᆯ|겨ᅀᅳᆯ〮|겨ᅀᅳᆶ〮|겨ᅀᆞᆯ	<i>noun</i><br><ol><li>winter</li></ol>
겨시다|kyesita	<i>noun</i><br><ol><li>(honorific) honorific of 이시다 (isita) to stay</li></ol>
겨집|kyěcìp|겨〯집	<i>noun</i><br><ol><li>woman, girl</li><li>wife</li></ol>
겻다|kyèstá|겨ᇧ다|겨ᇧ다〮|겻거〮|겻다〮|겻그〮니〮|phonemic orthography 겨ᇧ다〮|kyèsktá	<i>verb</i><br><ol><li>(transitive) to suffer, to undergo, to go through</li><li>(transitive) to feed (a large number of people)</li></ol>
곁|kyèth|겨틔〮	<i>noun</i><br><ol><li>vicinity, side</li></ol>
계우다|kyèyGwútá|계우〮다〮|계워〮|계우〮니〮	<i>verb</i><br><ol><li>(transitive) to lose to; to be defeated by; to fail to overcome</li></ol>
고ᄋᆞ다|kwoota	<i>verb</i><br><ol><li>to snore</li></ol>
고기|kwòkí|고기〮	<i>noun</i><br><ol><li>meat; flesh</li><li>fish</li></ol>
고디식다|kwòtí sìktá|고디〮식다〮	<i>verb</i><br><ol><li>to act righteously</li><li>(by extension) to be self-righteous, to be stubborn</li></ol>
고마|kwŏmá|고〯마〮|고마〮|kwòmá	<i>noun</i><br><ol><li>respect, admiration</li><li>lover, concubine</li></ol>
고마ᄂᆞᄅᆞ|고마〮ᄂᆞᄅᆞ|Kwòmánòlò|熊津	<i>name</i><br><ol><li>Gongju, ancient capital town of the kingdom of Baekje</li></ol>
고마ᄒᆞ다|kwŏmáhòtá|고〯마〮ᄒᆞ다〮|고〯마〮ᄒᆞ니〮|고〯마〮ᄒᆞ야〮	<i>verb</i><br><ol><li>to respect, to admire</li></ol>
고지|kwoci	<i>noun</i><br><ol><li>fat, grease</li></ol>
골|골〯|kwǒl	<i>noun</i><br><ol><li>gorge; vale; valley</li><li>ditch</li><li>cave; hole</li></ol>
곰ᄇᆡ|kwompoy	<i>noun</i><br><ol><li>Yang 1947, the first major study of the work, believed that kwompoy and limpoy were two vessels used in the ceremonial dance that accompanied the singing of "Dongdong", connecting the second syllable poy to Sino-Korean 杯 (“cup”). Note, however, that the "Dongdong" manuscript marked all Sino-Korean words as such, whereas kwompoy and limpoy were written as fully native words.</li><li>Yang also speculated a connection to sailors' jargon 고물 (gomul, “stern of a ship”) and 이물 (imul, “bow of a ship”), with kwompoy perhaps referring to something towards the back and limpoy to something towards the front.</li><li>Park 1968 connected kwompoy to 검 (geom, “deity”) and limpoy to 님 (nim, “lord”), and speculated that the first was an invocation of the divine and the second a reference to the monarch.</li><li>Kim 2000 suggested that kwompoy and limpoy were two different movements in the choreography of the dance.</li><li>Park 2018 suggested that kwompoy and limpoy are divine locations from which human virtue and fortune originate, noting that the contemporaneous history Goryeosa states that "Dongdong" was inspired by the "language of the immortals".</li></ol>
곶|串|고ᄌᆡ〮|kwòc|곶〮|고재〮|kwóc	<i>noun</i><br><ol><li>flower; flowering plant</li><li>skewer (e.g. for meat)</li><li>cape; headland</li></ol>
곻|kwóh|곻〮|고해〮	<i>noun</i><br><ol><li>nose</li><li>tip, end</li></ol>
과ᇰ대|과ᇰ〯대〮|kwǎngtáy	<i>noun</i><br><ol><li>entertainer, performer; crown; acrobat</li></ol>
괴다|괴〯니〮|괴〯다〮|괴여〮|kwǒytá	<i>verb</i><br><ol><li>to love (often but not always romantic)</li></ol>
괴오다|kwoyGwota	<i>verb</i><br><ol><li>to support, to prop up</li></ol>
구겨ᇰ|구겨ᇰ〮|kwùkyéng	<i>noun</i><br><ol><li>a viewing</li><li>a thing worth watching</li></ol>
구레|kwuley	<i>noun</i><br><ol><li>flank (side of a person's body)</li></ol>
구룸|kwúlwùm|구〮룸	<i>noun</i><br><ol><li>cloud</li></ol>
구무|kwùmwù|굼긔〮	<i>noun</i><br><ol><li>hole</li></ol>
구믈구믈|kwumulkwumul	<i>noun</i><br><ol><li>moving slowly in succession</li><li>lazily, sluggishly</li><li>very wrigglingly</li></ol>
국|kwuk	<i>noun</i><br><ol><li>soup</li></ol>
국슈|kwuksyu	<i>noun</i><br><ol><li>noodle (string or strip of pasta)</li></ol>
굴에|굴에〮|kwùlGéy	<i>noun</i><br><ol><li>bridle</li></ol>
굿|kwús|굿〮	<i>noun</i><br><ol><li>shamanic ritual; indigenous religious ceremony</li></ol>
귀|귀〮|귀예〮|kwúy	<i>noun</i><br><ol><li>ear</li></ol>
귀믿터리|kwìmìtthèlí|귀믿터리〮	<i>noun</i><br><ol><li>sideburns (hair below the ears)</li></ol>
그ᅀᅳ다|그ᇫ어〮녀〮|그ᅀᅳ샴〮|그ᅀᅳ리〮ᅌᅵ다〮|그ᇫ우〮려〮|그ᅀᅳ시ᇙ〮|그ᇫ어〮시다〮|그ᅀᅳ고〮져〮 (kùzùkwócyé, desires one's own action)|그ᅀᅳᄂᆞᆫ다〮|그ᅀᅳ사〮ᅌᅵ다〮|그ᅀᅳ고〮|그ᅀᅳᇙ|그ᅀᅳᄂᆞᆫ가〮|그ᅀᅳ고〮ᅌᅵ다〮|그ᇫ운〮|그ᅀᅳ다〮|kùzùtá|그ᅀᅳ쇼〮셔〮|그ᅀᅳ시〮ᄂᆞᆫ〮|그ᅀᅳ던〮다〮|그ᅀᅳ뇨〮|그ᅀᅳ시〮니〮ᅌᅵ다〮|그ᅀᅳ과〮뎌〮 (kùzùkwátyé, desires other's action)|그ᅀᅳ니〮ᅌᅵ다〮|그ᇫ언〮마ᄅᆞᆫ〮|그ᇫ어〮뇨〮|그ᅀᅳᆫ|그ᅀᅳ과〮라〮|그ᅀᅳ리〮ᅌᅵᆺ고〮|그ᅀᅳ돗〮다〮|그ᇫ언〮다〮|그ᅀᅳᄂᆞ뇨〮|그ᅀᅳ관〮ᄃᆡ〮|그ᅀᅳᅀᆞᆸ〯ᄂᆞ〮니라〮|그ᅀᅳᄂᆞ녀〮|그ᅀᅳ던〮고〮|그ᅀᅳ니〮ᅌᅵᆺ고〮|그ᇫ어〮시〮ᅌᅵ다〮|그ᇫ우〮ᅌᅵ다〮|그ᅀᅳᄂᆞᆫ|그ᇫ우ᇙ〮|그ᅀᅳ시〮리라〮|그ᇫ어〮ᄂᆞᆯ〮|그ᅀᅳ논〮|그ᅀᅳ시〮다〮|그ᅀᅳ시〮ᅌᅵ다〮|그ᅀᅳ더〮니라〮|그ᅀᅳ시〮ᄂᆞ〮ᅌᅵ다〮|그ᅀᅳ다가〮|그ᅀᅳᇙ다〮|그ᇫ에〮라〮|그ᅀᅳ니〮ᅌᅵᆺ가〮|그ᅀᅳᆫᄃᆞᆯ〮|그ᇫ어〮시니〮ᅌᅵ다〮|그ᅀᅳ며〮|그ᅀᅳ려〮|그ᅀᅳᄂᆞᆫ고〮|그ᅀᅳᅀᆞᆸ〯더라〮|그ᅀᅳᄂᆞ니〮ᅌᅵ다〮|그ᅀᅳ시〮니라〮|그ᅀᅳᄂᆞ다〮|그ᅀᅳ더〮라〮|그ᅀᅳ져〮|그ᅀᅳ더〮시니〮ᅌᅵ다〮|그ᅀᅳ면〮|그ᅀᅳᅀᆞᄫᅡ〮다〮|그ᅀᅳ시〮ᄂᆞ〮니라〮|그ᅀᅳᆯᄊᆡ〮|그ᅀᅳᅀᆞᆸ〯다〮|그ᅀᅳᄂᆞ니〮ᅌᅵᆺ고〮|그ᅀᅳ녀〮|그ᅀᅳᅀᆞᆸ〯ᄂᆞ다〮|그ᅀᅳᅌᅵ다〮|그ᅀᅳ던〮가〮|그ᅀᅳᄂᆞᅌᅵ다〮|그ᅀᅳ신〮|그ᅀᅳ니〮라〮|그ᅀᅳ노〮ᅌᅵ다〮|그ᇫ어〮다〮|그ᅀᅳ더〮시〮ᅌᅵ다〮|그ᅀᅳ니〮|그ᅀᅳ리〮라〮|그ᇫ어〮|그ᇫ우〮라〮|그ᅀᅳ고〮라〮|그ᅀᅳᆫ대〮|그ᅀᅳᆫ다〮|그ᅀᅳᄂᆞ니〮라〮|그ᅀᅳᅀᆞᄫᆞ〮니라〮|그ᇫ어〮시〮니라〮|그ᅀᅳᆯ쎠〮|그ᇫ우〮ᄃᆡ〮|그ᅀᅳ더〮녀〮|그ᅀᅳᄂᆞ니〮ᅌᅵᆺ가〮|그ᅀᅳ리〮ᅌᅵᆺ가〮|그ᅀᅳ료〮|그ᅀᅳᆫ뎌〮|그ᅀᅳᅀᆞᆸ〯더〮니라〮|그ᇫ움〮|그ᅀᅳ시〮ᄂᆞ다〮|그ᅀᅳᇙ고〮|그ᅀᅳ시〮리〮ᅌᅵ다〮|no separate forms|그ᅀᅳᆫ고〮|그ᇫ우〮마〮|그ᅀᅳ라〮|그ᅀᅳᇙ가〮|그ᅀᅳ더〮시다〮|그ᅀᅳᆫ가〮|그ᇫ에〮ᅌᅵ다〮|그ᅀᅳ더〮시〮니라〮|그ᅀᅳ도〮다〮|그ᅀᅳ나〮|그ᇫ언〮댄〮|그ᇫ우〮리〮ᅌᅵ다〮|그ᅀᅳ다〮라〮|그ᅀᅳᅀᆞᄫᅡ〮니라〮|그ᅀᅳ시〮ᄂᆞ니〮ᅌᅵ다〮|그ᅀᅳ노〮라〮|그ᅀᅳᅀᆞᄫᆞ〮리라〮|그ᇫ어〮라〮|그ᇫ어〮든〮|그ᇫ우〮리라〮|그ᅀᅳ더〮뇨〮	<i>verb</i><br><ol><li>to pull, to draw, to drag</li><li>(of people, animals) to lead, to drag</li></ol>
그ᅌᅥ긔|그ᅌᅥ긔〮	<i>pron</i><br><ol><li>there</li></ol>
그릏|kuluh	<i>noun</i><br><ol><li>trunk, stem, stalk (of a plant)</li></ol>
그리다|그〮리뇨〮|그〮리더〮시다〮|그〮리ᄂᆞ〮니라〮|그〮리ᇙ다〮|그〮리〮고라〮|그〮려시〮니라〮|그〮린대〮|그〮료〮리라〮|그〮리〮ᄂᆞ녀〮|그〮리〮리라〮|그〮리다〮|그〮리〮다가〮|그〮리〮더시〮니라〮|그〮리시〮니라〮|그〮리더〮니라〮|그〮리〮더녀〮|그〮릴〮쎠〮|그〮리〮ᅀᆞᄫᆞ〮니라〮|그〮리나〮|그〮리〮ᅀᆞᆸ〯ᄂᆞ〮니라〮|그〮리〮ᅀᆞᆸ〯더라〮|그〮리〮ᄂᆞ다〮|그〮리리〮ᅌᅵ다〮|그〮룐〮|그〮리〮관ᄃᆡ〮|그〮리〮ᄂᆞᆫ다〮|그〮리〮노라〮|그〮리니〮ᅌᅵ다〮|그〮린고〮|그〮리니〮ᅌᅵᆺ고〮|그〮리〮ᅀᆞᄫᆞ〮리라〮|그〮료려〮|그〮리〮시ᄂᆞ〮ᅌᅵ다〮|그〮리〮시ᄂᆞ〮니라〮|그〮리〮더라〮|그〮리〮시ᄂᆞᆫ〮|그〮리〮ᅀᆞᆸ〯다〮|그〮리〮ᅀᆞᆸ〯더〮니라〮|그〮리사〮ᅌᅵ다〮|그〮려시〮ᅌᅵ다〮|그〮린〮|그〮료ᄃᆡ〮|그〮리ᇙ가〮|그〮료ᇙ〮|그〮리노〮ᅌᅵ다〮|그〮료리〮ᅌᅵ다〮|그〮릴〮ᄊᆡ〮|그〮려〮시다〮|그〮리료〮|그〮리〮더시〮ᅌᅵ다〮|그〮리논〮|그〮료라〮|그〮리ᄂᆞ〮ᅌᅵ다〮|그〮리〮ᄂᆞ니〮ᅌᅵᆺ가〮|그〮리니〮ᅌᅵᆺ가〮|그〮리〮ᄂᆞᆫ가〮|그〮리예〮ᅌᅵ다〮|그〮리〮니라〮|그〮리샴〮|그〮리〮도다〮|그〮리〮다라〮|kúlìtá|그〮리시〮리라〮|그〮리〮ᄂᆞᆫ고〮|그〮리시〮ᅌᅵ다〮|그〮리더〮시니〮ᅌᅵ다〮|그〮리신〮|그〮리〮던가〮|그〮리〮시리〮ᅌᅵ다〮|그〮리ᇙ고〮|그〮리〮과뎌〮 (kúlíkwàtyé, desires other's action)|그〮려〮시니〮ᅌᅵ다〮|그〮리며〮|그〮리〮쇼셔〮|그〮리ᄂᆞᆫ〮|그〮리녀〮|그〮리리〮ᅌᅵᆺ가〮|그〮린뎌〮|그〮리니〮|그〮리〮시니〮ᅌᅵ다〮|그〮리〮ᄂᆞ니〮ᅌᅵ다〮|그〮리〮ᄂᆞ뇨〮|그〮리〮더뇨〮|그〮룜〮|그〮리ᇙ〮|그〮려든〮|그〮료〮ᅌᅵ다〮|그〮리〮라〮|그〮리〮던고〮|그〮린ᄃᆞᆯ〮|그〮리〮던다〮|그〮리〮ᅀᆞᄫᅡ〮다〮|no separate forms|그〮리〮시다〮|그〮리〮돗다〮|그〮리리〮ᅌᅵᆺ고〮|그〮리시ᇙ〮|그〮리고〮|그〮리려〮|그〮려ᄂᆞᆯ〮|그〮리〮ᅀᆞᆸ〯ᄂᆞ다〮|그〮리〮예라〮|그〮리〮고져〮|그〮려〮|그〮린가〮|그〮련〮마ᄅᆞᆫ〮|그〮리〮ᅀᆞᄫᅡ〮니라〮|그〮료마〮|그〮리져〮|그〮리시〮ᄂᆞ니〮ᅌᅵ다〮|그〮리시〮ᄂᆞ다〮|그〮리〮ᅌᅵ다〮|그〮리〮ᄂᆞ니〮ᅌᅵᆺ고〮|그〮련댄〮|그〮리면〮|그〮린다〮	<i>verb</i><br><ol><li>to draw, to paint</li><li>to think about, especially lovingly</li><li>to long for, to yearn for</li></ol>
근원|kùnwèn|根源	<i>noun</i><br><ol><li>root, cause, source, origin</li></ol>
글|그〮레〮|kúl|글〮	<i>noun</i><br><ol><li>writing; a work of writing</li></ol>
글ᄫᅡᆯ|kulWal	<i>noun</i><br><ol><li>text</li><li>letter</li></ol>
긑|긑〮|그테〮|kúth	<i>noun</i><br><ol><li>end</li></ol>
긔ᄌᆞ|kuyco	<i>noun</i><br><ol><li>(dialectal or archaic) king, ruler</li></ol>
긔디|kuiti	<i>noun</i><br><ol><li>recall; the faculty of memory</li></ol>
기ᅀᅳᆷ|kizum	<i>noun</i><br><ol><li>weed</li></ol>
기드리다|kìtúlìtá|기드〮려〮|기드〮리다〮|기드〮리니〮	<i>verb</i><br><ol><li>(transitive) to wait</li></ol>
기름|kìlúm|기름〮	<i>noun</i><br><ol><li>oil</li></ol>
기름믈|kilummul	<i>noun</i><br><ol><li>broth</li></ol>
기릐|kiluy	<i>noun</i><br><ol><li>length</li></ol>
기춤|kichwum	<i>noun</i><br><ol><li>a cough</li></ol>
길|kǐl|길〯|길〮|kíl	<i>noun</i><br><ol><li>a gil, a traditional Korean unit of measurement</li></ol>
길나다|kilnata	<i>verb</i><br><ol><li>to depart</li></ol>
긿|kíl|긿〮|길〮|길헤〮|kílh|길	<i>noun</i><br><ol><li>road, path</li></ol>
깃다|kìstá|기츠〮니〮|기ᇧ다|기처〮|kichta|phonemic orthography 깇다〮|기ᇧ다〮|깃다〮|kìsktá|깃그〮니〮|깇다|깃거〮	<i>verb</i><br><ol><li>to rejoice</li><li>to cough</li></ol>
나ᄋᆞᆯ|naol	<i>noun</i><br><ol><li>four days</li></ol>
나랗|nàláh|나라〮|nàlá|나랗〮|나라|나라〮해〮	<i>noun</i><br><ol><li>country, nation, kingdom</li><li>(metonymically) king, monarch</li></ol>
나모|남ᄀᆡ〮|nàmwò	<i>noun</i><br><ol><li>tree</li><li>wood</li></ol>
나좋|나조ᄒᆡ〮|nàcwò|나조|nàcwòh	<i>noun</i><br><ol><li>evening</li></ol>
나타|나ᄒᆞ니〮라〮|나ᄒᆞᆯ쎠〮|나턴〮다〮|나하〮시다〮|nàthá|나턴〮고〮|나ᄒᆞ시〮ᄂᆞ다〮|난ᄂᆞᆫ|나ᄒᆞ시ᇙ〮|나하〮다〮|나ᄒᆞ시〮니〮ᅌᅵ다〮|나한〮다〮|나ᄒᆞ리〮ᅌᅵᆺ가〮|나호〮라〮|나타〮라〮|나ᄒᆞ시〮ᄂᆞ〮ᅌᅵ다〮|나ᄒᆞ시〮리〮ᅌᅵ다〮|나ᄊᆞᆸ〯더〮니라〮|난ᄂᆞ니〮ᅌᅵᆺ고〮|나콴〮ᄃᆡ〮|나터〮라〮|나ᄒᆞ시〮리라〮|나하〮시〮니라〮|나ᄒᆞ리〮ᅌᅵ다〮|나타가〮|나ᄒᆞᆫ|나하〮시니〮ᅌᅵ다〮|난ᄂᆞ니〮라〮|나ᄒᆞ리〮ᅌᅵᆺ고〮|나호〮ᄃᆡ〮|나호〮려〮|나하〮시〮ᅌᅵ다〮|나혼〮|나한〮댄〮|나ᄒᆞ시〮다〮|nahta|나호〮리라〮|나터〮시다〮|나ᄒᆞ나〮|나ᄒᆞ려〮|나호〮마〮|나호〮ᅌᅵ다〮|나하〮|나ᄒᆞ샴〮|나ᄒᆞ시〮ᄂᆞ〮니라〮|난ᄂᆞᅌᅵ다〮|나하〮든〮|나ᄒᆞ시〮ᄂᆞᆫ〮|나ᄒᆞᅌᅵ다〮|나터〮시〮ᅌᅵ다〮|나ᄒᆞᆫᄃᆞᆯ〮|나쳐〮|나호〮리〮ᅌᅵ다〮|난노〮라〮|나ᄊᆞᆸ〯ᄂᆞ〮니라〮|나싸〮ᅌᅵ다〮|나ᄊᆞᄫᅡ〮다〮|나ᄒᆞ니〮ᅌᅵ다〮|나홈〮|나톳〮다〮|나터〮녀〮|나ᄒᆞ리〮라〮|나ᄊᆞᄫᆞ〮니라〮|낳다|나ᄒᆞ료〮|나ᄒᆞ시〮ᅌᅵ다〮|나ᄒᆞᇙ|나ᄒᆞᆫ뎌〮|나ᄒᆞ뇨〮|난ᄂᆞ니〮ᅌᅵᆺ가〮|나ᄒᆞᇙ가〮|나ᄒᆞ니〮ᅌᅵᆺ고〮|난ᄂᆞ니〮ᅌᅵ다〮|나해〮ᅌᅵ다〮|난ᄂᆞ녀〮|나코〮|나하〮녀〮|나ᄒᆞᇙ고〮|나ᄊᆞᆸ〯ᄂᆞ다〮|나터〮뇨〮|나ᄒᆞ신〮|나ᄊᆞᆸ〯다〮|나ᄊᆞᆸ〯더라〮|나ᄒᆞ녀〮|나ᄒᆞ니〮|나타〮|나코〮ᅌᅵ다〮|난ᄂᆞᆫ고〮|나터〮시〮니라〮|난ᄂᆞ다〮|나토〮다〮|나ᄊᆞᄫᆞ〮리라〮|나ᄒᆞᆫ고〮|나코〮라〮|나한〮마ᄅᆞᆫ〮|나ᄒᆞᆫ가〮|난ᄂᆞᆫ다〮|난ᄂᆞ뇨〮|no separate forms|나턴〮가〮|나호ᇙ〮|난ᄂᆞᆫ가〮|나ᄒᆞ니〮ᅌᅵᆺ가〮|나해〮라〮|난노〮ᅌᅵ다〮|나ᄒᆞ면〮|나터〮니라〮|나ᄒᆞᇙ다〮|나ᄒᆞ라〮|나하〮니라〮|나콰〮뎌〮 (nàkhwátyé, desires other's action)|나ᄒᆞ며〮|나ᄒᆞᆯᄊᆡ〮|나ᄒᆞᆫ대〮|나ᄒᆞ쇼〮셔〮|나ᄒᆞᆫ다〮|나ᄒᆞ시〮니라〮|나하〮뇨〮|나ᄒᆞ시〮ᄂᆞ니〮ᅌᅵ다〮|나코〮져〮 (nàkhwócyé, desires one's own action)|난논〮|나ᄊᆞᄫᅡ〮니라〮|나하〮ᄂᆞᆯ〮|나콰〮라〮|나터〮시니〮ᅌᅵ다〮	<i>verb</i><br><ol><li>(of a female) to lay, to give birth to; (of a male) to sire</li></ol>
낛|낙새|naks	<i>noun</i><br><ol><li>fishing hook, fishing</li><li>hook, gaff. compare Korean 갈고리 (galgori)</li><li>tax payment</li></ol>
낟다|나타〮|낟다〮|nàttá|나ᄐᆞ〮니〮|나ᄃᆞ〮니〮|나다〮	<i>verb</i><br><ol><li>(intransitive) to emerge, to appear</li></ol>
날|날〮|nál|나래〮	<i>noun</i><br><ol><li>day</li></ol>
남진|nàmcìn	<i>noun</i><br><ol><li>man</li><li>husband</li></ol>
낮|낫〮|낫|낮〮|nás|nác|나ᄌᆡ〮|나재〮	<i>noun</i><br><ol><li>daytime</li><li>noon</li></ol>
낳|náh|낳〮	<i>noun</i><br><ol><li>age</li></ol>
냏|냏〯|nǎyh	<i>noun</i><br><ol><li>stream</li></ol>
너|nè	<i>pron</i><br><ol><li>you</li></ol>
넌즈시|nèncùsì	<i>adv</i><br><ol><li>discreetly, implicitly</li><li>without a care, without concern</li></ol>
넙다|nepta	<i>adj</i><br><ol><li>to be wide</li></ol>
넿|něyh|넿〯	<i>num</i><br><ol><li>four</li></ol>
녀ᄌᆞ|nyeco	<i>noun</i><br><ol><li>woman; girl; lady; female</li></ol>
녀다|녀〮아〮|nyètá|녀다〮|녀니〮	<i>verb</i><br><ol><li>to go; to move physically towards another place</li></ol>
녀름|녀름〮|nyèlúm	<i>noun</i><br><ol><li>summer</li></ol>
녀름지ᅀᅳ다|nyelumcizuta	<i>verb</i><br><ol><li>to farm, to do farming, farm work</li></ol>
노올|nwoGwol	<i>noun</i><br><ol><li>parasite</li></ol>
노타|노코〮ᅌᅵ다〮|노ᄒᆞ나〮|노ᄒᆞ뇨〮|논ᄂᆞ니〮ᅌᅵᆺ가〮|노ᄊᆞᆸ〯ᄂᆞ〮니라〮|노터〮시다〮|노ᄊᆞᆸ〯더라〮|노타〮|노ᄒᆞ시〮ᄂᆞ다〮|논ᄂᆞ뇨〮|논ᄂᆞᅌᅵ다〮|노호〮려〮|노한〮마ᄅᆞᆫ〮|노ᄒᆞ시ᇙ〮|노토〮다〮|노ᄒᆞᇙ다〮|노ᄒᆞ시〮ᄂᆞ니〮ᅌᅵ다〮|노코〮져〮 (nwòkhwócyé, desires one's own action)|노하〮든〮|노하〮다〮|노ᄒᆞ시〮니〮ᅌᅵ다〮|노ᄒᆞ신〮|노ᄒᆞᅌᅵ다〮|노타가〮|노ᄒᆞ시〮니라〮|논노〮라〮|노ᄒᆞᆫ가〮|노ᄒᆞ니〮|노ᄒᆞᆫ뎌〮|노ᄒᆞᆫ다〮|노호〮ᅌᅵ다〮|노턴〮가〮|노ᄒᆞ니〮ᅌᅵᆺ고〮|노ᄒᆞ시〮리〮ᅌᅵ다〮|노ᄒᆞ려〮|노호〮리라〮|논ᄂᆞᆫ다〮|노콰〮라〮|노ᄒᆞ시〮ᅌᅵ다〮|노하〮시〮ᅌᅵ다〮|노ᄊᆞᄫᅡ〮다〮|phonemic orthography 놓다〮|노콴〮ᄃᆡ〮|노터〮시니〮ᅌᅵ다〮|논ᄂᆞ니〮라〮|노ᄒᆞᇙ가〮|노하〮ᄂᆞᆯ〮|논ᄂᆞ니〮ᅌᅵᆺ고〮|노ᄊᆞᆸ〯더〮니라〮|노터〮시〮ᅌᅵ다〮|노ᄒᆞ시〮리라〮|노홈〮|노ᄒᆞ면〮|노ᄒᆞᆫ대〮|노ᄒᆞ니〮ᅌᅵ다〮|노해〮라〮|노ᄊᆞᄫᅡ〮니라〮|노호〮라〮|노한〮다〮|노혼〮|노ᄊᆞᆸ〯ᄂᆞ다〮|노호〮마〮|노ᄊᆞᆸ〯다〮|노터〮라〮|노터〮뇨〮|노ᄒᆞ시〮ᄂᆞ〮니라〮|노ᄒᆞ라〮|노호ᇙ〮|노코〮라〮|노ᄒᆞᇙ고〮|노싸〮ᅌᅵ다〮|놓다|노ᄒᆞ니〮ᅌᅵᆺ가〮|노코〮|노하〮니라〮|노ᄒᆞ샴〮|노ᄒᆞ녀〮|노ᄒᆞ리〮ᅌᅵᆺ가〮|논ᄂᆞᆫ가〮|노ᄒᆞ시〮ᄂᆞᆫ〮|nwòthá|노ᄒᆞ리〮ᅌᅵᆺ고〮|노ᄒᆞᆯᄊᆡ〮|논노〮ᅌᅵ다〮|노ᄒᆞᇙ|노ᄒᆞ쇼〮셔〮|노호〮리〮ᅌᅵ다〮|노ᄒᆞ시〮다〮|노쳐〮|논ᄂᆞᆫ고〮|노하〮녀〮|노ᄒᆞᆫᄃᆞᆯ〮|노터〮니라〮|노하〮시〮니라〮|노터〮시〮니라〮|노해〮ᅌᅵ다〮|노ᄒᆞ시〮ᄂᆞ〮ᅌᅵ다〮|노ᄒᆞ며〮|노ᄒᆞᆫ|no separate forms|노터〮녀〮|논논〮|노타〮라〮|노ᄊᆞᄫᆞ〮리라〮|노ᄒᆞ리〮ᅌᅵ다〮|노ᄒᆞᆯ쎠〮|노하〮뇨〮|노콰〮뎌〮 (nwòkhwátyé, desires other's action)|노호〮ᄃᆡ〮|논ᄂᆞᆫ|논ᄂᆞ니〮ᅌᅵ다〮|노턴〮고〮|노턴〮다〮|노ᄒᆞ료〮|논ᄂᆞ다〮|노ᄒᆞ리〮라〮|노하〮|노하〮시다〮|nwòh-tá|노하〮시니〮ᅌᅵ다〮|노톳〮다〮|놓다〮|노ᄒᆞ니〮라〮|논ᄂᆞ녀〮|노ᄊᆞᄫᆞ〮니라〮|노한〮댄〮|노ᄒᆞᆫ고〮	<i>verb</i><br><ol><li>(transitive) to put, to place</li></ol>
논|노내〮|nwón|논〮	<i>noun</i><br><ol><li>paddy field</li></ol>
놀애|놀애〮|nwòlGáy	<i>noun</i><br><ol><li>song</li></ol>
누|누〯를〮|뉘〮|nwú|눌〯|누〮|뉘〯|누〮를〮	<i>pron</i><br><ol><li>(interrogative) who?</li></ol>
누ᇈ믈|누ᇈ〮믈〮|nwún-z-múl	<i>noun</i><br><ol><li>tear</li></ol>
누의|nwùùy	<i>noun</i><br><ol><li>sister of a male</li></ol>
눈|눈〮|nwǔn|눈〯|누〯네〮|nwún|누네〮	<i>noun</i><br><ol><li>eye</li><li>snow</li></ol>
니르ᅘᅧ다|nilu.hhyeta	<i>verb</i><br><ol><li>to rouse</li><li>to cause, trigger, create, bring</li><li>to raise, kindle or stir up</li></ol>
니맣|nìmá|니마|니맣〮|니마〮해〮|니마〮ᄒᆡ〮|nìmáh|니마〮	<i>noun</i><br><ol><li>forehead, brow</li></ol>
닐굽|nìlkwúp|닐굽〮	<i>num</i><br><ol><li>seven</li></ol>
닐웨|nìlGwéy|닐웨〮	<i>noun</i><br><ol><li>seven days</li></ol>
닐위다|닐〯위〯오〮|닐〯위〯다〮|닐〯위여〮|nǐlGwǔytá|닐〯위면〮	<i>verb</i><br><ol><li>to cause to rise, to cause to emerge, to bring about</li></ol>
닐흔|닐흔〮|nìlhún	<i>num</i><br><ol><li>seventy</li></ol>
님|님〯|nǐm	<i>noun</i><br><ol><li>lord, master</li><li>one's love, the beloved</li></ol><br><i>suffix</i><br><ol><li>honored; esteemed; attached to nouns to show respect for the noun</li></ol>
님금|님〯금〮|nǐmkúm	<i>noun</i><br><ol><li>king; monarch</li></ol>
닙다|니버〮|니브〮니〮|닙다〮|nìptá	<i>verb</i><br><ol><li>to wear; to put on</li></ol>
닢|닙|니페〮|níp|níph|닢〮|닙〮	<i>noun</i><br><ol><li>leaf</li></ol>
다|다〯|tǎ	<i>adv</i><br><ol><li>everything, all, completely</li></ol>
다ᄉᆞᆺ|tàsós|다ᄉᆞᆺ〮	<i>num</i><br><ol><li>five</li></ol>
다대골|Tàtàykwǒl|다대골〯	<i>name</i><br><ol><li>a settlement of Tatars or Mongols in modern Hongwon County, North Korea</li></ol>
다로ᇰ디리|talwongtili	<i>intj</i><br><ol><li>A common vocable in songs and poetry, apparently without any meaning.</li></ol>
달ᄠᅳ다|talptuta	<i>verb</i><br><ol><li>to become wet</li><li>to indulge in</li></ol>
달내|달〮내〯|Tálnǎy	<i>name</i><br><ol><li>a tributary of the Han River running through Chungju, now called 달천 (達川, Dalcheon)</li><li>a stream in Chongju, now North Korea, today called 달천 (㺚川, Dalcheon)</li><li>presumably other streams in Korea which are now called Dalcheon, Dallae, etc., although these are not attested in Middle Korean</li></ol>
닷쇄|tassway	<i>noun</i><br><ol><li>five days</li></ol>
더|tè	<i>adv</i><br><ol><li>more, -er (to a greater extent)</li></ol>
더디다|tetita	<i>verb</i><br><ol><li>to throw</li></ol>
더럽다|더〯럽고〮|더〯럽다〮|tělèptá|더〯러ᄫᅥ〮|더〯러〮ᄫᅳ면〮	<i>adj</i><br><ol><li>to be dirty</li></ol>
덥다|těptá|덥〯고〮|덥〯다〮|더ᄫᅳ〮면〮|더ᄫᅥ〮	<i>adj</i><br><ol><li>(to be) hot, warm</li></ol>
뎔|뎌레〮|뎔〮|tyél	<i>noun</i><br><ol><li>Buddhist temple</li></ol>
도ᄌᆞᆨ|twòcòk|盜賊	<i>noun</i><br><ol><li>thief, robber</li><li>(metonymically) robbery</li></ol>
도ᇰᄉᆡᇰ|twongsoyng	<i>noun</i><br><ol><li>younger sibling</li></ol>
도ᇰᄒᆡ|twonghoy	<i>noun</i><br><ol><li>(an earthenware) jar</li></ol>
도ᇰ모|twongmwo	<i>noun</i><br><ol><li>friend, buddy</li></ol>
도로ᄒᆞ다|twolwohota	<i>verb</i><br><ol><li>to repay, to return (something loaned)</li></ol>
도산|twosan	<i>noun</i><br><ol><li>gift; present</li></ol>
독|도ᄀᆡ〮|毒|독〮|twòk|twók	<i>noun</i><br><ol><li>jar; pot</li><li>poison; venom</li></ol>
돌숫|twolswus	<i>noun</i><br><ol><li>coal</li></ol>
돓|돓〯|돌〯해〮|twǒlh	<i>noun</i><br><ol><li>stone</li></ol>
돗가비|twóskàpí|돗〮가비〮	<i>noun</i><br><ol><li>dokkaebi (mythical being in Korean folklore or fairy tales)</li></ol>
돝|도태〮|twòth	<i>noun</i><br><ol><li>pig, swine</li></ol>
되|twǒy|되〯	<i>noun</i><br><ol><li>Jurchen</li></ol>
됴타|tyǒthá|됴〯ᄒᆞᆫ가〮|됸〯ᄂᆞᆫ〮|됸〯ᄂᆞᆫ고〮|됴〯ᄒᆞ〮쇼셔〮|됴〯ᄒᆞ니〮|됴〯ᄒᆞᆫ다〮|됴〯ᄒᆞᆫ〮|됴〯ᄊᆞᆸ〯거다〮|됴〯ᄊᆞᆸ〯ᄂᆞ다〮|됴〯커뇨〮|됴〯호ᄃᆡ〮|됴〯ᄒᆞ며〮|됸〯ᄂᆞᆫ가〮|됴〯ᄒᆞ니〮ᅌᅵᆺ가〮|됴〯턴고〮|됴〯ᄒᆞ시〮리라〮|됴〯호마〮|됴〯코〮ᅌᅵ다〮|됸〯ᄂᆞᆫ다〮|됴〯코〮|됴〯ᄒᆞ리〮ᅌᅵᆺ가〮|됴〯ᄊᆞᆸ〯더라〮|됴〯ᄒᆞ〮시다〮|됴〯호리〮ᅌᅵ다〮|됴〯터녀〮|됴〯ᄒᆞ니〮ᅌᅵᆺ고〮|됴〯톳다〮|됴〯ᄒᆞ〮시니〮ᅌᅵ다〮|됴〯ᄒᆞ라〮|됴〯컨댄〮|됴〯터〮시다〮|됴〯터〮니라〮|둏〯다〮|됴〯ᄒᆞ〮시ᄂᆞ〮ᅌᅵ다〮|됴〯하〮|됴〯코라〮|됸〯ᄂᆞ〮ᅌᅵ다〮|됸〯ᄂᆞ다〮|됴〯콰라〮|됴〯커시〮ᅌᅵ다〮|됴〯호라〮|됴〯호〮ᅌᅵ다〮|됴〯해〮ᅌᅵ다〮|됴〯ᄒᆞ시〮ᄂᆞ다〮|됸〯ᄂᆞ뇨〮|됴〯ᄒᆞᆫᄃᆞᆯ〮|됴〯토다〮|됴〯커〮시니〮ᅌᅵ다〮|됴〯터라〮|됴〯ᄊᆞᆸ〯거〮니라〮|됴〯타가〮|됴〯ᄒᆞ샴〮|됴〯호〮리라〮|됸〯ᄂᆞ니〮ᅌᅵᆺ고〮|됴〯ᄒᆞ시〮ᅌᅵ다〮|됴〯ᄒᆞ〮시리〮ᅌᅵ다〮|됴〯ᄒᆞ시〮ᄂᆞ니〮ᅌᅵ다〮|됴〯ᄒᆞᆫ고〮|됴〯ᄒᆞ니〮ᅌᅵ다〮|됴〯ᄒᆞᆫ뎌〮|됴〯ᄒᆞ〮시ᄂᆞᆫ〮|됴〯호려〮|됴〯ᄒᆞᇙ고〮|됴〯커〮니라〮|됴〯커녀〮|됴〯타라〮|됸〯ᄂᆞ니〮ᅌᅵᆺ가〮|둏다|됴〯커시〮니라〮|됴〯ᄒᆞ시ᇙ〮|됴〯홈〮|됴〯ᄒᆞ신〮|됸〯ᄂᆞ〮니라〮|됴〯터뇨〮|됴〯커다〮|됴〯ᄒᆞᆯ쎠〮|됸〯ᄂᆞ녀〮|됴〯ᄒᆞ리〮ᅌᅵ다〮|됴〯ᄒᆞ녀〮|됴〯ᄊᆞᆸ〯더〮니라〮|됴〯터시〮ᅌᅵ다〮|됴〯터〮시니〮ᅌᅵ다〮|됴〯ᄒᆞᆯᄊᆡ〮|됴〯ᄊᆞᆸ〯ᄂᆞ〮니라〮|됴〯콴ᄃᆡ〮|됴〯커든〮|됴〯컨다〮|됴〯코져〮|됴〯ᄒᆞᇙ〮|됴〯싸〮ᅌᅵ다〮|됴〯ᄒᆞ시〮니라〮|됸〯노라〮|됴〯터시〮니라〮|됴〯커ᄂᆞᆯ〮|됴〯혼〮|됴〯턴가〮|됴〯턴다〮|됴〯ᄒᆞ〮ᅌᅵ다〮|됴〯ᄒᆞᇙ다〮|됴〯ᄒᆞ뇨〮|됴〯콰뎌〮 (tyǒkhwàtyé, desires other's action)|됸〯ᄂᆞ니〮ᅌᅵ다〮|됴〯ᄒᆞ〮시ᄂᆞ〮니라〮|됴〯ᄒᆞ리〮ᅌᅵᆺ고〮|됴〯컨〮마ᄅᆞᆫ〮|됴〯ᄒᆞ〮리라〮|no separate forms|됴〯ᄒᆞ려〮|됸〯노〮ᅌᅵ다〮|됴〯ᄊᆞᆸ〯다〮|됴〯ᄊᆞᄫᆞ〮리라〮|됴〯ᄒᆞ〮니라〮|tyǒhtá|됴〯타〮|됴〯ᄊᆞᄫᆞ〮니라〮|됴〯ᄒᆞ나〮|됴〯ᄒᆞᆫ대〮|됴〯호ᇙ〮|됴〯해라〮|됴〯ᄒᆞ면〮|됴〯ᄒᆞ료〮|됴〯ᄒᆞᇙ가〮|됴〯커〮시다〮|됸〯논〮|됴〯쳐〮	<i>verb</i><br><ol><li>(intransitive) to become (or to be) pleasing; to become (or to be) good</li><li>(intransitive) to become (or to be) of superior quality; to become (or to be) good</li><li>(intransitive) to become (or to be) suitable or good for a specific purpose</li><li>(intransitive) to get better, to be healed, to recover from an illness</li><li>(uncommon, transitive) to be pleased by, to consider as good</li><li>(hapax, transitive) to heal, to cure (possibly awkward literal translation from Chinese)</li></ol>
두루걷다|tuluketta	<i>verb</i><br><ol><li>to wander</li></ol>
두루치|twulwuchi	<i>noun</i><br><ol><li>shark</li><li>a type of skirt worn by lower-class women in the past, with a narrow width and short length</li></ol>
둟|twǔlh|둟〯	<i>num</i><br><ol><li>two</li></ol>
뒿|twǔyh|뒤〯헤〮|뒿〯	<i>noun</i><br><ol><li>back</li><li>north</li></ol>
듀ᇰ|tyùng	<i>noun</i><br><ol><li>middle; center; amongst</li></ol>
드러치다|드러〮치니〮|드러〮치어〮|드러〮치다〮|tùléchìtá	<i>verb</i><br><ol><li>to tremble</li></ol>
드릏|드릏〮|듫〯|드르〮헤〮|들〯헤〮|듫|tǔlh|tùlúh	<i>noun</i><br><ol><li>meadow</li></ol>
듬바되|듬바되〮|澄波渡|Tùmpàtwóy	<i>name</i><br><ol><li>A famous crossing over the Imjin River, now in Yeoncheon County near the Korean Demilitarized Zone</li></ol>
디히|디〮히〮|tìhí|tíhí|디히〮	<i>noun</i><br><ol><li>kimchi</li></ol>
딮|tiph	<i>noun</i><br><ol><li>straw</li></ol>
렴토ᇰ|lyemthwong	<i>noun</i><br><ol><li>heart</li></ol>
림ᄇᆡ|limpoy	<i>noun</i><br><ol><li>In the highly archaic fifteenth-century song "Dongdong", the speaker says that she receives virtue in "kwompoy" and fortune in "limpoy". The meaning of this term is uncertain.</li></ol>
마ᄂᆞᆯ|mànól|마ᄂᆞᆯ〮	<i>noun</i><br><ol><li>garlic</li></ol>
마고|màkwó|마고〮	<i>adv</i><br><ol><li>blocking; stopping up; presenting an obstacle</li><li>seeking to block; in order to block</li></ol>
마치|machi	<i>noun</i><br><ol><li>hammer</li></ol>
만ᄒᆞ다|mǎn-hòtá|만〯ᄒᆞ니〮|만〯ᄒᆞ다〮|만〯ᄒᆞ야〮	<i>adj</i><br><ol><li>(less common) to be many</li></ol>
말|말〮|mál|mǎl|말〯	<i>noun</i><br><ol><li>word, speech, language</li><li>measure (containing about 18 liters or 10 doe (되 (doe))</li><li>a unit of measure (about 18 liters)</li></ol>
말ᄊᆞᆷ|mǎlssòm|말〯ᄊᆞᆷ	<i>noun</i><br><ol><li>word or speech</li></ol>
말ᄒᆞ다|mǎl-hòtá|말〯ᄒᆞ다〮	<i>verb</i><br><ol><li>to speak, talk</li></ol>
말하|말하〮|màlhá	<i>noun</i><br><ol><li>spleen</li></ol>
맛ᄀᆞᆱ다|maskolmta	<i>verb</i><br><ol><li>to answer, respond</li></ol>
맡|math	<i>noun</i><br><ol><li>field</li></ol>
맣|màh	<i>noun</i><br><ol><li>monsoon rains</li></ol>
머섬|mesem	<i>noun</i><br><ol><li>farmhand</li></ol>
머툰ᄂᆞᄅᆞ|Mèthúnnòlò|머툰〮ᄂᆞᄅᆞ	<i>name</i><br><ol><li>a ford across the lower Taedong River near Pyongyang</li></ol>
멋다|mèctá|머저〮|phonemic orthography 멎다〮|멎다〮|멎다|머즈〮니〮|mèstá|멋다〮	<i>adj</i><br><ol><li>to be inauspicious</li></ol>
멎|mèc	<i>noun</i><br><ol><li>cherry fruit</li></ol>
며ᇰ|myeng	<i>noun</i><br><ol><li>a person's name</li></ol>
모ᄀᆡ|모〮ᄀᆡ〮|mwókóy	<i>noun</i><br><ol><li>mosquito</li></ol>
모ᄃᆡ|mwǒtóy|모〯ᄃᆡ〮	<i>adv</i><br><ol><li>necessarily</li><li>fervently</li></ol>
목|mwòk|모ᄀᆡ〮	<i>noun</i><br><ol><li>neck</li></ol>
몰애|몰애〮|mwòlGáy	<i>noun</i><br><ol><li>sand</li></ol>
몸|몸〮|mwóm|모매〮	<i>noun</i><br><ol><li>body</li></ol>
뫼ᅀᅡ리|뫼〯ᅀᅡ리〮|mwǒyzàlí	<i>noun</i><br><ol><li>echo</li></ol>
묏괴|묏〯괴〯|mwǒy-s kwǒy	<i>noun</i><br><ol><li>wildcat, lynx, bobcat</li></ol>
묗|mwǒyh|mwǒy|뫼〯|뫼|묗〯	<i>noun</i><br><ol><li>mountain</li></ol>
무ᅀᅮ|mwùzwù|무ᇫㅇ	<i>noun</i><br><ol><li>Korean radish, a variety of daikon.</li></ol>
무뤂|무루페〮|mwùlwùph|mwùlwùp|무룹	<i>noun</i><br><ol><li>knee</li></ol>
무뤼|mwúlwúy|무〮뤼〮	<i>noun</i><br><ol><li>hail (balls of ice)</li></ol>
뭍|mwùth|무틔〮	<i>noun</i><br><ol><li>(dry) land</li></ol>
뮈다|뮌〯다〮|뮈〯더〮시다〮|뮌〯뎌〮|뮈〯더〮시니〮ᅌᅵ다〮|무여〮|뮌〯대〮|뮈〯던다〮|뮈〯ᅌᅵ다〮|뮈〯료〮|뮈〯녀〮|뮈ᇙ〯가〮|뮈〯리라〮|뮈〯라〮|뮈〯ᄂᆞ니〮ᅌᅵᆺ고〮|뮈〯니라〮|뮈〯시ᄂᆞ〮니라〮|뮈〯오〮|뮈〯ᄂᆞ니〮ᅌᅵ다〮|뮈〯던가〮|뮈〯어〮시니〮ᅌᅵ다〮|무유〮리〮ᅌᅵ다〮|뮈〯던고〮|뮈〯리〮ᅌᅵᆺ고〮|뮈〯ᄂᆞᆫ다〮|뮈〯오라〮|뮈〯논〮|뮈〯어시〮ᅌᅵ다〮|뮌〯고〮|무유〮라〮|무유〮ᅌᅵ다〮|뮈ᇙ〯|뮈〯더라〮|뮈〯시〮ᄂᆞ다〮|mwǔytá|뮈〯ᄂᆞᆫ가〮|뮈〯쇼셔〮|뮐〯ᄊᆡ〮|뮈〯사〮ᅌᅵ다〮|뮈〯어〮시다〮|뮈〯ᄂᆞᆫ고〮|뮈〯ᄂᆞ다〮|뮈〯샴〮|뮈〯려〮|뮈〯더시〮ᅌᅵ다〮|뮈ᇙ〯고〮|뮈〯더〮니라〮|뮈〯시ᄂᆞ〮ᅌᅵ다〮|뮈〯ᄂᆞ니〮ᅌᅵᆺ가〮|무윰〮|뮈〯시ᄂᆞᆫ〮|무예〮ᅌᅵ다〮|무예〮라〮|뮈〯와뎌〮 (mwǔyGwàtyé, desires other's action)|뮈〯다가〮|무윤〮|뮈〯ᄂᆞ뇨〮|뮈〯언댄〮|뮈〯시〮ᄂᆞ니〮ᅌᅵ다〮|무유〮리라〮|뮐〯쎠〮|뮈〯시다〮|뮈〯더뇨〮|뮈〯오져〮 (mwǔyGwòcyé, desires one's own action)|뮈〯도다〮|뮈〯리〮ᅌᅵ다〮|뮈〯며〮|뮈〯시〮니라〮|무유〮려〮|뮌〯가〮|뮈〯더녀〮|뮈〯더시〮니라〮|무유〮마〮|뮈〯시〮ᅌᅵ다〮|뮌〯|뮈〯다〮|뮈〯시니〮ᅌᅵ다〮|뮈〯나〮|뮌〯ᄃᆞᆯ〮|무유ᇙ〮|뮈〯어시〮니라〮|뮈〯시〮리라〮|뮈〯져〮|뮈〯ᄂᆞ녀〮|뮈〯ᄂᆞ〮ᅌᅵ다〮|뮈〯면〮|뮈〯ᄂᆞᆫ〮|뮈〯시리〮ᅌᅵ다〮|뮈〯노라〮|뮈〯니〮ᅌᅵᆺ고〮|무유〮ᄃᆡ〮|뮈〯니〮|no separate forms|뮈〯리〮ᅌᅵᆺ가〮|뮈〯언〮마ᄅᆞᆫ〮|뮈〯신〮|뮈〯어ᄂᆞᆯ〮|뮈〯ᄂᆞ〮니라〮|뮈〯어든〮|뮈〯뇨〮|뮈〯니〮ᅌᅵ다〮|뮈〯완ᄃᆡ〮|뮈ᇙ〯다〮|뮈〯니〮ᅌᅵᆺ가〮|뮈〯돗다〮|뮈〯다라〮|뮈〯시ᇙ〮|뮈〯노〮ᅌᅵ다〮	<i>verb</i><br><ol><li>(intransitive) to move, to shake</li></ol>
므스|므스〮|mùsú	<i>pron</i><br><ol><li>(interrogative) what</li></ol><br><i>det</i><br><ol><li>(interrogative) what</li></ol><br><i>adv</i><br><ol><li>(interrogative) Alternative form of 므슴 (musum, “how could...”)</li></ol>
므슥|mùsúk|므슥〮	<i>pron</i><br><ol><li>(interrogative) what</li></ol>
므슴|mùsúm|므슴〮	<i>pron</i><br><ol><li>(interrogative) what</li></ol><br><i>det</i><br><ol><li>(interrogative, often rhetorical) what</li></ol><br><i>adv</i><br><ol><li>(interrogative, rhetorical) how is it...</li></ol>
므슷|므슷〮|mùsús	<i>det</i><br><ol><li>(interrogative) what</li></ol>
므즤다|므즤여〮|mucuyta	<i>verb</i><br><ol><li>(of clouds) to gather; to be covered (with clouds)</li></ol>
믈|múl|므〮레〮|믈〮	<i>noun</i><br><ol><li>water</li><li>liquid</li></ol>
믈뎜|multyem	<i>noun</i><br><ol><li>waterdrop</li></ol>
믌결|mulskyel	<i>noun</i><br><ol><li>wave; tide</li></ol>
믿나랗|mitnalah	<i>noun</i><br><ol><li>home country</li></ol>
믿다|mitta	<i>verb</i><br><ol><li>to believe in something; to trust someone</li></ol>
밋다|미처〮|mìstá|mìchtá|및다|밋다〮|미츠〮니〮|및다〮	<i>verb</i><br><ol><li>to reach</li></ol>
밑|mìth|미틔〮|mìt|믿	<i>noun</i><br><ol><li>basis, foundation (in general)</li><li>bottom, underneath</li></ol>
바ᄅᆞᆯ|바ᄅᆞ〮래〮|바ᄅᆞᆯ〮|pàlól	<i>noun</i><br><ol><li>sea; ocean</li></ol>
바ᇧ|밧긔〮|pàsk	<i>noun</i><br><ol><li>outside</li></ol>
바ᇰ올|pangGwol	<i>noun</i><br><ol><li>drop</li></ol>
바닿|바닿〮|pàtá|바다|바다〮해〮|바다〮|pàtáh	<i>noun</i><br><ol><li>(less common) sea; ocean</li></ol>
바독|波獨|바독〮|pàtwók	<i>noun</i><br><ol><li>the board game of go</li></ol>
바디|pati	<i>noun</i><br><ol><li>pants, trousers</li></ol>
바오달|波吾達|바오달〮	<i>noun</i><br><ol><li>an encampment, such as for a military host or for the royal entourage</li></ol>
바지|paci	<i>noun</i><br><ol><li>a man of skill</li><li>master craftsman, master artisan, blacksmith, smith</li></ol>
바톨|pàthwól|바톨〮	<i>noun</i><br><ol><li>hero</li></ol>
바회|pàhwóy|바회〮	<i>noun</i><br><ol><li>rock</li></ol>
발|바〯래〮|발〯|발〮|pǎl|pál|바래〮	<i>noun</i><br><ol><li>foot</li><li>blind, screen, or curtain made with woven bamboo or reed strips</li></ol>
밤|바〯매〮|pám|바ᄆᆡ〮|밤〮|pǎm|밤〯	<i>noun</i><br><ol><li>night</li><li>chestnut</li></ol>
밥고리|papkwoli	<i>noun</i><br><ol><li>lunchbox</li></ol>
밭|바ᄐᆡ〮|pàth|받|pàt	<i>noun</i><br><ol><li>dry field (for crops)</li></ol>
벌|벌〯|pěl	<i>noun</i><br><ol><li>bee (insect)</li></ol>
벌에|pèlGéy|벌에〮	<i>noun</i><br><ol><li>bug, insect (any small arthropod such as insects, spiders, etc.)</li></ol>
범|범〯|pĕm	<i>noun</i><br><ol><li>tiger</li></ol>
벼기다|pyekita	<i>verb</i><br><ol><li>to make a vow; to make a promise; to cry out in a vow</li></ol>
별|벼〯레〮|pyěl|별〯	<i>noun</i><br><ol><li>star</li></ol>
보다|보리〮라〮|보〮ᄂᆞ〮니라〮|보〮다라〮|보〮ᄂᆞ〮ᅌᅵ다〮|보〮시〮ᅌᅵ다〮|보〮ᄂᆞ니〮ᅌᅵᆺ고〮|보〮ᄂᆞ뇨〮|보ᇙ고〮|볼ᄊᆡ〮|보〮더라〮|보〯려〮|보〮ᄂᆞ니〮ᅌᅵᆺ가〮|보〮던고〮|보〮더뇨〮|보〯라〮|보〮더〮니라〮|보〮더녀〮|보〮시다〮|보〮노라〮|본|보져〮|보〮건〮마ᄅᆞᆫ〮|볼쎠〮|보〮ᅀᆞᆸ〯ᄂᆞ다〮|보리〮ᅌᅵ다〮|보〮돗다〮|보녀〮|보〮거〮시니〮ᅌᅵ다〮|보니〮라〮|보〮ᅀᆞᆸ〯더라〮|보〮더〮시〮ᅌᅵ다〮|보〮더시〮니라〮|보〮애라〮|보〮ᅀᆞᆸ〯ᄂᆞ〮니라〮|보뇨〮|보니〮ᅌᅵᆺ가〮|보〮ᄂᆞᆫ고〮|보〯리라〮|본가〮|보〮던가〮|보〮ᄂᆞ니〮ᅌᅵ다〮|보〮시〮ᄂᆞ니〮ᅌᅵ다〮|보〮다가〮|보아〮|본뎌〮|보ᇙ|보ᇙ다〮|보〮ᅀᆞᆸ〯거다〮|보〮애ᅌᅵ다〮|본고〮|본ᄃᆞᆯ〮|보사〮ᅌᅵ다〮|봄〯|pwòtá|보니〮ᅌᅵ다〮|보고〮져〮|보〮논〮|본대〮|보〮더〮시니〮ᅌᅵ다〮|보〮시ᄂᆞ〮니라〮|보〮시리〮ᅌᅵ다〮|보〮거ᄂᆞᆯ〮|보다〮|보〮던다〮|보〯리〮ᅌᅵ다〮|보려〮|보니〮ᅌᅵᆺ고〮|보〮노〮ᅌᅵ다〮|보〮시〮니라〮|보〮ᄂᆞ녀〮|본〯|보라〮|보〯ᅌᅵ다〮|보〮ᅀᆞᆸ〯더〮니라〮|보〮거시〮ᅌᅵ다〮|보〮거든〮|보〮시ᇙ〮|보〮거시〮니라〮|보며〮|보〮시ᄂᆞᆫ〮|보〮시니〮ᅌᅵ다〮|보료〮|보리〮ᅌᅵᆺ가〮|보〮ᅀᆞᄫᆞ〮리라〮|보〮시ᄂᆞ〮ᅌᅵ다〮|보〮ᅀᆞᄫᆞ〮니라〮|보과〮뎌〮 (pwòkwátyé, desires other's action)|보〮거〮시다〮|보〮ᅀᆞᆸ〯거〮니라〮|보〮ᄂᆞᆫ〮|보〮건댄〮|보〮ᄂᆞᆫ가〮|보ᇙ〯|보〮시〮리라〮|보〮ᄂᆞᆫ다〮|보리〮ᅌᅵᆺ고〮|보고〮라〮|보ᇙ가〮|no separate forms|보면〮|보〮ᅀᆞᆸ〯다〮|보〮쇼셔〮|보고〮|보ᅌᅵ다〮|보니〮|보〮신〮|보〮도다〮|보나〮|보〮더〮시다〮|보관〮ᄃᆡ〮|보〮ᄂᆞ다〮|보〮시〮ᄂᆞ다〮|본다〮|보〯ᄃᆡ〮|보〮샴〮|보〯마〮	<i>verb</i><br><ol><li>to see, to look at, to watch (to perceive with the eyes)</li><li>(auxiliary, with 어〮 (-é)) to try, to try out</li><li>(auxiliary, with 어〮 (-é)) to experience</li></ol>
보로|polo	<i>noun</i><br><ol><li>skirt</li></ol>
보믜|pwomuy	<i>noun</i><br><ol><li>rust</li></ol>
복셔ᇰ화|pwoksyenghwa	<i>noun</i><br><ol><li>peach</li></ol>
봄|pwóm|봄〮|보ᄆᆡ〮	<i>noun</i><br><ol><li>spring (season)</li></ol>
부루|pwulwu	<i>noun</i><br><ol><li>lettuce</li></ol>
부텨|Pwùthyè	<i>name</i><br><ol><li>Buddha</li></ol>
부하|부〮화|부화|부〮하|pwúhà|pwúhwà	<i>noun</i><br><ol><li>lung</li></ol>
분별|分別|분별〮|pwùnpyél	<i>noun</i><br><ol><li>worry, concern</li></ol>
붇|pwut	<i>noun</i><br><ol><li>writing brush, painting brush; pen</li></ol>
불휘|pwùlhwúy|불휘〮	<i>noun</i><br><ol><li>root</li></ol>
붚|부페〮|pwúp|붚〮|붑|pwúph|붑〮	<i>noun</i><br><ol><li>drum</li></ol>
뷔|pwuy	<i>noun</i><br><ol><li>broom</li></ol>
브ᅀᅥᆸ|pùzèp|브ᅀᅥ븨〮|브ᅀᅥ베〮	<i>noun</i><br><ol><li>kitchen</li></ol>
브릇그다|pùlùskútá|브릇그〮다〮|브릇그〮니〮|pùlúskùtá|브릇〮거〮|브릇거〮|브릇〮그다〮|브릇〮그니〮	<i>verb</i><br><ol><li>to cling</li></ol>
븓잡다|putcapta	<i>verb</i><br><ol><li>to seize; to grab</li></ol>
블|브〮레〮|블〮|púl	<i>noun</i><br><ol><li>fire</li></ol>
븕다|pulkta	<i>adj</i><br><ol><li>(to be) red</li></ol>
비|pí|비〮|비〮예〮	<i>noun</i><br><ol><li>rain</li></ol>
비ᅀᅳ다|비ᅀᅳ려〮|비ᅀᅳᆯ쎠〮|비ᅀᅳ더〮시니〮ᅌᅵ다〮|비ᅀᅳᅀᆞᆸ〯ᄂᆞ〮니라〮|비ᅀᅳ시〮ᄂᆞ니〮ᅌᅵ다〮|비ᅀᅳ시〮니〮ᅌᅵ다〮|비ᇫ언〮마ᄅᆞᆫ〮|비ᅀᅳᄂᆞᆫ고〮|비ᅀᅳ고〮|비ᅀᅳ료〮|비ᅀᅳ시ᇙ〮|비ᅀᅳ시〮다〮|비ᅀᅳ시〮ᄂᆞ다〮|비ᇫ어〮시다〮|비ᅀᅳᇙ|비ᅀᅳᅌᅵ다〮|비ᅀᅳ져〮|비ᅀᅳ니〮라〮|비ᇫ우〮마〮|비ᅀᅳᇙ가〮|비ᅀᅳ니〮ᅌᅵᆺ가〮|비ᅀᅳᆫ대〮|pìzùtá|비ᅀᅳᄂᆞᆫ가〮|비ᅀᅳ관〮ᄃᆡ〮|비ᅀᅳᅀᆞᄫᅡ〮다〮|비ᅀᅳ다〮|비ᅀᅳ녀〮|비ᅀᅳᅀᆞᄫᆞ〮리라〮|비ᅀᅳ시〮니라〮|비ᇫ어〮녀〮|비ᅀᅳᆯᄊᆡ〮|비ᅀᅳ니〮|비ᇫ어〮ᄂᆞᆯ〮|비ᅀᅳᅀᆞᄫᆞ〮니라〮|비ᇫ어〮든〮|비ᅀᅳᆫᄃᆞᆯ〮|비ᇫ우〮려〮|비ᅀᅳ던〮다〮|비ᅀᅳ시〮ᄂᆞ〮ᅌᅵ다〮|비ᇫ어〮시〮ᅌᅵ다〮|비ᅀᅳᆫ고〮|비ᅀᅳᅀᆞᆸ〯다〮|비ᅀᅳ고〮ᅌᅵ다〮|비ᅀᅳ신〮|비ᅀᅳ니〮ᅌᅵᆺ고〮|비ᇫ에〮라〮|비ᅀᅳᄂᆞ뇨〮|비ᅀᅳ시〮ᄂᆞ〮니라〮|비ᇫ어〮시〮니라〮|비ᅀᅳ나〮|비ᅀᅳ시〮리라〮|비ᅀᅳ리〮ᅌᅵᆺ고〮|비ᅀᅳ더〮녀〮|비ᅀᅳ라〮|비ᅀᅳ더〮시〮ᅌᅵ다〮|비ᇫ우〮ᅌᅵ다〮|비ᅀᅳ고〮져〮 (pìzùkwócyé, desires one's own action)|비ᇫ우〮리라〮|비ᅀᅳ노〮ᅌᅵ다〮|비ᅀᅳᅀᆞᆸ〯더라〮|비ᇫ에〮ᅌᅵ다〮|비ᅀᅳ던〮가〮|비ᅀᅳᆫ뎌〮|비ᅀᅳᅀᆞᄫᅡ〮니라〮|비ᅀᅳ다가〮|비ᅀᅳᇙ다〮|비ᇫ우〮ᄃᆡ〮|비ᅀᅳ고〮라〮|비ᅀᅳᅀᆞᆸ〯더〮니라〮|비ᅀᅳ던〮고〮|비ᇫ우〮라〮|비ᅀᅳ돗〮다〮|비ᅀᅳ더〮라〮|비ᅀᅳᄂᆞᆫ다〮|비ᅀᅳ쇼〮셔〮|비ᇫ어〮|비ᇫ운〮|비ᅀᅳᄂᆞ니〮ᅌᅵ다〮|비ᅀᅳᆫ다〮|비ᇫ움〮|비ᅀᅳ리〮라〮|비ᅀᅳᆫ가〮|비ᅀᅳ노〮라〮|비ᇫ우〮리〮ᅌᅵ다〮|비ᅀᅳᄂᆞ녀〮|비ᅀᅳ더〮시〮니라〮|비ᇫ언〮댄〮|비ᅀᅳ논〮|비ᅀᅳᄂᆞᅌᅵ다〮|비ᅀᅳ더〮뇨〮|비ᅀᅳ시〮리〮ᅌᅵ다〮|비ᅀᅳ리〮ᅌᅵᆺ가〮|비ᅀᅳᆫ|no separate forms|비ᇫ언〮다〮|비ᅀᅳ리〮ᅌᅵ다〮|비ᅀᅳ더〮시다〮|비ᅀᅳ니〮ᅌᅵ다〮|비ᇫ어〮뇨〮|비ᅀᅳ사〮ᅌᅵ다〮|비ᅀᅳᅀᆞᆸ〯ᄂᆞ다〮|비ᅀᅳᄂᆞᆫ|비ᅀᅳ과〮라〮|비ᇫ어〮다〮|비ᅀᅳ다〮라〮|비ᅀᅳ도〮다〮|비ᅀᅳ시〮ᅌᅵ다〮|비ᅀᅳ시〮ᄂᆞᆫ〮|비ᅀᅳᄂᆞ니〮라〮|비ᅀᅳᄂᆞ다〮|비ᅀᅳ과〮뎌〮 (pìzùkwátyé, desires other's action)|비ᇫ어〮라〮|비ᇫ우ᇙ〮|비ᇫ어〮시니〮ᅌᅵ다〮|비ᅀᅳ면〮|비ᅀᅳᇙ고〮|비ᅀᅳᄂᆞ니〮ᅌᅵᆺ가〮|비ᅀᅳ더〮니라〮|비ᅀᅳ뇨〮|비ᅀᅳ샴〮|비ᅀᅳᄂᆞ니〮ᅌᅵᆺ고〮|비ᅀᅳ며〮	<i>verb</i><br><ol><li>to adorn</li><li>to adorn oneself</li><li>to become splendid; (adjectivally) to be splendid</li></ol>
비타|비허〮시〮ᅌᅵ다〮|비후ᇙ〮|비흔|비흐니〮ᅌᅵᆺ고〮|비흔뎌〮|빈ᄂᆞ다〮|비헌〮마ᄅᆞᆫ〮|비코〮져〮 (pìkhwócyé, desires one's own action)|비흐시〮ᄂᆞᆫ〮|빈ᄂᆞᆫ가〮|비흐시〮ᄂᆞ다〮|비흐니〮라〮|비타가〮|비허〮|비헌〮댄〮|비흐시〮ᄂᆞ〮ᅌᅵ다〮|비허〮시〮니라〮|비터〮뇨〮|비흐리〮ᅌᅵ다〮|비터〮니라〮|빈ᄂᆞ녀〮|비흐려〮|비ᄊᆞᆸ〯ᄂᆞ다〮|비흐ᇙ다〮|비허〮녀〮|비흐ᅌᅵ다〮|비흔대〮|비흐ᇙ가〮|비ᄊᆞᄫᆞ〮리라〮|비코〮라〮|비흐시ᇙ〮|비후〮리〮ᅌᅵ다〮|비ᄊᆞᄫᅡ〮다〮|빈노〮ᅌᅵ다〮|비허〮다〮|비흐시〮니라〮|비흐ᇙ고〮|비후〮라〮|비콰〮뎌〮 (pìkhwátyé, desires other's action)|비ᄊᆞᆸ〯더〮니라〮|비허〮시니〮ᅌᅵ다〮|비흐샴〮|비흐시〮다〮|빈ᄂᆞ니〮ᅌᅵᆺ가〮|비흐료〮|비콰〮라〮|비ᄊᆞᄫᆞ〮니라〮|비흐쇼〮셔〮|비ᄊᆞᆸ〯ᄂᆞ〮니라〮|비타〮|비흐니〮ᅌᅵᆺ가〮|비흐시〮니〮ᅌᅵ다〮|비흐시〮리라〮|비터〮녀〮|빈ᄂᆞ니〮라〮|비코〮|비터〮시니〮ᅌᅵ다〮|비흔가〮|비토〮다〮|비후〮려〮|비코〮ᅌᅵ다〮|비흐ᇙ|비후〮마〮|비훈〮|비헌〮다〮|pìthá|비흘ᄊᆡ〮|비허〮뇨〮|비흐면〮|비흔ᄃᆞᆯ〮|비흐시〮ᄂᆞ니〮ᅌᅵ다〮|빈ᄂᆞᆫ|비허〮니라〮|비ᄊᆞᆸ〯다〮|빟다|비허〮ᄂᆞᆯ〮|비후〮리라〮|비터〮시〮니라〮|비흐녀〮|비쳐〮|비흐시〮리〮ᅌᅵ다〮|비흐리〮ᅌᅵᆺ고〮|비타〮라〮|빈ᄂᆞ니〮ᅌᅵ다〮|pihta|비흐리〮ᅌᅵᆺ가〮|비허〮든〮|비톳〮다〮|비흐시〮ᄂᆞ〮니라〮|비싸〮ᅌᅵ다〮|비흐라〮|비터〮라〮|비헤〮라〮|비콴〮ᄃᆡ〮|비흐니〮ᅌᅵ다〮|빈ᄂᆞᆫ고〮|비흔다〮|빈ᄂᆞ뇨〮|빈ᄂᆞ니〮ᅌᅵᆺ고〮|빈ᄂᆞᅌᅵ다〮|비후〮ᄃᆡ〮|비훔〮|비턴〮다〮|비흐리〮라〮|빈ᄂᆞᆫ다〮|비흐나〮|비흔고〮|비터〮시다〮|no separate forms|빈노〮라〮|비ᄊᆞᄫᅡ〮니라〮|비턴〮고〮|비턴〮가〮|비흐신〮|비흐니〮|비ᄊᆞᆸ〯더라〮|비흐며〮|비후〮ᅌᅵ다〮|비터〮시〮ᅌᅵ다〮|빈논〮|비흘쎠〮|비허〮시다〮|비흐뇨〮|비흐시〮ᅌᅵ다〮|비헤〮ᅌᅵ다〮	<i>verb</i><br><ol><li>to sprinkle, to scatter</li></ol>
빈혀|pinhye	<i>noun</i><br><ol><li>hairpin (often decorative)</li></ol>
빋|pìt	<i>noun</i><br><ol><li>price</li></ol>
빛|pích|비체〮|빛〮|비〮체〮	<i>noun</i><br><ol><li>light</li></ol>
사ᄅᆞᆷ|sǎlòm|사〯ᄅᆞᆷ	<i>noun</i><br><ol><li>person</li></ol>
사ᄉᆞᆷ|sàsóm|사ᄉᆞᆷ〮	<i>noun</i><br><ol><li>deer</li></ol>
사ᄫᅵ|사ᄫᅵ〮|sàWí	<i>noun</i><br><ol><li>shrimp, prawn</li></ol>
사ᇰ화|sanghwa	<i>noun</i><br><ol><li>dumplings</li></ol>
사회|sàhwóy|사회〮	<i>noun</i><br><ol><li>son-in-law</li></ol>
산ᄒᆡᇰ|山行|sànhòyng	<i>noun</i><br><ol><li>hunting</li><li>(literally) going to the mountains</li></ol>
살|살〮|사〮래〮|sál	<i>noun</i><br><ol><li>arrow</li><li>spoke (on a wheel)</li></ol>
삿기|sàskí|삿기〮	<i>noun</i><br><ol><li>a young animal</li></ol>
새|sáy|sǎy|새〮|새〯|새〯예〮	<i>noun</i><br><ol><li>bird (in general)</li><li>something new</li></ol><br><i>adv</i><br><ol><li>newly</li></ol><br><i>det</i><br><ol><li>new</li></ol>
새로|새〮로〮|sáy-lwó	<i>adv</i><br><ol><li>anew, newly, for the first time</li></ol>
새배|saypay	<i>noun</i><br><ol><li>dawn; daybreak</li></ol>
샤ᇰᄌᆞ|syangco	<i>noun</i><br><ol><li>box; case</li></ol>
샤님|샤〯님〯|syǎnǐm	<i>noun</i><br><ol><li>husband</li></ol>
샤오ᇰ|舍翁|syǎwòng|샤〯오ᇰ	<i>noun</i><br><ol><li>husband</li></ol>
설|설〯|서〯레〮|sěl	<i>noun</i><br><ol><li>year of age</li><li>New Year</li></ol>
설믜|selmuy	<i>noun</i><br><ol><li>(rare) wisdom</li></ol>
섬|섬〮|sém	<i>noun</i><br><ol><li>stairstep</li></ol>
셓|셓〯|sěyh	<i>num</i><br><ol><li>three</li></ol>
셔ᄫᅳᆯ|셔〯ᄫᅳᆯ|syěWùl	<i>noun</i><br><ol><li>capital city</li></ol>
셔ᇰ|syeng	<i>noun</i><br><ol><li>anger, rage, wrath, offense</li></ol>
셗|셗〮|syéks|syèks	<i>noun</i><br><ol><li>rein</li><li>duty; role</li></ol>
션ᄇᆡ|syenpoy	<i>noun</i><br><ol><li>classical scholar</li></ol>
션ᄉᆡᇰ|syensoyng	<i>noun</i><br><ol><li>teacher</li></ol>
셜흔|셜흔〮|syèlhún	<i>num</i><br><ol><li>thirty</li></ol>
셤|syěm|syém|셤〮|셤〯	<i>noun</i><br><ol><li>island</li><li>a seom, a unit of volume</li></ol>
셰ᄃᆡ|syeytoy	<i>noun</i><br><ol><li>age, generation, era</li></ol>
셰다|셰〯다|syěyta	<i>verb</i><br><ol><li>to turn grey (for hair)</li></ol>
소ᄅᆡ|swoloy	<i>noun</i><br><ol><li>sound</li></ol>
소곰|swòkwòm	<i>noun</i><br><ol><li>salt</li></ol>
소얌|swoyam	<i>pron</i><br><ol><li>(hapax) The meaning of this term is uncertain. Possibilities include:</li><li>that</li></ol>
소옴	<i>noun</i><br><ol><li>cotton</li></ol>
손|swón|소내〮|swòn|손〮	<i>noun</i><br><ol><li>hand</li><li>guest</li></ol>
솔|swól|솔〯|솔〮|swǒl	<i>noun</i><br><ol><li>pine (tree)</li><li>brush (tool)</li><li>(archery) target</li></ol>
솝|swop	<i>noun</i><br><ol><li>the inside</li></ol>
솥|소ᄐᆡ〮|swòth	<i>noun</i><br><ol><li>kettle; cauldron</li></ol>
솨줄|swàcwúl|솨줄〮	<i>noun</i><br><ol><li>confining chains, fetters</li></ol>
쇄ᅀᆞ|swayzo	<i>noun</i><br><ol><li>a die/dice</li></ol>
쇠|쇠〮|swóy	<i>noun</i><br><ol><li>metal</li></ol>
쇼|syó|쇼〮	<i>noun</i><br><ol><li>cow</li></ol>
수ᇧ|swusk	<i>noun</i><br><ol><li>charcoal</li></ol>
수을|술|swùwùl|swùùl|수울|swùl	<i>noun</i><br><ol><li>liquor</li></ol>
술|swúl|술〮|swùl	<i>noun</i><br><ol><li>spoon</li></ol>
술위|술위〮|swùlGwúy	<i>noun</i><br><ol><li>cart, carriage, wheelbarrow</li></ol>
숳|swuh	<i>noun</i><br><ol><li>male</li></ol>
쉰|쉰〯|swǔyn	<i>noun</i><br><ol><li>fifty</li></ol>
슈룹|syulwup	<i>noun</i><br><ol><li>umbrella</li></ol>
슈신|syùsìn	<i>noun</i><br><ol><li>penis</li></ol>
스스ᇰ|susung	<i>noun</i><br><ol><li>teacher, master, mentor, instructor</li></ol>
스싀로|스싀〮로〮|sùsúy-lwó	<i>adv</i><br><ol><li>by oneself, on one's own, without assistance</li></ol>
싀어버ᅀᅵ|suy-epezi	<i>noun</i><br><ol><li>husband's family</li></ol>
시긧벼ᇰ|시긧벼ᇰ〯|sìkùy-s pyěng	<i>noun</i><br><ol><li>epidemic</li></ol>
시냏|sǐnǎyh|시〯냏〯	<i>noun</i><br><ol><li>a narrow stream</li></ol>
신|sín|신〮	<i>noun</i><br><ol><li>shoe; footgear</li></ol>
실|sǐl|실〯	<i>noun</i><br><ol><li>thread, string</li></ol>
심바ᇰ|sìmpàng	<i>noun</i><br><ol><li>shaman; priest of Korean folk religion</li></ol>
씬|ssin	<i>syllable</i><br><ol><li>辰:</li></ol>
아ᄃᆞᆯ|àtól|아ᄃᆞ〮래〮|아ᄃᆞᆯ〮	<i>noun</i><br><ol><li>son</li></ol>
아ᄅᆞᆷ답다|àlóm-tàptá|아ᄅᆞᆷ〮답다〮	<i>adj</i><br><ol><li>to be beautiful</li></ol>
아ᄎᆞᆫᄯᅡᆯ|achonstal	<i>noun</i><br><ol><li>niece</li></ol>
아ᄎᆞᆷ|아ᄎᆞᆷ〮|아ᄎᆞ〮ᄆᆡ〮|àchóm	<i>noun</i><br><ol><li>morning</li></ol>
아ᄒᆞᆫ|ahon	<i>num</i><br><ol><li>ninety</li></ol>
아ᄒᆞ래|aholay	<i>noun</i><br><ol><li>nine days</li></ol>
아ᄒᆡ|àhóy|아ᄒᆡ〮	<i>noun</i><br><ol><li>child</li></ol>
아ᅀᆞ|아ᇫㅇ|àzò	<i>noun</i><br><ol><li>a man's younger brother</li></ol>
아ᅀᆞᆷ|azom	<i>noun</i><br><ol><li>kin, kinsmen, relatives</li></ol>
아ᇡ|amh	<i>noun</i><br><ol><li>female (non-human)</li></ol>
아기|ákì|아〮기	<i>noun</i><br><ol><li>baby</li></ol>
아니|àní|아니〮	<i>noun</i><br><ol><li>that which is not</li></ol><br><i>adv</i><br><ol><li>not (negates the following verb)</li></ol><br><i>intj</i><br><ol><li>no (interjection of negation)</li></ol>
아으|au	<i>intj</i><br><ol><li>(poetic) ah, o, alas; the most common exclamation or interjection in native Korean songs and poetry.</li></ol>
아질게|acilkey	<i>noun</i><br><ol><li>a young animal</li></ol>
아홉|아홉〮|àhwóp	<i>num</i><br><ol><li>nine</li></ol>
안도도다|ǎntwòtwótá|안〯도도〮다〮|안〯도도〮고〮|안〯도도〮아〮|안〯도도〮면〮	<i>verb</i><br><ol><li>to embrace and nurture, to nurture with embraces</li></ol>
안직|안〮직|안직〮|아직〮|àncík|áncìk|àcík|아직	<i>adv</i><br><ol><li>still</li><li>(with explicit or implicit verbal negation) yet; not yet</li><li>for a while</li><li>from now on</li><li>for now, for the time being</li><li>most, -est (adds superlative meaning to adjectives)</li><li>extremely, completely (adds intensive meaning to verbs)</li></ol>
안해|anhay	<i>noun</i><br><ol><li>wife</li></ol>
않|않〮|ánh|안해〮	<i>noun</i><br><ol><li>inside; interior</li></ol>
앒|àlph|àlp|앏|알ᄑᆡ〮	<i>noun</i><br><ol><li>fore, front</li><li>south</li></ol>
애|ǎy|애〯|良中	<i>noun</i><br><ol><li>the intestines, the guts</li><li>the gall bladder</li><li>(possibly) the liver (only attested in early Early Modern Korean)</li><li>(in figurative expressions) anxiety, impatience</li><li>(in figurative expressions) trouble; effort</li></ol>
야ᇰ|yang	<i>noun</i><br><ol><li>a standard way of doing things</li><li>sheep</li></ol>
어ᅀᅵ|어ᅀᅵ〮|èzí	<i>noun</i><br><ol><li>parent; parents</li><li>mother</li></ol>
어려ᄫᅮᆷ|elyeWwum	<i>noun</i><br><ol><li>difficulty</li></ol>
어른|èlùn	<i>adv</i><br><ol><li>quickly, at once</li></ol>
어버ᅀᅵ|èpèzí|어버ᅀᅵ〮	<i>noun</i><br><ol><li>parents</li></ol>
어비ᄆᆞᆮ|어비〮ᄆᆞᆮ|èpímòt	<i>noun</i><br><ol><li>(uncommon) nobleman, lord</li></ol>
언|en	<i>noun</i><br><ol><li>dike, bank</li></ol>
언마|enma	<i>noun</i><br><ol><li>how much, how many</li></ol>
얼우다|얼우어|elGwuta|얼우니	<i>verb</i><br><ol><li>(transitive) to cause to freeze</li></ol>
얼운|ělGwún|얼〯운〮	<i>noun</i><br><ol><li>grownup, adult, elder, senior</li></ol>
얼이다|얼이〮다〮|얼이〮어〮|얼이〮니〮|èlGítá	<i>verb</i><br><ol><li>(transitive) to marry (someone) to</li></ol>
업시|ěpsí|업〯시〮	<i>adv</i><br><ol><li>without, lacking</li></ol>
에ᇰ|èyng	<i>intj</i><br><ol><li>yes (affirmative interjection)</li></ol>
에우다|èyGwútá|에우〮다〮|에우〮어〮|에우〮니〮	<i>verb</i><br><ol><li>to encircle</li><li>to cross out (on a list, etc.)</li><li>(chiefly of food) to make do for</li></ol>
여ᄃᆞ래|yetolay	<i>noun</i><br><ol><li>eight days</li></ol>
여ᅀᆞ|yèzù|여ᅀᅳ|여ᇫㅇ|yèzò	<i>noun</i><br><ol><li>fox, vixen</li></ol>
여듧|yetulp	<i>num</i><br><ol><li>eight</li></ol>
여름|여름〮|yèlúm	<i>noun</i><br><ol><li>fruit</li></ol>
여슷|yesus	<i>noun</i><br><ol><li>six</li></ol>
여희다|여희〮니〮|여희〮다〮|여희〮여〮|yèhúytá	<i>verb</i><br><ol><li>to leave; to depart from; to bid farewell to</li><li>to lose a loved one (by death or departure)</li></ol>
엷다|yelpta	<i>adj</i><br><ol><li>(to be) thin</li></ol>
엻|yélh|열〮헤〮|엻〮|열헤〮|yèllh	<i>num</i><br><ol><li>ten</li></ol><br><i>noun</i><br><ol><li>hemp</li></ol>
엿쇄|yetsway	<i>noun</i><br><ol><li>six days</li></ol>
예|예〯|Yěy	<i>noun</i><br><ol><li>the Japanese</li></ol>
오곰|오고매|오곰〮|wòkwóm	
오라비|오〮라비〮|wólàpí	<i>noun</i><br><ol><li>brother of a female</li></ol>
온|wón|온〮	<i>num</i><br><ol><li>(one) hundred</li></ol>
올ᄒᆡ|wòlhóy|올ᄒᆡ〮	<i>noun</i><br><ol><li>this year</li></ol>
올히|wólhì|올〮히	<i>noun</i><br><ol><li>duck (in general), duck (domesticated)</li></ol>
옷|wòs|오새〮|옷〮|wós	<i>noun</i><br><ol><li>clothing; clothes</li><li>lacquer</li></ol>
외|wǒy|외〯	<i>noun</i><br><ol><li>cucumber</li></ol>
요ᄉᆞᅀᅵ|yosozi	<i>adv</i><br><ol><li>recently</li></ol>
요조ᅀᆞᆷ|yócwòzóm|요〮조ᅀᆞᆷ〮	<i>noun</i><br><ol><li>today; the present</li></ol>
우다|우〯다〮|울〯다〮|울다|wǔtá|우러〮|wǔl-tá|우르〮니〮	<i>verb</i><br><ol><li>to cry; to weep</li></ol>
우르다|우르다〮|울어〮|우르면〮|wùlùtá|우르고〮	<i>verb</i><br><ol><li>(of an animal or bird) to roar, to bellow, to cry, to make a large sound</li><li>(of a person) to shout</li><li>(figuratively, of a natural object) to roar, to rage</li></ol>
우리|wuli	<i>pron</i><br><ol><li>we; us</li></ol><br><i>noun</i><br><ol><li>cage, pen, coop</li></ol>
우워ᇰ|wuweng	<i>noun</i><br><ol><li>burdock</li></ol>
움즈기다|wumcwukita	<i>verb</i><br><ol><li>to move</li></ol>
웋|wùh|우희〮	<i>noun</i><br><ol><li>above, upper, upside, top</li></ol>
위|wǔy	<i>intj</i><br><ol><li>An interjection which appears in certain poems.</li></ol>
음란|음란〮|ùmlán|陰卵	<i>noun</i><br><ol><li>testicles; balls</li></ol>
이ᄅᆞ삶다|ilosalmta	<i>verb</i><br><ol><li>to manage</li></ol>
이ᅀᅵᇰ개|Ízìngkáy|圍仍浦|이〮ᅀᅵᇰ개〮	<i>name</i><br><ol><li>a beach with white sand in Kangryong, modern North Korea</li></ol>
이ᅌᅥ긔	<i>pron</i><br><ol><li>here</li></ol>
이력ᄒᆞ다|ilyek.hota	<i>verb</i><br><ol><li>to study</li></ol>
이바디|ipati	<i>noun</i><br><ol><li>feast; party</li></ol>
이웆|이우〮제〮|이웆〮|ìwúc	<i>noun</i><br><ol><li>neighbour</li></ol>
일|ǐl|일〮|íl|일〯	<i>noun</i><br><ol><li>work, job</li></ol><br><i>num</i><br><ol><li>one</li></ol>
일벗다|일벗다〮|일버ᅀᅥ〮|일버ᅀᅳ니〮|ìlpèstá	<i>verb</i><br><ol><li>(transitive) to steal, to rob</li></ol>
일홈|ilhwom	<i>noun</i><br><ol><li>name</li></ol>
잇다|ìstá|이셔〮|잇다〮|isita|이시니〮|이시다	<i>verb</i><br><ol><li>to be (at a place); to exist</li><li>to have</li><li>(auxiliary) to be (in a state of having done the main verb)</li></ol>
잇브다|잇브니〮|잇브다〮|잇버〮|ìspùtá	<i>adj</i><br><ol><li>to be tired, to be weary, to be exhausted</li></ol>
자내|canay	<i>pron</i><br><ol><li>oneself</li></ol>
자최|càchwóy|자최〮	<i>noun</i><br><ol><li>mark; trace; legacy</li></ol>
잣|cǎs|잣〮|자새〮|자〮새〮|잣〯|cás	<i>noun</i><br><ol><li>walled city, town, or fortress</li><li>pine nut</li></ol>
쟈ᇰᅀᅵᆫ|쟈ᇰ〯ᅀᅵᆫ|cyangzin	<i>noun</i><br><ol><li>craftsman, artisan</li></ol>
쟈ᇰ긔|cyǎngkùy|쟈ᇰ〯긔	<i>noun</i><br><ol><li>janggi; Korean chess</li></ol>
저프다|cèphùtá|저퍼〮|저프다〮|저프니〮	<i>adj</i><br><ol><li>to be fearful, to be frightening</li><li>to be fearful, to be in fear</li></ol>
져|cye	<i>noun</i><br><ol><li>chopstick(s)</li></ol>
져구리|cyekwuli	<i>noun</i><br><ol><li>jeogori (Korean traditional jacket, upper garment of Korean traditional clothes)</li></ol>
져차다|cyechata|져차|져차니	<i>verb</i><br><ol><li>(rare) to remove</li></ol>
젼툐|cyentywo	<i>noun</i><br><ol><li>blanket</li></ol>
졎|져제〮|졋|cyes|졎〮|cyéc	<i>noun</i><br><ol><li>breast</li><li>milk</li></ol>
조각|조가개〮|cwòkàk	<i>noun</i><br><ol><li>piece; sliver</li></ol>
죠ᄒᆡ|cyòhóy|죠ᄒᆡ〮	<i>noun</i><br><ol><li>paper</li></ol>
죽다|주그시〮ᄂᆞ〮ᅌᅵ다〮|주그〮니〮ᅌᅵᆺ고〮|죽노〮ᅌᅵ다〮|주그〮며〮|죽고〮|주그쇼〮셔〮|주그〮리〮ᅌᅵ다〮|주근〮가〮|주그〮뇨〮|죽더〮녀〮|죽거든〮|주구〮리〮ᅌᅵ다〮|주구〮리라〮|주그시〮다〮|죽고〮라〮|주그시〮ᅌᅵ다〮|주근〮|주구〮마〮|죽ᄂᆞᅌᅵ다〮|주구〮라〮|죽더〮뇨〮|죽져〮|죽더〮시다〮|죽건마ᄅᆞᆫ〮|죽도〮다〮|죽ᄂᆞ니〮ᅌᅵᆺ가〮|주그〮료〮|주그시〮니〮ᅌᅵ다〮|주그〮리라〮|주그〮녀〮|죽ᄂᆞ뇨〮|죽던〮다〮|주구〮려〮|죽ᄂᆞᆫ|주구〮ᅌᅵ다〮|죽논〮|주그시〮ᄂᆞᆫ〮|주그시ᇙ〮|죽더〮니라〮|주그ᇙ〮고〮|주그신〮|주그시〮리〮ᅌᅵ다〮|주근〮ᄃᆞᆯ〮|주그〮나〮|주그〮리〮ᅌᅵᆺ가〮|죽ᄂᆞ니〮ᅌᅵ다〮|죽더〮시〮ᅌᅵ다〮|죽ᄂᆞᆫ가〮|주그시〮ᄂᆞ다〮|주근〮고〮|주그〮ᅌᅵ다〮|주그시〮ᄂᆞ〮니라〮|죽건댄〮|죽사〮ᅌᅵ다〮|죽다〮라〮|죽돗〮다〮|주근〮뎌〮|죽더〮시니〮ᅌᅵ다〮|주구〮ᄃᆡ〮|cwùktá|죽ᄂᆞᆫ다〮|죽거〮시니〮ᅌᅵ다〮|주근〮대〮|주게〮ᅌᅵ다〮|주글〮ᄊᆡ〮|죽관〮ᄃᆡ〮|주그〮려〮|주그〮리〮ᅌᅵᆺ고〮|주거〮|주구ᇙ〮|주그〮라〮|주그ᇙ〮다〮|주글〮쎠〮|주군〮|주그시〮리라〮|주그〮니〮ᅌᅵᆺ가〮|죽거ᄂᆞᆯ〮|죽다가〮|죽고〮져〮 (cwùkwócyé, desires one's own action)|죽ᄂᆞ녀〮|주그시〮ᄂᆞ니〮ᅌᅵ다〮|no separate forms|죽거〮시다〮|주그〮니〮ᅌᅵ다〮|주게〮라〮|주그시〮니라〮|주그ᇙ〮가〮|죽던〮고〮|죽거〮시〮니라〮|죽ᄂᆞ니〮라〮|죽던〮가〮|죽더〮시〮니라〮|죽과〮뎌〮 (cwùkkwátyé, desires other's action)|죽다〮|죽노〮라〮|주그샴〮|죽더〮라〮|죽ᄂᆞ니〮ᅌᅵᆺ고〮|죽ᄂᆞ다〮|주그〮니〮|주근〮다〮|주그〮면〮|주굼〮|죽거〮시〮ᅌᅵ다〮|주그〮니라〮|주그ᇙ〮|죽ᄂᆞᆫ고〮	<i>verb</i><br><ol><li>(intransitive) to die</li></ol>
쥬련|cyulyen	<i>noun</i><br><ol><li>towel</li></ol>
즈ᇫ|즛〯|즈ᇫ〯|즈〯ᅀᅦ〮|즛|cǔz|cǔs	<i>noun</i><br><ol><li>visage; appearance; shape (e.g. of a person)</li><li>(by extension) situation; circumstances; behavior</li></ol>
즈믄|cumun	<i>num</i><br><ol><li>thousand</li></ol>
즐겁다|cúlkèptá|즐〮거ᄫᅥ〮|즐〮겁고〮|즐〮겁다〮|즐〮거〮ᄫᅳ면〮	<i>adj</i><br><ol><li>to be pleasant, to be enjoyable</li></ol>
즘게|즘게〮|cùmkéy	<i>noun</i><br><ol><li>a big tree, a large tree</li><li>a distance of thirty li, around twelve kilometres</li></ol>
지극|지〮극〮|cíkúk|至極	<i>adv</i><br><ol><li>very; extremely</li></ol>
지다|cita	<i>verb</i><br><ol><li>(auxiliary) to want, to desire</li></ol>
지차리|cichali	<i>noun</i><br><ol><li>House centipede (centipedes of the family Scutigeridae)</li></ol>
지타|짛다|cìthá|지타〮|지흐면〮|지허〮|지코〮|cihta	<i>verb</i><br><ol><li>(transitive) to tie a packsaddle</li><li>(transitive) to string a bow for shooting</li><li>(transitive, with object 일훔〮 (ìlhwúm, “name”)) to give (a name), to christen, to name (a person, an object, etc.)</li></ol>
진딧|cìntís|진딧〮	<i>det</i><br><ol><li>true, real</li></ol><br><i>adv</i><br><ol><li>really</li></ol>
집|지븨〮|cìp	<i>noun</i><br><ol><li>house</li></ol>
집웋|cipwuh	<i>noun</i><br><ol><li>roof</li></ol>
처ᅀᅥᆷ|처〮ᅀᅥᆷ|chézèm	<i>noun</i><br><ol><li>the first time</li></ol>
쳐	
쳔|chyèn|chyěn|쳔〯	<i>noun</i><br><ol><li>money</li></ol><br><i>num</i><br><ol><li>thousand</li></ol>
츩|츩〮|chúlk	<i>noun</i><br><ol><li>arrowroot, kudzu</li></ol>
칩다|칩〮더〮시니〮ᅌᅵ다〮|칩〮ᄂᆞ니〮ᅌᅵᆺ고〮|치〮ᄫᅳ〮시다〮|칩〮ᄂᆞᆫ가〮|칩〮더녀〮|치〮ᄫᅳᆫ뎌〮|치〮ᄫᅳᆫ다〮|치〮ᄫᅮ〮리라〮|칩〮던고〮|치〮ᄫᅳ〮니라〮|칩〮ᄂᆞ뇨〮|치〮ᄫᅳᇙ다〮|치〮ᄫᅳ〮시ᄂᆞᆫ〮|치〮ᄫᅳ〮리라〮|치〮ᄫᅳ리〮ᅌᅵᆺ가〮|치〮ᄫᅳ〮ᅌᅵ다〮|칩〮더뇨〮|칩〮다가〮|칩〮ᄂᆞᆫ다〮|치〮ᄫᅳᆫ고〮|치〮ᄫᅳᆫ〮|칩〮건〮마ᄅᆞᆫ〮|칩〮거시〮ᅌᅵ다〮|치〮ᄫᅳ리〮ᅌᅵ다〮|칩〮돗다〮|치〮ᄫᅮᆫ〮|치〮ᄫᅳ시〮ᄂᆞ니〮ᅌᅵ다〮|칩〮더〮시다〮|칩〮ᄂᆞ〮니라〮|칩〮고져〮|칩〮다〮|칩〮과뎌〮 (chípkwàtyé, desires other's action)|칩〮고〮|치〮ᄫᅳ니〮ᅌᅵᆺ고〮|칩〮더〮니라〮|치〮ᄫᅳ뇨〮|치〮ᄫᅮᆷ〮|치〮ᄫᅳ〮시ᄂᆞ〮ᅌᅵ다〮|치〮ᄫᅳᇙ가〮|chíptá|칩〮더시〮니라〮|치〮ᄫᅳᆫ가〮|치〮ᄫᅳ니〮ᅌᅵ다〮|치〮ᄫᅳ〮라〮|칩〮거시〮니라〮|칩〮사〮ᅌᅵ다〮|치〮ᄫᅳ〮쇼셔〮|치〮ᄫᅳ녀〮|치〮ᄫᅳ나〮|칩〮더시〮ᅌᅵ다〮|칩〮ᄂᆞ〮ᅌᅵ다〮|치〮ᄫᅮ마〮|치〮ᄫᅮ라〮|칩〮ᄂᆞᆫ〮|칩〮다라〮|치〮ᄫᅦ〮ᅌᅵ다〮|치〮ᄫᅳᆫ대〮|치〮ᄫᅳ시〮ᄂᆞ다〮|치〮ᄫᅳ〮시리〮ᅌᅵ다〮|치〮ᄫᅮᄃᆡ〮|칩〮도다〮|칩〮ᄂᆞ니〮ᅌᅵᆺ가〮|치〮ᄫᅳ료〮|칩〮ᄂᆞ녀〮|칩〮관ᄃᆡ〮|칩〮ᄂᆞ니〮ᅌᅵ다〮|치〮ᄫᅮ〮ᅌᅵ다〮|칩〮노라〮|치〮ᄫᅳ샴〮|치〮ᄫᅳ〮시니〮ᅌᅵ다〮|치〮ᄫᅳᇙ고〮|치〮ᄫᅳ니〮|치〮ᄫᅦ라〮|치〮ᄫᅳᆯᄊᆡ〮|치〮ᄫᅮ려〮|칩〮거〮시니〮ᅌᅵ다〮|치〮ᄫᅳ며〮|칩〮ᄂᆞ다〮|치〮ᄫᅳ니〮ᅌᅵᆺ가〮|치〮ᄫᅳ시〮니라〮|치〮ᄫᅳᇙ〮|no separate forms|치〮ᄫᅳ시ᇙ〮|칩〮거〮시다〮|치〮ᄫᅳᆫᄃᆞᆯ〮|치〮ᄫᅳ시〮ᅌᅵ다〮|칩〮더라〮|칩〮건댄〮|치〮ᄫᅳᆯ쎠〮|칩〮논〮|칩〮ᄂᆞᆫ고〮|치〮ᄫᅮᇙ〮|치〮ᄫᅳ시〮리라〮|칩〮던가〮|치〮ᄫᅥ〮|치〮ᄫᅳ〮시ᄂᆞ〮니라〮|칩〮거ᄂᆞᆯ〮|칩〮던다〮|치〮ᄫᅳ리〮ᅌᅵᆺ고〮|칩〮노〮ᅌᅵ다〮|치〮ᄫᅳ신〮|칩〮거든〮|칩〮고라〮|치〮ᄫᅳ려〮|치〮ᄫᅮ리〮ᅌᅵ다〮|치〮ᄫᅳ면〮|칩〮져〮	<i>adj</i><br><ol><li>(of weather, adjectivally) to be cold; (of weather, verbally) to become cold</li></ol>
코ᇰ|khwòng	<i>noun</i><br><ol><li>soybean</li></ol>
코ᇰᄑᆞᆺ|khwong.phos	<i>noun</i><br><ol><li>kidney</li></ol>
쾅지|khwangci	<i>noun</i><br><ol><li>basket</li></ol>
크다|케〮라〮|크〮노라〮|크〮더뇨〮|크〮ᄂᆞᆫ다〮|쿤〮|크〮던고〮|크〮ᄂᆞ니〮ᅌᅵᆺ가〮|크〮시ᄂᆞᆫ〮|크〮녀〮|크〮려〮|크〮ᄂᆞ니〮ᅌᅵ다〮|쿠〮ᅌᅵ다〮|크ᇙ〮고〮|크〮시ᇙ〮|크〮과뎌〮 (khúkwàtyé, desires other's action)|클〮쎠〮|쿠〮마〮|크〮니〮ᅌᅵᆺ고〮|크〮돗다〮|크〮면〮|크〮거ᄂᆞᆯ〮|크〮시니〮ᅌᅵ다〮|크〮니〮ᅌᅵ다〮|khútá|크〮던가〮|크〮다〮|크〮거든〮|쿠ᇙ〮|크〮ᄂᆞ녀〮|쿠〮리〮ᅌᅵ다〮|크〮ᄂᆞ니〮ᅌᅵᆺ고〮|큰〮|크〮도다〮|크〮료〮|크〮사〮ᅌᅵ다〮|큰〮뎌〮|크〮거시〮니라〮|크〮라〮|크〮고라〮|크〮리라〮|크〮니〮|큰〮대〮|쿠〮려〮|크〮더시〮ᅌᅵ다〮|크〮관ᄃᆡ〮|크〮더〮니라〮|큰〮가〮|크〮니라〮|크〮져〮|클〮ᄊᆡ〮|크〮리〮ᅌᅵᆺ고〮|크〮고〮|크〮다가〮|크〮ᅌᅵ다〮|크〮시〮ᅌᅵ다〮|크〮ᄂᆞᆫ〮|크〮시〮ᄂᆞ다〮|크〮ᄂᆞ다〮|크〮시ᄂᆞ〮니라〮|크〮ᄂᆞ〮니라〮|크〮신〮|큰〮다〮|크〮거시〮ᅌᅵ다〮|크〮며〮|크〮거〮시니〮ᅌᅵ다〮|크〮시〮니라〮|크〮시ᄂᆞ〮ᅌᅵ다〮|케〮ᅌᅵ다〮|크ᇙ〮다〮|크〮다라〮|크〮시〮ᄂᆞ니〮ᅌᅵ다〮|크〮ᄂᆞᆫ가〮|크〮ᄂᆞ뇨〮|크〮리〮ᅌᅵᆺ가〮|크〮ᄂᆞ〮ᅌᅵ다〮|크〮시〮리라〮|큰〮고〮|크〮ᄂᆞᆫ고〮|크〮시리〮ᅌᅵ다〮|크〮거〮시다〮|크〮고져〮|쿠〮라〮|크〮나〮|크〮논〮|크ᇙ〮가〮|no separate forms|크〮쇼셔〮|크〮리〮ᅌᅵ다〮|쿠〮리라〮|크〮시다〮|크ᇙ〮|쿰〮|크〮건〮마ᄅᆞᆫ〮|크〮던다〮|크〮니〮ᅌᅵᆺ가〮|크〮노〮ᅌᅵ다〮|크〮더녀〮|크〮더〮시다〮|크〮뇨〮|크〮더라〮|쿠〮ᄃᆡ〮|크〮더시〮니라〮|크〮더〮시니〮ᅌᅵ다〮|커〮|크〮샴〮|크〮건댄〮|큰〮ᄃᆞᆯ〮	<i>verb</i><br><ol><li>to grow, to get bigger; to be big</li><li>to become great; to be great</li></ol>
큰림금|khunlimkum	<i>noun</i><br><ol><li>apple</li></ol>
텬쳐ᇰ빛|thyenchyengpich	<i>noun</i><br><ol><li>sky blue (color)</li></ol>
토ᇰᄉᆡ|thwongsoy	<i>noun</i><br><ol><li>toilet</li></ol>
투먼가ᇰ|豆滿江|Thwùmén-kàng|투먼〮가ᇰ|豆漫江	<i>name</i><br><ol><li>Tumen River, border between Korea and the Tungusic peoples</li></ol>
파라ᄒᆞ다|파〮라ᄒᆞ다〮|phálàhòtá	<i>adj</i><br><ol><li>to be blue</li><li>to be green</li></ol>
편지|phyenci|片紙	<i>noun</i><br><ol><li>small piece of paper</li><li>letter</li></ol>
푸ᇰ륫갓|phwunglyuskas	<i>noun</i><br><ol><li>musical instrument</li></ol>
프르다|phuluta	<i>adj</i><br><ol><li>(to be) blue; (to be) green</li></ol>
플|phul	<i>noun</i><br><ol><li>grass</li></ol>
피|피〮예〮|피〮|phí	<i>noun</i><br><ol><li>blood</li></ol>
하ᄂᆞᆳ아ᄃᆞᆯ|hanols.atol	<i>noun</i><br><ol><li>Son of Heaven; Emperor</li></ol>
하ᄂᆞᆶ|hànólh|하ᄂᆞᆯ〮해〮|하ᄂᆞᆶ〮|하ᄂᆞᆯ|하ᄂᆞᆯ〮|hànól	<i>noun</i><br><ol><li>sky</li><li>heaven</li></ol>
하다|하다〮|hàtá	<i>adj</i><br><ol><li>to be big; to be many</li></ol>
한아비|han.api	<i>noun</i><br><ol><li>grandfather</li></ol>
한어버ᅀᅵ|han-epezi	<i>noun</i><br><ol><li>grandparents</li></ol>
할타|할하〮|핧다〮|hàlthá|hàlh-tá|핧다|할ᄒᆞ〮니〮|할타〮	<i>verb</i><br><ol><li>to lick</li></ol>
혀ᇰ|hyeng	<i>noun</i><br><ol><li>elder brother</li></ol>
혀ᇰ뎨|hyengtyey	<i>noun</i><br><ol><li>brothers</li></ol>
혜다|hyěytá|혜〯다〮	<i>verb</i><br><ol><li>to count</li><li>to reckon; to consider; to think</li></ol>
화ᇰ뎨|hwangtyey	<i>noun</i><br><ol><li>emperor</li></ol>
횩다|hyokta	<i>adj</i><br><ol><li>small; little</li></ol>
훗기|Hwùskí|훗기〮	<i>name</i><br><ol><li>a town in modern Hamju County</li></ol>
흐리눅다|흐리누그니|흐리누거|hulinwukta	<i>verb</i><br><ol><li>(hapax) to be murky and damp (in the sole known use, apparently in relation to sexual intercourse)</li></ol>
흘게|hulkey	<i>noun</i><br><ol><li>asthma</li></ol>
힐후다|힐후〮고〮|힐후〮어〮|힐후〮면〮|힐후〮다〮|hilhwuta	<i>verb</i><br><ol><li>to argue, to dispute</li><li>(with 숨 (swum, “breath”) as subject) to pant</li><li>(in compounds) to repeat (frequentative auxiliary)</li><li>(in compounds) auxiliary of unclear meaning attached to verbs related to change of state or location</li></ol>
힘|힘〮|hím|히〮메〮	<i>noun</i><br><ol><li>muscle</li></ol>
