Abril	<i>noun</i><br><ol><li>April</li></ol>
Agosto	<i>noun</i><br><ol><li>August</li></ol>
Almanha	<i>name</i><br><ol><li>Germany</li></ol>
Cuba	<i>name</i><br><ol><li>Cuba (an island and country in the Caribbean)</li></ol>
Dezembre	<i>noun</i><br><ol><li>December</li></ol>
Dius	<i>name</i><br><ol><li>God</li></ol>
Eigito	<i>name</i><br><ol><li>Egypt</li></ol>
Febreiro	<i>noun</i><br><ol><li>February</li></ol>
Janeiro	<i>noun</i><br><ol><li>January</li></ol>
Jasus	<i>name</i><br><ol><li>Jesus</li></ol>
Júlio	<i>noun</i><br><ol><li>July</li></ol>
Júnio	<i>noun</i><br><ol><li>June</li></ol>
Lisboua	<i>name</i><br><ol><li>Lisbon (the capital city of Portugal)</li></ol>
Maio	<i>noun</i><br><ol><li>May</li></ol>
Márcio	<i>noun</i><br><ol><li>March</li></ol>
Nobembre	<i>noun</i><br><ol><li>November</li></ol>
Ounion Ouropeia	<i>name</i><br><ol><li>European Union</li></ol>
Ouropa	<i>name</i><br><ol><li>Europe</li></ol>
Outubre	<i>noun</i><br><ol><li>October</li></ol>
Pertual	<i>name</i><br><ol><li>Portugal (a country in Europe)</li></ol>
Setembre	<i>noun</i><br><ol><li>September</li></ol>
Spanha	<i>name</i><br><ol><li>Spain</li></ol>
Stados Ounidos	<i>name</i><br><ol><li>United States</li></ol>
Stremadura	<i>name</i><br><ol><li>Extremadura</li></ol>
abandono	<i>noun</i><br><ol><li>abandonment</li></ol>
abe|abes	<i>noun</i><br><ol><li>bird</li></ol>
abeilha|abeilhas	<i>noun</i><br><ol><li>bee</li></ol>
abenida|abenidas	<i>noun</i><br><ol><li>avenue</li></ol>
abintura|abinturas	<i>noun</i><br><ol><li>adventure</li></ol>
abion|abiones	<i>noun</i><br><ol><li>airplane</li></ol>
abogado|abogada|abogadas|abogados	<i>noun</i><br><ol><li>lawyer</li></ol>
abó|abós	<i>noun</i><br><ol><li>grandfather</li><li>grandmother</li></ol>
acalcer	<i>verb</i><br><ol><li>to heat</li><li>to warm</li></ol>
acerca	<i>adv</i><br><ol><li>near</li></ol>
acraditar	<i>verb</i><br><ol><li>to believe</li></ol>
acuordo|acuordos	<i>noun</i><br><ol><li>agreement</li></ol>
acá	<i>adv</i><br><ol><li>here (in this place)</li></ol>
adbertido|adbertidos|adbertida|adbertidas	<i>adj</i><br><ol><li>funny; amusing; entertaining</li></ol>
adbertimiento|adbertimientos	<i>noun</i><br><ol><li>amusement, entertainment</li></ol>
adbertir	<i>verb</i><br><ol><li>(transitive) to amuse; to entertain</li></ol>
adebina|adebinas	<i>noun</i><br><ol><li>riddle</li></ol>
adebinar	<i>verb</i><br><ol><li>(transitive) to guess</li></ol>
adelantrar	<i>verb</i><br><ol><li>to bring forward (to make something happen earlier than originally planned)</li></ol>
admirança|admiranças	<i>noun</i><br><ol><li>admiration</li></ol>
admiraçon|admiraçones	<i>noun</i><br><ol><li>admiration</li></ol>
adominar	<i>verb</i><br><ol><li>to dominate</li></ol>
adonde	<i>adv</i><br><ol><li>(interrogative) where (at what place)</li><li>(interrogative) where (to what place)</li></ol><br><i>conj</i><br><ol><li>where (at or in which place or situation)</li></ol><br><i>pron</i><br><ol><li>where (the place in which)</li></ol>
adondequiera	<i>adv</i><br><ol><li>anywhere</li></ol>
adulto|adultos|adultas|adulta	<i>adj</i><br><ol><li>adult</li></ol><br><i>noun</i><br><ol><li>adult</li></ol>
afamado|afamados|afamada|afamadas	<i>adj</i><br><ol><li>famous</li></ol>
afirmaçon|afirmaçones	<i>noun</i><br><ol><li>affirmation, statement</li></ol>
agabar	<i>verb</i><br><ol><li>to praise</li></ol>
agarrar	<i>verb</i><br><ol><li>to grab, hold</li><li>to seize,</li></ol>
agonie|agonies	<i>noun</i><br><ol><li>agony</li></ol>
agora	<i>adv</i><br><ol><li>now</li></ol>
aila|ailas	<i>noun</i><br><ol><li>eagle</li></ol>
ala|alas	<i>noun</i><br><ol><li>wing</li><li>(nautical) sail</li></ol>
alantre	<i>adv</i><br><ol><li>ahead</li></ol>
alargar|alargo|alargado	<i>verb</i><br><ol><li>to widen</li></ol>
albador|albadores	<i>noun</i><br><ol><li>lift, elevator</li></ol>
alboruotona|alboruotonas	<i>noun</i><br><ol><li>branched asphodel (Asphodelus ramosus)</li></ol>
aldé|aldés	<i>noun</i><br><ol><li>village</li></ol>
algebeira|algebeiras	<i>noun</i><br><ol><li>pocket</li></ol>
algoritmo|algoritmos	<i>noun</i><br><ol><li>algorithm</li></ol>
algoç|algozes	<i>noun</i><br><ol><li>executioner</li></ol>
alguien	<i>pron</i><br><ol><li>somebody; someone</li></ol>
algun|alguns|algua|alguas	<i>pron</i><br><ol><li>some</li><li>any</li></ol>
alhargar|alhargo|alhargado	<i>verb</i><br><ol><li>to widen</li></ol>
alhi	<i>adv</i><br><ol><li>there (far from both the speaker and the audience)</li></ol>
alhumbrar	<i>verb</i><br><ol><li>to illuminate, to light</li></ol>
alhá	<i>adv</i><br><ol><li>there (far from both the speaker and the audience)</li></ol>
alhá riba	<i>adv</i><br><ol><li>up there (on the top of)</li></ol>
alimiento|alimientos	<i>noun</i><br><ol><li>food</li><li>nourishment</li></ol>
aliçace|aliçaces	<i>noun</i><br><ol><li>foundation, base</li></ol>
alma|almas	<i>noun</i><br><ol><li>soul</li></ol>
almairo|almairos	<i>noun</i><br><ol><li>cupboard</li><li>wardrobe</li></ol>
almendra|almendras	<i>noun</i><br><ol><li>almond</li></ol>
almendral|almendrales	<i>noun</i><br><ol><li>almond orchard (a place with many almond trees)</li></ol>
almendreira|almendreiras	<i>noun</i><br><ol><li>almond tree</li></ol>
almorragie|almorragies	<i>noun</i><br><ol><li>haemorrhage (release of blood; bleeding)</li></ol>
almorçar	<i>verb</i><br><ol><li>(intransitive) to have lunch</li></ol>
almuorço|almuorços	<i>noun</i><br><ol><li>lunch (meal eaten at noon)</li></ol>
altemoble|altemobles	<i>noun</i><br><ol><li>automobile, car</li></ol>
alternatiba|alternatibas	<i>noun</i><br><ol><li>alternative</li></ol>
alternatibo|alternatiba|alternatibas|alternatibos	<i>adj</i><br><ol><li>alternative</li></ol>
amarielho|amarielhas|amarielhos|amarielha	<i>adj</i><br><ol><li>yellow</li></ol><br><i>noun</i><br><ol><li>yellow</li></ol>
ambesible|ambesibles	<i>adj</i><br><ol><li>invisible</li></ol>
ambierno|ambiernos	<i>noun</i><br><ol><li>winter</li></ol>
amouchado|amouchadas|amouchados|amouchada	<i>adj</i><br><ol><li>having one’s head covered</li></ol>
ampeçar	<i>verb</i><br><ol><li>to start; to begin</li></ol>
amportante|amportantes	<i>adj</i><br><ol><li>important</li></ol>
ampossible|ampossibles	<i>adj</i><br><ol><li>impossible</li></ol>
ampressionante|ampressionantes	<i>adj</i><br><ol><li>impressive</li></ol>
ampério|ampérios	<i>noun</i><br><ol><li>empire</li></ol>
an	<i>prep</i><br><ol><li>in</li><li>on</li></ol>
ancluir	<i>verb</i><br><ol><li>to include</li></ol>
andicar	<i>verb</i><br><ol><li>to indicate</li></ol>
anho|anhos	<i>noun</i><br><ol><li>year</li></ol>
anjo|anjos	<i>noun</i><br><ol><li>angel</li></ol>
ansinar	<i>verb</i><br><ol><li>to teach</li></ol>
antender	<i>verb</i><br><ol><li>to understand</li></ol>
anterbalo|anterbalos	<i>noun</i><br><ol><li>interval, intermission</li></ol>
anton	<i>adv</i><br><ol><li>then; at that time; next</li></ol>
antrar	<i>verb</i><br><ol><li>to enter</li></ol>
antre	<i>prep</i><br><ol><li>between</li><li>among</li></ol>
antretener	<i>verb</i><br><ol><li>(transitive) to amuse; to entertain</li></ol>
aqueste|aquestas|aquesta|aquestes	<i>pron</i><br><ol><li>(archaic) this (masculine thing)</li></ol>
aquisto	<i>pron</i><br><ol><li>this (the thing here)</li><li>this (the thing being discussed; the current situation)</li></ol>
arble|arbles	<i>noun</i><br><ol><li>tree</li></ol>
armana|armanas	<i>noun</i><br><ol><li>sister</li></ol>
armano|armanos	<i>noun</i><br><ol><li>brother</li></ol>
arquiteto|arquitetos	<i>noun</i><br><ol><li>architect</li></ol>
arquitetura	<i>noun</i><br><ol><li>architecture</li></ol>
astanho	<i>adv</i><br><ol><li>this year</li></ol>
auga|augas	<i>noun</i><br><ol><li>water</li></ol>
auguita	<i>noun</i><br><ol><li>small amount of water</li></ol>
ayunar	<i>verb</i><br><ol><li>to fast</li></ol>
açucre	<i>noun</i><br><ol><li>sugar</li></ol>
bandeira|bandeiras	<i>noun</i><br><ol><li>flag</li></ol>
bela|belas	<i>noun</i><br><ol><li>(nautical) sail</li><li>sail, blade of a windmill</li><li>spark plug</li></ol>
bento	<i>noun</i><br><ol><li>wind</li></ol>
ber|bi	<i>verb</i><br><ol><li>to see</li></ol>
berano|beranos	<i>noun</i><br><ol><li>summer</li></ol>
berdade|berdades	<i>noun</i><br><ol><li>truth</li></ol>
berde|berdes	<i>adj</i><br><ol><li>green</li></ol>
besible|besibles	<i>adj</i><br><ol><li>visible</li></ol>
bexanar	<i>verb</i><br><ol><li>to speak to someone’s ear</li><li>to tell a secret whisperingly</li><li>to whisper (to speak in a quiet voice)</li></ol>
beç|bezes	<i>noun</i><br><ol><li>time (instance or occurrence)</li></ol>
bibal	<i>noun</i><br><ol><li>nursery (place where the buds of trees, shrubs and vines are cultivated)</li><li>a fox den</li></ol>
bibir	<i>verb</i><br><ol><li>to live</li></ol>
bida|bidas	<i>noun</i><br><ol><li>life</li></ol>
bielho|bielhos|bielhas|bielha	<i>adj</i><br><ol><li>old</li></ol>
bila|bilas	<i>noun</i><br><ol><li>village</li></ol>
bino|binos	<i>noun</i><br><ol><li>wine</li></ol>
binte	<i>num</i><br><ol><li>twenty</li></ol>
biolento|biolentos|biolentas|biolenta	<i>adj</i><br><ol><li>violent</li></ol>
biúba|biúbas	<i>noun</i><br><ol><li>widow</li></ol>
bolso|bolsos	<i>noun</i><br><ol><li>pocket</li></ol>
boç|bozes	<i>noun</i><br><ol><li>voice</li></ol>
brabo|brabos|braba|brabas	<i>adj</i><br><ol><li>angry, furious</li><li>bold, courageous</li></ol>
branco|brancos|branca|brancas	<i>adj</i><br><ol><li>white</li></ol>
buono|buonos|buona|buonas	<i>adj</i><br><ol><li>good</li></ol>
burmeilho|burmeilhas|burmeilhos|burmeilha	<i>adj</i><br><ol><li>red</li></ol>
bíblico|bíblicas|bíblicos|bíblica	<i>adj</i><br><ol><li>biblical</li></ol>
bós	<i>pron</i><br><ol><li>you (the second-person plural pronoun)</li></ol>
cabresto	<i>adj</i><br><ol><li>idiot, fool, moron</li></ol>
carro|carros	<i>noun</i><br><ol><li>automobile, car</li></ol>
casamiento|casamientos	<i>noun</i><br><ol><li>marriage</li><li>wedding</li></ol>
castielho|castielhos	<i>noun</i><br><ol><li>castle</li></ol>
catedral	<i>noun</i><br><ol><li>cathedral</li></ol>
ceblizaçon|ceblizaçones	<i>noun</i><br><ol><li>civilization</li></ol>
checharra|checharras	<i>noun</i><br><ol><li>cicada</li></ol>
cheno|chenas|chena	<i>adj</i><br><ol><li>full</li></ol>
chuober	<i>verb</i><br><ol><li>to rain</li></ol>
cidade|cidades	<i>noun</i><br><ol><li>city</li></ol>
cielo|cielos	<i>noun</i><br><ol><li>sky</li><li>heaven</li></ol>
cien	<i>num</i><br><ol><li>one-hundred</li></ol>
cinco	<i>num</i><br><ol><li>five</li></ol>
coincer	<i>verb</i><br><ol><li>to know; to be familiar with</li></ol>
coixa	<i>noun</i><br><ol><li>thigh</li></ol>
comer	<i>verb</i><br><ol><li>to eat</li></ol>
coraçon|coraçones	<i>noun</i><br><ol><li>heart</li></ol>
cousa|cousas	<i>noun</i><br><ol><li>thing</li></ol>
cul|culas|culs|cula	<i>abbrev</i><br><ol><li>Contraction of cun l (“with the”).</li></ol>
cumbencer	<i>verb</i><br><ol><li>to convince</li></ol>
cumpletamente	<i>adv</i><br><ol><li>completely</li></ol>
cumputador|cumputadores	<i>noun</i><br><ol><li>computer</li></ol>
cun	<i>prep</i><br><ol><li>with</li></ol>
cuncluir	<i>verb</i><br><ol><li>to conclude</li></ol>
cuncluson|cunclusones	<i>noun</i><br><ol><li>conclusion</li></ol>
cuntinente|cuntinentes	<i>noun</i><br><ol><li>continent</li></ol>
dalhi	<i>abbrev</i><br><ol><li>Contraction of de (“of; from”) + alhi (“there”)</li></ol>
dalhá	<i>abbrev</i><br><ol><li>Contraction of de (“of; from”) + alhá (“there”)</li></ol>
dar	<i>verb</i><br><ol><li>to give</li></ol>
de	<i>prep</i><br><ol><li>of, from</li></ol>
de fato	<i>adv</i><br><ol><li>truly</li><li>indeed</li><li>in fact</li></ol>
debedir	<i>verb</i><br><ol><li>to divide</li></ol>
deficuldade|deficuldades	<i>noun</i><br><ol><li>difficulty</li></ol>
defrente|defrentes	<i>adj</i><br><ol><li>different</li></ol>
defícel|defíceles	<i>adj</i><br><ol><li>difficult</li></ol>
deilhi	<i>abbrev</i><br><ol><li>Contraction of de (“of; from”) + eilhi (“there”)</li></ol>
deiqui	<i>abbrev</i><br><ol><li>Contraction of de (“of; from”) + eiqui (“here”)</li></ol>
demingo	<i>noun</i><br><ol><li>Sunday</li></ol>
deste|destas|desta|destes	<i>abbrev</i><br><ol><li>Contraction of de (“of; from”) + este (“this”)</li></ol>
dezir	<i>verb</i><br><ol><li>to say</li></ol>
die|dies	<i>noun</i><br><ol><li>day</li></ol>
dieç	<i>num</i><br><ol><li>ten</li></ol>
digeston	<i>noun</i><br><ol><li>digestion</li></ol>
dioucese|diouceses	<i>noun</i><br><ol><li>diocese</li></ol>
dous	<i>num</i><br><ol><li>two</li></ol>
eibitar	<i>verb</i><br><ol><li>to avoid</li></ol>
eideia|eideias	<i>noun</i><br><ol><li>idea</li></ol>
eigreija|eigreijas	<i>noun</i><br><ol><li>church</li></ol>
eigual|eiguales	<i>adj</i><br><ol><li>equal</li></ol>
eilebador|eilebadores	<i>noun</i><br><ol><li>lift, elevator</li></ol>
eilha|eilhas	<i>pron</i><br><ol><li>she</li><li>(of a feminine noun) it</li></ol>
eilhas	<i>pron</i><br><ol><li>they (third-person plural feminine pronoun)</li></ol>
eilhes	<i>pron</i><br><ol><li>they (third-person plural masculine pronoun)</li></ol>
eilhi	<i>adv</i><br><ol><li>there (far from both the speaker and the audience)</li></ol>
eili	<i>adv</i><br><ol><li>there (far from both the speaker and the audience)</li></ol>
eimaige|eimaiges	<i>noun</i><br><ol><li>image</li></ol>
eipistemologie|eipistemologies	<i>noun</i><br><ol><li>epistemology</li></ol>
eiqui	<i>adv</i><br><ol><li>here (in this place)</li></ol>
eisemplo|eisemplos	<i>noun</i><br><ol><li>example</li></ol>
eisistir	<i>verb</i><br><ol><li>to exist</li></ol>
eisército|eisércitos	<i>noun</i><br><ol><li>army</li></ol>
el	<i>pron</i><br><ol><li>he</li></ol>
este|estes|estas|esta	<i>pron</i><br><ol><li>this</li></ol>
falar	<i>verb</i><br><ol><li>to speak</li></ol>
fato|fatos	<i>noun</i><br><ol><li>fact (sometimes which is real)</li></ol>
feliç|felizes	<i>adj</i><br><ol><li>happy</li></ol>
filha|filhas	<i>noun</i><br><ol><li>daughter</li></ol>
filho|filhos|filhas|filha	<i>noun</i><br><ol><li>son</li></ol>
frol	<i>noun</i><br><ol><li>flower</li></ol>
fuogo|fuogos	<i>noun</i><br><ol><li>fire</li></ol>
fuorte|fuortes	<i>adj</i><br><ol><li>strong</li></ol>
fuortemente	<i>adv</i><br><ol><li>strongly</li></ol>
fácele|fáceles	<i>adj</i><br><ol><li>easy</li></ol>
gamon|gamones	<i>noun</i><br><ol><li>branched asphodel (Asphodelus ramosus)</li><li>backgammon</li></ol>
geografie	<i>noun</i><br><ol><li>geography</li></ol>
guapo|guapos|guapa|guapas	<i>adj</i><br><ol><li>gorgeous, beautiful</li></ol>
hoije	<i>adv</i><br><ol><li>today</li></ol>
home|homes	<i>noun</i><br><ol><li>man</li><li>husband</li></ol>
houmano|houmanas|houmanos|houmana	<i>adj</i><br><ol><li>human</li></ol><br><i>noun</i><br><ol><li>human</li></ol>
huorta	<i>noun</i><br><ol><li>kitchen garden (garden for growing fruit, vegetables and/or herbs)</li></ol>
i	<i>conj</i><br><ol><li>and</li></ol>
isto	<i>pron</i><br><ol><li>this (the thing here)</li><li>this (the thing being discussed; the current situation)</li></ol>
jabeira|jabeiras	<i>noun</i><br><ol><li>pocket</li></ol>
jardin|jardines	<i>noun</i><br><ol><li>garden</li></ol>
jibeira|jibeiras	<i>noun</i><br><ol><li>pocket</li></ol>
jinela|jinelas	<i>noun</i><br><ol><li>window</li></ol>
l|ls|la|las|l	<i>article</i><br><ol><li>the (definite article)</li></ol>
la|ls|la|l|las	<i>article</i><br><ol><li>the</li></ol>
lado|lhados|lados|lhado	<i>noun</i><br><ol><li>side</li></ol>
lago	<i>noun</i><br><ol><li>lake</li></ol>
las|ls|la|las|l	<i>article</i><br><ol><li>the</li></ol>
ler|lher	<i>verb</i><br><ol><li>to read</li></ol>
lhaço|lhaços	<i>noun</i><br><ol><li>a traditional Mirandese folk dance</li></ol>
lhei|lheis	<i>noun</i><br><ol><li>law</li></ol>
lheite	<i>noun</i><br><ol><li>milk</li></ol>
lhiteratura	<i>noun</i><br><ol><li>literature</li></ol>
lhobo|lhobos	<i>noun</i><br><ol><li>wolf</li></ol>
lhuna|lhunas	<i>noun</i><br><ol><li>the Moon</li><li>moon</li></ol>
lhéngua|lhénguas	<i>noun</i><br><ol><li>(anatomy) tongue</li><li>(linguistics) language</li></ol>
liberalismo	<i>noun</i><br><ol><li>liberalism</li></ol>
libro|libros|lhibros|lhibro	<i>noun</i><br><ol><li>book</li></ol>
limpo|limpos|limpa|limpas	<i>adj</i><br><ol><li>clean</li></ol>
loinge	<i>adv</i><br><ol><li>far</li></ol>
ls|ls|la|l|las	<i>article</i><br><ol><li>the</li></ol>
macacada|macacadas	<i>noun</i><br><ol><li>a joke (generally in bad taste)</li><li>a ridiculous or comical scene</li></ol>
macaco|macacos	<i>noun</i><br><ol><li>monkey</li><li>a person that imitates others</li><li>a treacherous, deceitful person</li></ol>
macada|macadas	<i>noun</i><br><ol><li>a large quantity</li></ol>
macado|macados|macadas|macada	<i>adj</i><br><ol><li>stained, blemished, dirty</li></ol>
macánico|macánicas|macánica|macánicos	<i>adj</i><br><ol><li>mechanic</li></ol><br><i>noun</i><br><ol><li>mechanic</li></ol>
maias	<i>noun</i><br><ol><li>chestnuts eaten during May Day, in belief that they will bring luck and prevent headaches in the coming year</li></ol>
maiorie|maiories	<i>noun</i><br><ol><li>majority</li></ol>
manhana|manhanas	<i>noun</i><br><ol><li>morning</li></ol>
mano|manos	<i>noun</i><br><ol><li>(anatomy) hand</li></ol>
matrimónio|matrimónios	<i>noun</i><br><ol><li>marriage, matrimony</li></ol>
maçana|maçanas	<i>noun</i><br><ol><li>apple (fruit)</li></ol>
metade|metades	<i>noun</i><br><ol><li>half</li></ol>
mirandés|mirandesas|mirandeses|mirandesa	<i>adj</i><br><ol><li>Mirandese</li></ol><br><i>noun</i><br><ol><li>Mirandese (person)</li></ol>
miu|mie|mius|mies	<i>pron</i><br><ol><li>my</li></ol>
mulhier|mulhieres	<i>noun</i><br><ol><li>woman</li><li>wife</li></ol>
muorte|muortes	<i>noun</i><br><ol><li>death</li></ol>
més|meses	<i>noun</i><br><ol><li>month</li></ol>
naide	<i>pron</i><br><ol><li>no one; nobody</li></ol>
neçairo|neçairas|neçairos|neçaira	<i>adj</i><br><ol><li>necessary</li></ol>
nible|nibles	<i>noun</i><br><ol><li>level (degree or amount)</li></ol>
nome|nomes	<i>noun</i><br><ol><li>name</li></ol>
nubre|nubres	<i>noun</i><br><ol><li>cloud</li></ol>
nuite|nuites	<i>noun</i><br><ol><li>night</li></ol>
nun	<i>adv</i><br><ol><li>not</li></ol>
nuobo|nuobas|nuobos|nuoba	<i>adj</i><br><ol><li>new</li></ol>
nuosso|nuossos|nuossas|nuossa	<i>pron</i><br><ol><li>our</li></ol>
nuôbe	<i>num</i><br><ol><li>nine</li></ol>
nós	<i>pron</i><br><ol><li>we (the first-person plural pronoun)</li></ol>
onte	<i>adv</i><br><ol><li>yesterday</li></ol>
onze	<i>num</i><br><ol><li>eleven</li></ol>
oubido|oubidos	<i>noun</i><br><ol><li>ear</li></ol>
oubir	<i>verb</i><br><ol><li>to hear</li></ol>
ouceano|ouceanos	<i>noun</i><br><ol><li>ocean</li></ol>
oucidental|oucidentales	<i>adj</i><br><ol><li>western</li></ol>
oufecialmente	<i>adv</i><br><ol><li>officially</li></ol>
oulhar	<i>verb</i><br><ol><li>to look</li></ol>
oulá	<i>intj</i><br><ol><li>hello</li></ol>
oumentar	<i>verb</i><br><ol><li>to increase; to grow</li></ol>
ounibersidade|ounibersidades	<i>noun</i><br><ol><li>university</li></ol>
ounion|ouniones	<i>noun</i><br><ol><li>union</li><li>junction, joint</li><li>alliance</li></ol>
ounion de fato|ouniones de fato	<i>noun</i><br><ol><li>civil union, domestic partnership</li></ol>
ouponer	<i>verb</i><br><ol><li>to oppose</li></ol>
oupçon|oupçones	<i>noun</i><br><ol><li>option</li></ol>
oureginal|oureginales	<i>adj</i><br><ol><li>original</li></ol>
ouro	<i>noun</i><br><ol><li>gold</li></ol>
ouropeu|ouropeia|ouropeus|ouropeias	<i>adj</i><br><ol><li>European</li></ol><br><i>noun</i><br><ol><li>European</li></ol>
ousar	<i>verb</i><br><ol><li>to use</li></ol>
ouserbar	<i>verb</i><br><ol><li>to observe</li></ol>
outonho|outonhos	<i>noun</i><br><ol><li>autumn</li></ol>
outor|outores	<i>noun</i><br><ol><li>author</li></ol>
pai|pais	<i>noun</i><br><ol><li>father</li></ol>
parro	<i>noun</i><br><ol><li>duck</li></ol>
paç	<i>noun</i><br><ol><li>peace</li></ol>
paíç|paízes	<i>noun</i><br><ol><li>country (territory of a nation)</li></ol>
peligro	<i>noun</i><br><ol><li>danger</li></ol>
pensar	<i>verb</i><br><ol><li>to think</li></ol>
pequeinho|pequeinhos|pequeinha|pequeinhas	<i>adj</i><br><ol><li>small</li></ol>
pertués|pertuesas|pertueses|pertuesa	<i>adj</i><br><ol><li>Portuguese</li></ol><br><i>noun</i><br><ol><li>Portuguese (person)</li></ol>
pessona|pessonas	<i>noun</i><br><ol><li>person</li></ol>
piedra|piedras	<i>noun</i><br><ol><li>stone</li></ol>
pobo|pobos	<i>noun</i><br><ol><li>people</li></ol>
porblema|porblemas	<i>noun</i><br><ol><li>problem</li></ol>
porduzir	<i>verb</i><br><ol><li>to produce</li></ol>
posiçon|posiçones	<i>noun</i><br><ol><li>position</li></ol>
primabera|primaberas	<i>noun</i><br><ol><li>spring (season)</li></ol>
puorta|puortas	<i>noun</i><br><ol><li>door (portal of entry into a building or room, consisting of a rigid plane movable on a hinge)</li></ol>
puosta|puostas	<i>noun</i><br><ol><li>steak</li></ol>
purmeiro|purmeiros|purmeiras|purmeira	<i>adj</i><br><ol><li>first</li></ol>
páixaro|páixaros	<i>noun</i><br><ol><li>bird</li></ol>
quaije	<i>adv</i><br><ol><li>almost</li></ol>
quando	<i>adv</i><br><ol><li>when</li></ol>
quarta-feira	<i>noun</i><br><ol><li>Wednesday</li></ol>
quatro	<i>num</i><br><ol><li>four</li></ol>
queiso|queisos	<i>noun</i><br><ol><li>cheese</li></ol>
quelor|quelores	<i>noun</i><br><ol><li>color</li></ol>
quelónia|quelónias	<i>noun</i><br><ol><li>colony</li></ol>
quemido|quemidos	<i>noun</i><br><ol><li>food</li><li>nourishment</li></ol>
quemun|quemuns	<i>adj</i><br><ol><li>common</li></ol>
quemunidade|quemunidades	<i>noun</i><br><ol><li>community</li></ol>
queruja|querujas	<i>noun</i><br><ol><li>owl (a bird)</li></ol>
quinta-feira	<i>noun</i><br><ol><li>Thursday (day between Wednesday and Friday)</li></ol>
rabielho	<i>noun</i><br><ol><li>a type of sailboat used in the Douro river to transport wine barrels</li></ol>
raiç|raízes	<i>noun</i><br><ol><li>root</li></ol>
reboluçon|reboluçones	<i>noun</i><br><ol><li>revolution</li></ol>
rei|reis	<i>noun</i><br><ol><li>king</li></ol>
reloijo|reloijos	<i>noun</i><br><ol><li>clock</li><li>watch, wristwatch</li></ol>
respunder	<i>verb</i><br><ol><li>to respond; to answer</li></ol>
rezon|rezones	<i>noun</i><br><ol><li>reason</li><li>reasoning</li></ol>
riu|rius	<i>noun</i><br><ol><li>river</li></ol>
sangre	<i>noun</i><br><ol><li>blood</li></ol>
scluir	<i>verb</i><br><ol><li>to exclude</li></ol>
screbir	<i>verb</i><br><ol><li>to write</li></ol>
scultura|sculturas	<i>noun</i><br><ol><li>sculpture</li></ol>
scuola|scuolas	<i>noun</i><br><ol><li>school</li></ol>
segunda-feira	<i>noun</i><br><ol><li>Monday (day of the week)</li></ol>
seis	<i>num</i><br><ol><li>six</li></ol>
selombra|selombras	<i>noun</i><br><ol><li>shadow</li></ol>
ser|seres	<i>verb</i><br><ol><li>to be (indicates a permanent quality)</li></ol><br><i>noun</i><br><ol><li>being</li></ol>
sesta-feira	<i>noun</i><br><ol><li>Friday (day of the week)</li></ol>
sfera|sferas	<i>noun</i><br><ol><li>sphere</li></ol>
sien	<i>prep</i><br><ol><li>without</li></ol>
siete	<i>num</i><br><ol><li>seven</li></ol>
simples	<i>adj</i><br><ol><li>simple</li></ol>
smola	<i>noun</i><br><ol><li>alms</li><li>charity</li></ol>
spada|spadas	<i>noun</i><br><ol><li>sword</li></ol>
spandir	<i>verb</i><br><ol><li>to expand</li></ol>
sperar	<i>verb</i><br><ol><li>to wait</li><li>to hope</li></ol>
spresson|spressones	<i>noun</i><br><ol><li>expression</li></ol>
spulsar	<i>verb</i><br><ol><li>to expel</li></ol>
spulson|spulsones	<i>noun</i><br><ol><li>expulsion</li></ol>
squecer	<i>verb</i><br><ol><li>to forget</li></ol>
squierdo	<i>adj</i><br><ol><li>left (left-handed)</li></ol>
stado|stados	<i>noun</i><br><ol><li>state (subdivision of a nation)</li><li>state; status; condition</li></ol>
star	<i>verb</i><br><ol><li>to be (indicates a temporary state)</li></ol>
streilha|streilhas	<i>noun</i><br><ol><li>star</li></ol>
suldado|suldados	<i>noun</i><br><ol><li>soldier</li></ol>
suonho|suonhos	<i>noun</i><br><ol><li>sleep</li><li>dream</li></ol>
sábado	<i>noun</i><br><ol><li>Saturday</li></ol>
talbeç	<i>adv</i><br><ol><li>maybe; perhaps</li></ol>
tamien	<i>adv</i><br><ol><li>also</li></ol>
tascar	<i>verb</i><br><ol><li>to remove the bast from a flax plant</li></ol>
terça-feira	<i>noun</i><br><ol><li>Tuesday (day of the week)</li></ol>
traduçon|traduçones	<i>noun</i><br><ol><li>translation</li></ol>
triato|triatos	<i>noun</i><br><ol><li>theater</li></ol>
trinta	<i>num</i><br><ol><li>thirty</li></ol>
trés	<i>num</i><br><ol><li>three</li></ol>
tu	<i>pron</i><br><ol><li>you (the second-person singular pronoun)</li></ol>
ua|ũa|ua|un	<i>article</i><br><ol><li>a, an</li></ol>
uba|ubas	<i>noun</i><br><ol><li>grape</li></ol>
uito	<i>num</i><br><ol><li>eight</li></ol>
un|ũa|ua|un	<i>article</i><br><ol><li>a, an</li></ol>
uolho|uolhos	<i>noun</i><br><ol><li>eye</li></ol>
xadreç	<i>noun</i><br><ol><li>chess</li></ol>
you	<i>pron</i><br><ol><li>I (the first-person singular pronoun)</li></ol>
zambolber	<i>verb</i><br><ol><li>to develop</li></ol>
zaparecer	<i>verb</i><br><ol><li>to disappear</li></ol>
zde	<i>prep</i><br><ol><li>since</li><li>from a location</li></ol>
zeigual|zeiguales	<i>adj</i><br><ol><li>unequal</li></ol>
zinolho|zinolhos	<i>noun</i><br><ol><li>knee</li></ol>
águila|águilas	<i>noun</i><br><ol><li>eagle</li></ol>
çapato	<i>noun</i><br><ol><li>shoe</li></ol>
çcansar	<i>verb</i><br><ol><li>(intransitive) to rest</li></ol>
çcer	<i>verb</i><br><ol><li>to descend; to drop; to decline</li></ol>
çcrebir	<i>verb</i><br><ol><li>to describe</li></ol>
çcriçon|çcriçones	<i>noun</i><br><ol><li>description</li></ol>
çcubrir	<i>verb</i><br><ol><li>to discover</li></ol>
çfazer	<i>verb</i><br><ol><li>to undo</li></ol>
çtinto|çtinta|çtintas|çtintos	<i>adj</i><br><ol><li>distinct; different</li></ol>
çtruir	<i>verb</i><br><ol><li>to destroy</li></ol>
