( )	<i>punct</i><br><ol><li>sometimes used to enclose digits to distinguish from letters</li></ol>
က|ka	<i>character</i><br><ol><li>Ka, the first consonant of the Mon alphabet.</li></ol><br><i>noun</i><br><ol><li>fish</li><li>howdah harness saddle.</li><li>short prop fulcrum.</li></ol><br><i>verb</i><br><ol><li>to be lacking.</li><li>to harness a horse or any draught animal.</li><li>to fail.</li></ol>
ကကနန်|ka kanan|ကဂနန်|ka kanon|ကကနောန်	<i>noun</i><br><ol><li>banded snakehead or immature banded snakehead. (Channa striata, syn. Ophiocephalus striatus)</li><li>(Kaw Kyaik) immature banded snakehead (Channa striata)</li></ol>
ကက္ကုသန်|kakkusan	<i>noun</i><br><ol><li>(Buddhism) Kakusandha, the first of the five Buddhas of the present cycle.</li></ol>
ကကၠဴ|kaklau	<i>noun</i><br><ol><li>point-tailed goby, flying-fish, Gobius acutipinnis Cuvier and Valenciennes.</li></ol>
ကချေၚ်|kakhyeṅ	<i>name</i><br><ol><li>Kachin {an ethnic group in Burma}, name of one of the Tibeto-Burman speaking, national groups of the union of Burma.</li></ol>
ကဆိၚ်|kachiṅ	<i>noun</i><br><ol><li>female dancer.</li></ol>
ကဆေဝ်|kachew	<i>verb</i><br><ol><li>to slip.</li></ol>
ကဆံ|kacham	<i>verb</i><br><ol><li>to repeat.</li></ol><br><i>adv</i><br><ol><li>repeatedly, again and again.</li></ol>
ကဆံၚ်|kachåṅ	<i>verb</i><br><ol><li>to build in tiers, launder.</li></ol><br><i>noun</i><br><ol><li>step, standard, stage in educational system.</li></ol>
ကညာ|kañā	<i>noun</i><br><ol><li>dry season summer dry or hot season.</li></ol>
ကညောန်|kañon	<i>verb</i><br><ol><li>to wrap tightly around one.</li></ol>
ကဏ္ဍ|kaṇḍa	<i>noun</i><br><ol><li>section</li></ol>
ကတပံင်|katapaṃṅ	<i>noun</i><br><ol><li>cockup immature bectie.</li></ol>
ကတာ|kachåṅ	<i>noun</i><br><ol><li>foreshore of river below bank, alluvial soil {as an island reformed}.</li></ol>
ကတ်|kat	<i>noun</i><br><ol><li>class of medicinal herbs and plants, such as Costus speciousus</li></ol><br><i>verb</i><br><ol><li>to study</li></ol>
ကထိုန်|katiun	<i>noun</i><br><ol><li>one of 12 lunar months in the traditional Mon calendar, roughly coinciding with November</li><li>(Buddhism) monastic robes presented to monks at end of the Buddhist Lent (Vassa)</li></ol>
ကဒါတ်|kadāt	<i>noun</i><br><ol><li>species of yam (Dioscorea wallichii)</li><li>liver, three leaved caper tree, Crataeva Roxburghii Brandis, species of yam, a kind of yam.</li></ol>
ကပလှု|kapalhu	<i>noun</i><br><ol><li>mullet fish.</li></ol>
ကပေါဝ်|kapow	<i>noun</i><br><ol><li>acacia, soap acacia creeper, Acacia concinna De Candolle.</li></ol>
ကပ်|kap	<i>noun</i><br><ol><li>mat of woven split bamboo</li><li>natural disasters an era calamity time of catastrophe.</li></ol>
ကမက်|kamak	<i>noun</i><br><ol><li>handle by which something is lifted or carried subscript consonant.</li></ol>
ကမာ|kamā	<i>noun</i><br><ol><li>thank reservoir cistern.</li></ol><br><i>verb</i><br><ol><li>to be geminate.</li></ol>
ကမ်|ကံ|kam	<i>noun</i><br><ol><li>bullet shell round cartridge.</li><li>Karma law of good and bad actions the cumulative product of a person’s past actions determining his destiny at any given time.</li></ol>
ကယာ|kayā	<i>verb</i><br><ol><li>to lift up</li><li>to be lift up</li><li>to come loose</li></ol>
ကယျာ|ကယာ|kayyā|kayā	<i>name</i><br><ol><li>Kayah, a Tibeto-Burman speaking ethnic group in Myanmar</li></ol>
ကရုဏာ|karuṇā	<i>noun</i><br><ol><li>compassion; sympathy</li></ol>
ကရေင်|kareng	<i>name</i><br><ol><li>Karen, {Kareang} Kayin name of one of Tibeto-burman speaking national groups of the Union of Burma.</li></ol><br><i>verb</i><br><ol><li>be half asleep with eyes closed luxuriate with eyes half close maintain a calculate silence.</li></ol>
ကရှ်ေ|karh	<i>noun</i><br><ol><li>measure of capacity equal to one thirty-two of a basket န (na) or half a ကလတ် (kalat).</li></ol>
ကလတ်|kalat	<i>noun</i><br><ol><li>measure of capacity equal to one-sixteenth of a basket န (na) four ကလတ် (kalat) is a ဇိပ် (jip).</li><li>royal or government emissary, ambassador, intelligencer.</li><li>middle-sixed tree bearing acerbic fruit in clusters used for curry.</li><li>sprout, shoot</li></ol><br><i>verb</i><br><ol><li>to plant seeds or sow individually.</li></ol>
ကလာထေၚ်|kalātheṅ	<i>noun</i><br><ol><li>chair</li></ol>
ကလေၚ်|kaleṅ	<i>verb</i><br><ol><li>(intransitive) to return to bring back to send back. {usually as first element of (v) phr} to reciprocate repeat an action.</li></ol>
ကဝက်|kəwɛk	<i>noun</i><br><ol><li>half</li></ol>
ကဝိ|kawi	<i>noun</i><br><ol><li>poet composer.</li></ol>
ကဝဲ|kaway|ka way	<i>noun</i><br><ol><li>shark</li></ol><br><i>verb</i><br><ol><li>(Pak Kret District) twirl, twist.</li><li>to turn round, twist, wind, screw in</li><li>(of wind) whirl</li></ol>
ကဝ်|kaw	<i>noun</i><br><ol><li>coarse sugar viscid substance pulp paste glue syrup residue obtained by evaporation.</li><li>cycle of time at the end of which the universe is destroyed and recreated.</li></ol><br><i>verb</i><br><ol><li>to be broken off</li><li>to snap break in two under the stress of bending.</li><li>to carry hanging loosely over the shoulder.</li></ol>
ကဝ်ဖှဳ	<i>noun</i><br><ol><li>coffee</li></ol>
ကသပ်|kasap	<i>noun</i><br><ol><li>expletive in.</li><li>plan of action considered intention.</li></ol>
ကအ်|ကမ်|kaʼ|ကံ|kam	<i>noun</i><br><ol><li>neck throat.</li><li>island raised mound formed by village site in low lying areas.</li></ol>
ကာ|kā	<i>noun</i><br><ol><li>teapot, tea kettle.</li><li>motor car, bus.</li><li>work, deed.</li></ol>
ကာပ္ပလဳ|kappəli	<i>noun</i><br><ol><li>Negro, negrito, esp. Andamanese</li></ol>
ကာမ|kāma	<i>noun</i><br><ol><li>sensual desire passion.</li></ol>
ကာလယဲ|kālayay	<i>noun</i><br><ol><li>epidemic, especially cholera</li></ol>
ကာဲ|kāyy	<i>verb</i><br><ol><li>to behave without restraint</li></ol>
ကိစ္စ|ketca	<i>noun</i><br><ol><li>matter of importance business.</li></ol>
ကိတ်|kit	<i>verb</i><br><ol><li>to bite</li><li>to come up to standard.</li></ol>
ကိုက်|kiuk	<i>noun</i><br><ol><li>{blade of} plane {carpenter’s} plane.</li></ol><br><i>verb</i><br><ol><li>to be humpbacked bent.</li></ol>
ကိုတ်|kuit	<i>num</i><br><ol><li>hundred thousand</li></ol>
ကိုန်|kɒn	<i>noun</i><br><ol><li>number, in arithmetic or as numerological index</li></ol>
ကိုပ်ကၠာ|kiupklā	<i>adv</i><br><ol><li>before</li></ol>
ကီုလေဝ်|kiuṃlew	<i>adj</i><br><ol><li>even.</li></ol>
ကုတ်|kut	<i>verb</i><br><ol><li>to cut off amputate.</li></ol>
ကုန်|kun	<i>noun</i><br><ol><li>hillock mound small hill.</li><li>dwarf.</li></ol><br><i>verb</i><br><ol><li>to be humpbacked</li></ol>
ကေက်|kek	<i>verb</i><br><ol><li>to be sharp pointed.</li></ol>
ကော|kao	<i>noun</i><br><ol><li>elder brother</li></ol>
ကောန်|ကွေန်|kon	<i>noun</i><br><ol><li>child (descendant); cub.</li><li>child, offspring, young person, young of animals, son, young shoot of a plant.</li><li>member (of a society).</li><li>component.</li><li>something minor.</li><li>something subordinate (also applied to person).</li><li>(Martaban) young person.</li><li>magic</li></ol>
ကောန်ကမာ|kon kamā	<i>noun</i><br><ol><li>twin</li></ol>
ကောန်ကွာန်|kon kwān	<i>noun</i><br><ol><li>A male villager.</li></ol>
ကောန်ကွး|kon kwaḥ	<i>noun</i><br><ol><li>pupil pupil who is like a son.</li></ol>
ကောန်ကၟာ|kon kmā	<i>noun</i><br><ol><li>twin</li><li>(Pak Kret District) more than three siblings born together</li></ol>
ကောန်ကၠၚ်|kon klaṅ	<i>noun</i><br><ol><li>bastard.</li><li>equivalent for Thai กาฝาก (gaa-fàak); parasitic plants of the families Loranthaceae and Santalaceae (including former Viscaceae)</li></ol>
ကောန်ခအှ်|kon khaʼah|ကောန်ခအဟ်|ကောန်ဟအှ်|kon haʼah	<i>noun</i><br><ol><li>daughter-in-law</li></ol>
ကောန်စိုတ်|kon cət	<i>noun</i><br><ol><li>heart mind.</li><li>mind</li><li>(Pak Kret District) weak point</li></ol>
ကောန်စဴ|kon cau	<i>noun</i><br><ol><li>grandchild, great-nephew</li><li>(Pak Kret District) offspring, progeny</li></ol>
ကောန်ညာ်|konñāk	<i>noun</i><br><ol><li>child. [Var.]</li></ol>
ကောန်ဍုၚ်ကောန်ကွာန်|kon ḍuṅ kon kwān	<i>noun</i><br><ol><li>population</li><li>nation</li></ol>
ကောန်တဲ|kon tay	<i>noun</i><br><ol><li>finger.</li><li>(Pak Kret District) subordinate</li><li>rolling stock of a train</li><li>boat</li></ol>
ကောန်တြုံ|konkraoh	<i>noun</i><br><ol><li>son</li></ol>
ကောန်တၟံ|kon tmaʼ	<i>noun</i><br><ol><li>kidney heart.</li><li>heart (a kind of internal organ)</li></ol>
ကောန်ပၞာန်|kon pnān	<i>noun</i><br><ol><li>soldier</li></ol>
ကောန်ပၞံက်|kon pnåk	<i>noun</i><br><ol><li>key</li><li>bolt key.</li></ol>
ကောန်မေံ|ကောန်မေအ်|kon meʼ|kon mheʼ|ကောန်မှေံ	<i>noun</i><br><ol><li>buffalo calf a kind of plant.</li></ol>
ကောန်ရုပ်|kon rup	<i>noun</i><br><ol><li>puppet doll.</li></ol>
ကောန်ရဲ|kon ray	<i>noun</i><br><ol><li>subordinate</li><li>servant follower</li></ol>
ကောန်လတာ်|ကောန်ကတာ်|kon katāk|kon latāk	<i>noun</i><br><ol><li>uvula</li></ol>
ကောန်လေၚ်|kon leṅ	<i>noun</i><br><ol><li>adopted child, foster child</li><li>(Pak Kret District) stepchild</li></ol>
ကောန်လံက်|kon lok|kon låk|ကောန်လော်	<i>noun</i><br><ol><li>tadpole, polliwog</li></ol>
ကောန်သွီု|kon swəṁ	<i>noun</i><br><ol><li>stepchild foster-child step-son a wife’s son by a former husband.</li></ol>
ကောန်ၚာ်|ကွေန်ၚါ်|ကောန်ၚါ်	<i>noun</i><br><ol><li>child (young person)</li><li>child young person usually male</li></ol>
ကောန်ၚာ်တြုံ|ကွေန်ၚါ်တြုံ|ကောန်ညာ်တြုံ|kon ṅāk truʔ|ကောန်ၚါ်တြုံ	<i>noun</i><br><ol><li>boy</li><li>very young child</li></ol>
ကောန်ၚာ်ဗြဴ|konŋaikprɛ̀a	<i>noun</i><br><ol><li>Girl.</li></ol>
ကောပ်|kop	<i>verb</i><br><ol><li>to bind the edge of something with a hoop or continuous band</li><li>to discipline, dispense justice to</li></ol>
ကောံပါ|kompa	<i>noun</i><br><ol><li>compass, divider</li></ol>
ကော်|kok	<i>verb</i><br><ol><li>to call name summon.</li></ol>
ကဴ|kao	<i>noun</i><br><ol><li>flower.</li></ol><br><i>verb</i><br><ol><li>to flower blossom.</li></ol>
ကဵု|k̆o	<i>prep</i><br><ol><li>with, by, to</li></ol><br><i>conj</i><br><ol><li>and</li><li>or</li></ol><br><i>verb</i><br><ol><li>to give, to pay.</li></ol>
ကံ|kam	<i>noun</i><br><ol><li>luck</li></ol>
ကံက်|kɔk	<i>verb</i><br><ol><li>to levy duty (on)</li><li>to pick out</li></ol>
ကံၚ်|kaṃṅ|ကံင်	<i>noun</i><br><ol><li>piece of facial matter parcel work.</li></ol><br><i>verb</i><br><ol><li>to be lean thin to be crying without rest.</li></ol>
က္ည|kña	<i>verb</i><br><ol><li>to go or come {invite or bid farewell politely}. [pref.] Honorific prefixed to (vv) of motion when referring to monks usually combined with verbs of motion to and from {respectfully} verbal prefix with imperative expressing invitation.</li></ol>
က္ဍိုပ်|kḍəp	<i>noun</i><br><ol><li>head upper end summit fore-end.</li><li>work-shift work-gang.</li></ol>
က္တောဝ်|ktow	<i>noun</i><br><ol><li>ear (organ)</li><li>gill (of fish)</li><li>handle (of a container)</li></ol>
က္သေဲ|ksey	<i>verb</i><br><ol><li>to whisper.</li></ol>
က္ၜင်ကျာ|kḅaṅkyā	<i>noun</i><br><ol><li>aeroplane (US: airplane, plane)</li></ol>
က္ၜၚ်|kḅaṅ	<i>noun</i><br><ol><li>edible bamboo shoot.</li><li>final in (n.) (phr.) naming natural species often exotic.</li><li>ship large vessel.</li></ol>
ကျ|kya	<i>verb</i><br><ol><li>to be defeated beaten (by) to lose (to) fail (examination) be defeated (in battle sport and games) lost (in business game match legal case etc).</li></ol>
ကျာ|kyā	<i>noun</i><br><ol><li>air wind talk (especially a windy one).</li></ol>
ကျာန်|can	<i>verb</i><br><ol><li>to remain, be left over</li></ol>
ကျာန်ထၜေါအ်ရဳ|kyānthaṗorī	<i>name</i><br><ol><li>(ဍုင်~) Chanthaburi (a city in Thailand)</li><li>(ဒေသရး~) Chanthaburi (a province of Thailand)</li><li>(တွဵုရး~) Mueang Chanthaburi (a district of Chanthaburi Province, Thailand)</li><li>(ကြုင်~) Chanthaburi (a river in Thailand)</li></ol>
ကျာံ|kyāṃ	<i>noun</i><br><ol><li>crocodile.</li><li>crocodile alligator.</li><li>kyam (a three-stringed, fretted zither that is shaped like a crocodile)</li><li>Mon three stringed musical instrument in the shape of a crocodile type of stick-zither or vina in from of crocodile with three or five strings.</li></ol>
ကျာ်|kyāk	<i>noun</i><br><ol><li>sacred being or thing Buddha pagoda image of Buddha term of address terminating all utterances directed to monks when no other such term is included and as isolate inticating assent (Siam) general respectful term of address and assent.</li></ol><br><i>particle</i><br><ol><li>particle used to show acknowledgement or affirmation</li></ol>
ကျာ်ခမဳ|kyākkhamī	<i>name</i><br><ol><li>(ကျာ်စေတဳ or ဍုင်) Kyaikkhami (a town in Mon State, Myanmar)</li></ol><br><i>noun</i><br><ol><li>Missionary Monk Pagoda.</li></ol>
ကျေနာန်|kyenān	<i>noun</i><br><ol><li>telegram</li></ol>
ကြပ်|krap	<i>verb</i><br><ol><li>to be near to keep close (ကဵု (keu)) to} to be nearly.</li></ol>
ကြာ|krā	<i>noun</i><br><ol><li>brand seal stamp.</li><li>tripod derrick from which winnowing sieve ကၞာဲဇာ (knāyjā) is suspended.</li></ol>
ကြုက်|kruk|Kruk	<i>noun</i><br><ol><li>mango.</li></ol><br><i>name</i><br><ol><li>Chinese China man..</li></ol>
ကြုတ်	<i>noun</i><br><ol><li>intestine</li><li>inner portion</li><li>heart; core</li><li>heartwood; pith</li><li>cochineal; lac</li><li>kaffir lime, Citrus hystrix</li><li>crossing</li></ol>
ကြုၚ်|kruṅ	<i>noun</i><br><ol><li>creek small river stream.</li></ol>
ကြောပ်|krop	<i>noun</i><br><ol><li>rectilinear slab of roofing material</li><li>tile</li></ol>
ကြေဲ|krey	<i>noun</i><br><ol><li>sarus crane curlew Grus antigona sharpie.</li></ol>
ကြဳု|krɒm	<i>verb</i><br><ol><li>to shout, roar, boast</li></ol>
ကွ|kwa	<i>noun</i><br><ol><li>spanner.</li><li>matter of importance.</li></ol><br><i>verb</i><br><ol><li>to be short in stature.</li></ol>
ကွက်|kwak	<i>noun</i><br><ol><li>matter of importance.</li></ol><br><i>verb</i><br><ol><li>to hang up</li></ol>
ကွတ်|kwat	<i>noun</i><br><ol><li>branch of learning or knowledge craft.</li></ol>
ကွာ|kwa	<i>verb</i><br><ol><li>to become separate, to come apart</li></ol>
ကွာင်|kwāṅ|ကွာၚ်	<i>noun</i><br><ol><li>snack, sweets</li><li>confection prepared from flour {loaf of} bread cake pudding biscuit.</li></ol>
ကွာန်|kwān	<i>noun</i><br><ol><li>village</li><li>a kind of axe or adze {used in falling timber}.</li><li>species of laurel.</li></ol>
ကွာဲ|kwāy	<i>noun</i><br><ol><li>yam white yam Dioscorea alata.</li></ol><br><i>verb</i><br><ol><li>to present to.</li></ol>
ကွာ်|kwāk	<i>verb</i><br><ol><li>to walk go.</li></ol>
ကွာၚ်ကဝေက်|kwāṅkawek	<i>noun</i><br><ol><li>pancake baked on a potsherd.</li></ol>
ကွာၚ်ကံက်တဲ|kwāṅkaṃktoa	<i>noun</i><br><ol><li>doughnut made from glutinous rice, related to the မုန့်လက်ကောက် (mun.lakkauk)</li></ol>
ကွေန်	<i>verb</i><br><ol><li>to be curly.</li></ol>
ကွး|တွး|kwaḥ|twaḥ	<i>noun</i><br><ol><li>disciple pupil</li></ol>
ကှ်ခြံက်|khraṃk|khkhraṃk|ခြံက်	<i>verb</i><br><ol><li>to be dried up.</li></ol>
ကၚ်|kaṅ	<i>noun</i><br><ol><li>village defence post guardhouse.</li><li>brass gong.</li></ol><br><i>verb</i><br><ol><li>to stare be wide open.</li></ol>
ကၞိ|kni	<i>noun</i><br><ol><li>rat, mouse</li><li>attap or nipa palm Nipa fruticans.</li><li>nipa palm (Nypa fruticans)</li><li>long pepper.</li></ol>
ကၞိပ်|ကနိပ်|knip|kanip	<i>noun</i><br><ol><li>head</li><li>quantifier for objects arranged in groups.</li></ol>
ကၞု|kanau	<i>noun</i><br><ol><li>(zoology) shellfish shell.</li></ol>
ကၞုဲ|ka.nui	<i>noun</i><br><ol><li>monkey</li></ol>
ကၟက်|kamak	<i>verb</i><br><ol><li>to be filled in closed blind be fully covered or enveloped keep something tight.</li></ol>
ကၟာဲ|kmāy	<i>noun</i><br><ol><li>widow, unmarried mother</li></ol><br><i>verb</i><br><ol><li>to be widowed</li><li>to carry a burden slung across the shoulder</li></ol>
ကၟု|kmu	<i>adj</i><br><ol><li>white.</li></ol><br><i>verb</i><br><ol><li>to be mildewed.</li></ol>
ကၟဲာ	<i>noun</i><br><ol><li>Encoding in Unicode standard for modern Burmese of ကၟာဲ</li></ol><br><i>verb</i><br><ol><li>Encoding in Unicode standard for modern Burmese of ကၟာဲ</li></ol>
ကၠ|kla	<i>noun</i><br><ol><li>tiger</li><li>draught man</li></ol>
ကၠန်|klan	<i>noun</i><br><ol><li>python boa boa constrictor. (Malayopython reticulatus, syn. Python reticulatus)</li></ol>
ကၠိက်|kalac	<i>noun</i><br><ol><li>pig.</li></ol>
ကၠိုဟ်|kləh	<i>verb</i><br><ol><li>understand know comprehend to know thoroughly to understand thoroughly.</li><li>to pierce to penetrate to be perforate to be holed.</li></ol><br><i>adj</i><br><ol><li>whole through.</li></ol>
ကၠီု|kliuṃ	<i>verb</i><br><ol><li>to be dense</li><li>.to put upper saddle of the ridge.</li></ol>
ကၠုၚ်|kluŋ	<i>verb</i><br><ol><li>to come.</li></ol>
ကၠေၚ်|kleŋ	<i>verb</i><br><ol><li>to be oily fatty.</li></ol>
ကၠဵု|kluiw	<i>noun</i><br><ol><li>dog.</li></ol>
ကၠံ|klaʼ|klaṃ	<i>noun</i><br><ol><li>garden [esp.] market garden on open unirrigated land plantation.</li><li>(Myanmar, Thailand) land leech.</li></ol><br><i>num</i><br><ol><li>(Myanmar, Thailand) hundred.</li></ol>
ခ|kha	<i>character</i><br><ol><li>Kha, the 2nd letter of the Mon alphabet.</li></ol><br><i>verb</i><br><ol><li>to be dependent</li></ol>
ခက်|khak	<i>verb</i><br><ol><li>to catch on snag stick stick in mud.</li></ol>
ခမာ|khamā	<i>verb</i><br><ol><li>to crawl.</li></ol>
ခမိက်|əhmɔik	<i>noun</i><br><ol><li>dirt, mess, debris, litter, rubbish</li></ol>
ခမဳ|khamī	<i>noun</i><br><ol><li>(Buddhism) fully ordained monk.</li></ol>
ခမှာဲ|khamhāy	<i>noun</i><br><ol><li>egg tuber cooking-pot cauldron.</li><li>(Kaw Kyaik) tuber</li></ol><br><i>verb</i><br><ol><li>(Pak Kret District) to lay eggs</li></ol>
ခရိုင်|khariuŋ	<i>noun</i><br><ol><li>enclosure for animals pen corral cage box-trap sty.</li></ol>
ခရေတ်|kʰəret	<i>noun</i><br><ol><li>Christ</li></ol>
ခရေတ်ယာန်|kʰəretyàn	<i>noun</i><br><ol><li>Christian</li></ol>
ခရေတ်သမာတ်	<i>phrase</i><br><ol><li>(Christianity) Christmas</li></ol>
ခရံ|kharam	<i>noun</i><br><ol><li>advance payment, deposit, advance</li></ol>
ခါတ်|kʰat	<i>verb</i><br><ol><li>to stamp (used in compounds)</li></ol>
ခါန်|kʰan	<i>noun</i><br><ol><li>fact</li></ol>
ခိုဟ်|khəh	<i>verb</i><br><ol><li>to be good auspicious.</li></ol>
ခိုၚ်|kʰaŋ	<i>verb</i><br><ol><li>to be durable, firm, unyielding</li></ol>
ခု|khu	<i>verb</i><br><ol><li>to prop by a short prop or fulcrum.</li></ol>
ခုန်|khun	<i>verb</i><br><ol><li>to be sullen be moody.</li></ol>
ခုၚ်|kʰɜŋ	<i>noun</i><br><ol><li>flat-topped movable article of furniture, table, bench, chair, stand</li></ol>
ခူ|kʰao	<i>noun</i><br><ol><li>whitlow</li></ol>
ခေတ်|khet	<i>noun</i><br><ol><li>extent, domain, region, field</li><li>age, period, era</li></ol>
ခေဝ်|kʰle	<i>verb</i><br><ol><li>to return, restore</li></ol>
ခေါ်|khok	<i>noun</i><br><ol><li>cup small cup cupful measure of capacity equal to one thirty-second of a basket န (na) two ကရှ်ေ (karh) or half a ကလတ် (kalat).</li></ol>
ခဲတန်|kʰoa tɔn	<i>noun</i><br><ol><li>lead pencil</li></ol>
ခံ|kham	<i>verb</i><br><ol><li>to bear up to catch in falling to catch hold of.</li></ol><br><i>noun</i><br><ol><li>small basket used for offerings to spirits.</li></ol>
ချက်ချေၚ်|chɛk cheaŋ	<i>noun</i><br><ol><li>immediately, at once</li></ol>
ချပ်|khyap	<i>noun</i><br><ol><li>panic millet.</li></ol><br><i>verb</i><br><ol><li>to consider, think over, make plans, plan to, decide to.</li></ol>
ချာံ|khyāṁ	<i>noun</i><br><ol><li>common cold, head cold</li></ol>
ချိုတ်|khyuit	<i>verb</i><br><ol><li>to be dead to be numb cold to run down to close in chess and other games to be out in cricket.</li></ol>
ချိၚ်|choiŋ	<i>noun</i><br><ol><li>plumbline</li></ol>
ချုက်|chɜk	<i>verb</i><br><ol><li>to enter into a contract</li><li>to confine, imprison</li></ol>
ချေဳၚ်မာဲ|chiiangmày	<i>name</i><br><ol><li>Chiang Mai.</li></ol>
ချေံ|cheh	<i>noun</i><br><ol><li>horse.</li></ol><br><i>verb</i><br><ol><li>be mischievous unrestrained be faithless wanton or disloyal to one’s spouse.</li></ol>
ချေၚ်|cheaŋ	<i>name</i><br><ol><li>Chin</li></ol>
ချဲ	<i>noun</i><br><ol><li>grass; weeds; hay</li></ol>
ချဳ|khyī	<i>verb</i><br><ol><li>to tremble, to shake</li><li>to move</li></ol>
ချဴ|chao	<i>verb</i><br><ol><li>to solder (on)</li></ol>
ချံၚ်|chɔŋ	<i>verb</i><br><ol><li>to spy (used in compound)</li></ol>
ခြာ|kʰra	<i>verb</i><br><ol><li>to be separated (by), to separate</li></ol>
ခြိၚ်|kʰraŋ	<i>verb</i><br><ol><li>to enclose, fence in</li></ol>
ခြုပ်|kʰrup	<i>verb</i><br><ol><li>to be distressed (used in compounds)</li></ol>
ခြး|kʰrah	<i>verb</i><br><ol><li>to scratch in the dust</li></ol>
ခၚ်|ခင်|khaṅ	<i>noun</i><br><ol><li>skein hank.</li></ol>
ခၜေံ|khaṗeʼ	<i>noun</i><br><ol><li>(Thailand) Alternative form of ဗၜေံ</li></ol>
ခၞာခၟာဲစာၚ်|khnākhmāycāṅ	<i>noun</i><br><ol><li>fried egg</li></ol>
ခၞိက်ထဝ်|khnikthaw	<i>noun</i><br><ol><li>fine gold dust.</li></ol>
ခၟာဲစာၚ်|khmāycāṅ	<i>noun</i><br><ol><li>a hen's egg, chicken egg.</li></ol>
ခၟာဲစာၚ်ၜိုဟ်|khmāycāṅṗiuh	<i>noun</i><br><ol><li>poached egg, boiled egg.</li></ol>
ခၠၚ်|kʰlɛŋ	<i>verb</i><br><ol><li>to pierce (used in compounds)</li></ol>
ဂ|ga	<i>character</i><br><ol><li>Ga, the third consonant of the Mon alphabet.</li></ol>
ဂကောံအက္ခရ်ဗွဟ်ရမျာင်	<i>name</i><br><ol><li>International Phonetic Alphabet.</li></ol>
ဂစိုတ်|gacət	<i>verb</i><br><ol><li>to kill</li><li>(Kaw Kyaik) to flavour, to season</li><li>(Pak Kret District) to insert steadily a wound end of tied string or bamboo stick</li><li>to wipe</li></ol><br><i>noun</i><br><ol><li>(linguistics) coda, final consonant</li><li>equivalent for Burmese အသတ် (a.sat) (်)</li><li>death</li></ol>
ဂစေပ်|gacep	<i>noun</i><br><ol><li>roselle (Hibiscus sabdariffa)</li></ol>
ဂစေအ်|gaceʼ	<i>noun</i><br><ol><li>talcum powder.</li></ol>
ဂစေံ|gacem	<i>noun</i><br><ol><li>bird</li></ol>
ဂဇံ|gaʒaʔ	<i>verb</i><br><ol><li>to sit</li></ol>
ဂတာ|gatā	<i>noun</i><br><ol><li>underpart, bottoms</li></ol>
ဂတာဝိက်|gatāwik	<i>noun</i><br><ol><li>immerse.</li></ol>
ဂတာံ|gatāṁ	<i>noun</i><br><ol><li>crab.</li></ol>
ဂတု|gatu	<i>noun</i><br><ol><li>moon</li><li>month</li></ol>
ဂတေက်|gatek	<i>noun</i><br><ol><li>mallet club hatchet.</li></ol>
ဂတဵုတၟံ|gatuiw tmaʼ	<i>noun</i><br><ol><li>slate (tablet used for writing)</li></ol>
ဂပ်|gap	<i>verb</i><br><ol><li>to suffice.</li></ol>
ဂမၠိုၚ်|gamləṅ	<i>noun</i><br><ol><li>quantity.</li><li>many</li><li>all, whole, entire</li></ol>
ဂယိုၚ်|gayiuṅ	<i>noun</i><br><ol><li>spouse.</li><li>weight responsibility.</li><li>life.</li></ol><br><i>verb</i><br><ol><li>to live maintain life.</li></ol>
ဂဝ်ရခါ|kòrəkʰa	<i>name</i><br><ol><li>Gurkha, Nepalese</li></ol>
ဂအုဲ|gaʼuy	<i>noun</i><br><ol><li>vegetable substance dried or otherwise prepared for medical or other use medicine tobacco drug; chemical.</li></ol>
ဂီု|gəṁ	<i>verb</i><br><ol><li>(to be) warm, lukewarm</li><li>(Kaw Kyaik) to be comfortable, to be happy</li><li>(Pak Kret District) to swell like a balloon</li></ol><br><i>noun</i><br><ol><li>lamp, lantern</li><li>(Pak Kret District) globe of a lamp</li><li>(Pak Kret District) lampshade</li><li>(Pak Kret District) fluorescent lamp</li><li>(Kaw Kyaik) balloon</li></ol>
ဂူ|gū	<i>noun</i><br><ol><li>market garden</li><li>a cultivated clearing</li></ol><br><i>verb</i><br><ol><li>to rain</li></ol>
ဂူၜဴ|ku:bao	<i>name</i><br><ol><li>(ကွာန်) Kyan Taw (a village in Kayin State, Myanmar)</li></ol><br><i>noun</i><br><ol><li>The cane forest.</li></ol>
ဂး|gaḥ	<i>verb</i><br><ol><li>to say</li><li>to speak</li><li>(Pak Kret District) to mean, to stand for</li></ol><br><i>conj</i><br><ol><li>(complementizer) that</li></ol>
ဂ္ၚေၚ်သံသာ|gṅeṅsaṃsā	<i>verb</i><br><ol><li>to pass through a succession of births.</li></ol>
ဂျပါန်|capạ̀n	<i>name</i><br><ol><li>Japan, Japanese</li></ol>
ဂျဗောဝ်|cəpò	<i>noun</i><br><ol><li>idle person, corner-boy</li></ol>
ဂျုၚ်|cɜ̀ŋ	<i>noun</i><br><ol><li>wheat</li></ol>
ဂျဳ|cì	<i>noun</i><br><ol><li>bar, stick (used in compounds)</li></ol>
ဂြိုပ်|gruip	<i>noun</i><br><ol><li>forest; jungle.</li></ol><br><i>adj</i><br><ol><li>wild (of animal).</li></ol>
ဂြိုဟ်|krɜ̀h	<i>noun</i><br><ol><li>liver</li><li>heart</li><li>central part</li><li>(astronomy) planet, planetary compartment</li></ol>
ဂြိုၚ်	<i>verb</i><br><ol><li>to laugh</li></ol>
ဂြဳ|grī	<i>noun</i><br><ol><li>(New modern) an assistant a monk of the second rank in the monastery.</li></ol>
ဂြၚ်|ဂြင်	<i>noun</i><br><ol><li>horn</li></ol>
ဂြၚ်စိၚ်|ဂြင်စိင်	<i>noun</i><br><ol><li>tusk of an elephant; ivory</li></ol>
ဂွိ	<i>noun</i><br><ol><li>soft-shell turtle.</li></ol>
ဂွဳ|gwī	<i>verb</i><br><ol><li>to wrap</li><li>to tie up in a bundle</li></ol><br><i>noun</i><br><ol><li>(Pak Kret District) parcel, package</li><li>(Pak Kret District) carton (for cigarettes)</li><li>(Pak Kret District) envelope</li></ol>
ဂှ်|gah	<i>det</i><br><ol><li>denoting something or someone perceived as being distant by the speaker; that</li><li>referent already known to the listener or mentioned by the speaker; it</li></ol><br><i>particle</i><br><ol><li>topic marker</li><li>used as intensifier</li></ol><br><i>pron</i><br><ol><li>particle making. [nn.] and nominal. [phr.] [esp.] in initial prominence position, and occasionally complete sents.</li><li>is occasionally deictic.</li></ol>
ဂၞဴ|gnau	<i>noun</i><br><ol><li>stomach bowels.</li><li>shell (of palm-tree)</li></ol>
ဂၞဴကွာ်|gnau kwāk	<i>verb</i><br><ol><li>to have diarrhoea</li></ol>
ဂၞဴပု|gnau pu	<i>verb</i><br><ol><li>loosening of the bowels.</li></ol>
ဂၞဴဗိုန်|gnau bən	<i>verb</i><br><ol><li>to be constipated</li></ol>
ဂၞဴလီု|gnau ləṁ	<i>verb</i><br><ol><li>to have diarrhoea {US diarrhea} suffer from stomach upset be indisposed suffer from diarrhea.</li></ol>
ဂၞဴအာ|gnau ʼā	<i>verb</i><br><ol><li>(Kaw Kyaik) to have normal motions of the bowels empty the bowels defecate have looses bowels.</li></ol>
ဂၠိုၚ်|gləṅ	<i>adj</i><br><ol><li>many, numerous</li><li>much</li></ol>
ဂၠိၚ်|gliṅ	<i>adj</i><br><ol><li>long</li></ol>
ဂၠုၚ်|gluṅ	<i>noun</i><br><ol><li>small boat, canoe.</li><li>(Kaw Kyaik) boat-shaped trough.</li></ol>
ဂၠေံ|gleʼ	<i>adj</i><br><ol><li>short</li></ol>
ဂၠဴ|glau|ဒၠဴ|dlau	<i>noun</i><br><ol><li>cattle (both ox and cow)</li><li>(Pak Kret District) plank for supporting another plank hammered to post in order to prevent its further subsidence</li></ol>
ဃ|gha	<i>character</i><br><ol><li>Gha, the fourth consonant of the Mon alphabet.</li></ol>
ဃံက်|kʰòk	<i>noun</i><br><ol><li>hook</li></ol>
ဃံၚ်|kʰòŋ	<i>noun</i><br><ol><li>headman</li></ol>
စ|ca	<i>character</i><br><ol><li>Ca, the sixth consonant of the Mon alphabet.</li></ol><br><i>verb</i><br><ol><li>to eat.</li><li>to live on, to live (by the revenues of something)</li><li>to divide (in arithmetic).</li><li>to take (in chess and other games)</li><li>{usually as va.} to begin, start {to}, do for the first time.</li><li>to eat, to live on, by, by the revenues of, govern, to devide {in arithmetic}, to take, in chess and other games, wear away, erode.</li><li>to begin; to start.</li><li>{usually as va.} to begin, start {to}, do for the first time, commence.</li></ol><br><i>adv</i><br><ol><li>particle denoting generic or habitual aspect.</li></ol>
စက္ကာန်	<i>noun</i><br><ol><li>second (of time).</li></ol>
စက္ခူ|cah.khao	<i>noun</i><br><ol><li>paper</li></ol>
စက္ခော	<i>noun</i><br><ol><li>paper.</li></ol>
စန်|can	<i>noun</i><br><ol><li>(astrology) moon</li><li>(တ္ၚဲ~) Monday</li></ol><br><i>verb</i><br><ol><li>to tie, to bind</li></ol>
စန်စာ|cɔn ca	<i>verb</i><br><ol><li>to deliberate, consider</li></ol>
စမ္ၚာ|camṅā	<i>noun</i><br><ol><li>champac tree (Magnolia champaca)</li><li>(Pak Kret District) natural or artificial flower</li></ol>
စရၚ်|kərɛŋ	<i>noun</i><br><ol><li>account, tabulation, list</li></ol>
စာင်|စါင်|စာၚ်|cāṅ	<i>noun</i><br><ol><li>chicken; fowl.</li></ol>
စာရေ|kəre	<i>noun</i><br><ol><li>clerk</li></ol>
စိန်|cin	<i>verb</i><br><ol><li>to be cooked, to boil, to be healed.</li></ol><br><i>noun</i><br><ol><li>arsenic</li></ol>
စိပ်|cip	<i>verb</i><br><ol><li>to be set close together, edge to edge</li></ol>
စိုတ်|cət	<i>noun</i><br><ol><li>mind, heart</li></ol>
စိုတ်ခိုဟ်|cət khəh	<i>verb</i><br><ol><li>to be good natured good nature.</li></ol>
စိုတ်လီု|cət ləṁ	<i>adj</i><br><ol><li>discouraged</li><li>sorry, regretful</li><li>absurd</li><li>stupid, foolish</li><li>(Pak Kret District) crazy, insane</li></ol><br><i>intj</i><br><ol><li>(Pak Kret District) excuse me, sorry</li></ol>
စိၚ်|ciṅ|စိင်	<i>noun</i><br><ol><li>elephant</li><li>ridgepole of house</li></ol><br><i>classifier</i><br><ol><li>(Pak Kret District) used for counting houses</li></ol>
စိၚ်ဂၞာတ်|ciṅ gnāt	<i>noun</i><br><ol><li>wild goat, antelope</li><li>serow</li></ol>
စုက်|cɜk	<i>noun</i><br><ol><li>paintbrush</li><li>tattooing iron</li></ol>
စုံ|cum	<i>verb</i><br><ol><li>to be complete</li><li>to be an even number</li></ol>
စူ|cu	<i>verb</i><br><ol><li>to pierce</li></ol>
စေက်|cɔik	<i>verb</i><br><ol><li>to advance a payment (used in compounds)</li></ol>
စေတဳ|cetɔe	<i>noun</i><br><ol><li>stupa, pagoda.</li></ol>
စေန်|cen	<i>verb</i><br><ol><li>to order (in succession) (used in compounds)</li></ol>
စေဝ်|ce	<i>noun</i><br><ol><li>barrel, cask, canister</li></ol>
စောန်|con	<i>verb</i><br><ol><li>to be mottled</li><li>to be envious, jealous</li></ol>
စေဲာ|coa	<i>verb</i><br><ol><li>to cleave (used in compounds)</li></ol>
စဲ|cay	<i>verb</i><br><ol><li>to dry spreading out in the sun</li></ol><br><i>noun</i><br><ol><li>louse</li><li>traditional month roughly equivalent to April</li></ol>
စဴ|cau	<i>verb</i><br><ol><li>(intransitive) to return go back come back to proceed to an arranged destination to go out to perform a prescribed observance.</li><li>(Pak Kret District, intransitive) to end, to finish</li><li>(Pak Kret District) to draw (of match)</li></ol><br><i>noun</i><br><ol><li>grandchild</li></ol>
စံ|cɔm	<i>verb</i><br><ol><li>to touch, feel, probe, sound, to try, assay</li><li>adverbial with imperatives, indicative of mild exhortation</li></ol>
စံပါ|caṁpā	<i>noun</i><br><ol><li>(Kaw Kyaik) champac tree (Magnolia champaca, syn. Michelia champaca)</li></ol>
စံၚ်	<i>noun</i><br><ol><li>harp.</li></ol><br><i>classifier</i><br><ol><li>used for books.</li></ol><br><i>verb</i><br><ol><li>to set fire; to burn; to cremate.</li><li>to roast; to bake.</li><li>to be burning.</li><li>to watch (used in compounds)</li></ol>
စးကောန်စဴ|caḥ kon cau	<i>noun</i><br><ol><li>progeny descendants.</li><li>behind grandchildren.</li></ol>
စွံ|cwaṃʼ	<i>noun</i><br><ol><li>part.</li></ol><br><i>verb</i><br><ol><li>to place put {down} leave refrain from removing to keep maintain to abandon to adopt {attitude}.</li><li>take off remove conduct away.</li></ol>
စှ်|coh|cɔh|စှော်	<i>num</i><br><ol><li>ten</li></ol>
စှ်ပန်	<i>num</i><br><ol><li>fourteen</li></ol>
စှ်ပိ	<i>num</i><br><ol><li>thirteen</li></ol>
စှ်မွဲ	<i>num</i><br><ol><li>eleven.</li></ol>
စှ်သုန်	<i>num</i><br><ol><li>fifteen</li></ol>
စှ်ၜါ	<i>num</i><br><ol><li>twelve</li></ol>
စၚ်|cɛŋ	<i>noun</i><br><ol><li>rack or bin with open top, framework, staging</li></ol>
စၠတ်ထဝ်|clat-thaw	<i>noun</i><br><ol><li>Parliament.</li></ol>
ဆ|cha	<i>character</i><br><ol><li>Cha, the seventh consonant of the Mon alphabet.</li></ol><br><i>verb</i><br><ol><li>to weigh in one’s hand, feel the weight of.</li></ol><br><i>adv</i><br><ol><li>only.</li></ol><br><i>pron</i><br><ol><li>whoever, whatever, as much as, {not} even.</li></ol><br><i>noun</i><br><ol><li>Malay chestnut, castanopsis javanica De Candolle.</li></ol>
ဆက်	<i>verb</i><br><ol><li>to join, connect</li><li>to associate (with)</li><li>to offer to [superior]</li></ol>
ဆက်ဆက်|chɛk chɛk	<i>noun</i><br><ol><li>certainly, truly</li></ol>
ဆန္ဒ|chan-da	<i>noun</i><br><ol><li>desire, wish</li><li>impulse, opinion</li></ol>
ဆပ်|chɔp	<i>noun</i><br><ol><li>panic millet</li></ol>
ဆာန်လာန်|chānlān	<i>verb</i><br><ol><li>to be cute</li><li>to be admirable, remarkable</li></ol>
ဆာပ်ပျာ|chappya	<i>noun</i><br><ol><li>soap</li></ol>
ဆိ|chi	<i>noun</i><br><ol><li>(vulgar) cunt, vulva; vagina</li><li>female reproductive organs or female animal.</li></ol>
ဆီ|chiṃ	<i>noun</i><br><ol><li>blood</li></ol>
ဆု	<i>noun</i><br><ol><li>tree.</li><li>log; wood; timber.</li></ol>
ဆေန်	<i>verb</i><br><ol><li>to descend (used in compounds)</li></ol>
ဆေဝ်	<i>verb</i><br><ol><li>to obstruct, hinder</li></ol>
ဆေၚ်|chɔiŋ	<i>noun</i><br><ol><li>shop</li><li>musical instrument consisting of set of graduated drums, suspended from circular frame and played by man sitting in centre, drum chime</li></ol><br><i>verb</i><br><ol><li>to have concern with, pertain to</li></ol>
ဆံ	<i>verb</i><br><ol><li>to associate (used in compounds)</li></ol>
ဆၚ်|ဆင်|chaṅ	<i>verb</i><br><ol><li>to descend, alight, {animals} to give birth, to drop, to jump down.</li></ol>
ဇ|ja	<i>character</i><br><ol><li>Ja, the eighth consonant of the Mon alphabet.</li></ol><br><i>noun</i><br><ol><li>great-grandfather.</li><li>cause, that which produces an effect, a thing, a person or event that makes a thing happen.</li></ol>
ဇကု|jaku	<i>noun</i><br><ol><li>person; self.</li><li>body.</li><li>polite term of address and reference-in-address between persons of equal status and some acquaintances, and to persons of lower age-status.</li></ol><br><i>classifier</i><br><ol><li>used with human beings.</li></ol>
ဇာဒိသိုၚ်|jādisiuṅ	<i>noun</i><br><ol><li>lion</li></ol>
ဇိပ်|jip	<i>noun</i><br><ol><li>measure of capacity equal to a quarter of a basket န (na) or four ကလတ် (kalat).</li></ol><br><i>verb</i><br><ol><li>expletive in မိပ်ဇိပ် (mipjip).</li></ol>
ဇိုၚ်|juiṅ	<i>noun</i><br><ol><li>foot</li><li>leg</li></ol>
ဇုတ်|ʒut	<i>noun</i><br><ol><li>bone</li></ol>
ဇေတ်	<i>verb</i><br><ol><li>to be genuine</li></ol>
ဇ္ၚဲ|jṅay	<i>adj</i><br><ol><li>far, distant</li></ol><br><i>noun</i><br><ol><li>(Pak Kret District) distant place, somewhere far away</li></ol>
ဇြုံ|jruṁ	<i>noun</i><br><ol><li>snake, serpent</li></ol>
ဇြုံဇာတ်|ဇြုံဇါတ်|jruṁ jāt	<i>noun</i><br><ol><li>cobra</li></ol>
ဇွိ|jwi	<i>noun</i><br><ol><li>left</li></ol>
ဇှေ်|jeh	<i>noun</i><br><ol><li>June.</li></ol>
ဇၞော်|jnok	<i>adj</i><br><ol><li>big, large, great</li></ol>
ည|ña	<i>character</i><br><ol><li>Ñnya, the tenth consonant of the Mon alphabet.</li></ol><br><i>noun</i><br><ol><li>expletive in ညိည.</li></ol>
ညာတ်|ñāt	<i>verb</i><br><ol><li>to see</li><li>to notice, to perceive</li><li>(Pak Kret District) to meet</li><li>(Pak Kret District) to seem</li><li>(Pak Kret District) to think, to regard</li></ol>
ညိၚ်|ñiṅ	<i>verb</i><br><ol><li>to be quiet, peaceful, composed, self-sufficient</li></ol>
ညဳ|ñī	<i>verb</i><br><ol><li>to be (on a) level, even, in agreement</li></ol>
ညး|ñaḥ	<i>pron</i><br><ol><li>person {who} people they others. {usually respectful} he, she they them.</li></ol>
ညးဖျဵုဂှ် ဒှ်ညးထေဲ	<i>proverb</i><br><ol><li>a hungry man is an angry man</li></ol>
ညးဗၞိက်|ñaḥbanik|ညးဗနိက်	<i>noun</i><br><ol><li>merchant</li></ol>
ဋ|ṭa	<i>character</i><br><ol><li>Ṭta, the eleventh consonant of the Mon alphabet.</li></ol>
ဌ|ṭha	<i>character</i><br><ol><li>Ṭtha, the twelfth consonant of the Mon alphabet.</li></ol>
ဍ|ḍa	<i>character</i><br><ol><li>Ḍda, the thirteen consonant of the Mon alphabet.</li></ol><br><i>noun</i><br><ol><li>distance spanned by the thumb and middle finger when extended.</li></ol>
ဍာပ်နာပ်|ḍāp nāp	<i>verb</i><br><ol><li>(Pak Kret District) to stain, to be stained, to be blotted</li><li>(Pak Kret District) to fade away</li><li>(Lopburi) to be blemished</li></ol>
ဍာ်|ḍaːk	<i>noun</i><br><ol><li>water</li></ol>
ဍာ်ကၠောံ	<i>noun</i><br><ol><li>ice.</li></ol>
ဍာ်ခြက်	<i>noun</i><br><ol><li>ice.</li></ol>
ဍာ်ဆၚ်	<i>noun</i><br><ol><li>waterfall.</li></ol>
ဍာ်တှ်	<i>noun</i><br><ol><li>milk.</li></ol>
ဍာ်တှ်သတ်ဗြဴ|daiktachsatprea	<i>noun</i><br><ol><li>coconut milk.</li></ol>
ဍာ်လက်ဖက်	<i>noun</i><br><ol><li>tea (beverage).</li></ol>
ဍာ်သာဲ|ḍāk sāy	<i>noun</i><br><ol><li>honey.</li></ol>
ဍိုၚ်	<i>noun</i><br><ol><li>umbrella.</li><li>tube.</li></ol><br><i>adj</i><br><ol><li>deaf.</li></ol>
ဍေန်|ḍen	<i>verb</i><br><ol><li>to light, to kindle, to be lit by, to cause to take fire</li><li>to memorize</li></ol>
ဍောတ်|ḍot	<i>adj</i><br><ol><li>small, little</li><li>young, infant</li><li>narrow</li><li>tight</li><li>thin</li><li>mean (in terms of social class)</li></ol>
ဎ|ḍha	<i>character</i><br><ol><li>Ḍdha, the fourteenth consonant of the Mon alphabet.</li></ol>
ဏ|ṇa	<i>character</i><br><ol><li>Ṇna, the fifteen consonant of the Mon alphabet.</li></ol>
ဏမ်|nom	<i>noun</i><br><ol><li>urine</li></ol>
ဏး|ṇá	<i>particle</i><br><ol><li>post positional maker suffixed to a verb to indicate optative mood equivalent in usage to ‘please let me’.</li></ol>
တ|ta	<i>character</i><br><ol><li>Ta, the sixteenth consonant of the Mon alphabet.</li></ol><br><i>noun</i><br><ol><li>father.</li></ol><br><i>verb</i><br><ol><li>to vomit.</li></ol>
တက်|tak	<i>verb</i><br><ol><li>to beat, to strike</li><li>to strike the time</li></ol><br><i>noun</i><br><ol><li>stroke</li></ol>
တခဳ|takhī	<i>noun</i><br><ol><li>clerk writer secretary.</li></ol>
တဆိပ်	<i>noun</i><br><ol><li>seal; stamp; trademark.</li></ol>
တတ်တတ်	<i>adj</i><br><ol><li>involuntary, unwitting</li></ol><br><i>adv</i><br><ol><li>(Pak Kret District, onomatopoeia) with a throbbing heart</li></ol>
တန်|tun|တုန်|tan	<i>noun</i><br><ol><li>class, standard, grade in school.</li><li>bamboo rat</li></ol><br><i>verb</i><br><ol><li>to be cheap.</li><li>to recur</li></ol><br><i>prep</i><br><ol><li>Marks change of subject of discourse.</li></ol>
တမ္ၚာ|təŋa	<i>noun</i><br><ol><li>fisherman</li></ol>
တရဴ	<i>num</i><br><ol><li>six</li></ol>
တာ|tā	<i>noun</i><br><ol><li>palmyra</li><li>toddy palm</li><li>measure of length equal to seven cubits or about 11 feet 4½ inches</li></ol><br><i>verb</i><br><ol><li>to hold up, signal to stop</li><li>to be considerate</li></ol>
တာန်|tān	<i>noun</i><br><ol><li>standard grade in school and in school examination system.</li><li>ton (unit of weight).</li></ol><br><i>verb</i><br><ol><li>to plait twill of bamboo cane or similar material.</li><li>to be worth.</li></ol>
တာဲ|tāy	<i>noun</i><br><ol><li>field hut used temporary dwelling during harvest or occupied semipermanently on a market garden temporary abode house which is not the ordinary family dwelling booth tent.</li></ol>
တိ|ti	<i>noun</i><br><ol><li>earth</li><li>soil</li></ol>
တိတ်|tit	<i>verb</i><br><ol><li>to go out</li></ol>
တိရစ္ဆာန်	<i>noun</i><br><ol><li>animal.</li></ol>
တိုက်|tiuk	<i>noun</i><br><ol><li>building of brick, stone, or cement</li><li>public building, hall, brick or stone building, any secure place, a depository</li><li>walking</li><li>high quality of crockery, porcelain, china, chinaware</li></ol><br><i>adv</i><br><ol><li>by land</li></ol><br><i>verb</i><br><ol><li>to play (musical instrument)</li><li>to beat</li><li>to strike (a drum or a gong)</li></ol>
တိုက်လဝဟ်|taklavch	<i>noun</i><br><ol><li>armoury</li></ol>
တီ|tiṁ	<i>verb</i><br><ol><li>to know, to be acquainted, to come, to know, learn, realize, or determine.</li></ol>
တု|tu	<i>noun</i><br><ol><li>snail slug.</li></ol>
တုဲ|tuy	<i>verb</i><br><ol><li>to be finished over to be ready to succeed to be accomplished.</li></ol>
တူ|tao	<i>name</i><br><ol><li>Libra (zodiacal sign)</li></ol><br><i>verb</i><br><ol><li>(intransitive) to burn</li></ol><br><i>adj</i><br><ol><li>hot; burning</li></ol>
တေက်|tek	<i>verb</i><br><ol><li>to charge, barge into</li></ol>
တောရော|toro	<i>verb</i><br><ol><li>to steer towards</li></ol>
တော်|tok	<i>noun</i><br><ol><li>drop</li></ol><br><i>verb</i><br><ol><li>to make calculation, to cast up accounts</li></ol>
တဲ|tay	<i>noun</i><br><ol><li>hand</li></ol>
တဳတိတ္ထိ|tītitthi	<i>name</i><br><ol><li>(historical) Burmese, Burmese people.</li></ol><br><i>noun</i><br><ol><li>non-religious person.</li></ol>
တဵု|tiuw	<i>noun</i><br><ol><li>wild mangosteen.</li></ol><br><i>verb</i><br><ol><li>advance improve progress.</li><li>to stand be stationary.</li><li>to sow plant set in the ground erect.</li></ol>
တံၚ်ဒဇဵု|တံၚ်ဂဇဵု|taṃṅdajeu|taṃṅgajeu	<i>noun</i><br><ol><li>a kind of fruit-bearing tree sometimes cultivated Baccaurca sapida and parviflora Mueller Arg.</li></ol>
တံၚ်သူ|tɔŋsu	<i>name</i><br><ol><li>Taungthu</li></ol>
တ္ၚဲ|tṅay	<i>noun</i><br><ol><li>(astronomy) sun</li><li>sunlight</li><li>day</li></ol>
တ္ၚဲခရေတ်သမာတ်	<i>phrase</i><br><ol><li>Christmas Day.</li></ol>
တ္ၚဲခရေတ်သမာတ်ကဵုတ္ၚဲသၞာံတၟိကဵုဂွံမိပ်ဇြိပ်အာညိအဴ|တ္ၚဲခရေတ်သမာတ်ကဵုတ္ၚဲသၞာံတၟိကဵုဂွံမိပ်ဇြိပ်အာညိအဴ။	<i>phrase</i><br><ol><li>Merry Christmas and a Happy New Year!</li></ol>
တြုံ|truĥ	<i>noun</i><br><ol><li>man male husband affix denoting the male gender chiefly as final element in (n) (phr.) denoting sex of peson.</li><li>husband</li></ol>
တွာဲ	<i>verb</i><br><ol><li>to give, offer (to royalty, clergy, or deities)</li></ol>
တှ်|tah	<i>noun</i><br><ol><li>breast; udder.</li><li>milk</li></ol>
တၚ်|taṅ	<i>verb</i><br><ol><li>to be left undamaged</li></ol>
တၚ်လာဲ|taṅlāy	<i>noun</i><br><ol><li>molasses treacle coarse melted sugar syrup.</li></ol>
တၞံကြုက်|tanamksk	<i>name</i><br><ol><li>(ကွာန်) Nam Krerk (a village in Nong Lu Subdistrict, Thailand).</li></ol><br><i>noun</i><br><ol><li>mango tree.</li></ol>
တၞံသၞီ|tnaṁ sniṁ	<i>noun</i><br><ol><li>neem, nim, margosa (Azadirachta indica)</li></ol>
တၞး	<i>noun</i><br><ol><li>leaf.</li><li>thin sheet.</li><li>palm (of hand).</li></ol>
တၞးထဝ်|tnaḥthaw	<i>noun</i><br><ol><li>(Myanmar) gold leaf.</li></ol>
တၟိ|tmi|တမိ|tami	<i>adj</i><br><ol><li>new.</li></ol>
တၟုဲ|tmuy	<i>adj</i><br><ol><li>ready.</li></ol><br><i>noun</i><br><ol><li>guest</li><li>visitor</li><li>stranger</li></ol>
တၟံ|tmaʼ	<i>noun</i><br><ol><li>stone, rock</li><li>mountain</li><li>(Kaw Kyaik) totality</li></ol><br><i>verb</i><br><ol><li>aim at hope for intend be meant for.</li></ol><br><i>adj</i><br><ol><li>all, every</li></ol><br><i>particle</i><br><ol><li>(applied only to human being) every</li></ol>
တၟံဂစး|tmaʼ hacaḥ|tmaʼ gacaḥ|တၟံဟစး|တၟအ်ဂစး	<i>noun</i><br><ol><li>alum</li></ol>
တၠ	<i>pron</i><br><ol><li>you (referring to higher class)</li></ol><br><i>noun</i><br><ol><li>lord; master</li><li>owner; possessor</li></ol>
ထ|tha	<i>character</i><br><ol><li>Tha, the seventeenth consonant of the Mon alphabet.</li></ol><br><i>noun</i><br><ol><li>kind, pattern, verbal affix.</li></ol>
ထပ်|thap	<i>verb</i><br><ol><li>to superimpose, add</li></ol>
ထပှ်	<i>num</i><br><ol><li>seven</li></ol>
ထဝ်|thaw	<i>noun</i><br><ol><li>gold.</li></ol>
ထဝ်တၞး|thawtnaḥ	<i>noun</i><br><ol><li>(Thailand) gold leaf.</li></ol>
ထဝ်ဗာတ်|thawbāt	<i>noun</i><br><ol><li>butter</li><li>other oily ingredient</li></ol>
ထာမ္မဏေဝ်|tʰamməne	<i>noun</i><br><ol><li>seasonal delicacy made of glutinous rice, groundnuts, onion, sesame, and coconut with oil, eaten at harvest festival</li></ol>
ထိ	<i>verb</i><br><ol><li>to be complete</li></ol>
ထိက်|tʰoik	<i>noun</i><br><ol><li>stocks</li></ol>
ထိၚ်|thiṅ	<i>verb</i><br><ol><li>to keep watch over</li></ol>
ထု|thu	<i>verb</i><br><ol><li>to tap to beat.</li></ol>
ထုပ်|thup	<i>verb</i><br><ol><li>to wrap up, envelop</li></ol>
ထေရဝါဒ|təərawaidɛ̀	<i>name</i><br><ol><li>(Buddhism) Theravada</li></ol>
ထေၚ်|theṅ	<i>verb</i><br><ol><li>to think, believe, expect, hope</li><li>to be clear, distinct, visible</li></ol>
ထဲ|thai	<i>verb</i><br><ol><li>to throw, skim</li></ol>
ထဲု|thaiu	<i>verb</i><br><ol><li>to be tangled, confused, chaotic</li><li>to behave indecorously, in a disorderly manner</li><li>to mix, associate (with)</li></ol>
ထံက်|thaṃk	<i>verb</i><br><ol><li>to prop, underpin</li><li>2verb to support, assist</li></ol>
ထံက်ကလဵု|thåk kaləw	<i>verb</i><br><ol><li>to kneel</li></ol>
ထံက်က္ၜံင်|ထံက် က္ၜံင်|thåk kḅåṅ	<i>verb</i><br><ol><li>(Kaw Kyaik) to kneel</li></ol>
ထံက်အလဵု|thåk ʼalhəw	<i>phrase</i><br><ol><li>Where do you point?</li></ol>
ထံၚ်|tʰɔŋ	<i>noun</i><br><ol><li>jail</li></ol><br><i>verb</i><br><ol><li>to set upright</li></ol>
ထး|thaḥ	<i>noun</i><br><ol><li>brass tray salver on which curry bowls are sometimes laid out.</li></ol>
ထၟ|thma|kma|ကၟ	<i>noun</i><br><ol><li>insect</li></ol>
ဒ|da	<i>character</i><br><ol><li>Da, the eighteen consonant of the Mon alphabet.</li></ol><br><i>noun</i><br><ol><li>verbal affix, affirmative.</li></ol>
ဒကာ	<i>noun</i><br><ol><li>(honorific) term of address used by monks to laymen</li></ol>
ဒဂိုန်|dagaen	<i>noun</i><br><ol><li>July.</li></ol>
ဒစိတ်	<i>num</i><br><ol><li>nine</li></ol>
ဒတံ	<i>num</i><br><ol><li>eight</li></ol>
ဒဒန်	<i>noun</i><br><ol><li>bridge (structure).</li><li>jetty.</li><li>wharf built on piles over water.</li></ol>
ဒမှော်	<i>noun</i><br><ol><li>wide hat</li></ol>
ဒလန်|delun	<i>noun</i><br><ol><li>pomegranate</li></ol>
ဒအာပ်	<i>verb</i><br><ol><li>to yawn</li></ol>
ဒအိုအ်	<i>verb</i><br><ol><li>to belch</li></ol>
ဒိုဟ်ဨသာန်|diuh esān	<i>noun</i><br><ol><li>northeast</li></ol>
ဒုတိယ	<i>adj</i><br><ol><li>second</li><li>deputy, assistant, vice-</li></ol>
ဒုန်|dun	<i>noun</i><br><ol><li>bamboo</li><li>(Pak Kret District) bamboo pole</li><li>(Pak Kret District) butter knife</li></ol><br><i>verb</i><br><ol><li>to paddle</li></ol>
ဒုၚ်	<i>verb</i><br><ol><li>to receive; to accept.</li><li>to meet; to welcome.</li><li>to bear; to suffer; to endure.</li></ol>
ဒူရေန်|dūren	<i>noun</i><br><ol><li>durian (fruit)</li></ol>
ဒဳ|dī|tì	<i>noun</i><br><ol><li>thigh</li><li>(Pak Kret District, derived from 1.) whole leg</li><li>that, there (accompanying physical indication of object)</li></ol><br><i>verb</i><br><ol><li>(Pak Kret District) to drive to graze (cattle, etc.)</li></ol>
ဒဵု|duiw	<i>noun</i><br><ol><li>mountain</li></ol>
ဒး|daḥ	<i>noun</i><br><ol><li>correct.</li></ol><br><i>verb</i><br><ol><li>to hit</li><li>to come in contact with</li><li>to touch</li><li>to meet, to encounter</li><li>(to be) correct, (to be) apposite, (to be) right</li><li>to coincide with law(s)</li><li>to reach (goal)</li><li>to fit, to be fitting</li><li>to fall in (with one another)</li><li>(intransitive) to bump</li><li>to be exposed to (wind, rain, high temperature, etc.)</li><li>to undergo (unpleasant experience such as illness), to suffer</li><li>(auxiliary verb, adversative) to get</li><li>to hurt oneself unintentionally</li><li>to get into (trap)</li><li>to violate, to break (an oath)</li><li>(to be) cheap</li><li>to hurt mentally</li><li>(auxiliary verb) placed before full verb for implying necessity; must, should</li><li>(auxiliary verb, passive) to be</li><li>(auxiliary verb) used for denoting certainty; must</li></ol>
ဒးချာံ|daḥ khyāṁ	<i>noun</i><br><ol><li>catarrh.</li></ol><br><i>verb</i><br><ol><li>to catch cold have a cold.</li></ol>
ဒးစိုတ်|daḥ cət	<i>verb</i><br><ol><li>to like</li><li>(Pak Kret District) to do something easily, often</li></ol>
ဒးဒုဟ်|daḥ duh	<i>verb</i><br><ol><li>to be punished</li></ol>
ဒးရး|daḥ raḥ	<i>adj</i><br><ol><li>appropriate, right</li><li>eminently suitable</li><li>orderly</li></ol>
ဒျောဒျာ	<i>name</i><br><ol><li>Ayutthaya Kingdom (before Siam).</li><li>Siam.</li></ol>
ဒြပ်	<i>noun</i><br><ol><li>property, wealth</li></ol>
ဒြုန်|drun	<i>noun</i><br><ol><li>white ant</li><li>termite</li><li>small red wood-ant</li></ol>
ဒွက်|dwak	<i>noun</i><br><ol><li>music</li><li>song</li><li>(Pak Kret District) ring for binding neck and hands of a corpse</li><li>(Pak Kret District) trap made of rope</li></ol>
ဒၞေၚ်	<i>noun</i><br><ol><li>forehead</li><li>brow</li></ol>
ဓ|dha	<i>character</i><br><ol><li>Dha, the nineteenth consonant of the Mon alphabet.</li></ol>
ဓဂဵု	<i>noun</i><br><ol><li>thunder</li></ol>
ဓဇဲ|həcòa	<i>noun</i><br><ol><li>carpenter</li></ol>
ဓုပ်|tʰùp	<i>noun</i><br><ol><li>bundle, especially one of herbs etc. used as fomentation</li></ol>
န|na	<i>character</i><br><ol><li>Na, the twentieth consonant of the Mon alphabet.</li></ol><br><i>noun</i><br><ol><li>rice-basket, bushel.</li><li>basket, rice basket, basket as measure of capacity, bushel, measure equal to about a bushel.</li></ol>
နက်|nɛ̀ak	<i>noun</i><br><ol><li>weapon (used in compounds)</li></ol>
နင်|naṅ	<i>verb</i><br><ol><li>bring.</li></ol>
နန်|nòn	<i>noun</i><br><ol><li>palace</li></ol>
နမောတဿ ဘဂဝတော အရဟတော သမ္မာသမ္ဗုဒ္ဓဿ	<i>phrase</i><br><ol><li>Buddhism</li></ol>
နရက်|nae rekt	<i>noun</i><br><ol><li>hell</li></ol>
နာဲ|nāy	<i>noun</i><br><ol><li>(honorific) referring to a male person senior to the speaker; Mr.</li><li>master</li><li>superior</li><li>chief</li></ol><br><i>pron</i><br><ol><li>used by senior monks toward junior</li><li>(Pak Kret District) toward men who has once been a Buddhist monk</li></ol>
နာ်|nāk	<i>noun</i><br><ol><li>dragon serpent mythical serpent possessing superhuman powers Naga.</li></ol>
နူကနေံတေံ|nū taneʼ teʼ	<i>adv</i><br><ol><li>yesterday</li></ol>
နဳပသဳ|nìpəsɔe	<i>noun</i><br><ol><li>small trees from roots of which red and yellow dyes are obtained (Morinda citrifolia, Tinctoria roxburgh)</li></ol>
နွံ|nwaṁ	<i>verb</i><br><ol><li>to be, to exist</li><li>to have</li></ol>
နွံယၟု|nwaṁ ymu	<i>verb</i><br><ol><li>to be famous</li></ol>
ပ|pa	<i>character</i><br><ol><li>Pa, the twenty-first consonant of the Mon alphabet.</li></ol><br><i>pron</i><br><ol><li>(colloq) do not, prohibitory particle.</li></ol><br><i>conj</i><br><ol><li>because.</li></ol><br><i>adv</i><br><ol><li>why.</li></ol>
ပက်	<i>verb</i><br><ol><li>to splash.</li><li>to be splashed.</li></ol>
ပဆာန်|pəchan	<i>noun</i><br><ol><li>money, cash</li></ol>
ပညာ|pɔnɲa	<i>noun</i><br><ol><li>wisdom, knowledge, learning</li></ol>
ပထမ	<i>adj</i><br><ol><li>first</li></ol>
ပထောၚ်သအိက်|pathoṅsaik	<i>noun</i><br><ol><li>anus.</li></ol>
ပန်	<i>num</i><br><ol><li>four.</li></ol><br><i>verb</i><br><ol><li>to shoot.</li></ol>
ပပ်|pap	<i>verb</i><br><ol><li>to be dirty, uncleanly</li></ol>
ပယျေန်|pəyen	<i>noun</i><br><ol><li>amber</li></ol>
ပရိယာယ်|pa ri yāy	<i>noun</i><br><ol><li>indirect reference, synonym.</li></ol>
ပရှူ|pəʃu	<i>name</i><br><ol><li>Malay</li></ol>
ပလိက်|pəloik	<i>noun</i><br><ol><li>police</li></ol>
ပလဳ|palī	<i>verb</i><br><ol><li>to be deceitful, insincere, to feign</li></ol>
ပလၚ်|pəlɛŋ	<i>noun</i><br><ol><li>bottle</li></ol>
ပဝါ|pavā	<i>noun</i><br><ol><li>Name of a certain festival pavāraṇā is the name given to the festival held at the termination of the Buddhist vassa.</li></ol><br><i>verb</i><br><ol><li>to tether.</li></ol>
ပဝ်|paw	<i>verb</i><br><ol><li>to fly</li></ol>
ပသာ်|pasike	<i>noun</i><br><ol><li>May.</li></ol>
ပါ|pā	<i>noun</i><br><ol><li>ring dove</li></ol><br><i>verb</i><br><ol><li>to entangle</li><li>to accompany, to come with, to go with</li></ol>
ပါတ္တာ|patta	<i>noun</i><br><ol><li>hinge</li></ol>
ပါန်|pan	<i>noun</i><br><ol><li>arts (used in compounds)</li></ol>
ပါပါ|pāpā	<i>noun</i><br><ol><li>(informal) dad; papa.</li><li>The sound of a baby calling its Father.</li></ol>
ပါၚ်|pāṅ	<i>noun</i><br><ol><li>mouth</li><li>opening</li><li>(Pak Kret District) lip</li><li>(Pak Kret District) rim</li></ol><br><i>classifier</i><br><ol><li>used for word or speech</li><li>(Pak Kret District) mouthful of, morsel of, bit of</li></ol>
ပိ|pi	<i>num</i><br><ol><li>three</li></ol>
ပိက်|poik	<i>noun</i><br><ol><li>cotton cloth</li></ol>
ပိက်ထကာ|poiktəka	<i>noun</i><br><ol><li>master carpenter, housebuilder</li></ol>
ပိုဲ|puij	<i>pron</i><br><ol><li>we</li><li>our</li></ol>
ပိုၚ်|piuṅ	<i>verb</i><br><ol><li>to own, have authority over</li></ol>
ပု|pu	<i>verb</i><br><ol><li>to swell</li><li>(Pak Kret District, of noodles) to be swollen after time passed</li><li>(of fruits like mango, tamarind, etc.) to be ripe seemingly</li><li>to suffer diarrhoea</li></ol>
ပုက်|pɜk	<i>noun</i><br><ol><li>basket with square base</li><li>small bucket-shaped basket of palmyra leaf</li></ol>
ပုင်သင်္ကြာန်	<i>noun</i><br><ol><li>khao chae; Thingyan rice.</li></ol>
ပုံ|pɔm	<i>noun</i><br><ol><li>story</li></ol>
ပုၚ်|puṅ	<i>noun</i><br><ol><li>cooked rice</li></ol><br><i>adj</i><br><ol><li>right (opposite of left)</li></ol>
ပုၚ်ဍာ်	<i>noun</i><br><ol><li>khao chae; Thingyan rice.</li></ol>
ပူ|pū	<i>noun</i><br><ol><li>dove</li></ol><br><i>verb</i><br><ol><li>to bind cord or cloth round</li></ol>
ပေ|pe	<i>noun</i><br><ol><li>foot measure, foot rule</li></ol>
ပေဝ်|pev	<i>verb</i><br><ol><li>to be dirty, unpleasant</li></ol>
ပေါန်|pon	<i>verb</i><br><ol><li>to be worn down, away</li></ol>
ပေဲါ|poa	<i>noun</i><br><ol><li>religious festival, dramatic entertainment (esp. given at such festivals, pwè, feast, entertainment, contest, race)</li></ol>
ပေဲါဇာ|poa cɛ̀a	<i>noun</i><br><ol><li>broker</li></ol>
ပေၚ်|peṅ|peŋ	<i>adj</i><br><ol><li>full</li></ol><br><i>verb</i><br><ol><li>to fill</li></ol><br><i>prep</i><br><ol><li>(Pak Kret District) filled to the brim in</li></ol>
ပဲါ|paiā	<i>verb</i><br><ol><li>to reject, to set aside, leave vacant, avoid, remove from</li></ol>
ပဵု|paဵu	<i>verb</i><br><ol><li>to exceed requirements</li></ol>
ပံင်	<i>name</i><br><ol><li>Paung (in Myanmar)</li></ol>
ပံၚ်|paṃṅ|pɔŋ	<i>noun</i><br><ol><li>arch</li><li>vaulted shelter of matting on sampan or other boat</li></ol><br><i>verb</i><br><ol><li>to add to, add together</li><li>[to [associate]], have dealings (with)</li><li>to mortgage, pledge, pawn</li></ol>
ပံၚ်မဳ|pɔŋmɔe	<i>noun</i><br><ol><li>trousers</li></ol>
ပးဒၞက်|pāh dnak	<i>noun</i><br><ol><li>a fowler’s snare.</li></ol>
ပ္ကဴ	<i>noun</i><br><ol><li>flower.</li></ol>
ပ္ညပ်|pñap	<i>noun</i><br><ol><li>name, term, designation, something which is an appellation only.</li></ol><br><i>verb</i><br><ol><li>to name, to designate, to prescribe, to promulgate, to command, to ordain,</li><li>to forbid, to prohibit</li></ol>
ပ္ညဳ|pñī|even	<i>verb</i><br><ol><li>to make even, to make level</li></ol>
ပ္ညဳပ္ညပ်|pñīpñap	<i>verb</i><br><ol><li>to appoint, to negotiate.</li><li>to consult with a view to union of sentiment to negotiate.</li></ol>
ပ္ဍုၚ်|pḍuṅ|ပ္ဍုင်|ပဍုင်|ပဍုၚ်	<i>verb</i><br><ol><li>to be salty.</li></ol>
ပ္ဍဲ|pḍay	<i>prep</i><br><ol><li>denoting location; in, at</li><li>denoting time; in, at</li><li>(Pak Kret District) against</li><li>(Pak Kret District) joining adjective or verb to clause</li></ol><br><i>noun</i><br><ol><li>interior, inside</li></ol>
ပ္တေၚ်	<i>noun</i><br><ol><li>ashes</li></ol>
ပျာတာ|pyata	<i>noun</i><br><ol><li>office messenger, peon</li></ol>
ပျေက်|pyek	<i>verb</i><br><ol><li>to clown, play the buffoon</li></ol>
ပျောန်|pyon	<i>noun</i><br><ol><li>tap</li></ol>
ပျၚ်|pəyɛŋ	<i>noun</i><br><ol><li>(Buddhism) one who has received the upasampada ordination, monk esp. below grade of mahāthera</li></ol>
ပြင်သေတ်|parencac	<i>name</i><br><ol><li>France, French</li></ol>
ပြာကတ်|prākot	<i>verb</i><br><ol><li>to reveal; to appear.</li></ol>
ပြိုၚ်|priuṅ	<i>verb</i><br><ol><li>to contend, compete</li></ol>
ပြု|pru	<i>verb</i><br><ol><li>to prepare (used in compounds)</li></ol>
ပြေ|pre	<i>verb</i><br><ol><li>to be smooth</li><li>to be appeased</li></ol>
ပြဵု	<i>verb</i><br><ol><li>to crumble, moulder, away</li></ol>
ပြံက်|praṃk	<i>verb</i><br><ol><li>to be speckled, variegated</li></ol>
ပြံၚ်|praṃṅ	<i>verb</i><br><ol><li>to move, change position</li></ol>
ပွေကိုၚ်|kəwe kaŋ	<i>noun</i><br><ol><li>senna</li></ol>
ပှော်|pawh	<i>noun</i><br><ol><li>January.</li><li>chevrotain {a species of deer} mouse deer Tragulidea.</li></ol><br><i>verb</i><br><ol><li>to fillip to propel with a pellet-bow.</li></ol>
ပၞဟ်|pnah	<i>noun</i><br><ol><li>jackfruit</li></ol>
ပၞါန်	<i>noun</i><br><ol><li>army; armed forces</li><li>war</li></ol>
ပၞဴ|pnau	<i>noun</i><br><ol><li>lime (fruit)</li></ol>
ပၠန်|plan	<i>adv</i><br><ol><li>again</li></ol><br><i>verb</i><br><ol><li>(rare) to repeat, to do again, to turn around</li></ol>
ပၠိုတ်|pliut	<i>verb</i><br><ol><li>to be extinguished eliminated to set.</li></ol>
ပၠံၚ်|plɔŋ	<i>noun</i><br><ol><li>millet (used in compounds)</li></ol>
ဖ|pha	<i>character</i><br><ol><li>Pha, the twenty-second consonant of the Mon alphabet.</li></ol>
ဖန်|phan	<i>verb</i><br><ol><li>to arrange, set in order</li></ol>
ဖရာပ်	<i>noun</i><br><ol><li>pigeon</li></ol>
ဖဝ်ရဂိုဏ်|phawragain	<i>noun</i><br><ol><li>March.</li></ol>
ဖအိုအ်	<i>noun</i><br><ol><li>rafter</li></ol>
ဖာ|pha	<i>noun</i><br><ol><li>very, great, long</li></ol>
ဖာန်|pʰan	<i>noun</i><br><ol><li>drinking glass</li></ol>
ဖာဲ|phāy	<i>verb</i><br><ol><li>to separate, to part, to pull apart, to pull aside, to set aside</li><li>to be divided.</li></ol>
ဖိက်|phik	<i>verb</i><br><ol><li>to invite</li></ol>
ဖုန်|phun	<i>noun</i><br><ol><li>mattress</li></ol>
ဖေက်	<i>verb</i><br><ol><li>to fear</li></ol>
ဖေဝ်|pʰe	<i>noun</i><br><ol><li>playing cards</li></ol>
ဖေံ	<i>noun</i><br><ol><li>otter</li></ol>
ဖဲ	<i>adj</i><br><ol><li>full; sated</li></ol>
ဖဲာ|phāy	<i>verb</i><br><ol><li>Encoding in Unicode standard for modern Burmese of ဖာဲ</li></ol>
ဖဴ|pʰao	<i>noun</i><br><ol><li>raised wooden trough filled with earth or sand on which cooking-fire is lit, hearth, furnace</li><li>kitchen</li></ol>
ဖျေံစိုတ်|phyeĥ cət	<i>verb</i><br><ol><li>to make up one's mind, to determine</li></ol>
ဗ|ba	<i>character</i><br><ol><li>Ba, the twenty third consonant of the Mon alphabet.</li></ol><br><i>verb</i><br><ol><li>to have one’s breathing-passages congested or obstructed, to chock.</li></ol>
ဗဂဲ	<i>noun</i><br><ol><li>cat.</li><li>cat's eye (gemstone).</li></ol>
ဗညာ|pəɲɛ̀a	<i>noun</i><br><ol><li>(honorific) title prefixed to names of royalty and nobility.</li></ol>
ဗတာဲ|batat	<i>noun</i><br><ol><li>hare; rabbit</li></ol>
ဗတဳ|batī	<i>noun</i><br><ol><li>see ဗ္တဳ (btī)</li></ol>
ဗန္ဒာ|pàntɛ̀a	<i>noun</i><br><ol><li>finance (used in compounds)</li></ol>
ဗဗိုန်|həpɜ̀n	<i>noun</i><br><ol><li>small drum with shallow body, of type used in chɔiŋ</li></ol>
ဗမတ်|ပၟတ်	<i>noun</i><br><ol><li>fire</li><li>lamp</li><li>light</li></ol>
ဗမာ|bamā	<i>name</i><br><ol><li>(Myanmar, Thailand) Burma; Myanmar; Burman; Burmese (country, person or language)</li></ol>
ဗလံက်|pəlòk	<i>noun</i><br><ol><li>piece of artillery, cannon, gun</li></ol>
ဗဝ်ဂဳ|pò kì	<i>noun</i><br><ol><li>close haircut, crew cut</li></ol>
ဗာဂျာ|pàcà	<i>noun</i><br><ol><li>mouth organ</li></ol>
ဗာၚ်သ္ကုက်|pàiŋsəkɜk	<i>noun</i><br><ol><li>cinema (show)</li></ol>
ဗာၚ်သ္ကေဝ်|pàiŋsəke	<i>noun</i><br><ol><li>bicycle</li></ol>
ဗီုတိ	<i>noun</i><br><ol><li>map</li></ol>
ဗု|bu	<i>adj</i><br><ol><li>white</li></ol>
ဗုဒ္ဓ|pùtthɛ̀ʔ	<i>noun</i><br><ol><li>Buddha</li></ol>
ဗုဒ္ဓဘာသာ	<i>noun</i><br><ol><li>Buddhism</li></ol>
ဗုဒ္ဓဝါ|buddhawā	<i>noun</i><br><ol><li>(astronomy) (ဂြိုဟ်~) Mercury</li><li>(တ္ၚဲ~) Wednesday</li></ol>
ဗုဒ္ဓသာသနာ|budhasāsanā	<i>noun</i><br><ol><li>(Buddhism) teachings of Buddha; Buddhist teachings</li></ol>
ဗေဒၚ်|pètɛ̀aŋ	<i>noun</i><br><ol><li>Vedic lore</li><li>astrology</li></ol>
ဗဳ|bī	<i>noun</i><br><ol><li>small bottle</li><li>(Pak Kret District) flowerpot</li><li>(Pak Kret District) vase</li><li>(Pak Kret District) wide-mouthed vessel</li><li>bael fruit tree, bel, Bengal quince (Aegle marmelos)</li><li>(Pak Kret District) money</li></ol>
ဗဳဒဵု|pìtɜ̀	<i>noun</i><br><ol><li>cupboard, almirah</li></ol>
ဗဳလာတ်|pìlàt	<i>name</i><br><ol><li>England, Great Britain</li></ol>
ဗ္တဳ|btī	<i>noun</i><br><ol><li>sand</li></ol>
ဗ္တံ|btaṁ|hataṁ|ဟတံ	<i>noun</i><br><ol><li>night</li></ol>
ဗ္ၜေံ|bṗeʼ	<i>noun</i><br><ol><li>(Myanmar) goat.</li></ol>
ဗျဉ်|ဗျန်	<i>noun</i><br><ol><li>consonant</li></ol>
ဗျု|byu	<i>verb</i><br><ol><li>(to be) old (in terms of age), (to be) aged</li><li>to be decrepit, to de dilapidated</li></ol>
ဗြာတ်|brāt	<i>noun</i><br><ol><li>banana</li><li>plantain</li></ol>
ဗြု|bru	<i>verb</i><br><ol><li>to make a noise, to make a sound</li><li>(Thailand (Lopburi etc.)) to say, to utter</li><li>(Pak Kret District, of birds etc.) to cry</li></ol>
ဗြေန်ဂျေဝ်|prèncè	<i>name</i><br><ol><li>Roman Catholic</li></ol>
ဗြဲ|braj	<i>noun</i><br><ol><li>rain.</li></ol>
ဗြဲဂူ|bray gū	<i>verb</i><br><ol><li>to rain; it rains.</li></ol>
ဗြဲဝၚ်|bray waṅ	<i>verb</i><br><ol><li>(Pak Kret District) to be droughty</li></ol><br><i>noun</i><br><ol><li>(Lopburi) drought</li></ol>
ဗြဴ|brau	<i>noun</i><br><ol><li>woman wife.</li><li>wife</li></ol>
ဗြဴဗတိ|braubati	<i>noun</i><br><ol><li>(astronomy) (ဂြိုဟ်~) Jupiter</li><li>(တ္ၚဲ~) Thursday</li></ol>
ဗြဴမိန်|braomin	<i>noun</i><br><ol><li>(Buddhism) female renunciant living under modified monastic rules, but not acknowledged as a member of the Sangha</li></ol>
ဗှေ်|beh	<i>noun</i><br><ol><li>non-standard encoding of ဗှ်ေ (“you”)</li></ol>
ဗှ်ေ|beh	<i>pron</i><br><ol><li>you, thou (second-person singular)</li><li>you (second-person plural, toward inferior or children)</li></ol>
ဗၚ်ဂလဳ|pɛ̀aŋkəlì	<i>name</i><br><ol><li>Bengali</li></ol>
ဗၜေအ်|baṗeʼ	<i>noun</i><br><ol><li>(Thailand) Alternative form of ဗၜေံ</li></ol>
ဗၜေံ|baṗeʼ	<i>noun</i><br><ol><li>(Thailand) goat.</li></ol>
ဗၜဵု	<i>noun</i><br><ol><li>wild cat.</li><li>fishing cat, Prionailurus viverrinus.</li></ol>
ဗၞိက်|banik|ဗနိက်|bnik	<i>noun</i><br><ol><li>goods; merchandise</li><li>trade</li><li>axis centre.</li></ol>
ဗၞိဟ်|banih	<i>noun</i><br><ol><li>axis, centre</li></ol>
ဗၟာ|bmā	<i>name</i><br><ol><li>(Myanmar) Burma; Myanmar; Burman; Burmese (country, person or language)</li></ol>
ဘ|bha	<i>character</i><br><ol><li>Bha, the twenty-fourth consonant of the Mon alphabet.</li></ol><br><i>verb</i><br><ol><li>to frighten, to scare.</li><li>to frighten, {perform actions calculated to} scare, to make afraid.</li></ol>
ဘတ်|bhod	<i>noun</i><br><ol><li>September</li></ol>
ဘဝ|həwɛ̀ʔ	<i>noun</i><br><ol><li>State of existence, incarnation, stage of life</li></ol>
ဘာ|phɛ̀a	<i>noun</i><br><ol><li>monastery</li><li>school</li><li>funeral pavilion</li></ol>
ဘာသာ|bhāsā	<i>noun</i><br><ol><li>language</li><li>system of religion</li></ol>
ဘာသာမန်|bhāsā Man	<i>noun</i><br><ol><li>Mon language</li></ol>
ဘိန်|bhin	<i>noun</i><br><ol><li>opium poppy</li><li>opium</li><li>heroin</li></ol>
ဘိုအ်|bhiua	<i>particle</i><br><ol><li>for</li></ol>
ဘိၚ်|bhiṅ	<i>noun</i><br><ol><li>opium</li></ol>
ဘဲ|phòa	<i>noun</i><br><ol><li>calamity</li></ol>
မ|ma	<i>character</i><br><ol><li>Burmese, ma, MA</li></ol><br><i>noun</i><br><ol><li>(chiefly formal) father (chiefly in formal contexts)</li><li>seed, kernel, pill, small particle, small round object, quantifier for fruit, clocks.</li></ol><br><i>verb</i><br><ol><li>to bear up, support</li></ol>
မင်မွဲ|maṅmau	<i>verb</i><br><ol><li>care</li></ol>
မတ်|mòt	<i>noun</i><br><ol><li>jewel precious stone.</li><li>the edge of any cutting instrument.</li><li>eye precious stone cutting edge edge of cutting instrument.</li></ol><br><i>num</i><br><ol><li>in medical prescriptions.</li></ol>
မတ်ဆု	<i>noun</i><br><ol><li>knot (in wood).</li></ol>
မတ်ဗြဲ|mat.brai	<i>noun</i><br><ol><li>cloud</li></ol>
မန်|mawn	<i>name</i><br><ol><li>Mon.</li></ol><br><i>noun</i><br><ol><li>Mon Peguan {in old lit. Reman}.</li><li>charm or magical formula.</li></ol><br><i>verb</i><br><ol><li>to infuse healing virus into {water medicine} by recitation of mantras to repeat a charm or magical formula recite mantra utter mystic words to heal or word of evil.</li></ol>
မန်ညှ|monñha	<i>name</i><br><ol><li>the Mon Hnya, one of three Mon sub-groups that settled in what is now Mottama, also known as မုဟ်တၟံ (muhtmaṃʼ)</li></ol>
မန်ဒ|monda	<i>name</i><br><ol><li>Mon Dae, one of three Mon sub-groups that settled in what is now Bago, formerly known as ဟံသာဝတဳ (haṃsāwatī)</li></ol>
မန်ဒိုၚ်|mondiuṅ	<i>name</i><br><ol><li>the Mon Diung, one of three Mon sub-groups that settled in what is now Pathein, also known as ဖာသဳ (phāsīm)</li></ol>
မလာၚ်|məlàiŋ	<i>noun</i><br><ol><li>cream</li></ol>
မဝ်တဝ်ကာ|mɔtɔka	<i>noun</i><br><ol><li>motorcar</li></ol>
မသကလောကောဒေံ|masakalokodeṃ	<i>adj</i><br><ol><li>fellow villagers of townsman as close as akin.</li></ol>
မသုန်|masun	<i>num</i><br><ol><li>five</li></ol>
မာဏ္ဍာတ်|màntàt	<i>noun</i><br><ol><li>shed, pavilion (used in compounds)</li></ol>
မာန်|mān	<i>verb</i><br><ol><li>win conquer prevail domineer overpower overcome part particle suffixed to verbs to denote capability probability or possibility. {Usually expressed in English with the auxiliary verbs “can” “may” “be able to” “be likely to” etc.).</li><li>to win to beat.</li><li>to work {clay} to work clay with the hands in making pottery.</li></ol><br><i>noun</i><br><ol><li>pride arrogance force of personality.</li></ol>
မာရေဝ်ခရေတ်သမာတ်	<i>phrase</i><br><ol><li>merry Christmas</li></ol>
မာံ|ma	<i>noun</i><br><ol><li>title title prefixed to the proper name of a male.</li></ol>
မာ်|māk	<i>noun</i><br><ol><li>The eleventh month of the Mon lunar calendar, which corresponds to February.</li></ol>
မိ|mi	<i>noun</i><br><ol><li>mother.</li></ol><br><i>verb</i><br><ol><li>Mrs.</li></ol>
မိဂမဴတှ်|migamaoth	<i>noun</i><br><ol><li>to wet nurse, breastfeeding, breastfeed.</li></ol>
မိတ်|mit	<i>noun</i><br><ol><li>(Botany) turmeric plant Curcuma longa Roxburgh.</li><li>friendship amity.</li></ol>
မိပ်ဇိပ်|mipjip	<i>verb</i><br><ol><li>to be thoroughly happy.</li></ol>
မိုဟ်	<i>noun</i><br><ol><li>nose</li><li>(terminal) point</li><li>edge; fringe</li></ol>
မုသာ|musā	<i>noun</i><br><ol><li>lie</li></ol>
မုဟ်ကျာ|muh-kyā	<i>noun</i><br><ol><li>cold season.</li></ol>
မုဟ်တၟံ|muhtmaṃʼ	<i>name</i><br><ol><li>Mottama (also known as Martaban)</li></ol>
မုဲ	<i>noun</i><br><ol><li>axe</li></ol>
မူ|mòʔ|mao|mù	<i>noun</i><br><ol><li>parent's younger brother</li><li>unit of weight</li><li>coinage</li></ol><br><i>pron</i><br><ol><li>uncle</li></ol>
မူသလေန်|mūsalen	<i>noun</i><br><ol><li>(Islam) Muslim</li></ol>
မေတ္တာ|mètta	<i>noun</i><br><ol><li>loving friend</li><li>friendship, love</li></ol>
မောဝ်|mow	<i>adj</i><br><ol><li>fragrant.</li></ol><br><i>verb</i><br><ol><li>to smell sweet be fragrant inhale the fragrance emit an odour sweet smell.</li><li>to emit odour to smell sweetly to be fragrant.</li><li>to increase in size or number plus add to.</li></ol>
မဲာ|mài	<i>noun</i><br><ol><li>indigo</li><li>lot, vote</li><li>(Buddhism) offering made to monks at end of lent and distributed by lot among those assembled</li></ol>
မဳယထာ|mìyətʰa	<i>noun</i><br><ol><li>railway train</li></ol>
မဴ|ma	<i>noun</i><br><ol><li>to suck (at a breast) to consume milk.</li></ol>
မံၚ်|mòŋ	<i>noun</i><br><ol><li>lever with fixed pivot</li></ol>
မ္ညဝ်|mañaw	<i>verb</i><br><ol><li>to shake. shake off.</li></ol>
မ္ၚဵုရအဴ	<i>intj</i><br><ol><li>hello (used to express a greeting)</li></ol>
မြ|mra	<i>noun</i><br><ol><li>emerald</li></ol>
မြာ်|pəràik	<i>noun</i><br><ol><li>peacock; peafowl</li></ol>
မြာ်ကသဵု|mareakkasaw	<i>noun</i><br><ol><li>December.</li></ol>
မြေက်|mrek	<i>noun</i><br><ol><li>chilli</li></ol>
မြံၚ်|pəròŋ	<i>noun</i><br><ol><li>artificial water channel, transport or irrigation canal, ditch, drain</li></ol>
မွဲ|mwaj	<i>num</i><br><ol><li>one.</li></ol><br><i>adj</i><br><ol><li>another.</li><li>single; sole.</li><li>all; whole.</li></ol><br><i>noun</i><br><ol><li>a other only entirety. [Siam] neg. reinforcing p.</li><li>functions as.</li></ol><br><i>verb</i><br><ol><li>to guard watch over.</li></ol>
မွဲလက်|mgala	<i>num</i><br><ol><li>ten thousand</li></ol>
မှာလိၚ်|ma loiŋ	<i>noun</i><br><ol><li>shipmate</li></ol>
မှၚ်|mhaṅ	<i>noun</i><br><ol><li>ink casket wicker work box.</li></ol>
မၚ်|maṅ|မင်	<i>noun</i><br><ol><li>red deer brow-antlered rusa Rucervus thamin.</li></ol><br><i>verb</i><br><ol><li>to wait wait for remain in one place watch {for over} lie in wait for guard to observe to take care of.</li></ol>
မၞိဟ်|mnih	<i>noun</i><br><ol><li>man human being person Homo sapiens people in general.</li></ol>
မၞိဟ်တြုံ|mnih truĥ	<i>noun</i><br><ol><li>man (male person).</li></ol>
မၞိဟ်ဗြဴ	<i>noun</i><br><ol><li>woman.</li></ol>
ယ|ya	<i>character</i><br><ol><li>Ya, the twenty-sixth consonant of the Mon alphabet.</li></ol><br><i>noun</i><br><ol><li>tar, pitch.</li><li>resin of resinous wood, used in caulking, tar, pitch, tar substitute prepared by mixing wax of dammar bee with petrol or wood-iol, is used as a substitute for pitch.</li></ol>
ယက်|jak	<i>noun</i><br><ol><li>smoke</li></ol>
ယခေၚ်|yəkʰɔiŋ	<i>name</i><br><ol><li>Arakanese</li></ol>
ယထာ|yətʰa	<i>noun</i><br><ol><li>vehicle, esp train</li></ol>
ယအ်|yaa	<i>verb</i><br><ol><li>to be deficient in quantity or content, partly empty</li></ol>
ယီု|yəṁ	<i>verb</i><br><ol><li>to breathe.</li></ol>
ယုတ်|yut	<i>verb</i><br><ol><li>to be depraved, of despicable character</li><li>to degenerate, to diminish, fall short in quantity</li></ol>
ယေန်|yen	<i>verb</i><br><ol><li>to be pleasant (used in compounds)</li></ol>
ယောဂဳ|yòkì	<i>noun</i><br><ol><li>ascetic</li></ol>
ယဲ|yay	<i>verb</i><br><ol><li>to be ill; to be sick.</li></ol><br><i>noun</i><br><ol><li>illness; disease.</li><li>symptom of disease.</li></ol>
ယဲကာလ|yay kāla	<i>noun</i><br><ol><li>(Thailand) epidemic, especially cholera.</li><li>(Myanmar, obsolete) Alternative form of ကာလယဲ (“epidemic”)</li></ol>
ယဲကျာ	<i>noun</i><br><ol><li>flatulence.</li></ol>
ယဲကၠန်	<i>noun</i><br><ol><li>hernia; enterocele.</li></ol>
ယဲဂၞဴ|yay gnau	<i>noun</i><br><ol><li>(Kaw Kyaik) cholera.</li><li>(Pak Kret District) stomach disease.</li></ol>
ယဲမတ်|yay mat	<i>noun</i><br><ol><li>(Kaw Kyaik) ophthalmia; pinkeye.</li><li>(Kaw Kyaik) cataract; clouding eye.</li></ol>
ယဲမတ်ကနအ်|yay mat kanaʼ	<i>noun</i><br><ol><li>(Kaw Kyaik) ophthalmia; pinkeye.</li></ol>
ယံက်|yòk	<i>noun</i><br><ol><li>ladle, shovel</li></ol>
ယံၚ်|yaṃṅ	<i>verb</i><br><ol><li>to turn from one's course, to go astray, fail in one's duty</li></ol>
ယျာ|yyā	<i>verb</i><br><ol><li>to be pleasant</li></ol>
ယျေဝ်|ye	<i>noun</i><br><ol><li>police</li></ol>
ယျဵု|yyaဵu	<i>verb</i><br><ol><li>to be strictly true (used in compounds)</li></ol>
ယွံ|ywaṃ	<i>adv</i><br><ol><li>yes also used in beginning a formal address.</li></ol><br><i>prep</i><br><ol><li>of formal address prefixed to respect title indicates assent.</li></ol>
ရ|ra	<i>character</i><br><ol><li>Ra, the twenty-seventh consonant of the Mon alphabet.</li></ol><br><i>pron</i><br><ol><li>particle of unqualified assertion.</li></ol><br><i>adj</i><br><ol><li>assertive.</li><li>Closing the sentence, in questions It precedes the interrogative particle also used with the imperative.</li></ol>
ရန်|ran	<i>verb</i><br><ol><li>to (have) regard (to), consider, be concerned with</li></ol>
ရပ်	<i>verb</i><br><ol><li>to hold</li></ol>
ရမာန်|ramān	<i>name</i><br><ol><li>(historical) Mon</li></ol>
ရာ|rɛ̀a	<i>noun</i><br><ol><li>thing, place</li></ol>
ရာန်|rān	<i>verb</i><br><ol><li>to buy</li></ol>
ရိုဟ်|ruih	<i>verb</i><br><ol><li>to count</li></ol><br><i>adj</i><br><ol><li>every</li></ol><br><i>noun</i><br><ol><li>root</li></ol>
ရိုၚ်|ruiṅ|rɜ̀ŋ	<i>noun</i><br><ol><li>large building usually without partitions, public building, office, courthouse, shed</li></ol><br><i>verb</i><br><ol><li>to be wild, savage, uncultivated, coarse, ill-bred, rude</li></ol>
ရိုၚ်ဂအုဲ	<i>noun</i><br><ol><li>hospital.</li></ol>
ရုန်|run	<i>verb</i><br><ol><li>to strain away, attempt to get loose, to be intractable</li></ol>
ရုဲ|ruy	<i>noun</i><br><ol><li>housefly</li></ol><br><i>verb</i><br><ol><li>to choose, select, elect</li></ol>
ရေတ်|ret	<i>verb</i><br><ol><li>to go round, about</li></ol>
ရဲ|roa	<i>noun</i><br><ol><li>A friend.</li></ol>
ရဲု|ruy	<i>noun</i><br><ol><li>Encoding in Unicode standard for modern Burmese of ရုဲ</li></ol>
ရးမည|ရာမည|rāmaña	<i>noun</i><br><ol><li>Mon area.</li><li>Mon Country.</li></ol>
ရှအ်|rhaa	<i>verb</i><br><ol><li>to reduce</li></ol>
ရှုက်|rhuk	<i>verb</i><br><ol><li>to be tangled, confused</li><li>to behave indecorously, in a disorderly manner</li></ol>
လ|la	<i>character</i><br><ol><li>La, the twenty-eighth consonant of the Mon alphabet.</li></ol><br><i>noun</i><br><ol><li>grandfather, elderly person.</li></ol>
လကံ|təkɔm	<i>noun</i><br><ol><li>kind of palm yielding edible fruit, Zalacca wallichiana</li></ol>
လက်|lak	<i>num</i><br><ol><li>ten thousand</li></ol><br><i>noun</i><br><ol><li>curse</li><li>cursed</li></ol>
လက်ချဴ|lakkhyao	<i>noun</i><br><ol><li>cursed</li><li>curse</li></ol>
လက်ဖက်	<i>noun</i><br><ol><li>tea (plant or leaves).</li></ol>
လစိန်|kacin|lacin|ကစိန်	<i>noun</i><br><ol><li>ring (ornament).</li></ol>
လတ်|lat	<i>verb</i><br><ol><li>to be fresh</li></ol>
လထုပ်|kətʰup	<i>noun</i><br><ol><li>hat</li></ol>
လနက်|lanak	<i>verb</i><br><ol><li>to be deep (in mud), to sink into, to bog down</li></ol>
လဗာ	<i>noun</i><br><ol><li>rubber (pliable material derived from the sap of the rubber tree)</li></ol>
လမျီူ	<i>noun</i><br><ol><li>life</li></ol>
လဝဟ်|lavch	<i>noun</i><br><ol><li>(weaponry) weapon, arms</li></ol>
လသိုဏ်|lasiun	<i>noun</i><br><ol><li>onion</li></ol>
လီ|liṃ	<i>verb</i><br><ol><li>to lie (to give false information intentionally with intent to deceive)</li></ol>
လီု|ləṁ	<i>verb</i><br><ol><li>to break down</li><li>to decay, to rot, to go bad</li><li>to perish</li><li>to miscarry</li></ol><br><i>adj</i><br><ol><li>destroyed,</li></ol>
လုပ်|lup	<i>verb</i><br><ol><li>to enter, to go into</li></ol>
လုၚ်|luṅ	<i>verb</i><br><ol><li>to be watertight</li></ol>
လေဝ်|lew	<i>pron</i><br><ol><li>also too.</li></ol>
လောက|lòkaʔ	<i>noun</i><br><ol><li>the physical world, the world as the theatre of secular life</li></ol>
လောန်|lòn|lon	<i>noun</i><br><ol><li>shuttle</li></ol><br><i>verb</i><br><ol><li>to come to an end, elapse, to exceed, pass go past</li></ol>
လောပ်	<i>verb</i><br><ol><li>to go in; to enter.</li></ol>
လောဘ|lobha	<i>noun</i><br><ol><li>avarice, selfish desire, cupidity</li></ol>
လောဲ|loy	<i>verb</i><br><ol><li>(to be) easy</li></ol><br><i>noun</i><br><ol><li>friend</li></ol>
လေဲာ	<i>verb</i><br><ol><li>Encoding in Unicode standard for modern Burmese of လောဲ</li></ol><br><i>noun</i><br><ol><li>Encoding in Unicode standard for modern Burmese of လောဲ</li></ol>
လဲ|lay	<i>adj</i><br><ol><li>to be easy</li></ol><br><i>noun</i><br><ol><li>friend</li></ol>
လံၚ်|laṃṅ	<i>verb</i><br><ol><li>to put in, into, to add to, to stake, wager</li></ol>
လ္ကံ	<i>noun</i><br><ol><li>island</li></ol>
လ္ပာ်|lpāk	<i>noun</i><br><ol><li>side, direction</li><li>half</li></ol>
လ္ပံ	<i>verb</i><br><ol><li>to dream</li></ol>
လ္ၚီ|lṅim	<i>num</i><br><ol><li>thousand</li></ol>
လျးတ္ၚဲ|lyehstanoa	<i>noun</i><br><ol><li>(astronomy) solar system</li></ol>
လှာ|la	<i>noun</i><br><ol><li>mule, donkey</li></ol>
လှောတ်|hlot	<i>noun</i><br><ol><li>legislature, parliament</li></ol>
လှောၚ်|lhoṅ	<i>verb</i><br><ol><li>to sail</li></ol>
လၟာတ်|lmāt	<i>noun</i><br><ol><li>(Buddhism) a person who separates himself from family life and pledges himself to keep the Eight Precepts.</li></ol>
ဝ|wa	<i>character</i><br><ol><li>Wa, the twenty-ninth consonant of the Mon alphabet.</li></ol><br><i>noun</i><br><ol><li>Wa, Lawa, pagan hill man practising slash-and-burn cultivation, a race of northern Burma and Siam formerly noted head hunters. They are closed by Mon writers, with the Karens as a people of more rudimentary culture, name of one of the Mon-Khmer language and its speakers found mainly in areas east of the Salween river in the Shan State.</li></ol>
ဝကျ|wɛ̀akcaˀ	<i>noun</i><br><ol><li>sentence</li></ol>
ဝင်္က|waṅka	<i>name</i><br><ol><li>(ကွာန်) or ဍုင် Sangkhlaburi (a town in Nong Lu Subdistrict, Thailand).</li></ol><br><i>noun</i><br><ol><li>fish history.</li></ol>
ဝန်|wan	<i>noun</i><br><ol><li>government official</li></ol>
ဝပ်|vap	<i>verb</i><br><ol><li>to be quiet, peaceful, composed</li></ol>
ဝါ|wā	<i>classifier</i><br><ol><li>time (for counting)</li></ol><br><i>noun</i><br><ol><li>open ground not under cultivation or pasture</li><li>kite</li></ol>
ဝါတ်|wāt	<i>verb</i><br><ol><li>(to be) difficult</li><li>(to be) impoverished, (to be) poor</li></ol>
ဝေန်	<i>verb</i><br><ol><li>to be crooked, deformed</li></ol>
ဝဲါဝှာင်|wayfan	<i>noun</i><br><ol><li>(networking) Wi-Fi.</li></ol>
ဝဳပက်|wìpɛk	<i>noun</i><br><ol><li>results of former evil deeds, misfortune caused by bad karma</li></ol>
ဝှ်|waoh	<i>noun</i><br><ol><li>October.</li></ol>
သ|sa	<i>character</i><br><ol><li>Sa, the thirtieth consonant of the Mon alphabet.</li></ol><br><i>particle</i><br><ol><li>the sign of the future or subjunctive, in order works it is used with the most verbs.</li></ol><br><i>verb</i><br><ol><li>to have the skin broken, ulcerate, develop sores, to be injured.</li></ol>
သက္ကရာဇ်|sakkarāj	<i>noun</i><br><ol><li>era.</li><li>year.</li></ol>
သက်|sak	<i>verb</i><br><ol><li>to moderate (used in compounds)</li></ol>
သက်သက်|sɛk sɛk	<i>adj</i><br><ol><li>wholly, completely, entirely</li></ol>
သက်သာ|saksā	<i>verb</i><br><ol><li>to be cheap</li><li>to be easy</li></ol>
သက်သဳ|sɛksɔe	<i>noun</i><br><ol><li>testimony, evidence, testimonial</li><li>witness</li></ol>
သဂြာ|sagrā	<i>noun</i><br><ol><li>sugar</li></ol>
သတ္တိ|satti	<i>noun</i><br><ol><li>strength.</li><li>bravery.</li></ol>
သတ်	<i>noun</i><br><ol><li>fruit; nut; berry.</li><li>areca nut.</li><li>head or blade (of tool).</li><li>animal; creature.</li></ol><br><i>verb</i><br><ol><li>to bear fruit.</li></ol>
သတ်ဗြဴ|satprea	<i>noun</i><br><ol><li>coconut.</li></ol>
သပုန်|sapun	<i>noun</i><br><ol><li>rebel, rebellion</li></ol><br><i>verb</i><br><ol><li>to rebel, to raise a rebellion mutiny.</li></ol>
သမာ|həma	<i>noun</i><br><ol><li>-er, -ist</li></ol>
သမ္အုဲ	<i>noun</i><br><ol><li>decay, rotting</li></ol>
သရ|sara	<i>verb</i><br><ol><li>to break the surface of.</li><li>to break {up} the surface of.</li></ol><br><i>noun</i><br><ol><li>discharging lesion sore ulcer burn scald.</li></ol>
သရဳရ|sarīra	<i>noun</i><br><ol><li>body (of human)</li></ol>
သဝ်|sw	<i>verb</i><br><ol><li>to be low short in stature.</li></ol>
သာ|sā	<i>verb</i><br><ol><li>to exceed</li><li>to be pleasant</li></ol>
သာဂူ	<i>noun</i><br><ol><li>sago.</li></ol>
သာဓု|sahtoo	<i>noun</i><br><ol><li>thank, Vocabulary used by Buddhist monks.</li></ol>
သာသနာ|saasnaa	<i>noun</i><br><ol><li>(Buddhism) teaching; dispensation</li><li>era</li></ol>
သာဲ|sāy	<i>noun</i><br><ol><li>bee (insect)</li></ol>
သိ|sɔeʔ	<i>noun</i><br><ol><li>rice beer, rice spirits</li><li>hermit</li></ol>
သိက်|sik	<i>verb</i><br><ol><li>to force into a container, cram, stuff, in</li></ol>
သိုက်|sak	<i>name</i><br><ol><li>(astronomy) (ဂြိုဟ် ~) Venus</li><li>(astrology) Shukra</li><li>(တ္ၚဲ ~) Friday</li></ol><br><i>verb</i><br><ol><li>to be well-to-do; rich</li></ol>
သိုၚ်	<i>noun</i><br><ol><li>building</li></ol><br><i>verb</i><br><ol><li>to build</li></ol>
သီ|sɛm	<i>verb</i><br><ol><li>to collect (up), tidy away</li><li>to bring to a conclusion</li></ol>
သုခ|saoʔkhaʔ	<i>noun</i><br><ol><li>happiness</li></ol>
သုည|sunña	<i>num</i><br><ol><li>zero.</li><li>emptiness nothingness {maths} cipher zero naught.</li></ol>
သုန်|su	<i>noun</i><br><ol><li>nothingness deteriorate and cease to become extinct emptiness.</li></ol>
သုန်ည|sunña	<i>num</i><br><ol><li>zero</li></ol>
သုသာန်|saoʔsan	<i>noun</i><br><ol><li>cemetery</li></ol>
သုၚ်|သုင်	<i>verb</i><br><ol><li>to drink.</li><li>to take (medicine).</li><li>to inhale smoke; to smoke.</li></ol>
သေနာတ်|shinnad	<i>noun</i><br><ol><li>(firearms) gun</li></ol>
သောန်|son	<i>verb</i><br><ol><li>to cast in metal, coin, mint</li></ol>
သော်|sok	<i>noun</i><br><ol><li>hairs of head</li><li>body hair</li></ol>
သော်က္ဍိုပ်|sokkḍuip	<i>noun</i><br><ol><li>headhair</li></ol>
သဳလ|sīla	<i>noun</i><br><ol><li>(Buddhism) morals or precepts {which are five, eight, and ten in number} codifying moral conduct of which ten are followed by monks, five ordinarily by laymen, and eight by white-robed acolytes (လၟာတ် (lmāt)) and ဗြဴမိန် (braomin) (female renunciants) and by laymen as sabbath or Lenten observance</li><li>(Buddhism) priestess, nun</li><li>moral practice, moral precepts.</li></ol>
သံၚ်|sɔŋ	<i>noun</i><br><ol><li>shallow place in river or sea, sandbank, shoal, ford</li></ol>
သ္ကေပ်	<i>noun</i><br><ol><li>pliers.</li><li>tongs.</li><li>chopsticks.</li></ol><br><i>verb</i><br><ol><li>to use pliers, tongs, or chopsticks.</li><li>to grasp with the claws.</li><li>to take between finger and thumb; to pinch.</li></ol>
သ္ဍိသဳ|khadausoi	<i>noun</i><br><ol><li>August</li></ol>
သ္တန်|တန်|stan	<i>verb</i><br><ol><li>to stand, firm, to settle in a place, to endure, to be [valid]]</li></ol>
သ္တိက်|stik	<i>verb</i><br><ol><li>to sleep</li><li>to lie</li></ol>
သ္တၚ်|staṅ	<i>verb</i><br><ol><li>to place on something</li><li>(honorific) to lie down, go to bed, sleep</li></ol>
သ္ဗံ	<i>noun</i><br><ol><li>hump of ox or cow</li></ol>
သ္အး	<i>adj</i><br><ol><li>clear; clean</li></ol><br><i>verb</i><br><ol><li>to clean; to clean out</li><li>to geld</li></ol>
သ္ၚိ|sṅi	<i>noun</i><br><ol><li>house</li></ol>
သ္ၚိတ်|hɛt	<i>noun</i><br><ol><li>sampan, flat-bottomed oared boat with projecting incurved timbers at stern</li></ol>
သ္ၚိသဝ်|sṅi saw	<i>noun</i><br><ol><li>(astronomy) (ဂြိုဟ်~) Saturn</li><li>(တ္ၚဲ~) Saturday</li></ol>
သ္ၚု	<i>noun</i><br><ol><li>uncooked husked rice.</li></ol>
သြန်	<i>noun</i><br><ol><li>silver</li><li>money</li><li>a unit of money: kyat, baht, etc.</li></ol>
သြာန်လာ်|san làik	<i>noun</i><br><ol><li>magnet</li></ol>
သြိုၚ်	<i>noun</i><br><ol><li>hole, cavity.</li></ol><br><i>verb</i><br><ol><li>to build.</li></ol>
သြောတ်|sot	<i>noun</i><br><ol><li>zinc</li></ol>
သွ|swa	<i>noun</i><br><ol><li>dish eaten as accompaniment to rice curry soap broth.</li></ol>
သွတ်|swat	<i>noun</i><br><ol><li>chew quid part numerical classifier for counting betel quids.</li></ol><br><i>verb</i><br><ol><li>to prepare a chew of betel make betel quids.</li><li>to be small immature.</li></ol>
သွာ|swā	<i>noun</i><br><ol><li>water lily</li><li>(Pak Kret District) white lotus (Nymphaea lotus)</li></ol><br><i>verb</i><br><ol><li>to be easy</li><li>to improve (in health), to ameliorate</li><li>to make easier</li><li>(Kaw Kyaik) to be at ease</li><li>(Pak Kret District) to appease (pain, anger, fatigue)</li></ol>
သွုၚ်|သွုင်	<i>noun</i><br><ol><li>drink; drinkable; beverage.</li><li>dose (of medicine).</li></ol>
သွဵု|swuiw	<i>noun</i><br><ol><li>vowel</li></ol>
သွံ	<i>noun</i><br><ol><li>paddy</li></ol><br><i>verb</i><br><ol><li>to sell</li></ol><br><i>adv</i><br><ol><li>indeed, certainly</li></ol>
သၚ်|sɛŋ	<i>verb</i><br><ol><li>to give off, emit</li></ol>
သၚ်ကြာန်|sɛŋkran	<i>name</i><br><ol><li>Thingyan; Songkran.</li></ol>
သၞာံ	<i>noun</i><br><ol><li>year.</li><li>skin; leather.</li></ol>
သၞေၚ်	<i>noun</i><br><ol><li>wing</li><li>feather</li><li>fin</li></ol>
သၞဴ	<i>verb</i><br><ol><li>to be mixed with, to mix, associate</li></ol>
သၞံၚ်	<i>noun</i><br><ol><li>(astronomy) star.</li></ol>
သၟဝ်|smaw	<i>prep</i><br><ol><li>under, beneath.</li></ol>
သၟာ|smā	<i>verb</i><br><ol><li>to go astray, err</li></ol>
သၟာန်	<i>verb</i><br><ol><li>to ask a question</li></ol><br><i>noun</i><br><ol><li>question</li></ol>
သၟုဲလေင်|smuyleṅ	<i>noun</i><br><ol><li>teenager.</li></ol>
သၠ|sla	<i>noun</i><br><ol><li>leaf</li><li>palm leaf</li></ol>
သၠသိုတ်|slasiut	<i>noun</i><br><ol><li>leaf used in Brahmanical rites.</li></ol>
သၠီ|sliṁ	<i>noun</i><br><ol><li>pride of India, white cedar, Persian lilac (Melia azedarach)</li><li>neem tree, margosa tree (Azadirachta indica)</li></ol>
သၠုၚ်|sluṅ	<i>adj</i><br><ol><li>high</li><li>tall</li><li>exalted</li></ol>
သၠေံ|sleṃ	<i>verb</i><br><ol><li>to lure, entice, coax, to soothe</li></ol>
ဟ|ha	<i>character</i><br><ol><li>Ha, the thirty-first consonant of the Mon alphabet.</li></ol><br><i>verb</i><br><ol><li>particle of verbal negation. Not, not any, non.</li></ol>
ဟစေပ်|hacep	<i>verb</i><br><ol><li>(Pak Kret District) to click one's tongue</li></ol><br><i>noun</i><br><ol><li>see ဂစေပ် (gacep).</li></ol>
ဟာန်|hàn	<i>noun</i><br><ol><li>assumed or false appearance</li></ol>
ဟီု|həṁ	<i>verb</i><br><ol><li>to speak</li></ol>
ဟုတ်|hut	<i>verb</i><br><ol><li>to deteriorate decay dwindle to diminish to become less to decay.</li></ol>
ဟေတုပစ္စယော|hexˀtĕāp̆xdˀcayó	<i>noun</i><br><ol><li>(Buddhism, philosophy) hetu-paccaya, the six "root conditions" (attachment, anti-attachment, aggressiveness, anti-aggressiveness, ignorance, and wisdom) that engender all thoughts and feelings in Buddhist philosophy</li></ol>
ဟံသာဝတဳ|haṃsawatae	<i>name</i><br><ol><li>Hanthawaddy</li></ol>
ဠ|ḷa	<i>character</i><br><ol><li>Ḷla, the thirty-second consonant of the Mon alphabet. {not initial}.</li></ol>
အ|ʼa	<i>character</i><br><ol><li>ʼA, the thirty-fourth consonant of the Mon alphabet.</li></ol><br><i>name</i><br><ol><li>ʼA, the first of twelve vowels the Mon language.</li></ol><br><i>adj</i><br><ol><li>Unable to speak, mute, dumb, dud.</li></ol><br><i>verb</i><br><ol><li>to private affix.</li></ol>
အကုသိုလ်|အကုသလ|ʼakusa|'akusala	<i>noun</i><br><ol><li>evil, misdeed, demerit</li></ol>
အကောပ်|əkop	<i>noun</i><br><ol><li>reinforcing binding, hoop of barrel etc</li></ol>
အကောၚ်|əkeaŋ	<i>noun</i><br><ol><li>habit, custom</li></ol>
အကဲာ|əkai	<i>noun</i><br><ol><li>build, bodily habit, character, appearance</li></ol>
အကံက်|əkɔk	<i>noun</i><br><ol><li>customs or excise duty</li><li>bracelet</li></ol>
အကး|လကး|အာကာသ်|ʼakaḥ|ʼākās|lakaḥ	<i>noun</i><br><ol><li>sky, upper air</li></ol>
အကြာ|əkra	<i>noun</i><br><ol><li>between, among</li></ol>
အကွက်|əkwɛk	<i>noun</i><br><ol><li>(matter of) account</li><li>sake, behalf, for, for the sake of, on behalf of, for the use of</li><li>for the duration of</li><li>in order to, in order that, so as to</li><li>general nominalizing phrase head referring to future or hypothetical events, in indirect speech replacing an imperative construction</li></ol>
အကၚ်|əkɛŋ	<i>noun</i><br><ol><li>skin eruption, vesication</li></ol>
အခါ|əkʰa	<i>noun</i><br><ol><li>time, season, continuing time, time when</li></ol>
အခါန်|əkʰan	<i>noun</i><br><ol><li>room</li></ol>
အခိၚ်|əkʰoiŋ	<i>noun</i><br><ol><li>time, time of day, precise time</li><li>(infrequent) occasion</li></ol>
အခေါန်|əkʰon	<i>noun</i><br><ol><li>tax, especially land tax</li></ol>
အခေါၚ်|əkʰoŋ	<i>noun</i><br><ol><li>permission</li><li>pardon</li></ol>
အဂ္ဂမဟာပဏ္ဍိတ|ʼaggamahāpaṇḍita	<i>noun</i><br><ol><li>the Agga Maha Pandita title presented by the government to a monk or person for his impeccable morals through knowledge of the Tipitakas and authoriship of Buddhist religious tracks.</li></ol>
အဂၞဲ|agnay	<i>noun</i><br><ol><li>southeast</li></ol>
အစာတ်|əcat	<i>noun</i><br><ol><li>hot pickle prepared with chillies and vinegar</li></ol>
အစေန်|əcen	<i>noun</i><br><ol><li>succession (used in compounds)</li></ol>
အစောံ|əcon	<i>noun</i><br><ol><li>mottling (used in compounds)</li></ol>
အစေံ|ahceṃ	<i>name</i><br><ol><li>Ahsin (a town in Mon State, Myanmar)</li></ol>
အစဵုယျ|əcɜyaˀ	<i>noun</i><br><ol><li>government, government authorities</li></ol>
အစံၚ်|əcom|əcɔŋ	<i>noun</i><br><ol><li>ability (used in compounds)</li><li>guard (used in compounds)</li></ol>
အဆက်|əchɛk	<i>noun</i><br><ol><li>succession, lineage, descent</li></ol>
အဆိပ်|əchip	<i>noun</i><br><ol><li>stamp (used in compounds)</li></ol>
အဆံ|əchɔm	<i>noun</i><br><ol><li>relations (used in compounds)</li></ol>
အဆံၚ်အလံၚ်|əchɔŋ əlòŋ	<i>noun</i><br><ol><li>retinue</li></ol>
အတာန်|ətan	<i>noun</i><br><ol><li>form, class, standard, in school</li></ol>
အတိက်|ətoik	<i>noun</i><br><ol><li>former times, ancient times</li></ol>
အတိုၚ်|ətaŋ	<i>noun</i><br><ol><li>accordance, in accordance with, according to, as</li><li>along</li></ol>
အတေၚ်|əteaŋ	<i>noun</i><br><ol><li>against the will of the person acted on, forcibly</li></ol>
အထက်|ətʰɛk	<i>noun</i><br><ol><li>lifetime</li></ol>
အထုပ်|a'thup	<i>noun</i><br><ol><li>bundle, wrapper</li><li>hat, helmet</li></ol>
အထောတ်|ətʰot	<i>noun</i><br><ol><li>pinnacle, summit, top</li></ol>
အဒိုတ်|ʼaduit	<i>noun</i><br><ol><li>(astronomy) sun</li><li>(astrology) Surya</li><li>(တ္ၚဲ ~) Sunday</li><li>(Pak Kret District) week</li></ol>
အဓိပ္ပါယ်|a'dhippāy	<i>noun</i><br><ol><li>explanation.</li></ol>
အနာဂါံ|ʼanāgāṃ	<i>noun</i><br><ol><li>third path to Nirvana (Pali anāgāmimagga)</li><li>one who has entered the third stage of enlightenment</li></ol>
အနာံ|ənèm	<i>noun</i><br><ol><li>breadth</li></ol>
အနိၚ်|ənòiŋ	<i>noun</i><br><ol><li>force, coercion</li></ol>
အနုဘာဝ်|'anubhau	<i>noun</i><br><ol><li>transcendent power.</li></ol>
အနေ|ənè	<i>noun</i><br><ol><li>state, condition, in the state of</li></ol>
အန္တရာယ်|oondtàraai	<i>noun</i><br><ol><li>danger, harm, calamity, disaster</li></ol>
အနှေန်|əhnɛn	<i>noun</i><br><ol><li>market rate, price at which a commodity is generally sold</li></ol>
အပါ|ʼapā	<i>noun</i><br><ol><li>father</li></ol>
အပိုဟ်|a'piuh	<i>noun</i><br><ol><li>reed used for mats of various species.</li></ol>
အပိုၚ်|əpaŋ	<i>noun</i><br><ol><li>division, section, esp of books</li></ol>
အပံၚ်|əpɔŋ	<i>noun</i><br><ol><li>association between persons, partnership</li><li>total</li><li>fritter</li></ol>
အပ်|ɔp	<i>verb</i><br><ol><li>to be suitable, agreeable, proper</li></ol>
အပြေံက်|əprɔk	<i>noun</i><br><ol><li>variegated markings, brindling</li></ol>
အပၚ်|əpɛŋ	<i>noun</i><br><ol><li>foreign substance or object obtruded into body by sorcery and causing illness</li></ol>
အဖက်|əpʰɛk	<i>noun</i><br><ol><li>friend, companion</li></ol>
အဘိဓဇမဟာရဋ္ဌဂုရု|ʼabhidhajamahāraṭṭhaguru	<i>noun</i><br><ol><li>ecclesiastical title conferred on a Buddhist monk who already has အဂ္ဂမဟာပဏ္ဍိတ (ʼaggamahāpaṇḍita) little has been in monk hood for more than forty years and has written religious tracts.</li></ol>
အဘိဓာန်|abhidhān	<i>noun</i><br><ol><li>dictionary</li></ol>
အမိၚ်|əmòiŋ	<i>noun</i><br><ol><li>official permission, permit, licence</li></ol>
အမေ|əmè	<i>noun</i><br><ol><li>mother</li></ol>
အမှု|əhmaoˀ	<i>noun</i><br><ol><li>affair, business, case, lawsuit, issue, dispute</li></ol>
အမှဲ|ʼamhoa	<i>noun</i><br><ol><li>sky.</li></ol>
အယုက်|əyɜ̀k	<i>noun</i><br><ol><li>age (of person).</li><li>lifespan.</li></ol>
အယျဲ	<i>noun</i><br><ol><li>age-status, age-group, one of three covering respectively youth and adolescence, the period of active married life, and late middle age and old age.</li></ol>
အရည|'arañña	<i>noun</i><br><ol><li>jungle forest.</li></ol>
အရာ|ərɛ̀a	<i>noun</i><br><ol><li>thing, matter</li></ol>
အရာပ်|ərèp	<i>noun</i><br><ol><li>place, district</li></ol>
အရိုၚ်|əràŋ	<i>noun</i><br><ol><li>wildness esp. of human beings, primitive state, lack of breeding</li></ol>
အရဳ|ʼarī	<i>noun</i><br><ol><li>holy person saint.</li></ol><br><i>adj</i><br><ol><li>saintly pious faithful person.</li></ol>
အရံၚ်|əròŋ	<i>noun</i><br><ol><li>colour</li><li>lustre, polish</li><li>appearance</li></ol>
အရၚ်|ərɛ̀aŋ	<i>noun</i><br><ol><li>trading capital</li><li>principal, sum on which interest is payable</li><li>blood relationship</li></ol>
အလာံ|alām	<i>noun</i><br><ol><li>flag</li></ol>
အလာံဂကူမန်	<i>phrase</i><br><ol><li>flag</li></ol>
အလိုက်|əlàk	<i>noun</i><br><ol><li>according to, along</li><li>accord, convenience</li></ol>
အလုံ|əlùm	<i>noun</i><br><ol><li>whole, entirety</li></ol>
အလဵုလဵု|əlɜ̀ lɜ̀	<i>noun</i><br><ol><li>of itself, automatically</li></ol>
အဝ|ahwa	<i>name</i><br><ol><li>(ဍုင်) Mandalay (a town in the Mandalay Region, Myanmar).</li></ol><br><i>noun</i><br><ol><li>The Wa Karen region (Old).</li></ol>
အဝတ်|ʼawat	<i>noun</i><br><ol><li>duty.</li></ol>
အဝါ|'awā	<i>noun</i><br><ol><li>turn.</li></ol>
အသုဘ|əsaoʔphɛ̀ʔ	<i>noun</i><br><ol><li>(polite) feces.</li></ol>
အသုၚ်|ʼasuṅ	<i>noun</i><br><ol><li>use, utility</li></ol>
အသူ|'asū	<i>noun</i><br><ol><li>(Buddhism), Asura, a fallen angel or a kind of deva who is the sworn enemy of the Tarvaetoing deva.</li></ol>
အသူရိကာဲ|'asūrikāy	<i>noun</i><br><ol><li>(Buddhism) Suraloka, one of the four apayas</li></ol>
အသံ|ʼasaṃm	<i>noun</i><br><ol><li>edict government order verdict authority ability of influence events sound a kind of medicinal plant.</li><li>utterance order command decree injunction mandate.</li></ol>
အသၟဝ်|'asmaw	<i>prep</i><br><ol><li>(colloquial) lower part under underneath below.</li><li>below under.</li></ol><br><i>adj</i><br><ol><li>under.[opp.] tower.</li></ol>
အဟာန်|ʼahān	<i>noun</i><br><ol><li>goose</li></ol>
အာ	<i>verb</i><br><ol><li>to go.</li><li>to walk.</li></ol>
အာကာသ|ʼākās|ʼākāsa|အာကာသ်	<i>noun</i><br><ol><li>sky, space</li></ol>
အိက်|ʼik	<i>noun</i><br><ol><li>feces.</li><li>excretion; waste product.</li></ol>
အိန်|ဣန်|ʼin	<i>name</i><br><ol><li>(Hinduism, Buddhism) Indra, chief of the gods</li></ol>
အိန်ထံၚ်|ʼinthaṃṅ	<i>noun</i><br><ol><li>married state</li></ol>
အုက်|ʼuk	<i>affix</i><br><ol><li>affix used denote male as in ‘hen’.</li></ol>
အုတ်|ʼut	<i>noun</i><br><ol><li>camel.</li></ol><br><i>verb</i><br><ol><li>to be stale to go stale.</li></ol>
အုပ်|ʼup	<i>noun</i><br><ol><li>block billet of wood jungle bush thicket.</li><li>volume or separate part of book quantifier for books lengths of cloth.</li></ol><br><i>verb</i><br><ol><li>to cover</li><li>to preside over</li><li>to be covered</li></ol>
အုဲ|'auy	<i>verb</i><br><ol><li>rot.</li><li>scoop.</li></ol>
အူ|ʼū	<i>verb</i><br><ol><li>to be brighten to furbish to polish.</li></ol>
အေ|ʼe	<i>adj</i><br><ol><li>yes. [ps.] particle introducing statement or request. with general approbatory colour.</li></ol>
အေရှာ|ʼerhā	<i>name</i><br><ol><li>Asia</li></ol>
အောန်|ʼon	<i>adj</i><br><ol><li>few</li></ol>
အောန်စိုတ်|ʼoncət	<i>adj</i><br><ol><li>sad, (to feel) hurt</li></ol>
အောဟ်|ʼoh	<i>noun</i><br><ol><li>firewood</li></ol>
အဲ|ʼoa	<i>pron</i><br><ol><li>I (1st-person singular personal pronoun)</li></ol>
အဴ|ʼaó	<i>noun</i><br><ol><li>sir madam lord used in replying to the call of a superior and at the close of a petition. [ps.] [Bur] standing alone calls for repetition of utterance eh? {formal [esp.] in oratorical style} final in sent implies deference between the persons addressed {Saim} standing alone acknowledges an utterance yes all right.</li></ol><br><i>character</i><br><ol><li>ʼaó, the tenth vowel of the modern Mon alphabet.</li></ol>
အံ|ʼaṃʼ|ʼaṃm|aṁ	<i>character</i><br><ol><li>Aṁ, the eleventh vowel of the modern Mon alphabet.</li></ol><br><i>verb</i><br><ol><li>to smell musty rank rotten be unpleasant smell.</li><li>to feed with premisticated food.</li></ol>
အံၚ်|ʼaṃṅ	<i>verb</i><br><ol><li>to be successful (in)</li><li>to pass (an examination)</li><li>to hold</li><li>to be close</li><li>to restrain</li></ol>
အး|aḥ	<i>verb</i><br><ol><li>to be clean to be clear pure innocent holy.</li></ol><br><i>character</i><br><ol><li>ʼAh, the twelfth vowel of the modern Mon alphabet.</li></ol>
အ္စာဥပဒေ|ʼcāʼupade|ʼupades|ဥပဒေသ်	<i>noun</i><br><ol><li>lawyer.</li></ol>
အၚာ|ʼaṅā	<i>noun</i><br><ol><li>(astronomy) (ဂြိုဟ် ~) Mars</li><li>(astrology) Mangala</li><li>(တ္ၚဲ ~) Tuesday</li><li>the planet Mars name of planet Mars name of the Tuesday of the week.</li></ol>
အၚ်|ɛŋ	<i>noun</i><br><ol><li>pond, lake</li><li>bowl</li></ol>
အၜဝ်|ah:bou	<i>name</i><br><ol><li>(ကွာန်) Abaw (a village in Mon State, Myanmar)</li></ol>
ဣ|i	<i>adv</i><br><ol><li>always followed by ရ (ra) prefect particle.</li></ol><br><i>character</i><br><ol><li>ʼI, the third vowel of the modern Mon alphabet.</li></ol>
ဣသိ|ʼisi	<i>noun</i><br><ol><li>hermit</li></ol>
ဥ|ʼu	<i>character</i><br><ol><li>ʼU, the fifth vowel of the modern Mon alphabet.</li></ol>
ဥတု|ʼutu	<i>noun</i><br><ol><li>season of the year</li><li>one of three seasons into which the year is divided</li><li>menstrual period, menses</li></ol>
ဥတုက္ညၚ်|ʼutukañaṅ	<i>noun</i><br><ol><li>dry weather embracing both cold and hot seasons.</li></ol>
ဥပဒေ|ʼupades|ʼupade|ဥပဒေသ်	<i>noun</i><br><ol><li>(law) jurist prudence.</li><li>instruction, guidance.</li></ol>
ဥပမာ|ʼupamā	<i>noun</i><br><ol><li>comparison an example simile traditional story cited in exposition of narrative such expositon.</li></ol>
ဥပရာဇာ|ʼupparājā	<i>noun</i><br><ol><li>(historical) crown prince; heir apparent; viceroy</li></ol>
ဥပ်|ʼup	
ဥု|ū	<i>verb</i><br><ol><li>to polish to brighten to furbish as gold by a certain procees.</li></ol><br><i>character</i><br><ol><li>ʼŪ, the sixth vowel of the modern Mon alphabet.</li></ol>
ဥူ|ū	<i>verb</i><br><ol><li>to polish</li></ol>
ဩ|ʼa|au	<i>noun</i><br><ol><li>basin small bay.</li></ol><br><i>intj</i><br><ol><li>oh!</li></ol><br><i>character</i><br><ol><li>ʼAu, the ninth vowel of the modern Mon alphabet.</li></ol>
ိ	<i>character</i><br><ol><li>Mon vowels</li></ol>
ု	
ူ	
ဲ	
၀|sunna	<i>num</i><br><ol><li>0 (zero)</li></ol>
၁|maw	<i>num</i><br><ol><li>1 (one)</li></ol>
၂|ba	<i>num</i><br><ol><li>2 (two)</li></ol>
၃|put	<i>num</i><br><ol><li>3 (three)</li></ol>
၄|pxnd	<i>num</i><br><ol><li>4 (four)</li></ol>
၅|masxn	<i>num</i><br><ol><li>5 (five)</li></ol>
၆|arao	<i>num</i><br><ol><li>6 (six)</li></ol>
၇|happo	<i>num</i><br><ol><li>7 (seven)</li></ol>
၈|hacan	<i>num</i><br><ol><li>8 (eight)</li></ol>
၉|haci	<i>num</i><br><ol><li>9 (nine)</li></ol>
ၐြဳ|śrī	<i>noun</i><br><ol><li>(Old modern) an assistant a monk of the second rank in the monastery.</li></ol>
ၚ|ṅa	<i>character</i><br><ol><li>Ṅa, the fifth consonant of the Mon alphabet.</li></ol><br><i>noun</i><br><ol><li>rice-land, rice field.</li><li>(colloq) cross-bow, bow.</li></ol>
ၚုဲ|ṅuy	<i>noun</i><br><ol><li>shrimp; prawn; crayfish</li></ol>
ၚေက်|ṅek	<i>noun</i><br><ol><li>tooth</li></ol>
ၚဴ|ṅao	<i>noun</i><br><ol><li>frog</li></ol><br><i>intj</i><br><ol><li>The sound of a baby crying.</li></ol>
ၛ|jha	<i>character</i><br><ol><li>The ninth consonant in the Mon alphabet.</li></ol>
ၜ|bba	<i>character</i><br><ol><li>Bba, the thirty-third consonant of the Mon alphabet.</li></ol><br><i>verb</i><br><ol><li>to make an offering, esp. to devas.</li></ol>
ၜင်ကံက်|kḅaṅgɔ̀ɔkt	<i>noun</i><br><ol><li>A giant knee joint.</li></ol><br><i>name</i><br><ol><li>(now informal) Bangkok (the capital city of Thailand; province of Thailand)</li></ol>
ၜဝ်|ah:bou|bou|အၜဝ်	<i>noun</i><br><ol><li>a rattan.</li></ol>
ၜဝ်ကဒါတ်|ḅaw kadāt	<i>noun</i><br><ol><li>okra (Abelmoschus esculentus)</li><li>(Pak Kret District) roselle (Hibiscus sabdariffa)</li></ol>
ၜါ|ṗā	<i>num</i><br><ol><li>two.</li></ol>
ၜါစှော်|ṗāchok	<i>num</i><br><ol><li>twenty</li></ol>
ၜိုပ်|ḅəp	<i>noun</i><br><ol><li>swan</li><li>goose, duck</li></ol>
ၜိုဟ်|ḅəh	<i>adj</i><br><ol><li>cold, chilly</li></ol><br><i>verb</i><br><ol><li>to be cold</li><li>to be cool</li><li>to be peaceful</li><li>to be pleasant</li><li>to boil</li></ol>
ၜိုဟ်သိုဟ်|ḅəh səh	<i>adj</i><br><ol><li>(to be) peaceful</li><li>(to be) comfortable</li><li>(to be) prosperous</li><li>(Kaw Kyaik) to be cool</li></ol>
ၜိုဟ်သြိုဟ်|ḅəh srəh	<i>adj</i><br><ol><li>peaceful</li><li>comfortable</li><li>prosperous</li><li>(Kaw Kyaik) cool</li></ol>
ၜိၚ်|biŋ	<i>verb</i><br><ol><li>to swim</li></ol>
ၜုၚ်|ṗuṅ	<i>verb</i><br><ol><li>to hit</li><li>to strike</li></ol>
ၜေါ|ḅo	<i>noun</i><br><ol><li>sugar cane</li></ol><br><i>verb</i><br><ol><li>to rinse out, to gargle</li></ol>
ၜဳ|ḅī	<i>noun</i><br><ol><li>river</li></ol>
ၜဳဒူ|ၜဳဒဵု|ṗīdeuw|ṗīdū	<i>noun</i><br><ol><li>cupboard, almirah.</li></ol>
ၜဴ|ḅau	<i>noun</i><br><ol><li>sugar cane (Saccharum officinarum)</li></ol><br><i>verb</i><br><ol><li>(Pak Kret District) to gargle, to rinse out</li></ol>
ၜဴလုပ်ပါၚ်စိၚ်|ḅau lup pāṅ ciṅ	<i>phrase</i><br><ol><li>(idiomatic) it cannot be undone anymore</li></ol>
ၜဵု|ḅuiw	<i>noun</i><br><ol><li>salt</li></ol>
ၝ|bbe	<i>character</i><br><ol><li>Bbe, the thirty-fifth consonant of the Mon alphabet.</li></ol><br><i>pron</i><br><ol><li>masc. you. Used in familiar address to inferiors, term of address and reference, usually peremptory or offensive, occasionally as as a noun phrase head.</li></ol>
ၝောံ	<i>noun</i><br><ol><li>female (of animals).</li><li>main component.</li></ol><br><i>adj</i><br><ol><li>female (of animals).</li></ol>
