آخر|أخرى|ʔāḵur|أخرات|أخرين|آخرين	<i>adj</i><br><ol><li>another, one more, other</li></ol>
آدى|يآديوا|نآدي|ʔāda|يآدي|آديوا|آديت|آديتوا|نآديوا|آدات|آدي|yʔādi|آداوا|آدينا|تآدي|تآديوا|آديتي	<i>verb</i><br><ol><li>to harm</li></ol>
آش|ʔāš	<i>adv</i><br><ol><li>(interrogative) what?</li></ol>
آنا|ʔāna|أنا|ʔana	<i>pron</i><br><ol><li>I (first person singular subject pronoun)</li></ol>
آه|ʔāh	<i>particle</i><br><ol><li>yes</li></ol>
أبجور|أبجورات|ʔabajūr	<i>noun</i><br><ol><li>bedside lamp</li></ol>
أبدا|ʔabda|ʔabadan	<i>adv</i><br><ol><li>never</li><li>(obsolete) never</li></ol>
أبط|أبطين|ʔabṭ	<i>noun</i><br><ol><li>armpit</li></ol>
أتاي|ʔatāy|tāy|تاي	<i>noun</i><br><ol><li>tea</li></ol>
أتت|yʔattat|أتّتوا|ʔattat|أتّتتوا|أتّتت|يأتت|نأتّتوا|تأتّتوا|تأتّتي|أتّتتي|يأتّتوا|أتّت|نأتّت|يأتّت|تأتّت|أتّتنا|أتّتي	<i>verb</i><br><ol><li>to furnish</li></ol>
أخ|خا|ḵū|خاوة|ʔaḵḵ|ḵā|أخت|خوت|خو	<i>noun</i><br><ol><li>brother, male sibling</li></ol>
أخطبوط|أخطبوطات|خطابط|ʔuḵṭubūṭ	<i>noun</i><br><ol><li>octopus</li></ol>
أدن|ودّنت|أدّننا|ودن|يودّنوا|تأدّنوا|ودّنتوا|تودّني|يأدن|تأدّن|waddan|نودّن|ودّن|ywaddan|تودّن|yʔaddan|يودن|أدّنتوا|تودّنوا|أدّن|ودّننا|نودّنوا|تأدّني|ودّنوا|أدّنت|يأدّن|يودّن|ودّنتي|نأدّنوا|ودّني|أدّنوا|ʔaddan|نأدّن|أدّني|يأدّنوا|أدّنتي	<i>verb</i><br><ol><li>to call to prayer</li></ol>
أستاد|أساتْدَة|ʔustād|أساتِدَة|أستادة	<i>noun</i><br><ol><li>professor; teacher</li><li>title of courtesy commonly given to individuals of high education or learning, best translated simply as mister</li></ol>
أش|ʔaš	<i>adv</i><br><ol><li>(interrogative) what</li></ol>
أشكون|ʔaškūn	<i>adv</i><br><ol><li>(interrogative) who?</li></ol>
أشمن|ʔašmen	<i>adv</i><br><ol><li>(interrogative) which?</li></ol>
أشنو|ʔašnu	<i>adv</i><br><ol><li>(interrogative) what?</li></ol>
ألف|آلاف|ʔalf|ألفَيْن|ألفِين	<i>num</i><br><ol><li>thousand</li></ol>
ألفين|ʔalfīn|ألفَيْن|ʔalfayn|ألفِين	<i>num</i><br><ol><li>two thousand</li></ol>
أما|ʔamma	<i>conj</i><br><ol><li>as for</li><li>but</li></ol>
أنا|ʔana	<i>adv</i><br><ol><li>(interrogative) which?</li></ol>
أول|أولين|ʔawwal|أولة|أولات|أوائل|أولى	<i>adj</i><br><ol><li>first</li></ol>
أي|ʔayy	<i>det</i><br><ol><li>any</li></ol>
أي حاجة|ʔayy ḥāja	<i>pron</i><br><ol><li>anything</li></ol>
أي حد|ʔayy ḥadd	<i>pron</i><br><ol><li>anyone</li></ol>
أي واحد|ʔayy wāḥed	<i>pron</i><br><ol><li>anyone</li></ol>
أڭادير|ʔagadīr	<i>name</i><br><ol><li>Agadir (a city in Morocco)</li></ol>
إبرة|ʔibra|إبرات|إباري|bra|برة|براوات	<i>noun</i><br><ol><li>needle</li></ol>
إترو|ʔītru|إتروات	<i>noun</i><br><ol><li>litre</li></ol>
إجاص|لنجاصات|نجاص|نجاصة|langāṣ|نجاصات|لنجاصة|ngāṣ|ʔijjāṣ|إجاصات|إجاصة|لنجاص	<i>noun</i><br><ol><li>pears</li></ol>
إدا|ʔidan|إدن|ʔila|إلا|ʔida	<i>conj</i><br><ol><li>if</li></ol><br><i>adv</i><br><ol><li>then, therefore</li></ol>
إلا|ʔila|ʔilla	<i>conj</i><br><ol><li>except, save</li><li>unless, if not</li></ol>
إنا|ʔina	<i>adv</i><br><ol><li>(interrogative) which?</li></ol>
إنسان|ʔinsān|إنسانة|ناس	<i>noun</i><br><ol><li>human being, person</li></ol>
إيميل|إيميلات|ʔimīl	<i>noun</i><br><ol><li>email</li></ol>
اتسنى|يتسنى|tsanna	<i>verb</i><br><ol><li>(transitive, intransitive) to wait</li></ol>
اختار|ḵtār|اختيار|يختار|مختار	<i>verb</i><br><ol><li>to choose</li><li>to select</li></ol>
ادى|يدي|edda	<i>verb</i><br><ol><li>to take</li></ol>
ارتاح|ertāḥ|يرتاح	<i>verb</i><br><ol><li>to rest, to relax</li><li>to find rest</li><li>to be satisfied</li></ol>
استأنف|استئناف|يستأنف|مستأنف|staʔnaf	<i>verb</i><br><ol><li>to resume</li><li>(law) to appeal</li></ol>
استاهل|يستاهل|stāhal	<i>verb</i><br><ol><li>to deserve</li></ol>
استصغر|staṣḡar|يستصغر	<i>verb</i><br><ol><li>to belittle someone</li></ol>
استغل|staḡall|مستغل|يستغلّ|استغلال	<i>verb</i><br><ol><li>to take advantage, to exploit</li></ol>
استنى|يستنى|stanna	<i>verb</i><br><ol><li>(transitive, intransitive) to wait</li></ol>
استهلك|stahlak|يستهلك	<i>verb</i><br><ol><li>(transitive) to use up, to consume, to expend</li></ol>
اسمية|اسميات|smiyya	<i>noun</i><br><ol><li>name</li></ol>
اضطر|ḍṭarr|يضطرّ	<i>verb</i><br><ol><li>to be forced, to be obliged</li></ol>
الاربع|l-ārbaʕ|الاربعة	<i>noun</i><br><ol><li>Wednesday</li></ol>
البارح|el-bāriḥ	<i>adv</i><br><ol><li>yesterday</li></ol><br><i>noun</i><br><ol><li>yesterday</li></ol>
البرطقيز|el-barṭqīz	<i>name</i><br><ol><li>Portugal (a country in Europe)</li></ol>
التلات|et-tlāt	<i>noun</i><br><ol><li>Tuesday</li></ol>
التنين|et-tnayn|التنِين|et-tnīn|التنَيْن	<i>noun</i><br><ol><li>Monday</li></ol>
الجزاير|el-jazāyir	<i>name</i><br><ol><li>Algeria (a country in Africa)</li></ol>
الجمعة|ej-jamʕa	<i>noun</i><br><ol><li>Friday</li></ol>
الحد|el-ḥadd	<i>noun</i><br><ol><li>Sunday</li></ol>
الخميس|el-ḵmīs|le-ḵmīs	<i>noun</i><br><ol><li>Thursday</li></ol>
الدار البيضا|ed-dār el-bayḍa|الدار البَيْضا|الدار البِيضا|ed-dār el-bīḍa	<i>name</i><br><ol><li>Casablanca (a city in Morocco)</li></ol>
السبت|es-sabt	<i>noun</i><br><ol><li>Saturday</li></ol>
العيد الصغير|el-ʕīd eṣ-ṣḡīr	<i>noun</i><br><ol><li>(Islam) Eid al-Fitr</li></ol>
القرد فعين امه غزال|el-qard f-ʕīn ummu ḡzāl	<i>proverb</i><br><ol><li>beauty is in the eye of the beholder</li></ol>
المغرب|المُغْرِب|المَغْرِب|el-muḡrib|el-maḡrib	<i>name</i><br><ol><li>Morocco (a country in Africa)</li></ol>
الهدرة ما تشري خضرة|el-hadra ma tašri ḵuḍra	<i>proverb</i><br><ol><li>talk is cheap</li></ol>
الهيه|el-hīh	<i>adv</i><br><ol><li>there</li></ol>
الهيهة|el-hīha	<i>adv</i><br><ol><li>there</li></ol>
اليوم|el-yūma|el-yūm	<i>adv</i><br><ol><li>today</li></ol>
امتى|ايمتى|ʔimta|ʔīmta	<i>adv</i><br><ol><li>(interrogative) when?</li></ol>
ايد|إيدين|يدين|إِيد|ʔīd	<i>noun</i><br><ol><li>(anatomy) hand</li></ol>
باب|bāb|bībān|بيبان|بواب	<i>noun</i><br><ol><li>door, gate</li></ol>
بابغيو|بابغيوات|bābḡayyu	<i>noun</i><br><ol><li>parrot</li></ol>
باربة|bārba|باربات	<i>noun</i><br><ol><li>beetroot</li></ol>
بارد|bārid|أبرد|براد|برد|باردات|باردة|باردين	<i>adj</i><br><ol><li>cold</li><li>dull</li></ol>
باز|bāz|بيزان	<i>noun</i><br><ol><li>falcon</li></ol>
باس|يبوس|بوسي|bās|بسنا|بست|باسوا|باست|تبوسي|بوسوا|تبوسوا|تبوس|نبوس|بوس|يبوسوا|بستي|نبوسوا|ybūs|بستوا	<i>verb</i><br><ol><li>to kiss</li></ol>
باش|bāš|baš|بَاش	<i>conj</i><br><ol><li>in order to, in order that, so that: followed by the subjunctive mood</li></ol><br><i>adv</i><br><ol><li>(interrogative) with what?</li></ol>
باع|باعوا|بعت|bāʕ|مبيوع|بيعوا|بيع|تبيع|بعتوا|بايع|بعنا|باعت|ybīʕ|نبيع|بيعي|يبيع|بعتي|تبيعي|تبيعوا|يبيعوا|نبيعوا	<i>verb</i><br><ol><li>(transitive, ditransitive) to sell</li></ol>
بال|بالت|بلتي|يبولوا|بول|تبول|بلت|بولي|بلنا|يبول|بالوا|تبولي|bāl|بلتوا|بولوا|تبولوا|نبولوا|نبول	<i>verb</i><br><ol><li>to urinate</li></ol><br><i>noun</i><br><ol><li>mind, state</li></ol>
بالأخص|b-el-ʔaḵaṣṣ	<i>adv</i><br><ol><li>especially</li></ol>
بالة|بالات|bāla	<i>noun</i><br><ol><li>shovel</li></ol>
بالتخبية|b-et-tḵabya	<i>adv</i><br><ol><li>hiddenly</li></ol>
بالتوفيق|bettawfīq	<i>intj</i><br><ol><li>good luck</li></ol>
بالخف|b-ek-ḵaff	<i>adv</i><br><ol><li>quickly</li></ol>
بالزاف|بزاف|bezzāf	<i>adv</i><br><ol><li>very</li></ol>
بالزايد|b-ez-zāyid	<i>adv</i><br><ol><li>more than enough</li></ol>
بالزربة|b-ez-zarba	<i>adv</i><br><ol><li>quickly</li></ol>
بالزهر|bezzhar	<i>adv</i><br><ol><li>by chance</li></ol>
بالسلامة|b-es-slāma	<i>intj</i><br><ol><li>goodbye, farewell</li></ol>
بالسيف|b-es-sīf	<i>adv</i><br><ol><li>by force</li></ol>
بالشوية|b-eš-šwiyya	<i>adv</i><br><ol><li>gradually</li><li>slowly</li></ol>
بالعاني|b-el-ʕāni	<i>adv</i><br><ol><li>intentionally, on purpose</li><li>jokingly</li></ol>
بالعكس|b-el-ʕaks	<i>adv</i><br><ol><li>on the contrary</li></ol>
بالمقلوب|b-el-maqlūb	<i>adv</i><br><ol><li>upside down</li><li>in a contrary sense</li></ol>
بانيو|bānyu|بانيوات	<i>noun</i><br><ol><li>bathtub</li></ol>
ببغة|ببغات|babbaḡa|ببغاوات	<i>noun</i><br><ol><li>parrot</li></ol>
ببوش|ببوشة|ببوشات|babbūš	<i>noun</i><br><ol><li>snails</li></ol>
بتبان|بتبانة|ptippān|بتبانات	<i>noun</i><br><ol><li>pain au chocolat</li></ol>
بجوج|بجوجهم|بجوجكم|bjūj|بجوجنا	<i>pron</i><br><ol><li>both</li></ol>
بحال|بحالكم|بحالهم|bḥāl|بحالها|بحالي|بحالك|بحالنا|بحاله	<i>prep</i><br><ol><li>similar to, like, as</li></ol>
بحال والو|bḥāl wālu	<i>prep_phrase</i><br><ol><li>probably</li></ol>
بحر|بحور|bḥar	<i>noun</i><br><ol><li>sea</li><li>beach</li></ol>
بحرا|baḥra	<i>adv</i><br><ol><li>just</li></ol>
بخير|b-ḵīr|b-ḵayr|bi-ḵayr|bi-ḵīr	<i>prep_phrase</i><br><ol><li>well, fine, okay, good</li></ol>
بدا|bdā|يبدا	<i>verb</i><br><ol><li>to begin, to start</li></ol>
برا|barra	<i>adv</i><br><ol><li>outside, outdoors</li></ol><br><i>prep</i><br><ol><li>outside</li></ol>
براد|barrād|برارد	<i>noun</i><br><ol><li>teapot</li></ol>
بربوق|بربوقات|بربوقة|barbūq	<i>noun</i><br><ol><li>a cannabis-based product made by frying the cannabis, then grinding it and finally sifting it.</li></ol>
بردان|bardān|بردانة|بردانات|بردانين	<i>adj</i><br><ol><li>cold (feeling of someone)</li></ol>
برطمة|barṭma|برطمات	<i>noun</i><br><ol><li>apartment, flat</li></ol>
برق|brīq|barq|بروقة|برقان|بروق|بريق	<i>noun</i><br><ol><li>lightning</li></ol>
برقوق|برقوقات|barqūq|برقوقة	<i>noun</i><br><ol><li>plums</li></ol>
برودة|brūda	<i>noun</i><br><ol><li>coldness</li></ol>
برودية|brūdiyya	<i>noun</i><br><ol><li>coldness</li></ol>
برويطة|barwīṭa|براوط|برويطات	<i>noun</i><br><ol><li>wheelbarrow</li></ol>
برى|نبراوا|برينا|بريتوا|تبرا|تبراوا|يبرا|يبراوا|بريتي|bra|براوا|نبرا|برا|برات|بريت|براي	<i>verb</i><br><ol><li>to recover (from illness)</li></ol>
برية|بريات|briyya	<i>noun</i><br><ol><li>letter (written or printed communication)</li></ol>
بريق|brīq|برقان	<i>noun</i><br><ol><li>coffee maker</li></ol>
بريكة|بريكات|brīka	<i>noun</i><br><ol><li>lighter (cigarette)</li></ol>
بزبوز|bazbūz|بزابز	<i>noun</i><br><ol><li>tap, faucet</li></ol>
بزطام|bazṭām|buzṭām|بزاطم|بُزطام|بَزطام	<i>noun</i><br><ol><li>wallet</li></ol>
بزق|yibzaq|يبزق|bzaq	<i>verb</i><br><ol><li>to spit</li></ol>
بزناس|biznās|بزناسة	<i>noun</i><br><ol><li>drug dealer</li></ol>
بزنس|baznas|يبزنس	<i>verb</i><br><ol><li>to deal (sell (illicit drugs))</li></ol>
بزولة|بزازل|bazzūla	<i>noun</i><br><ol><li>breast</li></ol>
بسباب|be-sbāb	<i>prep</i><br><ol><li>because of</li></ol>
بسباس|basbās	<i>noun</i><br><ol><li>fennel</li></ol>
بسبب|bsabab	<i>prep</i><br><ol><li>because of</li></ol>
بشكليطة|بِشْكْليطة|bšaklīṭ|بْشَكْليط|بْشَكْليطات|bišklīṭa|bšaklīṭa|بِشْكْليطات|بْشَكْليطة|بشكليط|بِشْكْليط	<i>noun</i><br><ol><li>bicycle</li></ol>
بصدفة|b-ṣudfa	<i>adv</i><br><ol><li>by chance</li></ol>
بطاطا|بْطَاطا|بطاطية|baṭāṭa|bṭāṭa|بطاطيات|بَطَاطا	<i>noun</i><br><ol><li>potato</li></ol>
بطاطا حلوة|بْطَاطا حلوة|بَطَاطا حلوة|baṭāṭa ḥluwwa|bṭāṭa ḥluwwa	<i>noun</i><br><ol><li>sweet potato</li></ol>
بطاطا مقلية|بَطَاطا مقلية|bṭāṭa maqliyya|baṭāṭa maqliyya|بْطَاطا مقلية	<i>noun</i><br><ol><li>french fries</li></ol>
بطانية|baṭṭāniyya|بطانيات	<i>noun</i><br><ol><li>blanket</li></ol>
بطبط|نبطبطوا|ybaṭbaṭ|بطبطنا|baṭbaṭ|بطبطتي|بطبطت|تبطبطوا|يبطبط|يبطبطوا|بطبطي|تبطبط|تبطبطي|بطبطتوا|نبطبط|بطبطوا	<i>verb</i><br><ol><li>to quack</li><li>(slang) to talk</li></ol>
بطعة|بطعات|baṭʕa	<i>noun</i><br><ol><li>crumb (soft internal portion of bread)</li></ol>
بعد بعد غدا|baʕd baʕd ḡadda	<i>adv</i><br><ol><li>two days after tomorrow</li></ol><br><i>noun</i><br><ol><li>two days after tomorrow</li></ol>
بعد غدا|baʕd ḡadda	<i>adv</i><br><ol><li>day after tomorrow, overmorrow.</li></ol><br><i>noun</i><br><ol><li>day after tomorrow, overmorrow.</li></ol>
بعيد|بعيدين|بعيدة|بعد|بعاد|أبعد|bʕīd|بعيدات	<i>adj</i><br><ol><li>far, remote, distant</li></ol>
بغى|yibḡi|bḡā|يبغي	<i>verb</i><br><ol><li>to want</li><li>to love</li></ol>
بقولة|baqqūla	<i>noun</i><br><ol><li>spinach</li></ol>
بقى|bqā|يبقى	<i>verb</i><br><ol><li>to remain, to stay</li></ol>
بكى|يبكي|bka	<i>verb</i><br><ol><li>(intransitive) to cry, to weep (over)</li></ol>
بلارج|ballārij|billārij	<i>noun</i><br><ol><li>stork</li></ol>
بلاصة|بلايص|بليصة|blāyiṣ|blāṣa	<i>noun</i><br><ol><li>place, location, spot</li></ol>
بلع|تبلّعي|تبلّعوا|بلّعتي|بلّعتوا|بلّعت|نبلّعوا|بلّعوا|نبلّع|blaʕ|بلّعنا|تبلّع|بلّع|yiblaʕ|بلّعي|يبلّع|يبلّعوا|yballaʕ|يبلع|ballaʕ	<i>verb</i><br><ol><li>(transitive) to swallow</li><li>(transitive) to close</li></ol>
بلوزة|blūza|بلايز|بلوزات	<i>noun</i><br><ol><li>uniform or coat with buttons down the front</li></ol>
بلية|بليات|balya	<i>noun</i><br><ol><li>addiction</li></ol>
بليد|بلد|balīd|بليدة|بلدة|بليدين|أبلد|بليدات	<i>adj</i><br><ol><li>stupid</li></ol>
بليزة|بليزات|بوالز|balīza	<i>noun</i><br><ol><li>suitcase</li></ol>
بنادم|بنادمين|بنادمة|بنادمية|bnādam|bnādim	<i>noun</i><br><ol><li>human being, person</li></ol>
بنان|banān|bnān|بنانة|بنانات	<i>noun</i><br><ol><li>banana</li></ol>
بناي|bannāy|بناية	<i>noun</i><br><ol><li>mason; builder</li></ol>
بنة|banna|بنات	<i>noun</i><br><ol><li>taste</li></ol>
بنت|بنوتة|بنية|بنات|bint	<i>noun</i><br><ol><li>daughter</li><li>girl (female child)</li><li>young woman</li></ol>
بنج|تبنّجي|ybannaj|بنّجتي|يبنّجوا|bannaj|يبنّج|بنّج|نبنّجوا|تبنّج|بنّجت|بنّجتوا|بنّجنا|يبنج|banj|بنّجوا|بنّجي|تبنّجوا|نبنّج	<i>noun</i><br><ol><li>sedative</li><li>anesthesia</li></ol><br><i>verb</i><br><ol><li>to sedate</li><li>to anesthetize</li></ol>
بنك|بنكات|bank|بنوك|بنوكة	<i>noun</i><br><ol><li>bank</li></ol>
بنين|bnīnīn|أبنن|bnān|بنن|بنان|بنينة|بنينات|bnīna|bnīn|bnīnāt|بنينين	<i>adj</i><br><ol><li>delicious</li></ol>
بهض|يبهض|bhaḍ	<i>verb</i><br><ol><li>to amaze</li></ol>
بهيمة|bhīma|بهايم	<i>noun</i><br><ol><li>head of cattle</li></ol>
بوا|buwwa	<i>noun</i><br><ol><li>(childish) water</li><li>(childish) drink</li></ol>
بواقة|بواوق|buwwāqa|بواقات	<i>noun</i><br><ol><li>bubble</li></ol>
بوبال|būbāl	<i>noun</i><br><ol><li>broccoli</li></ol>
بوبريص|būbrīṣ|بوبريصات	<i>noun</i><br><ol><li>lizard</li></ol>
بوخرارب|بوخراربات|būḵrārib	<i>noun</i><br><ol><li>sewage</li></ol>
بوسطة|būsṭa	<i>noun</i><br><ol><li>post office</li></ol>
بوطة|بوطات|būṭa	<i>noun</i><br><ol><li>gas canister</li></ol>
بوعويد|بوعويدة|būʕwīd|بوعويدات	<i>noun</i><br><ol><li>pears</li></ol>
بوغطاط|būḡaṭṭāṭ	<i>noun</i><br><ol><li>Synonym of حمار الليل (ḥmār el-līl, ḥmār el-layl, “sleep paralysis”)</li></ol>
بوكوص|بوكوصين|بوكوصة|būgūṣ	<i>noun</i><br><ol><li>(slang) good-looking guy</li></ol>
بول|būl	<i>noun</i><br><ol><li>urine</li></ol>
بوليس|būlīs	<i>noun</i><br><ol><li>police</li></ol>
بوم|būm|بومة|بومات	<i>noun</i><br><ol><li>owls</li></ol>
بياع|biyyāʕ|بياعة	<i>noun</i><br><ol><li>salesman, seller</li><li>(figuratively) sellout, traitor</li></ol>
بيبي|bībi	<i>noun</i><br><ol><li>turkey</li></ol>
بيت|بيّتتي|يبيّت|بَيْت|بيّت|bayt|بيوتة|تبيّت|بيّتي|يبيت|بيّتوا|بيّتت|بيّتنا|نبيّت|يبيّتوا|بِيت|تبيّتوا|نبيّتوا|تبيّتي|بيّتتوا|bīt|بيوت|bayyat	<i>noun</i><br><ol><li>room</li></ol><br><i>verb</i><br><ol><li>to put up someone for the night</li><li>to provide lodging</li></ol>
بيت الخزين|بَيْت الخزين|بيوتة الخزين|بييت الخزين|bayt le-ḵzīn|bīt le-ḵzīn|بيوت الخزين|بِيت الخزين	<i>noun</i><br><ol><li>storage room</li></ol>
بيت الراحة|بَيْت الراحة|bīt er-rāḥa|bayt er-rāḥa|بيوتة الما|بيوت الما|بِيت الراحة|بييت الما	<i>noun</i><br><ol><li>toilet</li></ol>
بيت الما|بَيْت الما|بيوتة الما|bīt el-mā|بِيت الما|bayt el-mā|بيوت الما|بييت الما	<i>noun</i><br><ol><li>toilet</li></ol>
بير|bīr|بيار	<i>noun</i><br><ol><li>well</li></ol>
بيرة|bīrra|بيرات	<i>noun</i><br><ol><li>beer</li></ol>
بيرمي|بيرميات|pīrmi	<i>noun</i><br><ol><li>driver's license</li></ol>
بيض|بويض|بَيْضين|byaḍ|بِيضين|بِيض|بَيْضا|bayḍ|بِيضا|بَيْضات|أبيض|بِيضات|بَيْضة|بِيضة|bīḍ|بَيْض	<i>adj</i><br><ol><li>white</li></ol><br><i>noun</i><br><ol><li>egg, eggs</li></ol>
بين|بينتوا|بينكم|بينتي|bayn|بينه|بينت|نبينوا|بَيْن|بينك|نبين|biyyan|bīn|بينا|تبين|بيننا|تبيني|بينوا|تبينوا|بينهم|بيني|يبين|يبينوا|بينها	<i>prep</i><br><ol><li>between (in the position or interval that separates two things)</li></ol><br><i>verb</i><br><ol><li>to make clear, to explain, to outline, to illustrate</li></ol>
بينما|bīnemma	<i>conj</i><br><ol><li>while</li></ol>
بيوضية|byūḍiyya	<i>noun</i><br><ol><li>whiteness</li></ol>
تاسع|tāsiʕ|تاسعين|تاسعات|تاسعة	<i>adj</i><br><ol><li>ninth</li></ol>
تاق|تيّقنا|tāq|تيّقي|تيقي|تيّقتي|تيّقتوا|نتيّق|يتيّقوا|نتيق|تقت|تيّقت|تيّقوا|تِيّق|تيّق|تتيّقوا|نتيّقوا|تيقتي|تقنا|tiyyaq|تقتوا|or يتَيّق|تتيقي|يتِيّق|ytīq|tayyaq|تاقت|تيقت|تيقتوا|نتيقوا|تتيقوا|تيق|تيقوا|يتيق|تيقنا|تتيّقي|تتيّق|تقتي|يتيقوا|تتيق|تَيّق|تاقوا|يتيّق	<i>verb</i><br><ol><li>to trust</li></ol>
تالت|تالتات|تالتين|tālit|تالتة	<i>adj</i><br><ol><li>third</li></ol>
تامن|تامنات|tāmin|تامنة|تامنين	<i>adj</i><br><ol><li>eighth</li></ol>
تانش|تانشة|تانشين|tāniš|تانشات	<i>adj</i><br><ol><li>twelfth</li></ol>
تاني|تانيات|tāni|tānya|تانيين|تانية	<i>adj</i><br><ol><li>second</li></ol>
تانية|tāniya|tānya|تواني	<i>noun</i><br><ol><li>second</li></ol>
تباكى|تباكت|تباكاي|تتباكاوا|تباكاوا|تتباكى|tbāka|تباكيتوا|تباكيتي|تباكيت|نتباكى|يتباكى|نتباكاوا|يتباكاوا|تباكينا	<i>verb</i><br><ol><li>to pretend to weep, to feign weeping</li></ol>
تبوريدة|تبوريدات|tbūrīda	<i>noun</i><br><ol><li>fantasia (traditional festival of the inhabitants of the Maghreb)</li></ol>
تحتت|نتحتّتوا|تحتّتي|يتحتت|تحتّتت|تتحتّت|يتحتّتوا|تتحتّتوا|تحتّت|تحتّتتوا|tḥattat|تحتّتوا|yitḥattat|نتحتّت|تحتّتتي|تتحتّتي|يتحتّت|تحتّتنا	<i>verb</i><br><ol><li>(transitive) to talk, to speak, to converse</li></ol>
تحمم|يتحمّم|تحمّمتي|نتحمّموا|يتحمّموا|تتحمّموا|تحمّمي|تتحمّم|تحمّمت|تحمّموا|نتحمّم|تحمّم|يتحمم|تحمّمتوا|yitḥammam|tḥammam|تتحمّمي|تحمّمنا	<i>verb</i><br><ol><li>(intransitive) to shower</li></ol>
تحميرة|taḥmīra	<i>noun</i><br><ol><li>paprika</li></ol>
تران|trān|ترانات	<i>noun</i><br><ol><li>(transport, railway) train</li></ol>
ترجمان|تراجمية|tarjmān|تَرجمان|تُرجمان|turjmān	<i>noun</i><br><ol><li>translator</li></ol>
ترنفيس|ترنفيسات|turnufīs|turnuvīs	<i>noun</i><br><ol><li>screwdriver</li></ol>
ترية|triyya|تريات	<i>noun</i><br><ol><li>chandelier</li></ol>
تزوج|تزوّجت|تزوّجتوا|تزوّج|تتزوّجوا|tzawwaj|yitzawwaj|يتزوج|يتزوّجوا|تزوّجنا|نتزوّجوا|يتزوّج|تتزوّجي|نتزوّج|تزوّجوا|تزوّجي|تزوّجتي|تتزوّج	<i>verb</i><br><ol><li>(reciprocal, intransitive) to get married (to each other)</li><li>(transitive or intransitive + ب (bi)) to marry (someone), to get married (to someone)</li><li>to take another spouse in addition to (+ على (ʕla))</li></ol>
تسارى|تساراوا|متساري|تتساراوا|تساراي|tsāra|نتساراوا|مسارية|تتسارى|يتساراوا|يتسارى|تساريت|تساريتي|تسارينا|مساري|تسارت|نتسارى|تساريتوا	<i>verb</i><br><ol><li>(intransitive) to sightsee</li></ol>
تسرع|تتسرّعوا|يتسرّع|تتسرّعي|تسرّعنا|نتسرّعوا|تسرّعي|تسرّعتوا|tsarraʕ|تسرّعت|تسرّعتي|تسرّع|تسرّعوا|تتسرّع|يتسرّعوا|نتسرّع	<i>verb</i><br><ol><li>to be hasty</li></ol>
تسعة|tisʕa|تسع	<i>num</i><br><ol><li>nine</li></ol>
تسعتاش|tsaʕtāš	<i>num</i><br><ol><li>nineteen</li></ol>
تسعمية|tisʕamya	<i>num</i><br><ol><li>nine hundred</li></ol>
تسعود|تسع|tisʕūd	<i>num</i><br><ol><li>nine</li></ol>
تسعين|tisʕīn	<i>num</i><br><ol><li>ninety</li></ol>
تشكليط|تشكليطة|tšaklīṭ	<i>noun</i><br><ol><li>masturbation</li></ol>
تصاب|tṣāb|يتصاب	<i>verb</i><br><ol><li>to be infected</li></ol>
تصالح|يتصالح|tṣālaḥ	<i>verb</i><br><ol><li>to make peace, to make up, to reconcile with one another</li></ol>
تصباع|taṣbāʕ|تصبيعة	<i>noun</i><br><ol><li>fingering (the act of using the fingers to penetrate and sexually stimulate one's own or another person's vagina or anus)</li></ol>
تصور|tṣawwar|تتصوّروا|يتصور|تصوّرتي|يتصوّروا|تصوّري|نتصوّروا|يتصوّر|تصوّرتوا|تصوّروا|تتصوّر|تتصوّري|تصوّر|تصوّرت|نتصوّر|تصوّرنا	<i>verb</i><br><ol><li>(intransitive) to be or become pictured, portrayed, photographed</li><li>(intransitive) to imagine, to conceive (something)</li><li>(ditransitive) to think (something, someone) to be (something, someone)</li><li>(intransitive) to photograph oneself</li></ol>
تصويرة|تصاور|taṣwīra	<i>noun</i><br><ol><li>picture, image</li></ol>
تصيد|تصيّدت|تصيّدتي|تتصيّدي|تصيّدتوا|تصيّدنا|يتصيّدوا|تصِيّد|يتصِيّد|tṣiyyad|تتصيّدوا|تصَيّد|يتصيّد|نتصيّدوا|تصيّد|تتصيّد|نتصيّد|tṣayyad|or يتصَيّد|تصيّدوا|تصيّدي	<i>verb</i><br><ol><li>to be hunted, to fished</li><li>to be duped</li></ol>
تفاح|teffāḥ|تِفَّاحَة|تفاحات|تُفَّاحَة|teffāḥa|تُفَّاحَ|تُفَّاح|تفاحة|tuffāḥ|تُفَّاحة|تِفَّاحَ|تُفَّاحَات|teffāḥāt|tuffāḥa|تِفَّاح|تِفَّاحة|تِفَّاحَات|tuffāḥāt	<i>noun</i><br><ol><li>(uncountable) apple, apples</li></ol>
تفادى|تفادينا|تفاداي|يتفادى|نتفادى|تفاداوا|تتفاداوا|تفاديتوا|يتفاداوا|تفادت|تتفادى|تفاديت|نتفاداوا|tfāda|تفاديتي	<i>verb</i><br><ol><li>to avoid, to evade</li></ol>
تفرج|تفرّج|نتفرّج|تفرّجتي|نتفرّجوا|تفرّجي|تتفرّجوا|تتفرّجي|يتفرّج|تفرّجت|تفرّجنا|تفرّجتوا|تتفرّج|يتفرّجوا|تفرّجوا|tfarraj|يتفرج|yitfarraj	<i>verb</i><br><ol><li>to watch</li></ol>
تفل|yitfal|tfal|يتفل	<i>verb</i><br><ol><li>to spit</li></ol>
تفوق|تفوّقتوا|تفوّق|تفوّقنا|تتفوّق|يتفوّقوا|تتفوّقي|تفوّقي|نتفوّقوا|تفوّقت|tfawwaq|يتوفق|نتفوّق|تفوّقوا|تفوّقتي|تتفوّقوا|يتفوّق	<i>verb</i><br><ol><li>to outperform</li><li>to hiccup</li><li>to burp, to belch</li></ol>
تفوه|نتفوّهوا|tfawwah|تفوّهتي|تتفوّه|تفوّهنا|نتفوّه|يتفوّه|تفوّه|يتفوه|تتفوّهوا|يتفوّهوا|تتفوّهي|تفوّهي|تفوّهت|تفوّهوا|تفوّهتوا|yitfawwah	<i>verb</i><br><ol><li>to yawn</li></ol>
تقبة|تقبات|tuqbāt|tqābi|tuqba|تقابي	<i>noun</i><br><ol><li>hole</li></ol>
تقة|tiqa	<i>noun</i><br><ol><li>reliance, confidence, trust</li><li>someone trustworthy, reliable; an authority</li></ol><br><i>adj</i><br><ol><li>trustworthy, reliable</li></ol>
تقريبا|taqrīban	<i>adv</i><br><ol><li>approximately</li></ol>
تقشيرة|تقيشيرة|taqšīra|تقشيرات|تقاشر	<i>noun</i><br><ol><li>sock</li></ol>
تقطيرة العين|تقطيرات العِين|تقطيرة العَيْن|تقطيرات العَيْن|taqṭīrat el-ʕayn|تقطيرة العِين|taqṭīrat el-ʕīn	<i>noun</i><br><ol><li>(medicine) eyedrop</li></ol>
تقل|يتقل|تقّلنا|تقّل|تقّلوا|تتقّلوا|تتقّلي|نتقّل|تقّلتوا|tqul|تقّلتي|taqqal|تتقّل|نتقّلوا|يتقّل|تقّلي|يتقّلوا|تقّلت	<i>verb</i><br><ol><li>(transitive) to make (something) heavy</li><li>(transitive) to burden something onto someone [+ على (object) = someone]</li></ol><br><i>noun</i><br><ol><li>weight</li><li>burden, load</li></ol>
تقن|or يتقُن|tqan|يتقَن|يُتقُن	<i>verb</i><br><ol><li>to perfect</li></ol>
تقولية|tqūliyya	<i>noun</i><br><ol><li>heaviness</li></ol>
تقيل|tqīl|تقل|تقال|تقيلين|تقيلة|أتقل|تقيلات	<i>adj</i><br><ol><li>heavy</li><li>slow</li></ol>
تكفات|تكفيتات|تكفيتة|takfāt	<i>noun</i><br><ol><li>(vulgar) masturbation</li></ol>
تلاتة|tlāta	<i>num</i><br><ol><li>three</li></ol>
تلاتة وتلاتين|tlāta w tlātīn	<i>num</i><br><ol><li>thirty-three</li></ol>
تلاتة وعشرين|tlāta w ʕašrīn	<i>num</i><br><ol><li>twenty-three</li></ol>
تلاتين|tlātīn	<i>num</i><br><ol><li>thirty</li></ol>
تلاجة|tallāja|تلاجات|تلالج	<i>noun</i><br><ol><li>refrigerator, fridge</li></ol>
تلاقى|تلاقاي|tlāqa|تلاقت|يتلاقاوا|يتلاقى|تلاقينا|نتلاقاوا|تلاقاوا|تلاقيت|تتلاقى|تلاقيتي|نتلاقى|تتلاقاوا|تلاقيتوا	<i>verb</i><br><ol><li>to meet up</li></ol>
تلتاش|tlattāš	<i>num</i><br><ol><li>thirteen</li></ol>
تلتمية|taltimya	<i>num</i><br><ol><li>three hundred</li></ol>
تلج|تلّجتوا|تلوجة|نتلّجوا|تلوج|تلّجت|تتلّجوا|تتلّج|تلّجتي|يتلّجوا|نتلّج|تلّجنا|تلّج|تتلّجي|تلّجي|يتلّج|تلّجوا|tallaj|talj	<i>noun</i><br><ol><li>snow</li></ol><br><i>verb</i><br><ol><li>to freeze</li></ol>
تلف|tallaf|تلّفتي|تلّفنا|تتلّفي|تلّفتوا|يتلّفوا|تلّفي|talf|يتلف|تتلّف|يتلّف|تلّفوا|tlaf|تلّف|نتلّف|نتلّفوا|تلّفت|تتلّفوا	<i>verb</i><br><ol><li>to get lost</li><li>to cause to get lost, to make someone get lost</li><li>to cause to lose focus</li></ol><br><i>noun</i><br><ol><li>act of losing</li></ol>
تلفت|يتلفت|تلفّتوا|تلفّتنا|يتلفّتوا|تلفّتتوا|تلفّت|تلفّتت|تتلفّتوا|تتلفّت|tlaffat|تلفّتي|نتلفّت|يتلفّت|نتلفّتوا|تلفّتتي|تتلفّتي	<i>verb</i><br><ol><li>to turn, to turn around, to turn one's face, to look around</li></ol>
تلفزة|talfaza|تلفزات|تلافز	<i>noun</i><br><ol><li>television, TV</li></ol>
تلفون|tilifūn|تلفونات|تلافن	<i>noun</i><br><ol><li>telephone</li></ol>
تلميد|تلميدة|تلامدة|talmīd|تلامد	<i>noun</i><br><ol><li>pupil, student, disciple</li></ol>
تم|temm|تمّْ|temma|تمَّ	<i>adv</i><br><ol><li>there</li></ol>
تمانين|tmānīn	<i>num</i><br><ol><li>eighty</li></ol>
تمة|temma	<i>adv</i><br><ol><li>there</li></ol>
تمرين|تمارن|tamrīn	<i>noun</i><br><ol><li>practice</li><li>exercise</li></ol>
تمنتاش|tmantāš	<i>num</i><br><ol><li>eighteen</li></ol>
تمنمية|tamnamya	<i>num</i><br><ol><li>eight hundred</li></ol>
تمنية|تمان|tmanya	<i>num</i><br><ol><li>eight</li></ol>
تمنية وتلاتين|tmanya w tlātīn	<i>num</i><br><ol><li>thirty-eight</li></ol>
تمنية وعشرين|tmanya w ʕašrīn	<i>num</i><br><ol><li>twenty-eight</li></ol>
تناش|tnāš	<i>num</i><br><ol><li>twelve</li></ol>
تنفع|تنفّعتوا|يتنفّعوا|يتنفع|تنفّعتي|yitnaffaʕ|تنفّعنا|تنفّعوا|نتنفّع|تتنفّعوا|تنفّعي|تنفّع|تتنفّع|تتنفّعي|يتنفّع|tnaffaʕ|تنفّعت|نتنفّعوا	<i>verb</i><br><ol><li>to enjoy</li></ol>
تنى|tnā|يتني	<i>verb</i><br><ol><li>(transitive) to fold, to bend</li></ol>
تنين|tnīn|tnayn|تنَيْن|تنِين	<i>num</i><br><ol><li>two</li></ol>
تنين وتلاتين|tnayn u tlātīn|تنِين وعشرين|tnīn u tlātīn|تنَيْن وتلاتين	<i>num</i><br><ol><li>thirty-two</li></ol>
تنين وعشرين|تنِين وعشرين|تنَيْن وعشرين|tnīn u ʕašrīn|tnayn u ʕašrīn	<i>num</i><br><ol><li>twenty-two</li></ol>
توام|twām	<i>noun</i><br><ol><li>one who was born of a multiple birth, i.e. a twin, triplet, quadruplet, etc.</li></ol>
توت|tūt|توتات|توتة	<i>noun</i><br><ol><li>berry</li></ol>
توحيمة|توحيمات|tawḥīma	<i>noun</i><br><ol><li>birthmark</li></ol>
تور|تيران|tūr|tawr	<i>noun</i><br><ol><li>bull, steer, ox</li></ol>
تونس|tūnes	<i>name</i><br><ol><li>Tunisia (a country in North Africa)</li><li>Tunis (the capital city of Tunisia)</li></ol>
تيق|تيّقنا|تيّقي|تيقي|تيّقتي|تيّقتوا|نتيّق|يتيّقوا|نتيق|تيّقت|تيّقوا|تِيّق|تيّق|تتيّقوا|نتيّقوا|تيقتي|tiyyaq|or يتَيّق|يتِيّق|تتيقي|tayyaq|تيقتوا|ytīq|تيقت|نتيقوا|تتيقوا|تيقوا|تيقنا|يتيق|تتيّقي|تتيّق|يتيقوا|تتيق|تَيّق|يتيّق	<i>verb</i><br><ol><li>to trust</li></ol>
تينة|tīna	<i>noun</i><br><ol><li>(vulgar) vagina</li></ol>
جا|نجيوا|jāy|مجية|يجيوا|mjī|ماجين|جات|ماجات|تجي|جاية|آجي|جيت|جاوا|māji|يجي|jā|yji|نجي|ماجية|majya|ماجي|جايات|ماجيين|or ييجي|جينا|مجي|ماجيات|آجيوا|مجيات|جايين|جاي|تجيوا|جيتي|جيتوا	<i>verb</i><br><ol><li>to come</li><li>to suit (to be suitable or apt for one's image) [+ مع (object)]</li><li>to arrive</li><li>(in the past tense) to be located</li><li>(in the present tense) to be related to someone</li></ol>
جاب|جيبي|جيبوا|يجيبوا|نجيبوا|تجيب|يجيب|جبتوا|جيب|yjīb|جبتي|جبنا|جابوا|نجيب|جبت|jāb|جابت|تجيبي|تجيبوا	<i>verb</i><br><ol><li>to bring</li><li>(construed with ل (l-, “to”) and always followed by الله (el-lāh, “God”) as the subject) to make one think</li></ol>
جار|جارة|جيران|jār	<i>noun</i><br><ol><li>neighbour</li></ol>
جاع|جاعوا|جعت|جعنا|جوعوا|جعتوا|جوعي|تجوعي|نجوع|جاعت|تجوع|جوع|تجوعوا|جعتي|نجوعوا|يجوعوا|يجوع|jāʕ	<i>verb</i><br><ol><li>to be hungry, to starve</li></ol>
جاكيطة|jākīṭāt|جاكيطات|jākīṭa|jwākiṭ|جواكط	<i>noun</i><br><ol><li>jacket (piece of clothing)</li></ol>
جامع|جوامع|jāmiʕ	<i>noun</i><br><ol><li>mosque</li></ol>
جاموس|gāmūs|jāmūs|جاموسة|جوامس	<i>noun</i><br><ol><li>buffalo</li></ol>
جانطة|jānṭa|جانطات	<i>noun</i><br><ol><li>wheelrim</li></ol>
جاهل|جاهلين|جهل|جهال|أجهل|جاهلة|جاهلات|jāhil|جهلة	<i>adj</i><br><ol><li>ignorant, illiterate, uneducated</li><li>having a blind rage</li></ol>
جاوب|جاوبنا|jāwab|جاوبتي|يجاوب|تجاوب|نجاوب|جاوبي|تجاوبي|نجاوبوا|جاوبتوا|جاوبت|يجاوبوا|تجاوبوا|جاوبوا	<i>verb</i><br><ol><li>to answer</li></ol>
جاي|jāy|جاية|جايين|جايات	<i>adj</i><br><ol><li>next</li></ol>
جبد|jbad|يجبد|yijbad	<i>verb</i><br><ol><li>to pull</li></ol>
جبر|اتجبر|يجبر|يتجبر|ettajbar|jbar	<i>verb</i><br><ol><li>to find</li></ol>
جبس	<i>noun</i><br><ol><li>gypsum</li><li>parget, plaster</li></ol>
جبن|جَبنات|جبَن|jbun|جُبنات|jban|جبُن|جبنة|جبان|جُبنة	<i>noun</i><br><ol><li>cheese</li></ol>
جبهة|jabha|جبهات|جباهي	<i>noun</i><br><ol><li>(anatomy) forehead</li><li>(figuratively) stubborn person</li></ol>
جد|جدود|jadd|جدة	<i>noun</i><br><ol><li>grandfather</li><li>ancestor</li></ol>
جدرمي|جدرميين|جدرميات|جدرمية|jadarmi|jadarmiyya	<i>noun</i><br><ol><li>gendarme</li></ol>
جدرمية|jadarmiyya|جدرميات	<i>noun</i><br><ol><li>gendarmerie</li></ol>
جديد|جدد|jdīd|جداد|جديدين|جديدة|جديدات|أجدد	<i>adj</i><br><ol><li>new</li></ol>
جر|جرّيت|نجرّ|جرّي|جرّ|تجرّي|تجرّوا|جرّوا|jarr|جرّينا|جرّيتي|تجرّ|يجرّ|جرّت|نجرّوا|يجرّوا|yjurr|يجر|جرّيتوا	<i>verb</i><br><ol><li>to pull, to draw, to drag, to attract</li></ol>
جراد|jrād|جرادة|جرادات	<i>noun</i><br><ol><li>locust; grasshopper</li></ol>
جران|jrān|جرانات|جرانة	<i>noun</i><br><ol><li>frog</li></ol>
جرب|جرّب|جرّبنا|جرّبوا|جرّبي|نجرّب|جرّبتوا|يجرّبوا|تجرّبي|نجرّبوا|تجرّبوا|jarrab|يجرّب|جرّبت|تجرّب|جرّبتي|يجرب	<i>verb</i><br><ol><li>to try</li></ol>
جرح|جُرح|jarḥ|jraḥ|جَرح|جراح|jurḥ|يجرح|جروح	<i>verb</i><br><ol><li>to wound, to injure, to hurt</li><li>to offend</li></ol><br><i>noun</i><br><ol><li>wound</li></ol>
جردة|جردات|جرادي|جريدة|jarda	<i>noun</i><br><ol><li>garden</li></ol>
جرى|جرّينا|يجرّي|jarra|يجري|جرّيوا|جرّي|تجرّي|جرّيتي|yjarri|يجرّيوا|jra|تجرّيوا|جرّيت|جرّى|نجرّي|جرّات|نجرّيوا|جرّاوا|yijri|جرّيتوا	<i>verb</i><br><ol><li>to run</li><li>to happen, to occur</li><li>to make (someone) leave</li><li>to fire (terminate the employment of) [+ على (object)]</li></ol>
جزايري|جزايرية|jazāyri|جزايريين	<i>noun</i><br><ol><li>Algerian</li></ol>
جعدة|jaʕda|جعدات	<i>noun</i><br><ol><li>carrot</li></ol>
جلبانة|جلبان|jalbān|jalbāna	<i>noun</i><br><ol><li>peas</li></ol>
جلس|gallas|جلّستي|يجلّس|جلّستوا|تجلّسي|جلّسي|جلّست|يجلّسوا|glas|نجلّس|نجلّسوا|جلّسوا|تجلّسوا|تجلّس|جلّسنا|يجلس|جلّس	<i>verb</i><br><ol><li>to sit down</li><li>to cause to sit down</li></ol>
جمودية|jmūdiyya	<i>noun</i><br><ol><li>freezing</li></ol>
جميل|جميلين|جميلة|جميلات|أجمل|جمل|جمال|jmīl	<i>adj</i><br><ol><li>beautiful</li></ol><br><i>noun</i><br><ol><li>good deed, favor, benefit</li></ol>
جناح|جناحات|jnāḥ|جوانح	<i>noun</i><br><ol><li>wing</li></ol>
جنب|janb|جناب	<i>noun</i><br><ol><li>side, flank</li></ol>
جنوب|janūb	<i>noun</i><br><ol><li>south</li></ol>
جهة|jiha|جوايه|جهات	<i>noun</i><br><ol><li>side, way</li><li>administrative region</li></ol>
جواب|جوابات|أجوبة|jawāb|jwāb	<i>noun</i><br><ol><li>answer, reply</li></ol>
جوان|جوانات|jwān	<i>noun</i><br><ol><li>joint, marijuana cigarette</li></ol>
جوج|jūj	<i>num</i><br><ol><li>two</li></ol>
جوق|جواق|جُوق|jūq|jawq|جَوق	<i>noun</i><br><ol><li>music group</li></ol>
جوقة|jūqa|جواق|جُوقة|jawqa|جَوقة	<i>noun</i><br><ol><li>group of people</li></ol>
جيب|جيوبة|جويب|جيوب|jīb	<i>noun</i><br><ol><li>pocket</li></ol>
جيعان|jīʕān|جيعانة|جيعانين|جيعانات	<i>adj</i><br><ol><li>hungry</li></ol>
حابة|ḥāba	<i>noun</i><br><ol><li>zombie tag</li></ol>
حاجب|حجبان|ḥājib	<i>noun</i><br><ol><li>(anatomy) eyebrow</li></ol>
حاجيتك ما جيتك|ḥājītak mā jītak	<i>phrase</i><br><ol><li>(used at the beginning of children's stories) once upon a time</li></ol>
حادش|ḥādiš|حادشة|حادشات|حادشين	<i>adj</i><br><ol><li>eleventh</li></ol>
حار|حرة|حر|ḥarr|حرات|حرين|hārr|حارين|حارات|حارة	<i>adj</i><br><ol><li>spicy</li></ol>
حامض|ḥāmḍāt|حامضات|أحمض|ḥāmiḍ|حامضين|ḥāmḍa|حمض|حامضة|ḥāmḍīn	<i>noun</i><br><ol><li>lemon</li></ol><br><i>adj</i><br><ol><li>sour</li><li>unfunny</li></ol>
حامى|حامي|yḥāmi|حامينا|يحامي|يحاميوا|تحامي|حامت|حاميتي|نحاميوا|تحاميوا|حاميت|حاميتوا|نحامي|حاماوا|ḥāma|حاميوا	<i>verb</i><br><ol><li>(construed with على) to defend</li></ol>
حب|تحبّوا|yḥabb|حبّيتوا|يحبّوا|حبّت|حبّوا|يحبّ|تحبّي|حبّيتي|نحبّ|حبّيت|يحب|نحبّوا|تحبّ|ḥabb|ḥubb|حبّينا|حبّي|حبّ	<i>verb</i><br><ol><li>to love</li></ol><br><i>noun</i><br><ol><li>love</li></ol>
حبا|يحبو|ḥba	<i>verb</i><br><ol><li>to crawl</li></ol>
حبس|ḥabs|حباس|حباسات|حبوسات|ḥbas|يحبس	<i>noun</i><br><ol><li>prison</li></ol><br><i>verb</i><br><ol><li>to imprison</li><li>to quit (to give up, stop doing something)</li><li>to guard (a goal post)</li></ol>
حبق|ḥbaq|حبوقة	<i>noun</i><br><ol><li>basil</li><li>vase</li></ol>
حبيب|حباب|ḥbīb|حبيبة	<i>noun</i><br><ol><li>beloved</li><li>sweetheart</li><li>dear</li><li>darling</li><li>maternal uncle</li></ol>
حتى حاجة|ḥatta ḥāja	<i>noun</i><br><ol><li>nothing</li></ol><br><i>pron</i><br><ol><li>nothing</li></ol>
حج|نحجّ|حجّيت|تحجّوا|ḥagg|ḥajj|حجّيتوا|حجّ|حجّيتي|تحجّ|نحجّوا|يحج|تحجّي|حجّوا|يحجّوا|حجّينا|yḥujj|يحُج|يحجّ|حجّت|حجّي|yḥajj|or يحَج	<i>verb</i><br><ol><li>to make a pilgrimage to mecca</li></ol><br><i>noun</i><br><ol><li>(religion) pilgrimage</li><li>(Islam) hajj (pilgrimage to Mecca according to a specific ritual)</li></ol>
حدا|حداهم|حدانا|حداي|حداكم|حداها|ḥdā|حداك|حداه	<i>prep</i><br><ol><li>near, next to</li></ol>
حدادة|ḥaddāda|حدادات	<i>noun</i><br><ol><li>smoothing iron</li></ol>
حداش|ḥdāš	<i>num</i><br><ol><li>eleven</li></ol>
حدد|يحدد|ḥaddad|حدّدنا|يحدّد|حدّدي|يحدّدوا|نحدّد|حدّدتوا|حدّدتي|نحدّدوا|تحدّدي|تحدّد|حدّدوا|تحدّدوا|حدّدت|حدّد	<i>verb</i><br><ol><li>to iron (to pass an iron over clothing)</li><li>to forge iron</li></ol>
حديد|ḥdīd|حدايد|حديدات|حديدة	<i>noun</i><br><ol><li>(uncountable) iron</li><li>cars</li></ol>
حر|حرة|ḥarr|ḥurr|حرار|حرات|حرين	<i>noun</i><br><ol><li>spiciness</li><li>free (not imprisoned)</li></ol>
حرارة|ḥarāra	<i>noun</i><br><ol><li>heat</li><li>temperature</li></ol>
حرق|or يِحرق|يَحرق|ḥraq	<i>verb</i><br><ol><li>to burn</li><li>to spoil (reveal the ending)</li></ol>
حرورية|ḥrūriyya	<i>noun</i><br><ol><li>spiciness</li></ol>
حزاق|ḥzāq	<i>noun</i><br><ol><li>fart, flatus</li><li>(figuratively) state of having no money</li></ol>
حزر|حزّرنا|يحزّر|حزّري|ḥazzar|تحزّر|حزّر|تحزّري|حزّرت|تحزّروا|نحزّر|يحزّروا|نحزّروا|حزّروا|حزّرتوا|حزّرتي	<i>verb</i><br><ol><li>to butter up</li></ol>
حسان|ḥassān|حسانة	<i>noun</i><br><ol><li>barber</li></ol>
حسي مسي|ḥassi massi	<i>adv</i><br><ol><li>on the sly, secretly</li></ol>
حشمان|حشمانات|ḥašmān|حشمانة|حشمانين	<i>adj</i><br><ol><li>shy</li></ol>
حشمة|ḥašma	<i>noun</i><br><ol><li>shyness</li></ol>
حشومي|حشوميات|ḥaššūmi|حشوميين|ḥaššūmiyya|حشومية	<i>adj</i><br><ol><li>shy</li></ol>
حشومية|ḥaššūmiyya|ḥšūmiyya	<i>noun</i><br><ol><li>shyness</li></ol>
حصل|حصّلت|يحصل|نحصّل|تحصّلي|حصّلتي|حصّلتوا|تحصّل|يحصّل|تحصّلوا|ḥaṣṣal|نحصّلوا|يحصّلوا|حصّلنا|حصّلوا|حصّلي|ḥṣal|حصّل	<i>verb</i><br><ol><li>to be stuck</li><li>to obtain [+ على (object)]</li><li>to trap</li></ol>
حصيرة|حصيرات|حصير|ḥṣīra|حصاير	<i>noun</i><br><ol><li>mat</li></ol>
حط|يحط|حطّيتوا|حطّيتي|يحطّوا|تحطّي|yḥuṭṭ|تحطّوا|تحطّ|ḥaṭṭ|يحطّ|حطّينا|نحطّوا|حطّت|حطّيت|حطّي|حطّ|نحطّ|حطّوا	<i>verb</i><br><ol><li>to put</li></ol>
حطيشة|ḥuṭṭayša|حطيشات	<i>noun</i><br><ol><li>swing (for children)</li></ol>
حفيد|حفيدات|حفيدة|حفاد|حفايد|ḥfīda|ḥfīd	<i>noun</i><br><ol><li>grandson</li></ol>
حفيدة|حفيدات|حفاد|حفايد|ḥfīda|ḥfīd|حفيد	<i>noun</i><br><ol><li>granddaughter</li></ol>
حك|حكّ|حكّوا|تحكّي|تحكّوا|يحك|yḥukk|يحكّ|حكّي|يحكّوا|نحكّوا|حكّينا|حكّت|حكّيت|حكاك|ḥakk|حكّيتي|حكّيتوا|ḥukk|ḥkāk|تحكّ|نحكّ	<i>noun</i><br><ol><li>can</li></ol><br><i>verb</i><br><ol><li>to rub</li><li>to scrape, to scratch</li></ol>
حكاكة|ḥakkāka|حكاكات	<i>noun</i><br><ol><li>grater</li></ol>
حل|تحلّوا|يحلّ|حلّيتوا|تحلّ|نحلّوا|يحلّوا|حلّي|ḥall|حلّيتي|حلّ|نحلّ|حلول|حلّيت|تحلّي|حلّوا|يحل|حلّت|حلّينا	<i>noun</i><br><ol><li>solution</li></ol><br><i>verb</i><br><ol><li>to loosen</li><li>to open</li><li>to solve</li></ol>
حلاق|ḥallāq|حلاقة	<i>noun</i><br><ol><li>barber</li></ol>
حلان|ḥullān	<i>noun</i><br><ol><li>solving</li><li>opening</li><li>loosening</li></ol>
حلاوة|ḥlāwa	<i>noun</i><br><ol><li>sweetness</li></ol>
حلقة|حلقات|ḥalaqa|ḥalqa	<i>noun</i><br><ol><li>earring</li><li>(media) show; episode (single edition of a serial program)</li><li>circle of people</li></ol>
حلمة|حلمات|ḥalma	<i>noun</i><br><ol><li>dream</li></ol>
حلو|ḥluwwa|أحلى|حلوين|حلوة|حلوات|ḥluww|حلى	<i>adj</i><br><ol><li>sweet</li></ol>
حلوة|ḥluwwa|حلاوي|حلوات|ḥalwa	<i>noun</i><br><ol><li>dessert</li></ol>
حلوف|ḥallūf|حلوفة|حلالف	<i>noun</i><br><ol><li>pig</li></ol>
حليب|ḥlīb	<i>noun</i><br><ol><li>milk</li><li>(slang, vulgar) semen</li></ol>
حمار|حمارة|حمير|ḥmāra|ḥmīr|حمارات|ḥmār	<i>noun</i><br><ol><li>donkey, ass</li><li>(vulgar) idiot, dumbass</li></ol>
حمار الليل|حمار اللِيل|حمار اللَيْل|ḥmār el-līl|ḥmār el-layl	<i>noun</i><br><ol><li>sleep paralysis</li></ol>
حمام|ḥammām|حمامات|ḥmām|حمامة	<i>noun</i><br><ol><li>bath, bathroom</li><li>bathhouse, spa</li><li>dove, pigeon</li></ol>
حمر|حمرا|حمرات|ḥamrīn|أحمر|ḥmar|حومر|ḥamrāt|ḥamra|حمرين	<i>adj</i><br><ol><li>red</li></ol>
حمم|حمّم|يحمم|حمّمتي|تحمّمي|يحمّم|تحمّموا|ḥammam|نحمّم|تحمّم|يحمّموا|حمّموا|حمّمتوا|حمّمنا|حمّمي|حمّمت|نحمّموا	<i>verb</i><br><ol><li>(transitive) to shower</li></ol>
حمورة|ḥmūra	<i>noun</i><br><ol><li>redness</li></ol>
حمورية|ḥmūriyya	<i>noun</i><br><ol><li>redness</li></ol>
حمى|ḥma|يحمي	<i>verb</i><br><ol><li>to bake</li><li>to protect</li></ol>
حنا|ḥna	<i>pron</i><br><ol><li>we (subject pronoun)</li></ol>
حنة|ḥanna	<i>noun</i><br><ol><li>henna</li></ol>
حنجر|ḥanjar|يحنجر	<i>verb</i><br><ol><li>(informal) to eat</li></ol>
حنجرة|حناجر|ḥanjra|حنجرات	<i>noun</i><br><ol><li>throat, larynx</li></ol>
حنش|ḥanš|حنوشة|حناش|حنوش	<i>noun</i><br><ol><li>snake</li><li>(derogatory) policeman</li></ol>
حنك|حنكين|حناك|ḥank	<i>noun</i><br><ol><li>cheek</li></ol>
حوات|حواتة|ḥawwāt	<i>noun</i><br><ol><li>fishmonger</li></ol>
حوايج|ḥwāyij	<i>noun</i><br><ol><li>clothes</li></ol>
حوت|حوتات|ḥūt|حوتة	<i>noun</i><br><ol><li>fish</li></ol>
حوتة واحدة كتخنز الشواري|ḥūta waḥda katḵannaz eš-šwāri	<i>proverb</i><br><ol><li>one bad fish can spoil the whole pond</li></ol>
حوس|يحوس|تحوّسي|حوّستي|يحوّسوا|حوّسنا|تحواس|يحوّس|تحوّسوا|نحوّس|محوس|حوّست|حوّسوا|حوّستوا|حوّس|حوّسي|نحوّسوا|تحوّس|ḥawwas	<i>verb</i><br><ol><li>to search, to look for</li><li>to stroll, to go for a walk</li></ol>
حولي|حوالة|حولية|ḥawliyya|ḥawli	<i>noun</i><br><ol><li>sheep</li></ol>
حي|حَي|ḥayy|حيات|ḥiyy|حية|حيين|أحياء	<i>adj</i><br><ol><li>alive</li></ol><br><i>noun</i><br><ol><li>neighbourhood</li></ol>
حيت|ḥīt	<i>conj</i><br><ol><li>because</li></ol>
حيط|حيطان|ḥayṭ|حيوط|ḥīṭ|حَيْط|حيوطة	<i>noun</i><br><ol><li>wall</li></ol>
خاد|خدى|خديتي|ياخدوا|خديت|خدت|ḵda|خدتي|خادوا|ناخد|خودوا|تاخدي|تاخد|خداوا|تاخدوا|ياخد|ناخدوا|ḵād|خدينا|خدات|خودي|خدتوا|خدنا|خود|خادت|خديتوا	<i>verb</i><br><ol><li>to take</li></ol>
خاص|ḵāṣṣ|أخص|خاصة|خاصين|خاصات|خواص	<i>adj</i><br><ol><li>special</li><li>particular</li><li>specific</li><li>designated (ب (b-) for)</li><li>characteristic (ب (b-) of)</li><li>private</li></ol><br><i>prep</i><br><ol><li>(false verb) should; need</li></ol>
خاف|خفت|خافوا|يخاف|تخافي|خفتوا|خافي|خفتي|تخاف|نخاف|تخافوا|يخافوا|خفنا|نخافوا|ḵāf|خافت	<i>verb</i><br><ol><li>to fear</li></ol>
خامج|خامجين|خامجات|خمج|خامجة|ḵāmij|أخمج	<i>adj</i><br><ol><li>rotten</li><li>gone bad</li></ol>
خامس|خامسين|ḵāmis|خامسات|خامسة	<i>adj</i><br><ol><li>fifth</li></ol>
خامية|خوامي|خاميات|ḵāmiyya	<i>noun</i><br><ol><li>curtain</li></ol>
خاوي|خاويات|ḵāwīn|ḵāwya|خاوية|خاويين|ḵāwyīn|ḵāwyāt|ḵāwi|خاوين	<i>adj</i><br><ol><li>empty</li></ol>
خباز|ḵabbāz|خبازة	<i>noun</i><br><ol><li>baker</li></ol>
خبر|أخبار|خبار|يخبر|ḵbar|ḵabar	<i>verb</i><br><ol><li>(transitive) to notify, to inform</li></ol><br><i>noun</i><br><ol><li>report, message, notification</li><li>news</li><li>information</li></ol>
خبز|خبزتين|ḵubza|خبزة|خبزات|ḵubz|ḵbaz|يخبز	<i>noun</i><br><ol><li>bread</li></ol><br><i>verb</i><br><ol><li>to bake</li></ol>
خبع|يخبّع|خبّع|خبّعتوا|تخبّعي|يخبع|خبّعت|يخبّعوا|خبّعي|نخبّعوا|خبّعنا|ḵabbaʕ|تخبّع|تخبّعوا|خبّعوا|خبّعتي|نخبّع	<i>verb</i><br><ol><li>(transitive) to hide, to conceal, to cloak</li></ol>
خبى|خبّيوا|يخبّي|خبّيتوا|تخبّي|خبّاوا|خبّات|خبّينا|خبّيت|يخبي|نخبّي|خبّي|خبّى|تخبّيوا|ḵabba|نخبّيوا|يخبّيوا|خبّيتي	<i>verb</i><br><ol><li>(transitive) to hide, to conceal, to cloak</li></ol>
ختانة|ختانات|ḵtāna	<i>noun</i><br><ol><li>circumcision</li></ol>
خد|خدود|ḵadd|خدين	<i>noun</i><br><ol><li>cheek</li></ol>
خدمة|خدمات|خدامي|ḵadma	<i>noun</i><br><ol><li>work, job</li></ol>
خدية|خدايد|ḵaddiyya|خديات	<i>noun</i><br><ol><li>pillow, cushion</li></ol>
خرج|خرّج|ḵraj|نخرّج|خرّجت|ḵarraj|خرّجوا|تخرّجوا|يخرج|نخرّجوا|خرّجتي|تخرّج|تخرّجي|خرّجنا|خرّجتوا|يخرّجوا|يخرّج|خرّجي	<i>verb</i><br><ol><li>to go out</li><li>to exit [+ من (object)]</li><li>to deviate from, to stop to conform to [+ على (object)]</li><li>to ruin [+ على (object)]</li><li>to take out, to bring out, to get out</li><li>to solve</li></ol>
خرشف|ḵuršuf|خرشفة|خرشفات	<i>noun</i><br><ol><li>artichoke</li></ol>
خرشوف|خرشوفة|ḵaršūf|خرشوفات	<i>noun</i><br><ol><li>artichoke</li></ol>
خرطال|ḵarṭāl	<i>noun</i><br><ol><li>oat</li></ol>
خرقة|خروق|ḵarqa	<i>noun</i><br><ol><li>rag, tatter, shred</li><li>diaper</li></ol>
خرقوم|ḵarqūm	<i>noun</i><br><ol><li>turmeric</li></ol>
خروف|نعجة|نعجات|خروفة|خرفان|ḵrūfa|خروفات|naʕja|ḵrūf	<i>noun</i><br><ol><li>sheep</li><li>lamb</li></ol>
خريف|ḵrīf|خرايف	<i>noun</i><br><ol><li>autumn, fall</li></ol>
خزر|يِخزُر|or يُخزُر|ḵzar	<i>verb</i><br><ol><li>to look</li></ol>
خس|خسات|خسة|ḵuss	<i>noun</i><br><ol><li>lettuce</li></ol>
خضار|ḵaḍḍār|خضارة	<i>noun</i><br><ol><li>greengrocer</li></ol>
خضرة|ḵuḍra	<i>noun</i><br><ol><li>(uncountable) vegetables</li></ol>
خضورية|ḵḍūriyya	<i>noun</i><br><ol><li>greenness</li></ol>
خطيب|ḵaṭīb|خطيبة|خطاب	<i>noun</i><br><ol><li>fiancé</li></ol>
خطير|خطيرين|خطار|أخطر|خطيرات|ḵaṭīr|خطيرة	<i>adj</i><br><ol><li>dangerous, risky</li><li>great</li><li>amazing</li><li>powerful</li></ol>
خفاش|ḵuffāš|خفافش	<i>noun</i><br><ol><li>bat (winged animal)</li></ol>
خفوفية|ḵfūfiyya	<i>noun</i><br><ol><li>lightness (the state of having little weight)</li></ol>
خفيف|ḵfīf|خفف|خفيفة|خفاف|أخفف|خفيفات|خف	<i>adj</i><br><ol><li>light (in weight)</li><li>agile</li></ol>
خلخال|ḵalḵāl|خلاخل	<i>noun</i><br><ol><li>anklet</li></ol>
خلص|خلّص|خلّصي|yḵallaṣ|خلّصتي|نخلّص|تخلّصي|خلّصنا|يخلص|تخلّص|خلّصت|يخلّص|نخلّصوا|تخلّصوا|يخلّصوا|ḵallaṣ|خلّصوا|خلّصتوا	<i>verb</i><br><ol><li>to pay</li></ol>
خلصة|ḵulṣa|خلصات	<i>noun</i><br><ol><li>salary, pay, wages</li></ol>
خلى|يخلّي|خلّيوا|خلّينا|خلّيتوا|yḵalli|خلّيت|خلّات|خلّيتي|نخلّيوا|خلّى|تخلّيوا|نخلّي|ḵalla|يخلّيوا|خلّاوا|يخلي|تخلّي|خلّي	<i>verb</i><br><ol><li>to leave, to let</li></ol>
خمس|ḵumus|ḵams|خماس|خمسين	<i>noun</i><br><ol><li>fifth (fraction)</li></ol>
خمسة|ḵams|ḵamsa|خمس	<i>num</i><br><ol><li>five</li></ol>
خمسة وتلاتين|ḵamsa w tlātīn	<i>num</i><br><ol><li>thirty-five</li></ol>
خمسة وعشرين|ḵamsa w ʕašrīn	<i>num</i><br><ol><li>twenty-five</li></ol>
خمستاش|ḵmastāš|ḵamistāš|خْمَستاش|خَمِستاش	<i>num</i><br><ol><li>fifteen</li></ol>
خمسمية|xamsamya	<i>num</i><br><ol><li>five hundred</li></ol>
خمسين|xamsīn	<i>num</i><br><ol><li>fifty</li></ol>
خميرة|ḵmīra|خماير	<i>noun</i><br><ol><li>yeast</li></ol>
خنزير|ḵanzīr|خنزيرة|خنازر	<i>noun</i><br><ol><li>pig</li></ol>
خنشة|خناشي|ḵanša|خنشات	<i>noun</i><br><ol><li>bag</li></ol>
خنفوس|خنفوسة|خنافس|خنفوسات|ḵanfūs	<i>noun</i><br><ol><li>beetle</li></ol>
خنق|ḵnaq|يخنق	<i>verb</i><br><ol><li>(transitive) to strangle, to throttle, to choke</li></ol>
خنونة|خناين|خنونات|ḵnūna	<i>noun</i><br><ol><li>mucus, snot</li><li>someone easy to manipulate</li><li>(derogatory) homosexual, gay</li></ol>
خوخ|خوّختي|خوخات|ḵūḵa|خوّخوا|مخوخ|يخوّخوا|خوّخنا|خوّخت|تخواخ|خوّخ|تخوّخ|خوخة|ḵawwaḵ|يخوّخ|نخوّخوا|يخوخ|تخوّخي|خوّخي|نخوّخ|خوّختوا|ḵūḵ|تخوّخوا	<i>noun</i><br><ol><li>peaches</li></ol><br><i>verb</i><br><ol><li>to hollow out</li><li>to decay, to rot</li></ol>
خياط|ḵiyyāṭ|خياطة	<i>noun</i><br><ol><li>tailor, seamster</li></ol>
خيبوعة|خيبوعات|ḵaybūʕa	<i>adj</i><br><ol><li>(derogatory) ugly</li></ol>
خيزو|خيزووات|خيزووة|خيزويات|ḵizzu|خزوية|خزو|خزووات|ḵīzzu|خزويات|خزووة|خيزوية	<i>noun</i><br><ol><li>carrot, carrots</li></ol>
خيط|نخيطوا|يخيط|نخيط|خيطوا|ḵīṭ|خَيْط|يخيطوا|تخيطي|خيطنا|ḵiyyaṭ|ḵayṭ|خيوط|خيطتي|خيطت|تخيط|خيوطة|تخيطوا|خيطي|خِيط|خيطتوا	<i>verb</i><br><ol><li>to sew</li><li>(idiomatic) to stroll</li></ol><br><i>noun</i><br><ol><li>thread, string, cable</li></ol>
داب|يدوبوا|دوبي|ندوب|ydūb|دبتي|تدوب|دوبوا|دبتوا|دابوا|ندوبوا|دبت|تدوبوا|dāb|دوب|دبنا|تدوبي|يدوب|دابت	<i>verb</i><br><ol><li>(intransitive) to melt, to dissolve</li></ol>
دابا|dāba|دبا	<i>adv</i><br><ol><li>now; right now; at present</li></ol>
داخ|ندوخوا|دوّخي|تدوّخ|داخت|دوّخت|تدوّخي|دوخي|يدوخ|يدوّخ|تدواخ|ندوّخوا|دوّخ|تدوخ|دختوا|مدوخ|تدوّخوا|دوخوا|تدوخوا|دوخان|دايخ|تدوخي|دخت|داخوا|دوّختي|ندوّخ|dawwaḵ|دوّخنا|دوّخوا|dāḵ|دوخة|يدوّخوا|ندوخ|دختي|دوخ|يدوخوا|دخنا|دوّختوا	<i>verb</i><br><ol><li>to become dizzy</li></ol>
دار|تدوري|دارت|تدوروا|ديري|يدوروا|دير|درتوا|ديورة|ندير|dār|dwīra|دوروا|داروا|ندوروا|تدور|يديروا|درتي|دويرة|دار|درت|ديور|تديروا|يدور|دور|تدير|ydūr|درنا|دوري|نديروا|يدير|ydīr|ديروا|تديري|ندور	<i>verb</i><br><ol><li>to do</li><li>to turn</li><li>to go around</li><li>to rotate</li></ol><br><i>noun</i><br><ol><li>house</li><li>family, folks</li></ol>
داز|جوزوا|دازوا|gāz|يجوز|ندوزوا|جوز|دوز|جازت|dāz|جوزي|دزنا|ندوز|تدوزوا|دازت|دزتي|يدوزوا|نجوز|تدوز|جزتوا|تجوزي|jāz|نجوزوا|جاز|جازوا|يدوز|جزتي|جزت|تدوزي|جزنا|يجوزوا|دزتوا|دوزوا|تجوز|تجوزوا|دوزي|دزت	<i>verb</i><br><ol><li>(transitive) to pass, pass by</li></ol>
دافي|دافيات|دفى|أدفى|دافية|dāfi|دافيين	<i>adj</i><br><ol><li>warm</li></ol>
داق|دوّقتي|دوقوا|تدوّقي|داقوا|dūq|dāqet|دوق|ندوّق|يدوّق|تدوقي|tdūqi|dāqu|dūqu|دقنا|ndūqu|duqt|ndūq|dāq|يدوق|ندوقوا|دوّقوا|tdūq|duqna|ydawwaq|تدوّق|ydūqu|دوقي|دوّقتوا|يدوقوا|دوّق|دقتي|تدوق|دقتوا|duqti|دقت|ندوق|duqtu|tdūqu|داقت|يدوّقوا|dūqi|dawwaq|دوّقت|دوّقي|تدوقوا|تدوّقوا|دوّقنا|ندوّقوا	<i>verb</i><br><ol><li>to taste</li></ol>
داك|dīk|دوك|ديك|dāk|dūk	<i>det</i><br><ol><li>that</li></ol>
دانون|دوانن|ḍanūn	<i>noun</i><br><ol><li>yoghurt</li></ol>
داوى|مداوين|مداويات|يداوي|داويتي|مداويين|mdāwi|نداوي|dāwa|داوينا|داوت|تداوي|مداوي|داواوا|داويت|يداويوا|تداويوا|نداويوا|داويوا|ydāwi|داوي|داويتوا|مداوية	<i>verb</i><br><ol><li>(medicine) to treat a medical issue</li></ol>
دجاج|دجاجات|djāj|دجاجة	<i>noun</i><br><ol><li>poultry, chickens</li></ol>
دجايجي|djāyji|دجايجية	<i>noun</i><br><ol><li>chicken seller</li></ol>
دحش|دحشات|daḥša|دحوش|daḥš|دحشة	<i>noun</i><br><ol><li>young donkey</li></ol>
دحمر|daḥmar|يدحمر	<i>verb</i><br><ol><li>to bump into</li></ol>
درجة|darja|drūj|دريجة|دروج|درجات|darjāt	<i>noun</i><br><ol><li>step</li></ol>
دردر|تدردروا|تدردر|يدردروا|dardar|دردرتي|تدردري|ندردروا|دردري|دردرنا|دردرت|يدردر|ندردر|دردروا|دردرتوا	<i>verb</i><br><ol><li>to sprinkle</li></ol>
درع|يدرّعوا|درّعنا|يدرع|درّع|darraʕ|درّعتي|تدرّعي|يدرّع|ندرّعوا|تدرّعوا|تدرّع|درّعوا|درّعتوا|ندرّع|درّعت|درّعي	<i>verb</i><br><ol><li>(transitive) to hug</li><li>(intransitive) to use one's arms to swim</li></ol>
درق|ندرّق|تدرّق|درّقي|تدرّقي|درّقنا|درّقتوا|درّقتي|darraq|يدرّق|يدرّقوا|درّقوا|ندرّقوا|درّقت|تدرّقوا|يدرق|درّق	<i>verb</i><br><ol><li>(transitive) to hide, to conceal, to cloak</li></ol>
دروج|drūj	<i>noun</i><br><ol><li>stairs, staircase</li></ol>
دري|درية|darriyya|darri|دراري|دريات	<i>noun</i><br><ol><li>kid, offspring</li></ol>
دعا|yidʕi|dʕa|يدعي	<i>verb</i><br><ol><li>to call upon God, to pray</li><li>to curse</li><li>to sue (to file a legal action)</li></ol>
دغري|duḡri	<i>adj</i><br><ol><li>honest</li></ol><br><i>adv</i><br><ol><li>immediately</li></ol>
دغية|daḡya	<i>adv</i><br><ol><li>quickly</li></ol>
دق|تدقّي|دقّينا|دقّوا|ندقّوا|دقّ|تدقّوا|دقّيتوا|يدقّوا|يدق|ندقّ|دقّت|يدقّ|دقّي|daqq|تدقّ|دقّيت|دقّيتي|yduqq	<i>verb</i><br><ol><li>to knock</li><li>to crush, to bruise</li><li>to nail (to drive a nail)</li></ol><br><i>noun</i><br><ol><li>beating</li><li>grinding, crushing</li></ol>
دقق|daqqaq|دقّقتوا|دقّق|ندقّقوا|دقّقتي|دقّقي|يدقق|تدقّقوا|يدقّق|تدقّقي|دقّقنا|دقّقت|يدقّقوا|تدقّق|دقّقوا|ندقّق	<i>verb</i><br><ol><li>to check</li><li>to look at every part of something carefully</li><li>to be meticulous</li></ol>
دقيقة|dqīqa|دقيقتين|دقايق	<i>noun</i><br><ol><li>minute</li><li>(by extension) a short time</li></ol>
دكا|daka	<i>noun</i><br><ol><li>intelligence</li></ol>
دكي|أدكى|دكية|dkī|دكيات|دكيين|دكى	<i>adj</i><br><ol><li>smart</li></ol>
دلاح|دلاحة|دلاحات|dallāḥ	<i>noun</i><br><ol><li>watermelon, watermelons</li></ol>
دم|damm|دمايات	<i>noun</i><br><ol><li>blood</li></ol>
دمع|يدمع|dmaʕ	<i>verb</i><br><ol><li>to tear (to produce tears)</li></ol>
دمعة|damʕa|دموع	<i>noun</i><br><ol><li>a tear (drop of salty liquid resulting from crying)</li></ol>
دمليج|دمالج|damlīj	<i>noun</i><br><ol><li>bangle, bracelet</li></ol>
دنب|يدنب|danb|dnab|دنوب	<i>noun</i><br><ol><li>sin</li></ol><br><i>verb</i><br><ol><li>to sin</li></ol>
دنجال|دنجان|دنجالات|danjān|دنجانة|دنجانات|danjāl|دنجالة	<i>noun</i><br><ol><li>eggplant</li></ol>
دنفيل|دنافل|danfīl	<i>noun</i><br><ol><li>dolphin</li></ol>
دنيا|dinya|dunya|دُنيا|دِنيا|دِنيات|دُنيات	<i>noun</i><br><ol><li>world, earth</li><li>it; things; everything; used to refer to general states and circumstances</li></ol>
دهاب|دهابة|dahhāb	<i>noun</i><br><ol><li>goldsmith</li></ol>
دهايبي|dhāybi|دهايبية	<i>noun</i><br><ol><li>goldsmith</li></ol>
دوا|dwa|دوايات	<i>noun</i><br><ol><li>(medicine) remedy, medicine, medication, drug</li></ol>
دوخ|يدوخ|يدوّخ|دوّختي|دوّخي|ندوّخ|dawwaḵ|تدوّخ|تدواخ|دوّخنا|دوّخوا|دوّخ|ندوّخوا|دوّخت|تدوّخي|مدوخ|يدوّخوا|تدوّخوا|دوّختوا	<i>verb</i><br><ol><li>to make dizzy</li></ol>
دود القز|دودة القز|dūd el-qazz|دودات القز	<i>noun</i><br><ol><li>silkworms</li></ol>
دورك|dūrk	<i>adv</i><br><ol><li>now; right now; at present</li></ol>
دوق|دوّقتي|تدوّقي|dūq|يدوّق|ندوّق|دُوق|يدوق|دوّقوا|ydawwaq|تدوّق|دوّقتوا|دوّق|دَوْق|أدواق|يدوّقوا|dawwaq|دوّقت|دوّقي|dawq|تدوّقوا|دوّقنا|ندوّقوا	<i>noun</i><br><ol><li>taste</li><li>good taste</li></ol><br><i>verb</i><br><ol><li>to give someone a small amount of food or drink</li></ol>
دوى|يدوي|dwa	<i>verb</i><br><ol><li>to talk</li></ol>
ديال|dyāl|دياول	<i>noun</i><br><ol><li>(vulgar, not used without a pronominal suffix attached to it) penis</li></ol>
ديب|dīb|ديبة|دياب	<i>noun</i><br><ol><li>wolf</li></ol>
ديما|دَيْما|dayma|دايما|dīma|dāyman|دِيما|دائما	<i>adv</i><br><ol><li>always</li></ol>
را|rā|يرى|رينا|رات|راوا|تراوا|نرى|تراي|آروا ٫ آراوا (ʔāru or ʔārāw)|آرى|f\|s\|imperative-form-of transliteration-ʔārāy_or_ʔāri origin_transliteration-rā " lang="ary">آري ٫ آراي (ʔārāy or ʔāri)|نراوا|ريت|ترى|ريتي|يراوا|ريتوا	<i>verb</i><br><ol><li>(dated) to see</li><li>(imperative) to give</li></ol>
رابع|rābiʕ|رابعة|رابعات|رابعين	<i>adj</i><br><ol><li>fourth</li></ol>
رابوز|rābūz|روابز	<i>noun</i><br><ol><li>bellows (air blower)</li></ol>
راتب|رواتب|rātib	<i>noun</i><br><ol><li>salary, pay, wages</li></ol>
راجل|رجالة|rājil|رجال	<i>noun</i><br><ol><li>man</li><li>husband</li></ol>
راح|رحتوا|نروح|يروحوا|تروح|يروح|rāḥ|رايحة|رايحات|رحت|تروحوا|روحي|rāyiḥ|نروحوا|روحوا|رحنا|yrūḥ|رحتي|راحوا|روح|رايحين|راحت|تروحي|رايح	<i>verb</i><br><ol><li>to go</li></ol>
راس|ريوسة|rwiyyas|رويسات|ريوس|ryūsa|rās|ryūs|رويس	<i>noun</i><br><ol><li>(anatomy) head</li><li>beginning</li></ol>
راف|يروف|رفتوا|نروفوا|مريوف|رايف|روف|روفي|رفنا|يروفوا|تروفوا|روفوا|رفت|تروفي|رفتي|rāf|رافوا|رافت|نروف|تروف	<i>verb</i><br><ol><li>to have mercy, to be merciful, to be compassionate [+ على (object)] or [+ ب (object)]</li><li>to give money [+ على (object)] or [+ ب (object)]</li></ol>
ربح|تربّحوا|نربّحوا|تربّحي|ربّحوا|ربّحت|rabbaḥ|yirbaḥ|ربّحتي|ربّحي|نربّح|rbaḥ|يربّح|yrabbaḥ|يربح|أرباح|ربّح|يربّحوا|ربّحنا|rabḥ|تربّح|ربّحتوا	<i>verb</i><br><ol><li>(transitive, intransitive) to win, to gain; to profit</li><li>(transitive) to cause to win, to cause to gain; to cause to profit</li></ol><br><i>noun</i><br><ol><li>profit</li><li>interest</li></ol>
ربعة|rabʕa|ʔarbʕa|أربعة|ربع	<i>num</i><br><ol><li>four</li></ol>
ربعة وتلاتين|rabʕa w tlātīn	<i>num</i><br><ol><li>thirty-four</li></ol>
ربعة وعشرين|rabʕa w ʕašrīn	<i>num</i><br><ol><li>twenty-four</li></ol>
ربعتاش|rbaʕtāš	<i>num</i><br><ol><li>fourteen</li></ol>
ربعمية|rabʕamya	<i>num</i><br><ol><li>four hundred</li></ol>
ربعين|rabʕīn	<i>num</i><br><ol><li>forty</li></ol>
ربيب|ربايب|rbīb|ربيبة	<i>noun</i><br><ol><li>stepson</li></ol>
ربيع|rbīʕ	<i>noun</i><br><ol><li>spring</li><li>grass</li><li>mix of coriander and parsley</li></ol>
رتيلة|رتيلات|rtīla	<i>noun</i><br><ol><li>spider</li></ol>
رجع|يرجّع|رجّع|نرجّعوا|رجّعتي|ترجّع|يرجّعوا|rajjaʕ|يَرجع|رجّعنا|رجّعوا|ترجّعوا|رجّعتوا|رجّعي|or يِرجع|ترجّعي|رجّعت|نرجّع|rjaʕ	<i>verb</i><br><ol><li>(intransitive) to return, to come back, to go back</li><li>(transitive) to return</li></ol>
رجلة|rujla	<i>noun</i><br><ol><li>manhood</li></ol>
رجولة|rujūla	<i>noun</i><br><ol><li>manhood</li></ol>
رجيم|rijīm	<i>noun</i><br><ol><li>diet (controlled regimen of food)</li></ol>
رحل|ترحّلي|رحّلت|rḥal|رحّل|رحّلوا|رحّلتي|نرحّل|ترحّلوا|يرحّلوا|رحّلي|رحّلنا|raḥḥal|رحّلتوا|يرحّل|ترحّل|نرحّلوا|يرحل	<i>verb</i><br><ol><li>to move house</li><li>to set out</li><li>to transport, to relocate</li></ol>
رخيص|رخيصة|rḵīṣ|رخاص|أرخص|رخيصات|رخيصين|رخص	<i>adj</i><br><ol><li>cheap (low in price)</li></ol>
رد|يردّوا|نردّوا|ردّيت|نردّ|ردّت|تردّوا|ردّيتوا|يرُد|ردّوا|ردّي|تردّ|ردّيتي|yrudd|ردّينا|yradd|ردّ|يرد|or يرَد|يردّ|radd|تردّي	<i>verb</i><br><ol><li>to reply, to answer, to respond [+ على (object)]</li><li>to give back</li><li>(intransitive) to vomit</li></ol>
ردان|ruddān	<i>noun</i><br><ol><li>replying</li><li>giving back</li><li>vomiting</li></ol>
ردخ|يردخ|rdaḵ	<i>verb</i><br><ol><li>to slam</li></ol>
ردم|or يردَم|يردُم|rdam	<i>verb</i><br><ol><li>to demolish</li></ol>
رزوزية|rzūziyya|رزوزيات	<i>noun</i><br><ol><li>wasp</li></ol>
رعد|رعيد|رعود|رعودة|raʕd	<i>noun</i><br><ol><li>thunder</li></ol>
رعف|rʕaf|يرعف	<i>verb</i><br><ol><li>to nosebleed</li></ol>
رغوة|raḡwa|رغوات	<i>noun</i><br><ol><li>foam</li></ol>
رقد|رقّدي|نرقّد|يِرْقَد|or يِرْقُد|ترقّد|yraqqad|نرقّدوا|يرقد|رقّدت|رقّدتوا|يرقّدوا|rqad|yirqud|رقّد|يُرْقَد|yirqad|رقّدتي|رقّدوا|يرقّد|ترقّدوا|ترقّدي|raqqad|yurqud|رقّدنا	<i>verb</i><br><ol><li>(intransitive) to sleep</li><li>to put to sleep, to put to bed</li><li>to preserve, to can</li></ol>
رقوقية|rqūqiyya	<i>noun</i><br><ol><li>thinness</li></ol>
ركبة|ركاب|ركابي|rukba|ركبتين|ركبات	<i>noun</i><br><ol><li>(anatomy) knee</li></ol>
ركنة|rukna|ركاين|ركنات	<i>noun</i><br><ol><li>corner</li></ol>
ركيزة|ركايز|rkīza|ركيزات	<i>noun</i><br><ol><li>pole, post</li></ol>
رموك|rmūk|رموكة	<i>noun</i><br><ol><li>semi-trailer</li></ol>
رمى|rma|يرمي	<i>verb</i><br><ol><li>to throw, to toss</li></ol>
روبيني|rubīni|روبينيات	<i>noun</i><br><ol><li>tap, faucet</li></ol>
روت|روات|rawt|روتات	<i>noun</i><br><ol><li>dung</li></ol>
روج|rūj	<i>noun</i><br><ol><li>wine</li></ol>
روز|rūz	<i>noun</i><br><ol><li>rice</li></ol>
روض|رَوْض|رَوْضات|rawḍ|rūḍ|رُوضات|رُوض	<i>noun</i><br><ol><li>kindergarten</li></ol>
روضة|rūḍa|رَوْضات|رَوْضة|رُوضات|رُوضة|rawḍa	<i>noun</i><br><ol><li>graveyard</li></ol>
روطالة|rūṭāla|روطالات	<i>noun</i><br><ol><li>Synonym of أخطبوط (ʔuḵṭubūṭ)</li></ol>
رون|يروّنوا|نروّن|روّننا|يروّن|روّنتوا|تروّنوا|rawwan|تروّن|روّنتي|روّنت|تروّني|نروّنوا|روّني|روّنوا|روّن	<i>verb</i><br><ol><li>to ruin, to mess up</li></ol>
رويضة|رويضات|rwāyiḍ|rwīḍāt|rwīḍa|روايض	<i>noun</i><br><ol><li>wheel</li><li>tyre</li></ol>
روينة|رواين|روينات|rwīna	<i>noun</i><br><ol><li>mess, wreck</li></ol>
رياحة|riyyāḥa|رياحات|ريايح	<i>noun</i><br><ol><li>fan (electrical device for cooling)</li></ol>
رية|riyya|ريات	<i>noun</i><br><ol><li>lung</li></ol>
ريح|تريحوا|riyyaḥ|تريحي|ريحتي|يريح|نريح|ريحنا|نريحوا|رياح|ريحت|ريحتوا|تريح|ريحي|rīḥ|ريحوا|يريحوا	<i>verb</i><br><ol><li>to sit down</li><li>to relax</li><li>wind</li></ol>
ريحان|rīḥān	<i>noun</i><br><ol><li>myrtle</li></ol>
ريحة|rīḥa|روايح	<i>noun</i><br><ol><li>smell, scent; odor</li><li>perfume</li></ol>
زاج|jāj|جاجات|جاجة|زاجات|zāj|جاج|زاجة	<i>noun</i><br><ol><li>glass</li></ol>
زار|نزور|نزوروا|تزوري|zār|يزور|زرنا|تزوروا|يزوروا|زرتوا|زوروا|زور|زوري|زاروا|زارت|تزور|زرتي|زرت	<i>verb</i><br><ol><li>to visit</li></ol>
زال|نزولوا|زولي|زلتوا|تزولوا|زالت|زولوا|زالوا|يزولوا|يزول|زلنا|تزول|زول|yzūl|زلتي|تزولي|نزول|زلت|zāl	<i>verb</i><br><ol><li>(intransitive) to remove</li><li>(intransitive) to go away</li></ol>
زامل|زوامل|زاملة|زويمل|zāmel	<i>noun</i><br><ol><li>(vulgar) homosexual</li></ol>
زايس|zāyis	<i>noun</i><br><ol><li>Synonym of أخطبوط (ʔuḵṭubūṭ)</li></ol>
زب|زَب|zbūba|zubb|زبوب|zabb|زبوبة|زُب	<i>noun</i><br><ol><li>(vulgar) penis</li></ol>
زرب|نزرّب|or يزرُب|زرّب|زرّبتي|زرّبتوا|زرّبنا|تزرّبي|يزرّبوا|زرّبي|يزرب|تزرّب|zarrab|يزرّب|zrab|يزرَب|نزرّبوا|زرّبت|زرّبوا|تزرّبوا	<i>verb</i><br><ol><li>(intransitive) to hurry</li><li>(transitive) to hurry</li></ol>
زردة|zarda|زردات	<i>noun</i><br><ol><li>banquet</li></ol>
زرق|زرقين|أزرق|زورق|زرقات|zraq|زرقة	<i>adj</i><br><ol><li>blue</li></ol>
زروبية|zrūbiyya	<i>noun</i><br><ol><li>quickness</li></ol>
زرودية|zrūdiyya	<i>noun</i><br><ol><li>(Eastern Morocco) carrot</li></ol>
زروقية|zrūqiyya	<i>noun</i><br><ol><li>blueness</li></ol>
زريعة|zarrīʕa|زريعات|زرارع	<i>noun</i><br><ol><li>seed</li></ol>
زريعة الكتان|zarrīʕat el-kattān	<i>noun</i><br><ol><li>flaxseed</li></ol>
زعتر|صحتر|zaʕtar|ṣaḥtar	<i>noun</i><br><ol><li>thyme</li></ol>
زعفان|زعفانين|زعفانة|zaʕfān|زعفانات	<i>adj</i><br><ol><li>upset</li></ol>
زعلولة|زعلولات|zaʕlūla	<i>noun</i><br><ol><li>swing (for children)</li></ol>
زغرت|يزغرت|zaḡrat	<i>verb</i><br><ol><li>to utter trilling cries of joy, to ululate</li><li>to congratulate</li></ol>
زغروتة|zaḡruta|زغاريت|زغروتات	<i>noun</i><br><ol><li>ululation</li></ol>
زغريت|zaḡrīt|زغريتة|زغريتات	<i>noun</i><br><ol><li>ululations</li></ol>
زفت|zaffat|تزفات|zaft|يزفت	<i>noun</i><br><ol><li>tar, pitch</li><li>(figuratively) rubbish, trash, shit</li></ol><br><i>verb</i><br><ol><li>to pave</li></ol>
زفزوف|zafzūf	<i>noun</i><br><ol><li>jujube (Ziziphus jujuba)</li></ol>
زك|zukk|زكوكة|زكوك	<i>noun</i><br><ol><li>(vulgar) ass</li></ol>
زكرون|زكروم|zakrūn|زكارن|زكارم|zakrūm	<i>noun</i><br><ol><li>bolt lock</li></ol>
زلاج|زلاجة|zallāj|جلاجة|jallāj|جلاج	<i>noun</i><br><ol><li>tile installer</li></ol>
زلافة|زلايف|زلافات|zlāfa	<i>noun</i><br><ol><li>bowl</li></ol>
زلايجي|جلايجية|جلايجي|zlāyji|jlāyji|زلايجية	<i>noun</i><br><ol><li>tile installer</li></ol>
زلزال|زلازل|زنازل|zanzāl|زنزال|zalzāl	<i>noun</i><br><ol><li>earthquake</li></ol>
زليج|جليجة|جليجات|جليج|jallīja|زليجة|jallījāt|zallīja|zallījāt|jallīj|zallīj|زليجات	<i>noun</i><br><ol><li>tiles; zelliges</li></ol>
زليقة|زليقات|zallīqa	<i>noun</i><br><ol><li>slide (for children)</li></ol>
زماكري|زماكرية|zmāgri	<i>noun</i><br><ol><li>Moroccan born abroad</li></ol>
زملة|zamla	<i>noun</i><br><ol><li>homosexuality</li></ol>
زنجبير|zanjbīr	<i>noun</i><br><ol><li>ginger</li></ol>
زنجلان|zanjlān|زنجلانات|زنجلانة	<i>noun</i><br><ol><li>sesame</li></ol>
زنطيط|zanṭīṭ|زناطط	<i>noun</i><br><ol><li>tail</li><li>(vulgar) penis</li></ol>
زنقة|زَنقات|زُنقات|زَنقة|zanqa|زُنقة|zunqa|زناقي	<i>noun</i><br><ol><li>street, alley</li></ol>
زهر|zhar	<i>noun</i><br><ol><li>luck</li></ol>
زيتي|زَيْتي|زِيتية|زَيْتيين|زِيتيين|زَيْتية|زِيتيات|زَيتي|zīti|زِيتي|zayti|زَيْتيات	<i>adj</i><br><ol><li>oily, oil</li><li>olive green</li></ol><br><i>noun</i><br><ol><li>olive green (colour)</li></ol>
زيزون|زيزونين|زيازن|زيزونات|zayzūn|زيزونة	<i>adj</i><br><ol><li>mute</li></ol>
زيطة|زيطات|zīṭa	<i>noun</i><br><ol><li>swing (for children)</li></ol>
زين|ziyyan|زيننا|تزين|زينوا|زين|زيني|زَيْن|zayn|يزينوا|نزين|زِين|زينتوا|zīn|yziyyan|نزينوا|يزين|زينت|تزينوا|زينتي|تزيني	<i>noun</i><br><ol><li>beauty</li><li>to adorn, to decorate, to embellish, to ornament, to garnish</li></ol>
سابع|سابعات|sābiʕ|سابعة|سابعين	<i>adj</i><br><ol><li>seventh</li></ol>
سات|ساتة|ساتين|ساتات|sātt	<i>adj</i><br><ol><li>sixth</li></ol>
سادس|سادسات|سادسين|sādis|سادسة	<i>adj</i><br><ol><li>sixth</li></ol>
ساروت|sārūt|سوارت	<i>noun</i><br><ol><li>key</li></ol>
سارى|متساري|ساريوا|ساريتي|ساراوا|تساريوا|سارينا|يساريوا|ساريت|ساري|سارت|تساري|نساري|نساريوا|مساري|sāra|ساريتوا|يساري	<i>verb</i><br><ol><li>(transitive) to take someone sightseeing</li></ol>
سارية|sārya|سواري|ساريات	<i>noun</i><br><ol><li>post, column</li><li>pole</li></ol>
ساعة|ساعات|سوايع|sāʕa|ساعتين	<i>noun</i><br><ol><li>hour</li><li>clock</li><li>(in the plural) private lessons</li></ol>
ساق|تسوقوا|سقنا|nsūqu|sūqi|tsūq|sāqet|suqtu|sūqān|ysūqu|sāqu|سقتي|يسوق|ساقت|nsūq|suqna|سقت|سوقوا|سوق|سقتوا|نسوقوا|tsūqi|sāq|سيقان|ysūq|sūq|نسوق|سوقي|سوقان|tsūqu|يسوقوا|sūqu|تسوقي|suqti|ساقوا|suqt|تسوق	<i>verb</i><br><ol><li>to drive</li></ol><br><i>noun</i><br><ol><li>leg</li></ol>
ساقطة|ساقطات|sāqṭa	<i>noun</i><br><ol><li>bolt lock</li></ol>
ساقية|سواقي|sāqyāt|ساقيات|swāqi|sāqya	<i>noun</i><br><ol><li>runlet, rivulet, ditch</li></ol>
سال|نسالوا|سالت|يسالوا|تسيلوا|تسال|سلت|سال|سيلي|sāl|سالوا|نسال|تسيل|نسيلوا|سيل|سالي|يسيل|يسيلوا|تسالوا|سلتي|يسال|سلنا|سلتوا|نسيل|تسالي|تسيلي|سيلوا	<i>verb</i><br><ol><li>to flow, to run</li><li>to be owed money</li><li>(dated) to ask</li></ol>
سالمية|sālmiyya	<i>noun</i><br><ol><li>sage (Salvia and especially Salvia officinalis)</li></ol>
سالى|تساليوا|سالي|سالت|نسالي|يسالي|تسالي|نساليوا|يساليوا|ساليوا|ساليتي|sāla|ساليتوا|ساليت|سالينا|سالاوا	<i>verb</i><br><ol><li>(transitive, intransitive) to finish</li></ol>
ساهل|ساهلات|sāhil|سهال|أسهل|ساهلين|سهل|ساهلة	<i>adj</i><br><ol><li>easy</li></ol>
ساين|ساينوا|ساينت|sāyan|سايننا|يساين|ساينتوا|نساينوا|يساينوا|تساينوا|تسايني|ساينتي|سايني|تساين|نساين	<i>verb</i><br><ol><li>(transitive, intransitive) to wait</li></ol>
سب|ysubb|يسبّ|سبّيتوا|يسُب|سبّ|سبّينا|سبّي|سبّوا|تسبّ|سبّت|تسبّوا|يسبّوا|نسبّ|يسب|سبّيتي|نسبّوا|or يسَب|ysabb|sabb|تسبّي|سبّيت	<i>verb</i><br><ol><li>to insult</li></ol>
سبرديلة|سبرديلات|sbardīla	<i>noun</i><br><ol><li>sneakers, creps</li></ol>
سبسي|sabsi	<i>noun</i><br><ol><li>a long pipe used to smoke marijuana</li></ol>
سبع|سبوعة|sbaʕ	<i>noun</i><br><ol><li>lion</li></ol>
سبعة|sabʕa|سبع	<i>num</i><br><ol><li>seven</li></ol>
سبعة وتلاتين|sabʕa w tlātīn	<i>num</i><br><ol><li>thirty-seven</li></ol>
سبعة وعشرين|sabʕa w ʕašrīn	<i>num</i><br><ol><li>twenty-seven</li></ol>
سبعتاش|sbaʕtāš	<i>num</i><br><ol><li>seventeen</li></ol>
سبعمية|sabʕamya	<i>num</i><br><ol><li>seven hundred</li></ol>
سبعين|sabʕīn	<i>num</i><br><ol><li>seventy</li></ol>
سبليون|سبليوني|sbalyūn	<i>name</i><br><ol><li>Spain (a country in Europe)</li></ol><br><i>noun</i><br><ol><li>Spaniards</li></ol>
سبنيول|سبنيولي|sbanyūl	<i>name</i><br><ol><li>Spain (a country in Europe)</li></ol><br><i>noun</i><br><ol><li>Spaniards</li></ol>
سبيطار|سبيطارات|sbīṭār	<i>noun</i><br><ol><li>hospital</li></ol>
ستاش|sittāš	<i>num</i><br><ol><li>sixteen</li></ol>
ستاية|ستايات|sattāya	<i>noun</i><br><ol><li>sieve (for liquids)</li></ol>
ستة|sitta|ست	<i>num</i><br><ol><li>six</li></ol>
ستة وتلاتين|sitta w tlātīn	<i>num</i><br><ol><li>thirty-six</li></ol>
ستة وعشرين|setta w ʕašrīn	<i>num</i><br><ol><li>twenty-six</li></ol>
ستف|ستّف|ستّفتوا|يستف|تستّفوا|يستّف|ستّفوا|نستّف|sattaf|تستّفي|ستّفنا|نستّفوا|يستّفوا|ستّفي|ستّفتي|ستّفت|تستّف	<i>verb</i><br><ol><li>to arrange</li></ol>
ستمية|sittimya	<i>num</i><br><ol><li>six hundred</li></ol>
ستيلو|stīlu|ستيلوات	<i>noun</i><br><ol><li>pen</li><li>fountain pen</li></ol>
ستين|sittīn	<i>num</i><br><ol><li>sixty</li></ol>
سجل|يسجل|يسجّلوا|تسجّل|تسجّلوا|نسجّل|سجّلتوا|تسجّلي|سجّلتي|سجّلنا|نسجّلوا|يسجّل|سجّلوا|سجّلي|سجّلت|سجّل|sajjal	<i>verb</i><br><ol><li>to record</li><li>to register</li></ol>
سحت الليل|saḥt el-līl|saḥt el-layl	<i>noun</i><br><ol><li>bat (winged animal)</li></ol>
سخانة|سخاخن|sḵāna|saḵḵāna|سخانات	<i>noun</i><br><ol><li>heat</li><li>fever</li><li>heater</li></ol>
سخف|يسخّفوا|سخّفت|saḵḵaf|سخّفنا|سخّفتوا|سخّفي|تسخّفوا|sḵaf|سخّفوا|نسخّفوا|سخّف|تسخّفي|يسخّف|نسخّف|سخّفتي|يسخف|تسخّف	<i>verb</i><br><ol><li>to faint</li><li>to lose one's breath</li><li>to feeble</li></ol>
سخون|سخونات|سخونين|سخان|سخونة|sḵūn	<i>adj</i><br><ol><li>hot</li><li>horny</li></ol>
سخونية|sḵūniyya	<i>noun</i><br><ol><li>hotness</li></ol>
سخي|سخيات|سخيين|sḵī|سخى|سخية|أسخية|أسخى	<i>adj</i><br><ol><li>kind, generous</li></ol>
سد|sadd|تسدّ|نسدّوا|تسدّوا|سدّينا|سدود|سدّيتوا|سدّيت|سدّت|يسدّوا|تسدّي|سدّ|نسدّ|سدّي|سدّيتي|يسدّ|سدّوا	<i>verb</i><br><ol><li>(transitive) to close</li></ol><br><i>noun</i><br><ol><li>dam</li></ol>
سدس|sudus|سداس|سدسين	<i>noun</i><br><ol><li>sixth (fraction)</li></ol>
سراق|سراقة|sarrāq	<i>noun</i><br><ol><li>thief, robber, stealer, looter, mugger, pilferer, embezzler</li></ol>
سراق الزيت|sarrāq ez-zīt|سراقين الزيت	<i>noun</i><br><ol><li>cockroach</li></ol>
سرج|سروج|سروجة|sarj	<i>noun</i><br><ol><li>saddle</li></ol>
سرجى|tšarja|šarja|يتسرجي|شرجى|يشرجي|tsarja|sarja|تشرجى|يسرجي|يتشرجي|تسرجى	<i>verb</i><br><ol><li>to load up (vehicle, animal, etc…)</li><li>to charge (battery)</li></ol>
سردوك|سرادك|sardūk	<i>noun</i><br><ol><li>rooster</li></ol>
سردين|sardīnāt|سردينة|sardīna|سردينات|sardīn	<i>noun</i><br><ol><li>sardine</li></ol>
سرسر|نسرسروا|سرسرتوا|سرسرت|sarsartu|نسرسر|تسرسر|sarseri|tsarsar|سرسري|سرسروا|sarserāt|sarsarti|سرسرنا|tsarseru|sarsart|nsarsar|sarsar|sarseru|nsarseru|sarsarna|تسرسري|سرسرتي|ysarsar|tsarseri|تسرسروا|يسرسروا|يسرسر|ysarseru	<i>verb</i><br><ol><li>to ring</li></ol>
سرط|sraṭ|يسرط	<i>verb</i><br><ol><li>(transitive) to swallow</li></ol>
سرق|sraq|يسرق|yisraq	<i>verb</i><br><ol><li>to steal</li></ol>
سرقة|سرقات|sarqa	<i>noun</i><br><ol><li>stealing, theft, robbery</li></ol>
سروال|sarwāl|سراول	<i>noun</i><br><ol><li>pants, trousers</li></ol>
سريع|srīʕ|سراع|سريعات|سريعة|سرع|أسرع|سريعين	<i>adj</i><br><ol><li>fast, quick</li></ol>
سشوار|sišwār|سشوارات	<i>noun</i><br><ol><li>hairdryer, blow-dryer</li></ol>
سطافيط|sṭāfīṭ|سطافيطات	<i>noun</i><br><ol><li>van</li><li>(by extension) police van</li></ol>
سطح|سطوح|سطوحة|sṭaḥ	<i>noun</i><br><ol><li>roof</li></ol>
سطوب|sṭūp|سطوبات	<i>noun</i><br><ol><li>stop sign</li></ol>
سعاي|saʕʕāy|سعاية	<i>noun</i><br><ol><li>beggar</li></ol>
سعل|or يسعُل|sʕal|يسعَل	<i>verb</i><br><ol><li>to cough</li></ol>
سعى|يسعى|sʕa	<i>verb</i><br><ol><li>to beg (plead for money or goods)</li></ol>
سفرجل|سفرجلة|سفرجلات|sfarjal	<i>noun</i><br><ol><li>quince</li></ol>
سفينة|سفينات|سفاين|sfīna	<i>noun</i><br><ol><li>ship</li></ol>
سقصى|سقصي|ysaqṣi|saqṣītu|تسقصيوا|نسقصي|tsaqṣi|سقصينا|سقصاوا|saqṣīw|saqṣa|سقصيتي|saqṣāt|سقصيتوا|سقصت|يسقصي|tsaqṣīw|يسقصيوا|saqṣāw|saqṣīt|تسقصي|ysaqṣīw|nsaqṣīw|نسقصيوا|nsaqṣi|سقصيت|saqṣīti|saqṣīna|سقصيوا|saqṣi	<i>verb</i><br><ol><li>(transitive or intransitive) to ask</li></ol>
سقط|saqqaṭ|sqaṭ|يسقط	<i>verb</i><br><ol><li>(intransitive) to flunk</li><li>(transitive) To give a student a non-passing grade in an academic endeavour.</li></ol>
سقم|يسقّم|تسقّموا|نسقّم|تسقّمي|سقّم|نسقّموا|سقّمتوا|saqqam|سقّموا|يسقّموا|سقّمتي|سقّمت|سقّمي|سقّمنا|تسقّم	<i>verb</i><br><ol><li>to fix</li><li>to do</li></ol>
سقى|يسقي|yisqi|sqa	<i>verb</i><br><ol><li>(transitive) to water</li></ol>
سكاتة|sakkāta|سكاتات	<i>noun</i><br><ol><li>pacifier</li></ol>
سكت|skat|سكّتوا|تسكّت|نسكّتوا|يسكّتوا|يسكّت|or يسكت|تسكّتي|سكّتي|نسكّت|تسكّتوا|sakkat|يسكت|سكّتتي|سكّت|سكّتنا|سكّتتوا|سكّتت	<i>verb</i><br><ol><li>to be silent</li><li>to silence</li></ol>
سكوتش|skūtš|سكوتشات	<i>noun</i><br><ol><li>adhesive tape</li></ol>
سكويلة|سكويلات|sakwīla	<i>noun</i><br><ol><li>(dated) school</li></ol>
سكينجبير|skīnjbīr|skanjbīr|سكنجبير	<i>noun</i><br><ol><li>ginger</li></ol>
سلحفة|sulaḥfāt|sulaḥfa|سلحفات	<i>noun</i><br><ol><li>tortoise, turtle</li></ol>
سلك|سلوكة|salk|سلوك	<i>noun</i><br><ol><li>wire</li></ol>
سلوم|sallūm|سلالم|slālim	<i>noun</i><br><ol><li>ladder</li></ol>
سم|سُم|samm|summ|سمومة|سموم|سَم	<i>noun</i><br><ol><li>poison, toxin</li><li>(figuratively) jealousy</li></ol>
سما|sma|سماوات	<i>noun</i><br><ol><li>sky</li></ol>
سماسري|smāsri|سماسرية	<i>noun</i><br><ol><li>broker, agent, middleman</li><li>real estate agent</li></ol>
سمان|يسمان|smān	<i>verb</i><br><ol><li>to become fat</li></ol>
سمانة|smāna	<i>noun</i><br><ol><li>fatness</li></ol>
سمسار|samsār|سمسارة	<i>noun</i><br><ol><li>broker, agent, middleman</li><li>real estate agent</li></ol>
سمطة|سميطة|سماطي|سمطات|samṭa	<i>noun</i><br><ol><li>belt</li></ol>
سمع|سمّعي|سمّعوا|يسمع|سمّع|smaʕ|تسمّع|سمّعنا|samʕ|يسمّعوا|يسمّع|سمّعت|تسمّعوا|سمّعتوا|نسمّع|sammaʕ|تسمّعي|سمّعتي|نسمّعوا	<i>verb</i><br><ol><li>to hear</li><li>to hear of</li><li>to listen to, to pay attention to, to hear someone out</li><li>(ditransitive) to make hear, to let hear, to give someone something to hear</li></ol><br><i>noun</i><br><ol><li>hearing, sense of hearing</li></ol>
سمم|يسمّموا|سمّمت|سمّمتوا|تسمّموا|سمّم|سمّموا|يسمّم|نسمّموا|تسمّمي|تسمّم|سمّمي|سمّمنا|سمّمتي|sammam|نسمّم|يسمم	<i>verb</i><br><ol><li>to poison</li></ol>
سمن|نسمّنوا|يسمّن|تسمّني|samman|سمّنتي|samn|سمّنتوا|تسمّن|تسمّنوا|سَمْن|سمّني|سمّنوا|sman|سمّن|يسمّنوا|سْمَن|سمّنت|نسمّن|سمّننا	<i>verb</i><br><ol><li>to fatten</li></ol><br><i>noun</i><br><ol><li>ghee</li></ol>
سمنة|sumna	<i>noun</i><br><ol><li>obesity</li></ol>
سمونية|smūniyya	<i>noun</i><br><ol><li>obesity</li></ol>
سمى|تسمّيوا|سمّيتي|يسمّيوا|يسمي|سمّيتوا|سمّيوا|سمّاوا|نسمّي|سمّات|تسمّي|نسمّيوا|سمّينا|يسمّي|سمّى|سمّيت|samma|سمّي	<i>verb</i><br><ol><li>(ditransitive) to name, to call, to designate, to denominate</li><li>to title, to entitle</li><li>to nominate, to appoint</li></ol>
سمين|سمينة|سمينين|smīn|سمينات|سمان	<i>adj</i><br><ol><li>fat, overweight</li></ol>
سنة|سنان|سنينة|سنين|sanna|snīn|سنوات|sana|سنتين	<i>noun</i><br><ol><li>year</li><li>tooth</li></ol>
سنجاب|sinjāb|سناجب	<i>noun</i><br><ol><li>squirrel</li></ol>
سندرية|sandriyya|سندريات	<i>noun</i><br><ol><li>ashtray</li></ol>
سنسلة|سناسل|sansla	<i>noun</i><br><ol><li>necklace</li><li>zip fastener</li></ol>
سنسور|sansūr|سنسورات	<i>noun</i><br><ol><li>lift, elevator</li></ol>
سنسول|سنسولات|sansūl	<i>noun</i><br><ol><li>(anatomy) backbone, spinal column</li></ol>
سنى|يسني|sna	<i>verb</i><br><ol><li>to sign</li></ol>
سهولية|shūliyya	<i>noun</i><br><ol><li>easiness</li></ol>
سواق|sawwāqīn|سواقين|sawwāq|سواقة	<i>noun</i><br><ol><li>vehicle driver</li><li>chauffeur</li></ol>
سودانية|sūdāniyya	<i>noun</i><br><ol><li>cayenne pepper</li></ol>
سورت|تسوريت|يسورت|sawrat	<i>verb</i><br><ol><li>to close with a key</li></ol>
سوق|sawwāqīn|أسواق|sawwāq|سواق|sūq|سواقين|سواقة	<i>noun</i><br><ol><li>market, souq, bazaar, street of shops</li><li>business (something involving one personally)</li></ol>
سول|تسوّلي|نسوّلوا|تسوّل|يسوّل|تسوّلوا|سوّلي|سوّلتي|سوّلتوا|يسول|نسوّل|سوّلنا|سوّلت|يسوّلوا|سوّل|sawwal|سوّلوا	<i>verb</i><br><ol><li>(transitive or intransitive) to ask</li></ol>
سير|سيروا|سيري|sīr	<i>verb</i><br><ol><li>to go</li></ol>
سيف|sīf|سيوف|sayf|سيوفة	<i>noun</i><br><ol><li>sword, sabre</li></ol>
سيمانة|سيمانات|simāna	<i>noun</i><br><ol><li>week</li></ol>
سيمة|sīma	<i>noun</i><br><ol><li>cement</li></ol>
شاب|يشيب|شبتوا|يشيبوا|شباب|šābb|شابة|شبان|نشيبوا|تشيبوا|شابت|شبت|شبتي|شابوا|شيب|شبنا|šāb|نشيب|شيبوا|تشيبي|شيبي|تشيب	<i>noun</i><br><ol><li>young man, youth, adolescent</li></ol><br><i>verb</i><br><ol><li>to be grey-haired, to grow grey hair</li><li>to become older</li></ol>
شارف|šārif|شرف|أشرف|شارفة|شارفين|شارفات	<i>adj</i><br><ol><li>old (of people)</li></ol>
شاري|شاريات|šāryīn|شارية|šāryāt|šārya|šāri|شاريين	<i>noun</i><br><ol><li>buyer</li></ol>
شاف|šāf|يشوفوا|شوفي|شوف|شافت|شافوا|شفتي|شايف|شفنا|yšūf|شافة|شفت|نشوف|شيفان|شوفان|تشوفوا|شوفوا|تشوفي|شفتوا|تشوف|يشوف|نشوفوا	<i>verb</i><br><ol><li>to see (to perceive with the eyes)</li></ol><br><i>noun</i><br><ol><li>boss, manager</li></ol>
شاكمة|šāgma|شاكمات	<i>noun</i><br><ol><li>exhaust pipe</li></ol>
شاور|شاوروا|يشاور|يشاوروا|šāwar|نشاوروا|شاورتي|شاورت|تشاوري|شاوري|شاورتوا|نشاور|شاورنا|تشاور|تشاوروا	<i>verb</i><br><ol><li>to consult</li></ol>
شبعان|شبعانات|شبعانين|شبعانة|šabʕān	<i>adj</i><br><ol><li>full, satiated</li></ol>
شتا|شتاوي|štā|مشاتي	<i>noun</i><br><ol><li>rain</li><li>winter</li></ol>
شحال|šḥāl	<i>adv</i><br><ol><li>(interrogative) how much?</li></ol>
شحال الساعة|šḥāl es-sāʕa|شحال الساعة؟	<i>phrase</i><br><ol><li>what time is it?</li></ol>
شحال فالساعة|شحال فالساعة؟|šḥāl f-es-sāʕa	<i>phrase</i><br><ol><li>what time is it?</li></ol>
شخر|or يشخَر|يشخُر|šḵar	<i>verb</i><br><ol><li>to snore</li></ol>
شخير|šḵīr	<i>noun</i><br><ol><li>snoring</li></ol>
شد|تشدّي|شدّ|يشدّ|شدّينا|yšadd|شدّيتي|šadd|شدّيتوا|or يشَدّ|يشُدّ|شدّت|شدّيت|yšudd|نشدّ|شدّي|تشدّ|نشدّوا|يشدّوا|شدّوا|يشد|تشدّوا	<i>verb</i><br><ol><li>(transitive) to grab</li><li>(transitive) to imprison</li><li>(intransitive) to be or become firm</li></ol>
شراب|شرابات|šrāb	<i>noun</i><br><ol><li>wine</li><li>alcoholic drink</li></ol>
شرب|يشرب|تشرّب|šarrab|شرّبوا|or يِشرُب|yišrab|يشرّبوا|yišrub|yušrub|yšarrab|نشرّب|شرّبي|يشرّب|تشرّبوا|شرّبت|شرّبنا|نشرّبوا|شرّب|يِشرَب|شرّبتوا|تشرّبي|šrab|شرّبتي|يُشرُب	<i>verb</i><br><ol><li>to drink</li><li>to take medicine</li><li>to cause to drink</li></ol>
شرجب|surjab|سرجم|شرجم|šarjam|šurjab|شراجب|سرجب|surjam|شراجم|sarjab|sarjam|سراجم|šarjab|šurjam|سراجب	<i>noun</i><br><ol><li>window</li></ol>
شرق|šarq	<i>noun</i><br><ol><li>east</li></ol>
شرك|شرّكتي|يشرّكوا|شرّكي|šarrag|شرّك|شرّكتوا|تشرّكوا|شرّكت|يشرك|širk|شرّكوا|تشرّك|نشرّكوا|شرّكنا|نشرّك|تشرّكي|šrak|يشرّك	<i>verb</i><br><ol><li>to share</li><li>to become a partner, to be a participant, to be an associate</li><li>to commit shirk</li><li>to rip, to tear</li></ol><br><i>noun</i><br><ol><li>(uncountable, Islam) polytheism, idolatry</li></ol>
شرى|šra|يشري	<i>verb</i><br><ol><li>to buy</li></ol>
شريحة|šrīḥa|شريحات	<i>noun</i><br><ol><li>dried fig</li></ol>
شطابة|šaṭṭāba|شطابات	<i>noun</i><br><ol><li>broom</li></ol>
شطح|šṭaḥ|šṭīḥ|شطيح|يشطح	<i>verb</i><br><ol><li>to dance</li></ol>
شعالة|šaʕʕāla|شعالات	<i>noun</i><br><ol><li>bonfire</li><li>lighter (cigarette)</li></ol>
شعر|شعور|šʕar|شعورات|أشعار|šiʕr|شعرة	<i>noun</i><br><ol><li>hair</li><li>bristles</li><li>fur</li><li>poetry</li></ol>
شعكوكة|شعكوكات|šaʕkūka	<i>noun</i><br><ol><li>curly hair</li></ol>
شعل|يشعل|yišʕal|šʕal	<i>verb</i><br><ol><li>to light</li><li>to turn on</li></ol>
شفر|šfar|yišfur|يشفر|or يشفَر|yišfar|يشفُر	<i>verb</i><br><ol><li>to steal</li></ol>
شفرة|شفرات|šafra	<i>noun</i><br><ol><li>a stealing, theft, robbery</li></ol>
شقة|šuqqa|شقات|šaqqa|شقق	<i>noun</i><br><ol><li>apartment, flat</li><li>fissure, hollow</li></ol>
شكارة|šukkāra|šakkāra|شَكارة|شَكارات|شكاير|شُكارة|شكاكر|شُكارات	<i>noun</i><br><ol><li>bag</li></ol>
شكرا|šukran	<i>intj</i><br><ol><li>thanks, thank you</li></ol>
شكلاط|شكلاطات|شكلاطة|šuklāṭ	<i>noun</i><br><ol><li>chocolate</li></ol>
شكم|تشكّم|شكّمتوا|شكّمت|šakkam|شكّموا|نشكّم|شكّمنا|يشكّم|يشكم|يشكّموا|نشكّموا|تشكّموا|شكّمي|تشكّمي|شكّم|شكّمتي	<i>verb</i><br><ol><li>to report (to notify formally) [+ ب (object)]</li><li>to snitch [+ ب (object)]</li></ol>
شكون|škūn|form من	<i>adv</i><br><ol><li>(interrogative) who?</li></ol>
شلاضة|شلايض|šlāḍa|شْلَاضات|šalāḍa|شَلَاضات|شْلَاضة|شَلَاضة	<i>noun</i><br><ol><li>salad</li></ol>
شلة|šalla	<i>adv</i><br><ol><li>many, much</li></ol>
شلغوم|šlāḡem|شلاغم|šalḡūm	<i>noun</i><br><ol><li>moustache</li></ol>
شلقومة|šalqūma|شلاقم	<i>noun</i><br><ol><li>lip</li></ol>
شلية|šliyya|شليات|šalya|شلية	<i>noun</i><br><ol><li>chair</li></ol>
شمال|šamāl|šmāl	<i>noun</i><br><ol><li>north</li><li>left</li></ol>
شمش|šams|شموسة|شموش|šamš|شمس|شموس|شموشة	<i>noun</i><br><ol><li>sun, Sun</li></ol>
شمكار|šamkār|شمكارة|شماكرية	<i>noun</i><br><ol><li>drug user</li><li>homeless person</li></ol>
شنطة|شانطة|شانطات|šānṭa|شناطي|šanṭa|شنطات|شوانط	<i>noun</i><br><ol><li>bag</li><li>backpack</li></ol>
شنو|šnu	<i>adv</i><br><ol><li>(interrogative) what?</li></ol>
شنيولة|شنيولات|šnīwla	<i>noun</i><br><ol><li>mosquito</li></ol>
شهر|شهرين|šhar|شهور|šahrayn|شهورة	<i>noun</i><br><ol><li>month</li></ol>
شهر تسعة|شهر تسعود|šhar tisʕa|šhar tisʕūd	<i>name</i><br><ol><li>September</li></ol>
شهر تلاتة|šhar tlāta	<i>name</i><br><ol><li>March</li></ol>
شهر تمنية|šhar tmanya	<i>name</i><br><ol><li>August</li></ol>
شهر تناش|šhar tnāš	<i>name</i><br><ol><li>December</li></ol>
شهر جوج|šhar jūj	<i>name</i><br><ol><li>February</li></ol>
شهر حداش|šhar ḥdāš	<i>name</i><br><ol><li>November</li></ol>
شهر خمسة|šhar ḵamsa	<i>name</i><br><ol><li>May</li></ol>
شهر ربعة|šhar rabʕa	<i>name</i><br><ol><li>April</li></ol>
شهر سبعة|šhar sabʕa	<i>name</i><br><ol><li>July</li></ol>
شهر ستة|šhar sitta	<i>name</i><br><ol><li>June</li></ol>
شهر عشرة|šhar ʕašra	<i>name</i><br><ol><li>October</li></ol>
شهر واحد|šhar wāḥid	<i>name</i><br><ol><li>January</li></ol>
شواية|šawwāya|شوايات	<i>noun</i><br><ol><li>grill</li></ol>
شوربة|šūrba|شوربات	<i>noun</i><br><ol><li>soup</li></ol>
شوط|شُوط|šūṭ|أشواط|šawṭ|شَوْط	<i>noun</i><br><ol><li>(sports) half of a match</li></ol>
شوفة|šūfa|شوفات	<i>noun</i><br><ol><li>a look</li></ol>
شوكة|شوكات|šūka	<i>noun</i><br><ol><li>syringe</li><li>fork</li></ol>
شوى|šwa|يشوي	<i>verb</i><br><ol><li>to fry, to grill</li></ol>
شوية|šwiyya	<i>adv</i><br><ol><li>a little</li></ol>
شي حاجة|ši ḥāja	<i>pron</i><br><ol><li>something</li></ol>
شيب|شيبة|šīb|šība|شيبات	<i>noun</i><br><ol><li>grey hair</li></ol>
شيبة|šība	<i>noun</i><br><ol><li>wormwood</li></ol>
شيتة|شيتات|šīta	<i>noun</i><br><ol><li>brush</li></ol>
شيتة السنان|šītat es-snān|شيتات السنان	<i>noun</i><br><ol><li>toothbrush</li></ol>
شير|شيّرت|نشير|يشيّروا|نشيروا|شيرتوا|شيرت|شيّرتي|تشيري|شيرتي|يشيّر|يشيروا|شيّروا|šayyar|نشيّروا|تشيروا|شيروا|شيّر|تشيّروا|شيري|يشير|تشيّر|شيّري|تشيّري|نشيّر|šiyyar|شيّرتوا|تشير|شيرنا|شيّرنا	<i>verb</i><br><ol><li>to wave (sign by moving something back and forth, e.g. one's hand, a flag)</li><li>to aim</li></ol>
شيفور|شيافر|شَيْفور|شِيفور|šīfūr|šayfūr	<i>noun</i><br><ol><li>chauffeur</li></ol>
صاب|صبتي|نصيبوا|صيبوا|صابوا|تصيبوا|تصيب|ṣāb|صيبي|صابت|صيب|يصيب|صبتوا|يصيبوا|تصيبي|صبت|يتصاب|tṣāb|تصاب|صبنا|نصيب	<i>verb</i><br><ol><li>to find</li></ol>
صاحب|صحاب|صاحبة|صحيب|ṣāḥeb	<i>noun</i><br><ol><li>friend</li></ol>
صاك|صيكان|ṣāk	<i>noun</i><br><ol><li>purse</li></ol>
صاكة|صاكات|ṣāka	<i>noun</i><br><ol><li>kiosk</li></ol>
صالون|ṣālūn|صالونات	<i>noun</i><br><ol><li>living room</li><li>reception hall, salon</li></ol>
صاية|صايات|ṣāyāt|ṣāya	<i>noun</i><br><ol><li>skirt</li></ol>
صب|صبّيت|صبّيتي|صبّوا|صبّت|تصبّ|يصبّ|ṣabb|تصبّي|صبّي|تصبّوا|صبّينا|يصبّوا|نصبّ|yṣubb|صبّ|نصبّوا|يصب|صبّيتوا	<i>verb</i><br><ol><li>to pour out</li><li>to rain</li></ol>
صبع|صباع|ṣbaʕ|صبعان|ṣbuʕ	<i>noun</i><br><ol><li>finger; toe</li></ol>
صبيح|ṣubbīḥ	<i>noun</i><br><ol><li>early morning</li></ol>
صحيح|أصحح|صحيحين|ṣḥīḥ|ṣḥīḥa|ṣḥāḥ|صحاح|صحيحة|صحح|صحيحات	<i>adj</i><br><ol><li>healthy</li><li>strong</li><li>correct</li></ol>
صداع|ṣdāʕ|صداعات	<i>noun</i><br><ol><li>noise</li><li>ache</li></ol>
صدع|صدّعنا|يصدّعوا|صدّعتوا|صدّعت|صدّع|يصدع|يصدّع|صدّعتي|تصدّعي|صدّعي|نصدّع|ṣaddaʕ|تصدّع|صدّعوا|نصدّعوا|تصدّعوا	<i>verb</i><br><ol><li>(transitive) to annoy</li></ol>
صدفة|ṣudfa|صدفات|صدافي|صدف|ṣadfa	<i>noun</i><br><ol><li>chance (accidental occurrence), accident, coincidence</li><li>button (knob or small disc serving as a fastener)</li></ol>
صرفق|ṣarfaq|يصرفق	<i>verb</i><br><ol><li>to smack; to slap</li></ol>
صعوبية|ṣʕūbiyya	<i>noun</i><br><ol><li>difficultness</li></ol>
صعيب|صعب|صعيبين|ṣʕīb|صعيبة|صعاب|صعيبات|أصعب	<i>adj</i><br><ol><li>difficult</li></ol>
صغوري|صغوريين|ṣaḡḡūriyya|صغورية|ṣaḡḡūri|صغوريات	<i>adj</i><br><ol><li>very small</li></ol>
صغورية|ṣḡūriyya|ṣaḡḡūriyya	<i>noun</i><br><ol><li>smallness</li></ol>
صغير|صغيرين|ṣḡīr|صغار|صغر|صغيرات|أصغر|صغيرة	<i>adj</i><br><ol><li>small</li><li>young (for a person)</li></ol>
صفاية|صفايات|ṣaffāya	<i>noun</i><br><ol><li>sieve (for liquids)</li></ol>
صفر|صفرا|صوفر|أصفر|صفرين|صفرات|ṣfar	<i>adj</i><br><ol><li>yellow</li></ol>
صفف|يصفف|نصفّفوا|نصفّف|يصفّف|تصفّفوا|تصفّفي|صفّفتي|صفّفوا|تصفّف|صفّفي|ṣaffaf|صفّف|صفّفنا|يصفّفوا|صفّفتوا|صفّفت	<i>verb</i><br><ol><li>(transitive) to line up, to align</li></ol>
صفق|ṣaffaq|يصفق	<i>verb</i><br><ol><li>to clap</li></ol>
صفورية|ṣfūriyya	<i>noun</i><br><ol><li>yellowness</li></ol>
صلاية|صلايات|ṣallāya	<i>noun</i><br><ol><li>prayer rug, prayer mat</li></ol>
صلح|صلّحوا|نصلّحوا|نصلّح|صلّح|صلّحي|يصلّحوا|صلّحنا|تصلّحوا|يصلح|تصلّحي|صلّحتي|صلّحتوا|يصلّح|صلّحت|ṣlaḥ|تصلّح	<i>verb</i><br><ol><li>to fix</li><li>to be fit, to be suitable</li><li>to iron (to pass an iron over clothing)</li></ol>
صندالة|ṣandāla|صندالات|صنادل	<i>noun</i><br><ol><li>sandal</li></ol>
صندل|صنادل|ṣandal	<i>noun</i><br><ol><li>sandal</li></ol>
صنعة|ṣanʕa|صنعات|صنايع	<i>noun</i><br><ol><li>craft, trade</li><li>one’s craft, one’s trade</li></ol>
صهريج|ṣahrīj|صهارج	<i>noun</i><br><ol><li>reservoir</li><li>pool</li><li>tank</li></ol>
صوب|يصوب|ṣawwab	<i>verb</i><br><ol><li>(intransitive) to move aside</li></ol>
صوبة|صوبات|ṣūbba	<i>noun</i><br><ol><li>soup</li></ol>
صوت|صوّتتوا|صوّت|نصوّتوا|صوات|ṣūt|تصوّتوا|صوّتت|صوّتوا|صَوْت|صوّتي|نصوّت|يصوّتوا|ṣawt|يصوت|ṣawwat|صوّتتي|صوّتنا|تصوّتي|يصوّت|تصوّت|صُوت	<i>noun</i><br><ol><li>voice (sound uttered by the mouth)</li><li>sound</li><li>vote, ballot</li></ol><br><i>verb</i><br><ol><li>to vote</li></ol>
صور|نصوّروا|صوّرتي|صوّرتوا|يصوّروا|تصوّري|ṣawwar|صوّرت|تصوّروا|صوّروا|نصوّر|يصوّر|يصور|تصوّر|صوّري|صوّر|صوّرنا	<i>verb</i><br><ol><li>to photograph</li></ol>
صيد|يصيد|صيّدوا|صيدتوا|صيّد|نصيدوا|تصيّدت|ṣayyad|or يصَيّد|ṣiyyad|صيّدت|صَيّد|تصيّدتي|يصيدوا|تتصيّدي|صيدوا|تصيّدتوا|ṣayd|تصيّدنا|صيّدتوا|تصيد|يصيّد|نصيد|يتصيّدوا|صيدت|تصِيّد|صيدي|صيّدتي|يصِيّد|يتصِيّد|صيدنا|tṣiyyad|تتصيّدوا|تصَيّد|يتصيّد|ṣīd|تصيدوا|نتصيّدوا|صيّدنا|تصيّد|تتصيّد|نتصيّد|tṣayyad|or يتصَيّد|صيدتي|نصيّد|صِيد|تصيّدوا|تصيدي|تصيّدي|صيّدي|صَيْد|نصيّدوا|يصيّدوا|صِيّد	<i>verb</i><br><ol><li>to hunt, to fish</li><li>to dupe</li></ol><br><i>noun</i><br><ol><li>hunting, fishing</li></ol>
صيف|صيوفة|صَيْف|صِيف|ṣīf|ṣayf|صيوف	<i>noun</i><br><ol><li>summer</li></ol>
ضامة|ضامات|ḍāma	<i>noun</i><br><ol><li>draughts</li></ol>
ضاية|ḍāya|ضايات	<i>noun</i><br><ol><li>lake</li></ol>
ضايف|متضايف|ضايفتوا|تضايف|نضايفوا|تضايفي|ḍāyaf|ضايفت|ضايفوا|يضايف|ضايفنا|نضايف|يضايفوا|مضايفة|ضايفي|تضايفوا|ضايفتي|مضايف	<i>verb</i><br><ol><li>to invite over, to invite as a guest, to offer hospitality</li></ol>
ضباب|ḍbāb	<i>noun</i><br><ol><li>(uncountable) fog</li></ol>
ضبابة|ḍbāba	<i>noun</i><br><ol><li>(uncountable) fog</li></ol>
ضحك|ḍaḥḥak|تضحّكي|ضحّك|ḍaḥk|يضحّك|يضحك|نضحّك|تضحّكوا|يضحّكوا|ضحكات|ضحّكتي|ḍḥak|ضحّكتوا|ضحّكنا|تضحّك|ضحكة|ضحّكي|ضحّكت|ضحّكوا|نضحّكوا	<i>verb</i><br><ol><li>to laugh</li><li>to smile</li><li>to make (someone) laugh</li><li>to make (someone) smile</li></ol><br><i>noun</i><br><ol><li>laughter</li></ol>
ضد|ضدود|ضدك|ضدكي|ضدها|ضدكم|ضدنا|ضدودة|ضدي|ضدهم|ضده|ḍadd	<i>noun</i><br><ol><li>opposite, contrast</li><li>antonym</li></ol><br><i>prep</i><br><ol><li>against</li></ol>
ضر|ضرّيتي|yḍurr|ضرّوا|ضرّت|ضرّ|يضَر|يضرّوا|تضرّ|ضرّينا|نضرّوا|ضرّيت|يضرّ|نضرّ|يضر|ضرّيتوا|تضرّي|or يضُر|ضرّي|تضرّوا|yḍarr|ḍarr	<i>verb</i><br><ol><li>to harm</li><li>to hurt</li></ol>
ضربان|ḍurbān	<i>noun</i><br><ol><li>porcupine</li></ol>
ضرسة|ضروس|ḍarsa|ضراس	<i>noun</i><br><ol><li>molar tooth</li></ol>
ضفر|ḍfar|ضفران|ḍfur|ضفار	<i>noun</i><br><ol><li>nail (of finger or toe)</li></ol>
ضل|ḍall	<i>noun</i><br><ol><li>shadow</li></ol>
ضلعة|ضلوعة|ḍalʕa|ضلوع	<i>noun</i><br><ol><li>(anatomy) rib</li></ol>
ضهر|ضهور|ضْهُر|ḍhar|ḍuhr|ضُهْر|ḍhur|يضهر|ضهورة	<i>verb</i><br><ol><li>to be visible</li><li>to think (to conceive of something or someone)</li></ol><br><i>noun</i><br><ol><li>(anatomy) back</li><li>noon</li></ol>
ضو|ḍū|ضُوّ|ضَوّ|ḍuww|ضواو|ḍaww|ضُو|ḍwāw	<i>noun</i><br><ol><li>light</li><li>electricity</li></ol>
ضوا|ضويوا|ضويت|ضويتوا|ضواوا|تضويوا|yḍawwi|نضويوا|ضوي|نضوي|ḍawwa|ضوات|تضوي|يضويوا|ضوينا|ضويتي|يضوي	<i>verb</i><br><ol><li>(transitive) to light, to illuminate</li></ol>
ضوضان|ḍūḍān|ضوضانات|ضواضن|ضوضانة	<i>noun</i><br><ol><li>speedbumps</li></ol>
ضيافة|ضيافات|ḍyāfa	<i>noun</i><br><ol><li>hospitality</li></ol>
ضيف|ḍayf|ضيّفت|تضيّف|تضيّفوا|ضِيفة|ضيّفتي|يضيّف|ḍīf|ḍayyaf|ضَيْف|ضياف|تضيّفي|ضيّفنا|ضيّفي|يضيّفوا|نضيّفوا|ضيّفوا|ضيّفتوا|ضَيْفة|ضِيف|نضيّف|يضيف|ضيّف	<i>noun</i><br><ol><li>guest</li></ol><br><i>verb</i><br><ol><li>to invite over, to invite as a guest, to offer hospitality</li></ol>
ضيق|ḍiyyqa|ضيقة|ضيقين|ḍiyyqāt|ضيقات|ḍiyyqīn|ḍiyyaq|أضيق	<i>adj</i><br><ol><li>narrow</li></ol>
ضيقة|ḍiyyqāt|ḍiyyqa|ضيقات|ḍīqa	<i>noun</i><br><ol><li>asthma</li></ol>
طاب|تطيبوا|طيبوا|ṭiyyab|طبنا|نطيب|طبتوا|طيبتوا|طِيب|يطيب|يطيّب|طيبت|ṭāb|طيّبتي|ṭayyab|طبتي|يطيّبوا|طيّبتوا|طيبنا|طيّبت|طَيب|طابت|طيّبي|تطيب|طبت|طابوا|طيّبوا|نطيبوا|تطيّب|يطِيب|تطيّبوا|طيّب|تطيبي|يطيبوا|طيبي|نطيّب|نطيّبوا|طيبتي|تطيّبي|طيّبنا|or يطَيب|طيب	<i>verb</i><br><ol><li>to ripen, to be cooked</li></ol>
طابلة|طبالي|ṭābla|طوابل|طابلات	<i>noun</i><br><ol><li>(furniture) table</li></ol>
طاح|طحت|طحنا|طاحوا|نطيحوا|طيحي|تطيحوا|طحتوا|تطيح|طيح|يطيحوا|yṭīḥ|نطيح|طيحوا|طاحت|طحتي|ṭāḥ|تطيحي|يطيح	<i>verb</i><br><ol><li>(intransitive) to fall</li></ol>
طار|نطير|يطير|طاروا|طارت|طرنا|تطير|نطيروا|طير|ṭār|طيروا|طرتي|تطيري|طيري|طرتوا|yṭīr|يطيروا|طرت|تطيروا	<i>verb</i><br><ol><li>(intransitive) to fly</li><li>to fly (someone) [+ ب (object)]</li><li>(intransitive) to move rapidly</li></ol>
طارو|طوارو|ṭārru|طاروات	<i>noun</i><br><ol><li>garbage can</li></ol>
طاسة|ṭāsa|طواسي|طاسات	<i>noun</i><br><ol><li>cup (drinking vessel)</li><li>alcoholic drink</li></ol>
طاش|يطيشوا|طيشوا|طيش|طيشي|طاشات|يطيش|طاشوا|نطيش|نطيشوا|طشتوا|تطيش|تطيشي|طشتي|طاشت|طشت|طشنا|ṭāš|تطيشوا	<i>verb</i><br><ol><li>to be unsettled, to rock up the air, to swing</li><li>to be dispersed, to be dilapidated</li></ol><br><i>noun</i><br><ol><li>blot, blemish</li></ol>
طاقة|twāqi|طويقة|tāqa|تويقة|ṭāqa|تواقي|تاقة|ṭwāqi|طواقي	<i>noun</i><br><ol><li>window</li></ol>
طاقية|طاقيات|tāqiyya	<i>noun</i><br><ol><li>beanie</li></ol>
طانكة|طانكات|طوانك|ṭānga	<i>noun</i><br><ol><li>earring</li></ol>
طاوة|طواوي|طاوات|ṭāwa	<i>noun</i><br><ol><li>cooking pot</li></ol>
طاوس|طواوس|ṭāwis|طاوسات	<i>noun</i><br><ol><li>peacock</li></ol>
طاولة|ṭāwla|طاولات	<i>noun</i><br><ol><li>(furniture) desk</li></ol>
طاووس|ṭāwūs|طاووسات|طواوس	<i>noun</i><br><ol><li>peacock</li></ol>
طباخ|طباخة|ṭabbāḵ	<i>noun</i><br><ol><li>cook</li></ol>
طبع|يطبع|ṭbaʕ	<i>verb</i><br><ol><li>to print, imprint, stamp</li></ol>
طبقة|طبقات|ṭabqa	<i>noun</i><br><ol><li>storey; floor; level</li></ol>
طبوزي|طبوزية|طبوزيان|ṭabbūzi|طبوزيين	<i>adj</i><br><ol><li>fat, overweight</li></ol>
طبون|طبابن|ṭabbūn	<i>noun</i><br><ol><li>(vulgar) vagina</li></ol>
طبيب|أطباء|طبة|طبيبة|ṭbīb	<i>noun</i><br><ol><li>doctor, physician</li></ol>
طجين|طواجن|ṭwājin|ṭajīn	<i>noun</i><br><ol><li>tajine</li></ol>
طرش|طرشين|يطرَش|طورش|طرشة|طرشات|طرش|ṭarš|ṭraš|or يطرُش	<i>verb</i><br><ol><li>to smack, to slap</li></ol><br><i>noun</i><br><ol><li>deafness</li></ol><br><i>adj</i><br><ol><li>deaf</li></ol>
طرطق|ṭarṭaq|يطرطق	<i>verb</i><br><ol><li>to crack (knuckles, head, etc)</li><li>to pop</li><li>to explode</li></ol>
طرومبية|ṭrūmbiyya|طرومبيات	<i>noun</i><br><ol><li>top (spinning toy)</li></ol>
طريق|طرقان|ṭrīq	<i>noun</i><br><ol><li>way, road, path, track, street</li></ol>
طعام|ṭʕām	<i>noun</i><br><ol><li>couscous</li></ol>
طفاية|ṭaffāya|طفايات	<i>noun</i><br><ol><li>wall switch</li></ol>
طفى|ṭfa|يطفي	<i>verb</i><br><ol><li>to extinguish</li><li>to switch off (the light, a device, a candle)</li></ol>
طفيان|ṭafyān	<i>noun</i><br><ol><li>extinguishing</li><li>switching off</li></ol>
طلاب|طلابة|ṭallāb	<i>noun</i><br><ol><li>beggar</li></ol>
طلع تاكل الكرموس، نزل شكون قالها ليك|ṭlaʕ tākul el-karmūs|nzal škūn qālha līk	<i>proverb</i><br><ol><li>Used when someone tells someone else to do something and then criticises them for it (because they changed their mind in the meantime, etc.).</li></ol>
طليان|ṭalyān	<i>name</i><br><ol><li>Italy (a country in Europe)</li></ol>
طمبيل|طنبيلات|طوموبيل|طنابل|ṭmābil|ṭumubīl|طمبيلات|طوموبيلات|طمابل|طميبيلة|طنيبيلة|ṭunubīl|ṭumubīlāt|طنبيل	<i>noun</i><br><ol><li>car</li></ol>
طنجة|ṭanja	<i>name</i><br><ol><li>Tangier (the capital city of the region of Tanger-Tetouan-Al Hoceima, Morocco)</li></ol>
طنجرة|طناجر|طنجرات|ṭanjra	<i>noun</i><br><ol><li>pot</li><li>cooking pot</li><li>pressure cooker</li></ol>
طنجرة الكوكوت|طناجر الكوكوت|طنجرة الكوكوط|ṭanjrat el-kūkūt|طنجرات الكوكوط|طنجرات الكوكوت|طناجر الكوكوط|ṭanjrat el-kūkūṭ	<i>noun</i><br><ol><li>pressure cooker</li></ol>
طنجرة كسكسو|طنجرات كسكسو|طناجر كسكسو|ṭanjrat ksuksu	<i>noun</i><br><ol><li>Synonym of كسكاس (kaskās)</li></ol>
طنك|ṭang|طنوكة	<i>noun</i><br><ol><li>(military) tank (armoured fighting vehicle)</li></ol>
طواليط|طواليطات|ṭwālīṭ	<i>noun</i><br><ol><li>toilet</li></ol>
طوبة|ṭūbba|طوبات|طوب|ṭūba	<i>noun</i><br><ol><li>rat</li><li>a brick, baked brick, adobe brick</li></ol>
طون|ṭūn	<i>noun</i><br><ol><li>tuna</li></ol>
طويل|طوال|طويلة|طويلين|طول|أطول|طويلات|ṭwīl	<i>adj</i><br><ol><li>long, tall</li></ol>
طياب|طيابة|ṭayyāb	<i>noun</i><br><ol><li>cook</li></ol>
طيارة|ṭiyyāra|طيارات|طياير	<i>noun</i><br><ol><li>airplane, aircraft</li></ol>
طياشة|طياشات|ṭiyyāša	<i>noun</i><br><ol><li>swing (for children)</li></ol>
طيب|تطيبوا|طيبوا|ṭiyyab|نطيب|طيبتوا|طِيب|يطيب|يطيّب|طيبت|طيّبتي|ṭayyab|طيّبتوا|طيبنا|طيّبت|طَيب|طيّبي|تطيب|طيّبوا|نطيبوا|تطيّب|يطِيب|تطيّبوا|طيّب|تطيبي|يطيبوا|طيبي|نطيّب|نطيّبوا|طيبتي|تطيّبي|طيّبنا|or يطَيب|يطيّبوا	<i>verb</i><br><ol><li>to cook</li></ol>
طير الليل|ṭayr el-līl|ṭīr el-līl|ṭayr el-layl|ṭīr el-layl	<i>noun</i><br><ol><li>bat (winged animal)</li></ol>
عائلة|عايلات|ʕāyla|عايلة|عائلات	<i>noun</i><br><ol><li>family</li></ol>
عاد|ʕād	<i>adv</i><br><ol><li>just (recently)</li><li>yet</li></ol>
عاشر|ʕāšar|عاشرات|عاشرة|عاشرين	<i>adj</i><br><ol><li>tenth</li></ol>
عالريق|ʕar-rīq	<i>adv</i><br><ol><li>on an empty stomach</li></ol>
عام|ʕām|تعوم|عوموا|عَوْمان|عامة|ʕūmān|يعوموا|عمنا|عومان|عُومان|ʕawmān|ʕāmm|نعوموا|عوم|عامت|أعم|عامين|نعوم|تعوموا|أعوام|يعوم|عمتي|عمت|عمتوا|عاموا|عامات|عومي|تعومي	<i>noun</i><br><ol><li>year</li></ol><br><i>verb</i><br><ol><li>(intransitive) to swim</li></ol><br><i>adj</i><br><ol><li>public</li><li>prevalent, universal</li><li>general</li><li>common, ordinary</li></ol>
عاون|تعاوني|عاوني|عاونتوا|نعاون|تعاون|عاونوا|عاونتي|عاوننا|ʕāwan|يعاونوا|عاونت|نعاونوا|تعاونوا|يعاون	<i>verb</i><br><ol><li>(transitive) to help, to assist</li></ol>
عاير|عايرتي|تعاير|عايري|تعايري|عايرنا|نعاير|نعايروا|يعاير|عايروا|عايرت|تعايروا|ʕāyar|يعايروا|عايرتوا	<i>verb</i><br><ol><li>to insult</li></ol>
عاين|عايني|تعايني|تعاينوا|نعاينوا|عاينت|يعاين|نعاين|ʕāyan|عاينتوا|عاينوا|يعاينوا|عاينتي|تعاين|عايننا	<i>verb</i><br><ol><li>(transitive, intransitive) to wait</li></ol>
عبا|يعبيوا|yʕabbi|عبينا|عبيت|تعبي|عبات|عبي|عبيتي|ʕabba|عباوا|نعبي|نعبيوا|عبيوا|يعبي|تعبيوا|عبيتوا	<i>verb</i><br><ol><li>to take</li></ol>
عباد|ʕibād	<i>noun</i><br><ol><li>people</li><li>mankind</li></ol>
عباد الله|ʕibād allāh	<i>noun</i><br><ol><li>people</li></ol>
عتبة|ʕatba|عتبات	<i>noun</i><br><ol><li>threshold, doorsill</li></ol>
عتروس|عتارس|ʕatrūs	<i>noun</i><br><ol><li>billy goat</li></ol>
عجزان|عجزانة|عجزانين|ʕagzān|عجزانات	<i>adj</i><br><ol><li>lazy</li></ol>
عدو|عديان|ʕduww|عدوة	<i>noun</i><br><ol><li>enemy; foe</li></ol>
عرام|ʕurrām|عرارم	<i>noun</i><br><ol><li>massive amount</li></ol>
عربي|عرب|عربيات|ʕarbi|عربية	<i>adj</i><br><ol><li>Arab</li></ol><br><i>noun</i><br><ol><li>Arab (person)</li></ol>
عرس|يعرّس|عرّست|يعرس|تعرّس|ʕurs|عراسات|تعرّسي|عرّس|ʕarras|نعرّسوا|تعرّسوا|عرّستي|عرّستوا|يعرّسوا|عرّسوا|عرّسي|نعرّس|عرّسنا	<i>noun</i><br><ol><li>marriage</li><li>wedding</li><li>marriage feast</li></ol><br><i>verb</i><br><ol><li>to marry</li><li>to hold a marriage feast</li></ol>
عرف|ʕraf|يعرف	<i>verb</i><br><ol><li>to know</li></ol>
عرق|ʕraq|عرّقي|ʕarq|تعرّقوا|عرّقنا|يعرق|نعرّق|يعرّقوا|عرّق|عرّقت|ʕarraq|يعرّق|تعرّق|عرّقوا|نعرّقوا|عرّقتوا|تعرّقي|عرّقتي	<i>verb</i><br><ol><li>to sweat</li><li>to make sweat</li></ol><br><i>noun</i><br><ol><li>sweat</li></ol>
عرقان|عرقانين|ʕarqān|عرقانات|عرقانة	<i>adj</i><br><ol><li>sweaty</li></ol>
عرقل|تعرقيل|ʕarqal|يعرقل	<i>verb</i><br><ol><li>to obstruct</li></ol>
عروسة|عروسات|عريس|ʕrīs|عرايس|عرسان|ʕrūsa	<i>noun</i><br><ol><li>bride</li></ol>
عريان|ʕaryān|عريانين|عريانة|عريانات	<i>adj</i><br><ol><li>naked, nude</li></ol>
عريس|عروسات|ʕrīs|عرايس|عرسان|ʕrūsa|عروسة	<i>noun</i><br><ol><li>bridegroom</li></ol>
عزي|عزاوة|ʕazzi|عزيين|عزية	<i>noun</i><br><ol><li>(offensive, ethnic slur) black person</li></ol>
عسكر|ʕaskar	<i>noun</i><br><ol><li>armed forces, soldiers</li></ol>
عشا|ʕša|عشايات|عشاوات	<i>noun</i><br><ol><li>dinner, supper</li></ol>
عشر آلاف	<i>num</i><br><ol><li>ten thousand</li></ol>
عشرة|ʕušra|عشرات|عشر|ʕašra	<i>num</i><br><ol><li>ten</li></ol><br><i>noun</i><br><ol><li>companionship, friendship, partnership</li></ol>
عشرين|عَشرين|ʕašrīn|ʕušrīn|عُشرين	<i>num</i><br><ol><li>twenty</li></ol>
عشية|ʕšiyya|عشيات	<i>noun</i><br><ol><li>afternoon</li></ol>
عصارة|ʕaṣṣāra|عصارات	<i>noun</i><br><ol><li>juicer</li></ol>
عصفور|ʕaṣfūr|عصافر	<i>noun</i><br><ol><li>sparrow</li><li>any small bird</li></ol>
عصير|ʕaṣīr|عصيرات	<i>noun</i><br><ol><li>juice</li></ol>
عطار|ʕaṭṭār|عطارة	<i>noun</i><br><ol><li>spice seller</li></ol>
عطاي|ʕaṭṭāy|عطاية	<i>noun</i><br><ol><li>(vulgar) homosexual</li><li>(vulgar) snitch</li></ol>
عطرية|ʕaṭriyya	<i>noun</i><br><ol><li>spice, spices</li></ol>
عطس|يعطس|ʕṭas	<i>verb</i><br><ol><li>to sneeze</li></ol>
عطشان|عطشانين|عطشانة|عطشانات|ʕaṭšān	<i>adj</i><br><ol><li>thirsty</li></ol>
عطى|يعطي|ʕṭa	<i>verb</i><br><ol><li>to give</li></ol>
عقد|نعقّدوا|ʕaqd|يعقّدوا|عقّد|or يُعْقد|عقّدي|ʕqad|عقّدتي|عقّدوا|يعقد|تعقّد|ʕaqqad|عقّدت|يعقّد|عقّدنا|نعقّد|يِعْقد|تعقّدوا|عقّدتوا|عقود|تعقّدي	<i>verb</i><br><ol><li>to tie, knit, make a knot</li><li>to conclude a bargain or contract</li><li>to complicate</li></ol><br><i>noun</i><br><ol><li>contract</li><li>decade</li></ol>
عقل|ʕqal|يعقل	<i>verb</i><br><ol><li>to remember</li></ol>
عكاز|عكاكز|ʕukkāz	<i>noun</i><br><ol><li>walking stick, cane</li></ol>
علاش|ʕlāš	<i>adv</i><br><ol><li>(interrogative) why?</li><li>(interrogative) about what?</li></ol>
علاقة|ʕallāqa|علاقات|ʕalāqa	<i>noun</i><br><ol><li>coat hanger</li><li>relationship, kinship</li><li>relationship, connection</li><li>relation</li><li>relevance</li></ol>
علاه|ʕlāh	<i>adv</i><br><ol><li>(interrogative) why?</li><li>(interrogative) about what?</li></ol>
علف|علّفي|علّفنا|يعلّفوا|علّفتوا|تعلّف|ʕallaf|يعلف|علّفوا|تعلّفي|نعلّف|نعلّفوا|ʕlaf|ʕalf|يعلّف|تعلّفوا|علّفت|علّفتي|علّف	<i>verb</i><br><ol><li>to feed (animals)</li><li>to be fed (animals)</li></ol><br><i>noun</i><br><ol><li>fodder</li><li>hay</li></ol>
على|عليك|علي|ʕla|عليكم|عليها|علينا|عليه|عليهم	<i>prep</i><br><ol><li>on; upon; onto</li><li>against</li><li>expresses obligation</li></ol>
على من|ʕla man	<i>adv</i><br><ol><li>(interrogative) about whom?</li><li>(interrogative) on whom?</li></ol>
علياش|ʕlayāš	<i>adv</i><br><ol><li>(interrogative) why?</li><li>(interrogative) about what?</li></ol>
عمارة|ʕmāra|عمارات|ʕimāra	<i>noun</i><br><ol><li>residential building</li><li>filling</li></ol>
عمر|أعمار|تعمّري|ʕmur|عمّرت|عمّروا|عمّرنا|يعمّروا|نعمّر|عمُر|تعمّر|يعمر|ʕammar|عمّر|عمّرتوا|تعمّروا|عمّري|ʕmar|يعمّر|عمَر|عمّرتي|نعمّروا	<i>verb</i><br><ol><li>to fill (a container, etc.)</li></ol><br><i>noun</i><br><ol><li>age</li></ol>
عمل|ʕmal|يعمل	<i>verb</i><br><ol><li>to do</li></ol>
عملاول|عاملاول|ʕamlāwwal|ʕāmlawwal|ʕamlawwal|ʕāmlāwwal|عملول|عاملول	<i>adv</i><br><ol><li>last year</li></ol>
عند|عندنا|عندك|عندها|عندكم|عندهم|ʕand|عنده|عندي	<i>prep</i><br><ol><li>at the house of</li><li>expresses possession, to have</li></ol>
عنزي|ʕanzi	<i>noun</i><br><ol><li>goatmeat, chevon</li></ol>
عنعن|ʕanʕan	<i>noun</i><br><ol><li>(childish) car</li></ol>
عنق|عنّقوا|يعنق|عنّقنا|يعنّق|نعنّق|ʕannaq|عنّقتوا|عنوق|عنّقي|عنوقة|عنّق|عنّقت|عنّقتي|يعنّقوا|تعنّقي|تعنّقوا|ʕunq|نعنّقوا|تعنّق	<i>verb</i><br><ol><li>to hug</li></ol><br><i>noun</i><br><ol><li>(anatomy) neck</li></ol>
عوج|معوج|يعوج|تعواج|ʕwaj|عوجات|عوجين|ʕawwaj|ʕawj|عوجة	<i>adj</i><br><ol><li>deformed, crooked</li><li>bent</li></ol><br><i>noun</i><br><ol><li>crookedness</li></ol><br><i>verb</i><br><ol><li>to bend</li></ol>
عود|عواد|عودان|ʕūd|ʕawd	<i>noun</i><br><ol><li>wood, timber</li><li>stick</li><li>branch, twig</li><li>(music) oud, lute</li><li>horse</li></ol>
عود النوار|عودة النوار|عواد النوار|عودات النوار|ʕūd en-nuwwār	<i>noun</i><br><ol><li>cloves</li></ol>
عيان|ʕiyyān|عيانات|عين|عيانين|أعين|عيانة	<i>adj</i><br><ol><li>tired</li><li>weak</li></ol>
عيط|تعيطي|عَيط|يعيط|تعيّط|يعيّطوا|عيطت|نعيط|نعيّط|yʕiyyaṭ|ʕiyyaṭ|عيّطنا|عيّطتي|عيطنا|عيطتوا|ʕayyaṭ|عيطتي|عيطي|yʕayyaṭ|عيّطتوا|نعيطوا|عيّطي|عيّط|عِيط|تعيّطي|تعيّطوا|يعيّط|يعَيط|عيطوا|يعيطوا|تعيط|عيّطوا|عيّطت|تعيطوا|نعيّطوا|or يعِيط	<i>verb</i><br><ol><li>to call</li></ol>
عين|ʕīn|عِين|عِينَين|ʕayn|عوينة|عَيْن|عَيْنَين|عيون	<i>noun</i><br><ol><li>(anatomy) eye (organ)</li><li>spring (of water)</li><li>envy</li></ol>
غ|غـ|ḡa	<i>particle</i><br><ol><li>will (prefix indicating the future tense)</li></ol>
غادي|ḡādi	<i>particle</i><br><ol><li>added to a non-past verb form to express future tense: will</li></ol>
غالي|ḡāli|غلى|غاليين|غالية|غاليات|أغلى	<i>adj</i><br><ol><li>expensive</li></ol>
غبرة|غبرات|ḡubra	<i>noun</i><br><ol><li>dust</li></ol>
غبور|ḡbūr	<i>noun</i><br><ol><li>absence, disappearance</li></ol>
غدا|ḡadda|ɣda|ɣadda|غداوات	<i>adv</i><br><ol><li>tomorrow</li></ol><br><i>noun</i><br><ol><li>tomorrow</li><li>lunch</li></ol>
غر|نغرّ|غرّينا|ḡarr|غرّت|غرّيت|غرّ|تغرّي|تغرّوا|غرّيتي|نغرّوا|غرّيتوا|غرّوا|يغرّ|يغرّوا|غرّي|يغر|تغرّ	<i>verb</i><br><ol><li>to deceive</li></ol>
غرب|ḡarb	<i>noun</i><br><ol><li>west</li></ol>
غربال|غرابل|ḡurbāl|ḡarbāl|غَربال|غُربال	<i>noun</i><br><ol><li>coarse sieve (for grain)</li></ol>
غرفة|غرفات|ḡurfa	<i>noun</i><br><ol><li>upper room (in a house, usually on the rooftop)</li></ol>
غرق|غرّق|يغرّق|غرّقتوا|يغرّقوا|غرّقي|ḡurq|تغرّقوا|يغرق|غرّقتي|غرّقت|تغرّق|نغرّقوا|غرّقنا|نغرّق|ḡraq|غرّقوا|تغرّقي|ḡarraq	<i>verb</i><br><ol><li>to drown</li><li>to sink</li><li>(figuratively) to be overwhelmed</li><li>to deepen</li></ol><br><i>noun</i><br><ol><li>depth</li></ol>
غرقان|ḡarqān|غرقانة|غرقانات|غرقانين	<i>adj</i><br><ol><li>drowning</li></ol>
غزال|غزالين|غزالة|غزلان|ḡzāl	<i>noun</i><br><ol><li>gazelle</li></ol><br><i>adj</i><br><ol><li>beautiful</li></ol>
غش|نغشّوا|يغشّوا|غشّيت|تغشّ|تغشّي|تغشّوا|غشّيتوا|غشّ|ḡašš|yḡušš|غشّيتي|غشّي|يغش|غشّينا|نغشّ|يغشّ|غشّت|غشّوا	<i>verb</i><br><ol><li>to cheat, to cheat someone</li></ol><br><i>noun</i><br><ol><li>deceit, fraud, imposture</li><li>cheating, academic dishonesty</li></ol>
غضبان|غضبانات|غضبانة|ḡaḍbān|غضبانين	<i>adj</i><br><ol><li>angry, furious, enraged</li></ol>
غطا|ḡṭa|غطاوات	<i>noun</i><br><ol><li>cover</li><li>lid</li><li>blanket</li></ol>
غطى|نغطّي|ḡaṭṭa|يغطّيوا|غطّي|تغطّي|نغطّيوا|غطّيوا|غطّيتوا|غطّى|يغطي|غطّيت|غطّاوا|يغطّي|تغطّيوا|غطّيتي|غطّات|غطّينا	<i>verb</i><br><ol><li>to cover; to wrap</li></ol>
غلا|يغلا|ḡla	<i>verb</i><br><ol><li>to become expensive</li></ol><br><i>noun</i><br><ol><li>high cost</li></ol>
غلاض|يغلاض|ḡlāḍ	<i>verb</i><br><ol><li>to become fat</li></ol>
غلاقة|ḡlāqa|غلاقات	<i>noun</i><br><ol><li>bottle cap</li></ol>
غلاي|غلايات|ḡallāy	<i>noun</i><br><ol><li>kettle</li></ol>
غلض|غُلض|ḡalḍ|تغلّض|ḡallaḍ|غلّضتوا|نغلّض|غَلض|تغلّضي|غلّض|ḡulḍ|غلّضوا|غلّضنا|غلّضي|يغلّض|غلّضت|نغلّضوا|غلّضتي|تغلّضوا|يغلّضوا	<i>noun</i><br><ol><li>fatness</li></ol><br><i>verb</i><br><ol><li>to fatten</li></ol>
غلوضية|ḡlūḍiyya	<i>noun</i><br><ol><li>obesity</li></ol>
غلى|يَغلي|or يِغلي|غلّيتوا|يغلّي|يغلي|ḡla|تغلّيوا|يغلّيوا|غلّى|غلّيوا|غلّي|غلّيتي|غلّاوا|غلّيت|yḡalli|غلّينا|غلّات|نغلّيوا|تغلّي|ḡalla|نغلّي	<i>verb</i><br><ol><li>(intransitive) to boil</li><li>(transitive) to boil</li><li>to make something expensive</li></ol>
غليض|غلاض|غليضة|ḡlīḍ|غليضات|غليضين	<i>adj</i><br><ol><li>fat, overweight</li><li>thick</li></ol>
غمز|ḡmaz|يغمز	<i>verb</i><br><ol><li>(intransitive, transitive) to wink</li><li>to wink at (someone) (+ في (fi))</li></ol>
غمزة|غميزة|ḡamza|غمزات	<i>noun</i><br><ol><li>wink</li></ol>
غمس|تغمّسي|yḡammas|يغمّس|تغمّس|غمّس|غمّسوا|نغمّس|تغمّسوا|غمّستي|غمّسنا|نغمّسوا|يغمّسوا|غمّسي|غمّست|ḡammas|غمّستوا|يغمس	<i>verb</i><br><ol><li>to dip</li><li>to wet</li></ol>
غمق|يغمق|ḡmaq	<i>verb</i><br><ol><li>to fool, to trick</li></ol>
غميضة|ḡummīḍa|غمَّيْضة|غمِّيضة|ḡummayḍa	<i>noun</i><br><ol><li>hide and seek</li></ol>
غنزوز|ḡanzūz	<i>noun</i><br><ol><li>(vulgar) vagina</li></ol>
غوت|غوّتتوا|تغوّت|نغوّتوا|ḡawwat|يغوّتوا|يغوت|غوّتت|غوّت|غوّتوا|غوّتي|نغوّت|غوّتتي|تغوّتوا|يغوّت|تغوّتي|غوّتنا	<i>verb</i><br><ol><li>to shout, to scream</li><li>(rural) to call</li></ol>
غيمة|غيام|ḡīma	<i>noun</i><br><ol><li>cloud</li></ol>
فا|فواه|fā|فمام	<i>noun</i><br><ol><li>mouth</li></ol>
فات|فايتات|fāt|يفوت|فايتين|فتت|فوت|فوتوا|فتتي|فايت|فتنا|fāyit|نفوتوا|فاتوا|تفوتي|فاتت|يفوتوا|فوتي|فتتوا|تفوت|نفوت|فايتة|تفوتوا	<i>verb</i><br><ol><li>(intransitive) to pass</li></ol>
فاجأ|متفاجئ|fājaʔ|يفاجئ|مفاجي|مفاجأة	<i>verb</i><br><ol><li>(transitive) to surprise</li></ol>
فاجى|fāja|مفاجي|يفاجي|متفاجي|مفاجية	<i>verb</i><br><ol><li>(transitive) to cheer up</li></ol>
فار|تفوّري|تفوّروا|فارت|فوّر|فيران|فرنا|تفوري|فوروا|تفوّر|فاروا|فرتي|فوّرتي|فوّرتوا|fawwar|yfawwar|يفوّر|فوّرت|فرت|yfūr|فرتوا|يفور|فوّرنا|فوّروا|يفوّروا|نفوروا|fār|تفوروا|فور|نفوّر|نفوّروا|نفور|فارة|تفور|فوري|يفوروا|فوّري	<i>noun</i><br><ol><li>mouse</li></ol><br><i>verb</i><br><ol><li>to boil up</li></ol>
فاز|تفوزي|فزتوا|فزتي|يفوز|تفوزوا|فازوا|نفوزوا|فوزوا|فازات|fāz|تفوز|vāz|يفوزوا|فزت|فوز|فوزي|فزنا|فازت|فيزان|نفوز	<i>verb</i><br><ol><li>to win</li></ol><br><i>noun</i><br><ol><li>vase</li></ol>
فاس|fās|فيسان	<i>noun</i><br><ol><li>axe</li><li>pickaxe</li></ol><br><i>name</i><br><ol><li>Fez (the capital city of the region of Fez-Meknes, Morocco)</li></ol>
فاسمة|fāsma|فاسمات	<i>noun</i><br><ol><li>bandage, dressing, sticking plaster</li></ol>
فاق|فيقتوا|تفيق|نفيقوا|فيقت|تفيقوا|نفيق|فيقتي|فقتوا|فيق|فيقنا|فقت|يفيق|فاقت|فقتي|تفيقي|yfīq|فاقوا|fiyyaq|فيقوا|فقنا|فيقي|fāq|يفيقوا	<i>verb</i><br><ol><li>(intransitive) to wake up</li></ol>
فالصباح|f-eṣ-ṣbāḥ	<i>noun</i><br><ol><li>in the morning</li></ol>
فالطة|فالطات|fālṭa	<i>noun</i><br><ol><li>fault</li></ol>
فانيد|fānīd|فانيدات|فانيدة	<i>noun</i><br><ol><li>candy</li><li>pill</li></ol>
فايت|فايتة|فايتات|fāyit|فايتين	<i>adj</i><br><ol><li>past, prior, last</li></ol>
فايدة|fāyda	<i>noun</i><br><ol><li>usefulness</li></ol>
فاين|fāyen	<i>adv</i><br><ol><li>(interrogative) where?</li></ol>
فتش|نفتّش|فتّش|تفتّش|يفتّش|فتّشي|فتّشت|تفتّشوا|فتّشوا|تفتّشي|فتّشنا|يفتّشوا|fattaš|نفتّشوا|فتّشتوا|يفتش|فتّشتي	<i>verb</i><br><ol><li>to search, look for</li><li>to investigate</li></ol>
فجلي|fajli	<i>noun</i><br><ol><li>pink (colour)</li></ol>
فخار|faḵḵār|فخارة	<i>noun</i><br><ol><li>pottery, earthenware</li><li>potter</li></ol>
فراشة|فراشات|farāša	<i>noun</i><br><ol><li>butterfly</li></ol>
فران|frān|farrān|فرانات|فرارن	<i>noun</i><br><ol><li>oven</li><li>bakery</li><li>brake</li></ol>
فرحان|farḥān|فرحانين|فرحانة|فرحانات|أفرح|فرح	<i>adj</i><br><ol><li>happy, joyous</li></ol>
فردة|فردات|farda	<i>noun</i><br><ol><li>one of a pair</li></ol>
فردي|فرادة|fardi	<i>noun</i><br><ol><li>handgun</li></ol>
فرزية|farziyya|فرزيات	<i>noun</i><br><ol><li>favoritism</li></ol>
فرش|تفرّش|فرّشتوا|تفرّشوا|تفرّشي|نفرّش|يفرّش|فرّشوا|فرّش|فرّشت|نفرّشوا|فرّشنا|يفرش|فرّشتي|فرّشي|farraš|يفرّشوا	<i>verb</i><br><ol><li>to furnish</li></ol>
فرشيطة|فراشط|furšīṭa|فرشيطات	<i>noun</i><br><ol><li>fork</li></ol>
فرطوط|فراطط|farṭūṭ	<i>noun</i><br><ol><li>moth</li></ol>
فرفارة|فرافر|farfāra|فرفارات	<i>noun</i><br><ol><li>fan (electrical device for cooling)</li><li>fan (electrical device for machinery)</li></ol>
فرقع|يفرقع|fargaʕ|farqaʕ|or يفرقع	<i>verb</i><br><ol><li>to explode</li></ol>
فرماج|furmāj|فُرْماجة|فْرُماج|فُرْماجات|frumāj|فْرُماجة|فْرُماجات|فُرْماج	<i>noun</i><br><ol><li>cheese</li></ol>
فرملي|فرملية|farmli|فرمليين	<i>noun</i><br><ol><li>nurse</li></ol>
فرنسا|fransa	<i>name</i><br><ol><li>France (a country in Europe)</li></ol>
فروج|فرارج|farrūj	<i>noun</i><br><ol><li>rooster</li></ol>
فريز|فريزة|frīz|فريزات	<i>noun</i><br><ol><li>strawberry</li></ol>
فريق|فرق|farīq	<i>noun</i><br><ol><li>party, group</li><li>team; sports club</li></ol>
فزع|fzaʕ|يفزع	<i>verb</i><br><ol><li>to be afraid</li></ol>
فسر|فسّرتوا|fassar|فسّرنا|فسّرت|فسّروا|يفسّر|فسّر|فسّرتي|تفسّر|يفسّروا|تفسّري|فسّري|تفسّروا|يفسر|نفسّر|نفسّروا	<i>verb</i><br><ol><li>to clarify; to explain</li></ol>
فشلوق|fašlūq	<i>noun</i><br><ol><li>(vulgar) vagina</li></ol>
فضل|فضّلتي|فضّل|يتفضّل|تفضّلوا|faḍḍal|تفضّلي|نفضّلوا|فضّلي|tfaḍḍal|تفضّلتوا|فضّلتوا|تفضّلتي|تتفضّلي|تفضّل|فضّلنا|تفضّلنا|نتفضّل|تتفضّل|تفضل|نفضّل|يفضّل|يتفضّلوا|تفضّلت|فضّلوا|نتفضّلوا|يفضّلوا|فضّلت|تتفضّلوا	<i>verb</i><br><ol><li>to favor</li></ol>
فطور|fṭūr	<i>noun</i><br><ol><li>breakfast</li></ol>
فقر|faqr	<i>noun</i><br><ol><li>poverty</li></ol>
فقيه|fqīh|فقيهة|فقهة	<i>noun</i><br><ol><li>jurist and theologian, expert in Islamic jurisprudence, faqih</li><li>(by extension) expert</li><li>teacher of the Qur'an in a quranic school</li></ol>
فك|يفك|تفكّ|فكّينا|تفكّي|فكّ|فكّيتوا|تفكّوا|فكّي|فكّوا|fakk|فكّيت|فكّت|نفكّ|يفكّوا|فكّيتي|نفكّوا|يفكّ	<i>verb</i><br><ol><li>to loosen</li></ol>
فكر|فكّر|فكّرت|فكّرتي|نفكّروا|فكّرتوا|تفكّري|يفكر|يفكّر|نفكّر|تفكّروا|يفكّروا|تفكّر|فكّري|فكّروا|fakkar|فكّرنا	<i>verb</i><br><ol><li>to think</li><li>to cause to think of, to remind</li></ol>
فكرون|fkāren|فكارن|fakrūn	<i>noun</i><br><ol><li>tortoise, turtle</li></ol>
فلسطين|filisṭīn	<i>name</i><br><ol><li>Palestine (a country in Asia)</li></ol>
فلفلة|فلفلات|falfla	<i>noun</i><br><ol><li>pepper (including sweet peppers, chilis)</li></ol>
فلوس|fallūs|flūs|ڢلوس|فلالس	<i>noun</i><br><ol><li>money</li><li>chick, young chicken</li></ol>
فلوكة|flūka|فلوكات|فلايك	<i>noun</i><br><ol><li>small boat</li></ol>
فم|فواه|فمام|fumm	<i>noun</i><br><ol><li>mouth</li></ol>
فمن|fman	<i>adv</i><br><ol><li>(interrogative) in whom?</li></ol>
فنتة|فنتات|فناتي|fanta	<i>noun</i><br><ol><li>hairpin</li></ol>
فواقة|fuwwāqa	<i>noun</i><br><ol><li>hiccup</li></ol>
فور|تفوّر|يفور|فوّرنا|نفوّر|نفوّروا|فوّروا|تفوّروا|تفوّري|فوّرتي|فوّر|يفوّروا|فوّرتوا|fawwar|yfawwar|يفوّر|فوّرت|فوّري	<i>verb</i><br><ol><li>to steam (to cook with steam)</li></ol>
فورنو|fūrnu|فرارن	<i>noun</i><br><ol><li>oven</li></ol>
فوطة|فواطي|فوطات|fūṭa	<i>noun</i><br><ol><li>towel</li></ol>
فوق|فَوْق|فُوق|فوقها|فوقه|fūq|فوقي|fawq|فوقك|فوقنا|فوقكم|فوقهم	<i>noun</i><br><ol><li>location that is above</li></ol><br><i>adv</i><br><ol><li>above</li></ol><br><i>prep</i><br><ol><li>above, on top of</li></ol>
فوقاش|فُوقاش|fūqāš|فَوْقاش|fawqāš	<i>adv</i><br><ol><li>(interrogative) when?</li><li>(interrogative) above what?</li></ol>
فوقت ما|f-waqt emma|فْوَقت ما|fūqt emma|فُوقت ما	<i>conj</i><br><ol><li>whenever</li></ol>
فوقتاش|fwaqtāš|فوَقْتاش|fūqtāš|فُوقْتاش	<i>adv</i><br><ol><li>(interrogative) when?</li></ol>
فيرمة|فيرمات|fīrma	<i>noun</i><br><ol><li>farm</li></ol>
فيساع|fīsāʕ	<i>adv</i><br><ol><li>quickly</li></ol>
فيستة|fīsta|فيستات	<i>noun</i><br><ol><li>lounge jacket</li></ol>
فيشطة|fīšṭa|فيشطات	<i>noun</i><br><ol><li>party</li><li>carnival</li></ol>
فيق|فيقتوا|فيقي|يفيق|تفيقي|تفيق|فيقت|فيقتي|فيقوا|نفيقوا|تفيقوا|فيقنا|yfīq|يفيقوا|fiyyaq|نفيق	<i>verb</i><br><ol><li>(transitive) to wake up</li></ol>
فين|fīn	<i>adv</i><br><ol><li>(interrogative) where?</li></ol>
قادوس|qwādis|qādūs|قوادس	<i>noun</i><br><ol><li>pipe, conduit</li></ol>
قاس|قسنا|قيسنا|قستوا|يقوسوا|تقيسوا|نقوس|تقيس|تقوسوا|نقيس|قيست|يقوس|قيستوا|تقيسي|قوس|نقيسوا|قاسوا|قستي|تقوسي|قيستي|or يقوس|قست|قوسوا|قاست|qās|قيسي|qiyyas|يقيس|قيس|قوسي|يقيسوا|قيسوا|تقوس|نقوسوا	<i>verb</i><br><ol><li>to touch, to feel</li></ol>
قاسح|قسح|قاسحين|قاسحة|qāsiḥ|قساح|قاسحات|أقسح	<i>adj</i><br><ol><li>hard</li></ol>
قاع|قيعان|qāʕ	<i>noun</i><br><ol><li>bottom</li><li>buttock</li><li>all</li></ol>
قال|قلتوا|تقول|قلت|قول|قولي|قولوا|قلتي|تقولوا|نقول|قالت|يقول|qāl|نقولوا|تقولي|قالوا|قلنا|يقولوا	<i>verb</i><br><ol><li>to say</li></ol>
قام|يقوموا|نقوّموا|قوّمت|قوّم|قمت|قاموا|تقوموا|قوّموا|قمنا|نقوّم|تقوّموا|قوّمي|yqawwam|قوّمنا|قومي|qām|qawwam|قمتي|يقوم|قوّمتي|قوم|قمتوا|قامت|يقوّم|تقوم|نقوم|تقوّم|يقوّموا|قوّمتوا|تقوّمي|تقومي|yqūm|نقوموا|قوموا	<i>verb</i><br><ol><li>to stand up</li><li>used to form the inchoative</li></ol>
قب|qubb|قباب	<i>noun</i><br><ol><li>hood (headwear)</li></ol>
قبالة|قبالتكم|قبالتنا|قبالته|qbāla|قبالتي|قبالتهم|قبالتها|قبالتك	<i>prep</i><br><ol><li>in front of, in the presence of</li></ol>
قبط|يقبّط|تقبّطي|قبّطي|يقبط|تقبّطوا|نقبّطوا|قبّطت|يقبّطوا|تقبّط|قبّطنا|نقبّط|qbaṭ|قبّطوا|qabbaṭ|yqabbaṭ|قبّط|yaqbaṭ|قبّطتي|قبّطتوا	<i>verb</i><br><ol><li>to seize, to take, to grab</li><li>to capture, to arrest</li><li>to hold</li><li>to give into (someone's) possession</li></ol>
قبل|قبلي|قبلهم|قبلكم|قابل|قبول|مقبول|قبلك|قبلنا|qbal|قبله|قبلها|يقبل	<i>prep</i><br><ol><li>before, prior to</li></ol><br><i>verb</i><br><ol><li>to accept, to agree to something</li></ol>
قبوحية|qbūḥiyya	<i>noun</i><br><ol><li>rudeness</li><li>ugliness</li></ol>
قبية|قبيات|qubbiyya	<i>noun</i><br><ol><li>hoodie</li></ol>
قبيح|قبيحات|قبح|أقبح|قبيحة|qbīḥ|قبيحين|قباح	<i>adj</i><br><ol><li>ugly</li><li>infamous</li><li>abominable</li></ol>
قج|قجّيت|قجّ|قجّيتوا|تقجّ|تقجّوا|قجّي|قجّوا|نقجّوا|مقجوج|قجّيتي|قجّت|قجّينا|قاجات|maqjūj|مقجوجات|مقجوجين|qajj|qājj|نقجّ|مقجوجة|تقجّي|قاجين|قاج|يقجّوا|قاجة|يقجّ	<i>verb</i><br><ol><li>(transitive) to strangle, to throttle, to choke</li></ol>
قح|قحة|قحين|quḥḥ|قحاح|قحات	<i>adj</i><br><ol><li>pure, genuine, true</li></ol>
قحبة|قحبات|qaḥbāt|قحاب|qḥāb|qaḥba	<i>noun</i><br><ol><li>(vulgar) whore, harlot (a prostitute or any woman suspect of promiscuity or indecent behaviour)</li></ol>
قداش|qaddāš	<i>adv</i><br><ol><li>(interrogative) how much?</li></ol>
قدام|قدامنا|قدامكم|quddām|قدامهم|قدامه|قدامك|قدامها|قدامي	<i>prep</i><br><ol><li>in front of, in the presence of</li></ol>
قدومية|qdūmiyya	<i>noun</i><br><ol><li>oldness</li></ol>
قديد|qaddīd|قديدة|قديدات	<i>noun</i><br><ol><li>jerky</li></ol>
قديم|أقدم|قديمة|قديمات|qdīm|قدام|قدم	<i>adj</i><br><ol><li>old (of things)</li></ol>
قرآن|قرائن|qurʔān|قرآنات	<i>noun</i><br><ol><li>(in the definite) the Qur'an</li><li>a copy of the Qur'an</li></ol>
قرا|قريتوا|تقري|يقرا|qra|قريتي|قري|قرايات|قرا|qarra|قراوا|قرينا|qrāya|yqarri|قريت|نقريوا|or يَقرا|نقري|تقريوا|yiqra|قرات|يقري|yaqra|يقريوا|قريوا|قراية|يِقرا	<i>verb</i><br><ol><li>to read</li><li>to study</li><li>to teach</li></ol>
قراية|قرايات|qrāya	<i>noun</i><br><ol><li>reading</li><li>studying</li></ol>
قرة|gīrra	<i>noun</i><br><ol><li>war</li></ol>
قرتاح|qurtāḥ	<i>noun</i><br><ol><li>(Hawwari dialect) dog</li></ol>
قرجوطة|قرجوطات|qarjūṭa	<i>noun</i><br><ol><li>(anatomy) larynx</li></ol>
قرر|تقرّر|qarrar|نقرّر|يقرر|قرّرت|قرّروا|تقرّري|قرّري|تقرّروا|يقرّروا|نقرّروا|قرّرتي|قرّر|قرّرتوا|يقرّر|قرّرنا	<i>verb</i><br><ol><li>to decide</li></ol>
قرطاس|قراطس|قَرْطَاس|قُرْطَاس|qurṭās|qarṭās	<i>noun</i><br><ol><li>bullet (projectile)</li></ol>
قرعة|قراعي|qarʕa|قرعات	<i>noun</i><br><ol><li>bottle</li><li>pumpkin, gourd</li><li>courgette</li></ol>
قرفة|qarfa	<i>noun</i><br><ol><li>cinnamon</li></ol>
قرقابة|qarqāba|قراقب|قرقابات	<i>noun</i><br><ol><li>sandal</li></ol>
قرقورة|قرقورات|qarqūra	<i>noun</i><br><ol><li>toad</li></ol>
قرمزي|qarmzi	<i>noun</i><br><ol><li>scarlet (colour)</li></ol>
قرمود|قرمودة|قرمودات|قرامد|qarmūd	<i>noun</i><br><ol><li>flat burned bricks, tiles, tegulae</li></ol>
قرنفل|qrunful	<i>noun</i><br><ol><li>carnation (flower)</li><li>clove (spice)</li></ol>
قريب|قرب|قراب|قريبة|qrīb|أقرب|قريبين|قريبات	<i>adj</i><br><ol><li>near, close, adjacent</li></ol>
قزب|نقزّبوا|قزّبتي|نقزّب|qazzab|قزّبوا|تقزّب|قزّبنا|قزّب|يقزّب|تقزّبوا|تقزّبي|قزّبتوا|قزّبي|يقزب|يقزّبوا|قزّبت	<i>verb</i><br><ol><li>to flatter</li><li>to schmooze</li></ol>
قزبور|qazbūr	<i>noun</i><br><ol><li>coriander, cilantro</li></ol>
قزدير|qazdīr|قزديرة|قزديرات	<i>noun</i><br><ol><li>tin</li></ol>
قزيبة|qazzība|قزيبات	<i>noun</i><br><ol><li>tail</li><li>(vulgar) ass</li></ol>
قزيبرة البير|qzībrat el-bīr	<i>noun</i><br><ol><li>maidenhair fern</li></ol>
قسطل|قسطلة|qasṭal|قسطلات	<i>noun</i><br><ol><li>chestnuts</li></ol>
قسوحية|qsūḥiyya	<i>noun</i><br><ol><li>hardness</li></ol>
قشر|يقشّر|يقشّروا|قشّري|yqaššar|تقشّر|نقشّر|qaššar|قشّرت|تقشّري|قشّرنا|قشّرتوا|قشّر|تقشّروا|يقشر|قشّرتي|قشّروا|نقشّروا	<i>verb</i><br><ol><li>to peel, to husk</li></ol>
قشرة|قَشرة|قشور|qušra|qašra|قُشرة	<i>noun</i><br><ol><li>shell</li><li>dandruff</li></ol>
قشع|يقشع|qšaʕ	<i>verb</i><br><ol><li>to spot</li><li>to see</li><li>(figuratively) to understand</li></ol>
قشلة|قشلات|qašlāt|qašla	<i>noun</i><br><ol><li>barracks</li></ol>
قصورية|qṣūriyya	<i>noun</i><br><ol><li>shortness</li></ol>
قصير|قصيرات|قصيرين|قصيرة|قصار|أقصر|قصر|qṣīr	<i>adj</i><br><ol><li>short</li></ol>
قضى|qḍa|يقضي	<i>verb</i><br><ol><li>to finish</li><li>to complete</li><li>to carry out, to execute</li></ol>
قط|qṭūṭ|قطة|قطات|قطوط|qaṭṭa|قطوطة|qaṭṭ|qṭūṭa	<i>noun</i><br><ol><li>cat</li></ol>
قطن|قطنات|قطنة|qṭun	<i>noun</i><br><ol><li>cotton</li></ol>
قفز|يقفّز|تقفّز|قفّزت|قفّزنا|قفّزتي|نقفّزوا|قفّزي|قفّزتوا|نقفّز|تقفّزوا|يقفز|qaffaz|يقفّزوا|تقفّزي|قفّز|قفّزوا	<i>verb</i><br><ol><li>to startle</li></ol>
قفل|قفّلت|تقفّلي|قفّلتي|قفّلوا|قفّلتوا|قفُل|يقفّلوا|قفَل|qful|yiqfal|قفّلنا|نقفّلوا|yqaffal|تقفّلوا|يقفل|نقفّل|qaffal|تقفّل|قفولة|qfal|قفّل|قفول|يقفّل|قفّلي	<i>verb</i><br><ol><li>to close</li><li>to lock</li></ol><br><i>noun</i><br><ol><li>lock</li></ol>
قلادة|قلايد|qlāda	<i>noun</i><br><ol><li>necklace</li></ol>
قلاوي|qlāwi	<i>intj</i><br><ol><li>(vulgar, in the definite form) fuck!</li></ol><br><i>noun</i><br><ol><li>(vulgar, slang) dude</li></ol>
قلب|يقلب|qlab|qalb|قلّبوا|يقلّب|قلّب|يقلّبوا|qallab|قلّبتي|قلّبتوا|تقلّبي|تقلّب|yqallab|قلّبت|تقلّبوا|قلوب|yiqlab|قلوبة|نقلّب|نقلّبوا|قلّبي|قلّبنا	<i>noun</i><br><ol><li>heart</li><li>core</li></ol><br><i>verb</i><br><ol><li>to turn, to flip</li><li>to search</li></ol>
قلقل|نقلقلوا|قلقلتي|يقلقلوا|قلقلي|qalqal|نقلقل|قلقلتوا|تقلقل|قلقلوا|قلقلت|تقلقلي|تقلقلوا|يقلقل|قلقلنا	<i>verb</i><br><ol><li>(ditransitive) to put words in someone's mouth</li></ol>
قلوة|qalwa|قلاوي|qlāwi|قليوة	<i>noun</i><br><ol><li>(vulgar) testicle</li><li>(vulgar, slang) thing</li></ol>
قمر|أقمار|yqammar|قمّروا|يقمر|قمّرتي|قمّرتوا|نقمّروا|نقمّر|قمّرنا|تقمّروا|قمّر|qamar|يقمّر|تقمّر|قمّرت|تقمّري|يقمّروا|قمّري|qammar	<i>noun</i><br><ol><li>moon</li><li>to gamble</li></ol>
قمل|قملة|قملات|qmal	<i>noun</i><br><ol><li>lice, louse</li></ol>
قميجة|قميجات|قوامج|qamīja	<i>noun</i><br><ol><li>shirt</li></ol>
قنارية|qannāriyya|قناريات	<i>noun</i><br><ol><li>artichoke</li></ol>
قنبة|قنبات|qannba	<i>noun</i><br><ol><li>rope</li></ol>
قنبولة|قنابل|qanbūla	<i>noun</i><br><ol><li>bomb, grenade</li></ol>
قنت|qunt|قنات	<i>noun</i><br><ol><li>corner</li></ol>
قنديل|qandīl|قنادل	<i>noun</i><br><ol><li>lamp</li><li>jellyfish</li></ol>
قنطر|qanṭar|يقنطر	<i>verb</i><br><ol><li>to put on weight</li></ol>
قنطرة|قنطرات|qanṭra|قناطر	<i>noun</i><br><ol><li>bridge</li></ol>
قنفود|qanfūd|قنافد	<i>noun</i><br><ol><li>hedgehog</li><li>(vulgar) vagina</li></ol>
قنية|qniyyāt|قنيات|qniyya	<i>noun</i><br><ol><li>rabbit</li></ol>
قهوة|qahwa|قهاوي|قهوات	<i>noun</i><br><ol><li>coffee</li><li>coffee shop, café</li></ol>
قهوي|قهويين|قهويات|قهوية|qahwi	<i>adj</i><br><ol><li>brown</li></ol>
قوق|قوقة|قوقات|qūq	<i>noun</i><br><ol><li>artichoke</li></ol>
قوقي|قوقيين|قوقيات|qūqi|قوقية	<i>noun</i><br><ol><li>violet (colour)</li></ol><br><i>adj</i><br><ol><li>violet</li></ol>
قوم|نقوّموا|قوّمت|قَوْم|قوّم|قُوم|قوّموا|نقوّم|تقوّموا|قوّمي|قوّمنا|yqawwam|أقوام|qawwam|يقوم|قوّمتي|qūm|يقوّم|qawm|تقوّم|يقوّموا|قوّمتوا|تقوّمي|yqūm	<i>verb</i><br><ol><li>(transitive) to evaluate</li></ol><br><i>noun</i><br><ol><li>people, nation</li></ol>
قيس|نقيس|قيسنا|يقيسوا|قيست|قيسوا|قيسي|qiyyas|نقيسوا|تقيسوا|قيستوا|تقيس|تقيسي|قيستي|يقيس	<i>verb</i><br><ol><li>to measure</li></ol>
قيمرون|qaymrūn|قَيْمرون|قِيمرونات|قيمرونة|qīmrūn|قِيمرون|قيمرونات|قِيمرونة|قَيْمرونة|قَيْمرونات|qīmrūna	<i>noun</i><br><ol><li>shrimp</li></ol>
ك	<i>particle</i><br><ol><li>Used to prefix a non-past verb to mark the present tense.</li></ol>
كابوس|كوابس|kābūs	<i>noun</i><br><ol><li>handgun</li><li>nightmare</li></ol>
كادو|كادوات|كادويات|kādu	<i>noun</i><br><ol><li>gift</li></ol>
كار|كارات|كيران|kār|gār	<i>noun</i><br><ol><li>train station</li><li>interurban bus</li></ol>
كارو|gārru|كاروات	<i>noun</i><br><ol><li>cigarette</li></ol>
كاس|كيسان|kās	<i>noun</i><br><ol><li>glass</li><li>cup</li></ol>
كاشة|كاشات|kāšša|كواش	<i>noun</i><br><ol><li>blanket</li></ol>
كاعي|kāʕi|كاعين|أكعى|كاعيين|كاعية|كاعيات	<i>adj</i><br><ol><li>sad</li></ol>
كاغط|كواغط|kāḡaṭ	<i>noun</i><br><ol><li>piece of paper</li><li>(archaic) document</li><li>(by extension) marriage certificate</li></ol>
كاف|kāf|كيفان	<i>noun</i><br><ol><li>cave</li></ol>
كال|كول|كلتي|كلت|تاكلي|ناكل|كلتوا|ياكل|yākul|تاكلوا|كلنا|kāl|كولي|كولوا|ياكلوا|واكل|كالوا|ماكلة|موكول|ناكلوا|كالت|تاكل	<i>verb</i><br><ol><li>to eat</li></ol>
كامون|kāmūn	<i>noun</i><br><ol><li>cumin (Cuminum cyminum)</li></ol>
كاوكاو|kāwkāw|كاوكاوات|كاوكاوة	<i>noun</i><br><ol><li>peanut</li></ol>
كاين|كاينين|كاينة|kāyin	<i>verb</i><br><ol><li>there is</li></ol>
كب|كبّيتوا|تكبّ|كبّيتي|كبّينا|تكبّوا|يكبّوا|نكبّوا|تكبّي|كبّيت|كبّي|ykubb|kabb|كبّت|كبّ|نكبّ|يكب|يكبّ|كبّوا	<i>verb</i><br><ol><li>to pour out</li></ol>
كبورية|kbūriyya	<i>noun</i><br><ol><li>bigness</li></ol>
كبوط|kabbūṭ|كبابط	<i>noun</i><br><ol><li>coat, overcoat</li></ol>
كبير|كبر|كبيرين|أكبر|kbīr|كبيرات|كبار|كبيرة	<i>adj</i><br><ol><li>big</li><li>great</li><li>old (for a person)</li></ol>
كبينة|kabīna|كبينات	<i>noun</i><br><ol><li>toilet</li></ol>
كتان|kattān	<i>noun</i><br><ol><li>flax</li></ol>
كتب|يكتُب|or يكتَب|ktab	<i>verb</i><br><ol><li>to write</li><li>to destine or predestine</li></ol>
كترة|katra	<i>noun</i><br><ol><li>large quantity, abundance</li></ol>
كتف|ktaf|كتاف|كْتَف|كَتف|katf	<i>noun</i><br><ol><li>shoulder</li></ol>
كتير|كتار|كتيرين|ktīr|كتيرة|كتيرات|كتر|أكتر	<i>adj</i><br><ol><li>a lot of, much, many</li></ol><br><i>adv</i><br><ol><li>very</li></ol>
كح|يكح|كحّيتوا|كحّت|نكحّوا|تكحّ|كحّ|كحّيت|kaḥḥ|ykuḥḥ|كحّينا|نكحّ|تكحّوا|كحّيتي|كحّوا|كحّي|يكحّ|يكحّوا|تكحّي	<i>verb</i><br><ol><li>to cough</li></ol>
كحب|kḥab|يكحب	<i>verb</i><br><ol><li>to cough</li></ol>
كحل|kaḥlāt|kaḥlīn|كحلين|كحلا|كحلة|أكحل|كحلات|kaḥla|kḥal|كوحل	<i>adj</i><br><ol><li>black</li></ol>
كحلوش|كحلوشة|كحالش|كحلوشين|kaḥlūš	<i>noun</i><br><ol><li>(offensive, ethnic slur) black person</li></ol>
كحولية|kḥūliyya	<i>noun</i><br><ol><li>blackness</li></ol>
كدبة|كدبات|كديبة|kadba	<i>noun</i><br><ol><li>lie (untruth)</li></ol>
كدوب|kdūb	<i>noun</i><br><ol><li>lying</li></ol>
كر|karr	<i>noun</i><br><ol><li>(vulgar) ass</li></ol>
كراطة|karrāṭa|كراطات	<i>noun</i><br><ol><li>squeegee</li></ol>
كرسي|كراسي|kursi|كراسة	<i>noun</i><br><ol><li>chair</li></ol>
كركاع|كركاعة|gurgāʕ|كركاعات	<i>noun</i><br><ol><li>walnuts</li></ol>
كرموس|karmūs|كرموسة|كرموسات	<i>noun</i><br><ol><li>fig, figs</li></ol>
كرموس المسلمين|كرموسة المسلمين|كرموسات المسلمين|karmūs el-misilmīn|karmūs le-msilmīn	<i>noun</i><br><ol><li>fig, figs</li></ol>
كرموس النصارى|كرموسات النصارى|karmūs en-nṣāra|كرموسة النصارى	<i>noun</i><br><ol><li>prickly pears</li></ol>
كرموس هندي|karmūs handi|كرموسات هندية|كرموسة هندية	<i>noun</i><br><ol><li>prickly pear</li></ol>
كرنب|karnab	<i>noun</i><br><ol><li>cabbage</li></ol>
كروسة|karrūsa|كروسات|كرارس	<i>noun</i><br><ol><li>cart</li></ol>
كروصة|kurwaṣṣa|karwaṣṣa|كروصات	<i>noun</i><br><ol><li>croissant</li></ol>
كريلو|grīllu	<i>noun</i><br><ol><li>(Northeastern Morocco) cockroach</li></ol>
كسكاس|كسكاسات|kaskās	<i>noun</i><br><ol><li>steamer</li></ol>
كسوة|كساوي|كسوات|kaswa	<i>noun</i><br><ol><li>robe, dress</li></ol>
كسيدة|كسيدات|ksīda|كسايد	<i>noun</i><br><ol><li>accident</li></ol>
كسيراتور|كسيراتورات|ksīrātūr	<i>noun</i><br><ol><li>gas pedal</li></ol>
كفتة|kafta|kufta|كَفتة|كُفتة	<i>noun</i><br><ol><li>ground meat, minced meat</li></ol>
كفح|kaffaḥ|يكفح	<i>verb</i><br><ol><li>to spill</li></ol>
كل|كلك|kulla|كلَّ|كلنا|كلها|كله|كلهم|كلي|كلّْ|kull|كلكم	<i>det</i><br><ol><li>each, every (with following indefinite noun)</li></ol><br><i>pron</i><br><ol><li>whole, all (attached to an object pronoun after following definite noun)</li></ol>
كل بلاصة|kull blāṣa|kulla blāṣa	<i>adv</i><br><ol><li>everywhere</li></ol>
كل خنفوس عند امه غزال|kulla ḵanfūs ʕand ummu ḡzāl	<i>proverb</i><br><ol><li>beauty is in the eye of the beholder</li></ol>
كل شي|kull ši	<i>pron</i><br><ol><li>everything</li><li>everyone</li></ol>
كل مكان|kulla mkān|kull mkān	<i>adv</i><br><ol><li>everywhere</li></ol>
كل موضع|a	<i>adv</i><br><ol><li>everywhere</li></ol>
كلب|كلاب|kliyyab|كليبة|كليبين|كليب|كلبة|kalb	<i>noun</i><br><ol><li>dog</li></ol>
كلمة|kalma|كلمات	<i>noun</i><br><ol><li>word</li><li>promise</li></ol>
كلميني|كلمينيات|kilimīni|كلمينية|كلمينيين	<i>noun</i><br><ol><li>spoiled person</li><li>(by extension, derogatory) a member of the upper class</li></ol><br><i>adj</i><br><ol><li>(derogatory) related to the upper class</li></ol>
كلى|كول|كلت|كلينا|تاكلي|ناكل|كليتوا|ياكل|yākul|تاكلوا|كولي|كولوا|كليت|ياكلوا|واكل|ماكلة|كليتي|موكول|ناكلوا|klā|كلاوا|تاكل	<i>verb</i><br><ol><li>to eat</li></ol>
كليب|kliyyab|كليبة|كليبين	<i>noun</i><br><ol><li>puppy</li></ol>
كلية|كلاوي|klāwi|kliyya|كليات|kulliyya	<i>noun</i><br><ol><li>kidney</li><li>faculty, school (of a university)</li></ol>
كم|kumm|كمام	<i>noun</i><br><ol><li>sleeve (part of a garment that covers the arm)</li></ol>
كمامة|كَمّامة|kammāma|كَمّامات|كْمَامة|kmāma|كمايم|كْمَامات	<i>noun</i><br><ol><li>muzzle (device)</li><li>surgical mask, medical mask, procedure mask</li></ol>
كمنجة|كمنجات|kamanja	<i>noun</i><br><ol><li>(music) violin</li></ol>
كمى|kma|يكمي	<i>verb</i><br><ol><li>to smoke</li></ol>
كميسارية|kumīsarīya|كميساريات	<i>noun</i><br><ol><li>police station</li></ol>
كنوة|كنوات|kunwa	<i>noun</i><br><ol><li>Synonym of كنية (kniyya)</li></ol>
كنى|كنّيتوا|نكنّي|يكنّيوا|كنّى|نكنّيوا|كنّينا|تكنّي|كنّيوا|كنّات|كنّي|كنّيتي|كنّيت|كنّاوا|يكنّي|تكنّيوا|يكني|kanna	<i>verb</i><br><ol><li>to call someone by their last name</li></ol>
كنية|كنيات|kniyyāt|kniyya	<i>noun</i><br><ol><li>surname</li></ol>
كورة|كورات|كواري|kūra	<i>noun</i><br><ol><li>ball</li><li>(sports) football, soccer</li></ol>
كوردة|kūrda|كوردات	<i>noun</i><br><ol><li>rope</li></ol>
كوري|كورية|كوريين|كوارة|كوريات|kūri	<i>adj</i><br><ol><li>Korean</li></ol><br><i>noun</i><br><ol><li>Korean</li><li>barn</li></ol>
كوزينة|كوزينات|kuzīnāt|kuzīna	<i>noun</i><br><ol><li>kitchen</li></ol>
كوش|kūš|كوشات|kūša|كوشة	<i>noun</i><br><ol><li>diaper</li></ol>
كوك|kūk	<i>noun</i><br><ol><li>coconut</li></ol>
كوكب|kawkab|kūkab|كُوكب|كَوْكب|كواكب	<i>noun</i><br><ol><li>planet</li></ol>
كوكوت|كوكوتات|كوكوطات|kūkūt|kūkūṭ|كوكوط	<i>noun</i><br><ol><li>pressure cooker</li></ol>
كولية|كوليات|kūliyya	<i>noun</i><br><ol><li>parcel, package</li></ol>
كيف|kīf	<i>adv</i><br><ol><li>(interrogative) how</li><li>as soon as</li></ol><br><i>conj</i><br><ol><li>(before nouns and pronouns) as, like</li></ol><br><i>noun</i><br><ol><li>cannabis</li></ol>
كيف ما|kīf mā	<i>conj</i><br><ol><li>(before verbal clauses) as, like</li></ol>
كيوي|kīwi|كيويات|كيوية	<i>noun</i><br><ol><li>kiwi fruit</li></ol>
لا باس|lā bās|la bās	<i>phrase</i><br><ol><li>how are you?</li><li>well, fine, okay, good</li></ol>
لاح|يتلاح|تلاحي|لوحوا|يلوح|لحنا|لاحت|نلوح|نتلاحوا|لحت|لوحي|لحتوا|ylūḥ|تتلاحوا|تلاح|تلاحت|lāḥ|تلوحوا|تلاحوا|تتلاح|تلاحتوا|تلوح|لوح|لحتي|tlāḥ|نلوحوا|تلاحتي|تلاحنا|تلوحي|يلوحوا|لاحوا|نتلاح	<i>verb</i><br><ol><li>to throw, to toss</li></ol>
لاحض|mlāḥaḍ|لاحضتوا|نلاحض|ملاحضة|ملاحضين|تلاحض|لاحضوا|لاحضتي|نلاحضوا|لاحضي|تلاحضوا|lāḥaḍ|تلاحضي|لاحضنا|لاحضت|ملاحضات|ملاحض|يلاحضوا|يلاحض	<i>verb</i><br><ol><li>to notice</li></ol>
لاش|lāš	<i>adv</i><br><ol><li>(interrogative) why?</li></ol>
لاقى|نلاقي|لاقيتي|تلاقيت|لاقي|يلاقي|يتلاقاوا|نتلاقاوا|lāqa|لاقت|tlāqa|لاقينا|يتلاقى|تلاقينا|نلاقيوا|لاقيت|لاقيوا|لاقاوا|تلاقاوا|تتلاقاوا|تلاقيوا|تلاقيتوا|تلاقت|تلاقى|تلاقاي|تلاقي|لاقيتوا|تتلاقى|تلاقيتي|نتلاقى|يلاقيوا	<i>verb</i><br><ol><li>to fit together</li><li>to connect</li></ol>
لام|lām|ylūm|لوم|لمتوا|لاموا|يلوم|لامت|لمنا|نلوم|تلوموا|تلوم|تلومي|لومي|لمتي|يلوموا|لمت|لوموا|نلوموا	<i>verb</i><br><ol><li>to blame, to censure, to rebuke, to chide, to scold, to reproach</li></ol>
لاه|lāh	<i>adv</i><br><ol><li>(interrogative) why?</li></ol>
لاين|lāyin	<i>adv</i><br><ol><li>(interrogative) to where?</li></ol>
لبس|لبّسي|يلبّسوا|labbas|لبّست|يلبّس|لبّستي|lbas|لبّسوا|نلبّسوا|لبّس|تلبّس|تلبّسي|لبّسنا|لبّستوا|يلبس|تلبّسوا|نلبّس	<i>verb</i><br><ol><li>to wear; to put on</li><li>(transitive) to dress</li></ol>
لبسة|لباسي|labsa|لبسات	<i>noun</i><br><ol><li>dress (apparel, clothing)</li></ol>
لبنان|lubnān	<i>name</i><br><ol><li>Lebanon (a country in Asia)</li></ol>
لتشين|لتشينات|لتشينة|litšīn	<i>noun</i><br><ol><li>oranges (fruit)</li></ol>
لجلاس|laglas	<i>noun</i><br><ol><li>ice cream</li></ol>
لحضة|لحظات|laḥḍa	<i>noun</i><br><ol><li>moment, instant</li></ol>
لحية|لحيات|لحي|laḥya	<i>noun</i><br><ol><li>beard</li></ol>
لديد|لديدة|لديدات|ldīd|لداد|ألدد|ldīda|ldād|لدد|ldīdāt|لديدين|ldīdīn	<i>adj</i><br><ol><li>delicious</li></ol>
لسان|lsān|لسانات	<i>noun</i><br><ol><li>(anatomy) tongue</li></ol>
لصاق|lṣāq	<i>noun</i><br><ol><li>glue</li></ol>
لصق|يلصق|تلصّقي|laṣṣaq|تلصّق|نلصّق|ylaṣṣaq|نلصّقوا|لصّقتي|yilṣaq|لصّقتوا|تلصّقوا|لصّقوا|lṣaq|لصّقت|يلصّقوا|لصّقي|لصّق|لصّقنا|يلصّق	<i>verb</i><br><ol><li>to be glued</li><li>to glue</li></ol>
لصقة|لصقات|laṣqa	<i>noun</i><br><ol><li>glue stick</li></ol>
لعاقة|lʕāqa	<i>noun</i><br><ol><li>(slang) money</li></ol>
لعبة|luʕba|لعب|لعبات	<i>noun</i><br><ol><li>toy, plaything</li><li>game</li></ol>
لفت|لفتة|laft|لفتات	<i>noun</i><br><ol><li>turnip</li></ol>
لقاط|laqqāṭ|لقاطات	<i>noun</i><br><ol><li>pliers</li></ol>
لقلاق|لقالق|laqlāq	<i>noun</i><br><ol><li>stork</li></ol>
لقى|lqa|يلقى|يتلقى|ettalqa|اتلقى	<i>verb</i><br><ol><li>to find</li></ol>
لمن|lman	<i>adv</i><br><ol><li>(interrogative) to whom?</li></ol>
لنو|linnu	<i>conj</i><br><ol><li>because</li></ol>
لهاية|lahhāya|لهايات	<i>noun</i><br><ol><li>pacifier</li></ol>
لهت|يلهت|laht|لهيت|lhat|لهت	<i>verb</i><br><ol><li>to pant (for animals)</li></ol>
لهنا|lahna	<i>adv</i><br><ol><li>to here</li></ol>
لوز|نلوّزوا|لوّزت|يلوّز|يلوّزوا|لوّزتي|lūz|لوّزي|lawz|ملوز|يلوز|لوزات|لوّز|لوّزتوا|لوزة|تلوّز|lawwaz|لوّزوا|تلواز|نلوّز|لوّزنا|تلوّزي|تلوّزوا	<i>noun</i><br><ol><li>almonds</li></ol><br><i>verb</i><br><ol><li>to belly dance</li></ol>
لوطو|لواطة|lūṭu	<i>noun</i><br><ol><li>(Eastern region) car</li></ol>
لون|نلوّنوا|يلوّنوا|تلوّني|lawwan|لوّنتوا|لوان|لوّننا|نلوّن|لوّنت|تلوّنوا|يلوّن|lūn|لوّن|ألوان|لوّنوا|يلون|لوّني|لوّنتي|تلوّن	<i>noun</i><br><ol><li>color</li></ol><br><i>verb</i><br><ol><li>to color</li></ol>
ليبيا|lībya	<i>name</i><br><ol><li>Libya (a country in Africa)</li></ol>
ليزر|layzar	<i>noun</i><br><ol><li>laser</li></ol>
ليسار|līsār	<i>noun</i><br><ol><li>left side</li></ol>
ليقامة|līqāma	<i>noun</i><br><ol><li>mint</li><li>mix of coriander and parsley</li></ol>
ليكة|līga|ليڭة|ليكات|ليگة|ليگات|ليڭات	<i>noun</i><br><ol><li>glove</li></ol>
ليل|līl|layl|ليلهم|لَيْل|ليلها|ليله|ليلك|ليلكم|ليلي|لِيل|ليالي|ليلنا	<i>noun</i><br><ol><li>nighttime, night</li></ol><br><i>prep</i><br><ol><li>for</li></ol>
ليلة|لَيْلات|لَيْلة|layla|līla|لِيلات|لِيلة	<i>noun</i><br><ol><li>a night</li></ol>
ليمن|ليمِن|ليمَن|līmin|līman	<i>noun</i><br><ol><li>right side</li></ol>
ليمون|لِيمونة|لِيمون|līmūn|لَيْمون|لَيْمونة|لَيْمونات|لِيمونات|laymūn	<i>noun</i><br><ol><li>oranges (fruit)</li></ol>
لين|līn|لِين	<i>adv</i><br><ol><li>(interrogative) to where?</li></ol>
ما|ma|ميايه|mā	<i>noun</i><br><ol><li>water</li></ol><br><i>particle</i><br><ol><li>not</li></ol><br><i>pron</i><br><ol><li>(relative) that which, what</li></ol>
ما حد|ما حدهم|ما حدي|ما حدك|ما حده|ma ḥadd|ما حدنا|ما حدكِ|ما حدكم|ما حدها	<i>conj</i><br><ol><li>as long as</li></ol>
مات|تموتوا|يموت|متتي|māt|تموتي|نموتوا|تموت|متنا|ماتت|نموت|يموتوا|موتوا|مايت|متتوا|ماتوا|موت|متت|ymūt|موتي	<i>verb</i><br><ol><li>(intransitive) to die</li></ol>
ماجي|ماجين|ماجية|ماجات|māji|ماجيات|ماجيين	<i>adj</i><br><ol><li>next</li></ol>
ماش|māš|ماشـ	<i>particle</i><br><ol><li>will (prefix indicating the future tense)</li></ol>
ماشي|māši	<i>particle</i><br><ol><li>not</li><li>added to a non-past verb form to express future tense: will</li></ol>
ماضي|māḍi	<i>noun</i><br><ol><li>(time) past</li></ol>
ماطيشة|māṭīša|ماطيشات|ماطيشية	<i>noun</i><br><ol><li>tomatoes</li></ol>
ماعون|māʕin|mwāʕin|ماعن|مواعن|māʕūn	<i>noun</i><br><ol><li>utensil, implement, instrument</li></ol>
ماكلة|مواكل|ماكل|mākla	<i>noun</i><br><ol><li>food</li></ol>
ماللي|milli|ملي	<i>conj</i><br><ol><li>when</li></ol>
مانضة|مانضات|mānḍa	<i>noun</i><br><ol><li>salary, pay, wages</li></ol>
مانطة|مانطات|mānṭa	<i>noun</i><br><ol><li>blanket</li></ol>
مباعد|مباعدة|mbāʕad|mbāʕid|مباعدين|مباعدات|مباعِد|مباعَد	<i>adj</i><br><ol><li>(reciprocal) far, remote, distant</li></ol>
مبلي|مبليين|مبليات|مبلية|mabli	<i>adj</i><br><ol><li>addicted</li></ol>
مبوق|مبوقة|mbawwaq|مبوقين|مبوقات	<i>adj</i><br><ol><li>sleep-drunk, groggy</li><li>stoned, high (under the influence of drugs, especially recreational drugs)</li></ol>
متأكد|متأكدين|متأكدة|mitʔakkad|متأكات	<i>adj</i><br><ol><li>sure, certain, convinced</li></ol>
متحف|matḥaf|متاحف	<i>noun</i><br><ol><li>museum</li></ol>
مترو|mītru|متروات	<i>noun</i><br><ol><li>metre</li></ol>
متمول|mitmawwal|متموّلة|متمولات|متمولين	<i>adj</i><br><ol><li>financed</li></ol>
مجر|مجور|مجورة|mjar	<i>noun</i><br><ol><li>drawer</li></ol>
مجية|majya|مجيات	<i>noun</i><br><ol><li>arrival, coming</li></ol>
محل|محلات|maḥall	<i>noun</i><br><ol><li>place, location</li><li>store</li></ol>
محلول|محلولين|محلولات|محلولة|maḥlūl	<i>adj</i><br><ol><li>open</li></ol>
محى|mḥa|يمحي	<i>verb</i><br><ol><li>to erase</li></ol>
مخ|muḵḵ|مخاخ	<i>noun</i><br><ol><li>(anatomy) brain (“organ”)</li></ol>
مخبزة|مخبزات|maḵbaza	<i>noun</i><br><ol><li>bakery</li></ol>
مخدة|mḵadda|مخاد|مخدات	<i>noun</i><br><ol><li>pillow, cushion</li></ol>
مخض|يمخَض|yimḵuḍ|يمخض|or يمخُض|yimḵaḍ|mḵaḍ	<i>verb</i><br><ol><li>to churn</li></ol>
مد|نمدّوا|تمدّ|يمدّ|تمدّوا|مدّيتي|يمدّوا|مدّيتوا|مدّينا|مدّت|مدّيت|مدّي|يمد|مدّ|تمدّي|نمدّ|madd|مدّوا	<i>verb</i><br><ol><li>to extend, to stretch</li></ol>
مداد|مدادات|mdād	<i>noun</i><br><ol><li>ink</li></ol>
مدرح|مدرحات|مدرحة|mdarraḥ|مدرحين	<i>adj</i><br><ol><li>ingenuine</li></ol>
مدينة|مدن|mdīna|مدينات|مدون	<i>noun</i><br><ol><li>town, city</li></ol>
مراة|مرة|عيالات|mrā|نسا|مراوات	<i>noun</i><br><ol><li>woman</li><li>wife</li></ol>
مراية|مرايات|mrāya	<i>noun</i><br><ol><li>mirror</li></ol>
مرحبا|marḥba	<i>intj</i><br><ol><li>welcome</li></ol>
مرسى|مرسات|marsa	<i>noun</i><br><ol><li>port, harbour</li></ol>
مرفق|marfaq|مرافق	<i>noun</i><br><ol><li>elbow</li></ol>
مرقة|marqa|مرقات	<i>noun</i><br><ol><li>broth</li></ol>
مركان|mirikān	<i>name</i><br><ol><li>United States of America (a country in North America)</li></ol>
مركاني|مركانيات|مركانية|mirikāni|مركانيين	<i>adj</i><br><ol><li>American</li></ol><br><i>noun</i><br><ol><li>American</li></ol>
مركى|تمركي|مركيوا|يمركي|مركيت|مركاوا|marka|مركت|مركيتي|مركيتوا|نمركيوا|نمركي|مركي|مركينا|تمركيوا|يمركيوا	<i>verb</i><br><ol><li>(sports) to score (a goal)</li></ol>
مرورية|mrūriyya	<i>noun</i><br><ol><li>bitterness</li></ol>
مريض|مريضين|مرضى|mrīḍ|أمرض|مرض|مريضات|مريضة|مراض	<i>adj</i><br><ol><li>sick, ill (in poor health)</li></ol>
مزاح|مزاحات|mzāḥ|مزاحة	<i>noun</i><br><ol><li>loquats, medlars</li></ol>
مزيان|mizyān|مزيانة|مزيانات|مزيانين	<i>adj</i><br><ol><li>good, nice</li><li>beautiful</li></ol><br><i>adv</i><br><ol><li>properly, correctly</li></ol>
مس|يمسّ|مسّت|مسّي|مسّيت|مسّيتوا|تمسّي|تمسّوا|تمسّ|مسّينا|مسّوا|مسّ|miss|مساس|يمسّوا|مسّيتي|نمسّوا|mass|يمس|نمسّ	<i>verb</i><br><ol><li>to touch, to feel</li><li>to violate, to infringe</li></ol>
مسارية|msārya|مساريات	<i>noun</i><br><ol><li>sightseeing</li></ol>
مسالي|msāli|مسالية|مساليين|مساليات	<i>adj</i><br><ol><li>nonbusy</li></ol>
مسدود|مسدودين|masdūd|مسدودة|مسدودات	<i>adj</i><br><ol><li>closed</li></ol>
مسقصية|msaqṣiya|مسقصيات	<i>noun</i><br><ol><li>inquiry</li><li>question</li></ol>
مسكة|مسكات|maskāt|مساكي|msāki|مسيكة|maska	<i>noun</i><br><ol><li>chewing gum</li></ol>
مسكوتة|maskūta|مسكوتات	<i>noun</i><br><ol><li>cake</li></ol>
مسكين|مساكن|مسكينات|مسكينة|miskīn|مسكينين	<i>adj</i><br><ol><li>poor (inspiring pity)</li></ol>
مسموح|مسموحة|مسموحين|masmūḥ|مسموحات	<i>adj</i><br><ol><li>permitted, allowed</li></ol>
مش|مشات|مشة|mšāš|mušš|مشاش|mušša|muššāt	<i>noun</i><br><ol><li>cat</li></ol>
مشاية|مشاشي|مشايات|maššāya	<i>noun</i><br><ol><li>slippers, flip-flops</li></ol>
مشطة|mašṭa|مشاطي|mšāṭi	<i>noun</i><br><ol><li>comb</li></ol>
مشكل|مشكُل|muškul|مشكِل|muškil	<i>noun</i><br><ol><li>problem</li></ol>
مشماش|mašmāš|مشماشة|مشماشات	<i>noun</i><br><ol><li>apricots</li></ol>
مشى|mša|يمشي|yimši	<i>verb</i><br><ol><li>(intransitive) to walk</li><li>(intransitive) to go</li><li>(intransitive) to leave</li></ol>
مصاصة|مصاصات|maṣṣāṣa	<i>noun</i><br><ol><li>lollipop</li><li>pacifier</li></ol>
مصبنة|مصبنات|maṣbana	<i>noun</i><br><ol><li>cleaner, dry cleaner (professional laundry)</li></ol>
مصر|miṣr|مِصْر	<i>name</i><br><ol><li>Egypt (a country in North Africa and Western Asia)</li></ol>
مصران|مصارن|muṣrān|مُصران|maṣrān|مَصران	<i>noun</i><br><ol><li>(anatomy) intestine, bowel</li></ol>
مصلوح|maṣlūḥ|مصلوحات	<i>noun</i><br><ol><li>smoothing iron</li></ol>
مصيبة|مصيبات|muṣība|مصايب	<i>noun</i><br><ol><li>calamity, affliction, misfortune, disaster</li></ol>
مضاربة|mḍārba|مضاربات	<i>noun</i><br><ol><li>fight</li></ol>
مضغ|يمضغ|mḍaḡ	<i>verb</i><br><ol><li>to chew, to gum</li></ol>
مضغان|maḍḡān	<i>noun</i><br><ol><li>chewing, crunch, mastication</li></ol>
مضلة|مضال|mḍalla|mḍāll|mḍallāt|مضلات	<i>noun</i><br><ol><li>umbrella, parasol</li></ol>
مضى|مضّيت|نمضّي|مضّيوا|يمضي|مضّى|نمضّيوا|تمضّيوا|يمضّي|maḍḍa|مضّاوا|تمضّي|مضّينا|يمضّيوا|مضّي|مضّيتوا|مضّيتي|mḍa|مضّات	<i>verb</i><br><ol><li>to sign</li><li>to sharpen</li></ol>
مضيغ|mḍīḡ	<i>noun</i><br><ol><li>chewing, crunch, mastication</li></ol>
مضيق|maḍyaq|مضايق	<i>noun</i><br><ol><li>(geography) strait</li></ol>
مطرو|mīṭru|مطروات	<i>noun</i><br><ol><li>metro</li></ol>
مطفي|مطفية|مطفيات|maṭfi|مطفيين	<i>adj</i><br><ol><li>extinguished</li><li>switched off</li></ol>
مطيشة|muṭṭayša|مطيشات	<i>noun</i><br><ol><li>swing (for children)</li></ol>
مع|معاك|معاي|mʕa|معاكم|معاها|معانا|معاهم|معاه|معاكي	<i>conj</i><br><ol><li>as (at the same instant that)</li></ol><br><i>prep</i><br><ol><li>with, together with, in the company of</li><li>pro, for, advocate of, supporting</li></ol>
مع جنب|مع جنبها|مع جنبنا|مع جنبهم|مع جنبكم|مع جنبه|مع جنبي|mʕa janb|مع جنبك	<i>prep</i><br><ol><li>next to, close to</li></ol>
مع من|mʕa man	<i>adv</i><br><ol><li>(interrogative) with whom?</li></ol>
معدنوس|مَعْدْنوس|مْعَدْنوس|maʕdnūs|mʕadnūs	<i>noun</i><br><ol><li>parsley</li></ol>
معصب|معصبة|معصبات|معصبين|mʕaṣṣab	<i>adj</i><br><ol><li>angry, furious, enraged</li></ol>
معلقة|mʕalqa|معالق	<i>noun</i><br><ol><li>spoon (utensil)</li></ol>
معنى|معاني|maʕna|يمعني|معناة	<i>noun</i><br><ol><li>meaning, sense</li></ol><br><i>verb</i><br><ol><li>to hint to someone</li></ol>
مغرف|مغارف|muḡruf	<i>noun</i><br><ol><li>ladle</li></ol>
مغرفة|مغارف|مغرفات|mḡarfa	<i>noun</i><br><ol><li>ladle</li></ol>
مغلوق|maḡlūq|مغلوقين|مغلوقات|مغلوقة	<i>adj</i><br><ol><li>closed</li><li>dark in colour</li></ol>
مقاتلة|مقاتلات|mqātla	<i>noun</i><br><ol><li>fight</li></ol>
مقبط|maqbaṭ|مقابط	<i>noun</i><br><ol><li>clothes peg</li><li>hairclip; headband</li></ol>
مقراج|بقراج|maqrāj|مقارج|baqrāj|بقارج	<i>noun</i><br><ol><li>kettle</li></ol>
مقرونية|مقرونيات|maqarūniyya	<i>noun</i><br><ol><li>pasta</li></ol>
مقص|مقاص|mqaṣṣ	<i>noun</i><br><ol><li>scissors</li></ol>
مقلة|maqla|مقلات|مقالي	<i>noun</i><br><ol><li>frying pan</li></ol>
مقلمة|miqlama|مقلمات	<i>noun</i><br><ol><li>pencil case, pencil box</li></ol>
مقلي|maqli|مقلية|مقليات|مقليين	<i>adj</i><br><ol><li>fried (cooked by frying)</li></ol>
مكان|مكاين|mkān	<i>noun</i><br><ol><li>place</li></ol>
مكانة|مݣانة|ماݣن|مواكن|مواݣن|ماگن|ماكن|مواگن|مگانة|magāna	<i>noun</i><br><ol><li>clock, watch</li><li>electricity meter, water meter</li></ol>
مكلخ|مكلخة|مكلخات|كلخ|أكلخ|mkallaḵ|مكلخين	<i>adj</i><br><ol><li>stupid</li></ol>
مكور|مكورات|mkawwar|مكورة	<i>noun</i><br><ol><li>cabbage</li></ol>
مكينة التصبين|مكينات التصبين|مواكن التصبين|makīnet et-taṣbīn	<i>noun</i><br><ol><li>washing machine</li></ol>
مكينة الصابون|makīnet eṣ-ṣābūn|مواكن الصابون|مكينات الصابون	<i>noun</i><br><ol><li>washing machine</li></ol>
مكينة الغسيل|makīnet l-eḡsīl|مكينات الغسيل|مواكن الغسيل	<i>noun</i><br><ol><li>washing machine</li></ol>
ملاسة|mallāsa|ملاسات	<i>noun</i><br><ol><li>trowel</li></ol>
ملاصق|mlāṣiq|ملاصقة|ملاصقين|ملاصقات	<i>adj</i><br><ol><li>contiguous</li></ol>
ملاغة|mlāḡa	<i>noun</i><br><ol><li>joking</li></ol>
ملاك|ملايكة|ملائكة|malāk	<i>noun</i><br><ol><li>angel</li></ol>
ملح|مْلَح|malḥa|malḥ|mlaḥ|ملحة|مَلْح	<i>noun</i><br><ol><li>salt</li></ol>
ملوخية|mlūḵiyya	<i>noun</i><br><ol><li>okra</li></ol>
مليار|ملاير|malyār	<i>num</i><br><ol><li>billion</li></ol>
مليح|مليحة|ملح|mlīḥ|ملاح|أملح|مليحين|مليحات	<i>adj</i><br><ol><li>good</li></ol>
مليون|ملاين|malyūn	<i>num</i><br><ol><li>million</li></ol>
ممول|ممولين|ممولات|mmawwal|مموّلة	<i>adj</i><br><ol><li>someone financed (something)</li><li>financed</li></ol>
من بعد|من بعدكم|من بعده|من بعدها|من بعدك|من بعدي|men baʕd|من بعدهم|من بعدنا	<i>prep</i><br><ol><li>after</li></ol>
من بعدما|men baʕd ma	<i>conj</i><br><ol><li>after</li></ol>
من من	<i>adv</i><br><ol><li>(interrogative) from whom?</li></ol>
مناش|mennaš	<i>adv</i><br><ol><li>(interrogative) from what?</li></ol>
منام|منامات|mnām	<i>noun</i><br><ol><li>a dream</li></ol>
مناين|mnāyin	<i>adv</i><br><ol><li>(interrogative) from where?</li></ol>
منخار|مناخر|manḵār	<i>noun</i><br><ol><li>(anatomy) nostril</li></ol>
منديل|mandīl|منادل	<i>noun</i><br><ol><li>napkin</li><li>table cloth</li></ol>
منشار|manšār|مَنشار|مناشر|مُنشار|munšār	<i>noun</i><br><ol><li>saw</li></ol>
منطو|munṭu	<i>noun</i><br><ol><li>overcoat</li></ol>
منمل|منملات|منملة|mnammal|منملين	<i>adj</i><br><ol><li>numb</li></ol>
منيكة|munīka|منيكات	<i>noun</i><br><ol><li>doll</li></ol>
منين|mnīn	<i>adv</i><br><ol><li>(interrogative) from where?</li></ol>
مهول|مهولين|mhawwal|مهولات|مهولة	<i>adj</i><br><ol><li>worried</li></ol>
مواعن|māʕin|mwāʕin|ماعن	<i>noun</i><br><ol><li>utensils, kitchenware</li></ol>
مواكني|مواكنية|mwāgni	<i>noun</i><br><ol><li>watchmaker</li></ol>
موتة|موتات|mūta	<i>noun</i><br><ol><li>a death</li></ol>
موج|mawj|موجة|موجات|مواج|mūj	<i>noun</i><br><ol><li>waves</li></ol>
مورا|موراها|موراهم|mūrā|موراه|موراك|موراي|مورانا|موراكم	<i>prep</i><br><ol><li>behind</li></ol>
موريطانية|muriṭānya	<i>name</i><br><ol><li>Mauritania (a country in Africa)</li></ol>
موس|miss|مساس|mūs|مواس|مس	<i>noun</i><br><ol><li>knife</li></ol>
موسخ|موسخات|mūssaḵ|موسخة|موسخين	<i>adj</i><br><ol><li>dirty</li></ol>
موسيقى|mūsīqa|mwāsiq|موسيقات|مواسق	<i>noun</i><br><ol><li>music</li></ol>
موضع|mawḍaʕ|mūḍaʕ|mwāṭaʕ|māṭaʕ|mawṭaʕ|ماضع|mūṭaʕ|مواضع|māḍaʕ|mwāḍaʕ	<i>noun</i><br><ol><li>place, location, spot</li></ol>
موكة|mūka|موكات	<i>noun</i><br><ol><li>owl</li></ol>
مول|موّلتي|نموّل|موّلي|تموّلي|موّلتوا|يموّل|mawwal|تموّلوا|موّل|تموّل|نموّلوا|يموّلوا|mōl|موّلنا|مولات|موّلوا|موّلت	<i>noun</i><br><ol><li>shopping center</li></ol><br><i>verb</i><br><ol><li>to finance</li></ol>
مول الحوت|مولاة الحوت|mūl el-ḥūt|مالين الحوت|مالي الحوت|موالي الحوت|موالين الحوت	<i>noun</i><br><ol><li>fishmonger</li></ol>
مول الدار|مالين الدار|مولاة الدار|موالي الدار|موالين الدار|مالي الدار|mūl ed-dār	<i>noun</i><br><ol><li>landlord</li></ol>
مول النضاضر|مالين النضاضر|موالي النضاضر|mūl en-nḍāḍar|مولاة النضاضر|مالي النضاضر|موالين النضاضر	<i>noun</i><br><ol><li>optician</li></ol>
مية|مئات|مْيَة|مِية|mya|مْيَتِين|مْيَتَيْن|مِيتِين	<i>num</i><br><ol><li>hundred</li></ol>
مية ألف|myat ʔalf	<i>num</i><br><ol><li>hundred thousand</li></ol>
ميت|موتى|ميتين|ميتات|ميتة|miyyat	<i>adj</i><br><ol><li>dead</li></ol><br><i>noun</i><br><ol><li>dead (person)</li></ol>
ميتين|myatayn|myatīn|مْيَتِين|مْيَتَيْن|mītīn|مِيتِين	<i>num</i><br><ol><li>two hundred</li></ol>
ميزان|mīzān|موازن	<i>noun</i><br><ol><li>scale, scales</li><li>balance</li></ol>
ميزان الحرارة|mīzān el-ḥarāra|موازن الحرارة	<i>noun</i><br><ol><li>thermometer</li></ol>
ميزان الما|موازن الما|mīzān el-mā	<i>noun</i><br><ol><li>level (tool)</li></ol>
ميكة|ميكات|mīka	<i>noun</i><br><ol><li>plastic bag</li><li>plastic</li></ol>
مينا|mīna|مواني|موانئ	<i>noun</i><br><ol><li>port</li></ol>
ناب|نياب|nāb	<i>noun</i><br><ol><li>canine tooth</li></ol>
نادم|نادمين|nādim|نادمة|نادمات	<i>adj</i><br><ol><li>regretful</li></ol>
نادى|ناديتوا|نادينا|ناداوا|nāda|ناديت|نادت|ينادي|يناديوا|نادي|ناديوا|ننادي|نناديوا|تناديوا|تنادي|ناديتي	<i>verb</i><br><ol><li>to call</li></ol>
ناض|نوضوا|نضنا|نضتي|تنوض|ناضوا|نوضي|ناضت|ننوض|نضتوا|نضت|تنوضي|نوض|nāḍ|ينوضوا|ننوضوا|ينوض|نوضان|نايض|تنوضوا	<i>verb</i><br><ol><li>to stand up</li><li>to get up</li></ol>
نافع|nāfaʕ	<i>noun</i><br><ol><li>aniseed</li></ol>
ناك|ناكت|ينيك|نيكي|نكتوا|تنيكي|nāk|نيك|ننيك|نيكوا|تنيكوا|ynīk|تنيك|ناكوا|نكنا|نكتي|نكت|ينيكوا|nīk|ننيكوا	<i>verb</i><br><ol><li>(vulgar) to fuck</li></ol>
ناموس|nāmūs|ناموسة|ناموسات	<i>noun</i><br><ol><li>mosquitoes</li></ol>
ناموسية|nāmūsiyya|ناموسيات|نوامس	<i>noun</i><br><ol><li>bed</li><li>(dated) mosquito net</li></ol>
نجمة|نجوم|نجومة|نجمات|najma	<i>noun</i><br><ol><li>star</li><li>asterisk</li></ol>
نحل|نحلة|nḥal|نحلات	<i>noun</i><br><ol><li>bees</li></ol>
نحى|نحّى|نحّي|ynaḥḥi|ينحي|نحّيت|ننحّيوا|تنحّيوا|نحّاوا|نحّات|تنحّي|نحّيتوا|ينحّيوا|ننحّي|نحّيوا|نحّيتي|نحّينا|naḥḥa|ينحّي	<i>verb</i><br><ol><li>to remove</li></ol>
ندامة|ndāma	<i>noun</i><br><ol><li>regret</li></ol>
ندم|تندّموا|naddam|ندّمتي|تندّمي|ندّمت|تندّم|ندّمتوا|نندّم|ندّمنا|ندّموا|يندّم|نندّموا|يندّموا|ندّمي|يندم|ndam|ندّم	<i>verb</i><br><ol><li>to regret</li><li>to make someone regret</li></ol>
ندمان|ندمانين|ندمانات|ندمانة|nadmān	<i>adj</i><br><ol><li>regretful</li></ol>
ندمة|nadma	<i>noun</i><br><ol><li>regret</li></ol>
نده|ndīh|نديه|ndah|ينده|yindah	<i>verb</i><br><ol><li>to drive</li></ol>
نسر|نسورة|نسور|nsar	<i>noun</i><br><ol><li>an eagle</li></ol>
نسى|تنساوا|nsīna|nsītu|nsāt|تنسى|نسي|ننسّي|تنسي|نسيوا|ينساوا|tansa|تنسّيوا|ينسيوا|yinsāw|نسّي|نسيتي|nassīna|ينسي|nassīt|نسّيوا|نسينا|tansāw|نسات|نسّات|نسّينا|تنسّي|nassīw|tnassīw|ننسى|ynassi|نساي|nassāw|nassi|نسّاوا|نسّيتوا|nassa|ynassīw|نسّى|nansāw|nassīti|tnassi|نسّيتي|نسيتوا|nsāy|nsīti|nsīt|نساوا|yinsa|ينسى|نسيت|nansa|تنسيوا|نسّيت|ينسّي|ننساوا|nsa|nassītu|ينسّيوا|ننسّيوا|nsāw|nassāt	<i>verb</i><br><ol><li>to forget</li><li>(ditransitive) to cause to forget</li></ol>
نص|نُصّ|نِصّ|nuṣṣ|niṣṣ|نصوصة|نصوص|نصاص|naṣṣ	<i>noun</i><br><ol><li>half</li><li>script</li><li>text</li></ol>
نضاضر|nẓāẓar|نظيظرات|نضيضرات|نظاظر|nḍāḍar	<i>noun</i><br><ol><li>spectacles, glasses, eyeglasses</li></ol>
نضيف|نضيفة|أنضف|nḍīf|نضيفات|نضف|نضاف|نضيفين	<i>adj</i><br><ol><li>clean</li></ol>
نعاس|nʕās	<i>noun</i><br><ol><li>sleep</li></ol>
نعام|نعامات|nʕām|نعامة	<i>noun</i><br><ol><li>ostriches</li></ol>
نعس|نعّس|تنعّس|تنعّسي|nʕas|نعّستوا|ننعّسوا|نعّست|نعّستي|ynaʕʕas|نعّسنا|naʕʕas|تنعّسوا|ننعّس|نعّسي|ينعّس|ينعّسوا|yinʕas|نعّسوا|ينعس	<i>verb</i><br><ol><li>(intransitive) to sleep</li><li>(transitive) to cause to sleep</li></ol>
نعل|yinʕal|nʕal|ينعل	<i>verb</i><br><ol><li>to curse</li><li>to damn</li></ol>
نعناع|naʕnāʕ	<i>noun</i><br><ol><li>mint</li></ol>
نفاخة|نُفاخات|نَفاخات|نَفاخة|نُفاخة|naffāḵa|nuffāḵa|نفافخ	<i>noun</i><br><ol><li>balloon</li></ol>
نفس|تنفّسي|نفّسوا|ينفّس|نفّستوا|naffas|نفّستي|ننفّس|تنفّسوا|تنفّس|نفّسي|ينفس|نفّس|ينفّسوا|ynaffas|nafs|ننفّسوا|نفّسنا|نفّست	<i>verb</i><br><ol><li>to vent, to air</li><li>to let out air</li><li>to fart on (someone)</li></ol><br><i>noun</i><br><ol><li>same used in the construct state, with a modifying noun, or after the noun with an enclitic pronoun attached to it</li><li>life, breath</li><li>inclination, appetite, proclivity</li></ol>
نفع|ينفع|nfaʕ	<i>verb</i><br><ol><li>to benefit</li></ol><br><i>noun</i><br><ol><li>usefulness</li></ol>
نقاصة|نقاصات|naqqāṣa	<i>noun</i><br><ol><li>cord switch</li></ol>
نقرة|nuqra	<i>noun</i><br><ol><li>silver</li></ol>
نقز|تنقّزي|ننقّز|ينقز|ينقّز|ينقّزوا|تنقّزوا|نقّز|نقّزت|تنقّز|نقّزي|naqqaz|ننقّزوا|نقّزنا|نقّزتوا|نقّزوا|نقّزتي	<i>verb</i><br><ol><li>to jump</li></ol>
نقطة|نقطات|نقط|nuqṭa|نقاطي	<i>noun</i><br><ol><li>dot, point</li><li>subject, issue</li><li>period (punctuation mark)</li><li>drop</li><li>grade, mark (performance expressed by a number, letter, or other symbol)</li></ol>
نقل|or يُنْقُل|nqal|يِنْقُل	<i>verb</i><br><ol><li>to transport, bring from one place to another</li><li>to copy, copy out</li><li>to cheat (in an exam)</li></ol>
نكتة|نكت|nukat|نكيتة|nuktāt|nkāti|نكتات|نكاتي|nukta	<i>noun</i><br><ol><li>joke</li></ol>
نكليز|نكالزة|naglīz|نكليزي	<i>noun</i><br><ol><li>Englishmen; the English</li></ol>
نمر|نمورة|نوامر|نمرات|نماري|namra|نمور|نمرة|nmar	<i>noun</i><br><ol><li>tiger</li></ol>
نمرة|نماري|نوامر|namra|نمرات	<i>noun</i><br><ol><li>number (used to show the rank of something in a list or sequence)</li></ol>
نمس|نموس|نموسة|nams|نمسة	<i>noun</i><br><ol><li>squirrel</li><li>polecat, mongoose and the like</li><li>cunning</li></ol>
نمل|نملات|نملة|nmal	<i>noun</i><br><ol><li>ants</li></ol>
نهار|نهارات|نهاريات|nhār	<i>noun</i><br><ol><li>daytime</li><li>day</li></ol>
نهج|nhaj|نهجة|ينهج	<i>verb</i><br><ol><li>to pant (for people)</li></ol>
نوار الشمش|nuwwār eš-šamš|نواور الشمش|نوارة الشمش|نوارات الشمش	<i>noun</i><br><ol><li>sunflowers</li></ol>
نوى|nwa|نوايات|نواية	<i>noun</i><br><ol><li>nuts</li><li>almonds</li></ol>
نيش|ينيش|نيّشت|ننيّش|nayyaš|نيّش|ننيّشوا|نيّشي|نيّشتوا|نيّشوا|ينيّش|نيّشنا|تنيّشوا|ينيّشوا|تنيّش|تنيّشي|نيّشتي	<i>verb</i><br><ol><li>to aim</li></ol>
نيشان|nīšān	<i>adv</i><br><ol><li>straight</li></ol>
نيف|نيوفة|نويف|nīf|نيوف|nayf	<i>noun</i><br><ol><li>(anatomy) nose</li></ol>
نيك|nīk	<i>noun</i><br><ol><li>(vulgar) fucking</li></ol>
هاد|hād	<i>det</i><br><ol><li>this, those</li></ol>
هجال|هجالة|هجالات|hajjāl|هجالين|hajjāla	<i>noun</i><br><ol><li>widower</li></ol>
هجالة|هجالات|hajjāl|هجالين|hajjāla|هجال	<i>noun</i><br><ol><li>widow</li></ol>
هدا|هادو|هادا|hādi|هدو|hāda|hādu|هادي|هدي	<i>pron</i><br><ol><li>this</li></ol>
هداك|هدوك|hadūk|هديك|hadīk|hadāk	<i>det</i><br><ol><li>that</li></ol>
هدر|تهدّر|نهدّروا|هدّرنا|هدّري|هدّر|haddar|هدّرت|هدّرتي|نهدّر|يهدر|هدّرتوا|تهدّروا|يهدّروا|yahdar|yhaddar|hdar|تهدّري|يَهدر|يهدّر|yihdar|or يِهدر|هدّروا	<i>verb</i><br><ol><li>to talk, to speak</li><li>to cause to talk</li></ol>
هدرة|هداري|هديرة|hadra|هدرات	<i>noun</i><br><ol><li>talking, speaking</li><li>conversation</li></ol>
هدية|هديات|hdiyya	<i>noun</i><br><ol><li>gift</li></ol>
هر|يهرّ|يهرّوا|هرّوا|هرّينا|نهرّوا|harr|هرّت|هرّ|هرّي|تهرّي|هران|نهرّ|تهرّ|هرّيتي|يهر|هرّيت|تهرّوا|هرّيتوا|harrān|hurrān	<i>verb</i><br><ol><li>to tickle</li></ol>
هرق|يهرق|harraq	<i>verb</i><br><ol><li>to spill</li></ol>
هري|hrī|هريات	<i>noun</i><br><ol><li>convenience store</li></ol>
هكدا|hākda	<i>adv</i><br><ol><li>thus, like so</li></ol>
هنا|hna	<i>adv</i><br><ol><li>here</li></ol>
هناك|hnāk	<i>adv</i><br><ol><li>there</li></ol>
هندية|handiyya|هنديات	<i>noun</i><br><ol><li>prickly pear</li></ol>
هو|huwwa	<i>pron</i><br><ol><li>he (subject pronoun)</li></ol>
هوا|hawa|hwā	<i>noun</i><br><ol><li>air</li></ol>
هوتة|hawta|هوتات	<i>noun</i><br><ol><li>(geography) depression</li></ol>
هود|هوّدتوا|تهوّدي|هوّدنا|هوّدت|تهوّد|هوّدتي|نهوّدوا|hawwad|هوّد|يهوّدوا|هوّدوا|يهود|تهوّدوا|نهوّد|يهوّد|هوّدي	<i>verb</i><br><ol><li>to descend, to come down, to go down</li><li>to get off</li></ol>
هوم|hūm	<i>pron</i><br><ol><li>they (masculine or feminine plural subject pronoun)</li></ol>
هوما|hūma	<i>pron</i><br><ol><li>they (masculine or feminine plural subject pronoun)</li></ol>
هون|هوّنوا|تهوّني|هوّن|نهوّنوا|نهوّن|هوّني|هوّنتوا|يهون|يهوّنوا|yhawwan|هوّنتي|هوّنت|hawwan|هوّننا|تهوّن|تهوّنوا|يهوّن	<i>verb</i><br><ol><li>to ease</li></ol>
هي|hiyya	<i>pron</i><br><ol><li>she (subject pronoun)</li></ol>
هيدورة|هَيْدورات|haydūra|هَيْدورة|هِيدورة|هيادر|hīdūra|هِيدورات	<i>noun</i><br><ol><li>sheepskin, cowskin, goatskin</li></ol>
واتى|واتي|يواتي|واتينا|واتيت|wāta|يواتيوا|واتيتي|واتيتوا|واتت|تواتيوا|نواتي|نواتيوا|واتيوا|واتاوا|تواتي	<i>verb</i><br><ol><li>to be agreeable, to suit someone (eg. clothes)</li></ol>
واحد|واحدة|wāḥid|واحدين|واحدات	<i>num</i><br><ol><li>one</li></ol><br><i>adj</i><br><ol><li>single</li></ol>
واحد وتلاتين|wāḥed u tlātīn	<i>num</i><br><ol><li>thirty-one</li></ol>
واحد وعشرين|wāḥed u ʕašrīn	<i>num</i><br><ol><li>twenty-one</li></ol>
واد|ويدان|wīdān|wād	<i>noun</i><br><ol><li>river</li><li>valley</li></ol>
واد حار|واد الحار|ويدان الحار|wād ḥārr|ويدان حارة|wād el-ḥārr	<i>noun</i><br><ol><li>sewage</li></ol>
واسع|وساع|وسع|أوسع|واسعات|wāsaʕ|واسعة|واسعين	<i>adj</i><br><ol><li>wide</li></ol>
واش|wāš	<i>particle</i><br><ol><li>Interrogative particle that is added to the beginning of a declarative sentence to change it into a yes-or-no question.</li></ol>
واعر|واعرة|وعر|واعرات|wāʕir|وعار|أوعر|واعرين	<i>adj</i><br><ol><li>difficult</li></ol>
والو|wālu	<i>noun</i><br><ol><li>nothing</li></ol><br><i>pron</i><br><ol><li>nothing</li></ol>
وجه|وْجَه|وجوه|وجوهة|wjah|وَجْه|wajh	<i>noun</i><br><ol><li>(anatomy) face</li></ol>
وجهية|wajhiyya|وجهيات	<i>noun</i><br><ol><li>favoritism</li></ol>
وحل|نوحّل|وحّلوا|وحّلي|وحّلنا|waḥḥal|وحّلت|يوحل|توحّلي|وحّل|يوحّلوا|نوحّلوا|وحّلتوا|wḥal|توحّلوا|يوحّل|توحّل|وحّلتي	<i>verb</i><br><ol><li>(intransitive) to be stuck</li><li>(transitive) to jam</li></ol>
وحلة|وحلات|waḥla	<i>noun</i><br><ol><li>dilemma</li></ol>
وخا|waḵḵa	<i>intj</i><br><ol><li>OK</li></ol><br><i>prep</i><br><ol><li>in spite of</li></ol>
وخر|نوخّروا|توخّري|توخّر|يوخر|توخّروا|وخّر|وخّرتي|وخّرت|وخّروا|waḵḵar|نوخّر|يوخّر|يوخّروا|وخّرنا|وخّري|وخّرتوا	<i>verb</i><br><ol><li>to step aside</li><li>to move</li><li>to postpone, to set back, to hold back, to put back, to delay</li></ol>
ودن|ودّنت|يودّنوا|ودّنتوا|تودّني|وُدن|waddan|نودّن|ودّن|تودّن|ywaddan|ودَن|يودن|تودّنوا|wudn|ودنَيْن|ودّننا|نودّنوا|ودّنوا|يودّن|ودّنتي|ودّني|wdan|ودنِين	<i>noun</i><br><ol><li>(anatomy) ear (organ)</li></ol>
ورا|وراها|وراي|وراهم|ورانا|wrā|وراكم|وراه|وراك	<i>prep</i><br><ol><li>behind</li></ol>
ورت|wurt	<i>noun</i><br><ol><li>inheritance</li></ol>
وردي|wardi	<i>noun</i><br><ol><li>pink (colour)</li></ol>
وز|وزة|وزات|wazz	<i>noun</i><br><ol><li>geese</li><li>(slang, usually singulative) thing</li></ol>
وزن|yiwzan|wzan|يوزن	<i>verb</i><br><ol><li>to weigh (have a weight)</li><li>to weigh (measure a weight)</li></ol>
وسادة|وسادات|وسايد|wsāda	<i>noun</i><br><ol><li>cushion</li></ol>
وعورية|wʕūriyya	<i>noun</i><br><ol><li>difficultness</li></ol>
وقتاش|waqtāš	<i>adv</i><br><ol><li>(interrogative) when?</li></ol>
وقيد|wqīd|وقيدة|وقيدات	<i>noun</i><br><ol><li>match (device to make fire)</li></ol>
وقيل|waqīla	<i>adv</i><br><ol><li>maybe, probably</li></ol>
ولا|wala|walla	<i>conj</i><br><ol><li>or</li><li>nor, neither</li></ol>
ولد|wald|ولاد|wuld	<i>noun</i><br><ol><li>boy</li><li>son</li><li>(in the plural) children</li></ol>
ولد الحرام|wuld la-ḥrām|ولاد الحرام	<i>noun</i><br><ol><li>bastard</li></ol>
ولد فرنسا|ولاد فرنسا|بنت فرنسا|wald fransa	<i>noun</i><br><ol><li>westernized Moroccan, Moroccan loyal to France</li><li>(derogatory) Algerian</li></ol>
ولكن|walakin	<i>conj</i><br><ol><li>but</li></ol>
ولى|يولي|walla|ولّينا|تولّي|ولّيت|ولّات|ولّي|ولّى|ولّيتي|ولّيوا|تولّيوا|يولّيوا|ولّاوا|ولّيتوا|نولّيوا|نولّي|يولّي|ywalli	<i>verb</i><br><ol><li>to become</li></ol>
ويكاند|ويكاندات|wīkānd	<i>noun</i><br><ol><li>weekend</li></ol>
ياجور|yājūra|yājūr|ياجورات|ياجورة|يجورات	<i>noun</i><br><ol><li>(uncountable) brick, bricks</li></ol>
يتيم|يتيمة|يتام|يتامى|ytīm	<i>noun</i><br><ol><li>orphan</li></ol>
يد|yadd|يَدين|yidd|يِدين|يَد|يِد	<i>noun</i><br><ol><li>(anatomy) hand</li></ol>
يمام|يمامات|ymām|يمامة	<i>noun</i><br><ol><li>dove, pigeon</li></ol>
يمكن|yimkan	<i>adv</i><br><ol><li>maybe</li></ol>
يوم|yūm|إيام|يومين|إيامات	<i>noun</i><br><ol><li>day</li><li>(usually in the plural) time, era, age</li></ol>
يوميا|yawmiyyan	<i>adv</i><br><ol><li>daily</li></ol>
پنوة|pnuwwa|پنوات	<i>noun</i><br><ol><li>tyre, tire</li></ol>
پيكالة|pikāla	<i>noun</i><br><ol><li>bicycle</li></ol>
ڭاوري|gāwri|ڭوار|ڭاورية	<i>noun</i><br><ol><li>westerner</li></ol>
ڭراج|ڭراجات|garāj	<i>noun</i><br><ol><li>garage</li></ol>
