'E Paise Vasce	<i>name</i><br><ol><li>the Netherlands</li></ol>
'a|la	<i>article</i><br><ol><li>the</li></ol><br><i>pron</i><br><ol><li>her (accusative)</li></ol><br><i>prep</i><br><ol><li>from</li><li>by (indicating the actor in a passive voice)</li><li>to (something that has to be done)</li></ol>
'chiòtula	<i>noun</i><br><ol><li>drink</li></ol>
'e|le|’e pl and|’e	<i>prep</i><br><ol><li>of</li><li>from (only with verb esse)</li></ol><br><i>article</i><br><ol><li>the</li></ol><br><i>pron</i><br><ol><li>him (dative)</li><li>her (dative)</li><li>them (accusative)</li></ol>
'i|li	<i>pron</i><br><ol><li>him (dative)</li><li>them (masculine, accusative)</li></ol>
'llustrà|’llustrà	<i>verb</i><br><ol><li>to illustrate</li><li>(of books) to illuminate</li><li>to honor (someone) for their accomplishments</li></ol>
'mbriacòne	<i>noun</i><br><ol><li>drunkard</li></ol>
'mbòllo	<i>noun</i><br><ol><li>postage stamp</li></ol>
'mbòmma	<i>noun</i><br><ol><li>bomb</li></ol>
'mbómma	<i>noun</i><br><ol><li>bomb</li></ol>
'mmericina	<i>noun</i><br><ol><li>medicine (science)</li></ol>
'mmiria	<i>noun</i><br><ol><li>jealousy</li></ol>
'mmito	<i>noun</i><br><ol><li>invitation</li></ol>
'mmìdia	<i>noun</i><br><ol><li>jealousy</li></ol>
'mparà	<i>verb</i><br><ol><li>to teach</li><li>to learn</li></ol>
'nciarmo	<i>noun</i><br><ol><li>charm</li><li>the fixing of something so as to make it functional</li></ol>
'nfiétto	<i>noun</i><br><ol><li>infection</li></ol>
'ngiarmo	<i>noun</i><br><ol><li>charm</li><li>seduction, beguilement</li></ol>
'ngigniére	<i>noun</i><br><ol><li>engineer</li></ol>
'nnìzio	<i>noun</i><br><ol><li>evidence</li></ol>
'ntréllece|’ntréllece	<i>adv</i><br><ol><li>vivaciously, briskly</li><li>brilliantly</li></ol>
'ntussecoso|'ntussecosa|'ntussecose	<i>adj</i><br><ol><li>poisonous</li></ol>
'nu	<i>article</i><br><ol><li>a, an</li></ol>
'nzegnale	<i>noun</i><br><ol><li>signal</li></ol>
'nzularchìa	<i>noun</i><br><ol><li>jaundice</li></ol>
'o|lo	<i>article</i><br><ol><li>the</li></ol><br><i>pron</i><br><ol><li>him</li><li>it</li></ol>
'o mmangià	<i>noun</i><br><ol><li>food</li></ol>
'rara	<i>noun</i><br><ol><li>threshold</li></ol>
'rrevutà	<i>verb</i><br><ol><li>to revolt or disgust</li></ol>
'u|lu	<i>pron</i><br><ol><li>him (accusative)</li></ol>
Custantenobbule	<i>name</i><br><ol><li>Constantinople</li></ol>
Danemarca	<i>name</i><br><ol><li>Denmark (a country in Western Europe)</li></ol>
Franza	<i>name</i><br><ol><li>France</li></ol>
Gran Vretagna	<i>name</i><br><ol><li>Great Britain</li></ol>
Innia	<i>name</i><br><ol><li>India (a country in Asia)</li></ol>
Ischia	<i>name</i><br><ol><li>Ischia (an island in Italy)</li></ol>
Islanna	<i>name</i><br><ol><li>Iceland</li></ol>
Juann	<i>name</i><br><ol><li>John</li></ol>
Naggitto	<i>name</i><br><ol><li>Egypt</li></ol>
Napule|Nàpule	<i>name</i><br><ol><li>Naples (a province and city in Italy)</li></ol>
Proceta	<i>name</i><br><ol><li>Procida (an island and municipality of Italy)</li></ol>
Sciorenza	<i>name</i><br><ol><li>Florence (a province and city in Tuscany, Italy)</li></ol>
Sguizzera	<i>name</i><br><ol><li>Switzerland</li></ol>
Surriento	<i>name</i><br><ol><li>Sorrento (a town in the province of Naples, Italy)</li></ol>
Ulanna	<i>name</i><br><ol><li>Holland</li></ol>
a	<i>prep</i><br><ol><li>from (referring to a place)</li><li>by (introducing the actor in the passive voice)</li><li>to (implying necessity)</li><li>in (locative: staying in a place of relative width)</li><li>to (locative: moving towards a place of relative width)</li><li>to (dative)</li></ol>
abbaccamiento	<i>noun</i><br><ol><li>secret pact</li></ol>
abbafaogno|abbafaogne|abbafaogna	<i>adj</i><br><ol><li>hot</li></ol><br><i>noun</i><br><ol><li>(archaic) a hot south or west wind</li><li>scorching heat</li></ol>
abballà|abballajemo|abballarrissemo|abballassemo|abballeno|abballarranno|abballano|abballarrissevo|abballarrimmo|abballammo|abballavate|abballassero|abballavo|abballarrite|abballanno|abballarrisse|abballarraje|abballa|abballasse|abballato|abballe|abballarriano|abballarrà|abballante|abballavamo|abballajeno|abballate|abballaste|abballaje|abballassevo|abballavano|abballava|abballarria|abballave|abballastevo|abballarraggio|abballo	<i>verb</i><br><ol><li>to dance</li></ol>
abbanunà|abbanunajeno|abbanunammo|abbanunarria|abbanunavamo|abbanunarrisse|abbanunasse|abbanunato|abbanunante|abbanunava|abbanunarraje|abbanunarrà|abbanunarrite|abbanunassemo|abbanunanno|abbanunarraggio|abbanunate|abbanunarrimmo|abbanunajemo|abbanunastevo|abbanunarrissevo|abbanunarranno|abbanunano|abbanunavo|abbanunaje|abbanunave|abbanunassero|abbanunassevo|abbanunarriano|abbanunarrissemo|abbanune|abbanuna|abbanunavano|abbanunaste|abbanunavate|abbanuneno|abbanuno	<i>verb</i><br><ol><li>to abandon</li></ol>
abbascio	<i>adv</i><br><ol><li>downstairs</li></ol>
abbastante	<i>adj</i><br><ol><li>sufficient</li></ol><br><i>adv</i><br><ol><li>quite</li></ol>
abbastà|abbastarranno|abbastavamo|abbastassero|abbastasse|abbastarria|abbastave|abbastato|abbastarrissevo|abbastaje|abbasteno|abbasto|abbastante|abbasta|abbastanno|abbastarraje|abbastavo|abbastarriano|abbaste|abbastassevo|abbastate|abbastajeno|abbastarrà|abbastarrissemo|abbastassemo|abbastaste|abbastano|abbastarraggio|abbastavate|abbastavano|abbastastevo|abbastarrimmo|abbastammo|abbastava|abbastarrisse|abbastarrite|abbastajemo	<i>verb</i><br><ol><li>to suffice</li></ol>
abbate	<i>noun</i><br><ol><li>abbot</li><li>priest</li></ol>
abbenì	<i>noun</i><br><ol><li>The future</li></ol>
abberbio	<i>noun</i><br><ol><li>adverb</li></ol>
abbiccià	<i>verb</i><br><ol><li>to light (a fire etc)</li></ol>
abbià	<i>verb</i><br><ol><li>to begin</li><li>to initiate</li></ol>
abbrunzo	<i>noun</i><br><ol><li>bronze</li></ol>
abbuscà|abbuscano|abbuscaje|abbuscarraggio|abbuscammo|abbuscato|abbuscarria|abbuscassevo|abbusceno|abbuscastevo|abbuscasse|abbuscave|abbuscanno|abbuscarrisse|abbuscajeno|abbuscaste|abbuscassero|abbusco|abbuscate|abbuscava|abbuscarrà|abbuscavate|abbuscavano|abbuscarrite|abbuscarranno|abbuscarrissevo|abbuscarrimmo|abbusce|abbuscarraje|abbuscavo|abbuscajemo|abbuscarriano|abbusca|abbuscassemo|abbuscarrissemo|abbuscante|abbuscavamo	<i>verb</i><br><ol><li>(transitive) to get (e.g. money, a beating-up)</li><li>(intransitive) to lose</li></ol>
abolemiento	<i>noun</i><br><ol><li>abolition</li></ol>
acalà|acalajemo|acalammo|acalarranno|acalaste|acalarrà|acalato|acalanno|acalarrissevo|acalavamo|acalave|acalarria|acalarraggio|acalarrimmo|acaleno|acale|acalante|acalastevo|acalarraje|acalano|acalassero|acalajeno|acalarrisse|acalarrite|acalaje|acalarriano|acalassemo|acalavate|acala|acalate|acalasse|acalarrissemo|acalassevo|acalavo|acalavano|acalo|acalava	<i>verb</i><br><ol><li>to lower</li></ol>
accadèmmia	<i>noun</i><br><ol><li>academy</li></ol>
accapputtà|accapputto|accapputtarrisse|accapputtastevo|accapputtava|accapputtassevo|accapputtavate|accapputtarrissemo|accapputtassemo|accapputtavo|accapputtarria|accapputtaste|accapputtante|accapputtavano|accapputteno|accapputtaje|accapputte|accapputtarriano|accapputta|accapputtajeno|accapputtarranno|accapputtate|accapputtassero|accapputtarrà|accapputtano|accapputtarrimmo|accapputtarrite|accapputtarrissevo|accapputtato|accapputtanno|accapputtavamo|accapputtarraje|accapputtasse|accapputtammo|accapputtajemo|accapputtarraggio|accapputtave	<i>verb</i><br><ol><li>to upset, turn over</li></ol>
accaremmia	<i>noun</i><br><ol><li>academy</li></ol>
accattà	<i>verb</i><br><ol><li>to buy</li></ol>
accavallà|accavalla|accavallasse|accavallaste|accavallante|accavallassemo|accavallajeno|accavallajemo|accavallarrimmo|accavallaje|accavallavate|accavallava|accavallassevo|accavallastevo|accavallavamo|accavalleno|accavallarrisse|accavallarriano|accavallarranno|accavallarrissemo|accavallammo|accavallave|accavallano|accavallate|accavallato|accavallavo|accavallarrà|accavalle|accavallavano|accavallo|accavallarria|accavallanno|accavallarraje|accavallarrissevo|accavallassero|accavallarraggio|accavallarrite	<i>verb</i><br><ol><li>to command</li><li>to dominate</li><li>to take control of</li><li>to superimpose</li></ol>
acchiale	<i>noun</i><br><ol><li>eyeglasses</li></ol>
acchiano acchiano	<i>adv</i><br><ol><li>slowly</li></ol>
acchiare	<i>noun</i><br><ol><li>glasses, spectacles</li></ol>
accidere|accidisseve|accidiano|accidarriano|accidarrisseve|accidisse|accidenno|accidarriamo|accidevamo|accidono|accidevo|accidessemo|accidarria|accido|accidite|accidarraggio|accidiamo|accidiveve|accidiste|accidettero|acciduto|accidettemo|accidarrammo|accidimmo|accidevano|accidive|accide|accidarrà|accidette|accidente|accideva|accidarranno|accidesseno|accidisteve|accidarrisse|accidarraje|accidetteno|accidarrate|accidesse	<i>verb</i><br><ol><li>to kill</li></ol>
accio	<i>noun</i><br><ol><li>celery</li></ol>
accirere|accirisse|acciriano|accire|acciriste|accirive|accirettero|acciro|accirimmo|accirevano|acciriamo|accirarrisseve|accirarrà|accirite|accirono|accirarriano|accirarrammo|accirarriamo|accirenno|accirarrate|accirevo|accirente|accirarrisse|acciressemo|acciruto|acciriveve|accirarraggio|accirarraje|accireva|acciresse|accirettemo|accirarranno|accirevamo|acciresseno|accirarria|acciretteno|acciristeve|accirette|accirisseve	<i>verb</i><br><ol><li>to kill</li></ol>
accirerse	<i>verb</i><br><ol><li>to kill oneself</li></ol>
acconciaòsse	<i>noun</i><br><ol><li>surgeon</li></ol>
accrianzatézza	<i>noun</i><br><ol><li>education, training</li></ol>
accummincià	<i>verb</i><br><ol><li>to begin</li></ol>
accuppatura	<i>noun</i><br><ol><li>The filling of a vessel</li></ol>
accussì	<i>adv</i><br><ol><li>therefore, hence, thus</li></ol><br><i>conj</i><br><ol><li>so</li><li>like this/that</li></ol>
aco	<i>noun</i><br><ol><li>needle</li></ol>
acqua|acque	<i>noun</i><br><ol><li>water</li><li>rain</li></ol>
acìto	<i>noun</i><br><ol><li>vinegar</li></ol>
addenucchiarse	<i>verb</i><br><ol><li>To kneel, to kneel down, to go down on one's knees.</li><li>To fall to one's knees.</li></ol>
addimannà	<i>verb</i><br><ol><li>to ask</li></ol>
addivinà	<i>verb</i><br><ol><li>to guess by an unqualified conclusion</li></ol>
addore	<i>noun</i><br><ol><li>odor</li><li>perfume</li></ol>
addorme	<i>verb</i><br><ol><li>to make someone to fall asleep</li></ol>
addovonca|dovonca	<i>adv</i><br><ol><li>wherever</li><li>everywhere</li></ol>
addu	<i>prep</i><br><ol><li>to</li></ol>
addò	<i>adv</i><br><ol><li>where</li></ol>
aecche	<i>adv</i><br><ol><li>(Scanno) here</li></ol>
aggrisse	<i>noun</i><br><ol><li>eclipse</li></ol>
aglia	<i>noun</i><br><ol><li>garlic</li></ol>
agliàneca	<i>noun</i><br><ol><li>a kind of black grape</li></ol>
agnulillo	<i>noun</i><br><ol><li>silkworm</li></ol>
ajere	<i>adv</i><br><ol><li>yesterday</li></ol><br><i>noun</i><br><ol><li>yesterday</li></ol>
ajutà	<i>verb</i><br><ol><li>to help</li></ol>
ajùto	<i>noun</i><br><ol><li>help</li></ol>
alarbo	<i>adj</i><br><ol><li>Arabian</li></ol><br><i>noun</i><br><ol><li>Arab</li></ol>
albèrgo	<i>noun</i><br><ol><li>hotel</li></ol>
alevento	<i>noun</i><br><ol><li>treason, betrayal</li></ol>
alimento	<i>noun</i><br><ol><li>element</li></ol>
allazzà	<i>verb</i><br><ol><li>To tie</li><li>To bind</li></ol>
allerezza	<i>noun</i><br><ol><li>happiness</li></ol>
alliccarse	<i>verb</i><br><ol><li>to lick oneself</li></ol>
alliccasalèmme	<i>noun</i><br><ol><li>flatterer</li><li>enticement, allurement</li></ol>
allicchette	<i>adv</i><br><ol><li>perfectly</li></ol>
allicchetto	<i>adv</i><br><ol><li>perfectly</li></ol>
allicurdà	<i>verb</i><br><ol><li>to remember</li></ol>
alluccà	<i>verb</i><br><ol><li>to yell, to shout</li></ol>
alo	<i>noun</i><br><ol><li>yawn</li></ol>
aloja	<i>noun</i><br><ol><li>aloe</li></ol>
ambrennola	<i>noun</i><br><ol><li>sour cherry</li></ol>
amenta	<i>noun</i><br><ol><li>mint</li></ol>
americano|americana|americane	<i>adj</i><br><ol><li>American</li></ol><br><i>noun</i><br><ol><li>American (inhabitant or native of Americas or of the United States)</li></ol>
ammantecato	<i>noun</i><br><ol><li>sorbet, sherbet</li></ol>
ammasca	<i>noun</i><br><ol><li>nightmare</li></ol>
ammenola	<i>noun</i><br><ol><li>almond</li></ol>
ammore|ammure	<i>noun</i><br><ol><li>love</li></ol>
ammuntunà	<i>verb</i><br><ol><li>to accumulate</li><li>to hoard</li></ol>
ammuìna	<i>noun</i><br><ol><li>disorder</li><li>racket, noise</li></ol>
ammò|amò	<i>noun</i><br><ol><li>(Referring to another person) [my] love.</li></ol>
amà|amastevo|amarriano|amavano|amavamo|amano|ama|amarrite|amajeno|amajemo|amammo|amaste|amarrimmo|amarrissevo|amo|amarrà|amarranno|amave|amate|amassevo|amarrissemo|amaje|amarraggio|amarrisse|amassemo|amavo|amasse|amante|amanno|amassero|ame|amarraje|amava|amato|ameno|amarria|amavate	<i>verb</i><br><ol><li>to love</li></ol>
ananassa	<i>noun</i><br><ol><li>pineapple</li></ol>
aniello|anielle	<i>noun</i><br><ol><li>ring (jewellery)</li></ol>
annascuso|annascusa|annascuse	<i>adj</i><br><ol><li>hidden</li><li>occult</li></ol>
anneviérzo	<i>noun</i><br><ol><li>the Universe</li></ol>
anno|anne	<i>noun</i><br><ol><li>year</li></ol>
annummenata	<i>noun</i><br><ol><li>fame</li><li>gossip, buzz</li></ol>
annóre	<i>noun</i><br><ol><li>honour</li></ol>
antecòre	<i>noun</i><br><ol><li>infarct, heart attack</li></ol>
apa|ape	<i>noun</i><br><ol><li>bee</li></ol>
appenne	<i>verb</i><br><ol><li>(transitive) to hang (something on something else or execute by hanging)</li></ol>
appocundria	<i>noun</i><br><ol><li>deep melancholia</li></ol>
appriesso	<i>adv</i><br><ol><li>after</li></ol><br><i>prep</i><br><ol><li>after (referring to a queue)</li></ol>
appurà|appurarrisse|appurastevo|appurarrissevo|appurasse|appuravo|appurarraje|appurarrà|appurajemo|appuranno|appurarraggio|appuro|appuraste|appura|appurarranno|appurassemo|appurajeno|appuravate|appuravamo|appurano|appureno|appurante|appurassevo|appure|appurave|appurava|appurarria|appurarrissemo|appurate|appurammo|appurassero|appurarriano|appurato|appuravano|appurarrite|appurarrimmo|appuraje	<i>verb</i><br><ol><li>To discover</li><li>To control</li><li>To ascertain</li></ol>
arape	<i>verb</i><br><ol><li>to open</li></ol>
arapì	<i>verb</i><br><ol><li>to open</li></ol>
arba|arbe	<i>noun</i><br><ol><li>dawn</li></ol>
arbero	<i>noun</i><br><ol><li>tree</li></ol>
arcepelaco|arcepelache	<i>noun</i><br><ol><li>archipelago</li></ol>
arcepiscopo|arcepiscope	<i>noun</i><br><ol><li>archbishop</li></ol>
archemista|archemiste	<i>noun</i><br><ol><li>alchemist</li></ol>
archetetto|archetette	<i>noun</i><br><ol><li>architect</li></ol>
archetettura|archetetture	<i>noun</i><br><ol><li>architecture</li></ol>
arena	<i>noun</i><br><ol><li>sand</li></ol>
arriunà	<i>verb</i><br><ol><li>to ruin</li><li>to spoil</li><li>to break</li></ol>
arruinà	<i>verb</i><br><ol><li>to ruin</li><li>to spoil</li><li>to break</li></ol>
arrò	<i>adv</i><br><ol><li>where</li></ol>
arvulo	<i>noun</i><br><ol><li>tree (all senses)</li><li>shaft, spindle</li></ol>
ascella|ascelle	<i>noun</i><br><ol><li>wing</li></ol>
ascevulì	<i>verb</i><br><ol><li>to faint</li></ol>
ascià|asciaje|asciave|asciastevo|asciarrite|asciarraggio|asce|asciarraje|asciarriano|asciassemo|asciavo|asciaste|asciavate|ascia|asciarrà|asciarrissevo|asciavamo|asciasse|asciarrissemo|asciassevo|asciarria|asciate|asciavano|asciarranno|asciante|asciajemo|asceno|asciammo|asciarrimmo|ascianno|asciano|asciava|ascio|asciato|asciajeno|asciarrisse|asciassero	<i>verb</i><br><ol><li>to find</li></ol>
ascì	<i>verb</i><br><ol><li>to exit</li></ol>
aspettà	<i>verb</i><br><ol><li>to wait</li></ol>
assaje	<i>adv</i><br><ol><li>a lot</li></ol><br><i>prep</i><br><ol><li>very, a lot</li></ol>
assàje|assai	<i>adv</i><br><ol><li>much</li><li>a lot</li></ol>
attaccà	<i>verb</i><br><ol><li>To tie</li><li>To bind</li><li>To begin</li><li>To latch</li><li>To attach</li><li>To knot</li><li>To stick to glue</li></ol>
attuccà	<i>verb</i><br><ol><li>to break</li><li>to touch</li><li>to pertain</li></ol>
auciello|aucielle	<i>noun</i><br><ol><li>bird</li></ol>
auliva	<i>noun</i><br><ol><li>olive</li></ol>
austo	<i>noun</i><br><ol><li>August</li></ol>
ausà|ausarraje|ausassero|ausavamo|ausastevo|ausarrisse|ause|ausavo|ausarrà|ausajeno|ausano|ausarria|ausassevo|ausarriano|auseno|ausasse|ausanno|ausarranno|ausaste|ausarrimmo|ausarrissemo|ausavano|ausate|ausassemo|ausave|ausavate|ausajemo|ausammo|ausarrissevo|ausava|ausaje|ausarraggio|ausarrite|auso|ausa|ausato|ausante	<i>verb</i><br><ol><li>to use</li></ol>
auto|auta	<i>adj</i><br><ol><li>tall</li><li>high (in position)</li></ol><br><i>adv</i><br><ol><li>high</li></ol>
autriére	<i>adv</i><br><ol><li>day before yesterday.</li></ol>
avé|aviveve|aviste|avettero|avesse|avarraje|avettemo|aggiate|havente|aviano|avuto|avetteno|avette|avarrissevo|aveva|avive|avarriamo|aggio|avevo|avevamo|avarrisse|avite|avisse|avesseno|haje|avevano|avarrammo|avimmo|hanno|have|avarrà|avarria|ha|avarriano|havenno|aviamo|avarrate|avarranno|aveno|avarraggio|hê|avisseve|avessemo|avsteve	<i>verb</i><br><ol><li>to have (especially as an auxiliary verb)</li></ol>
avé a	<i>verb</i><br><ol><li>must; to have to</li></ol>
avé paura	<i>verb</i><br><ol><li>to fear</li><li>to be afraid of</li></ol>
babà	<i>noun</i><br><ol><li>rum baba (Neapolitan cake soaked in rum)</li></ol>
bafagna|bafagne	<i>noun</i><br><ol><li>scorching heat</li></ol>
bardascio	<i>noun</i><br><ol><li>boy</li></ol>
bemmenute	<i>intj</i><br><ol><li>welcome, greetings</li></ol>
bennaggia|bennaggia!	<i>intj</i><br><ol><li>blessed be... !</li><li>bless you!</li></ol>
ble	<i>noun</i><br><ol><li>blue</li></ol>
blo	<i>noun</i><br><ol><li>blue</li></ol>
bolle	<i>verb</i><br><ol><li>to boil (be in the state of boiling)</li></ol>
bonnì	<i>intj</i><br><ol><li>hello, good day</li></ol>
bucchino|bucchine	<i>noun</i><br><ol><li>a mouthful (of smoke, etc.)</li><li>(vulgar) fellatio</li></ol>
bussà|busseno|bussante|bussassero|bussarrissemo|bussano|bussarrimmo|bussate|bussaje|bussarrà|bussato|bussave|bussarrisse|bussassevo|bussanno|bussarraggio|bussasse|bussavano|bussajeno|bussarrissevo|bussarriano|bussava|busse|bussaste|bussavo|bussajemo|bussarrite|bussassemo|bussa|bussavamo|bussavate|bussarraje|bussarranno|bussastevo|bussammo|bussarria|busso	<i>verb</i><br><ol><li>To knock</li></ol>
ca	<i>adv</i><br><ol><li>what</li></ol><br><i>conj</i><br><ol><li>than (comparison between adjectives only)</li><li>that (as in 'the boy that I saw' ("O guaglio' ca vist'"))</li></ol><br><i>pron</i><br><ol><li>that</li><li>who</li><li>which</li></ol>
cacaglià|cacagliave|cacagliarranno|cacagliavamo|cacagliaste|cacagliammo|cacagliano|cacagliate|cacagliava|cacaglia|cacaglio|cacagliante|cacagliastevo|cacagliarrissemo|cacagliarrà|cacagliasse|cacagliarrite|cacagliassero|cacagliarrissevo|cacagliavo|cacagliarraje|cacaglieno|cacagliato|cacagliassevo|cacaglie|cacagliavate|cacagliassemo|cacagliarria|cacagliarriano|cacaglianno|cacagliaje|cacagliajemo|cacagliarraggio|cacagliavano|cacagliarrisse|cacagliajeno|cacagliarrimmo	<i>verb</i><br><ol><li>to stammer</li></ol>
cacà	<i>verb</i><br><ol><li>(intransitive, vulgar) to shit, crap</li><li>(transitive, vulgar) to soil with faeces</li><li>(transitive, vulgar) to give birth</li></ol>
cadavere|cadaveri	<i>noun</i><br><ol><li>corpse</li></ol>
caiorda	<i>noun</i><br><ol><li>(archaic) polecat, skunk</li></ol>
calapino|calpino	<i>noun</i><br><ol><li>A dictionary of the Latin language.</li></ol>
campà	<i>verb</i><br><ol><li>to live</li><li>to reside</li></ol>
cannarone|cannarune	<i>noun</i><br><ol><li>throat</li></ol>
cantane	<i>verb</i><br><ol><li>to sing</li></ol>
cantà	<i>verb</i><br><ol><li>to sing</li></ol>
canzona|canzone	<i>noun</i><br><ol><li>song</li></ol>
canzuncella	<i>noun</i><br><ol><li>Neapolitan song (traditional)</li></ol>
capa|cape	<i>noun</i><br><ol><li>head (the part of the body containing the brain)</li></ol>
capa 'e morte|ccape 'e morte	<i>noun</i><br><ol><li>skull</li></ol>
capello|capille	<i>noun</i><br><ol><li>hair of the mass growing on the top of the human head</li></ol>
cappiello|cappielli	<i>noun</i><br><ol><li>hat</li></ol>
carcioffula	<i>noun</i><br><ol><li>artichoke</li></ol>
carrià	<i>verb</i><br><ol><li>to move something by pushing</li></ol>
carugnone	<i>noun</i><br><ol><li>A wicked person</li></ol>
caré|carettero|carive|cararrite|cararria|cararrà|carevamo|cararrisse|caresse|cararraggio|cararranno|caresseno|cariano|carette|carevano|care|careva|caretteno|cariamo|cadé|caressemo|cariste|carimmo|caruto|carettemo|cariveve|cararrissevo|caristeve|carevo|carenno|carite|carisse|carente|caro|cararriano|cararrimmo|carisseve|cararrissemo|cararraje|careno	<i>verb</i><br><ol><li>to fall</li></ol>
casaménto	<i>noun</i><br><ol><li>an apartment building</li></ol>
caso|case	<i>noun</i><br><ol><li>cheese</li><li>event, occasion</li></ol>
castiello	<i>noun</i><br><ol><li>castle</li></ol>
cavajuolo|cavajuola|plurals cavajuole	<i>noun</i><br><ol><li>a troglodyte</li></ol>
cavulisciore|cavulisciure	<i>noun</i><br><ol><li>cauliflower</li></ol>
cavuluciore|cavuluciure	<i>noun</i><br><ol><li>cauliflower</li></ol>
cazzià	<i>verb</i><br><ol><li>To scold, to tell off</li></ol>
ccane	<i>adv</i><br><ol><li>(literary) here</li></ol>
cchiummo	<i>noun</i><br><ol><li>(uncountable) lead (metal)</li></ol>
cchiù	<i>adv</i><br><ol><li>more</li></ol>
ccà	<i>adv</i><br><ol><li>here</li></ol>
ce	<i>pron</i><br><ol><li>there (at a place)</li></ol>
ce verimmo	<i>intj</i><br><ol><li>goodbye</li></ol>
cenà	<i>verb</i><br><ol><li>to dine</li></ol>
cepolla	<i>noun</i><br><ol><li>onion</li></ol>
cerasa|ccerase	<i>noun</i><br><ol><li>cherry (fruit)</li></ol>
cercula	<i>noun</i><br><ol><li>oak tree</li></ol>
cercà|cercaje|cerca|cercato|cercajemo|cercassevo|cercante|cercasse|cercano|cercavo|cercastevo|cercarranno|cercarrisse|cercarraggio|cercavano|cercarrimmo|cierche|cercarria|cercassemo|cercassero|cercate|cercavamo|cercarrite|cercanno|cerco|cercarriano|cercarraje|cercaste|cercarrà|cercajeno|cercarrissevo|cercave|cercarrissemo|cercheno|cercammo|cercava|cercavate	<i>verb</i><br><ol><li>to search, to look for</li></ol>
ceroggeno|ceroggene	<i>noun</i><br><ol><li>a candle</li></ol>
cerza|cerze	<i>noun</i><br><ol><li>oak (tree of the genus Quercus)</li></ol>
cetro	<i>noun</i><br><ol><li>cedar tree</li></ol>
chesta|cheste	<i>pron</i><br><ol><li>this (in reference to someone or something near the speaker)</li></ol>
chestura	<i>noun</i><br><ol><li>police station</li></ol>
chiagne	<i>verb</i><br><ol><li>to weep, to cry</li></ol>
chiagnere	<i>verb</i><br><ol><li>to cry, weep</li></ol>
chiammà	<i>verb</i><br><ol><li>to call</li></ol>
chianiello	<i>noun</i><br><ol><li>slipper, babouche</li><li>(historical) patten</li></ol>
chianéta	<i>noun</i><br><ol><li>planet</li><li>priestly vestments</li></ol>
chiatto|chiatta|chiatte	<i>adj</i><br><ol><li>fat</li></ol>
chiazza|cchiazze	<i>noun</i><br><ol><li>square (an open space between buildings in a city)</li></ol>
chilleto	<i>noun</i><br><ol><li>whatchamacallit</li></ol>
chillo|chille|chelle|chella	<i>adj</i><br><ol><li>(demonstrative) that</li></ol>
chistu|chisti|chesta|cheste	<i>det</i><br><ol><li>this</li></ol>
chiummo	<i>noun</i><br><ol><li>a piece of lead (metal)</li></ol>
chiù	<i>prep</i><br><ol><li>more</li></ol><br><i>adv</i><br><ol><li>more, some more</li></ol>
chésso|chissò	<i>adj</i><br><ol><li>This (in reference to something that is near to the person being addressed)</li></ol><br><i>pron</i><br><ol><li>This one (in reference to something that is near to the person being addressed)</li></ol>
chésto|chisto	<i>adj</i><br><ol><li>This (in reference to something that is near to the speaker)</li></ol><br><i>pron</i><br><ol><li>This one (in reference to something that is near to the speaker)</li></ol>
cielo	<i>noun</i><br><ol><li>sky</li><li>heaven</li></ol>
cioccà	<i>verb</i><br><ol><li>to snow</li></ol>
ciucciaria	<i>noun</i><br><ol><li>stupidity, foolishness</li></ol>
ciuccio	<i>noun</i><br><ol><li>donkey, ass</li><li>fool, idiot</li></ol>
ciume|ciumi	<i>noun</i><br><ol><li>river: a stream with perennial spring</li><li>creek, stream: a little non-perennial river</li></ol>
civo|cive	<i>noun</i><br><ol><li>food</li></ol>
concetto|conciette	<i>noun</i><br><ol><li>concept</li></ol>
core	<i>noun</i><br><ol><li>heart</li></ol>
cortiello	<i>noun</i><br><ol><li>knife</li></ol>
cosere	<i>verb</i><br><ol><li>to sew</li></ol>
craje	<i>adv</i><br><ol><li>tomorrow</li></ol><br><i>noun</i><br><ol><li>tomorrow</li></ol>
crapa|crape	<i>noun</i><br><ol><li>goat</li></ol>
crapacuorno	<i>noun</i><br><ol><li>Capricorn</li></ol>
crastatore	<i>noun</i><br><ol><li>a person who castrates pigs and chickens.</li></ol>
crastà	<i>verb</i><br><ol><li>to castrate</li></ol>
cravone|cravune	<i>noun</i><br><ol><li>coal</li><li>charcoal</li></ol>
crestiano|crestiana|crestiane	<i>adj</i><br><ol><li>Christian</li></ol><br><i>noun</i><br><ol><li>Christian</li><li>person</li></ol>
criscio|criscia|crìsce|crìscio|crisce|crìscia	<i>adj</i><br><ol><li>gray</li></ol>
cu	<i>prep</i><br><ol><li>with</li></ol>
cuccà	<i>verb</i><br><ol><li>(transitive) To lay (someone or something) down.</li><li>(intransitive) To lie down, go to bed.</li></ol>
cucenà|cucenaste|cucenante|cucenavamo|cucene|cuceno|cucenassero|cucenarrissemo|cucenavano|cucenavate|cucenave|cuceneno|cucenasse|cucenarrisse|cucenassevo|cucenarraje|cucenajeno|cucenastevo|cucenaje|cucenarranno|cucenammo|cucenarria|cucenarriano|cucenato|cucenarrissevo|cucenanno|cucenarraggio|cucenarrimmo|cucenava|cucenavo|cucenano|cucenajemo|cucenate|cucena|cucenassemo|cucenarrà|cucenarrite	<i>verb</i><br><ol><li>to cook</li></ol>
cucìno	<i>noun</i><br><ol><li>a male cousin</li></ol>
cumannà|cumannato|cumanna|cumannassemo|cumannante|cumanne|cumannavano|cumannastevo|cumannassero|cumannarriano|cumannarranno|cumannarrite|cumannave|cumannavate|cumannajeno|cumannano|cumannava|cumanneno|cumannarrà|cumannassevo|cumannarraje|cumannate|cumannammo|cumannaje|cumannajemo|cumannarrissevo|cumanno|cumannavo|cumannarrissemo|cumannaste|cumannarrimmo|cumannasse|cumannanno|cumannarria|cumannarrisse|cumannavamo|cumannarraggio	<i>verb</i><br><ol><li>to command</li><li>to dominate</li></ol>
cumenzà	<i>verb</i><br><ol><li>to begin</li></ol>
cummà|cumpà	<i>noun</i><br><ol><li>(slang) female friend</li></ol>
cumprimento|cumprimente	<i>noun</i><br><ol><li>gift</li></ol>
cumpà|cummà	<i>noun</i><br><ol><li>(slang) male friend, buddy</li></ol>
cumpòsta	<i>noun</i><br><ol><li>pickle</li></ol>
cunto	<i>noun</i><br><ol><li>tale, story</li></ol>
cuntrullà|cuntrullo|cuntrullarrimmo|cuntrullaste|cuntrullasse|cuntrullammo|cuntrullajemo|cuntrullavamo|cuntrullavo|cuntrullassemo|cuntrullarrà|cuntrullante|cuntrullassero|cuntrullato|cuntrullarrissemo|cuntrullano|cuntrullassevo|cuntrullarriano|cuntrulleno|cuntrullate|cuntrullajeno|cuntrullarrite|cuntrullarranno|cuntrullarrissevo|cuntrullaje|cuntrullanno|cuntrullarraggio|cuntrullarraje|cuntrulla|cuntrullavano|cuntrullarria|cuntrullavate|cuntrullarrisse|cuntrullastevo|cuntrulle|cuntrullave|cuntrullava	<i>verb</i><br><ol><li>To verify</li><li>To control</li></ol>
cuntà|cunto|cuntassero|cuntarraje|cuntajemo|cuntarrite|cuntaste|cuntaje|cuntavamo|cuntano|cuntarraggio|cunteno|cuntanno|cuntato|cuntarrà|cuntarrissemo|cuntavo|cuntarria|cuntarriano|cuntavate|cuntasse|cunta|cuntajeno|cunte|cuntate|cuntarrimmo|cuntave|cuntassevo|cuntante|cuntarrissevo|cuntastevo|cuntavano|cuntarranno|cuntarrisse|cuntammo|cuntassemo|cuntava	<i>verb</i><br><ol><li>To narrate, tell or recount (a story)</li><li>to count a quantity</li></ol>
cuollo|cuolle	<i>noun</i><br><ol><li>neck</li></ol>
curreia|curreie	<i>noun</i><br><ol><li>belt</li><li>strap</li><li>strop</li></ol>
curreja|curreje	<i>noun</i><br><ol><li>belt</li><li>strap</li><li>strop</li></ol>
curtiello|curtielle	<i>noun</i><br><ol><li>knife</li><li>palette knife</li></ol>
curto	<i>adj</i><br><ol><li>short</li></ol>
custà	<i>verb</i><br><ol><li>to cost</li></ol>
cìmme 'e ràpa	<i>noun</i><br><ol><li>turnip greens</li></ol>
cìnche	<i>num</i><br><ol><li>five</li></ol>
còna	<i>noun</i><br><ol><li>icon</li><li>an image</li></ol>
cómme	<i>adv</i><br><ol><li>how</li></ol>
cómmo	<i>adv</i><br><ol><li>how</li></ol>
cóntro	<i>prep</i><br><ol><li>against</li></ol>
ddoje	<i>num</i><br><ol><li>two</li></ol>
debbusciatezza|'e ddebbusciatezze	<i>noun</i><br><ol><li>crapulence</li><li>gluttony</li><li>vice (in general)</li></ol>
debbusciato|debbusciate	<i>noun</i><br><ol><li>guzzler</li><li>glutton</li><li>someone who is intemperate</li></ol>
demierto	<i>adj</i><br><ol><li>stray, abandoned; fugitive</li></ol>
dente|diente	<i>noun</i><br><ol><li>tooth</li></ol>
denucchio	<i>noun</i><br><ol><li>knee</li></ol>
deposetà	<i>verb</i><br><ol><li>to deposit</li><li>to store</li><li>to put down, to place</li></ol>
deslenzà	<i>verb</i><br><ol><li>To rip or tear</li><li>To lacerate</li></ol>
devacà	<i>verb</i><br><ol><li>to pour (out)</li></ol>
dezzeiunario|dezzeiunàrio	<i>noun</i><br><ol><li>dictionary</li></ol>
dezziunàrio	<i>noun</i><br><ol><li>dictionary</li></ol>
dicere	<i>verb</i><br><ol><li>to say</li></ol>
dimannà|dimannano|dimannavamo|dimannava|dimannavano|dimannarranno|dimannassemo|dimanneno|dimannastevo|dimannato|dimannave|dimannarriano|dimannarria|dimannarrissemo|dimannaste|dimannasse|dimannarraje|dimannajemo|dimannavate|dimannarraggio|dimanne|dimannammo|dimanno|dimannarrimmo|dimannarrisse|dimannanno|dimannarrite|dimannassero|dimannaje|dimannarrà|dimannassevo|dimannavo|dimannajeno|dimannarrissevo|dimanna|dimannate|dimannante	<i>verb</i><br><ol><li>To ask</li><li>To demand</li></ol>
dinto	<i>adv</i><br><ol><li>inside; indoors</li><li>inwardly</li></ol>
dispoteco|dispoteche|dispoteca	<i>adj</i><br><ol><li>despotic</li></ol>
dizziunario	<i>noun</i><br><ol><li>dictionary</li></ol>
doce	<i>adj</i><br><ol><li>sweet</li></ol>
dormì	<i>verb</i><br><ol><li>to sleep</li></ol>
dulore	<i>noun</i><br><ol><li>pain</li></ol>
duminà|duminasse|duminarria|duminato|duminanno|duminaje|duminavate|duminaste|duminate|duminavo|duminava|duminarriano|duminarrissevo|duminammo|duminarranno|duminassero|dumineno|duminarrite|dumine|duminarrimmo|duminano|duminave|dumino|duminarrissemo|duminarrà|dumina|duminarraggio|duminarrisse|duminavamo|duminajemo|duminastevo|duminavano|duminarraje|duminante|duminassemo|duminassevo|duminajeno	<i>verb</i><br><ol><li>to command</li><li>to dominate</li></ol>
dummenà|dummenarraje|dummenato|dummenarraggio|dummena|dummenarria|dummenarrà|dummenarrisse|dummenano|dummenammo|dummenate|dummenarriano|dummeno|dummenaste|dummenarranno|dummenajeno|dummeneno|dummenavamo|dummenavate|dummenassemo|dummenastevo|dummenave|dummenaje|dummenassero|dummenarrissemo|dummenarrissevo|dummene|dummenajemo|dummenarrite|dummenasse|dummenavo|dummenanno|dummenarrimmo|dummenante|dummenassevo|dummenavano|dummenava	<i>verb</i><br><ol><li>to command</li><li>to dominate</li></ol>
dà	<i>verb</i><br><ol><li>to give</li></ol>
dùie	<i>num</i><br><ol><li>two</li></ol>
e	<i>prep</i><br><ol><li>of (used to express ownership)</li></ol><br><i>conj</i><br><ol><li>and</li></ol>
eccetto	<i>prep</i><br><ol><li>except</li></ol>
eine	<i>particle</i><br><ol><li>yes</li></ol>
esercizio	<i>noun</i><br><ol><li>exercise (also military)</li></ol>
essa|éssa	<i>pron</i><br><ol><li>she (nominative)</li><li>her (prepositional)</li></ol>
esse	<i>verb</i><br><ol><li>to be (dialectal)</li></ol>
evera	<i>noun</i><br><ol><li>grass</li><li>herb</li></ol>
fa'	<i>verb</i><br><ol><li>to do</li><li>to make</li><li>to act</li><li>to behave</li><li>to fuck (vulgar, colloquial)</li></ol>
faggio|faggie	<i>noun</i><br><ol><li>beech</li></ol>
famuso|famuse|famusa	<i>adj</i><br><ol><li>famous</li></ol>
fargna|fargne	<i>noun</i><br><ol><li>a laurel oak</li></ol>
fasulo|fasule	<i>noun</i><br><ol><li>bean</li></ol>
fatica|fatiche	<i>noun</i><br><ol><li>work</li><li>task</li></ol>
felece	<i>noun</i><br><ol><li>fern</li></ol>
feloseco|feloseche	<i>noun</i><br><ol><li>philosopher</li></ol>
femmena|femmene	<i>noun</i><br><ol><li>woman</li><li>wife</li></ol>
femmeniello|femmenielle	<i>noun</i><br><ol><li>(derogatory, offensive) a male transvestite</li></ol>
femmenile	<i>adj</i><br><ol><li>(also grammar) feminine</li></ol>
fermà	<i>verb</i><br><ol><li>to stop</li></ol>
fernì|fernente|fernesco|fernevo|fernite|ferniste|fernarrimmo|fernarrissevo|fernisseve|fernesse|fernarrà|fernenno|fernisce|fernettero|fernarrite|fernarrisse|ferniveve|fernetteno|fernimmo|fernette|fernesce|ferniamo|fernevamo|fernesceno|ferne|fernarriano|ferniano|fernisteve|fernarraje|fernisse|fernarraggio|fernarria|fernevano|ferneva|fernarranno|fernettemo|fernive|fernessemo|fernarrissemo|fernesseno|fernuto	<i>verb</i><br><ol><li>to finish</li></ol>
fessa|fesse	<i>noun</i><br><ol><li>vulva</li></ol>
fete	<i>verb</i><br><ol><li>to smell bad, to stink</li></ol>
ffierro	<i>noun</i><br><ol><li>Doubled initial consonant form of fierro</li></ol>
fierro|fierre	<i>noun</i><br><ol><li>iron (metal)</li></ol>
forasciuto|forasciute	<i>noun</i><br><ol><li>a political exile</li></ol>
formicola	<i>noun</i><br><ol><li>ant</li></ol>
frate	<i>noun</i><br><ol><li>brother</li></ol>
freoma	<i>noun</i><br><ol><li>patience</li><li>sufferance</li></ol>
friddo|fridda|fridde	<i>adj</i><br><ol><li>cold</li></ol>
fruntèra	<i>noun</i><br><ol><li>border</li></ol>
fruttefecà	<i>verb</i><br><ol><li>to proliferate</li></ol>
frùtto	<i>noun</i><br><ol><li>fruit, in the broadest sense</li></ol>
funniculare	<i>noun</i><br><ol><li>a funicular railroad.</li></ol>
fuoco|fuochi|fuoche	<i>noun</i><br><ol><li>fire</li><li>fireplace (the place of the house set to ignite a fire)</li></ol>
furesta|fureste	<i>noun</i><br><ol><li>forest</li></ol>
furesto|furesta|fureste	<i>adj</i><br><ol><li>wild</li><li>bad-tempered; peevish</li></ol>
furmaggio|furmagge	<i>noun</i><br><ol><li>cheese</li></ol>
futùro	<i>noun</i><br><ol><li>The future</li></ol>
fà|facive|facisse|faciarrà|faceva|facette|facettemo|facente|faciarrimme|facisseve|facesse|facevo|faciarría|facettero|facenno|fa|facetteno|faciarrisseve|faje|faciarranno|facimme|fanno|faciarríano|facesseno|facessemo|fatto|faciste|faciarrite|facevano|facite|faccio|farría|faciarrisse|face|facisteve|faciarraje|faciarraggio|facevamo|faciveve|faciarríame	<i>verb</i><br><ol><li>to do, make</li><li>to behave</li></ol>
gaiola|caiole	<i>noun</i><br><ol><li>birdcage</li></ol>
generalmente	<i>adv</i><br><ol><li>generally</li></ol>
gennere	<i>noun</i><br><ol><li>gender</li><li>(grammar) gender</li><li>genre</li></ol>
ggelo|ggieli	<i>noun</i><br><ol><li>frost (on the vegetation especially)</li><li>cold (relatively intense cold)</li></ol>
ghì	<i>verb</i><br><ol><li>to go</li></ol>
gliuommaro|gliuommare	<i>noun</i><br><ol><li>A ball of string or thread</li></ol>
gliuommero|gliuommere	<i>noun</i><br><ol><li>ball of string or thread</li></ol>
gravone|gravune	<i>noun</i><br><ol><li>coal</li></ol>
gruosso|gruosse|grossa|grosse	<i>adj</i><br><ol><li>great, big</li></ol>
grutto	<i>noun</i><br><ol><li>belch</li></ol>
gruttà|gruttammo|gruttaje|grutta|gruttanno|gruttave|gruttarriano|gruttavo|gruttano|gruttarrissemo|gruttarrissevo|gruttarraggio|gruttava|gruttassero|gruttassevo|gruttarria|gruttajemo|gruttajeno|gruttavano|grutto|grutte|gruttarranno|gruttavate|gruttaste|gruttate|gruttarrisse|gruttante|gruttarrite|gruttarrimmo|gruttavamo|gruttassemo|gruttarrà|grutteno|gruttarraje|gruttasse|gruttastevo|gruttato	<i>verb</i><br><ol><li>to belch</li></ol>
gruóbo	<i>noun</i><br><ol><li>globe</li></ol>
gròlia	<i>noun</i><br><ol><li>glory</li></ol>
guagliona|guagliune|guagliuni|guaglione	<i>noun</i><br><ol><li>girl</li></ol>
guaglione|guaglione|guagliona|guagliuni|guagliune	<i>noun</i><br><ol><li>boy</li></ol>
guallecchia	<i>noun</i><br><ol><li>hernia sufferer</li><li>weakling</li><li>the stretched part of the leg of a pair of pants/trousers caused by the wearer's knee</li></ol>
gudè	<i>verb</i><br><ol><li>to enjoy</li></ol>
i	<i>verb</i><br><ol><li>to go</li></ol><br><i>pron</i><br><ol><li>I: the first-person singular nominative personal pronoun.</li></ol>
iettà	<i>verb</i><br><ol><li>to hurl (something)</li><li>to vomit</li></ol>
ije	<i>pron</i><br><ol><li>I: the first-person singular nominative personal pronoun.</li></ol>
into	<i>prep</i><br><ol><li>in (surrounded by)</li></ol>
io|j’|i'|j'	<i>pron</i><br><ol><li>I (the first-person singular nominative pronoun)</li></ol>
isse|ìsse	<i>pron</i><br><ol><li>they (masculine nominative)</li></ol>
isso|ìsso	<i>pron</i><br><ol><li>he</li></ol>
iudecà	<i>verb</i><br><ol><li>to judge</li></ol>
janco|jànco	<i>adj</i><br><ol><li>white</li><li>pale</li></ol>
jastemma	<i>noun</i><br><ol><li>curse</li><li>insult</li></ol>
jastemmà|jastemmaste|jastemmate|jastemme|jastemmaje|jastemmarraggio|jastemmarria|jastemmassemo|jastemmo|jastemmajemo|jastemmavo|jastemmeno|jastemmasse|jastemma|jastemmarrissevo|jastemmarrà|jastemmarraje|jastemmavate|jastemmassero|jastemmammo|jastemmanno|jastemmano|jastemmastevo|jastemmarrissemo|jastemmava|jastemmato|jastemmassevo|jastemmarrite|jastemmante|jastemmarrimmo|jastemmajeno|jastemmave|jastemmarranno|jastemmarrisse|jastemmarriano|jastemmavamo|jastemmavano	<i>verb</i><br><ol><li>to curse</li><li>to insult</li></ol>
jenca|jenche	<i>noun</i><br><ol><li>heifer</li></ol>
jettatore|jettature|jettatora	<i>noun</i><br><ol><li>jinxer</li></ol>
jettà	<i>verb</i><br><ol><li>to hurl (something)</li><li>to vomit</li></ol>
ji	<i>verb</i><br><ol><li>to go</li></ol>
jonta|jonte	<i>noun</i><br><ol><li>an addition, or additional piece (also figuratively)</li><li>link (e.g. a hyperlink)</li></ol>
jucà	<i>verb</i><br><ol><li>to play (tennis, football etc.)</li></ol>
judecà	<i>verb</i><br><ol><li>to judge</li></ol>
jumenta|jumente	<i>noun</i><br><ol><li>mare (female horse)</li><li>(Scanno, mildly vulgar) beautiful woman</li></ol>
juorno|juorni	<i>noun</i><br><ol><li>day</li></ol>
jì	<i>verb</i><br><ol><li>to go</li></ol>
jì annànze	<i>verb</i><br><ol><li>to go forward</li><li>to make progress</li><li>to precede</li></ol>
jí|jenno|vaje|jettemo|vaco|jevano|jiveve|va|jarríame|je|jisseve|jate|jarrimme|jarranno|jamme|jarrisseve|jettero|jevamo|jiste|jarrite|jarría|jarraggio|jarríano|va'|juto|jive|vanno|jesse|jessemo|jisteve|jevo|jarraje|jesseno|jeva|jarrisse|jente|jisse|jette|jarrà|jetteno	<i>verb</i><br><ol><li>to go</li></ol>
l'|l' m and	<i>particle</i><br><ol><li>(before a vowel) Apocopic form of 'o, 'a: the</li></ol>
lapa|lape	<i>noun</i><br><ol><li>bee</li></ol>
lassà	<i>verb</i><br><ol><li>(Naples city) to leave, let</li></ol>
latte	<i>noun</i><br><ol><li>milk</li></ol>
lavoro|lavori	<i>noun</i><br><ol><li>a job (a specific task)</li></ol>
lazzarià	<i>verb</i><br><ol><li>to cover with cuts and bruises</li></ol>
legge	<i>verb</i><br><ol><li>to read</li></ol>
lengua|llengue	<i>noun</i><br><ol><li>tongue</li></ol>
lente	<i>noun</i><br><ol><li>glasses, lenses</li></ol>
levà	<i>verb</i><br><ol><li>to take off</li><li>to take out</li></ol>
lietto	<i>noun</i><br><ol><li>bed</li></ol>
ligno|legne	<i>noun</i><br><ol><li>wood</li></ol>
llatte	<i>noun</i><br><ol><li>Doubled initial consonant form of latte</li></ol>
lloro|llòro	<i>adj</i><br><ol><li>their</li></ol><br><i>pron</i><br><ol><li>they (feminine nominative)</li><li>them (after preposition)</li></ol>
llà	<i>adv</i><br><ol><li>there</li></ol>
lopa|lope	<i>noun</i><br><ol><li>she-wolf</li><li>bulimia</li></ol>
lucanna|llucanne	<i>noun</i><br><ol><li>inn</li></ol>
luna|lune	<i>noun</i><br><ol><li>moon</li></ol>
luntano|luntana|luntane	<i>adj</i><br><ol><li>distant</li></ol>
luongo|longa|luonge|longe	<i>adj</i><br><ol><li>long</li></ol>
luttà|luttate|lutta|luttarrà|luttarrisse|lutteno|luttammo|luttassevo|luttano|luttasse|luttaste|luttassemo|luttavano|luttato|luttarrimmo|lutto|luttavo|luttajeno|luttastevo|luttarrissevo|luttanno|luttarraje|luttavamo|luttave|luttarriano|luttava|luttarraggio|luttaje|luttavate|lutte|luttante|luttarrissemo|luttajemo|luttassero|luttarrite|luttarranno|luttarria	<i>verb</i><br><ol><li>to fight</li></ol>
luvà	<i>verb</i><br><ol><li>to take off</li><li>to take out</li></ol>
ma	<i>conj</i><br><ol><li>but</li></ol>
magnà|magnavano|magnavate|magnarrisse|magnarraje|magnato|magna|magnate|magnave|magnassevo|magnava|magnastevo|magnaje|magnassero|magnarrite|magnante|magnarrà|magnarranno|magnavamo|magnarrissemo|magnasse|magnarraggio|magnarriano|magnavo|magneno|magnanno|magnarria|magno|magnarrimmo|magnaste|magnarrissevo|magne|magnajeno|magnammo|magnassemo|magnano|magnajemo	<i>verb</i><br><ol><li>(transitive, intransitive) to eat</li></ol><br><i>noun</i><br><ol><li>(often uncountable) food</li></ol>
malacrianza|malacriànza	<i>noun</i><br><ol><li>rudeness</li><li>ill manners</li></ol>
malincunia	<i>noun</i><br><ol><li>melancholy</li></ol>
mammana	<i>noun</i><br><ol><li>midwife</li></ol>
mana	<i>noun</i><br><ol><li>hand</li></ol>
mandulino|manduline	<i>noun</i><br><ol><li>mandolin</li></ol>
mannaggia|mannaggia!	<i>intj</i><br><ol><li>(non-vulgar) damn!</li></ol>
mano|mmane	<i>noun</i><br><ol><li>hand</li></ol>
mantesino|mantesine	<i>noun</i><br><ol><li>apron</li></ol>
mare	<i>noun</i><br><ol><li>sea (a vast mass of salty water)</li></ol>
marenaro|marenare	<i>noun</i><br><ol><li>sailor</li></ol>
marvizzo|marvizze	<i>noun</i><br><ol><li>thrush (bird)</li></ol>
mazzecà	<i>verb</i><br><ol><li>to chew, masticate</li></ol>
me	<i>pron</i><br><ol><li>me (accusative or dative or reflexive or prepositional)</li></ol>
mellunaro|mellunare	<i>noun</i><br><ol><li>melon vendor, often specifically a watermelon vendor</li></ol>
mene|méne	<i>pron</i><br><ol><li>me (after preposition)</li></ol>
mengrània	<i>noun</i><br><ol><li>migraine</li></ol>
mereto|merete	<i>noun</i><br><ol><li>merit</li></ol>
mesale	<i>noun</i><br><ol><li>tablecloth</li></ol>
mette	<i>verb</i><br><ol><li>To put (something) aside.</li></ol>
metterse appaura	<i>verb</i><br><ol><li>to fear</li><li>to be afraid of</li></ol>
miccio|miccia|mìccio|míccio|micce	<i>adj</i><br><ol><li>pale</li><li>feeble, faint, weak</li></ol>
milo	<i>noun</i><br><ol><li>apple</li><li>apple tree</li></ol>
mio|mee|mìa|mèe|mìeje|mèje|mìo	<i>adj</i><br><ol><li>my</li></ol><br><i>pron</i><br><ol><li>mine (possessive)</li></ol>
miraculo|miracule	<i>noun</i><br><ol><li>miracle</li></ol>
mmangià	<i>noun</i><br><ol><li>food</li></ol>
mmece	<i>adv</i><br><ol><li>instead</li></ol>
mmelenà	<i>verb</i><br><ol><li>to poison</li></ol>
mmerda|mmerde	<i>noun</i><br><ol><li>shit</li></ol>
mmerrezzà	<i>verb</i><br><ol><li>to spoil (e.g. a child)</li></ol>
mmerzo	<i>prep</i><br><ol><li>circa</li><li>towards</li></ol>
mmità	<i>verb</i><br><ol><li>to invite</li></ol>
mmustà|mmustanno|mmustave|mmustarrà|mmustammo|mmustarriano|mmustarrimmo|mmustaste|mmustarraje|mmusteno|mmustavo|mmustarrite|mmustaje|mmustastevo|mmustarria|mmustarrisse|mmustajemo|mmustassemo|mmustavate|mmustante|mmusta|mmustassero|mmustato|mmustasse|mmustarraggio|mmustarrissevo|mmuste|mmustavamo|mmusto|mmustava|mmustarranno|mmustajeno|mmustavano|mmustassevo|mmustarrissemo|mmustate|mmustano	<i>verb</i><br><ol><li>To show</li><li>To indicate</li></ol>
mola d''o sinno|mola do sinno	<i>noun</i><br><ol><li>wisdom tooth</li></ol>
monnezza	<i>noun</i><br><ol><li>rubbish, garbage, trash, litter</li></ol>
morte|morti	<i>noun</i><br><ol><li>death</li></ol>
mprestà	<i>verb</i><br><ol><li>to loan</li></ol>
mpurtante|mportante	<i>adj</i><br><ol><li>important</li></ol>
mugliera|mugliere	<i>noun</i><br><ol><li>wife</li></ol>
mulignana|mulignane	<i>noun</i><br><ol><li>eggplant, aubergine</li><li>bruise</li></ol>
munno	<i>noun</i><br><ol><li>world</li></ol>
muntagna|muntagne	<i>noun</i><br><ol><li>mountain</li><li>big amount, excess quantity of something</li></ol>
murvillo	<i>noun</i><br><ol><li>measles</li></ol>
murì	<i>verb</i><br><ol><li>to die</li></ol>
muzzarella|mmuzzarella	<i>noun</i><br><ol><li>mozzarella</li></ol>
muzzarella 'e vufera|muzzarelle 'e vufera	<i>noun</i><br><ol><li>mozzarella made from water buffalo milk</li></ol>
muzzo	<i>noun</i><br><ol><li>person missing one or more limbs</li></ol><br><i>adj</i><br><ol><li>characterize by the loss of one or more limbs</li></ol>
n'	<i>article</i><br><ol><li>Contraction of na.</li><li>Contraction of nu.</li></ol>
na	<i>article</i><br><ol><li>a, an</li></ol>
nanassa|nanasse	<i>noun</i><br><ol><li>pineapple</li></ol>
napulione	<i>noun</i><br><ol><li>goatee</li></ol>
napulitano|napulitane|napulitana	<i>adj</i><br><ol><li>Neapolitan</li></ol><br><i>noun</i><br><ol><li>Neapolitan (man)</li></ol><br><i>name</i><br><ol><li>Neapolitan (language)</li></ol>
natrella|natrelle	<i>noun</i><br><ol><li>duck</li></ol>
natà	<i>verb</i><br><ol><li>to swim</li></ol>
ncarzà	<i>verb</i><br><ol><li>to reinforce</li><li>to shore up</li></ol>
nce	<i>pron</i><br><ol><li>us</li><li>(reflexive) ourselves; each other</li><li>to us, to him, to her, to them</li></ol><br><i>adv</i><br><ol><li>to there, here, there</li></ol>
nchiurè	<i>verb</i><br><ol><li>to close</li></ol>
nciarmà|nciarmave|nciarmavano|nciarmarranno|nciarmastevo|nciarmavate|nciarmarrà|nciarmanno|nciarme|nciarmante|nciarmaje|nciarmava|nciarmano|nciarmarraje|nciarmavamo|nciarmarraggio|nciarmeno|nciarmarria|nciarmajemo|nciarmajeno|nciarmarrite|nciarmavo|nciarmassero|nciarmasse|nciarmarrissevo|nciarma|nciarmarrissemo|nciarmassevo|nciarmassemo|nciarmarrisse|nciarmammo|nciarmate|nciarmo|nciarmarrimmo|nciarmaste|nciarmarriano|nciarmato	<i>verb</i><br><ol><li>To organize</li><li>To enchant</li></ol>
ncoppa	<i>prep</i><br><ol><li>over</li><li>more than</li><li>above</li><li>on, onto</li></ol><br><i>adv</i><br><ol><li>up</li><li>on top</li><li>above</li></ol>
ncroja	<i>noun</i><br><ol><li>orca</li></ol>
ncòppa	<i>prep</i><br><ol><li>above, on</li></ol>
nemmicculo	<i>noun</i><br><ol><li>lentil</li></ol>
nemmìco	<i>noun</i><br><ol><li>enemy</li></ol>
nenna|nenne	<i>noun</i><br><ol><li>girl (especially in a joking manner)</li></ol>
neutro|neutre|neutra	<i>adj</i><br><ol><li>(grammar) neuter</li></ol>
nfrusso	<i>noun</i><br><ol><li>influence</li></ol>
nfucato|nfucata|nfucate	<i>adj</i><br><ol><li>heated</li></ol>
ngoppe	<i>prep</i><br><ol><li>on, on top of, lying on</li><li>over (staying higher in position)</li></ol><br><i>adv</i><br><ol><li>upstairs</li></ol>
ngrese	<i>name</i><br><ol><li>English (nationality)</li></ol>
nguacchià	<i>verb</i><br><ol><li>To dirty</li><li>To scribble</li></ol>
niro|nera|plurals nire	<i>adj</i><br><ol><li>black</li></ol>
nisciuno|nisciuna	<i>adj</i><br><ol><li>(singular only, in negative sentences) no, any</li></ol><br><i>pron</i><br><ol><li>(singular only) none</li><li>(masculine singular only) no one, nobody</li></ol>
nnapulitano	<i>name</i><br><ol><li>Doubled initial consonant form of napulitano</li></ol>
nnatta|nnatte	<i>noun</i><br><ol><li>a flat fior di latte-style goat or cow milk cheese</li><li>an excessive amount of saliva</li></ol>
nnerizzo|nnerizze	<i>noun</i><br><ol><li>address</li></ol>
nonna|nnonne	<i>noun</i><br><ol><li>grandmother</li><li>beddy-bye</li></ol>
notte|nnotte	<i>noun</i><br><ol><li>night</li></ol>
ntoscia	<i>noun</i><br><ol><li>laziness</li><li>slowness</li><li>a slowing down</li><li>hernia</li></ol>
ntufato	<i>adj</i><br><ol><li>puffed-up, swollen (with pride, anger etc)</li></ol>
ntufà	<i>verb</i><br><ol><li>to fill, inflate</li></ol>
ntussecuso|ntussecusa|ntussecuse	<i>adj</i><br><ol><li>irritable</li><li>touchy</li></ol>
ntussecà	<i>verb</i><br><ol><li>to poison (also figuratively)</li></ol>
nu	<i>article</i><br><ol><li>a, an</li></ol>
nu sacco	<i>adv</i><br><ol><li>very (used to make superlative)</li><li>a lot of</li><li>much</li></ol>
nuje|nùje	<i>pron</i><br><ol><li>we</li></ol>
nuosto|nòsta|nòste|nuóste|nuósto	<i>adj</i><br><ol><li>our</li></ol>
nurmalmente	<i>adv</i><br><ol><li>normally</li></ol>
nustierzu	<i>adv</i><br><ol><li>(Northern Calabrian) the day before yesterday; two days ago</li></ol>
nzerrà|nzerrassemo|nzerrassevo|nzerrarraggio|nzerrave|nzerrarriano|nzerra|nzerrarria|nzerravate|nzerrante|nzerrano|nzerraje|nzerravamo|nzerrarrite|nzerrasse|nzerrajeno|nzerrarranno|nzerro|nzerrarrissevo|nzerrarraje|nzerravo|nzerravano|nzerrajemo|nzerrate|nzerranno|nzerrammo|nzerreno|nzerrastevo|nzerrarrissemo|nzerrava|nzerrarrimmo|nzerrarrà|nzerrato|nzerrarrisse|nzerre|nzerraste|nzerrassero	<i>verb</i><br><ol><li>to close</li></ol>
nzieme|nzieme co	<i>adv</i><br><ol><li>together</li></ol><br><i>prep</i><br><ol><li>with, together with, along with</li></ol>
nzignà|nzignavo|nzigna|nzignarrà|nzignastevo|nzignave|nzigne|nzignavamo|nzignasse|nzignassemo|nzignavate|nzignanno|nzignarraje|nzignaje|nzignarrissevo|nzignarrissemo|nzignano|nzignaste|nzignarrite|nzignarrisse|nzignarranno|nzignarriano|nzignavano|nzignarria|nzignarrimmo|nzigno|nzignajemo|nzignava|nzignajeno|nzignarraggio|nzignante|nzignassero|nzigneno|nzignate|nzignassevo|nzignammo|nzignato	<i>verb</i><br><ol><li>To show</li><li>To indicate</li></ol>
nòve	<i>num</i><br><ol><li>nine</li></ol>
o	<i>particle</i><br><ol><li>or</li></ol>
oggetto|oggiette	<i>noun</i><br><ol><li>(grammar) object</li></ol>
ogna|ogne	<i>noun</i><br><ol><li>(anatomy) nail (part of hands and toes in any organism)</li></ol>
ommo|uommene	<i>noun</i><br><ol><li>man (male human being)</li></ol>
osemà	<i>verb</i><br><ol><li>To sniff, smell</li></ol>
paisano	<i>noun</i><br><ol><li>a fellow countryman or compatriot</li></ol>
palàzzo 'e càsa	<i>noun</i><br><ol><li>An apartment building.</li></ol>
panaro|panari	<i>noun</i><br><ol><li>basket (a wood container used for fruit)</li></ol>
pandulino|panduline	<i>noun</i><br><ol><li>mandolin</li></ol>
pane	<i>noun</i><br><ol><li>bread</li></ol>
panza	<i>noun</i><br><ol><li>stomach</li></ol>
paro	<i>noun</i><br><ol><li>pair</li></ol>
parula|parule	<i>noun</i><br><ol><li>swamp, marsh</li></ol>
parè	<i>verb</i><br><ol><li>to seem</li></ol>
pastenaca|pastenache	<i>noun</i><br><ol><li>carrot (plant or vegetable)</li></ol>
pastiera|pastiere	<i>noun</i><br><ol><li>pastiera (Neapolitan Easter tart)</li></ol>
pe	<i>prep</i><br><ol><li>for</li></ol>
pe miezo che	<i>conj</i><br><ol><li>for, because</li></ol><br><i>prep</i><br><ol><li>(rare) because</li></ol>
peccato|piccati	<i>noun</i><br><ol><li>pity (a regrettable thing)</li><li>sin</li></ol>
pecché	<i>adv</i><br><ol><li>why</li><li>because</li></ol><br><i>conj</i><br><ol><li>for</li></ol>
pelo|pili	<i>noun</i><br><ol><li>hair (of the body)</li></ol>
penzà	<i>verb</i><br><ol><li>to think</li><li>to plan</li></ol>
perimma	<i>noun</i><br><ol><li>The mold which grows on ill-preserved food.</li><li>mildew</li></ol>
perzeca	<i>noun</i><br><ol><li>peach (fruit)</li></ol>
perzona|perzone	<i>noun</i><br><ol><li>person</li></ol>
pesante	<i>adj</i><br><ol><li>heavy</li></ol>
pesce|pisce	<i>noun</i><br><ol><li>fish</li></ol>
petrosino|petrosine	<i>noun</i><br><ol><li>parsley</li></ol>
pettore	<i>noun</i><br><ol><li>painter</li></ol>
pezzecà	<i>verb</i><br><ol><li>to pinch</li></ol>
pianefforte	<i>noun</i><br><ol><li>piano</li></ol>
piccerillo	<i>adj</i><br><ol><li>small</li><li>little</li><li>young</li></ol><br><i>noun</i><br><ol><li>child</li></ol>
picciunara|picciunare	<i>noun</i><br><ol><li>dovecote</li></ol>
piglià|piglieno|pigliassevo|pigliarranno|pigliaste|pigliano|pigliarrissevo|pigliavamo|pigliarrà|pigliassero|pigliajeno|pigliammo|pigliato|pigliave|pigliarraje|piglianno|pigliava|pigliajemo|pigliarrimmo|piglia|piglio|pigliante|pigliarrite|pigliasse|pigliaje|pigliate|pigliarrisse|pigliassemo|piglie|pigliavo|pigliarriano|pigliarrissemo|pigliarria|pigliastevo|pigliavano|pigliarraggio|pigliavate	<i>verb</i><br><ol><li>to take</li><li>to get, to buy</li><li>to pick up</li><li>to eat, to drink</li></ol>
pinto|pinte	<i>noun</i><br><ol><li>turkey</li></ol>
piscopo	<i>noun</i><br><ol><li>bishop</li></ol>
pisto|piste	<i>noun</i><br><ol><li>pesto (sauce)</li></ol>
pizza	<i>noun</i><br><ol><li>pizza</li></ol>
portalettere	<i>noun</i><br><ol><li>postman</li></ol>
posema|pposeme	<i>noun</i><br><ol><li>starch</li></ol>
prena|prene	<i>adj</i><br><ol><li>pregnant</li></ol>
pressa	<i>noun</i><br><ol><li>(uncountable) hurry</li></ol>
preta|pprete	<i>noun</i><br><ol><li>stone</li></ol>
priato|priàto|priàta|priàte|priata|priate	<i>adj</i><br><ol><li>happy</li><li>content, pleased, satisfied</li></ol>
priatorio	<i>noun</i><br><ol><li>purgatory</li></ol>
priezza|priezze|priézze|priézza	<i>noun</i><br><ol><li>great happiness, joy</li><li>satisfaction</li><li>exultation</li></ol>
pruducere	<i>verb</i><br><ol><li>to produce</li></ol>
pruggettà	<i>verb</i><br><ol><li>to plan</li></ol>
pruibbeto|plurals pruibbete|pruibbeta	<i>adj</i><br><ol><li>prohibitive</li></ol>
pruibbì	<i>verb</i><br><ol><li>to prohibit</li></ol>
prègo	<i>intj</i><br><ol><li>you're welcome</li></ol>
pulezzà|pulezzarraggio|pulezzassevo|pulezzeno|pulezzarrisse|pulezzasse|pulezzate|pulezzarrissevo|pulezzarrimmo|pulezzavano|pulezzave|pulezzarraje|pulezzarriano|pulezzaje|pulezzanno|pulezzarranno|pulezzaste|pulezzano|pulezzassemo|pulezzajeno|pulezzajemo|pulezzarrà|pulezzava|pulezza|pulezzavamo|pulezze|pulezzavo|pulezzastevo|pulezzo|pulezzarrite|pulezzarrissemo|pulezzassero|pulezzato|pulezzante|pulezzammo|pulezzarria|pulezzavate	<i>verb</i><br><ol><li>to clean</li></ol>
pummarda	<i>noun</i><br><ol><li>mortar cannon</li></ol>
pummarola|pummarole	<i>noun</i><br><ol><li>tomato</li></ol>
punio|ponie	<i>noun</i><br><ol><li>fist</li><li>punch</li></ol>
purcellamma|purcellamme	<i>noun</i><br><ol><li>porcelain</li></ol>
purchiacca|purchiacche	<i>noun</i><br><ol><li>(vulgar) pussy, vagina</li></ol>
purpo	<i>noun</i><br><ol><li>octopus</li></ol>
purtà	<i>verb</i><br><ol><li>to bring</li><li>to carry</li></ol>
pustino	<i>noun</i><br><ol><li>postman</li></ol>
puteca|pputeche	<i>noun</i><br><ol><li>retail store</li></ol>
putè	<i>verb</i><br><ol><li>to be able to</li><li>to be allowed</li></ol>
quanno	<i>adv</i><br><ol><li>when</li></ol>
quartino	<i>noun</i><br><ol><li>(small) apartment</li></ol>
quatto	<i>num</i><br><ol><li>four</li></ol>
quistùra	<i>noun</i><br><ol><li>police station</li></ol>
quàtto	<i>num</i><br><ol><li>four</li></ol>
ranceto|ranceta|plurals rancete	<i>adj</i><br><ol><li>rancid</li></ol>
rancio|rancie	<i>noun</i><br><ol><li>spider</li></ol>
rapillo|rapilli	<i>noun</i><br><ol><li>lapillo, (fragment of) rapilli</li></ol>
rebbrecà	<i>verb</i><br><ol><li>to replicate</li></ol>
recchiune	<i>noun</i><br><ol><li>mumps</li></ol>
remmasuglia	<i>noun</i><br><ol><li>leftovers</li></ol>
renaro|renare	<i>noun</i><br><ol><li>coin</li></ol>
rennena|renennee	<i>noun</i><br><ol><li>swallow; marten (Hirundo urbis)</li></ol>
reprubbecano|reprubbecana|plurals reprubbecane|reprubbecane	<i>noun</i><br><ol><li>republican</li></ol><br><i>adj</i><br><ol><li>republican</li></ol>
rescefrà	<i>verb</i><br><ol><li>to decipher</li></ol>
revacà	<i>verb</i><br><ol><li>to pour (out)</li></ol>
reverzà	<i>verb</i><br><ol><li>to vomit</li></ol>
rialà|rialaje|riala|rialarrissemo|rialave|rialastevo|rialavamo|rialano|rialarrissevo|riale|rialammo|rialavate|rialavo|rialarrà|rialo|rialarriano|rialassevo|rialajeno|rialeno|rialarranno|rialarrisse|rialava|rialante|rialato|rialassero|rialavano|rialarraggio|rialarria|rialassemo|rialajemo|rialanno|rialate|rialarrimmo|rialasse|rialaste|rialarraje|rialarrite	<i>verb</i><br><ol><li>to give (a gift)</li><li>to donate</li></ol>
rica|rriche	<i>noun</i><br><ol><li>line</li></ol>
riggina|riggìna	<i>noun</i><br><ol><li>queen</li></ol>
rota|rote	<i>noun</i><br><ol><li>wheel</li></ol>
rotunno	<i>adj</i><br><ol><li>round, rounded, rotund</li></ol><br><i>noun</i><br><ol><li>picarel, Spicara smaris</li></ol>
rré	<i>noun</i><br><ol><li>king</li></ol>
s'|s’	<i>pron</i><br><ol><li>(before a vowel) Apocopic form of se</li></ol>
s'addorme	<i>verb</i><br><ol><li>(reflexive) to fall asleep</li></ol>
sacco|sacchi	<i>noun</i><br><ol><li>sack, bag for garbage etc.</li></ol>
saciccio|sacicce	<i>noun</i><br><ol><li>sausage</li></ol>
saciccione|sacicciune	<i>noun</i><br><ol><li>large sausage</li></ol>
sanghe|sanghi	<i>noun</i><br><ol><li>blood</li></ol>
santunicola|santunicole	<i>noun</i><br><ol><li>ladybug</li></ol>
sapè	<i>verb</i><br><ol><li>to know something</li></ol>
saracone	<i>noun</i><br><ol><li>large overcoat</li><li>very astute man</li></ol>
sarcizio	<i>noun</i><br><ol><li>exercise (also military)</li></ol>
sartanio|sartanie	<i>noun</i><br><ol><li>frying pan</li><li>cooking pot</li></ol>
sarvia	<i>noun</i><br><ol><li>sage (herb)</li></ol>
sarzizzeje	<i>noun</i><br><ol><li>(archaic) exercise (also military)</li></ol>
scamazzà|scamazzano|scamazze|scamazzajemo|scamazzassero|scamazzave|scamazzajeno|scamazzarrite|scamazzato|scamazzarrissevo|scamazzanno|scamazzava|scamazzante|scamazzarriano|scamazzarrissemo|scamazza|scamazzate|scamazzarraje|scamazzassemo|scamazzarranno|scamazzammo|scamazzastevo|scamazzavo|scamazzaste|scamazzassevo|scamazzo|scamazzaje|scamazzarrà|scamazzasse|scamazzavamo|scamazzavate|scamazzarrimmo|scamazzarria|scamazzarrisse|scamazzarraggio|scamazzeno|scamazzavano	<i>verb</i><br><ol><li>to press</li><li>to crush</li><li>to squash</li><li>to trample</li></ol>
scarfatura	<i>noun</i><br><ol><li>gonorrhea</li></ol>
scarfà|scarfave|scarfarranno|scarfato|scarfammo|scarfano|scarfavo|scarfassemo|scarfassevo|scarfante|scarfajeno|scarfarrissevo|scarfe|scarfarrite|scarfarria|scarfastevo|scarfarrimmo|scarfajemo|scarfavano|scarfava|scarfate|scarfarriano|scarfanno|scarfarraje|scarfaste|scarfaje|scarfassero|scarfavamo|scarfo|scarfarraggio|scarfeno|scarfarrissemo|scarfavate|scarfarrisse|scarfasse|scarfa|scarfarrà	<i>verb</i><br><ol><li>To reheat</li><li>To heat up</li></ol>
scella|scelle	<i>noun</i><br><ol><li>wing</li></ol>
scerià	<i>verb</i><br><ol><li>To rub</li></ol>
scetavajasse	<i>noun</i><br><ol><li>(music) scetavajasse (Neapolitan percussion instrument)</li></ol>
scetà	<i>verb</i><br><ol><li>to wake up someone</li></ol>
schirchio|schirchie	<i>noun</i><br><ol><li>A crazy idea</li><li>whim</li></ol><br><i>adj</i><br><ol><li>crazy</li></ol>
schitto	<i>adv</i><br><ol><li>usually</li></ol>
sciancato	<i>adj</i><br><ol><li>lame</li><li>crippled</li></ol>
sciarmà	<i>verb</i><br><ol><li>to disarm</li></ol>
sciato|sciate	<i>noun</i><br><ol><li>breath, exhalation</li></ol>
sciaura|sciaure	<i>noun</i><br><ol><li>disaster, calamity</li><li>disgrace</li></ol>
scigna	<i>noun</i><br><ol><li>monkey</li></ol>
sciore|sciure	<i>noun</i><br><ol><li>(also figuratively) flower, bloom, blossom</li><li>flour</li></ol>
sciuscià|sciusciarrissevo|sciusciavamo|sciusciavo|sciusciasse|sciusciarriano|sciusciate|sciusciarrissemo|sciusciaste|sciusciarrisse|sciusciavano|sciusciarrimmo|sciusciano|sciusciarrà|sciusciarraggio|sciuscieno|sciusciava|sciuscianno|sciusciajeno|sciusciassemo|sciusciassero|sciusciaje|sciusciavate|sciusciassevo|sciusciarria|sciusciajemo|sciusciante|sciuscie|sciuscia|sciusciarranno|sciusciato|sciusciave|sciusciammo|sciuscio|sciusciastevo|sciusciarraje|sciusciarrite	<i>verb</i><br><ol><li>to blow</li></ol><br><i>noun</i><br><ol><li>shoeshine</li><li>shoeblack / bootblack (person)</li></ol>
sciòsciule	<i>noun</i><br><ol><li>dried fruit</li></ol>
scola	<i>noun</i><br><ol><li>school</li></ol>
scompetura|scompeture	<i>noun</i><br><ol><li>end</li></ol>
sconciglio	<i>noun</i><br><ol><li>Mulex sea snail</li></ol>
scoppetta|scoppette	<i>noun</i><br><ol><li>gun, arquebus, musket, rifle</li></ol>
scramazione	<i>noun</i><br><ol><li>an exclamation</li></ol>
scramà	<i>verb</i><br><ol><li>to exclaim</li></ol>
scrivì|scrivarrà|scrivessemo|scriviamo|scrivenno|scrivisseve|scrivisse|scriviste|scrivive|scrivetteno|scriveva|scrive|scrivimmo|scrivite|scrivevamo|scrivarrissevo|scrivesse|scrivarraggio|scriveno|scrivarrimmo|scrivarraje|scrivo|scrivevano|scrivuto|scrivettero|scrivisteve|scriviano|scrivarriano|scrivevo|scrivarria|scrivette|scrivarranno|scrivarrisse|scrivarrite|scrivarrissemo|scriviveve|scrivente|scrivesseno|scrivettemo	<i>verb</i><br><ol><li>to write</li><li>to spell</li></ol>
scuccià	<i>verb</i><br><ol><li>to disturb</li></ol>
scuorno|scuorni	<i>noun</i><br><ol><li>shame</li></ol>
scurcio	<i>noun</i><br><ol><li>A foreshortening.</li></ol>
scurdarse	<i>verb</i><br><ol><li>to forget (reflexive)</li></ol>
scurdà	<i>verb</i><br><ol><li>to forget</li><li>(music) to put out of tune</li></ol>
sdamma|sdamme	<i>noun</i><br><ol><li>lady</li><li>dame</li></ol>
sdammecella|sdammecelle	<i>noun</i><br><ol><li>maid of honor</li></ol>
se	<i>pron</i><br><ol><li>reflexive third person pronoun: oneself, himself, itself, herself, themselves etc.</li></ol>
se cuccà	<i>verb</i><br><ol><li>(reflexive) to lay down oneself to sleep</li></ol>
se firà	<i>verb</i><br><ol><li>(reflexive) to be able to</li></ol>
se scetà	<i>verb</i><br><ol><li>(reflexive) to wake up</li></ol>
sebburtura|sebburture	<i>noun</i><br><ol><li>burial</li><li>sepulchre</li><li>tomb</li></ol>
seca	<i>noun</i><br><ol><li>saw</li></ol>
seccogna|seccogne	<i>noun</i><br><ol><li>aridity; dryness</li></ol>
seculo|secule	<i>noun</i><br><ol><li>century</li></ol>
secà	<i>verb</i><br><ol><li>to saw</li></ol>
segliuzzà|segliuzzavamo|segliuzzarranno|segliuzzave|segliuzzaste|segliuzzato|segliuzzajemo|segliuzzasse|segliuzzastevo|segliuzzava|segliuzzano|segliuzzassemo|segliuzzarraje|segliuzzavo|segliuzzanno|segliuzzavate|segliuzzarrisse|segliuzzarrissemo|segliuzzo|segliuzzarria|segliuzzassero|segliuzzammo|segliuzzarraggio|segliuzzaje|segliuzzarrissevo|segliuzzante|segliuzzarrimmo|segliuzze|segliuzzarriano|segliuzzarrite|segliuzzassevo|segliuzzarrà|segliuzzavano|segliuzzajeno|segliuzza|segliuzzate|segliuzzeno	<i>verb</i><br><ol><li>To hiccough</li></ol>
selluzzà|selluzzarrissevo|selluzzajeno|selluzzavano|selluzzarraggio|selluzzarrisse|selluzzavamo|selluzzaje|selluzzajemo|selluzzarria|selluzzeno|selluzzo|selluzzassevo|selluzzarriano|selluzzastevo|selluzze|selluzzammo|selluzzarraje|selluzzate|selluzzarranno|selluzzavate|selluzzato|selluzzassero|selluzzante|selluzzasse|selluzzavo|selluzzanno|selluzzaste|selluzzarrissemo|selluzzave|selluzzarrite|selluzza|selluzzassemo|selluzzava|selluzzano|selluzzarrimmo|selluzzarrà	<i>verb</i><br><ol><li>To hiccough</li></ol>
semmana|semana|semmane|semane	<i>noun</i><br><ol><li>week</li></ol>
semprece	<i>adj</i><br><ol><li>simple</li><li>easy</li></ol>
sentì	<i>verb</i><br><ol><li>to feel</li><li>to listen</li></ol>
sfaccimma	<i>adj</i><br><ol><li>insolent, cheeky, impudent, shameless, brazen-faced</li></ol><br><i>noun</i><br><ol><li>sperm, cum</li><li>cheap stuff, garbage, refuse</li></ol>
sfacimma	<i>noun</i><br><ol><li>sperm</li></ol>
sfracassà	<i>verb</i><br><ol><li>To smash, or shatter.</li></ol>
sine	<i>particle</i><br><ol><li>yes</li></ol>
singulare	<i>adj</i><br><ol><li>(grammar) singular</li></ol>
siscà	<i>verb</i><br><ol><li>to whistle</li></ol>
smercià|smerciarria|smercianno|smerciano|smerciarrissevo|smerciavano|smerciave|smerciavate|smerciarraggio|smerciaste|smerciassevo|smercieno|smerciajemo|smerciate|smerciaje|smerciarraje|smerciavamo|smerciarrissemo|smercio|smerciava|smerciato|smerciammo|smerciarranno|smercie|smerciassemo|smerciarrimmo|smerciarrite|smerciarrisse|smerciajeno|smerciarrà|smerciasse|smerciastevo|smerciante|smerciarriano|smerciassero|smerciavo|smercia	<i>verb</i><br><ol><li>(transitive) to sell, sell off</li><li>(transitive) to smuggle</li></ol>
sole	<i>noun</i><br><ol><li>Sun</li></ol>
soppigno	<i>noun</i><br><ol><li>attic, garret, loft or mezzanine near the top of the building</li></ol>
sora|sore	<i>noun</i><br><ol><li>sister</li></ol>
sordi	<i>noun</i><br><ol><li>money</li></ol>
sordo	<i>noun</i><br><ol><li>A coin</li><li>money</li></ol>
sorece|surece	<i>noun</i><br><ol><li>mouse</li></ol>
sorice|surice	<i>noun</i><br><ol><li>a mouse</li></ol>
sotto	<i>prep</i><br><ol><li>below</li></ol>
spalece	<i>noun</i><br><ol><li>asparagus</li></ol>
spantacà|spantacastevo|spantaca|spantacajemo|spantacavate|spantacarraggio|spantacate|spantace|spantacajeno|spantacarrà|spantacassevo|spantacasse|spantacarraje|spantacavo|spantacammo|spantacaste|spantacarranno|spantacava|spantacarrissemo|spantaco|spantacato|spantacarrimmo|spantacarrite|spantacarria|spantaceno|spantacavano|spantacarrissevo|spantacaje|spantacante|spantacassemo|spantacarrisse|spantacanno|spantacave|spantacassero|spantacavamo|spantacano|spantacarriano	<i>verb</i><br><ol><li>(transitive) to scare, spook</li><li>(reflexive) to be scared, frightened, spooked, to fear</li></ol>
sparte	<i>verb</i><br><ol><li>to divide, to share</li></ol>
spartì	<i>verb</i><br><ol><li>to share</li><li>to divide</li></ol>
spetaccià	<i>verb</i><br><ol><li>To rip, shred, or tear to pieces</li></ol>
spezzà	<i>verb</i><br><ol><li>to interrupt</li></ol>
spustarse	<i>verb</i><br><ol><li>to move (from one place to another)</li><li>to remove</li></ol>
squatra|squatre	<i>noun</i><br><ol><li>team</li><li>squad</li><li>flotilla</li><li>a square (the tool)</li></ol>
staggione	<i>noun</i><br><ol><li>season</li><li>summer</li></ol>
stazzione|stazzioni	<i>noun</i><br><ol><li>railway station</li></ol>
stella|stelle	<i>noun</i><br><ol><li>star</li></ol>
stompagnare	<i>verb</i><br><ol><li>To break or smash (a barrel, bottle, etc.)</li><li>To bludgeon and crush (someone's bones with a club, etc.)</li><li>To knock the bottom out (of a barrel, etc.)</li></ol>
stordo	<i>noun</i><br><ol><li>moron, idiot</li></ol>
stratto|stratta|stratte	<i>adj</i><br><ol><li>abstract</li></ol>
strinto	<i>adj</i><br><ol><li>narrow</li><li>tight</li><li>strict</li></ol>
strulàbbio	<i>noun</i><br><ol><li>astrolabe</li></ol>
strumiento|strumiente	<i>noun</i><br><ol><li>instrument</li></ol>
stu|sta	<i>det</i><br><ol><li>Contraction of chistu; this</li></ol>
sturzellarse	<i>verb</i><br><ol><li>To deform</li><li>To contort</li></ol>
stutà	<i>verb</i><br><ol><li>extinguish</li></ol>
sudà	<i>verb</i><br><ol><li>to sweat</li></ol>
suggetto|suggetta|suggiette	<i>noun</i><br><ol><li>subject</li><li>(grammar) subject</li></ol><br><i>adj</i><br><ol><li>vulnerable, required</li></ol>
sujo|soja|suoje|soje	<i>adj</i><br><ol><li>his, her, its</li></ol><br><i>pron</i><br><ol><li>third-person singular possessive pronoun: hers, his, its</li></ol>
sunnà	<i>verb</i><br><ol><li>to sound</li><li>to dream</li></ol>
suonno|suonni	<i>noun</i><br><ol><li>sleep</li></ol>
surdato	<i>noun</i><br><ol><li>soldier</li></ol>
sustantivo|sustantive	<i>noun</i><br><ol><li>(grammar) noun</li></ol>
sèie	<i>num</i><br><ol><li>six</li></ol>
sótto	<i>prep</i><br><ol><li>under; underneath</li></ol>
tacca|tacche	<i>noun</i><br><ol><li>splinter</li></ol>
tanno	<i>adv</i><br><ol><li>then (referring to a specified time)</li></ol>
tata	<i>noun</i><br><ol><li>father, dad</li></ol>
tauto|taute	<i>noun</i><br><ol><li>coffin (box used for dead people)</li></ol>
tavano|tavane	<i>noun</i><br><ol><li>mosquito</li></ol>
tavulozza	<i>noun</i><br><ol><li>palette (board and range of colors)</li></ol>
tavuto|tavute	<i>noun</i><br><ol><li>coffin</li></ol>
tazzulella|tazzulelle	<i>noun</i><br><ol><li>demitasse</li></ol>
te	<i>pron</i><br><ol><li>you (singular familiar, accusative or dative or reflexive or prepositional)</li></ol>
tempesta|tempeste	<i>noun</i><br><ol><li>storm</li></ol>
tene|téne	<i>verb</i><br><ol><li>To have</li></ol><br><i>pron</i><br><ol><li>you (singular, formal, after preposition)</li></ol>
tennerumma	<i>noun</i><br><ol><li>a tender sort of cartilage</li><li>(humorous) tenderness</li></ol>
tennerùmmeca	<i>noun</i><br><ol><li>tenderness</li></ol>
tené	<i>verb</i><br><ol><li>To have</li></ol>
ternità	<i>noun</i><br><ol><li>eternity</li><li>(rare) the trinity</li></ol>
terra|terre	<i>noun</i><br><ol><li>land</li></ol>
tiano|tiane	<i>noun</i><br><ol><li>(cooking) pan</li></ol>
tiempo|tiempe	<i>noun</i><br><ol><li>time</li><li>tense</li><li>weather</li></ol>
titto|titte	<i>noun</i><br><ol><li>roof</li></ol>
trammiarse	<i>verb</i><br><ol><li>to wait</li><li>to hesitate</li></ol>
trappino|trappini	<i>noun</i><br><ol><li>mole (animal)</li></ol>
trappito|trappiti	<i>noun</i><br><ol><li>mole (animal)</li></ol>
trase	<i>verb</i><br><ol><li>to enter a place</li></ol>
trasfurmà|trasfurmarria|trasfurmarrimmo|trasfurmarraggio|trasfurmato|trasfurmano|trasfurmavano|trasfurma|trasfurmavamo|trasfurmaste|trasfurmarrite|trasfurmarrissevo|trasfurmarrà|trasfurmo|trasfurmarranno|trasfurmate|trasfurmave|trasfurmanno|trasfurmasse|trasfurmante|trasfurmavate|trasfurmaje|trasfurmarrissemo|trasfurmastevo|trasfurmavo|trasfurmarrisse|trasfurme|trasfurmarriano|trasfurmava|trasfurmassemo|trasfurmassevo|trasfurmajemo|trasfurmajeno|trasfurmeno|trasfurmassero|trasfurmammo|trasfurmarraje	<i>verb</i><br><ol><li>To transform</li><li>To change</li></ol>
trastula|trastule	<i>noun</i><br><ol><li>deceit</li></ol>
tre	<i>num</i><br><ol><li>three</li></ol>
trei	<i>num</i><br><ol><li>three</li></ol>
trennità	<i>noun</i><br><ol><li>the trinity</li></ol>
trimone|trimona|Bari|trimune	<i>noun</i><br><ol><li>wank (act of mansturbation)</li><li>idiot</li><li>hoe handle</li><li>a sorbet-making machine</li></ol>
truvà|truvasse|truvassevo|truvarraje|truvaje|troveno|truvarrite|truvassemo|truvavamo|truvassero|truvavate|truvaste|truvavo|truvarrissevo|truvanno|truvarrissemo|truvavano|trova|truvastevo|truvarraggio|truvarrà|truvava|truvammo|truvajeno|trovo|truvarrimmo|trovano|truvate|truvarriano|truove|truvarria|truvante|truvarrisse|truvato|truvarranno|truvave|truvajemo	<i>verb</i><br><ol><li>to find</li><li>to search, to look for</li></ol>
tré	<i>num</i><br><ol><li>three</li></ol>
tréje	<i>num</i><br><ol><li>three</li></ol>
tu	<i>pron</i><br><ol><li>you</li></ol>
tujo|toje|tuoje|toja	<i>adj</i><br><ol><li>your (to one person)</li></ol>
tuppetià|tuppetiavate|tuppetiaste|tuppetiave|tuppetiarrà|tuppetiarriano|tuppetiante|tuppetiarrissevo|tuppetiavano|tuppetiavo|tuppetieno|tuppetiajemo|tuppetiarria|tuppetiato|tuppetiarrissemo|tuppetiasse|tuppetiajeno|tuppetianno|tuppetiate|tuppetiarrimmo|tuppetiano|tuppetiassevo|tuppetiassemo|tuppetiammo|tuppetie|tuppetiarranno|tuppetio|tuppetiassero|tuppetia|tuppetiarrisse|tuppetiava|tuppetiarraje|tuppetiarraggio|tuppetiavamo|tuppetiastevo|tuppetiarrite|tuppetiaje	<i>verb</i><br><ol><li>To knock</li></ol>
tuppo|tuoppe	<i>noun</i><br><ol><li>(Irpinia variety) A hilltop or mountaintop: the summit of a mountain or hill.</li></ol>
turmiento|turmiente	<i>noun</i><br><ol><li>torment, storm</li></ol>
tuzzulià|tuzzuliajemo|tuzzuliano|tuzzuliastevo|tuzzuliajeno|tuzzuliavo|tuzzuliarrisse|tuzzuliante|tuzzuliate|tuzzuliave|tuzzulianno|tuzzuliammo|tuzzuliassemo|tuzzuliaste|tuzzuliarria|tuzzuliato|tuzzuliarrissevo|tuzzuliavate|tuzzuliarranno|tuzzuliarrimmo|tuzzuliarriano|tuzzulio|tuzzuliassevo|tuzzuliarrissemo|tuzzuliavamo|tuzzuliarraggio|tuzzuliaje|tuzzuliarraje|tuzzuliasse|tuzzulieno|tuzzulie|tuzzuliarrite|tuzzuliarrà|tuzzuliassero|tuzzulia|tuzzuliava|tuzzuliavano	<i>verb</i><br><ol><li>To knock</li></ol>
ue	<i>noun</i><br><ol><li>hello</li><li>sometimes used as a filler</li></ol>
uerra|uerre	<i>noun</i><br><ol><li>war</li></ol>
ummenone|ummenùne|ummenune|ummenóne	<i>noun</i><br><ol><li>(derogatory, offensive) a lesbian</li></ol>
unevèrzo	<i>noun</i><br><ol><li>The Universe</li></ol>
uocchio|uocchie	<i>noun</i><br><ol><li>eye</li></ol>
uosemo	<i>noun</i><br><ol><li>(also figuratively) scent, smell</li><li>(also figuratively) wisdom, common sense</li></ol>
urdinà	<i>verb</i><br><ol><li>to order</li></ol>
usemà	<i>verb</i><br><ol><li>To sniff, smell</li></ol>
va buono	<i>intj</i><br><ol><li>okay!; all right!</li></ol>
vabbuò	<i>adv</i><br><ol><li>(informal) okay; never mind</li></ol>
vacante	<i>adj</i><br><ol><li>empty</li></ol>
vammana	<i>noun</i><br><ol><li>midwife</li></ol>
vasinicola|vasinicole	<i>noun</i><br><ol><li>basil (plant, herb)</li></ol>
vaso|vase	<i>noun</i><br><ol><li>kiss</li></ol>
vastardo|vastarde	<i>noun</i><br><ol><li>bastard</li></ol>
ve	<i>pron</i><br><ol><li>you (formal or plural, reflexive or dative or accusative)</li></ol>
vecchia|vecchie	<i>adj</i><br><ol><li>old</li></ol><br><i>noun</i><br><ol><li>old woman</li><li>grandmother</li></ol>
vedè	<i>verb</i><br><ol><li>to see</li></ol>
vedé	<i>verb</i><br><ol><li>to see</li></ol>
venì	<i>verb</i><br><ol><li>to come</li></ol>
veramente	<i>adv</i><br><ol><li>really, truly</li></ol>
veré	<i>verb</i><br><ol><li>to see</li></ol>
vescata|vescate	<i>noun</i><br><ol><li>bird-lime</li></ol>
vestuto|vestuta|vestute	<i>adj</i><br><ol><li>dressed</li></ol>
viaggià	<i>verb</i><br><ol><li>to travel</li></ol>
vide Napule e po' muore	<i>proverb</i><br><ol><li>see Naples and die (nothing compares to the beauty of Naples, so you can die after you've seen it)</li></ol>
viecchio	<i>adj</i><br><ol><li>old</li></ol>
vierbo|vierbe	<i>noun</i><br><ol><li>(grammar) verb</li></ol>
vino	<i>noun</i><br><ol><li>wine</li></ol>
vita|bite|bita|vite	<i>noun</i><br><ol><li>life</li></ol>
viulino	<i>noun</i><br><ol><li>violin</li></ol>
vocca|vvocche	<i>noun</i><br><ol><li>mouth</li></ol>
vorpa	<i>noun</i><br><ol><li>fox</li></ol>
vorpe	<i>noun</i><br><ol><li>fox</li></ol>
vosco|voschi	<i>noun</i><br><ol><li>woodland (an area of great density of trees)</li></ol>
vottà	<i>verb</i><br><ol><li>to push</li><li>to throw</li></ol>
vrasa|vrase	<i>noun</i><br><ol><li>embers, coals</li></ol>
vufera|vvufere	<i>noun</i><br><ol><li>female water buffalo cow</li></ol>
vufero|vufere	<i>noun</i><br><ol><li>male water buffalo bull</li></ol>
vuje|vùje	<i>pron</i><br><ol><li>you (formal or plural)</li></ol>
vulio|vulío	<i>noun</i><br><ol><li>desire</li><li>wish</li></ol>
vulà	<i>verb</i><br><ol><li>to fly</li></ol>
vulè	<i>verb</i><br><ol><li>to want</li></ol>
vunnella|vvunnelle	<i>noun</i><br><ol><li>(dress) skirt</li></ol>
vuommeco	<i>noun</i><br><ol><li>vomit</li></ol>
vuosto|vóste|vuóste|vósta|vuósto	<i>adj</i><br><ol><li>your (to more than one person or formally to one person)</li></ol>
vvino	<i>noun</i><br><ol><li>Doubled initial consonant form of vino</li></ol>
vìppeto	<i>noun</i><br><ol><li>A drink, beverage.</li></ol>
zecchejà|zecchejava|zecchejavano|zecchejarria|zecchejarraggio|zecchejavate|zecchejarranno|zecchejassero|zecchejarrimmo|zecchejarrisse|zecchejassemo|zecchejate|zecchejarrà|zecchejajemo|zecchejaje|zecchejante|zecchejarraje|zecchejammo|zecchejanno|zecchejasse|zecchejavo|zecchejavamo|zecchejarriano|zecchejano|zecchejastevo|zecchejato|zeccheja|zecchejaste|zecchejassevo|zecchejarrissemo|zecchejo|zecchejave|zecchejajeno|zecchejarrite|zecchejeno|zeccheje|zecchejarrissevo	<i>verb</i><br><ol><li>(intransitive) To make a sound with one's mouth dominated by a "Z" sound in order to call birds.</li></ol>
zefierno|zefierne	<i>noun</i><br><ol><li>devil, demon, archdemon</li></ol>
zennà|zennarrissemo|zennarria|zennasse|zennajemo|zennarrissevo|zennarranno|zennassevo|zennava|zennano|zenne|zennammo|zennarrimmo|zennarrisse|zennante|zennave|zennavate|zennavano|zennate|zennarrite|zennavamo|zenno|zenna|zennanno|zennato|zennajeno|zenneno|zennassero|zennassemo|zennarraje|zennarraggio|zennarrà|zennaste|zennarriano|zennaje|zennastevo|zennavo	<i>verb</i><br><ol><li>To nod or point at</li><li>to indicate.</li></ol>
zeppulajuolo|zeppulajuole	<i>noun</i><br><ol><li>fried food vendor</li></ol>
zeremmònia	<i>noun</i><br><ol><li>ceremony</li></ol>
zirilla|zirille	<i>noun</i><br><ol><li>(Scanno, possibly wider) pinecone</li></ol>
zoccola	<i>noun</i><br><ol><li>sewer rat</li><li>whore, slut</li></ol>
zuco-zuco	<i>noun</i><br><ol><li>violin</li></ol>
zumpà	<i>verb</i><br><ol><li>to jump</li><li>to startle</li></ol>
zuppa|zuppe	<i>noun</i><br><ol><li>soup</li><li>soaked bread</li></ol>
àvaro	<i>noun</i><br><ol><li>tree</li></ol>
álema	<i>noun</i><br><ol><li>soul</li></ol>
â	<i>abbrev</i><br><ol><li>Contraction of a 'a (“to the”).</li></ol>
èssere|sarraje|songo|sarranno|so'|site|sarrite|sarrimmo|saraggio|simmo|è|sî	<i>verb</i><br><ol><li>to be</li></ol>
ê	<i>abbrev</i><br><ol><li>Contraction of a 'e (“to the”).</li></ol>
ìsciola	<i>noun</i><br><ol><li>chickenpox</li></ol>
òtto	<i>num</i><br><ol><li>eight</li></ol>
ô	<i>abbrev</i><br><ol><li>(Contraction of a 'o.) in (temporal preposition)</li><li>to the (specification of quantity)</li></ol>
ô veramente	<i>adv</i><br><ol><li>really, sincerely</li><li>really (intensifier)</li></ol>
ô vero	<i>adv</i><br><ol><li>really, truly, sincerely</li><li>(intensifier) really, for real</li></ol>
ùno	<i>num</i><br><ol><li>one</li></ol>
