'k	<i>pron</i><br><ol><li>Contraction of ik.</li></ol>
Aast|Aaster	<i>noun</i><br><ol><li>(Sylt) cheese</li></ol>
Baabe	<i>name</i><br><ol><li>Father</li></ol>
Blör	<i>noun</i><br><ol><li>(Sylt) blood</li></ol>
Brain|Brainen	<i>noun</i><br><ol><li>(Sylt) brain (anatomy)</li></ol>
Bruar|Bruarer	<i>noun</i><br><ol><li>(Sylt) bread</li></ol>
Bröch|Bröchen	<i>noun</i><br><ol><li>(Sylt) bridge (structure)</li></ol>
Bröđer|Bröđern	<i>noun</i><br><ol><li>(Sylt) brother</li></ol>
Buat|Buaten	<i>noun</i><br><ol><li>(Sylt) boat</li></ol>
Buusem|Buusemer	<i>noun</i><br><ol><li>(Sylt) barn</li></ol>
Dai|Daagen	<i>noun</i><br><ol><li>(Sylt) day</li></ol>
Dreeng|Dreenger	<i>noun</i><br><ol><li>(Sylt) boy, son</li></ol>
Dånmark	<i>name</i><br><ol><li>(Mooring) Denmark</li></ol>
Dörp|Dörper	<i>noun</i><br><ol><li>(Heligoland) village</li></ol>
En|Enen	<i>noun</i><br><ol><li>(Sylt) duck (waterfowl)</li></ol>
Faamen|Faamner	<i>noun</i><br><ol><li>(Sylt) girl, daughter</li></ol>
Faađer|Faađern	<i>noun</i><br><ol><li>(Sylt) father</li></ol>
Flāg|Flāgen	<i>noun</i><br><ol><li>(Sylt) flag</li></ol>
Fođer	<i>noun</i><br><ol><li>(Sylt) hay</li></ol>
Frinj|Frinjer	<i>noun</i><br><ol><li>(Sylt) friend</li></ol>
Fut|Fet|Futten	<i>noun</i><br><ol><li>(Heligoland, Sylt) foot</li></ol>
Gooki|Gookis	<i>noun</i><br><ol><li>(Sylt) grandfather, grandpa</li></ol>
Guus|Gös	<i>noun</i><br><ol><li>(Sylt) goose</li></ol>
Gögeler|Gögelers	<i>noun</i><br><ol><li>(Sylt) magician, wizard, witch</li></ol>
Gērs	<i>noun</i><br><ol><li>(Sylt) grass</li></ol>
Haur|Hauđer	<i>noun</i><br><ol><li>(Sylt) head (body part)</li></ol>
Hüs|Hüüsing	<i>noun</i><br><ol><li>(Sylt) house</li></ol>
Hārefst	<i>noun</i><br><ol><li>(Sylt) autumn, fall</li></ol>
Jungen	<i>noun</i><br><ol><li>(Sylt) child</li></ol>
Knif|Kniiwer	<i>noun</i><br><ol><li>(Sylt) knife</li></ol>
Kü|Kin	<i>noun</i><br><ol><li>(Sylt) cow</li></ol>
Lun|Lun'n	<i>noun</i><br><ol><li>(Heligoland) land</li></ol>
Man|Maaner	<i>noun</i><br><ol><li>(Sylt) man (adult male human)</li></ol>
Mooter|Mootern	<i>noun</i><br><ol><li>(Sylt) mother</li></ol>
Mootji|Mootjes	<i>noun</i><br><ol><li>(Sylt) grandmother, grandma</li></ol>
Mārig|Māriger	<i>noun</i><br><ol><li>(Sylt) sausage</li></ol>
Nuurđfriisk	<i>name</i><br><ol><li>(Sylt) North Frisian (language/language group)</li></ol>
Oapel|Oapler	<i>noun</i><br><ol><li>(Heligoland) apple</li></ol>
Oom|Oomen	<i>noun</i><br><ol><li>(Sylt) uncle</li></ol>
Sjiisklun	<i>noun</i><br><ol><li>(Amrum) Germany</li></ol>
Sjürt|Sjürter	<i>noun</i><br><ol><li>(Sylt) shirt</li></ol>
Skoch|Skuur	<i>noun</i><br><ol><li>(Sylt) shoe</li></ol>
Skolp	<i>noun</i><br><ol><li>(Sylt) dandruff</li><li>(Sylt) scales (of fish, reptiles, etc.)</li></ol>
Skruk|Skruken	<i>noun</i><br><ol><li>(Sylt) oyster</li></ol>
Spook|Spooken	<i>noun</i><br><ol><li>(Sylt) ghost, phantom</li></ol>
Spraak|Spraaken	<i>noun</i><br><ol><li>(Sylt) language</li></ol>
Stroom|Stroomen	<i>noun</i><br><ol><li>(Sylt) stream, river</li></ol>
Strun|Strun'n	<i>noun</i><br><ol><li>(Heligoland) beach</li></ol>
Swērt|Swērter	<i>noun</i><br><ol><li>(Sylt) sword</li></ol>
Sērk|Sērker	<i>noun</i><br><ol><li>(Sylt) church</li></ol>
Ter	<i>noun</i><br><ol><li>(Sylt) tooth</li></ol>
Tjiisklun	<i>noun</i><br><ol><li>(Föhr) Germany</li></ol>
Tjüschlönj	<i>noun</i><br><ol><li>(Mooring) Germany</li></ol>
Tērp|Tērper	<i>noun</i><br><ol><li>(Sylt) village</li></ol>
Ulv|Ulwer	<i>noun</i><br><ol><li>(Sylt) wolf</li></ol>
Uurt|Uurter	<i>noun</i><br><ol><li>(Sylt) word</li></ol>
Weeter	<i>noun</i><br><ol><li>(Sylt) water</li></ol>
aab|aaben	<i>noun</i><br><ol><li>(Föhr-Amrum) ape, monkey</li></ol>
aachst	<i>adj</i><br><ol><li>(Föhr-Amrum) eighth</li></ol>
aacht	<i>num</i><br><ol><li>(Föhr-Amrum, Sylt) eight</li></ol>
aagetanj	<i>num</i><br><ol><li>(Föhr-Amrum) eighteen</li></ol>
aapel|aapels|aapler	<i>noun</i><br><ol><li>(Föhr-Amrum) (Halligen) apple</li></ol>
aatj|aatjen	<i>noun</i><br><ol><li>(Föhr-Amrum) father</li></ol>
ach	<i>num</i><br><ol><li>(Heligoland) eight</li></ol>
adres|adresen	<i>noun</i><br><ol><li>(Föhr-Amrum) address</li></ol>
ai	<i>adv</i><br><ol><li>(Mooring) not</li></ol>
ailönj|ailönje	<i>noun</i><br><ol><li>(Mooring) island</li></ol>
alwen	<i>num</i><br><ol><li>(Mooring) eleven</li></ol>
april	<i>noun</i><br><ol><li>(Mooring and Föhr-Amrum) April</li></ol>
ark	<i>det</i><br><ol><li>(Mooring) each; every</li></ol>
august	<i>noun</i><br><ol><li>(Föhr-Amrum) August</li></ol>
baad|baaden	<i>noun</i><br><ol><li>(Föhr-Amrum) bed</li></ol>
baag|jam buch|wi buch|wi haa beegen|ik wal baag|jo skel baag|jat skel baag|ik haa beegen|hat|jo wel baag|jat haa beegen|jo hed beegen|beegen|jam hed beegen|jo haa beegen|baag'em|at beecht|dü beechst|hi|wat skel baag|jam wel baag|at wal baag|jo buch|jam skel baag|dü heest beegen|tu baagen|jat buch|jat hed beegen|at hed beegen|jat baag|wi hed beegen|at skal baag|wat buch|dü buchst|ik baag|wat haa beegen|ik hed beegen|dü wääl baag|jam baag|at buch|wi baag|wi wel baag|dü skääl baag|jat wel baag|wat hed beegen|wat baag|wat wel baag|jam haa beegen|ik buch|dü hedst beegen|ik skal baag|jo baag|wi skel baag|at hee beegen	<i>verb</i><br><ol><li>(Föhr-Amrum Dialect) to bake</li></ol>
baast	<i>verb</i><br><ol><li>(Föhr-Amrum) to burst</li></ol>
bage|wat bageden|ja hääwe baged|jü|et wårt bage|wat hääwe baged|jam wårde bage|ik wård bage|ja wårde bage|hi|et häi baged|we wårde bage|än bag|tu bagen|baged|jam häin baged|dü wårst bage|et baged|baget|we bageden|we hääwe baged|jat hääwe baged|jam bage|dü bagest|ja bageden|et bäget|dü hääst baged|ik baged|ik bag|jat bage|et heet baged|bag|wat häin baged|ja bage|ja häin baged|ik häi baged|jat häin baged|jat bageden|we häin baged|jam bageden|dü bagedst|dü häist baged|wat wårde bage|ik hääw baged|jam hääwe baged|wat bage|jat wårde bage|we bage	<i>verb</i><br><ol><li>(Mooring) to build</li></ol>
beed|beede	<i>noun</i><br><ol><li>(Mooring) bed</li></ol>
beeridmoune	<i>noun</i><br><ol><li>(Mooring) August</li></ol>
berig|berger	<i>noun</i><br><ol><li>(Föhr-Amrum) mountain</li></ol>
beskriiw|wat hed beskrewen|jam skel beskriiw|ik haa beskrewen|ik beskreew|at wal beskriiw|jam beskriiw|hat|wi beskriiw|dü hedst beskrewen|jat wel beskriiw|dü beskreewst|ik wal beskriiw|jat beskriiw|ik skal beskriiw|jo skel beskriiw|at hee beskrewen|hi|jam hed beskrewen|jo hed beskrewen|dü skääl beskriiw|at beskreew|ik beskriiw|tu beskriiwen|jat beskreew|wi beskreew|beskriiw'em|at hed beskrewen|wat skel beskriiw|wat beskriiw|wat haa beskrewen|wi hed beskrewen|jat haa beskrewen|jo haa beskrewen|jo beskriiw|wat beskreew|jat hed beskrewen|dü wääl beskriiw|beskrewen|at skal beskriiw|jam haa beskrewen|jo wel beskriiw|jo beskreew|wi haa beskrewen|wi skel beskriiw|dü beskrafst|wi wel beskriiw|jam beskreew|jam wel beskriiw|ik hed beskrewen|jat skel beskriiw|dü heest beskrewen|wat wel beskriiw|at beskraft	<i>verb</i><br><ol><li>(Föhr-Amrum) to describe</li></ol>
bi	<i>noun</i><br><ol><li>(Mooring) bee</li></ol>
biikenmoune	<i>noun</i><br><ol><li>(Mooring) February</li></ol>
biise	<i>det</i><br><ol><li>(Mooring) both</li></ol>
bin	<i>verb</i><br><ol><li>(Heligoland) to bind</li></ol>
bine|et bant|ja häin bünen|et häi bünen|jü|ik bün|dü häist bünen|wat wårde bine|wat bine|ja hääwe bünen|hi|dü bünst|jat wårde bine|jat bünen|tu binen|jat bine|et heet bünen|ja wårde bine|ik bin|bin|jat häin bünen|jam bine|bünen|we bine|et bün|et wårt bine|dü hääst bünen|we häin bünen|we bünen|ik häi bünen|jam bünen|jam wårde bine|ja bünen|dü banst|wat hääwe bünen|wat bünen|ja bine|we hääwe bünen|jam häin bünen|jam hääwe bünen|wat häin bünen|jat hääwe bünen|ik wård bine|dü wårst bine|än bin|ik hääw bünen|we wårde bine	<i>verb</i><br><ol><li>(Mooring) to bind</li></ol>
binj	<i>verb</i><br><ol><li>(Föhr-Amrum, Sylt) to bind</li></ol>
bister|bisterst|bisterer	<i>adj</i><br><ol><li>(Sylt) angry</li></ol>
bite	<i>verb</i><br><ol><li>(Halligen), (Mooring) To bite.</li></ol>
bitj	<i>verb</i><br><ol><li>(Föhr-Amrum) to bite</li></ol>
bjarn|bjarne	<i>noun</i><br><ol><li>(Mooring) child</li></ol>
blees	<i>noun</i><br><ol><li>(Mooring) newspaper</li></ol>
bliiw|tu bliiwen|jo wel bliiw|ik bliiw|wi bleew|ik skal bliiw|at bleew|hat|blewen|jam skel bliiw|wi bliiw|jo san blewen|jat wiar blewen|jat san blewen|hi|at wal bliiw|ik san blewen|wi wiar blewen|wat skel bliiw|jat bleew|jam wel bliiw|dü wääl bliiw|jam bliiw|wat bleew|dü skääl bliiw|dü bleefst|dü wiarst blewen|at wiar blewen|jam san blewen|jo bleew|jo wiar blewen|at skal bliiw|jat wel bliiw|jat skel bliiw|bliiw'em|wat bliiw|jat bliiw|jam bleew|wat wiar blewen|ik wal bliiw|dü beest blewen|dü blafst|at as blewen|wi skel bliiw|at blaft|ik wiar blewen|wi wel bliiw|jo bliiw|wat san blewen|ik bleew|jam wiar blewen|wat wel bliiw|jo skel bliiw|wi san blewen	<i>verb</i><br><ol><li>(Föhr-Amrum) to remain, to stay</li></ol>
bliwe|ja wjarn blaawen|än bliw|jam bliifen|ja bliifen|wat wjarn blaawen|jü|et wus blaawen|dü wårst bliwe|wat wårde bliwe|ja wårde bliwe|dü bliifst|jam san blaawen|et as blaawen|hi|jat bliwe|jam wjarn blaawen|we wårde bliwe|bliw|dü bast blaawen|wat bliwe|wat san blaawen|ik wård bliwe|jam bliwe|ik bliif|ja bliwe|ik ban blaawen|et bliif|jat wjarn blaawen|et blaft|jat san blaawen|ik wus blaawen|tu bliween|dü wjarst blaawen|we bliwe|dü blafst|jam wårde bliwe|wat bliifen|blaawen|jat bliifen|we wjarn blaawen|ik bliw|et wårt bliwe|we san blaawen|jat wårde bliwe|ja san blaawen|we bliifen	<i>verb</i><br><ol><li>(Mooring) to remain, stay</li></ol>
blä	<i>verb</i><br><ol><li>(Föhr-Amrum) to blow.</li></ol>
blädje	<i>verb</i><br><ol><li>(Mooring) to bleed</li></ol>
blö	<i>adj</i><br><ol><li>(Sylt) blue</li></ol>
blööm|blööme	<i>noun</i><br><ol><li>(Mooring) flower</li></ol>
bood|boode	<i>noun</i><br><ol><li>(Mooring) shop</li></ol>
booge|et wårt booge|ik boog|jü|et heet booged|booged|jat wårde booge|hi|jam booge|än boog|jam hääwe booged|we wårde booge|jam boogeden|et booged|ja booge|ik hääw booged|ik häi booged|jam wårde booge|wat boogeden|wat häin booged|we häin booged|jam häin booged|ja wårde booge|wat booge|dü hääst booged|tu boogen|et booget|ik booged|dü boogedst|dü wårst booge|we boogeden|wat hääwe booged|et häi booged|jat booge|jat boogeden|ja häin booged|wat wårde booge|we hääwe booged|jat häin booged|dü boogest|we booge|dü häist booged|ja hääwe booged|ja boogeden|ik wård booge|jat hääwe booged	<i>verb</i><br><ol><li>(Mooring) to dwell, to inhabit, to live</li></ol>
boosel|boosler	<i>noun</i><br><ol><li>(Föhr-Amrum) table</li></ol>
brag|bragen	<i>noun</i><br><ol><li>(Föhr-Amrum) bridge</li></ol>
breeg|breeg'em|at hed breegen|jo bruch|wat breeg|jo skel breeg|tu breegen|ik hed breegen|jam skel breeg|hat|wi hed breegen|breegen|jat haa breegen|dü bruchst|dü breechst|hi|jam hed breegen|jo hed breegen|wi skel breeg|dü skääl breeg|ik wal breeg|ik skal breeg|dü wääl breeg|wi haa breegen|wat wel breeg|wat bruch|dü hedst breegen|at breecht|at hee breegen|jo wel breeg|dü heest breegen|ik breeg|jat hed breegen|wi breeg|at skal breeg|jam haa breegen|at wal breeg|jat wel breeg|at bruch|jat breeg|jat bruch|wat hed breegen|wi wel breeg|ik bruch|jam bruch|wat haa breegen|jo haa breegen|wat skel breeg|wi bruch|jam wel breeg|jam breeg|jo breeg|jat skel breeg|ik haa breegen	<i>verb</i><br><ol><li>(Föhr-Amrum Dialect) to break</li></ol>
breege|jo skel breeg|jü|jam häin bräägen|jam breege|breegen|wat wårde breege|jam hed breegen|jat wårde breege|we bräken|ik skal breeg|wat wel breeg|jam bräken|wi breeg|ja wårde breege|wat hääwe bräägen|jat bruch|et bräk|jam bruch|dü wårst breege|jat bräken|jat breege|ik haa breegen|wat häin bräägen|ik häi bräägen|dü bräkst|jam skel breeg|hat|et heet bräägen|wi hed breegen|jam hääwe bräägen|hi|jo hed breegen|ja breege|dü skääl breeg|ik bräk|wi haa breegen|wat bruch|at breecht|at hee breegen|dü heest breegen|ik breeg|jat hääwe bräägen|at wal breeg|at bruch|wat hed breegen|ja bräken|wat haa breegen|wi bruch|we wårde breege|jat skel breeg|wat skel breeg|at hed breegen|jo bruch|tu breegen|ik hed breegen|jam wårde breege|et wårt breege|ik hääw bräägen|jat haa breegen|än breeg|dü häist bräägen|dü breechst|wi skel breeg|jat häin bräägen|ja hääwe bräägen|jo wel breeg|at skal breeg|jam haa breegen|wat bräken|jat breeg|dü hääst bräägen|ik bruch|jo haa breegen|bräägen|jam wel breeg|jo breeg|wat breege|breeg'em|wat breeg|dü bruchst|et häi bräägen|ik wal breeg|dü wääl breeg|dü hedst breegen|jat hed breegen|jat wel breeg|we breege|we hääwe bräägen|ja häin bräägen|ik wård breege|wi wel breeg|we häin bräägen|breeg|jam breeg|et breecht	<i>verb</i><br><ol><li>(Mooring), (Halligen) to break</li></ol>
breek	<i>verb</i><br><ol><li>(Heligoland), (Sylt) to break</li></ol>
briaf|briaw	<i>noun</i><br><ol><li>(Föhr-Amrum) letter (written message)</li></ol>
briange	<i>verb</i><br><ol><li>(Halligen) to bring</li></ol>
bring|jat bring|ik broocht|dü brangst|dü wääl bring|ik hed broocht|wi hed broocht|jat broocht|jo bring|jat skel bring|hat|at wal bring|jo skel bring|wat skel bring|jam haa broocht|jo wel bring|at hee broocht|jo haa broocht|wi bring|hi|wi broocht|jam broocht|dü heest broocht|jat hed broocht|jat wel bring|wi wel bring|dü skääl bring|ik skal bring|at skal bring|wat bring|jo broocht|bring'em|at brangt|ik haa broocht|wi skel bring|jam wel bring|ik bring|at hed broocht|jam hed broocht|wat broocht|jo hed broocht|wat wel bring|tu bringen|jam bring|dü hedst broocht|broocht|dü broochst|wat haa broocht|wat hed broocht|at broocht|jam skel bring|ik wal bring|wi haa broocht|jat haa broocht	<i>verb</i><br><ol><li>(Föhr-Amrum), (Heligoland) to bring</li></ol>
brouder|brouderne	<i>noun</i><br><ol><li>(Mooring) brother</li></ol>
bruler|breler	<i>noun</i><br><ol><li>(Föhr dialect) brother</li></ol>
bräif	<i>noun</i><br><ol><li>(Mooring) letter (written message)</li></ol>
bränge	<i>verb</i><br><ol><li>(Mooring) to bring</li></ol>
brün	<i>adj</i><br><ol><li>(Sylt) brown</li></ol>
brüüdj	<i>noun</i><br><ol><li>(Mooring) bread</li></ol>
buan|buanen	<i>noun</i><br><ol><li>(Föhr-Amrum) bean</li></ol>
buk|buken	<i>noun</i><br><ol><li>(Föhr-Amrum) book</li></ol>
buum|buume|buumer	<i>noun</i><br><ol><li>(Mooring and Föhr-Amrum) tree</li></ol>
bärj	<i>noun</i><br><ol><li>(Mooring) mountain</li></ol>
bååge|jat bååge|dü häist båågen|ik wård bååge|ja båågeden|bååg|ja bååge|jü|ik bååged|ik häi båågen|we häin båågen|wat häin båågen|et heet båågen|jat häin båågen|et wårt bååge|we hääwe båågen|ja wårde bååge|hi|bökst|et bååget|ja hääwe båågen|tu båågen|wat båågeden|jam båågeden|båågen|wat wårde bååge|än bååg|et bååged|dü båågedst|jam bååge|dü båågest|dü hääst båågen|wat hääwe båågen|jam hääwe båågen|ik hääw båågen|jat wårde bååge|ja häin båågen|böken|we wårde bååge|wat bååge|jam häin båågen|bök|we bååge|we båågeden|jat hääwe båågen|dü wårst bååge|jam wårde bååge|jat båågeden|ik bååg|et häi båågen	<i>verb</i><br><ol><li>(Mooring) to bake</li></ol>
bök|böke	<i>noun</i><br><ol><li>(Mooring dialect) book</li></ol>
böre	<i>noun</i><br><ol><li>(Mooring) farmer</li></ol>
bööder	<i>noun</i><br><ol><li>(Mooring) butter</li></ol>
da	<i>article</i><br><ol><li>the (plural)</li></ol>
dai|daar	<i>noun</i><br><ol><li>(Föhr-Amrum) day</li></ol>
dan|din	<i>pron</i><br><ol><li>(Föhr-Amrum) your</li></ol>
deetsember	<i>noun</i><br><ol><li>(Föhr-Amrum) December</li></ol>
deling	<i>adv</i><br><ol><li>(Sylt) today</li></ol>
di	<i>article</i><br><ol><li>the (masculine singular)</li><li>the (common singular) (Sylt)</li></ol><br><i>pron</i><br><ol><li>you, thou (familiar object singular)</li></ol>
dii	<i>noun</i><br><ol><li>(Föhr-Amrum) dough</li></ol>
diling	<i>noun</i><br><ol><li>today</li></ol><br><i>adv</i><br><ol><li>today</li></ol>
dit	<i>article</i><br><ol><li>(Sylt) the (definite article for singular neuter nouns)</li></ol>
djo	<i>pron</i><br><ol><li>(Heligoland) they</li></ol>
doochter|doochtern	<i>noun</i><br><ol><li>(Föhr-Amrum, Mooring) daughter</li></ol>
drainke|dü drainkst|jam drainke|ik drunk|ja häin drunken|jü|draink|ik draink|we häin drunken|et heet drunken|ik häi drunken|jat wårde drainke|et drainkt|dü häist drunken|än draink|we wårde drainke|we drunken|hi|ja wårde drainke|ja drunken|wat drainke|jam häin drunken|et wårt drainke|dü drunkst|et häi drunken|wat hääwe drunken|et drunk|jam wårde drainke|wat wårde drainke|jat häin drunken|dü wårst drainke|wat drunken|we drainke|jat drunken|ik wård drainke|jam drunken|wat häin drunken|ik hääw drunken|we hääwe drunken|tu drainken|dü hääst drunken|ja hääwe drunken|jat hääwe drunken|drunken|jat drainke|ja drainke|jam hääwe drunken	<i>verb</i><br><ol><li>(Mooring) to drink</li></ol>
drank|at hed dronken|wat skel drank|jam skel drank|wat haa dronken|ik wal drank|jam wel drank|at droonk|jat drank|hat|jat droonk|dü hedst dronken|jam haa dronken|at drankt|dü skääl drank|jat haa dronken|dü heest dronken|ik haa dronken|tu dranken|wi droonk|hi|jat skel drank|ik skal drank|wat drank|jo wel drank|drank'em|jo drank|wi wel drank|wat wel drank|wi drank|jam drank|wi skel drank|wat droonk|ik hed dronken|at skal drank|at wal drank|jat wel drank|jam hed dronken|jam droonk|jo hed dronken|dronken|at hee dronken|dü wääl drank|jo skel drank|dü droonkst|wi haa dronken|jo haa dronken|ik droonk|wat hed dronken|dü drankst|wi hed dronken|ik drank|jat hed dronken|jo droonk	<i>verb</i><br><ol><li>(Föhr-Amrum) to drink</li></ol>
dreeg|wi druch|ik skal dreeg|wat hed draanjen|at wal dreeg|dü draist|hat|ik dreeg|dü hedst draanjen|jat haa draanjen|wi haa draanjen|jo skel dreeg|ik haa draanjen|jat dreeg|hi|wat skel dreeg|ik hed draanjen|jat hed draanjen|wi hed draanjen|at hed draanjen|jam haa draanjen|jat wel dreeg|wi skel dreeg|at druch|wat dreeg|at skal dreeg|jo dreeg|jo haa draanjen|dü druchst|wat druch|jam druch|at hee draanjen|dreeg'em|at drait|tu dreegen|jam dreeg|dü wääl dreeg|jam skel dreeg|wat haa draanjen|jo wel dreeg|dü heest draanjen|ik wal dreeg|dü skääl dreeg|jat druch|wat wel dreeg|wi dreeg|jo druch|jam hed draanjen|jat skel dreeg|ik druch|jo hed draanjen|jam wel dreeg|draanjen|wi wel dreeg	<i>verb</i><br><ol><li>(Föhr-Amrum) to carry</li><li>(Föhr-Amrum) to wear</li></ol>
dreege|wi druch|wat hed draanjen|jü|ik häi dräägen|jat haa draanjen|ik hed draanjen|jat wel dreeg|at skal dreeg|jo dreeg|ik hääw dräägen|wat druch|jam dreege|ja häin dräägen|wat hääwe dräägen|we dröichen|ik wal dreeg|jat dreege|dü skääl dreeg|wat wel dreeg|et wårt dreege|et dreecht|jam hed draanjen|we wårde dreege|än dreeg|hat|dü hedst draanjen|we hääwe dräägen|jo skel dreeg|hi|dräägen|et häi dräägen|wi skel dreeg|we häin dräägen|wat dreeg|jam dröichen|at hee draanjen|tu dreegen|wat wårde dreege|dü heest draanjen|dü dröichst|jat wårde dreege|jat druch|wi dreeg|jo hed draanjen|jam wel dreeg|ja hääwe dräägen|draanjen|et heet dräägen|ja dreege|at wal dreeg|jat hääwe dräägen|jam wårde dreege|ik haa draanjen|jat dröichen|wat skel dreeg|wi hed draanjen|jam haa draanjen|at druch|wat häin dräägen|wat dröichen|jam häin dräägen|dü druchst|jam druch|dreeg'em|jam dreeg|wat haa draanjen|dü häist dräägen|we dreege|jo druch|ik wård dreege|dü wårst dreege|wat dreege|ik skal dreeg|dü draist|dü hääst dräägen|jam hääwe dräägen|ik dreeg|jat häin dräägen|ja dröichen|wi haa draanjen|dü dreechst|jat dreeg|jat hed draanjen|at hed draanjen|ik dröich|jo haa draanjen|at drait|dü wääl dreeg|jam skel dreeg|et dröich|jo wel dreeg|ja wårde dreege|dreeg|jat skel dreeg|ik druch|wi wel dreeg	<i>verb</i><br><ol><li>(Mooring) to carry</li><li>(Mooring) to wear</li></ol>
dring|dringer	<i>noun</i><br><ol><li>(Föhr-Amrum) boy, son</li></ol>
drinke	<i>verb</i><br><ol><li>(Halligen) to drink</li></ol>
dräng|dränge	<i>noun</i><br><ol><li>(Mooring) boy</li></ol>
du|at hee den|jo ded|jam hed den|dü deest|at hed den|dü hedst den|diadst|wi hed den|hat|jam ded|at wal du|jo haa den|dü wääl du|wi wel du|den|jat haa den|ik hed den|jam skel du|jo hed den|jat skel du|jo skel du|hi|dü dedst|jam du|wat ded|ik skal du|at dee|wat du|diad|ik ded|dü skääl du|du'em|ik haa den|wi skel du|ik wal du|jo du|jam haa den|wi ded|wat wel du|wat haa den|ik du|jat hed den|jat du|jo wel du|jat ded|at ded|wi du|wi haa den|dü heest den|jat wel du|jam wel du|at skal du|wat hed den|wat skel du|tu duen	<i>verb</i><br><ol><li>(Föhr-Amrum) to do</li><li>(Föhr-Amrum) to give</li></ol>
duuf|duufst|duuwer	<i>adj</i><br><ol><li>(Mooring and Föhr-Amrum dialects) deaf</li></ol>
däi|deege	<i>noun</i><br><ol><li>(Mooring) day</li></ol>
dåt	<i>article</i><br><ol><li>(Mooring) the (singular neuter)</li></ol>
dör|dören	<i>noun</i><br><ol><li>(Föhr-Amrum) door</li></ol>
dörnsch|dörnsche	<i>noun</i><br><ol><li>(Mooring) room; chamber</li></ol>
dörnsk|dörnsker	<i>noun</i><br><ol><li>(Föhr-Amrum) room</li></ol>
dörtig	<i>num</i><br><ol><li>(Föhr-Amrum, Sylt) thirty</li></ol>
döör|dööre	<i>noun</i><br><ol><li>(Mooring, Sylt) door</li></ol>
dü	<i>pron</i><br><ol><li>thou, you</li></ol>
düünj|wat häin dänj|jat däin|jat häin dänj|jü|ja däin|ik wård düünj|jam häin dänj|et däi|ja hääwe dänj|jam wårde düünj|we düünj|dü däist|ik häi dänj|et wårt düünj|hi|et häi dänj|ja häin dänj|we hääwe dänj|ik hääw dänj|dü häist dänj|ja wårde düünj|ik dou|ja düünj|jat wårde düünj|we däin|dou|än dou|dü hääst dänj|we wårde düünj|wat däin|ik däi|dü wårst düünj|jam däin|jat hääwe dänj|wat düünj|jam düünj|wat hääwe dänj|jam hääwe dänj|wat wårde düünj|et deet|tu douen|et heet dänj|we häin dänj|dü dääst|jat düünj|dänj	<i>verb</i><br><ol><li>(Mooring) to do</li></ol>
düüwel|düüwler	<i>noun</i><br><ol><li>(Mooring and Föhr-Amrum dialects) devil</li></ol>
eelemböög|eelembööger	<i>noun</i><br><ol><li>(Föhr dialect) elbow</li></ol>
een|or n. ian	<i>num</i><br><ol><li>(Föhr-Amrum) one</li></ol>
eerm|eerme	<i>noun</i><br><ol><li>(Halligen) (anatomy) arm</li></ol>
eeđer|jer|jest	<i>adj</i><br><ol><li>(Sylt) early</li></ol>
eilun|eilunen	<i>noun</i><br><ol><li>(Föhr-Amrum) island</li></ol>
ek	<i>adv</i><br><ol><li>(Sylt) not</li></ol>
elwen	<i>num</i><br><ol><li>(Föhr-Amrum) eleven</li></ol>
faal|jo skel faal|wat san feelen|jam wiar feelen|faal'em|jat san feelen|jam skel faal|hat|dü wiarst feelen|jo fool|dü skääl faal|jo faal|ik wiar feelen|at as feelen|wat fool|dü beest feelen|dü foolst|wat skel faal|hi|wi san feelen|ik san feelen|jat fool|jam wel faal|wi faal|jam san feelen|wi wiar feelen|at fool|ik wal faal|wat wiar feelen|jam faal|jo san feelen|jam fool|dü wääl faal|jo wel faal|ik fool|wi fool|tu faalen|at wal faal|wi skel faal|wi wel faal|at skal faal|feelen|dü fäälst|jat skel faal|ik faal|wat wel faal|at fäält|wat faal|at wiar feelen|jo wiar feelen|ik skal faal|jat wel faal|jat faal|jat wiar feelen	<i>verb</i><br><ol><li>(Föhr-Amrum) to fall</li></ol>
fanger|fangern	<i>noun</i><br><ol><li>(Föhr-Amrum) (anatomy) finger</li></ol>
fask|fasker	<i>noun</i><br><ol><li>(Föhr-Amrum) fish</li></ol>
febrewoore	<i>noun</i><br><ol><li>(Föhr-Amrum) February</li></ol>
feel	<i>verb</i><br><ol><li>(Föhr-Amrum) to feel</li></ol>
ferjeese|dü häist ferjin|jam häin ferjin|jü|forjeese|we wårde forjeese|et wårt forjeese|ferjin|jat hääwe ferjin|ik wård forjeese|ja ferjeese|et häi ferjin|dü ferjätjst|ik ferjees|hi|wat häin ferjin|jam wårde forjeese|jam ferjätjen|wat ferjeese|jat ferjeese|ja ferjätjen|tu forjeesen|än forjees|we ferjätjen|ik ferjätj|jat häin ferjin|ja hääwe ferjin|ja wårde forjeese|we hääwe ferjin|dü hääst ferjin|wat ferjätjen|dü ferjeest|we häin ferjin|ferjees|jam hääwe ferjin|et heet ferjin|ik häi ferjin|et ferjätj|jat wårde forjeese|ik hääw ferjin|ja häin ferjin|wat wårde forjeese|dü wårst forjeese|we ferjeese|et ferjeet|jam ferjeese|wat hääwe ferjin|jat ferjätjen	<i>verb</i><br><ol><li>(Mooring) to forget</li></ol>
ferjid	<i>verb</i><br><ol><li>(Föhr-Amrum) to forget</li></ol>
ferkuupe|dü ferkeefst|wat ferkuupe|at ferkeeft|jat wel ferkuupe|wi wel ferkuupe|ik skal ferkuupe|ferkuup'em|ik ferkeeft|dü wääl ferkuupe|hat|jo hed ferkeeft|at hed ferkeeft|ferkeeft|jat ferkuupe|ik ferkuup|hi|wat haa ferkeeft|wi ferkeeft|at wal ferkuupe|wi haa ferkeeft|jo skel ferkuupe|wi ferkuupe|jam ferkeeft|jo ferkeeft|dü hedst ferkeeft|at hee ferkeeft|jat haa ferkeeft|at skal ferkuupe|wat skel ferkuupe|ik haa ferkeeft|ik wal ferkuupe|jo ferkuupe|jam ferkuupe|wat ferkeeft|wi hed ferkeeft|jam hed ferkeeft|wat wel ferkuupe|dü skääl ferkuupe|jat hed ferkeeft|jam haa ferkeeft|ik hed ferkeeft|jo haa ferkeeft|jat ferkeeft|dü heest ferkeeft|jat skel ferkuupe|jo wel ferkuupe|wat hed ferkeeft|jam skel ferkuupe|jam wel ferkuupe|wi skel ferkuupe|tu ferkuupin	<i>verb</i><br><ol><li>(Föhr-Amrum) to sell</li></ol>
ferlees	<i>verb</i><br><ol><li>(Föhr-Amrum) to lose</li></ol>
ferliise|wat ferliise|et wårt ferliise|ja ferliise|we wårde ferliise|dü häist ferlääsen|jü|ja wårde ferliise|jam ferlüüsen|jat häin ferlääsen|dü wårst ferliise|än ferliis|jam ferliise|ik häi ferlääsen|jat wårde ferliise|dü hääst ferlääsen|wat häin ferlääsen|et heet ferlääsen|hi|et häi ferlääsen|et ferlüüs|we ferliise|tu ferliisen|we hääwe ferlääsen|ferlääsen|ik hääw ferlääsen|jat hääwe ferlääsen|wat ferlüüsen|et ferlüst|ja hääwe ferlääsen|dü ferlüst|jat ferlüüsen|jat ferliise|dü ferlüüst|jam häin ferlääsen|ja häin ferlääsen|wat wårde ferliise|ferliis|ik ferliise|ja ferlüüsen|ik ferlüüs|we ferlüüsen|we häin ferlääsen|jam hääwe ferlääsen|wat hääwe ferlääsen|jam wårde ferliise|ik wård ferliise	<i>verb</i><br><ol><li>(Mooring) to lose</li></ol>
ferteele|we ferteele|ja ferteele|we häin ferteeld|wat wårde ferteele|jam wårde ferteele|ik ferteel|jü|we ferteelden|ik häi ferteeld|dü hääst ferteeld|et heet ferteeld|jat hääwe ferteeld|jam hääwe ferteeld|et ferteelt|jat wårde ferteele|ferteel|hi|ferteeld|tu ferteelen|et ferteeld|dü ferteeldst|ja wårde ferteele|än ferteel|jam ferteelden|et häi ferteeld|jat ferteele|ja häin ferteeld|jam ferteele|wat ferteele|ja ferteelden|wat hääwe ferteeld|jat häin ferteeld|we wårde ferteele|et wårt ferteele|jam häin ferteeld|dü wårst ferteele|wat ferteelden|ik wård ferteele|dü ferteelst|jat ferteelden|wat häin ferteeld|ik hääw ferteeld|we hääwe ferteeld|dü häist ferteeld|ik ferteeld|ja hääwe ferteeld	<i>verb</i><br><ol><li>(Mooring) to tell</li></ol>
fial|fialen	<i>noun</i><br><ol><li>(Föhr-Amrum) field</li></ol>
fiartig	<i>num</i><br><ol><li>(Föhr-Amrum) forty</li></ol>
fif	<i>num</i><br><ol><li>(Sylt) five</li></ol>
fiirense	<i>noun</i><br><ol><li>distance</li></ol>
fiirsiien	<i>noun</i><br><ol><li>(Mooring) television</li></ol>
fiiw	<i>num</i><br><ol><li>(Mooring, Föhr-Amrum) five</li></ol>
fine|jam wårde fine|dü fünst|ik hääw fünen|we wårde fine|ja häin fünen|jü|dü häist fünen|jat fünen|ik fin|jam hääwe fünen|jat fine|wat wårde fine|dü hääst fünen|we fine|än fine|we häin fünen|fin|et fün|hi|wat fünen|jam häin fünen|jat häin fünen|ja hääwe fünen|ik wård fine|wat hääwe fünen|we hääwe fünen|jam fünen|dü fanst|tu finen|dü wårst fine|wat fine|et heet fünen|ik häi fünen|et häi fünen|ja fünen|wat häin fünen|et wårt fine|jat wårde fine|we fünen|jat hääwe fünen|ik fün|fünen|jam fine|et fant|ja wårde fine|ja fine	<i>verb</i><br><ol><li>(Mooring) to find</li></ol>
finj	<i>verb</i><br><ol><li>(Föhr-Amrum) to find</li></ol>
fiuw	<i>num</i><br><ol><li>(Heligoland) five</li></ol>
fjauer	<i>num</i><br><ol><li>(Föhr-Amrum) four</li></ol>
fjauertanj	<i>num</i><br><ol><li>(Föhr-Amrum) fourteen</li></ol>
fjouer	<i>num</i><br><ol><li>(Mooring) four</li></ol>
fjuard	<i>adj</i><br><ol><li>(Föhr-Amrum) fourth</li></ol>
fjuur	<i>num</i><br><ol><li>(Sylt) four</li></ol>
flicht	<i>adv</i><br><ol><li>maybe</li></ol>
fliinj	<i>verb</i><br><ol><li>(Mooring) to fly</li></ol>
flä	<i>verb</i><br><ol><li>(Föhr-Amrum) to fly</li></ol>
flååsch	<i>noun</i><br><ol><li>(Mooring) meat</li></ol>
foodermoune	<i>noun</i><br><ol><li>(Mooring) July</li></ol>
foomen|foomnen	<i>noun</i><br><ol><li>(Mooring, Föhr-Amrum) girl, daughter</li></ol>
foon	<i>prep</i><br><ol><li>from</li><li>of</li></ol>
fraage|wi wel fraage|wi fraaget|ik fraage|ik haa fraaget|wat fraaget|ik wal fraage|jam wel fraage|dü skääl fraage|dü heest fraaget|hat|jat hed fraaget|jat fraage|wi haa fraaget|jo wel fraage|dü hedst fraaget|hi|jo fraage|ik fraaget|wat skel fraage|dü fraagest|wat wel fraage|jat wel fraage|wat hed fraaget|jam haa fraaget|jat skel fraage|fraagi'm|wi skel fraage|dü wääl fraage|at hee fraaget|tu fraagin|jam fraaget|jat haa fraaget|wi fraage|jo fraaget|jo hed fraaget|jam hed fraaget|jam fraage|jat fraaget|at hed fraaget|ik hed fraaget|wat haa fraaget|wi hed fraaget|ik skal fraage|wat fraage|at wal fraage|at fraaget|at skal fraage|jam skel fraage|jo skel fraage|jo haa fraaget|fraaget	<i>verb</i><br><ol><li>(Föhr-Amrum) to ask</li></ol>
fraagi|fraagest|fraaget	<i>verb</i><br><ol><li>(Sylt) to ask</li></ol>
frasch	<i>adj</i><br><ol><li>(Mooring) Frisian (of or relating to the Frisian language generally)</li><li>(Mooring) Frisian (of or relating to the natives or inhabitants of Frisia, or to people of Frisian descent)</li><li>(Mooring) Frisian (of or relating to the region of Frisia)</li></ol>
freege	<i>verb</i><br><ol><li>(Halligen) to ask</li></ol>
freese	<i>noun</i><br><ol><li>(Mooring) peace</li></ol>
fresk	<i>adj</i><br><ol><li>(Föhr-Amrum) Frisian (of or relating to the Frisian language generally)</li><li>(Föhr-Amrum) Frisian (of or relating to the natives or inhabitants of Frisia, or to people of Frisian descent)</li><li>(Föhr-Amrum) Frisian (of or relating to the region of Frisia)</li></ol>
friis	<i>verb</i><br><ol><li>(Föhr-Amrum) to freeze</li></ol>
frinj|frinjer	<i>noun</i><br><ol><li>(Föhr-Amrum) friend</li></ol>
froage	<i>verb</i><br><ol><li>(Heligoland) to ask</li></ol>
frååge|et häi frååged|dü hääst frååged|wat häin frååged|tu fråågen|dü wårst frååge|dü häist frååged|we frååge|jü|jam fråågeden|jat wårde frååge|jat häin frååged|et frååged|ik häi frååged|wat frååge|ja frååge|hi|ja fråågeden|et heet frååged|wat hääwe frååged|än frååg|et wårt frååge|ik frååged|ja häin frååged|we häin frååged|ik frååg|et frååget|we wårde frååge|jat frååge|frååg|we fråågeden|jam wårde frååge|dü fråågedst|jat fråågeden|we hääwe frååged|wat fråågeden|dü fråågest|ik hääw frååged|jam frååge|jam häin frååged|ik wård frååge|jam hääwe frååged|ja hääwe frååged|frååged|jat hääwe frååged|ja wårde frååge|wat wårde frååge	<i>verb</i><br><ol><li>(Mooring) to ask</li></ol>
frün|früne	<i>noun</i><br><ol><li>(Mooring) friend</li></ol>
fu|at skal fu|jam hed fingen|fingen|at fing|wat skel fu|jo wel fu|wi fu|dü fingst|hat|jat fu|jo fu|jam fu|ik haa fingen|jo hed fingen|jat fing|wi wel fu|jam fing|dü wääl fu|at feit|jat hed fingen|wat wel fu|dü feist|hi|ik fing|jo skel fu|jo fing|ik skal fu|at hed fingen|at wal fu|jat skel fu|at hee fingen|jo haa fingen|wat fing|dü hedst fingen|jat haa fingen|dü heest fingen|jam haa fingen|feest|fee|wi skel fu|tu fuen|wat hed fingen|ik wal fu|dü skääl fu|wat fu|ik fu|jam skel fu|wi haa fingen|jat wel fu|jam wel fu|wi hed fingen|ik hed fingen|wi fing|wat haa fingen|fu'm	<i>verb</i><br><ol><li>(Föhr-Amrum) to get, obtain, receive</li></ol>
fut|fet	<i>noun</i><br><ol><li>(Föhr-Amrum, anatomy) foot</li></ol>
fälj	<i>noun</i><br><ol><li>(Mooring) field</li></ol>
fåle	<i>verb</i><br><ol><li>(Mooring) to fall</li></ol>
fögel	<i>noun</i><br><ol><li>(Föhr-Amrum) bird</li></ol>
fötj|fätj	<i>noun</i><br><ol><li>(Mooring, anatomy) foot</li></ol>
füft	<i>adj</i><br><ol><li>(Föhr-Amrum) fifth</li></ol>
füftanj	<i>num</i><br><ol><li>(Föhr-Amrum) fifteen</li></ol>
füünj	<i>verb</i><br><ol><li>(Mooring) to get, obtain, receive</li></ol>
geek	<i>noun</i><br><ol><li>(Mooring) fool</li></ol>
gjarsmoune	<i>noun</i><br><ol><li>(Mooring) April</li></ol>
goobel|gooble (Mooring dialect) \|or\|goobler	<i>noun</i><br><ol><li>(Mooring and Föhr-Amrum dialects) fork</li></ol>
grat|gratst|grater	<i>adj</i><br><ol><li>(Föhr-Amrum) big, great, large.</li><li>(Föhr-Amrum) tall</li></ol>
gre	<i>adj</i><br><ol><li>(Sylt) grey</li></ol>
green	<i>adj</i><br><ol><li>(Föhr-Amrum, Sylt) green</li></ol>
greew|dü skääl greew|jam skel greew|dü wääl greew|dü greefst|jo haa greewen|jat greew|wat hed greewen|wat skel greew|jat gruf|hat|at skal greew|ik wal greew|wi greew|wat gruf|dü heest greewen|at wal greew|at greeft|hi|jam gruf|at hee greewen|wi wel greew|greew'em|jat wel greew|at gruf|wat greew|jo hed greewen|jam haa greewen|ik haa greewen|ik skal greew|wi hed greewen|wat wel greew|jo skel greew|jam hed greewen|greewen|jo gruf|wi skel greew|jam greew|ik greew|wat haa greewen|tu greewen|at hed greewen|jo wel greew|jam wel greew|jat skel greew|wi haa greewen|wi gruf|ik hed greewen|jo greew|dü grufst|dü hedst greewen|ik gruf|jat haa greewen|jat hed greewen	<i>verb</i><br><ol><li>(Föhr-Amrum Dialect) to dig</li></ol>
greewe|jat hääwe grääwen|jo haa greewen|jü|at greeft|wat hääwe grääwen|we hääwe grääwen|at hee greewen|jam gröifen|ja greewe|wi skel greew|ja häin grääwen|jam greew|wat haa greewen|ja hääwe grääwen|jam wel greew|ik hääw grääwen|dü wårst greewe|grääwen|wi gruf|jo greew|ik gruf|wi hed greewen|dü wääl greew|ik wård greewe|wat skel greew|jat gruf|hat|ik wal greew|jat wårde greewe|hi|jat häin grääwen|ik häi grääwen|jat wel greew|dü gröifst|we greewe|ik gröif|jam haa greewen|ik haa greewen|ik skal greew|jo gruf|we häin grääwen|än greew|jo wel greew|wi haa greewen|jam häin grääwen|jam wårde greewe|ja gröifen|wat gröifen|dü greefst|wat hed greewen|et greeft|ja wårde greewe|at skal greew|wi greew|wat gruf|dü heest greewen|at wal greew|jam gruf|greew'em|dü häist grääwen|jam hääwe grääwen|wat greewe|jat gröifen|wat wel greew|jam greewe|tu greewen|at hed greewen|we wårde greewe|wat wårde greewe|jat skel greew|ik hed greewen|we gröifen|jat haa greewen|jat hed greewen|dü skääl greew|wat häin grääwen|jam skel greew|jat greew|et wårt greewe|greew|wi wel greew|jat greewe|at gruf|wat greew|jo hed greewen|et häi grääwen|jo skel greew|jam hed greewen|greewen|et heet grääwen|ik greew|dü grufst|dü hedst greewen|et gröif|dü hääst grääwen	<i>verb</i><br><ol><li>(Mooring) to dig</li></ol>
gripe|än grip|jat bååge|jat griipen|ja wårde gripe|jat hääwe gram|ja bååge|jü|gram|tu gripen|we griipen|jam häin gram|et griip|ik griip|et grapt|hi|et wårt gripe|dü griipst|jam hääwe gram|dü grapst|wat hääwe gram|jam bååge|et häi gram|we hääwe gram|ja hääwe gram|ik wård gripe|jat wårde gripe|ja griipen|we wårde gripe|grip|ik häi gram|dü hääst gram|wat häin gram|wat bååge|dü wårst gripe|wat wårde gripe|we bååge|jat häin gram|wat griipen|jam wårde gripe|ik grip|dü häist gram|we häin gram|ja häin gram|jam griipen|ik hääw gram|et heet gram	<i>verb</i><br><ol><li>(Mooring) to grab, seize</li></ol>
grut|grutst|gruter	<i>adj</i><br><ol><li>(Mooring) big, large</li></ol>
gul	<i>noun</i><br><ol><li>(Föhr-Amrum) gold</li></ol>
gunge|jam san gängen|jat gängen|jü|we gängen|än gung|wat gängen|we gunge|ja gunge|jam gunge|dü bast gängen|we san gängen|hi|we wjarn gängen|gung|wat wjarn gängen|wat san gängen|tu gungen|wat gunge|ja san gängen|jat wjarn gängen|ja gängen|ik gung|dü gungst|dü gängst|et wårt gunge|et as gängen|jam wjarn gängen|et gungt|et gäng|ja wjarn gängen|jat wårde gunge|ik wus gängen|we wårde gunge|jat gunge|jat san gängen|dü wårst gunge|ja wårde gunge|et wus gängen|jam wårde gunge|dü wjarst gängen|jam gängen|ik gäng|gängen|ik ban gängen|ik wård gunge|wat wårde gunge	<i>verb</i><br><ol><li>(Mooring) to go</li></ol>
gur|beeter|beest	<i>adj</i><br><ol><li>(Sylt) good</li></ol>
gäärshoper	<i>noun</i><br><ol><li>grasshopper</li></ol>
gödj|bääder|beest	<i>adj</i><br><ol><li>(Mooring) good</li></ol>
gööl	<i>adj</i><br><ol><li>(Mooring) yellow</li></ol>
güül	<i>adj</i><br><ol><li>(Sylt, Föhr, Wiedingharde) yellow</li></ol>
haa|tu haaen|jat wel haa|jo wel haa|wi skel haa|jo hed|jat haa hed|dü skääl haa|wat wel haa|jat haa|hat|jam haa hed|wi hed hed|jo haa hed|at hed hed|jo haa|jat skel haa|ik skal haa|wat hed hed|jat hed hed|hi|jam hed|wat hed|dü hedst hed|jo hed hed|at skal haa|at wal haa|jo skel haa|jam hed hed|ik wal haa|wi hed|hed|ik hed hed|at hee hed|wi haa hed|wat skel haa|wi wel haa|wat haa|jam haa|wat haa hed|haa'm|wi haa|dü wääl haa|at hed|dü heest|ik haa hed|dü heest hed|jam wel haa|at hee|jam skel haa|dü hed|ik haa|ik hed|jat hed	<i>verb</i><br><ol><li>(Föhr-Amrum, Sylt) to have</li></ol>
haiel|hailer	<i>noun</i><br><ol><li>(Föhr-Amrum) heel</li></ol>
halep	<i>verb</i><br><ol><li>(Föhr-Amrum) to help</li></ol>
ham	<i>pron</i><br><ol><li>him third-person singular, masculine, objective</li><li>it third-person singular, neuter, objective</li></ol>
harfst	<i>noun</i><br><ol><li>(Mooring) autumn, fall</li></ol>
hart|harten	<i>noun</i><br><ol><li>(Mooring and Föhr-Amrum dialects) heart</li></ol>
hat	<i>pron</i><br><ol><li>it</li></ol>
heelpe|dü hülpst|ik häi hülpen|dü häist hülpen|jat hääwe hülpen|et heelpt|wat hääwe hülpen|jat wårde heelpe|heelp|wat hülpen|jü|we häin hülpen|ik hülp|jam hülpen|hülpen|we hääwe hülpen|dü wårst heelpe|jam wårde heelpe|jat hülpen|we wårde heelpe|hi|jam häin hülpen|wat heelpe|tu heelpen|dü heelpst|et häi hülpen|ik wård heelpe|än heelp|ik heelp|jat heelpe|ja heelpe|wat wårde heelpe|ik hääw hülpen|ja häin hülpen|et heet hülpen|et hülp|jam hääwe hülpen|ja wårde heelpe|wat häin hülpen|we hülpen|ja hääwe hülpen|jat häin hülpen|jam heelpe|et wårt heelpe|we heelpe|dü hääst hülpen|ja hülpen	<i>verb</i><br><ol><li>(Mooring) to help</li></ol>
heewe|jü|jam heen|dat heet heet|jä win heewe|ik hääw hädj|jat wårde heewe|jat häin|wii heen heet|jam hääwe hädj|jat hääwe|jam häin hädj|du hääst|tu heewen|ik hääw heet|we häin|jat häin hädj|jam schin heewe|dat schal heewe|jam häin|jam heen heet|ja häin hädj|et heet|wat hääwe hädj|wat hääwe|jam hääwe|du schääl|schäät heewe|wii hääw|dü hääst hädj|dat hee|hi|et häi|to heewen|du wääl|jam win heewe|dat heet|dü wårst heewe|ja häin|jä schin heewe|et wårt heewe|et heet hädj|ja hääwe|ja hääwe hädj|jat hääwe hädj|we häin hädj|wii hääw heet|wii schin heewe|wat häin|ik wal heewe|ik wård heewe|wat häin hädj|we hääwe hädj|wat wårde heewe|jam hääw|jam wårde heewe|hädj|ik hee|we hääwe|ik hee heet|ik häi hädj|jä hääw heet|et häi hädj|heet|heew|we wårde heewe|hääw|än heew|dat hee heet|ja wårde heewe|wii heen|ik schal heewe|wii win heewe|dü hääst|ik häi|du heest heet|jä heen|dat wal heewe|dü häist|jä heen heet|wäät heewe|du heest|ju|ik hääw|hii|dü häist hädj|jam hääw heet|du hääst heet|jä hääw	<i>verb</i><br><ol><li>(Mooring) (Halligen) to have</li></ol>
her	<i>pron</i><br><ol><li>her: third-person singular, feminine, objective</li><li>her: third-person singular, feminine, possesive</li></ol>
hi|he	<i>pron</i><br><ol><li>he</li></ol>
hiire|ja wårde hiire|tu hiiren|jat hiirden|jü|we hääwe hiird|wat wårde hiire|we wårde hiire|ik hääw hiird|dü wårst hiire|jat häin hiird|we hiirden|we häin hiird|jat hiire|wat häin hiird|hi|wat hiire|ik wård hiire|ik hiird|et hiirt|ja hiire|ik häi hiird|än hiir|jat hääwe hiird|dü hiirst|dü hääst hiird|ja hiirden|dü hiirdst|hiir|jam hääwe hiird|we hiire|et heet hiird|hiird|et häi hiird|wat hääwe hiird|et hiird|jam wårde hiire|wat hiirden|dü häist hiird|jam häin hiird|jat wårde hiire|et wårt hiire|ja häin hiird|jam hiirden|jam hiire|ik hiir|ja hääwe hiird	<i>verb</i><br><ol><li>(Halligen), (Mooring) to hear</li></ol>
hiitje|et wårt hiitje|we hääwe hätjen|ik hätj|jü|dü wårst hiitje|wat hääwe hätjen|ja hääwe hätjen|wat häin hätjen|jam hääwe hätjen|ja hätjen|dü hääst hätjen|jam wårde hiitje|hätjen|hi|ik häi hätjen|dü häist hätjen|ja hiitje|jam hätjen|ik hääw hätjen|et heet hätjen|dü håtst|jat hääwe hätjen|ik hiitj|we hiitje|dü hätjst|we wårde hiitje|et håt|jam hiitje|et hätj|wat wårde hiitje|ik wård hiitje|ja wårde hiitje|we hätjen|jat hätjen|ja häin hätjen|jat wårde hiitje|jam häin hätjen|jat häin hätjen|we häin hätjen|wat hätjen|jat hiitje|wat hiitje|et häi hätjen	<i>verb</i><br><ol><li>(Mooring) to be named; to have as name, to be called.</li></ol>
hingst|hingster	<i>noun</i><br><ol><li>(Föhr-Amrum) horse</li></ol>
hobelfask	<i>noun</i><br><ol><li>frog</li></ol>
hoken	<i>pron</i><br><ol><li>someone, anyone</li><li>(interrogative, relative) who</li><li>whoever</li></ol>
hood|hööd	<i>noun</i><br><ol><li>(Föhr-Amrum) (anatomy) head</li></ol>
hoowe	<i>verb</i><br><ol><li>(Mooring) to hope</li></ol>
hotäl|hotäle	<i>noun</i><br><ol><li>(Mooring) hotel</li></ol>
hud|huder	<i>noun</i><br><ol><li>(Föhr-Amrum) hat</li></ol>
hun|hunen	<i>noun</i><br><ol><li>(Föhr-Amrum) (anatomy) hand</li></ol>
huuch|huuger|huuchst	<i>adj</i><br><ol><li>(Mooring, Föhr-Amrum) high, tall</li></ol>
härfstmoune	<i>noun</i><br><ol><li>(Mooring) September</li></ol>
hödj|hödje	<i>noun</i><br><ol><li>(Mooring dialect) hat</li></ol>
höm	<i>pron</i><br><ol><li>(Sylt) him (masculine pronoun as the direct object, indirect object, or prepositional object)</li><li>(Sylt) it (neuter pronoun as the direct object, indirect object, or prepositional object)</li></ol>
hönj|hönje	<i>noun</i><br><ol><li>(Mooring) (anatomy) hand</li></ol>
höör	<i>pron</i><br><ol><li>(Sylt) her (object pronoun)</li></ol><br><i>det</i><br><ol><li>(Sylt) her (possessive)</li></ol>
hü	<i>adv</i><br><ol><li>(Mooring) how</li></ol>
hün|hüne	<i>noun</i><br><ol><li>(Mooring) dog</li></ol>
hünj|hünjer	<i>noun</i><br><ol><li>(Föhr-Amrum) dog</li></ol>
hüs|hüsing|hüsinge|hüsinger	<i>noun</i><br><ol><li>(Mooring, Föhr-Amrum) house</li></ol>
i	<i>pron</i><br><ol><li>(Sylt) (second person plural subject pronoun) you, you all</li></ol>
iaan	<i>num</i><br><ol><li>(Heligoland) one</li></ol>
iaarem|iaaremer	<i>noun</i><br><ol><li>(Heligoland) (anatomy) arm</li></ol>
ial	<i>noun</i><br><ol><li>(Föhr-Amrum) fire</li></ol>
ian|or|een|or n. ian	<i>num</i><br><ol><li>(Föhr-Amrum) one</li></ol>
iarem|iarmer	<i>noun</i><br><ol><li>(Föhr-Amrum, anatomy) arm</li></ol>
iarst	<i>adj</i><br><ol><li>(Föhr-Amrum) first</li></ol>
iidj	<i>verb</i><br><ol><li>(Föhr-Amrum) to eat</li></ol>
iik|iike	<i>noun</i><br><ol><li>(Mooring) oak, oak tree</li></ol>
iilj	<i>noun</i><br><ol><li>(Mooring) fire</li></ol>
iinj	<i>num</i><br><ol><li>(Mooring) one</li></ol>
iir|iirnge	<i>noun</i><br><ol><li>(Mooring) year</li></ol>
iit|et|eet|iiten|etst	<i>verb</i><br><ol><li>(Sylt) to eat</li></ol>
ik|ick	<i>pron</i><br><ol><li>I</li></ol>
ismoune	<i>noun</i><br><ol><li>(Mooring) January</li></ol>
ja	<i>pron</i><br><ol><li>(Sylt and Mooring) they</li></ol>
jaan	<i>num</i><br><ol><li>(Heligoland) one</li></ol>
jam	<i>pron</i><br><ol><li>you (plural)</li><li>your (plural)</li></ol>
janewoore	<i>noun</i><br><ol><li>(Föhr-Amrum) January</li></ol>
jar	<i>pron</i><br><ol><li>them</li><li>their</li></ol>
jard	<i>noun</i><br><ol><li>(Mooring) earth</li></ol>
jat	<i>pron</i><br><ol><li>(second person dual personal pronoun) you two, both of you</li><li>(Sylt) (third person dual personal pronoun) they two, both of them, the two of them</li></ol>
jaw	<i>pron</i><br><ol><li>your (second personal pronoun plural possessive)</li></ol>
jeewe|jam jeewe|jam wårde jeewe|jam hääwe jääwen|wat jeewe|dü hääst jääwen|jam häin jääwen|dü wårst jeewe|jü|we häin jääwen|et heet jääwen|jat hääwe jääwen|dü jäifst|hi|we hääwe jääwen|we wårde jeewe|ja wårde jeewe|ik wård jeewe|wat häin jääwen|et jäif|et wårt jeewe|we jäifen|wat wårde jeewe|ik jeew|jeew|jat wårde jeewe|wat hääwe jääwen|jat jeewe|ja jäifen|dü häist jääwen|ja hääwe jääwen|jam jäifen|jat häin jääwen|et häi jääwen|dü jeefst|jääwen|ik hääw jääwen|jat jäifen|wat jäifen|et jeeft|ik jäif|we jeewe|än jeew|ik häi jääwen|ja häin jääwen|tu jeewen|ja jeewe	<i>verb</i><br><ol><li>(Mooring) to give</li></ol>
jen	<i>num</i><br><ol><li>(Sylt) one</li></ol>
jiiw|jat haa jewen|dü jafst|wat skel jiiw|wi hed jewen|hat|wat hed jewen|jo skel jiiw|at hed jewen|jam hed jewen|jam wel jiiw|juf|tu jiiwen|wat jiiw|jo hed jewen|hi|ik haa jewen|wi jiiw|wat jeew|jam jeew|wat wel jiiw|jo haa jewen|jat skel jiiw|at jeew|wi wel jiiw|wi jeew|ik jiiw|ik hed jewen|dü heest jewen|at skal jiiw|wat haa jewen|at wal jiiw|at hee jewen|ik jeew|jam skel jiiw|jewen|ik skal jiiw|at jaft|wi haa jewen|dü jeewst|jat jeew|jat wel jiiw|jo wel jiiw|dü skääl jiiw|dü wääl jiiw|jo jiiw|jam jiiw|jufst|dü hedst jewen|jiiw'em|wi skel jiiw|jam haa jewen|ik wal jiiw|jo jeew|jat jiiw|jat hed jewen	<i>verb</i><br><ol><li>(Föhr-Amrum) to give</li></ol>
jo	<i>pron</i><br><ol><li>they</li></ol>
jonk	<i>pron</i><br><ol><li>objective case of jat</li></ol>
jonkens	<i>pron</i><br><ol><li>possessive case of jat</li></ol>
jooge|we hääwe läägen|et jucht|jü|et häi läägen|ja luuchen|wat häin läägen|wat jooge|jam häin läägen|et luuch|jat häin läägen|dü wårst jooge|we häin läägen|we wårde jooge|ik luuch|läägen|ja hääwe läägen|hi|jam wårde jooge|ik joog|wat hääwe läägen|jat hääwe läägen|ja häin läägen|et heet läägen|än joog|wat luuchen|dü hääst läägen|jat wårde jooge|we luuchen|dü juchst|jam hääwe läägen|ik hääw läägen|dü häist läägen|tu joogen|ja jooge|ja wårde jooge|jat jooge|joog|we jooge|ik wård jooge|jat luuchen|ik häi läägen|wat wårde jooge|jam luuchen|dü luuchst|jam jooge|et wårt jooge	<i>verb</i><br><ol><li>(Mooring) to tell a lie; to lie</li></ol>
juar|juaren	<i>noun</i><br><ol><li>(Föhr-Amrum) year</li></ol>
junk	<i>adj</i><br><ol><li>(Sylt) dark</li></ol>
jä	<i>pron</i><br><ol><li>they (Halligen, Hoorning and Wiedingharde)</li></ol>
jü	<i>article</i><br><ol><li>(Föhr-Amrum) the (feminine singular)</li></ol><br><i>pron</i><br><ol><li>she</li></ol>
jülmoune	<i>noun</i><br><ol><li>(Mooring) December</li></ol>
jüüle	<i>noun</i><br><ol><li>(Föhr-Amrum) July</li></ol>
jüüne	<i>noun</i><br><ol><li>(Föhr-Amrum) June</li></ol>
kaame|än kaam|kiimen|we kaame|jü|et wus kiimen|ik kaam|jam kaame|ja wjarn kiimen|dü kamst|ja wårde kaame|et kamt|dü wjarst kiimen|kaam|hi|dü wårst kaame|jat kömen|wat kömen|wat wårde kaame|ja kömen|ik ban kiimen|jat san kiimen|we kömen|we san kiimen|jat wjarn kiimen|wat kaame|ik wård kaame|ja san kiimen|ja kaame|we wårde kaame|jat kaame|jat wårde kaame|et wårt kaame|ik wus kiimen|et as kiimen|jam san kiimen|ik köm|we wjarn kiimen|jam wjarn kiimen|jam wårde kaame|dü bast kiimen|wat san kiimen|tu kaamen|jam kömen|wat wjarn kiimen|dü kömst|et köm	<i>verb</i><br><ol><li>(Mooring) to come</li></ol>
kaat|kaater	<i>noun</i><br><ol><li>(Föhr-Amrum) cat</li></ol>
kafe	<i>noun</i><br><ol><li>(Mooring) coffee</li></ol>
kai|kaier	<i>noun</i><br><ol><li>(Föhr-Amrum) key</li></ol>
kem|at skal kem|jo skel kem|wi san kimen|jo san kimen|ik skal kem|ik kaam|hat|jat skel kem|jam wiar kimen|wat kem|jat kem|wat kaam|dü beest kimen|wi wel kem|jam skel kem|hi|dü wääl kem|wi skel kem|jo wiar kimen|jat wiar kimen|jat kaam|jat san kimen|wi kaam|at kaam|ik san kimen|jam wel kem|jam kaam|jo kem|ik wal kem|tu kemen|dü komst|at as kimen|jo kaam|at wiar kimen|jam kem|at komt|wi kem|ik wiar kimen|wat skel kem|wi wiar kimen|at wal kem|wat wel kem|jo wel kem|wat san kimen|dü skääl kem|kimen|dü kaamst|wat wiar kimen|ik kem|kem'em|jat wel kem|dü wiarst kimen|jam san kimen	<i>verb</i><br><ol><li>(Föhr-Amrum) to come</li></ol>
kiike|ja kiikeden|ik häi kiiked|tu kiiken|jü|jat kiike|ja hääwe kiiked|dü kiikedst|dü häist kiiked|än kiik|hi|we kiikeden|jam häin kiiked|jam kiike|ik hääw kiiked|kiiked|kiik|we wårde kiike|et kiiket|wat hääwe kiiked|ik wård kiike|we häin kiiked|jat hääwe kiiked|jat häin kiiked|jam hääwe kiiked|ik kiik|we hääwe kiiked|wat kiikeden|ja wårde kiike|dü kiikest|dü wårst kiike|wat häin kiiked|jam wårde kiike|dü hääst kiiked|ik kiiked|et häi kiiked|wat wårde kiike|ja kiike|jat kiikeden|et wårt kiike|we kiike|et kiiked|et heet kiiked|ja häin kiiked|jat wårde kiike|wat kiike|jam kiikeden	<i>verb</i><br><ol><li>(Mooring) to look</li></ol>
kining	<i>noun</i><br><ol><li>(Mooring) king</li></ol>
klap|klapen	<i>noun</i><br><ol><li>(Föhr-Amrum) cliff</li></ol>
klawiar|klawiaren	<i>noun</i><br><ol><li>(Föhr-Amrum, music) piano</li></ol>
klook	<i>noun</i><br><ol><li>(Mooring) clock</li></ol>
knooke	<i>noun</i><br><ol><li>(Mooring) bone</li></ol>
koone|jat häin kööt|jam häin kööt|et köö|ik hääw kööt|ja häin kööt|jü|jat köön|dü kööst|jam koone|we köön|wat koone|ja hääwe kööt|ik häi kööt|dü hääst kööt|we häin kööt|tu koonen|dü koonst|hi|ja koone|jam hääwe kööt|et heet kööt|än koon|wat köön|jam wårde koone|wat hääwe kööt|ik köö|ik koon|et häi kööt|kööt|ja wårde koone|jat hääwe kööt|jat wårde koone|we hääwe kööt|ik wård koone|et koon|dü häist kööt|ja köön|we koone|wat wårde koone|jam köön|we wårde koone|et wårt koone|jat koone|dü wårst koone|wat häin kööt	<i>verb</i><br><ol><li>(Mooring) to be able, can</li></ol>
krich	<i>noun</i><br><ol><li>(Mooring) war</li></ol>
krölemoune	<i>noun</i><br><ol><li>(Mooring) May</li></ol>
kualew|kualwer	<i>noun</i><br><ol><li>(Föhr-Amrum) calf</li></ol>
kuulew|kuulwe	<i>noun</i><br><ol><li>(Mooring) calf</li></ol>
kuup	<i>noun</i><br><ol><li>(Föhr-Amrum) purchase</li></ol>
kuupe|jam kuupe|jat wel kuupe|jam haa keeft|jo wel kuupe|wi hed keeft|dü wääl kuupe|hat|ik wal kuupe|ik keeft|wat keeft|ik hed keeft|jo haa keeft|wi skel kuupe|hi|jat skel kuupe|jam wel kuupe|jat hed keeft|keeft|dü hedst keeft|tu kuupin|jam skel kuupe|ik kuup|at keeft|dü heest keeft|wat wel kuupe|wi wel kuupe|jat keeft|ik haa keeft|at wal kuupe|at hee keeft|jat haa keeft|wat skel kuupe|jo skel kuupe|jo hed keeft|at hed keeft|jo keeft|kuup'em|jam hed keeft|ik skal kuupe|at skal kuupe|dü skääl kuupe|jat kuupe|wi haa keeft|jo kuupe|jam keeft|wi kuupe|dü keefst|wat haa keeft|wi keeft|wat kuupe|wat hed keeft	<i>verb</i><br><ol><li>(Föhr-Amrum) to buy</li></ol>
kääre|wat wårde kääre|jü|wat hääwe kjard|wat häin kjard|jat hääwe kjard|jam kääre|jat kjarden|we hääwe kjard|dü wårst kääre|ja kääre|hi|we kääre|ja häin kjard|dü kjarst|we kjarden|ik kjard|wat kääre|wat kjarden|ik hääw kjard|jam kjarden|et kjart|ik wård kääre|jam hääwe kjard|jam häin kjard|dü hääst kjard|we häin kjard|ik häi kjard|jam wårde kääre|jat kääre|dü kjardst|dü häist kjard|än käär|ik käär|et heet kjard|ja kjarden|kjard|ja hääwe kjard|et wårt kääre|et kjard|ja wårde kääre|jat häin kjard|we wårde kääre|tu käären|et häi kjard|jat wårde kääre	<i>verb</i><br><ol><li>(Mooring) to drive</li></ol>
kåmp	<i>noun</i><br><ol><li>(Mooring) battle</li></ol>
kåt|kåte	<i>noun</i><br><ol><li>(Mooring) cat</li></ol>
kölj	<i>adj</i><br><ol><li>(Mooring) cold</li></ol>
kön	<i>verb</i><br><ol><li>(Föhr-Amrum) to be able, can</li></ol>
köning|köninger	<i>noun</i><br><ol><li>(Föhr-Amrum) king</li></ol>
kööge	<i>verb</i><br><ol><li>(Föhr-Amrum) to boil, to cook</li></ol>
köögen	<i>noun</i><br><ol><li>(Mooring) kitchen</li></ol>
kü|ki	<i>noun</i><br><ol><li>(Mooring, Föhr-Amrum) cow</li></ol>
laawen	<i>noun</i><br><ol><li>(Mooring) life</li></ol>
latj	<i>adj</i><br><ol><li>(Mooring) small</li></ol>
lau	<i>noun</i><br><ol><li>lion</li></ol>
lees|lees'em|ik haa leesen|hat|dü wääl lees|wi lus|wat skel lees|dü hedst leesen|jat skel lees|wat hed leesen|hi|jo hed leesen|jam skel lees|wat haa leesen|jo haa leesen|ik lus|ik hed leesen|wat lees|dü leest|jat haa leesen|jat lees|at hed leesen|jam lees|at leest|wat wel lees|jat lus|wi hed leesen|ik wal lees|at lus|wat lus|jat hed leesen|dü skääl lees|jam wel lees|jam lus|jam haa leesen|wi lees|ik skal lees|ik lees|at wal lees|dü lust|at hee leesen|jat wel lees|jam hed leesen|wi skel lees|wi wel lees|jo lus|tu leesen|jo skel lees|jo wel lees|dü heest leesen|leesen|wi haa leesen|jo lees|at skal lees	<i>verb</i><br><ol><li>(Föhr-Amrum Dialect) to read</li><li>(Föhr-Amrum Dialect) to load</li></ol>
liiwde	<i>noun</i><br><ol><li>love</li></ol>
liiwe|wat liiweden|jam häin liiwd|jü|jam hääwe liiwd|dü liiwest|wat liiwe|jam liiweden|et wårt liiwe|liiw|liiwt|jam wårde liiwe|ja wårde liiwe|we häin liiwd|ja liiwe|än liiw|hi|jat wårde liiwe|jat hääwe liiwd|we liiweden|dü häist liiwd|we wårde liiwe|liiwd|jat liiweden|dü liiwedst|et liiwed|tu liiwen|ja liiweden|jat häin liiwd|ja hääwe liiwd|ik häi liiwd|ik wård liiwe|wat wårde liiwe|et heet liiwd|jat liiwe|et häi liiwd|ik liiw|dü hääst liiwd|dü wårst liiwe|wat hääwe liiwd|jam liiwe|we liiwe|ik hääw liiwd|wat häin liiwd|et liiwet|we hääwe liiwd|ik liiwed|ja häin liiwd	<i>verb</i><br><ol><li>(Mooring) to believe</li><li>(Mooring) to think</li></ol>
lun|lunen	<i>noun</i><br><ol><li>(Föhr-Amrum) land</li></ol>
luup	<i>verb</i><br><ol><li>(Föhr-Amrum) to run</li></ol>
luupe	<i>verb</i><br><ol><li>(Mooring) to run</li></ol>
lääs|leest|lääser	<i>adj</i><br><ol><li>(Mooring) late</li></ol>
lönj|lönje	<i>noun</i><br><ol><li>(Mooring dialect) land</li><li>(Mooring dialect) country</li></ol>
lööw	<i>noun</i><br><ol><li>lion</li></ol>
ma	<i>prep</i><br><ol><li>(Mooring) with</li></ol>
maage|dü maagest|wi skel maage|jam skel maage|wi maage|hat|ik haa maaget|tu maagin|jam maage|jo skel maage|jam haa maaget|wat wel maage|ik hed maaget|wat hed maaget|jam maaget|jo maaget|wat skel maage|wat maage|hi|at hed maaget|jo hed maaget|jat skel maage|wi hed maaget|wat maaget|ik maage|at skal maage|jat maaget|jat maage|ik wal maage|dü wääl maage|at wal maage|dü hedst maaget|dü maagetst|jat wel maage|ik maaget|ik skal maage|jam wel maage|dü heest maaget|jat haa maaget|jo wel maage|jam hed maaget|jat hed maaget|at hee maaget|maage'm|at maaget|maaget|dü skääl maage|wi wel maage|jo maage|wi haa maaget|jo haa maaget|wat haa maaget|wi maaget	<i>verb</i><br><ol><li>(Föhr-Amrum) to make</li></ol>
mak	<i>noun</i><br><ol><li>kiss</li></ol>
mam|mamen	<i>noun</i><br><ol><li>(Mooring, Föhr-Amrum) mother</li></ol>
man|min	<i>pron</i><br><ol><li>(Föhr-Amrum) my</li></ol>
mansche|manschne	<i>noun</i><br><ol><li>human, human being, person</li></ol>
marts	<i>noun</i><br><ol><li>(Föhr-Amrum) March</li></ol>
me	<i>pron</i><br><ol><li>First-person singular, objective: me</li></ol>
mei	<i>noun</i><br><ol><li>(Föhr-Amrum) May</li></ol>
mi	<i>pron</i><br><ol><li>me</li></ol>
mist	<i>noun</i><br><ol><li>(Mooring) mist</li></ol>
mistmoune	<i>noun</i><br><ol><li>(Mooring) November</li></ol>
moin	<i>intj</i><br><ol><li>(informal) hi</li></ol>
molke	<i>noun</i><br><ol><li>milk</li></ol><br><i>verb</i><br><ol><li>to milk</li></ol>
moolke	<i>noun</i><br><ol><li>(Mooring) milk</li></ol>
moon	<i>noun</i><br><ol><li>(Mooring) man</li></ol>
moune	<i>noun</i><br><ol><li>(Mooring) moon</li><li>(Mooring) month</li></ol>
mut	<i>verb</i><br><ol><li>(Föhr-Amrum) must, have to</li></ol>
muun|muuner	<i>noun</i><br><ol><li>(Föhr-Amrum) moon</li><li>(Föhr-Amrum) month</li></ol>
mååge|et mååged|ik mååg|et häi mååged|et mååget|ja hääwe mååged|jü|ja wårde mååge|ik mååged|jat måågeden|dü hääst mååged|dü måågedst|mååged|dü häist mååged|wat måågeden|jam hääwe mååged|mååg|ja mååge|jat häin mååged|hi|we hääwe mååged|ja måågeden|wat hääwe mååged|jam häin mååged|dü wårst mååge|ik wård mååge|jat wårde mååge|wat häin mååged|än mååg|ik hääw mååged|we häin mååged|ik häi mååged|et wårt mååge|dü måågest|we måågeden|we wårde mååge|ja häin mååged|jat mååge|et heet mååged|wat wårde mååge|jam wårde mååge|tu måågen|jam måågeden|jat hääwe mååged|jam mååge|we mååge|wat mååge	<i>verb</i><br><ol><li>(Mooring) to make</li></ol>
mölke	<i>verb</i><br><ol><li>to milk</li></ol>
mönster	<i>noun</i><br><ol><li>(Mooring) pattern</li></ol>
mötj|dü wårst mötj|we muursten|ja mönje|jat wårde mötj|jü|jat hääwe muurst|ja muursten|dü häist muurst|we mönje|ik häi muurst|wat häin muurst|än mötj|hi|dü möist|ja häin muurst|we hääwe muurst|ja hääwe muurst|ik hääw muurst|wat wårde mötj|et heet muurst|we häin muurst|jam häin muurst|jat muursten|wat mönje|et wårt mötj|wat hääwe muurst|jam wårde mötj|ik muurst|et muurst|jat mönje|jam hääwe muurst|we wårde mötj|et häi muurst|tu mötjen|jam mönje|jam muursten|jat häin muurst|ik mötj|et mötj|ik wård mötj|dü hääst muurst|muurst|ja wårde mötj|wat muursten|dü muurst	<i>verb</i><br><ol><li>(Mooring) must, to have to</li></ol>
müs	<i>noun</i><br><ol><li>(Mooring and Föhr-Amrum dialects) mouse</li></ol>
naas|naase	<i>noun</i><br><ol><li>(Mooring) nose</li></ol>
nei|neist|neier	<i>adj</i><br><ol><li>(Föhr-Amrum) new</li></ol>
nem|wi nem|jat wel nem|at naam|dü wääl nem|wi skel nem|hat|jam naam|jam haa nimen|jo haa nimen|jam nem|wi haa nimen|dü skääl nem|at namt|dü namst|hi|ik wal nem|wat skel nem|jam wel nem|jo wel nem|nem'em|wi hed nimen|at hee nimen|at skal nem|jo naam|at wal nem|wat wel nem|jo skel nem|jat nem|wi naam|dü naamst|wat haa nimen|jat haa nimen|jo nem|jo hed nimen|jam skel nem|wat nem|ik haa nimen|jat skel nem|jat naam|dü hedst nimen|ik nem|wi wel nem|tu nemen|wat naam|ik hed nimen|wat hed nimen|jam hed nimen|ik naam|ik skal nem|at hed nimen|nimen|dü heest nimen|jat hed nimen	<i>verb</i><br><ol><li>(Föhr-Amrum) to take</li></ol>
neägen	<i>num</i><br><ol><li>(Heligoland) nine</li></ol>
niigen	<i>num</i><br><ol><li>(Sylt) nine</li></ol>
ninte	<i>pron</i><br><ol><li>nothing</li></ol>
njüti|njütist|njütier	<i>adj</i><br><ol><li>(Mooring) cute</li></ol>
njüügen	<i>num</i><br><ol><li>(Föhr-Amrum) nine</li></ol>
njüügenst	<i>adj</i><br><ol><li>(Föhr-Amrum) ninth</li></ol>
njüügentanj	<i>num</i><br><ol><li>(Föhr-Amrum) nineteen</li></ol>
nofember	<i>noun</i><br><ol><li>(Föhr-Amrum) November</li></ol>
noome	<i>noun</i><br><ol><li>(Mooring dialect) name</li></ol>
noos	<i>noun</i><br><ol><li>(Mooring) nose</li></ol>
näiber	<i>noun</i><br><ol><li>(Mooring) neighbour</li></ol>
nåcht	<i>noun</i><br><ol><li>(Mooring) night</li></ol>
nåchtling	<i>noun</i><br><ol><li>tonight</li></ol><br><i>adv</i><br><ol><li>tonight</li></ol>
nööm|nöömer	<i>noun</i><br><ol><li>(Föhr-Amrum) name</li></ol>
nöös|nöösen	<i>noun</i><br><ol><li>(Föhr-Amrum, anatomy) nose</li></ol>
nü	<i>adv</i><br><ol><li>(Sylt) now; at the current time</li></ol>
nüügen	<i>num</i><br><ol><li>(Föhr-Amrum, Mooring) nine</li></ol>
oftem	<i>adv</i><br><ol><li>oft; often</li></ol>
oktuuber	<i>noun</i><br><ol><li>(Föhr-Amrum) October</li></ol>
oler	<i>adv</i><br><ol><li>(Sylt) never</li></ol>
onk	<i>pron</i><br><ol><li>objective case of wat</li></ol>
onkens	<i>pron</i><br><ol><li>possessive case of wat</li></ol>
oocht	<i>num</i><br><ol><li>(Mooring) eight</li></ol>
oodler|oodlern	<i>noun</i><br><ol><li>(Föhr-Amrum) eagle</li></ol>
oome	<i>noun</i><br><ol><li>uncle</li></ol>
ouers	<i>conj</i><br><ol><li>(Mooring) but</li></ol>
pluuge|jam pluug|wi haa pluuget|jat pluug|at skal pluuge|at pluuget|hat|wat wel pluuge|jam skel pluuge|tu pluugin|jo skel pluuge|wi wel pluuge|jat skel pluuge|ik pluuget|hi|wat pluuget|jat wel pluuge|jat pluuget|ik skal pluuge|jo pluug|wat hed pluuget|wat haa pluuget|dü wääl pluuge|wi hed pluuget|dü skääl pluuge|jam pluuget|wat pluug|at hee pluuget|jam wel pluuge|ik hed pluuget|jam haa pluuget|wat skel pluuge|ik haa pluuget|dü hedst pluuget|at wal pluuge|wi pluug|ik pluuge|dü heest pluuget|wi pluuget|jo haa pluuget|jo pluuget|at hed pluuget|jo hed pluuget|jat haa pluuget|jam hed pluuget|ik wal pluuge|wi skel pluuge|dü pluugest|jo wel pluuge|pluuget|jat hed pluuget|pluugi'm	<i>verb</i><br><ol><li>(Föhr-Amrum Dialect) to plough</li></ol>
pöber	<i>noun</i><br><ol><li>(Föhr-Amrum) pepper</li></ol>
rag|rager	<i>noun</i><br><ol><li>(Föhr-Amrum) (anatomy) back</li></ol>
ridj	<i>verb</i><br><ol><li>(Föhr-Amrum) to ride</li></ol>
rik	<i>adj</i><br><ol><li>(Mooring) rich</li></ol>
rin	<i>noun</i><br><ol><li>(Mooring and Föhr-Amrum dialects) rain</li></ol>
ruad	<i>adj</i><br><ol><li>(Föhr-Amrum) red</li></ol>
ruar	<i>adj</i><br><ol><li>(Sylt) red</li></ol>
räigel|räigeln	<i>noun</i><br><ol><li>(Mooring) rule</li></ol>
röp|ja her rööpen|hat her rööpen|dü sket röp|ik röp|hat reept|ik her rööpen|jü|wat her rööpen|i wel röp|hat heer rööpen|i röp|i haa rööpen|jat rööp|ik haa rööpen|jat her rööpen|dü wet röp|at skel röp|hat wel röp|dü rööpst|hi|wat röp|jat wel röp|jat röp|tö röpen|ja röp|wat haa rööpen|jat skel röp|hat skel röp|at rööp|hat rööp|wü röp|wat skel röp|wü haa rööpen|ja wel röp|ja haa rööpen|at wel röp|at haa rööpen|ja rööp|ja skel röp|jat haa rööpen|dü herst rööpen|rööpen|wü skel röp|i skel röp|dü heest rööpen|ik rööp|i rööp|ik skel röp|i her rööpen|wü her rööpen|wü wel röp|at röp|dü reepst|ik wel röp|wat rööp|wat wel röp|at her rööpen|wü rööp	<i>verb</i><br><ol><li>(Sylt dialect) to call</li></ol>
rüm|rümen|rööme	<i>noun</i><br><ol><li>(Mooring and Föhr-Amrum dialects) room</li></ol>
saalt	<i>noun</i><br><ol><li>(Föhr-Amrum) salt</li></ol>
saan|saane	<i>noun</i><br><ol><li>(Mooring) son</li></ol>
samer|samre	<i>noun</i><br><ol><li>(Mooring) summer</li></ol>
samermoune	<i>noun</i><br><ol><li>(Mooring) June</li></ol>
san|sin	<i>noun</i><br><ol><li>(Mooring and Föhr-Amrum) sun</li></ol><br><i>pron</i><br><ol><li>(Föhr-Amrum) his</li></ol>
sark|sarken	<i>noun</i><br><ol><li>(Föhr-Amrum) church</li></ol>
saster|sastern	<i>noun</i><br><ol><li>(Föhr-Amrum) sister</li></ol>
sate|ja sätjen|än sat|dü hääst sin|et heet sin|ja wårde sate|jam hääwe sin|jü|dü satst|jat häin sin|ja hääwe sin|tu saten|et häi sin|jam sate|et sätj|we hääwe sin|hi|jat hääwe sin|we sätjen|ik sat|sin|jam sätjen|wat sätjen|ik häi sin|we häin sin|dü häist sin|ik hääw sin|ja häin sin|we sate|et sat|jat sate|wat sate|we wårde sate|ik sätj|ja sate|et wårt sate|wat wårde sate|wat häin sin|jam häin sin|jat wårde sate|ik wård sate|dü wårst sate|jat sätjen|jam wårde sate|dü sätjst|wat hääwe sin	<i>verb</i><br><ol><li>(Mooring) to sit</li></ol>
schap|schaawe	<i>noun</i><br><ol><li>(Mooring) ship</li></ol>
scheew|scheewe	<i>noun</i><br><ol><li>(Mooring) table</li></ol>
schit	<i>noun</i><br><ol><li>(Mooring) shit</li></ol>
schtjuur	<i>num</i><br><ol><li>(Heligoland) four</li></ol>
schunge	<i>verb</i><br><ol><li>(Mooring) to sing</li></ol>
schäip	<i>noun</i><br><ol><li>(Goesharde, Mooring) sheep</li></ol>
schååp|schååwe	<i>noun</i><br><ol><li>cupboard, closet, cabinet</li><li>wardrobe (cabinet in which clothes may be stored)</li></ol>
schölj	<i>noun</i><br><ol><li>(Mooring) school</li></ol>
schörk	<i>noun</i><br><ol><li>(Mooring) church</li></ol>
se|sjochst|sjocht|saag|sen	<i>verb</i><br><ol><li>(Sylt) to see</li></ol>
sedel	<i>noun</i><br><ol><li>(Föhr-Amrum) kettle</li></ol>
see|seen	<i>noun</i><br><ol><li>(Föhr-Amrum) lake</li></ol>
seeben	<i>num</i><br><ol><li>(Heligoland) seven</li></ol>
seede|jü|we hääwe säid|jat seede|tu seeden|dü säist|jam häin säid|ik häi säid|we häin säid|jat häin säid|hi|jam sään|säid|ik hääw säid|wat hääwe säid|jat wårde seede|et wårt seede|et häi säid|ja hääwe säid|dü sääst|ik seed|et sää|we wårde seede|jam seede|ik wård seede|dü häist säid|ik sää|ja häin säid|wat sään|et säit|än seed|et heet säid|jat hääwe säid|wat seede|wat wårde seede|jam wårde seede|jam hääwe säid|ja seede|we seede|jat sään|dü hääst säid|ja sään|ja wårde seede|wat häin säid|we sään|dü wårst seede	<i>verb</i><br><ol><li>(Mooring) to say</li></ol>
seeks	<i>num</i><br><ol><li>(Föhr-Amrum, Mooring) six</li></ol>
seekst	<i>adj</i><br><ol><li>(Föhr-Amrum) sixth</li></ol>
seekstanj	<i>num</i><br><ol><li>(Föhr-Amrum) sixteen</li></ol>
september	<i>noun</i><br><ol><li>(Föhr-Amrum) September</li></ol>
sia	<i>noun</i><br><ol><li>(Föhr-Amrum) sea</li></ol>
sii|sair	<i>verb</i><br><ol><li>(Sylt) to say</li></ol>
sin	<i>pron</i><br><ol><li>its</li></ol>
skap|skeb	<i>noun</i><br><ol><li>(Föhr-Amrum) ship</li></ol>
skiltpod	<i>noun</i><br><ol><li>turtle</li><li>tortoise</li></ol>
skoler|skolern	<i>noun</i><br><ol><li>(Föhr dialect) shoulder</li></ol>
skriiw|jo haa skrewen|jo hed skrewen|dü skrafst|ik hed skrewen|hat|wi wel skriiw|skriiw'em|jam hed skrewen|dü skääl skriiw|wi hed skrewen|ik skreew|jat skriiw|tu skriiwen|wi haa skrewen|jam haa skrewen|hi|ik skriiw|jat haa skrewen|jam skel skriiw|wat hed skrewen|wi skriiw|at skraft|jam wel skriiw|jo skel skriiw|dü hedst skrewen|wat skriiw|jo skreew|jo skriiw|at skal skriiw|jo wel skriiw|jat hed skrewen|wat wel skriiw|jam skriiw|ik haa skrewen|at hed skrewen|wat haa skrewen|at skreew|ik skal skriiw|wi skel skriiw|dü wääl skriiw|jat skel skriiw|at wal skriiw|wi skreew|jat wel skriiw|skrewen|dü skreewst|dü heest skrewen|jat skreew|jam skreew|wat skel skriiw|wat skreew|ik wal skriiw|at hee skrewen	<i>verb</i><br><ol><li>(Föhr-Amrum) to write</li></ol>
sluber	<i>noun</i><br><ol><li>(Mooring) mud</li></ol>
smuk|smukst|smuker	<i>adj</i><br><ol><li>(Mooring) beautiful, handsome</li></ol>
snä	<i>noun</i><br><ol><li>(Föhr-Amrum) snow</li></ol>
soks	<i>num</i><br><ol><li>(Sylt) six</li></ol>
soowen	<i>num</i><br><ol><li>(Mooring, Sylt) seven</li></ol>
spaale|we wårde spaale|dü spaaldst|jü|wat spaale|we spaalden|ja hääwe spaald|jat hääwe spaald|jam häin spaald|wat häin spaald|ja wårde spaale|dü häist spaald|hi|tu spaalen|we hääwe spaald|ik hääw spaald|et heet spaald|ik spaald|jat spaale|wat hääwe spaald|jam spaalden|ja häin spaald|ik wård spaale|ja spaale|jat häin spaald|we häin spaald|jat wårde spaale|dü hääst spaald|jam wårde spaale|spaald|jam spaale|et wårt spaale|et spaalt|ik spaal|ik häi spaald|ja spaalden|dü spaalst|et häi spaald|et spaald|jam hääwe spaald|än spaal|jat spaalden|dü wårst spaale|we spaale|wat spaalden|wat wårde spaale	<i>verb</i><br><ol><li>(Mooring) to play</li></ol>
spreege|än spreeg|jü|et wårt spreege|wat spreege|et spreecht|spreeg|dü wårst spreege|we häin spräägen|jat spreege|dü spreechst|hi|we spreege|jam hääwe spräägen|dü häist spräägen|wat wårde spreege|dü spräkst|jam wårde spreege|ja hääwe spräägen|ik wård spreege|ik häi spräägen|et heet spräägen|spräägen|jat häin spräägen|jat wårde spreege|wat häin spräägen|we wårde spreege|ja häin spräägen|wat spräken|jam spreege|ik spräk|ja spräken|wat hääwe spräägen|ja wårde spreege|ik hääw spräägen|jam spräken|we hääwe spräägen|dü hääst spräägen|et häi spräägen|et spräk|jat spräken|ja spreege|tu spreegen|jam häin spräägen|ik spreeg|jat hääwe spräägen|we spräken	<i>verb</i><br><ol><li>(Mooring) to speak</li></ol>
spriik|spriaken	<i>noun</i><br><ol><li>(Föhr-Amrum) language</li></ol>
späägel	<i>noun</i><br><ol><li>(Mooring) mirror</li></ol>
steed|steeden	<i>noun</i><br><ol><li>(Föhr-Amrum) city, town</li></ol>
sterew	<i>verb</i><br><ol><li>(Föhr-Amrum) to die</li></ol>
stian|stianer	<i>noun</i><br><ol><li>(Föhr-Amrum) stone</li></ol>
stormmoune	<i>noun</i><br><ol><li>(Mooring) October</li></ol>
stridj|ik skal stridj|at wal stridj|wi haa streden|wat hed streden|at skal stridj|dü hedst streden|wi hed streden|tu stridjen|hat|ik wal stridj|jo skel stridj|at streed|jo haa streden|jat hed streden|jam haa streden|hi|wat streed|ik stridj|at strat|jat streed|ik hed streden|jo hed streden|jam wel stridj|jo streed|ik streed|dü wääl stridj|jam hed streden|wat stridj|jat stridj|dü heest streden|jat skel stridj|wat haa streden|wi skel stridj|at hed streden|jo stridj|streden|jam skel stridj|dü stratst|jat haa streden|stridj'em|wat skel stridj|dü streedst|wat wel stridj|jam streed|wi stridj|jat wel stridj|wi streed|jam stridj|wi wel stridj|at hee streden|dü skääl stridj|ik haa streden|jo wel stridj	<i>verb</i><br><ol><li>(Föhr-Amrum Dialect) to fight</li></ol>
stroote	<i>noun</i><br><ol><li>(Mooring dialect) street</li></ol>
struat|struaten	<i>noun</i><br><ol><li>(Föhr-Amrum) street</li></ol>
strun|strunen	<i>noun</i><br><ol><li>(Föhr-Amrum) beach</li></ol>
struum|struumer	<i>noun</i><br><ol><li>(Föhr-Amrum) river, stream</li><li>(Föhr-Amrum) electricity</li></ol>
ströön|strööne	<i>noun</i><br><ol><li>(Halligen) beach</li></ol>
sturem|sturmer	<i>noun</i><br><ol><li>(Föhr-Amrum) storm</li></ol>
stuul|stuuler	<i>noun</i><br><ol><li>(Föhr-Amrum) chair</li></ol>
stärwe|wat häin störwen|ik störw|et heet störwen|wat hääwe störwen|stärw|jam stärwe|dü hääst störwen|we hääwe störwen|jü|et steerft|et wårt stärwe|ja hääwe störwen|dü störwst|jam hääwe störwen|et häi störwen|et störw|ik stärw|dü häist störwen|hi|ja wårde stärwe|wat wårde stärwe|ja störwen|än stärw|jat hääwe störwen|jat störwen|jat häin störwen|jam wårde stärwe|störwen|dü steerfst|ja häin störwen|ik wård stärwe|ja stärwe|we störwen|wat störwen|jam störwen|dü wårst stärwe|jam häin störwen|we wårde stärwe|ik hääw störwen|ik häi störwen|jat stärwe|jat wårde stärwe|wat stärwe|we stärwe|tu stärwen|we häin störwen	<i>verb</i><br><ol><li>(Mooring) to die</li></ol>
stölj|stoule	<i>noun</i><br><ol><li>(Mooring dialect) chair</li></ol>
stönje	<i>verb</i><br><ol><li>(Mooring) to stand</li></ol>
suart	<i>adj</i><br><ol><li>(Föhr-Amrum) black</li></ol>
sun	<i>noun</i><br><ol><li>(Föhr-Amrum) sand</li></ol>
suurt	<i>adj</i><br><ol><li>(Sylt) black</li></ol>
swark|swarken	<i>noun</i><br><ol><li>(Föhr-Amrum) cloud (containing rain), raincloud</li></ol>
sös	<i>num</i><br><ol><li>(Heligoland) six</li></ol>
söster|sösterne	<i>noun</i><br><ol><li>(Mooring) sister</li></ol>
sööwen	<i>num</i><br><ol><li>(Föhr-Amrum) seven</li></ol>
sööwenst	<i>adj</i><br><ol><li>(Föhr-Amrum) seventh</li></ol>
sööwentanj	<i>num</i><br><ol><li>(Föhr-Amrum) seventeen</li></ol>
süster	<i>noun</i><br><ol><li>sister</li></ol>
taag|taagen	<i>noun</i><br><ol><li>(Föhr-Amrum) roof</li></ol>
taarep|taarpen	<i>noun</i><br><ol><li>(Föhr-Amrum) village</li></ol>
taatje	<i>noun</i><br><ol><li>(Mooring) father</li></ol>
taatji|taatjet	<i>verb</i><br><ol><li>(Sylt) to kiss</li></ol>
tain	<i>num</i><br><ol><li>(Heligoland) ten</li></ol>
tante	<i>noun</i><br><ol><li>aunt</li></ol>
tau	<i>num</i><br><ol><li>(Föhr-Amrum, Heligoland, Sylt) two</li></ol>
teenk|jo haa toocht|jat skel teenk|jat toocht|wi skel teenk|hat|jam toocht|at skal teenk|jat wel teenk|wat haa toocht|jam haa toocht|at hee toocht|wat skel teenk|jam skel teenk|ik wal teenk|dü teenkst|jo hed toocht|teenk'em|hi|wat hed toocht|jam hed toocht|jam teenk|jo teenk|at hed toocht|jat teenk|ik haa toocht|jat hed toocht|ik skal teenk|wat wel teenk|wi teenk|wat toocht|wi hed toocht|jat haa toocht|ik teenk|dü wääl teenk|dü skääl teenk|wat teenk|jo wel teenk|at toocht|dü hedst toocht|dü toochst|jo skel teenk|dü heest toocht|ik toocht|wi wel teenk|at teenkt|wi haa toocht|tu teenken|toocht|jo toocht|ik hed toocht|jam wel teenk|at wal teenk|wi toocht	<i>verb</i><br><ol><li>(Föhr-Amrum), to think</li></ol>
teew	<i>verb</i><br><ol><li>(Föhr-Amrum) to wait (+ üüb or efter for)</li></ol>
tid	<i>noun</i><br><ol><li>(Mooring dialect) time</li></ol>
tidj	<i>noun</i><br><ol><li>(Föhr-Amrum) time</li></ol>
tiin	<i>num</i><br><ol><li>(Mooring, Sylt) ten</li></ol>
tin	<i>num</i><br><ol><li>(Föhr-Amrum) ten</li></ol>
tjiin	<i>num</i><br><ol><li>(Föhr-Amrum) ten</li></ol>
tjiinst	<i>adj</i><br><ol><li>(Föhr-Amrum) tenth</li></ol>
tjüsch	<i>adj</i><br><ol><li>(Mooring) German (relating to Germany and the German people)</li></ol><br><i>noun</i><br><ol><li>(Mooring) German (the German language)</li></ol>
toorp|toorpe	<i>noun</i><br><ol><li>(Mooring) village</li></ol>
tou|tväär	<i>num</i><br><ol><li>(Mooring) two</li></ol>
tra	<i>num</i><br><ol><li>(Mooring) three</li></ol>
traad	<i>adj</i><br><ol><li>(Föhr-Amrum) third</li></ol>
tree	<i>num</i><br><ol><li>(Heligoland) three</li></ol>
tretanj	<i>num</i><br><ol><li>(Föhr-Amrum) thirteen</li></ol>
trii|tra|and	<i>num</i><br><ol><li>(Föhr-Amrum, Mooring) three</li></ol>
tu	<i>prep</i><br><ol><li>(Mooring) to</li></ol>
tuhuupe	<i>adv</i><br><ol><li>together</li></ol>
tus|tes	<i>noun</i><br><ol><li>(Föhr-Amrum) (anatomy) tooth</li></ol>
tuun	<i>noun</i><br><ol><li>(Mooring) hedge</li></ol>
tväär	<i>num</i><br><ol><li>(Mooring) two</li></ol>
twaalew	<i>num</i><br><ol><li>(Föhr-Amrum) twelve</li></ol>
twasche	<i>prep</i><br><ol><li>(Mooring) between</li></ol>
twesken	<i>prep</i><br><ol><li>(Sylt) between</li></ol>
twuntig	<i>num</i><br><ol><li>(Föhr-Amrum) twenty</li></ol>
twäär	<i>num</i><br><ol><li>(Mooring) two</li></ol>
tääte|täätens	<i>noun</i><br><ol><li>(Mooring) father</li></ol>
tånke|wat toochten|jü|we wårde tånke|ja wårde tånke|jat hääwe toocht|jam toochten|ik häi toocht|jam tånke|et heet toocht|et häi toocht|ja toochten|jam häin toocht|dü tånkst|ja hääwe toocht|hi|ja häin toocht|dü wårst tånke|et toocht|wat wårde tånke|ja tånke|jam wårde tånke|jat toochten|dü hääst toocht|we hääwe toocht|jam hääwe toocht|jat häin toocht|jat wårde tånke|we tånke|jat tånke|dü toochst|dü häist toocht|ik toocht|än tånk|et tånkt|ik hääw toocht|we häin toocht|wat häin toocht|wat tånke|tu tånken|tånk|ik tånk|toocht|ik wård tånke|wat hääwe toocht|we toochten|et wårt tånke	<i>verb</i><br><ol><li>(Mooring) to think</li></ol>
tååge	<i>noun</i><br><ol><li>(Mooring) roof</li></ol>
tün	<i>noun</i><br><ol><li>(Mooring) garden, yard</li></ol>
ual|äälst|ialst|ääler|ialer	<i>adj</i><br><ol><li>(Föhr-Amrum, Sylt) old</li></ol>
uar|uaren	<i>noun</i><br><ol><li>(Föhr-Amrum, anatomy) ear</li></ol>
uk	<i>adv</i><br><ol><li>(Föhr-Amrum) also; too</li></ol>
unti	<i>conj</i><br><ol><li>(Mooring) or</li></ol>
uug|uugen	<i>noun</i><br><ol><li>(Mooring and Föhr-Amrum dialects, anatomy) eye</li></ol>
uunkem	<i>verb</i><br><ol><li>(Föhr-Amrum) to come</li></ol>
uunskraft|uunskraften	<i>noun</i><br><ol><li>(Föhr-Amrum) address</li></ol>
uurd|uurde	<i>noun</i><br><ol><li>(Mooring) word</li></ol>
uurs	<i>noun</i><br><ol><li>(Mooring) spring</li></ol>
uursmoune	<i>noun</i><br><ol><li>(Mooring) March</li></ol>
waag|waagen	<i>noun</i><br><ol><li>(Föhr-Amrum) wave</li></ol>
waane	<i>noun</i><br><ol><li>(Mooring) friend</li></ol>
wale|ja wan|ik wal|jü|jat wårde wale|jat wänj|we wan|jam hääwe wäljt|ja wänj|we wänj|et wårt wale|jam wan|hi|jam wänj|än wal|wat wårde wale|dü wäist|we wårde wale|ja wårde wale|ja häin wäljt|jam häin wäljt|jat häin wäljt|dü häist wäljt|et heet wäljt|dü wäät|jat wan|et wälj|wäljt|wat häin wäljt|wat hääwe wäljt|dü wårst wale|wat wan|dü hääst wäljt|we hääwe wäljt|ik häi wäljt|we häin wäljt|wat wänj|ja hääwe wäljt|ik wälj|et häi wäljt|tu walen|jam wårde wale|jat hääwe wäljt|ik hääw wäljt|ik wård wale|et wal	<i>verb</i><br><ol><li>(Mooring) to want</li></ol>
wan|ik woon|wi haa wonen|dü woonst|wat skel wan|wi wan|ik wan|wat wel wan|wat woon|dü wääl wan|hat|jat wel wan|jo woon|jo wan|jat woon|jam wan|at hee wonen|ik haa wonen|hi|wat hed wonen|wi wel wan|jam skel wan|jo haa wonen|jam wel wan|wan'em|wi hed wonen|ik skal wan|wonen|jat haa wonen|wat haa wonen|jat skel wan|jo wel wan|jat wan|ik wal wan|dü heest wonen|ik hed wonen|wi skel wan|jat hed wonen|at wal wan|jam hed wonen|wi woon|wat wan|jo skel wan|jam haa wonen|jo hed wonen|dü skääl wan|tu wanen|at woon|at skal wan|dü hedst wonen|dü wanst|at want|at hed wonen|jam woon	<i>verb</i><br><ol><li>(Föhr-Amrum Dialect) to win</li></ol>
waning|waninge	<i>noun</i><br><ol><li>(Mooring) window</li></ol>
wat	<i>pron</i><br><ol><li>(first person dual personal pronoun) we two, both of us, us two</li></ol>
weeder|weedern	<i>noun</i><br><ol><li>(Föhr-Amrum) water</li></ol>
ween	<i>adj</i><br><ol><li>blue</li></ol>
wees|tu weesen|wi wiar weesen|dü skääl wees|wat san weesen|jam wiar weesen|jü|dü wiarst weesen|hat wiar|jo san|ik san weesen|hat as|wat wiar weesen|wat san|wees'em|ik wal wees|hi|jo wel wees|ik wiar weesen|dü wääl wees|ik wiar|dü wiarst|dü beest|wi wel wees|ik skal wees|dü beest weesen|jam wiar|weesen|jo wiar|jam wel wees|jo wiar weesen|jam san weesen|hat wal wees|jat wiar weesen|wat wiar|hat wiar weesen|ik san|jat san|wi wiar|wat skel wees|wi skel wees|jat san weesen|jo san weesen|wat wel wees|jam skel wees|hat as weesen|hat skal wees|jo skel wees|jat skel wees|wi san weesen|jam san|wi san|jat wiar	<i>verb</i><br><ol><li>(Föhr-Amrum, Heligoland) to be</li></ol>
weese|ja wårde weese|ik wus|jü|wees|dü wiarst weesen|jo san|et wårt weese|dü bast wään|et as wään|ik wård weese|dü beest|jam wårde weese|dü wårst weese|wii weern wään|ik wus wään|weesen|jo wiar weesen|wii weern|jam san weesen|hat wal wees|hat wiar weesen|ik san|jat san|ja san|wat skel wees|än wees|jo skel wees|jam schin weese|tu weesen|dü skääl wees|jam wiar weesen|du schääl|du weerst wään|du bäst|ik san weesen|hat as|dü wjarst|wat san|wees'em|wii schin weese|hi|ik ban wään|du bäst wään|jam wjarn wään|wii sän wään|we san|jam sän wään|ik wiar weesen|jä win weese|du wääl|dü beest weesen|ik skal wees|jat san wään|wäät weese|wii win weese|ik waos wään|jat wjarn wään|dat waos wään|ik wal weese|we san wään|jam wjarn|jo san weesen|wat wel wees|jam skel wees|we wjarn wään|jä sän|ik schal weese|jat skel wees|et wus|jat wiar|dü wjarst wään|jä sän wään|wi wiar weesen|wat san weesen|wat wjarn|jat wårde weese|ik bän|ja san wään|ik wal wees|jam win weese|jä weern wään|jo wel wees|et wus wään|dü wiarst|wään|dat schal weese|wat wjarn wään|wat san wään|dat is|ik ban|schäät weese|jam san wään|dü bast|ik bän wään|jat san weesen|hat skal wees|wi san weesen|jam san|wi san|du weerst|et as|jam weern wään|hat wiar|ja wjarn wään|wat wiar weesen|jat wjarn|dü wääl wees|ik wiar|wi wel wees|ik waos|jam sän|we wjarn|dat wal weese|jam wiar|jä schin weese|ju|dat waos|jo wiar|jam wel wees|jam weern|jä weern|jat wiar weesen|wat wiar|hii|wi wiar|wi skel wees|wat wårde weese|ja wjarn|we wårde weese|hat as weesen|wii sän|dat is wään	<i>verb</i><br><ol><li>(Mooring, Halligen) to be</li></ol>
weesegödj	<i>adv</i><br><ol><li>please</li></ol>
weg|wegen	<i>noun</i><br><ol><li>(Föhr-Amrum) week</li></ol>
wel|ik wal wel|ik haa wulen|dü wääl wel|ik wal|jam haa wulen|dü wulst|hat|jam skel wel|at hed wulen|at wal wel|dü heest wulen|wi skel wel|dü skääl wel|jo hed wulen|hi|ik hed wulen|wat wel|wi hed wulen|ik skal wel|wat wel wel|jam wel wel|jo skel wel|jat haa wulen|wat skel wel|wat wul|jam hed wulen|jam wel|ik wul|at wul|wulen|jat wel|at hee wulen|jo wul|dü wääl|jat hed wulen|jo haa wulen|wi wel|jo wel wel|jat wel wel|dü hedst wulen|jo wel|wi haa wulen|jam wul|jat skel wel|wi wul|jat wul|at skal wel|at wal|wat hed wulen|wi wel wel|wat haa wulen	<i>verb</i><br><ol><li>(Föhr-Amrum Dialect) to want</li><li>(Föhr-Amrum Dialect) shall, will (future tense auxiliary verb)</li></ol>
wi	<i>pron</i><br><ol><li>we</li></ol>
wiis|es|best|sen|wiar|wesen	<i>verb</i><br><ol><li>(Sylt) to be</li></ol>
win	<i>noun</i><br><ol><li>(Mooring) wind</li><li>(Mooring) wine</li></ol>
winj	<i>noun</i><br><ol><li>(Föhr-Amrum) wind</li></ol>
wit	<i>adj</i><br><ol><li>(Sylt) white</li></ol>
witj	<i>adj</i><br><ol><li>(Föhr-Amrum) white</li></ol>
wolk|wolken	<i>noun</i><br><ol><li>(Föhr-Amrum) cloud</li></ol>
wonter|wontern	<i>noun</i><br><ol><li>(Föhr-Amrum) winter</li></ol>
wråål	<i>noun</i><br><ol><li>(Mooring) world</li></ol>
wunter|wuntre	<i>noun</i><br><ol><li>(Mooring) winter</li></ol>
wurd|jam skel wurd|wat san wurden|jam wiar wurden|dü beest wurden|hat|ik san wurden|dü skääl wurd|wurd'em|ik skal wurd|hi|wat wiar wurden|ik wiar wurden|jat san wurden|wat skel wurd|at as wurden|wat wel wurd|jam wel wurd|at wiar wurden|ik wurd|at wal wurd|at wurt|ik wal wurd|at wurd|jo san wurden|jo skel wurd|jo wel wurd|tu wurden|jat wurd|jat wel wurd|wi wurd|wi wel wurd|wi skel wurd|wi wiar wurden|jam san wurden|dü wiarst wurden|jo wurd|wat wurd|at skal wurd|dü wurdst|jam wurd|dü wääl wurd|jo wiar wurden|jat wiar wurden|jat skel wurd|dü wurst|wurden|wi san wurden	<i>noun</i><br><ol><li>(Föhr-Amrum) word</li></ol><br><i>verb</i><br><ol><li>(Föhr-Amrum) to become</li></ol>
wääder	<i>noun</i><br><ol><li>(Mooring) weather</li></ol>
wååder	<i>noun</i><br><ol><li>(Mooring dialect) water</li></ol>
wöning|wönger	<i>noun</i><br><ol><li>(Föhr-Amrum) window</li></ol>
wörem|wörmer	<i>noun</i><br><ol><li>(Föhr-Amrum) worm</li></ol>
wü	<i>pron</i><br><ol><li>(Sylt) we, (first person plural pronoun)</li></ol>
wüset	<i>noun</i><br><ol><li>(Mooring) woman</li></ol>
Önereersk|Önereersken	<i>noun</i><br><ol><li>(Sylt) gnome, dwarf (underground folkloric creature)</li></ol>
än	<i>conj</i><br><ol><li>(Mooring) and</li></ol>
ärj|eerist|eere	<i>adj</i><br><ol><li>(Mooring) bad</li></ol>
ärm|ärme	<i>noun</i><br><ol><li>(Mooring) (anatomy) arm</li></ol>
ääse	<i>verb</i><br><ol><li>(Mooring) to eat</li></ol>
ån	<i>num</i><br><ol><li>(Mooring) one</li></ol>
åte	<i>noun</i><br><ol><li>(Mooring) grandfather</li></ol>
ååle	<i>noun</i><br><ol><li>(Mooring) grandmother</li></ol>
ååpel|ååple	<i>noun</i><br><ol><li>(Mooring) apple</li></ol>
ååwe|ååwe (n)	<i>noun</i><br><ol><li>ape, monkey</li></ol>
öler	<i>adj</i><br><ol><li>(Föhr-Amrum) second</li><li>(Föhr-Amrum) other</li></ol>
önj	<i>prep</i><br><ol><li>(Mooring) in</li></ol>
önjfånge	<i>verb</i><br><ol><li>(Mooring) to begin, to start</li></ol>
önjschraft|önjschrafte	<i>noun</i><br><ol><li>address</li></ol>
öönfange	<i>verb</i><br><ol><li>(Halligen) to begin, to start</li></ol>
üs	<i>pron</i><br><ol><li>us (second personal pronoun plural objective)</li><li>our, ours (second personal pronoun plural possessive)</li></ol>
üülj|åler|ålst	<i>adj</i><br><ol><li>(Mooring) old</li></ol>
üüs	<i>pron</i><br><ol><li>(Sylt) us, (first person plural object pronoun)</li></ol><br><i>det</i><br><ol><li>(Sylt) our</li></ol>
üđer	<i>adj</i><br><ol><li>(Sylt) other</li><li>(Sylt) second</li></ol>
ārig|āriger|ārigst	<i>adj</i><br><ol><li>(Sylt) angry</li></ol>
