'njiyun	<i>romanization</i><br><ol><li>Rōmaji transcription of っんじゆん</li></ol>
'nmaribī	<i>romanization</i><br><ol><li>Rōmaji transcription of っんまりびー</li></ol>
'wījun	<i>romanization</i><br><ol><li>Rōmaji transcription of っゐーじゅん</li></ol>
Betonamu	<i>romanization</i><br><ol><li>Rōmaji transcription of ベトナム</li></ol>
Fuchan	<i>romanization</i><br><ol><li>Rōmaji transcription of ふちゃん</li><li>Rōmaji transcription of フチャン</li></ol>
Furanshi	<i>romanization</i><br><ol><li>Rōmaji transcription of フランシ</li></ol>
Kagushima	<i>romanization</i><br><ol><li>Rōmaji transcription of かぐしま</li></ol>
Kwantun	<i>romanization</i><br><ol><li>Rōmaji transcription of くゎんとぅん</li><li>Rōmaji transcription of クヮントゥン</li></ol>
Mongoru	<i>romanization</i><br><ol><li>Rōmaji transcription of モンゴル</li></ol>
Uchinā	<i>romanization</i><br><ol><li>Rōmaji transcription of うちなー</li></ol>
Uchināguchi	<i>romanization</i><br><ol><li>Rōmaji transcription of うちなーぐち</li></ol>
Yamatu	<i>romanization</i><br><ol><li>Rōmaji transcription of やまとぅ</li></ol>
achi	<i>romanization</i><br><ol><li>Rōmaji transcription of あち</li></ol>
aka	<i>romanization</i><br><ol><li>Rōmaji transcription of あか</li></ol>
angwā	<i>romanization</i><br><ol><li>Rōmaji transcription of あんぐゎー</li></ol>
ashi	<i>romanization</i><br><ol><li>Rōmaji transcription of あし</li></ol>
bushi	<i>romanization</i><br><ol><li>Rōmaji transcription of ぶし</li></ol>
fuyu	<i>romanization</i><br><ol><li>Rōmaji transcription of ふゆ</li></ol>
gōburēki	<i>romanization</i><br><ol><li>Rōmaji transcription of ゴーブレーキ</li></ol>
hachā	<i>romanization</i><br><ol><li>Rōmaji transcription of はちゃー</li></ol>
hai	<i>romanization</i><br><ol><li>Rōmaji transcription of はい</li></ol>
haisai	<i>romanization</i><br><ol><li>Rōmaji transcription of はいさい</li></ol>
haitai	
irichi	<i>romanization</i><br><ol><li>Rōmaji transcription of いりち</li></ol>
kachun	<i>romanization</i><br><ol><li>Rōmaji transcription of かちゅん</li></ol>
kamun	<i>romanization</i><br><ol><li>Rōmaji transcription of かむん</li></ol>
kanasan	<i>romanization</i><br><ol><li>Rōmaji transcription of かなさん</li></ol>
kansui	<i>romanization</i><br><ol><li>Rōmaji transcription of かんすい</li></ol>
kuma	<i>romanization</i><br><ol><li>Rōmaji transcription of くま</li></ol>
kumu	<i>romanization</i><br><ol><li>Rōmaji transcription of くむ</li></ol>
machun	<i>romanization</i><br><ol><li>Rōmaji transcription of まちゅん</li></ol>
mijiushi	<i>romanization</i><br><ol><li>Rōmaji transcription of みじうし</li></ol>
mutu	<i>romanization</i><br><ol><li>Rōmaji transcription of むとぅ</li></ol>
mē	<i>romanization</i><br><ol><li>Rōmaji transcription of めー</li></ol>
mīchi	<i>romanization</i><br><ol><li>Rōmaji transcription of みーち</li></ol>
nanachi	<i>romanization</i><br><ol><li>Rōmaji transcription of ななち</li></ol>
nchun	<i>verb</i><br><ol><li>Rōmaji transcription of んちゅん</li></ol>
nji	<i>romanization</i><br><ol><li>Rōmaji transcription of んじ</li></ol>
numi	<i>romanization</i><br><ol><li>Rōmaji transcription of ぬみ</li></ol>
saki	<i>romanization</i><br><ol><li>Rōmaji transcription of さき</li></ol>
sanshin	<i>romanization</i><br><ol><li>Rōmaji transcription of さんしん</li></ol>
sashin	<i>romanization</i><br><ol><li>Rōmaji transcription of さしん</li></ol>
sun	<i>verb</i><br><ol><li>romanized of すん</li></ol>
sōyū	<i>romanization</i><br><ol><li>Rōmaji transcription of そーゆー</li></ol>
tui	<i>romanization</i><br><ol><li>Rōmaji transcription of とぅい</li></ol>
tunai	<i>romanization</i><br><ol><li>Rōmaji transcription of とぅない</li></ol>
tura	<i>romanization</i><br><ol><li>Rōmaji transcription of とぅら</li></ol>
uchinānchu	<i>romanization</i><br><ol><li>Rōmaji transcription of うちなーんちゅ</li></ol>
ufusan	<i>romanization</i><br><ol><li>Rōmaji transcription of うふさん</li></ol>
ufutchu	<i>romanization</i><br><ol><li>Rōmaji transcription of うふっちゅ</li></ol>
umaribī	<i>romanization</i><br><ol><li>Rōmaji transcription of うまりびー</li></ol>
ushi nu chī	<i>romanization</i><br><ol><li>Rōmaji transcription of うしぬちー</li></ol>
utuna	<i>romanization</i><br><ol><li>Rōmaji transcription of うとぅな</li></ol>
wan	<i>romanization</i><br><ol><li>Rōmaji transcription of わん</li></ol>
wō	<i>romanization</i><br><ol><li>Rōmaji transcription of をー</li></ol>
yamatunchu	<i>romanization</i><br><ol><li>Rōmaji transcription of やまとぅんちゅ</li></ol>
yu	<i>romanization</i><br><ol><li>Rōmaji transcription of ゆ</li></ol>
yuchi	<i>romanization</i><br><ol><li>Rōmaji transcription of ゆち</li></ol>
yēgo	<i>romanization</i><br><ol><li>Rōmaji transcription of いぇーご</li></ol>
yūrī	<i>noun</i><br><ol><li>romanized of ゆーりー</li></ol>
ūmiji	<i>romanization</i><br><ol><li>Rōmaji transcription of うーみじ</li></ol>
あい|ai	<i>noun</i><br><ol><li>蟻: ant</li></ol>
あか|aka	<i>noun</i><br><ol><li>赤: red</li></ol>
あかい|akai	<i>noun</i><br><ol><li>明かい: light</li></ol>
あがっ|aga'	<i>intj</i><br><ol><li>ouch, ow</li></ol>
あがり|agari	<i>noun</i><br><ol><li>東: east, eastern, eastward, in the east</li><li>上り: ascent, rising</li></ol>
あし|ashi	<i>noun</i><br><ol><li>汗: sweat</li><li>足: foot</li></ol>
あち|achi	<i>noun</i><br><ol><li>秋: autumn; fall</li></ol>
あちさん|achisan	<i>adj</i><br><ol><li>熱さん: hot (to touch)</li><li>暑さん: hot (said of a natural phenomenon such as the weather)</li></ol>
あみ|ami	<i>noun</i><br><ol><li>雨: rain</li></ol>
あん|an	<i>verb</i><br><ol><li>有ん: to be</li></ol>
あんぐゎー|angwā	<i>noun</i><br><ol><li>older sister</li></ol>
あんだ|anda	<i>noun</i><br><ol><li>油: oil</li></ol>
あんまー|anmā	<i>noun</i><br><ol><li>(familiar) A term used to refer to one's own mother: "Mom; mum; mama; momma; mother"</li></ol>
あー|Ā|ā	<i>suffix</i><br><ol><li>(sometimes derogatory) A suffix or ending used to indicate the subject of an adjective, noun or nominalized verb, akin to "-man", "-er" or "person" in English.</li><li>(derogatory) Used to indicate the provenance of a person</li><li>A suffix attached to warabi-naa (Okinawan traditional given name) of samuree (Ryukyuan aristocracy) to indicate the name of hyakushoo (Ryukyuan commoner).</li><li>A suffix attached to words for animals. Sometimes, the original, non-suffixed form is not used.</li></ol><br><i>noun</i><br><ol><li>泡: bubble</li></ol><br><i>name</i><br><ol><li>安和: Awa</li></ol><br><i>intj</i><br><ol><li>あー: oh! ah! (voice you make when you feel deeply about something)</li></ol>
あーさ|āsa	<i>noun</i><br><ol><li>石蓴: sea lettuce</li></ol>
いぃだ|yida	<i>noun</i><br><ol><li>枝: branch</li></ol>
いう|iu	<i>noun</i><br><ol><li>魚: fish</li></ol>
いぇーご|yēgo	<i>noun</i><br><ol><li>英語: English; the English language</li></ol>
いぇーま|Yēma	<i>name</i><br><ol><li>八重山: Yaeyama</li></ol>
いぇーまぐち|Yēmaguchi	<i>noun</i><br><ol><li>八重山口: Yaeyama language</li></ol>
いかい|ikai	<i>noun</i><br><ol><li>錨, 碇: anchor</li></ol>
いくさ|ikusa	<i>noun</i><br><ol><li>戦: war, battle, combat</li><li>軍: soldier</li></ol>
いさ|isa	<i>noun</i><br><ol><li>医者: doctor</li></ol>
いし|ishi	<i>noun</i><br><ol><li>石: stone</li></ol>
いちち|ichichi	<i>noun</i><br><ol><li>five (things)</li><li>five years old</li></ol>
いちちゅん|いちち|いちか|ichikan|ichicha|いちちゅ|ichichuru|ichikasun|いちちゃ|いちかすん|いちちぇーうぅらん|ichichi|ichikariyun|ichichabī|いちかりゆん|ichichibusan|いちかー|ichika|いちちぇー|ichikā|いちちょー|ichichun|いちちぶさん|ichichēwuran|いちき|いちちゃびー|ichichu|ichiki|いちちゅる|いちかん|ichichō|ichichē	<i>verb</i><br><ol><li>to live</li></ol>
いちゃい|ichai	<i>noun</i><br><ol><li>錨, 碇: anchor</li></ol>
いちゅび|ichubi	<i>noun</i><br><ol><li>苺, 莓: strawberry</li></ol>
いぬち|inuchi	<i>noun</i><br><ol><li>命: life</li></ol>
いみ|imi	<i>noun</i><br><ol><li>夢: dream</li></ol>
いゆ|iyu	<i>noun</i><br><ol><li>魚: fish</li></ol>
いゆん|iyun	<i>verb</i><br><ol><li>need</li></ol>
いり|iri	<i>noun</i><br><ol><li>西: west</li></ol>
いりがんぶし|iriganbushi	<i>noun</i><br><ol><li>入り髪星: comet</li></ol>
いりち|irichi	<i>noun</i><br><ol><li>鱗: scale (of a fish, reptile, etc); dandruff</li></ol>
いん|in	<i>noun</i><br><ol><li>犬: dog</li></ol>
いーち|īchi	<i>noun</i><br><ol><li>息: breath</li></ol>
いーび|ībi|いいび	<i>noun</i><br><ol><li>指: finger</li></ol>
うきゆん|ukiyun	<i>verb</i><br><ol><li>起きゆん: to wake up</li></ol>
うし|ʔusi	<i>noun</i><br><ol><li>牛: cow</li></ol>
うしぬちー|ushi nu chī	<i>noun</i><br><ol><li>牛ぬ乳: cow's milk</li></ol>
うしゅん|ushun	<i>verb</i><br><ol><li>押しゅん: to push</li></ol>
うた|uta	<i>noun</i><br><ol><li>歌: song</li></ol>
うちなー|Uchinā	<i>name</i><br><ol><li>沖縄: Okinawa</li></ol>
うちなーぐち|Uchināguchi	<i>noun</i><br><ol><li>沖縄口: Okinawan language</li></ol>
うちなーんちゅ|uchinānchu	<i>noun</i><br><ol><li>沖縄ん人: Okinawan person, Okinawan people</li></ol>
うとぅ|utu	<i>noun</i><br><ol><li>音: sound</li></ol>
うとぅな|utuna	<i>noun</i><br><ol><li>大人: adult</li></ol>
うふさん|ufusan	<i>adj</i><br><ol><li>多さん: many</li></ol>
うふっちゅ|ufutchu	<i>noun</i><br><ol><li>大人: adult</li></ol>
うふやまとぅんちゅ|ufuyamatunchu	<i>noun</i><br><ol><li>大大和ん人: Japanese person, non-Ryukyuan Japanese people, a mainlander</li></ol>
うまりびー|umaribī	<i>noun</i><br><ol><li>生日, 生まり日: birthday</li></ol>
うんがく|ungaku	<i>noun</i><br><ol><li>音楽: music</li></ol>
うんじゅ|unju	<i>pron</i><br><ol><li>御所: you (second-person pronoun)</li></ol>
うんすー|unsū	<i>noun</i><br><ol><li>fate, destiny</li></ol>
うーじ|ūji	<i>noun</i><br><ol><li>Clipping of 砂糖荻 (sātāūji): sugarcane</li></ol>
うーに|ūni	<i>noun</i><br><ol><li>(honorific) ship</li></ol>
うーみじ|ūmiji	<i>noun</i><br><ol><li>大水: flood</li></ol>
う菓子|御菓子|ukwāshi|うくゎーし	<i>noun</i><br><ol><li>sweet, confection</li><li>candy</li><li>pastry, cake, cookie</li></ol>
かがん|kagan	<i>noun</i><br><ol><li>鏡: mirror</li></ol>
かくしまじま|kakushimajima	<i>noun</i><br><ol><li>各島々: each island, every island</li></ol>
かぐしま|Kagushima	<i>name</i><br><ol><li>鹿児島: Kagoshima, Japan</li></ol>
かじ|kaji	<i>noun</i><br><ol><li>風: wind</li></ol>
かちゅん|kachun	<i>verb</i><br><ol><li>書ちゅん: to write</li></ol>
かなさん|kanasan	<i>noun</i><br><ol><li>愛さん: cute, adorable, pretty</li></ol>
かぬん|kanun	<i>verb</i><br><ol><li>食ぬん: to eat</li></ol>
かみにげー|kaminigē	<i>noun</i><br><ol><li>prayer</li></ol>
かみはぶ|kamihabu	<i>noun</i><br><ol><li>newspaper</li></ol>
かむん|kamun	<i>verb</i><br><ol><li>食むん: to eat</li></ol>
かんぐく|kanguku	<i>noun</i><br><ol><li>監獄: prison</li></ol>
かんじ	<i>noun</i><br><ol><li>漢字: Chinese character</li></ol>
かんすい|kansui	<i>noun</i><br><ol><li>剃刀: razor</li></ol>
かんだ|kanda	<i>noun</i><br><ol><li>creeper plant, vine</li><li>sweet potato</li></ol>
かんない|kannai	<i>noun</i><br><ol><li>雷: thunder</li></ol>
かーぶやー|kābuyā	<i>noun</i><br><ol><li>蝙蝠: bat (small flying mammal)</li></ol>
が|ga	<i>particle</i><br><ol><li>genitive case marker</li><li>Indicates possession: of, -'s</li><li>nominative case marker</li><li>Indicates the subject of a sentence.</li><li>particle indicating purpose/intent; for; to</li><li>final interrogative particle, similar to a question mark ("?"). Appear only in wh-questions,but followed by やー can be used in other interrogations.</li></ol>
がんちょー|ganchō	<i>noun</i><br><ol><li>眼鏡: glasses</li></ol>
がー|gā	<i>noun</i><br><ol><li>蛾: moth</li></ol>
きじ|kiji	<i>noun</i><br><ol><li>傷: wound</li></ol>
きー|kī	<i>noun</i><br><ol><li>毛: hair, fur</li><li>木: tree</li></ol>
きーうい|kīui	<i>noun</i><br><ol><li>胡瓜: cucumber</li></ol>
きーさち|kīsachi	<i>noun</i><br><ol><li>警察: police</li></ol>
くぃー|kwī	<i>noun</i><br><ol><li>声: voice; news (of someone), word (of someone)</li></ol>
くくぬち|kukunuchi	<i>noun</i><br><ol><li>nine (things)</li><li>nine years old</li></ol>
くくる|kukuru	<i>noun</i><br><ol><li>心: heart</li></ol>
くさ|kusa	<i>noun</i><br><ol><li>grass</li></ol>
くち|kuchi	<i>noun</i><br><ol><li>口: mouth, language, dialect, speech</li><li>骨: remains, ashes</li></ol>
くとぅば|kutuba	<i>noun</i><br><ol><li>言葉, 辞, 詞, 辭: language, speech, dialect, word(s), idiom</li></ol>
くび|kubi	<i>noun</i><br><ol><li>neck</li></ol>
くま|kuma	<i>noun</i><br><ol><li>熊: bear</li></ol>
くむ|kumu	<i>noun</i><br><ol><li>雲: cloud</li></ol>
くり|kurē|kuri|くれー	<i>pron</i><br><ol><li>this</li></ol>
くるま|kuruma	<i>noun</i><br><ol><li>車: car, wheel</li></ol>
くゎんとぅん|Kwantun	<i>name</i><br><ol><li>広東: Guangdong</li></ol>
くゎんふぁー|kwanfā	<i>noun</i><br><ol><li>官話: Mandarin; Guanhua (group of Northern Chinese dialects including Putonghua (Standard Chinese))</li></ol>
くーばー|kūbā	<i>noun</i><br><ol><li>蜘蛛: spider</li></ol>
ぐじら|gujira	<i>noun</i><br><ol><li>鯨: whale</li></ol>
ぐゎち|gwachi	<i>noun</i><br><ol><li>月: month</li></ol>
さかな|sakana	<i>noun</i><br><ol><li>fish</li></ol>
さき|saki	<i>noun</i><br><ol><li>酒: alcohol beverage (e.g., wine, whisky, or sake)</li></ol>
さしん|sashin	<i>noun</i><br><ol><li>写真: photograph</li></ol>
さち|sachi	<i>noun</i><br><ol><li>鯱: orca</li></ol>
さばち|sabachi	<i>noun</i><br><ol><li>comb</li></ol>
さん|san	<i>noun</i><br><ol><li>山: mountain</li></ol><br><i>suffix</i><br><ol><li>Terminal-form ending for inflected adjectives.</li></ol>
さんぐ|sangu	<i>noun</i><br><ol><li>珊瑚: coral</li></ol>
さんさなー|sansanā	<i>noun</i><br><ol><li>a cicada of the species Cryptotympana facialis</li><li>tomboy</li></ol>
さんしん|sanshin	<i>noun</i><br><ol><li>三線: fretless picked lute of Okinawan origin with three strings and skin-covered body, precursor to the shamisen</li></ol>
ざくら|zakura	<i>noun</i><br><ol><li>石榴: pomegranate</li></ol>
しけー|shikē	<i>noun</i><br><ol><li>世界: world, society</li></ol>
しじん|shijin	<i>noun</i><br><ol><li>自然: nature</li></ol>
しちゃ|shicha	<i>noun</i><br><ol><li>下: under</li><li>舌: tongue</li></ol>
しちゃじ|shichaji	<i>noun</i><br><ol><li>下着: underwear</li></ol>
しちゃふぃじ|shichafiji	<i>noun</i><br><ol><li>beard</li></ol>
してぃゆん|shitiyun	<i>verb</i><br><ol><li>捨てぃゆん: to abandon</li></ol>
しば|shiba	<i>noun</i><br><ol><li>唇: lip, tongue</li></ol>
しぴゆん|shipiyun	<i>verb</i><br><ol><li>to blow one's nose</li></ol>
しま|shima	<i>noun</i><br><ol><li>島: community, island</li></ol>
しむち|shimuchi	<i>noun</i><br><ol><li>書物: book</li></ol>
しーし|shīshi	<i>noun</i><br><ol><li>煤: soot</li></ol>
しーじ|shīji	<i>noun</i><br><ol><li>政治: politics, government</li></ol>
しーじゃ|shīja	<i>noun</i><br><ol><li>older brother</li><li>older sister</li><li>senior</li></ol>
じゆー|jiyū	<i>noun</i><br><ol><li>自由: freedom</li></ol>
じーなー|jīnā	<i>noun</i><br><ol><li>firefly</li></ol>
すみ|sumi	<i>noun</i><br><ol><li>趣味: hobby; taste, preference</li></ol>
すむち|sumuchi	<i>noun</i><br><ol><li>書物: book</li></ol>
すら|sura	<i>noun</i><br><ol><li>空: sky</li></ol>
すん|sun	<i>verb</i><br><ol><li>to do</li><li>(auxiliary) Creates verbs out of nouns.</li></ol>
すー|sū	<i>noun</i><br><ol><li>father, dad</li></ol>
そーゆー|sōyū	<i>noun</i><br><ol><li>醤油: soy sauce</li></ol>
たたかゆん|tatakayun	<i>verb</i><br><ol><li>戦ゆん: to fight</li></ol>
たたちゅん|tatachun	<i>verb</i><br><ol><li>叩ちゅん: to hit, strike</li></ol>
たに|tani	<i>noun</i><br><ol><li>valley</li></ol>
たぬき|tanuki	<i>noun</i><br><ol><li>狸: raccoon dog</li></ol>
たまし|tamashi	<i>noun</i><br><ol><li>魂: soul, spirit, mind</li></ol>
たましー|tamashī	<i>noun</i><br><ol><li>魂: soul of the dead</li></ol>
たまなー|tamanā	<i>noun</i><br><ol><li>玉菜: cabbage</li></ol>
たーち|tāchi	<i>noun</i><br><ol><li>two (things)</li><li>two years old</li></ol>
たーりー|tārī	<i>noun</i><br><ol><li>father</li></ol>
ちち|chichi	<i>noun</i><br><ol><li>月: moon</li></ol>
ちちに|chitsini|chichini|ちつィに	<i>noun</i><br><ol><li>狐: fox</li></ol>
ちな|china	<i>noun</i><br><ol><li>綱: rope</li></ol>
ちび|chibi	<i>noun</i><br><ol><li>尻: butt</li></ol>
ちびぬみー|chibi nu mī	<i>noun</i><br><ol><li>尻ぬ目: anus</li></ol>
ちぶる|chiburu	<i>noun</i><br><ol><li>頭: head; an intelligent person</li></ol>
ちぶるやん|chiburuyan	<i>noun</i><br><ol><li>頭病ん: headache</li></ol>
ちゃんぷるー|chanpurū	<i>noun</i><br><ol><li>a stir-fried dish consisting of tofu, vegetables, and cooking oil</li></ol>
ちゅあみ|chuami	<i>noun</i><br><ol><li>一雨: rainfall, shower</li></ol>
ちゅいだち|chuidachi	<i>noun</i><br><ol><li>independence</li></ol>
ちゅくゆん|chukuyun	<i>verb</i><br><ol><li>作ゆん: to make</li></ol>
ちゅらさん|churasan	<i>adj</i><br><ol><li>清らさん: beautiful</li></ol>
ちらー|chirā	<i>noun</i><br><ol><li>face</li></ol>
ちん|chin	<i>noun</i><br><ol><li>衣: kimono</li></ol>
ちー|chī	<i>noun</i><br><ol><li>血: blood</li></ol>
ちーさち|chīsachi	<i>noun</i><br><ol><li>警察: police</li></ol>
ちーちゃー|chīchā	<i>noun</i><br><ol><li>(childish) dog</li></ol>
ちーるー|chīrū	<i>noun</i><br><ol><li>黄色: yellow</li></ol>
っちゅ|tchu	<i>noun</i><br><ol><li>人: person, human</li></ol>
っやー|'yā	<i>pron</i><br><ol><li>(informal) second-person pronoun: you</li></ol>
っわー|'wā	<i>noun</i><br><ol><li>豚: pig, swine, hog</li></ol>
っゐーじゅん|'wījun	<i>verb</i><br><ol><li>泳じゅん: to swim</li></ol>
っんじゆん|'njiyun	<i>verb</i><br><ol><li>出ゆん: to go out</li></ol>
っんまりびー|'nmaribī	<i>noun</i><br><ol><li>生日, 生まり日: a birthday</li></ol>
てぃち|tichi	<i>noun</i><br><ol><li>鐵: iron</li></ol>
てぃっこー|tikkō	<i>noun</i><br><ol><li>手甲: back of the hand</li></ol>
てぃんさぐ|tinsagu	<i>noun</i><br><ol><li>Impatiens balsamina; balsam</li></ol>
てぃー|tī	<i>noun</i><br><ol><li>手: hand</li></ol>
てぃーち|tīchi	<i>noun</i><br><ol><li>one (thing)</li><li>one-year-old</li></ol>
でーびる|dēbiru	<i>verb</i><br><ol><li>(polite) To be.</li></ol>
とぅい|tui	<i>noun</i><br><ol><li>鳥: bird; chicken</li></ol>
とぅくぬしま|Tukunushima	<i>name</i><br><ol><li>徳之島: Tokunoshima (an island)</li></ol>
とぅじ|tuji	<i>noun</i><br><ol><li>刀自: wife</li></ol>
とぅない|tunai	<i>noun</i><br><ol><li>隣: neighbour</li></ol>
とぅら|tura	<i>noun</i><br><ol><li>虎: tiger</li></ol>
とーちょー|Tōchō	<i>name</i><br><ol><li>東京: Tokyo</li></ol>
どぅぐゎい|dugwai	<i>noun</i><br><ol><li>蘆薈: aloe (plant of the genus Aloe)</li></ol>
どぅし|dushi	<i>noun</i><br><ol><li>同士: friend</li></ol>
どぅー|dū	<i>pron</i><br><ol><li>reflexive pronoun</li></ol>
どーしー|dōshī	<i>noun</i><br><ol><li>同性: homosexual; homosexuality; same sex</li></ol>
なさき|nasaki	<i>noun</i><br><ol><li>love</li></ol>
ななち|nanachi	<i>noun</i><br><ol><li>seven (things)</li><li>seven years old</li></ol>
ななちぶし|Nanachibushi	<i>name</i><br><ol><li>七ち星: Big Dipper; the Plough; the Saptarishi</li></ol>
なー|nā	<i>noun</i><br><ol><li>名: name</li></ol>
なーく|Nāku	<i>name</i><br><ol><li>宮古: Miyako</li></ol>
なーくぐち|Nākuguchi	<i>noun</i><br><ol><li>宮古口: Miyako language</li></ol>
にし|nishi	<i>noun</i><br><ol><li>北: north</li></ol>
にー|nī	<i>noun</i><br><ol><li>根: root</li></ol>
にーびち|nībichi	<i>noun</i><br><ol><li>marriage, wedding</li></ol>
ぬ|nu	<i>particle</i><br><ol><li>genitive case marker</li><li>Indicates possession: of, -'s</li><li>nominative case marker</li><li>Indicates the subject of a sentence.</li></ol>
ぬみ|numi	<i>noun</i><br><ol><li>蚤: flea</li></ol>
ぬー|nū	<i>pron</i><br><ol><li>何: what</li></ol>
ぬーでぃー|nūdī	<i>noun</i><br><ol><li>喉: throat</li></ol>
ぬーでぃーじる|nūdījiru	<i>noun</i><br><ol><li>喉弦: vocal cords</li></ol>
ねーゆん|nēyun	<i>verb</i><br><ol><li>to wither, wilt</li><li>to become weak</li></ol>
のーじ|nōzi	<i>noun</i><br><ol><li>名字, 苗字: surname, family name, last name</li></ol>
はい|hai	<i>intj</i><br><ol><li>(gender-neutral) hello</li></ol>
はいさい|haisai	<i>intj</i><br><ol><li>(men's speech) hello, hi, hey, howdy (used by commoners in Naha)</li></ol>
はいたい|haitai	<i>intj</i><br><ol><li>(women's speech) hello</li></ol>
はく|haku	<i>noun</i><br><ol><li>box</li></ol>
はさん|hasan	<i>noun</i><br><ol><li>鋏: scissors</li><li>stag beetle</li></ol>
はちぐゎち|hachigwachi	<i>noun</i><br><ol><li>八月: the month of August</li></ol>
はちゃー|hachā	<i>noun</i><br><ol><li>蜂: bee; wasp; hornet</li></ol>
はっか|hakka	<i>noun</i><br><ol><li>薄荷: mint</li></ol>
はな|hana	<i>noun</i><br><ol><li>花: flower</li><li>鼻: nose</li></ol>
はなし|hanashi	<i>noun</i><br><ol><li>話, 話し: conversation, speech, story</li></ol>
はなすん|hanasun	<i>verb</i><br><ol><li>話すん: to speak, talk</li></ol>
はに|hani	<i>noun</i><br><ol><li>羽, 翼, 翅, 羽根: feather, wing</li></ol>
はぶ|habu	<i>noun</i><br><ol><li>波布, 蛇: snake, viper, Okinawan habu</li></ol>
はー|hā	<i>noun</i><br><ol><li>歯: tooth</li></ol>
はーい|hāi	<i>noun</i><br><ol><li>針, 鍼: needle</li></ol>
ばー|bā	<i>noun</i><br><ol><li>reason</li></ol>
ひる|hiru	<i>noun</i><br><ol><li>蒜, 葫: garlic</li></ol>
びーる|bīru	<i>noun</i><br><ol><li>蛭: leech</li></ol>
ふぁっか|fakka	<i>noun</i><br><ol><li>薄荷: mint</li></ol>
ふぁー|fā	<i>noun</i><br><ol><li>葉: leaf</li></ol>
ふぃかり|fikari	<i>noun</i><br><ol><li>光: light</li></ol>
ふぃさ|fisa	<i>noun</i><br><ol><li>足: foot</li></ol>
ふぃさなー|fisanā	<i>noun</i><br><ol><li>足甲: top of the foot</li></ol>
ふぃなゆん|finayun	<i>verb</i><br><ol><li>to decrease</li></ol>
ふぃーとぅ|fītu	<i>noun</i><br><ol><li>海豚: dolphin</li></ol>
ふし|husi	<i>noun</i><br><ol><li>星: star</li></ol>
ふちゃん|Fuchan	<i>name</i><br><ol><li>福建: Fujian</li></ol>
ふに|funi	<i>noun</i><br><ol><li>船: boat</li></ol>
ふや|fuya	<i>noun</i><br><ol><li>靴: shoe</li></ol>
ふゆ|fuyu	<i>noun</i><br><ol><li>冬: winter</li></ol>
ふゆん|fuyun	<i>verb</i><br><ol><li>to dig</li></ol>
ふん	<i>counter</i><br><ol><li>本: long cylindrical objects, films or TV shows, home runs or goals</li></ol>
ぶし|bushi	<i>noun</i><br><ol><li>節: a song, poem or musical piece</li><li>a term used in titles to denote a poetic or musical piece</li></ol>
へーさい|hēsai	<i>intj</i><br><ol><li>(Shuri, men's speech) hello</li></ol>
へーたい|hētai	<i>intj</i><br><ol><li>(Shuri, women's speech) hello</li></ol>
ほー|hō	<i>noun</i><br><ol><li>陰: female genitalia</li></ol>
ほーち|hōchi	<i>noun</i><br><ol><li>箒, 帚: broom</li></ol>
ほーちぶし|hōchibushi	<i>noun</i><br><ol><li>箒星: comet</li></ol>
ほーみー|hōmī	<i>noun</i><br><ol><li>陰目: vagina</li></ol>
まぎさん|magisan	<i>adj</i><br><ol><li>big</li></ol>
まさゆん|masayun	<i>verb</i><br><ol><li>勝ゆん: to excel, surpass</li></ol>
まちゅん|machun	<i>verb</i><br><ol><li>待ちゅん: to wait (for)</li><li>巻ちゅん: to roll, to wrap around</li><li>蒔ちゅん, 播ちゅん, 撒ちゅん: to sow, plant, disseminate</li></ol>
まぶい|mabui	<i>noun</i><br><ol><li>spirit</li></ol>
まやー|mayā	<i>noun</i><br><ol><li>猫: cat</li></ol>
まゆー|mayū	<i>noun</i><br><ol><li>猫: cat</li></ol>
まー|mā	<i>adv</i><br><ol><li>where</li></ol>
まーすん|māsun	<i>verb</i><br><ol><li>to die</li></ol>
みじ|miji	<i>noun</i><br><ol><li>水: water</li></ol>
みじうし|mijiushi	<i>noun</i><br><ol><li>水牛: water buffalo</li></ol>
みち|michi	<i>noun</i><br><ol><li>蜜: honey</li></ol>
みん|min	<i>noun</i><br><ol><li>耳: ear</li></ol>
みー|mī	<i>noun</i><br><ol><li>目: eye; sight</li></ol>
みーかがん|mīkagan	<i>noun</i><br><ol><li>眼鏡: glasses</li></ol>
みーがんちょー|mīganchō	<i>noun</i><br><ol><li>目眼鏡: glasses</li></ol>
みーぐるま|mīguruma	<i>noun</i><br><ol><li>新車: new car</li></ol>
みーさん|mīsan	<i>adj</i><br><ol><li>新ーさん: new</li></ol>
みーち|mīchi	<i>noun</i><br><ol><li>three (things)</li><li>three years old</li></ol>
みーやー|mīyā	<i>noun</i><br><ol><li>新家: new house</li></ol>
むちゅん|むた|muchuru|muchabī|muchi|むちゃびー|むたすん|muchibusan|muta|muti|むっちょー|むっちぇーうぅらん|むっち|むっちぇー|むっちゃ|むてぃ|mutchē|むちぶさん|むち|むたん|むちゅ|mutcha|むたりゆん|muchun|mutan|mutchēwuran|むちゅる|mutā|mutasun|muchu|mutchi|mutariyun|むたー|mutchō	<i>verb</i><br><ol><li>to have, possess, hold</li></ol>
むとぅ|mutu	<i>noun</i><br><ol><li>元, 本, 基, 素: source, origin</li></ol>
むぬ|munu	<i>noun</i><br><ol><li>物: thing</li></ol>
むむ|mumu	<i>noun</i><br><ol><li>桃: peach</li><li>腿: thigh, lap</li></ol>
むん|mun	<i>noun</i><br><ol><li>物: thing</li></ol>
むーち|mūchi	<i>noun</i><br><ol><li>six (things)</li><li>six years old</li></ol>
めんそーれー|mensōrē	<i>intj</i><br><ol><li>welcome</li></ol>
めー|mē	<i>counter</i><br><ol><li>枚: counter for flat thin objects or sheets</li></ol><br><i>noun</i><br><ol><li>前: front</li></ol><br><i>prefix</i><br><ol><li>毎: each, every (day, week, weekend, time)</li></ol>
もしもし|romāji moshi moshi	<i>intj</i><br><ol><li>A common telephone greeting: hello; used when answering the telephone.</li></ol>
や|ya	<i>particle</i><br><ol><li>topic marker</li></ol>
やまとぅ|Yamatu	<i>name</i><br><ol><li>大和: Japan</li></ol>
やまとぅぐち|Yamatuguchi	<i>noun</i><br><ol><li>大和口: Japanese language</li></ol>
やまとぅんちゅ|yamatunchu	<i>noun</i><br><ol><li>大和ん人: Japanese person, non-Ryukyuan Japanese people, a mainlander</li></ol>
やんばるくみらー|Yanbaru kumirā	<i>noun</i><br><ol><li>山原水鶏: an Okinawa rail</li></ol>
やー|yā	<i>noun</i><br><ol><li>家: house</li></ol>
やーち|yāchi	<i>noun</i><br><ol><li>eight (things)</li><li>eight years old</li></ol>
ゆ|yu	<i>particle</i><br><ol><li>(archaic, literary, with transitive verb) accusative case particle</li><li>(archaic, literary, with intransitive verb) away from, off</li><li>(archaic, literary, with intransitive verb) along, following a specified route, track, orbit, etc.</li></ol>
ゆさんでぃ|yusandi	<i>noun</i><br><ol><li>evening</li></ol>
ゆしーん|yushīn	<i>verb</i><br><ol><li>寄しーん: to approach, call</li></ol>
ゆだ|yuda	<i>noun</i><br><ol><li>枝: branch</li></ol>
ゆち|yuchi	<i>noun</i><br><ol><li>雪: hail; snow</li></ol>
ゆなぐに|Yunaguni	<i>name</i><br><ol><li>与那国: Yonaguni</li></ol>
ゆなぐにぐち|Yunaguniguchi	<i>noun</i><br><ol><li>与那国口: Yonaguni language</li></ol>
ゆる|yuru	<i>counter</i><br><ol><li>夜: nights</li></ol><br><i>noun</i><br><ol><li>夜: night</li></ol>
ゆー|yū	<i>noun</i><br><ol><li>夜: night</li><li>夕: night, evening</li><li>世: age, era, period, time; rule; world, society</li></ol>
ゆーち|yūchi	<i>noun</i><br><ol><li>four (things)</li><li>four years old</li></ol>
ゆーりー|yūrī	<i>noun</i><br><ol><li>幽霊: ghost</li></ol>
りんぐゎ|ringwa	<i>noun</i><br><ol><li>煉瓦: brick</li></ol>
るぐゎい|rugwai	<i>noun</i><br><ol><li>蘆薈: aloe (plant of the genus Aloe)</li></ol>
るー|rū	<i>noun</i><br><ol><li>牢: prison</li></ol>
るーか|rūka	<i>noun</i><br><ol><li>琉歌: ryūka</li></ol>
るーちゅー|Rūchū	<i>name</i><br><ol><li>琉球: Ryukyu, pertaining to the Ryukyu Islands or the former Ryukyu Kingdom</li></ol>
るーや|rūya	<i>noun</i><br><ol><li>牢屋: prison</li></ol>
わったー|wattā	<i>pron</i><br><ol><li>我達: we, us, ourselves</li></ol>
わん|wan	<i>pron</i><br><ol><li>我ん: first-person pronoun: I, me</li></ol>
ゐきが|wikiga	<i>noun</i><br><ol><li>男: man</li></ol>
ゐきー|wikī	<i>noun</i><br><ol><li>brother (of a female)</li></ol>
ゐなぐ|winagu	<i>noun</i><br><ol><li>女子: woman</li></ol>
をぅとーてぃ|wutōti	<i>particle</i><br><ol><li>at; location indicator</li></ol>
をぅない|wunai	<i>noun</i><br><ol><li>sister (of a male)</li></ol>
をー|wō	<i>noun</i><br><ol><li>王: a king</li></ol>
んかい|nkai	<i>particle</i><br><ol><li>locative marker: at, in, to</li></ol>
んちゅん|nchun	<i>verb</i><br><ol><li>剥ちゅん: to peel</li></ol>
アミリカー|アメリカー|amirikā|amerikā	<i>noun</i><br><ol><li>Americans, American people, a person from the United States</li></ol>
クヮントゥン|Kwantun	<i>name</i><br><ol><li>広東: Guangdong</li></ol>
ゴーブレーキ|gōburēki	<i>noun</i><br><ol><li>goldbrick</li></ol>
サフン|safun	<i>noun</i><br><ol><li>soap</li></ol>
フチャン|Fuchan	<i>name</i><br><ol><li>福建: Fujian</li></ol>
フランシ|Furanshi	<i>name</i><br><ol><li>France (country)</li></ol>
ベトナム|Betonamu	<i>name</i><br><ol><li>Vietnam</li></ol>
モンゴル|Mongoru	<i>name</i><br><ol><li>Mongolia</li></ol>
一ち|ふぃとぅち|てぃーち|tīchi|fituchi	<i>noun</i><br><ol><li>one thing (small or without a counter category)</li><li>(literary) one thing (small or without a counter category)</li></ol>
一雨|chuami|ちゅあみ	<i>noun</i><br><ol><li>a single rainfall</li><li>a single brief rain shower</li></ol>
七ち|ななち|nanachi	<i>num</i><br><ol><li>seven</li></ol>
七ち星|Nanachibushi|ななちぶし	<i>name</i><br><ol><li>Big Dipper; the Plough; the Saptarishi</li></ol>
三ち|mīchi|みーち	<i>noun</i><br><ol><li>three things (small or without a counter category)</li></ol>
三線|sanshin|さんしん	<i>noun</i><br><ol><li>a fretless plucked lute with three strings and skin-covered body, a precursor to the shamisen</li></ol>
下|しちゃ|shicha	<i>noun</i><br><ol><li>the below</li></ol>
下着|しちゃじ|shichaji	<i>noun</i><br><ol><li>underwear</li></ol>
与那国|Yunaguni|ゆなぐに	<i>name</i><br><ol><li>Yonaguni, Okinawa</li></ol>
与那国口|ゆなぐにぐち|Yunaguniguchi	<i>noun</i><br><ol><li>Yonaguni language</li></ol>
世|ゆー|yū	<i>noun</i><br><ol><li>age, era, period, time; rule</li><li>world, society</li></ol>
世界|しけー|shikē	<i>noun</i><br><ol><li>world, society</li></ol>
京都|ちょーとぅ|Chōtu	<i>name</i><br><ol><li>Kyoto (a prefecture of Japan)</li><li>Kyoto (the capital city of Kyoto Prefecture, Japan)</li></ol>
人|っちゅ|tchu|nin|pitu|い|ぴとぅ|にん|たい	<i>noun</i><br><ol><li>person</li><li>human</li><li>people</li><li>person; type of person</li></ol><br><i>counter</i><br><ol><li>counter for number of people</li></ol>
今日|chū|きゆ|kiyu|ちゅー	<i>noun</i><br><ol><li>today</li><li>(literary) today</li></ol>
今日拝なびら|reading ちゅーがなびら|ちゅーをぅがなびら|chūwuganabira|chūganabira	<i>intj</i><br><ol><li>(polite) a greeting or salutation used when meeting someone: hello, good day</li></ol>
仏|Buchi|futuki|ふとぅき|佛|ぶち	<i>noun</i><br><ol><li>a buddha</li><li>a Buddhist image or statue</li><li>(by extension) a kindhearted person</li></ol><br><i>name</i><br><ol><li>Buddha</li></ol>
仕事|しぐとぅ|shigutu	<i>noun</i><br><ol><li>a job; an occupation; work</li></ol>
何|nū|ぬー	<i>pron</i><br><ol><li>what</li></ol>
作	
作ゆん|chukuyun|ちゅくゆん	<i>verb</i><br><ol><li>to make</li></ol>
傷|kiji|きじ	<i>noun</i><br><ol><li>wound</li></ol>
元|むとぅ|mūtu|reading むーとぅ|mutu|個|本	<i>noun</i><br><ol><li>cause, origin</li><li>basis, foundation</li><li>cost</li><li>origin</li><li>(finance) capital</li><li>principal</li></ol>
兄弟|chōdē|ちょーでー	<i>noun</i><br><ol><li>(collective) siblings; brothers and sisters</li></ol>
先生|shinshī|しんしー	<i>noun</i><br><ol><li>teacher</li></ol>
光|fikari|ふぃちゃい|ふぃかり|fichai	<i>noun</i><br><ol><li>light</li><li>lush, polish, sheen</li><li>(rare, obsolete) authority, power, influence, honor</li></ol>
入り髪星|iriganbushi|いりがんぶし	<i>noun</i><br><ol><li>(astronomy) comet</li></ol>
八月|hachigwachi|はちぐゎち	<i>noun</i><br><ol><li>the month of August</li></ol>
八重山|Yēma|いぇーま	<i>name</i><br><ol><li>Yaeyama, Okinawa</li></ol>
八重山口|yēmaguchi|Yēmaguchi|いぇーまぐち	<i>noun</i><br><ol><li>Yaeyama language</li></ol>
公議|kūji|くーじ	<i>noun</i><br><ol><li>public discussion; public debate</li></ol>
内地人|ないちゃー|naichā	<i>noun</i><br><ol><li>A term used to refer to someone who comes from prefectures other than Okinawa; who comes from the main portion of Japan, including the islands of Honshu, Shikoku, and Kyushu. A mainlander, an outsider.</li></ol>
写真|寫眞|枚|さしん|sashin	<i>noun</i><br><ol><li>photograph</li></ol>
冬|fuyu|ふゆ	<i>noun</i><br><ol><li>winter</li></ol>
出ゆん|'njiyun|っんじゆん	<i>verb</i><br><ol><li>to go out</li></ol>
刀自|tuji|とぅじ	<i>noun</i><br><ol><li>wife</li></ol>
分かやびらん|わかやびらん|wakayabiran	<i>phrase</i><br><ol><li>(formal) I don't understand.</li></ol>
分からん|wakaran|わからん	<i>phrase</i><br><ol><li>(informal) I don't understand</li></ol>
初|はち	<i>prefix</i><br><ol><li>the first..., initial..., new...</li></ol>
剃刀|kansui|かんすい	<i>noun</i><br><ol><li>razor</li></ol>
剥ちゅん|んちゃびー|んちぶさん|剥ち|剥ちょー|んちぇー|nchun|nchu|んちゅる|nchēwuran|nchuru|んかー|んちぇーうぅらん|剥ちぇー|nchi|剥ちゃ|剥かすん|んちょー|nkā|nchō|nkasun|nkariyun|んちゅ|んちゅん|剥ちゅる|んき|剥ちぶさん|剥ちぇーうぅらん|nki|んかん|剥かー|んちゃ|剥ちゃびー|nka|剥き|んかすん|んかりゆん|nkan|剥ちゅ|剥かん|剥かりゆん|剥か|ncha|んち|nchē|nchibusan|nchabī|んか	<i>verb</i><br><ol><li>to peel</li></ol>
加那志|がなしー|がなし	<i>suffix</i><br><ol><li>honorific suffix</li><li>(literary) honorific suffix</li></ol>
勝	
勝ゆん|まさゆん|masayun	<i>verb</i><br><ol><li>to excel, surpass</li></ol>
北|にし|nishi	<i>noun</i><br><ol><li>north; northern; northwards</li></ol>
医者|isa|いさ	<i>noun</i><br><ol><li>doctor</li></ol>
南|fē|ふぇー	<i>noun</i><br><ol><li>the south (cardinal point)</li><li>a southerly (wind blowing from the south)</li></ol>
口|kuchi|くち	<i>noun</i><br><ol><li>mouth</li><li>language</li><li>dialect</li><li>speech</li></ol>
叩	
叩ちゅん|たたちゃ|たたちぇーうぅらん|たたちゅる|叩ちぶさん|tatachuru|叩か|叩ちぇーうぅらん|tataka|叩かー|たたちょー|叩かすん|tatachun|叩ちゅる|叩き|叩ちゃ|たたちぶさん|叩かりゆん|たたかん|tatakariyun|たたちゅん|たたちゅ|tatachi|tatakan|tataki|叩ちゅ|tatachō|たたき|たたかー|たたかすん|叩ちょー|叩かん|tatakā|叩ちぇー|たたか|たたちぇー|tatachibusan|tatachēwuran|叩ち|tatachē|tatacha|叩ちゃびー|tatachabī|たたち|たたちゃびー|たたかりゆん|tatakasun|tatachu	<i>verb</i><br><ol><li>to hit, strike</li></ol>
各島々|kakushimajima|かくしまじま	<i>noun</i><br><ol><li>Each island; every island</li></ol>
同士|どぅし|dushi	<i>noun</i><br><ol><li>friend</li></ol>
同性|dōshī|どーしー	<i>noun</i><br><ol><li>homosexual</li><li>homosexuality</li><li>same sex</li></ol>
名|nā|なー	<i>noun</i><br><ol><li>name</li></ol>
名前|namē|なめー	<i>noun</i><br><ol><li>a name (word or phrase indicating a particular person, place, class, or thing)</li><li>(more specifically) a given name (excluding the surname)</li></ol>
名字|nōji|myōji|reading のーじ|みょーじ	<i>noun</i><br><ol><li>surname, family name, last name</li></ol>
命|inuchi|いぬち|nuchi|ぬち	<i>noun</i><br><ol><li>life</li><li>(literary) life</li></ol>
唇|しば|“Jōyō” kanji	<i>suffix</i><br><ol><li>lip; pertaining to the lips</li></ol>
唐|“Jōyō” kanji|Tō|とー	<i>name</i><br><ol><li>China</li></ol>
唐ぬ国|Tōnukuku|とーぬくく	<i>name</i><br><ol><li>China</li></ol>
喉|“Jōyō” kanji|ぬーでぃー|nūdī	<i>noun</i><br><ol><li>throat</li></ol>
喉弦|nūdījiru|ぬーでぃーじる	<i>noun</i><br><ol><li>vocal cords</li></ol>
嘉例|karii	<i>intj</i><br><ol><li>Cheers! (used as a common toast when drinking in company)</li></ol>
四ち|ゆーち|yūchi	<i>noun</i><br><ol><li>four things (small or without a counter category)</li></ol>
城|gushiku|ぐしく	<i>noun</i><br><ol><li>a gusuku (Ryukyuan castle)</li><li>a word used in placenames</li></ol>
声|kwī|くぃー	<i>noun</i><br><ol><li>voice</li><li>news (of someone); word (of someone); something said (of someone)</li></ol>
夕|ゆー|yū	<i>noun</i><br><ol><li>night, evening</li></ol>
多	
多さん|ufusan|うふさん	<i>adj</i><br><ol><li>there are many, there is much, there are numerous</li></ol>
夜|ゆー|yū|yuru|ゆる	<i>counter</i><br><ol><li>nights</li></ol><br><i>noun</i><br><ol><li>night</li></ol>
大|うふ|でー	<i>prefix</i><br><ol><li>big, large</li><li>big; great</li><li>greater</li></ol>
大人|うふっちゅ|utuna|うとぅな|ufutchu	<i>noun</i><br><ol><li>adult</li><li>(literary) adult</li></ol>
大和|Ufuyamatu|やまとぅ|Yamatu|うふやまとぅ	<i>name</i><br><ol><li>Japan, mainland Japan in contrast to Okinawa</li><li>Satsuma, Japan</li></ol>
大和ん人|yamatunchu|やまとぅんちゅ|大和人	<i>noun</i><br><ol><li>Japanese person, non-Ryukyuan Japanese people, a mainlander</li></ol>
大和口|Yamatuguchi|やまとぅぐち|yamatuguchi	<i>noun</i><br><ol><li>Japanese language</li></ol>
大和暦|yamatuguyumi|やまとぅぐゆみ	<i>noun</i><br><ol><li>Gregorian calendar; solar calendar.</li></ol>
大和酒|やまとぅじゃき|yamatujaki	<i>noun</i><br><ol><li>sake (Japanese rice wine)</li></ol>
大大和|Ufuyamatu|大和|うふやまとぅ|大倭|大日本	<i>name</i><br><ol><li>Japan, Mainland Japan in contrast to Okinawan</li></ol>
大大和ん人|ufuyamatunchu|うふやまとぅんちゅ	<i>noun</i><br><ol><li>Japanese person, non-Ryukyuan Japanese people, a mainlander</li></ol>
大水|ūmiji|うーみじ	<i>noun</i><br><ol><li>flood</li></ol>
天気|tinchi|てぃんち	<i>noun</i><br><ol><li>weather</li></ol>
天道|tīda|てぃーだ|tīra|reading てぃーら	<i>noun</i><br><ol><li>(astronomy) the sun</li></ol>
太陽|tīda|てぃーだ	<i>noun</i><br><ol><li>the sun</li></ol>
女子|winagu|ゐなぐ	<i>noun</i><br><ol><li>woman, girl</li></ol>
学校|校|がっこー|學校|gakkō	<i>noun</i><br><ol><li>school (institution dedicated to teaching and learning)</li></ol>
学生|學生|gakushī|がくしー	<i>noun</i><br><ol><li>a student</li></ol>
安南|あんなん|Annan	<i>name</i><br><ol><li>Vietnam</li><li>Annam, the fromer name of Vietnam</li></ol>
官話|kwanfā|くゎんふぁー	<i>noun</i><br><ol><li>Mandarin; Guanhua (group of Northern Chinese dialects including Putonghua (Standard Chinese))</li></ol>
宮古|なーく|Nāku	<i>name</i><br><ol><li>Miyako</li></ol>
宮古口|Nākuguchi|なーくぐち	<i>noun</i><br><ol><li>Miyako language</li></ol>
家|やー|yā	<i>noun</i><br><ol><li>house</li></ol>
寄	
寄しーん|yushīn|ゆしーん	<i>verb</i><br><ol><li>to approach, call</li></ol>
寸|すぃん|shin|しん	<i>noun</i><br><ol><li>a measurement of length equivalent to 10 分 (bu) or approximately 3.03 cm</li></ol>
尻|“Jōyō” kanji|chibi|ちび	<i>noun</i><br><ol><li>butt</li></ol>
尻ぬ目|ちびぬみー|chibi nu mī	<i>noun</i><br><ol><li>(anatomy) anus</li></ol>
山|yama|やま	<i>noun</i><br><ol><li>mountain</li></ol>
山原水鶏|やんばるくみらー|Yanbaru kumirā	<i>noun</i><br><ol><li>the Okinawa rail, Gallirallus okinawae</li></ol>
山口|やまぐち|Yamaguchi	<i>name</i><br><ol><li>Yamaguchi (a prefecture of Japan)</li><li>Yamaguchi (the capital city of Yamaguchi Prefecture, Japan)</li></ol>
島|shima|しま	<i>noun</i><br><ol><li>a community</li><li>an island</li></ol>
左|hijai|ひじゃい	<i>noun</i><br><ol><li>(direction) left</li></ol>
巻ちゅん|まちぇーうぅらん|まかん|maka|巻かすん|巻かー|巻か|まちゅん|maki|巻ちゅる|makā|巻ちぶさん|巻ちゃびー|makariyun|まちゅる|machi|まかりゆん|まちゃびー|machabī|machu|まちぇー|まちょー|machēwuran|巻ちゃ|machuru|まかすん|まかー|まちぶさん|巻き|巻ちゅ|まちゃ|machun|まか|machō|巻かん|巻ちょー|巻ちぇー|machibusan|machē|まち|まき|巻かりゆん|makasun|makan|まちゅ|macha|巻ちぇーうぅらん|巻ち	<i>verb</i><br><ol><li>roll, coil, wind up</li><li>wrap around</li><li>tighten, wind</li></ol>
帚|ほーち|hōchi	
干	
幽霊|yūrī|ゆーりー	<i>noun</i><br><ol><li>ghost</li></ol>
広東|クヮントゥン|Kwantun|くゎんとぅん|廣東	<i>name</i><br><ol><li>Guangdong (a province of China)</li><li>Guangzhou (a city in Guangdong, China)</li></ol>
広東瓜|クヮントゥウイ|廣東瓜|くゎんとぅうい|kwantuui	<i>noun</i><br><ol><li>watermelon</li></ol>
待ちゅん|待っちょー|まてぃ|また|matā|まっちゃ|またりゆん|待たすん|matchē|待ちぶさん|またん|待ち|matariyun|まちゅん|待た|mati|まっちょー|matchi|matasun|まちゅる|machi|まちゃびー|machabī|またー|machu|待たー|待たん|machuru|待たりゆん|まっち|まちぶさん|待てぃ|mata|待っちぇー|待ちゃびー|またすん|machun|まっちぇーうぅらん|machibusan|待っち|matchō|matan|まち|待っちゃ|matchēwuran|待ちゅ|待ちゅる|まちゅ|まっちぇー|matcha|待っちぇーうぅらん	<i>verb</i><br><ol><li>to wait (for)</li></ol>
御所|うんじゅ|unju	<i>pron</i><br><ol><li>(formal) you, yourself (second person pronoun)</li></ol>
御拝でーびる|にふぇーでーびる|nifēdēbiru	<i>intj</i><br><ol><li>(formal) thank you</li></ol>
御無礼さびら|guburī sabira	<i>phrase</i><br><ol><li>Excuse me.</li><li>Goodbye.</li></ol>
御総様|gusūyō|グスーヨー	<i>pron</i><br><ol><li>everyone</li></ol>
心|shin|しん|くくる|kukuru|ふくまーみ|fukumāmi	<i>noun</i><br><ol><li>a heart, mind, spirit</li><li>(anatomy) a heart</li><li>the center</li><li>心, 芯: the core</li><li>芯: a wick</li></ol>
息|いーち|īchi	<i>noun</i><br><ol><li>breath</li></ol>
悪さいびーん|wassaibīn|わっさいびーん	<i>intj</i><br><ol><li>(formal) an expression of apology, of regret. "sorry", "I'm very sorry", "please forgive me"</li></ol>
愛	
愛さん|悲さん|哀さん|かなさん|kanasan	<i>adj</i><br><ol><li>dear, beloved</li><li>lovely, endearing</li><li>adorable, cute</li><li>pretty</li></ol>
我	
我ん|わん|わんねー|wan|吾ん|wannē|我んねー	<i>pron</i><br><ol><li>first-person pronoun: I, me</li></ol>
我達|わした|washita|わったー|wattā	<i>pron</i><br><ol><li>we, us, ourselves</li><li>my house</li><li>our</li></ol>
戦|ikusa|戰|いくさ	<i>noun</i><br><ol><li>a battle, combat, conflict, war</li></ol>
戦ゆん|tatakayun|たたかゆん	<i>verb</i><br><ol><li>to fight</li></ol>
所|shu|とぅくる|しゅ|tukuru	<i>noun</i><br><ol><li>area, location, spot</li></ol><br><i>suffix</i><br><ol><li>place, field</li></ol>
手|tī|てぃー	<i>noun</i><br><ol><li>a hand</li><li>a handle, grip</li><li>a skill, ability, means; especially in martial arts</li></ol>
手甲|tikkō|てぃっこー	<i>noun</i><br><ol><li>back of the hand</li></ol>
押|“Jōyō” kanji	
押すん|うすん|ushun|うしゅん|usun|押しゅん	<i>verb</i><br><ol><li>to push; to thrust; to shove</li><li>to press</li><li>to stamp</li><li>to focus one's attack</li></ol>
拝なびら|wuganabira|をぅがなびら	<i>phrase</i><br><ol><li>a phrasal ending roughly equivalent to "it's a pleasure to see you"</li></ol>
指|ībi|いーび|いいび	<i>noun</i><br><ol><li>finger</li></ol>
挨拶|えーさち|ēsachi	<i>noun</i><br><ol><li>greeting</li></ol>
捨	
捨てぃゆん|してぃゆん|shitiyun	<i>verb</i><br><ol><li>to abandon</li></ol>
政治|shīji|しーじ	<i>noun</i><br><ol><li>politics</li><li>government</li></ol>
新	<i>character</i><br><ol><li>Kun: 新ーさん (みーさん, mīsan)</li></ol>
新ーさん|mīsan|みーさん	<i>adj</i><br><ol><li>new</li></ol>
新家|みーやー|mīyā	<i>noun</i><br><ol><li>new house</li></ol>
新車|mīguruma|みーぐるま	<i>noun</i><br><ol><li>new car</li></ol>
日	
日記|にっち|nitchi	<i>noun</i><br><ol><li>record of events and facts</li><li>record of daily events or thoughts; a diary or journal</li></ol>
明	
明かい|あかい|akai	<i>noun</i><br><ol><li>light</li></ol>
明日|achā|あちゃー	<i>noun</i><br><ol><li>tomorrow</li></ol>
暁|akachichi|“Jōyō” kanji|曉|あかちち	<i>noun</i><br><ol><li>the dawn, daybreak</li></ol>
暑さかまらさー|あちさかまらさー|achisakamarasā	<i>noun</i><br><ol><li>A person who is sensitive to heat, who is intolerant to heat</li></ol>
書	
書ちゅん|かちょー|kachō|かかりゆん|かちゅる|kakasun|kachē|書かー|かちゃ|書かん|書ちぶさん|かち|kakariyun|書ちゃ|kachibusan|かちぇーうぅらん|かかー|書ちょー|kachabī|kachēwuran|kachun|kaki|書ちゅる|書ちゅ|書ちぇー|書かりゆん|書か|kachu|かき|書かすん|書ちゃびー|kachuru|かちゃびー|かちぶさん|書き|書ちぇーうぅらん|kakan|kaka|kacha|書ち|kakā|かかすん|かちゅん|かか|かちぇー|かかん|かちゅ|kachi	<i>verb</i><br><ol><li>to write</li><li>to draw; to paint</li></ol>
書物|reading すむち|しゆむつぃ|しむち|sumuchi|shimuchi	<i>noun</i><br><ol><li>a book</li></ol>
月|つぃち|ちち|chichi|gwachi|ぐゎち	<i>noun</i><br><ol><li>the moon</li><li>a month</li><li>month of the year</li></ol><br><i>suffix</i><br><ol><li>month of the year</li></ol>
月ぬ光|ちちぬふぃちゃい|chichi nu fichai	<i>noun</i><br><ol><li>the moonlight (light or gleam of the moon)</li></ol>
有	<i>character</i><br><ol><li>Kun: あん (有ん, an)</li></ol>
有ん|あん|an	<i>verb</i><br><ol><li>to be</li></ol>
朝	
朝鮮|Chōshin|ちょーしん	<i>name</i><br><ol><li>Korea (two countries in East Asia, North Korea and South Korea)</li><li>North Korea (a country in East Asia)</li></ol>
朧月|uburujichi|うぶるぢち	<i>noun</i><br><ol><li>the moon on a hazy night</li></ol>
木|きー|kī	<i>noun</i><br><ol><li>a tree</li></ol>
本|個|mutu|むとぅ|ふん	<i>counter</i><br><ol><li>long cylindrical things such as glasses of drink, pairs of jeans, pens or trains and buses</li><li>films or TV shows</li><li>home runs or goals</li><li>rounds of a match in boxing, wrestling or judo</li></ol>
東|あがり|agari	<i>noun</i><br><ol><li>east</li></ol>
東京|Tōchō|とーちょー	<i>name</i><br><ol><li>Tokyo (a prefecture, the capital city of Japan, consisting of 23 special wards)</li></ol>
枚|めー	<i>counter</i><br><ol><li>counter for flat thin objects or sheets</li></ol>
枝|reading ゆだ|yida|いぃだ|yuda	<i>noun</i><br><ol><li>branch (of a tree or plant); bough</li></ol>
根|にー|nī	<i>noun</i><br><ol><li>root</li></ol>
桃|“Jōyō” kanji|むむ|mumu	<i>noun</i><br><ol><li>peach</li></ol>
桜|さくら|櫻|sakura	<i>noun</i><br><ol><li>a cherry tree</li></ol>
梯梧|dīgu|でぃーぐ	<i>noun</i><br><ol><li>the Indian coral tree, Erythrina variegata</li></ol>
歌|うた|uta	<i>noun</i><br><ol><li>song</li></ol>
歯|はー|hā|齒	<i>noun</i><br><ol><li>tooth</li></ol>
死	
毛|きー|kī	<i>noun</i><br><ol><li>hair, fur</li></ol>
民国|民國|minkuku|みんくく	<i>noun</i><br><ol><li>republic</li></ol>
水|miji|みじ	<i>noun</i><br><ol><li>water</li></ol>
水牛|mijiushi|みじうし	<i>noun</i><br><ol><li>water buffalo</li></ol>
水鶏|くみらー|kumirā	<i>noun</i><br><ol><li>the water rail, Rallus aquaticus</li></ol>
汗|“Jōyō” kanji|あし|ashi	<i>noun</i><br><ol><li>sweat</li></ol>
沖縄|沖繩|うちなー|Uchinā	<i>name</i><br><ol><li>Okinawa</li></ol>
沖縄ん人|うちなーんちゅ|沖繩ん人|uchinānchu|沖縄人|沖繩人	<i>noun</i><br><ol><li>Okinawan person</li><li>Okinawan people</li></ol>
沖縄口|沖繩口|沖縄語|うちなーぐち|Uchināguchi	<i>noun</i><br><ol><li>Okinawan language</li></ol>
油|あんだ|anda	<i>noun</i><br><ol><li>oil</li></ol>
泡|あー|“Jōyō” kanji|ā	<i>noun</i><br><ol><li>bubbles</li><li>froth, foam</li></ol>
泡盛|あーむい|āmui	<i>noun</i><br><ol><li>awamori (strong rice whiskey)</li></ol>
波布|はぶ|habu	<i>noun</i><br><ol><li>snake, viper, Okinawan habu</li></ol>
泳	
泳じゅん|っゐーがん|'wījun|っゐーがりゆん|っゐーじ|泳ぎ|泳じぇーうぅらん|っゐーじぇーうぅらん|っゐーがすん|っゐーじょー|泳がん|泳じゃ|っゐーじゅる|泳がー|'wīja|'wīgā|'wījē|'wīji|泳がりゆん|っゐーじゃびー|泳じゃびー|'wījuru|'wījēwuran|'wījibusan|っゐーが|泳が|っゐーじゅ|'wīgan|っゐーじぇー|泳じょー|っゐーじゅん|っゐーじゃ|'wījabī|'wīgariyun|泳じゅ|泳がすん|っゐーじぶさん|'wīga|泳じ|'wīju|泳じぶさん|泳じゅる|っゐーぎ|'wīgasun|泳じぇー|っゐーがー|'wījō|'wīgi	<i>verb</i><br><ol><li>to swim</li></ol>
海豚|ふぃーとぅ|fītu	<i>noun</i><br><ol><li>dolphin</li></ol>
清	
清らさん|churasan|ちゅらさん|美らさん	<i>adj</i><br><ol><li>beautiful, lovely, darling, pretty, elegant</li><li>(rare) clean, pure, chaste</li></ol>
清らー|churā|ちゅらー	<i>noun</i><br><ol><li>a popular term used to describe someone who is beautiful, lovely, pretty, elegant or chaste</li></ol>
清明|Shīmī|しーみー	<i>name</i><br><ol><li>Qingming ("Pure Brightness"), the fifth of the 24 solar terms in the Chinese lunisolar calendar, occurring from the 4th or 5th of April until the 18th or 19th</li></ol>
満州|まんしゅー|Manshū|滿州	<i>name</i><br><ol><li>Manchuria</li></ol>
滿州|満州|まんしゅー|Manshū	<i>name</i><br><ol><li>Manchuria</li></ol>
漢字|かんじ	<i>noun</i><br><ol><li>Chinese character</li></ol>
火ぬ神|reading ふぃぬかん|ひぬかん|finukan|hinukan	<i>noun</i><br><ol><li>god of the hearth</li></ol>
火ぬ神加那志|ひぬかんがなしー|hinukanganashī|reading ふぃぬかんがなしー|finukanganashī	<i>noun</i><br><ol><li>honorific of 火ぬ神 (hinukan, finukan): god of the hearth</li></ol>
烏|鴉|がらし|garashi	<i>noun</i><br><ol><li>crow, raven</li></ol>
煉瓦|ringwa|りんぐゎ	<i>noun</i><br><ol><li>brick</li></ol>
煎餅|しんびー|shinbī	<i>noun</i><br><ol><li>rice cracker</li></ol>
煤|しーし|shīshi	<i>noun</i><br><ol><li>soot (fine particles of amorphous carbon and tar)</li></ol>
熊|kuma|“Jōyō” kanji|くま	<i>character</i><br><ol><li>bear</li></ol><br><i>noun</i><br><ol><li>bear</li></ol>
熱さん|achisan|あちさん|暑さん	<i>adj</i><br><ol><li>hot (thing)</li><li>hot (weather)</li></ol>
牛|ʔusi|ushi|うし	<i>noun</i><br><ol><li>cow, cattle</li></ol>
牛ぬ乳|うしぬちー|ushi nu chī	<i>noun</i><br><ol><li>cow's milk</li></ol>
牢|rū|るー	<i>noun</i><br><ol><li>prison</li></ol>
牢屋|rūya|るーや	<i>noun</i><br><ol><li>prison</li></ol>
物|munu|mun|reading むん|むぬ	<i>noun</i><br><ol><li>thing</li></ol>
犬|in|いん	<i>noun</i><br><ol><li>dog (Canis familiaris); domestic dog</li></ol>
狐|chitsini|chichini|ちつィに|ちちに	<i>noun</i><br><ol><li>fox</li></ol>
狸|たぬき|tanuki	<i>noun</i><br><ol><li>raccoon dog</li></ol>
猫|“Jōyō” kanji|まやー|mayā	<i>noun</i><br><ol><li>cat</li></ol>
玉菜|tamanā|たまなー	<i>noun</i><br><ol><li>cabbage</li></ol>
王|をー|wō	<i>noun</i><br><ol><li>a king</li><li>an East Asian queen regnant</li><li>an East Asian sovereign prince</li></ol><br><i>affix</i><br><ol><li>king</li></ol>
珊瑚|sangu|さんぐ	<i>noun</i><br><ol><li>coral</li></ol>
琉歌|rūka|るーか	<i>noun</i><br><ol><li>ryūka</li></ol>
琉球|Dūchū|るーちゅー|Rūchū|reading どぅーちゅー	<i>name</i><br><ol><li>Ryukyu, pertaining to the Ryukyu Islands or the former Ryukyu Kingdom</li></ol>
瓜|ui|うい	<i>noun</i><br><ol><li>melon</li><li>gourd</li></ol>
生	
生すん|なすん|nasun	<i>verb</i><br><ol><li>to give birth</li></ol>
生日|umaribī|うまりびー|'nmaribī|っんまりびー	<i>noun</i><br><ol><li>birthday</li></ol>
田魚|tāiyu|たーいゆ	<i>noun</i><br><ol><li>crucian carp (Carassius carassius)</li></ol>
由	
男|wikiga|wutuku|yukiga|ゐきが|うぅとぅく|reading ゆきが	<i>noun</i><br><ol><li>man</li><li>(literary) man</li></ol>
白|shirū|しるー	<i>noun</i><br><ol><li>white (color)</li></ol>
監獄|kanguku|かんぐく	<i>noun</i><br><ol><li>prison</li></ol>
目|みー|mī	<i>noun</i><br><ol><li>eye</li><li>sight</li></ol>
目眼鏡|みーがんちょー|mīganchō	<i>noun</i><br><ol><li>glasses</li></ol>
真塩|まーす|māsu	<i>noun</i><br><ol><li>salt</li></ol>
眠やー|nībuyā|にーぶやー	<i>noun</i><br><ol><li>person who is tired</li><li>sleepy person; sleepyhead</li></ol>
眼鏡|みーかがん|がんちょー|ganchō|mīkagan	<i>noun</i><br><ol><li>eyeglasses</li></ol>
石|いし|ishi	<i>character</i><br><ol><li>Kun: いし (ishi)</li></ol><br><i>noun</i><br><ol><li>stone</li></ol>
石榴|ざくら|zakura	<i>noun</i><br><ol><li>pomegranate</li></ol>
石蓴|āsa|あーさ	<i>noun</i><br><ol><li>sea lettuce</li></ol>
砂糖|sātā|さーたー	<i>noun</i><br><ol><li>sugar</li></ol>
碇|ikai|いかい|いちゃい|ichai	
祈	
神|kami|かみ	<i>noun</i><br><ol><li>a spirit or an essence present in all things</li><li>a god, deity</li></ol>
福建|Fuchan|ふちゃん	<i>name</i><br><ol><li>Fujian (a province of China)</li></ol>
秋|あち|achi	<i>character</i><br><ol><li>autumn; fall</li></ol><br><i>noun</i><br><ol><li>autumn; fall</li></ol>
空|すら|sura	<i>noun</i><br><ol><li>(literary) the sky, heavens</li></ol>
箒|ほーち|帚|はうち|hōchi	<i>noun</i><br><ol><li>broom</li></ol>
箒星|hōchibushi|ほーちぶし	<i>noun</i><br><ol><li>(astronomy) comet</li></ol>
節|ぶし|bushi	<i>noun</i><br><ol><li>a song, poem or musical piece</li><li>a term used in titles to denote a poetic or musical piece</li></ol>
糸|いーちゅー|īchū	<i>noun</i><br><ol><li>thread</li></ol>
紫|むらさち|murasachi	<i>noun</i><br><ol><li>the color purple</li></ol>
綱|china|ちな	<i>character</i><br><ol><li>Kun: ちな (china)</li></ol><br><i>noun</i><br><ol><li>rope</li></ol>
耳|みん|min	<i>character</i><br><ol><li>Kun: みん (min), みみ (mimi)</li></ol><br><i>noun</i><br><ol><li>ear</li></ol>
肝|ちむ|“Jōyō” kanji|chimu	<i>noun</i><br><ol><li>the liver</li><li>heart; spirit</li></ol>
肝心|ちむぐくる|chimugukuru	<i>noun</i><br><ol><li>thoughtfulness, sincerity</li></ol>
肝清らさん|reading ちむぢゅらさん|chimujurasan|ちむちゅらさん|chimuchurasan	<i>noun</i><br><ol><li>(to have a) beautiful heart, beautiful soul</li></ol>
胡瓜|kīui|きーうい	<i>noun</i><br><ol><li>cucumber</li></ol>
腿|mumu|むむ	<i>noun</i><br><ol><li>thigh, lap</li></ol>
自	
自然|しじん|shijin	<i>noun</i><br><ol><li>nature</li></ol>
自由|jiyū|reading じゆ|jiyu|じゆー	<i>noun</i><br><ol><li>freedom, liberty</li><li>as one expects</li></ol>
舌|しちゃ|shicha	<i>character</i><br><ol><li>Kun: しちゃ (shicha)</li></ol><br><i>noun</i><br><ol><li>tongue</li></ol>
船|ふに|funi	<i>character</i><br><ol><li>Kun: ふに (funi)</li></ol><br><i>noun</i><br><ol><li>boat</li></ol>
花|hana|ふぁな|fana|はな	<i>noun</i><br><ol><li>(Shuri, Naha) flower</li><li>(Tancha) flower</li></ol>
苦瓜|ごーやー|gōyā	<i>noun</i><br><ol><li>bitter melon; bitter gourd</li></ol>
英語|yēgo|いぇーご	<i>noun</i><br><ol><li>English, the English language</li></ol>
苺|ichubi|ichubī|莓|いちゅび|reading いちゅびー	<i>noun</i><br><ol><li>strawberry</li></ol>
莓|ichubī|ichubi|いちゅび|reading いちゅびー	
菓子|kwāshi|菓子|くゎーし|くゎし|kwashi	<i>noun</i><br><ol><li>sweet, confection</li><li>candy</li><li>pastry, cake, cookie</li></ol>
菩薩|ぶーさー|būsā	<i>noun</i><br><ol><li>(Buddhism) bodhisattva</li></ol>
葉|fā|ふぁー	<i>noun</i><br><ol><li>leaf</li></ol>
葫|hiru|ひる	
蒔ちゅん|machun|まちゅん	<i>verb</i><br><ol><li>sow, plant</li><li>disseminate (to sow and scatter principles, etc. for propagation, like seed)</li><li>sprinkle gold or silver on lacquerware</li></ol>
蒙古|Mūku|むーく	<i>name</i><br><ol><li>Mongolia</li></ol>
蒜|hiru|ひる|葫	<i>noun</i><br><ol><li>garlic</li></ol>
薄荷|hakka|ふぁっか|fakka|はっか	<i>noun</i><br><ol><li>mint</li></ol>
蘆薈|るぐゎい|reading どぅぐゎい|rugwai|dugwai	<i>noun</i><br><ol><li>(botany) aloe (plant of the genus Aloe)</li></ol>
虎|“Jōyō” kanji|tura|とぅら	<i>character</i><br><ol><li>tiger</li></ol><br><i>noun</i><br><ol><li>tiger</li></ol>
蚤|numi|ぬみ	<i>character</i><br><ol><li>flea</li></ol><br><i>noun</i><br><ol><li>flea</li></ol>
蛇|“Jōyō” kanji	
蛭|bīru|びーる	<i>noun</i><br><ol><li>leech</li></ol>
蛾|がー|gā	<i>noun</i><br><ol><li>moth</li></ol>
蜂|hachā|“Jōyō” kanji|はちゃー	<i>character</i><br><ol><li>bee; wasp; hornet</li></ol><br><i>noun</i><br><ol><li>bee; wasp; hornet</li></ol>
蜘蛛|くーばー|kūbā	<i>noun</i><br><ol><li>spider</li></ol>
蜜|michi|“Jōyō” kanji|みち	<i>noun</i><br><ol><li>honey</li></ol>
蝙蝠|かーぶやー|kābuyā	<i>noun</i><br><ol><li>a bat (small flying mammal of order Chiroptera)</li></ol>
蝿瘡|hēgashī|reading へーがさー|蠅瘡|fēgasa|hēgasā|reading へーがさ|hēgasa|reading へーがしー|ふぇーがさ	<i>noun</i><br><ol><li>inflammation of the skin (especially of the face) characterized by red spots (such as pimples, acne, blisters, scabs or a rash), often as the result of eczema or scabies</li></ol>
蝿瘡ー|hēgashī|hēgasa|reading へーがさー|蝿瘡|蠅瘡|fēgasā|fēgasa|hēgasā|蠅瘡ー|reading へーがさ|ふぇーがさー|reading へーがしー|ふぇーがさ	<i>noun</i><br><ol><li>a person with an inflammation of the skin characterized by red bumps caused by a skin condition or disease such as eczema or scabies</li></ol>
蟹|gani|がに	<i>noun</i><br><ol><li>crab</li></ol>
蟻|ai|あい	<i>noun</i><br><ol><li>ant</li></ol>
血|ちー|chī	<i>noun</i><br><ol><li>blood</li></ol>
衣|chin|ちん	<i>noun</i><br><ol><li>clothing, clothes</li><li>kimono</li></ol>
西|iri|いり	<i>noun</i><br><ol><li>the West</li></ol>
西瓜|shīkwa|しーくゎ|シークヮ	<i>noun</i><br><ol><li>watermelon</li></ol>
西表|Iriumuti|いりうむてぃ	<i>name</i><br><ol><li>An island in Yaeyama, Okinawa Prefecture, Japan</li></ol>
言|kutu|くとぅ	<i>character</i><br><ol><li>to say</li><li>speech</li></ol><br><i>noun</i><br><ol><li>word</li></ol>
言ゅん|っいゅん|'yun	<i>verb</i><br><ol><li>to say, to tell somebody</li></ol>
言葉|くとぅば|kutuba	<i>noun</i><br><ol><li>language; speech; lingo; dialect; way of speaking</li><li>word; words; idiom; expression</li></ol>
話|話し|hanashi|はなし	<i>noun</i><br><ol><li>conversation</li><li>speech</li><li>story</li></ol>
話すん|はなすん|hanasun	<i>verb</i><br><ol><li>to speak, talk</li></ol>
警察|kīsachi|chīsachi|reading ちーさち|きーさち	<i>noun</i><br><ol><li>police</li></ol>
豚|'wā|っわー	<i>noun</i><br><ol><li>a pig, hog, swine</li></ol>
赤|あか|aka	<i>noun</i><br><ol><li>red</li></ol>
起	
起きてぃ|ukiti|うきてぃ	<i>phrase</i><br><ol><li>(informal) good morning</li></ol>
起きみしぇーびてぃ|ukimishēbiti|うきみしぇーびてぃ	<i>intj</i><br><ol><li>(formal) good morning</li></ol>
起きみそーちー|うきみそーちー|ukimisōchī	<i>intj</i><br><ol><li>good morning</li></ol>
起きゆん|うきゆん|ukiyun	<i>verb</i><br><ol><li>to wake up</li></ol>
越南|いつなん|Itsunan	<i>name</i><br><ol><li>Vietnam</li></ol>
趣味|すみ|sumi	<i>noun</i><br><ol><li>hobby</li><li>taste, preference</li></ol>
足|ashi|washi|ふぃさ|あし|わし|ひさ|fisa	<i>character</i><br><ol><li>Native: あし (ashi), ふぃさ (fisa)</li><li>Nonnative: すく (suku)</li></ol><br><i>noun</i><br><ol><li>foot; leg; paw</li><li>edible leg (of a pig, etc)</li><li>(only in compounds) foot</li></ol>
足甲|ふぃさなー|fisanā	<i>noun</i><br><ol><li>(anatomy) top of the foot; dorsum of the foot</li></ol>
跳にーん|はにーん|hanīn	<i>verb</i><br><ol><li>to jump, hop, bounce</li></ol>
踵|adu|あどぅ	<i>noun</i><br><ol><li>heel</li></ol>
車|kuruma|くるま	<i>noun</i><br><ol><li>car</li><li>wheel</li></ol>
那覇|Nāfa|なーふぁ	<i>name</i><br><ol><li>Naha, the capital city of the Japanese prefecture of Okinawa</li></ol>
都	
酒|さき|saki	<i>noun</i><br><ol><li>any alcoholic beverage (wine, whisky, sake, etc.)</li></ol>
醤油|醬油|そーゆー|sōyū	<i>noun</i><br><ol><li>soy sauce</li></ol>
野菜|yashē|やしぇー	<i>noun</i><br><ol><li>vegetable</li></ol>
針|はーい|hāi	<i>noun</i><br><ol><li>a needle used in sewing or other forms of embroidery</li></ol>
銀	
銭|じん|jin	<i>noun</i><br><ol><li>money</li><li>coins</li></ol>
錨|いかい|ichai|ikai|いちゃい|碇	<i>noun</i><br><ol><li>anchor</li></ol>
鍼|はーい|hāi	<i>noun</i><br><ol><li>needle used in acupuncture</li></ol>
鏡|kagan|かがん	<i>noun</i><br><ol><li>a mirror</li></ol>
陰|hō|ほー	<i>noun</i><br><ol><li>female genitalia</li></ol>
陰目|ほーみー|hōmī	<i>noun</i><br><ol><li>vagina</li></ol>
陵|うどぅん|udun	
隣|“Jōyō” kanji|tunai|とぅない	<i>character</i><br><ol><li>neighbor</li></ol><br><i>noun</i><br><ol><li>neighbour</li></ol>
雨|あみ|ami	<i>noun</i><br><ol><li>rain, rainfall</li></ol>
雪|ゆち|yuchi	<i>character</i><br><ol><li>hail</li><li>snow</li></ol><br><i>noun</i><br><ol><li>hail</li><li>snow</li></ol>
雲|kumu|くむ	<i>noun</i><br><ol><li>a cloud (visible mass of water droplets or other related material suspended in the air)</li></ol>
雷|“Jōyō” kanji|kannai|かんない	<i>noun</i><br><ol><li>thunder</li></ol>
電話|dinwa|でぃんわ	<i>noun</i><br><ol><li>telephone</li></ol>
霜月|しむちち|shimuchichi	<i>noun</i><br><ol><li>November (the month of frost)</li></ol>
露|ちゆ|“Jōyō” kanji|chiyu	<i>noun</i><br><ol><li>a dew, dewdrop</li></ol>
靴|fuya|ふや	<i>noun</i><br><ol><li>shoe</li></ol>
韓国|くゎんくく|韓國|Kwankuku	<i>name</i><br><ol><li>South Korea</li><li>Korea</li></ol>
音|うとぅ|utu	<i>noun</i><br><ol><li>sound</li></ol>
音楽|うんがく|ungaku	<i>noun</i><br><ol><li>music</li></ol>
頭|chiburu|ちぶる	<i>noun</i><br><ol><li>head</li><li>an intelligent person</li></ol>
頭病ん|ちぶるやん|chiburuyan	<i>noun</i><br><ol><li>headache</li></ol>
顏|ちら|chira	<i>character</i><br><ol><li>Kun: ちら (chira)</li></ol><br><i>noun</i><br><ol><li>face</li></ol>
顔|ちら|chira	<i>character</i><br><ol><li>Kun: ちら (chira)</li></ol><br><i>noun</i><br><ol><li>face</li></ol>
飛ぶん|とぅぶん|tubun	<i>verb</i><br><ol><li>to fly, soar</li></ol>
食	
食むん|咬ぬん|噛むん|かむん|kamun|咬むん|嚙むん|嚙ぬん|食ぬん|kanun|噛ぬん|かぬん	<i>verb</i><br><ol><li>to eat</li></ol>
飲むん|numun|ぬむん	<i>verb</i><br><ol><li>to drink</li><li>to swallow</li></ol>
餅|むーちー|mūchī	<i>noun</i><br><ol><li>mochi</li></ol>
馬|'nma|っんま	<i>noun</i><br><ol><li>a horse</li></ol>
骨|骨 * Kan-on: くち * Kun: ふに|kushi|kuchi|ふに|くち|funi|くし	<i>noun</i><br><ol><li>bone</li><li>frame (of a sliding paper door, etc)</li><li>stem, stalk</li><li>remains, ashes</li></ol>
高麗|こーれー|Kōrē	<i>name</i><br><ol><li>Goryeo</li><li>Korea</li></ol>
魂|tamashi|たまし|tamashī|“Jōyō” kanji|たましー	<i>noun</i><br><ol><li>soul, spirit, mind</li><li>(religion) soul of the dead</li></ol>
魚	
鯨|“Jōyō” kanji|gujira|ぐじら	<i>noun</i><br><ol><li>whale</li></ol>
鯱|さち|sachi	<i>noun</i><br><ol><li>orca</li></ol>
鰻|っんなじ|'nnaji	<i>noun</i><br><ol><li>an eel</li></ol>
鱗|いりち|irichi	<i>character</i><br><ol><li>scale</li></ol><br><i>noun</i><br><ol><li>scale (of a fish, reptile, etc)</li><li>dandruff</li></ol>
鳥|tui|とぅい	<i>character</i><br><ol><li>bird</li><li>chicken</li></ol><br><i>noun</i><br><ol><li>bird</li><li>chicken</li></ol>
鴉|がらし|garashi	
鶴|ちる|“Jōyō” kanji|chiru	<i>noun</i><br><ol><li>a crane (large, long-legged and long-necked bird of the family Gruidae)</li></ol>
鹿児島|鹿兒島|Kagushima|かぐしま	<i>name</i><br><ol><li>Kagoshima (a prefecture in southwestern Japan)</li><li>Kagoshima (the capital city of Kagoshima Prefecture, Japan)</li></ol>
黄色|ちーるー|chīrū	<i>noun</i><br><ol><li>yellow</li></ol>
黒|kurū|くるー	<i>noun</i><br><ol><li>black</li></ol>
黒さん|くるさん|kurusan	<i>adj</i><br><ol><li>black</li></ol>
黒猫|kurumayā|くるまやー	<i>noun</i><br><ol><li>a black cat</li></ol>
黒砂糖|reading くるざーたー|kurujātā|kuruzātā|くるじゃーたー	<i>noun</i><br><ol><li>brown sugar</li></ol>
鼠|'wenchu|enchu|reading ゑんちゅ|wenchu|っゑんちゅ|reading えんちゅ	<i>noun</i><br><ol><li>mouse, rat</li></ol>
鼻|hana|はな	<i>noun</i><br><ol><li>(anatomy) nose</li></ol>
