აბანოჲ|abanoy	<i>noun</i><br><ol><li>bathhouse</li></ol>
აბრეშუმი|abrešumi	<i>noun</i><br><ol><li>silk</li></ol>
აგარაკი|agaraḳi	<i>noun</i><br><ol><li>field; village; garden</li></ol>
აგური|aguri	<i>noun</i><br><ol><li>brick</li></ol>
ადგილი|adgili	<i>noun</i><br><ol><li>place</li></ol>
ადვილ|advil	<i>adv</i><br><ol><li>easily</li></ol>
ადრე|adre	<i>adv</i><br><ol><li>early</li><li>tomorrow</li></ol>
ავაზანი|avazani	<i>noun</i><br><ol><li>pool, water tank</li><li>cauldron, basin</li><li>(Christianity) baptismal font</li></ol>
ავარი|avari	<i>noun</i><br><ol><li>plunder, booty</li></ol>
ავთოლოფოსი|avtoloposi	<i>noun</i><br><ol><li>antelope</li></ol>
ათი|ati	<i>num</i><br><ol><li>ten</li></ol>
აკუმი|aḳumi	<i>noun</i><br><ol><li>chair, bench</li><li>pile, heap</li></ol>
ალაგი|alagi	<i>noun</i><br><ol><li>trail, road, way</li></ol>
ამეთჳსტონი|ametwisṭoni	<i>noun</i><br><ol><li>amethyst</li></ol>
ამინატონი|aminaṭoni	<i>noun</i><br><ol><li>asbestos stone</li></ol>
ანაზდი|anazdi	<i>adj</i><br><ol><li>sudden</li></ol><br><i>adv</i><br><ol><li>suddenly</li></ol>
ანგარი|angari	<i>noun</i><br><ol><li>avaricious, greedy</li></ol>
ანგელოზი|angelozi	<i>noun</i><br><ol><li>angel</li></ol>
ანდამატიაჲ|andamaṭiay	<i>noun</i><br><ol><li>diamond</li><li>adamant</li></ol>
ანთრაკი|antraḳi	<i>noun</i><br><ol><li>a deep red precious stone, a carbuncle</li></ol>
ანუ|anu	<i>conj</i><br><ol><li>or</li></ol>
აპნისი|aṗnisi	<i>name</i><br><ol><li>January</li></ol>
არწივი|arc̣ivi	<i>noun</i><br><ol><li>eagle</li></ol>
ასი|asi	<i>num</i><br><ol><li>hundred</li></ol>
ასული|asuli	<i>noun</i><br><ol><li>daughter</li></ol>
ატამი|aṭami	<i>noun</i><br><ol><li>peach (Prunus persica)</li></ol>
აფსინდი|apsindi	<i>noun</i><br><ol><li>absinthe wormwood (Artemisia absinthium)</li></ol>
აქატჱ|akaṭē	<i>noun</i><br><ol><li>agate</li></ol>
აქლემი|aklemi	<i>noun</i><br><ol><li>camel</li></ol>
აღვსებაჲ|aɣvsebay	<i>noun</i><br><ol><li>filling up; fulfilling; (year etc․) passing</li><li>(Christianity) resurrection; Easter</li></ol>
აღმაშენებელი|aɣmašenebeli	<i>noun</i><br><ol><li>(literally) one who builds</li><li>(figuratively) one who improves, makes better something</li></ol>
ბაგინი|bagini	<i>noun</i><br><ol><li>pagan shrine</li><li>sacrificial altar</li></ol>
ბანი|bani	
ბანჯარი|banǯari	<i>noun</i><br><ol><li>herbs (green, mostly edible)</li><li>reeds, grass</li></ol>
ბარსაბონი|barsaboni	<i>noun</i><br><ol><li>balsam</li><li>official, viceroy</li></ol>
ბარჯი|barǯi	<i>noun</i><br><ol><li>gaff</li><li>bident</li></ol>
ბაწარი|bac̣ari	<i>noun</i><br><ol><li>tether</li><li>rope</li></ol>
ბედედი|bededi	<i>noun</i><br><ol><li>roof, housetop from trampled, flattened earth</li></ol>
ბევრი|bevri	<i>adj</i><br><ol><li>many, much</li></ol><br><i>num</i><br><ol><li>ten thousand</li></ol>
ბერი|beri	<i>noun</i><br><ol><li>monk</li></ol>
ბეჭი|beč̣i	<i>noun</i><br><ol><li>shoulder blade, scapula</li></ol>
ბიბლია|biblia	<i>name</i><br><ol><li>Bible</li></ol>
ბიჭი|bič̣i	<i>noun</i><br><ol><li>crumbs</li></ol>
ბორბალი|borbali	<i>noun</i><br><ol><li>wheel</li></ol>
ბრგუნვა|brgunva	<i>noun</i><br><ol><li>Lacking ability to speak clearly, stuttering</li></ol>
ბრინჯი|brinǯi	<i>noun</i><br><ol><li>nettle tree (Celtis spp.)</li></ol>
ბრტყელი|brṭq̇eli	<i>adj</i><br><ol><li>flat</li></ol>
ბრძოლაჲ|brʒolay	<i>noun</i><br><ol><li>battle</li><li>war</li><li>formation, structure, lineup</li><li>merit, contribution</li><li>fight</li></ol>
ბუდეჲ|budey	<i>noun</i><br><ol><li>nest</li><li>den, lair</li><li>eye socket</li></ol>
ბუზჳ|ბუზუი|buzwi|buzui|buzi|ბუზი	<i>noun</i><br><ol><li>fly (insect)</li></ol>
ბუჲ|ბუვი|buy|buvi	<i>noun</i><br><ol><li>owl</li></ol>
გალიაკი|galiaḳi	<i>noun</i><br><ol><li>cage</li><li>room, hall</li></ol>
განათლება|ganatleba	<i>noun</i><br><ol><li>the act of lighting up</li><li>christening, baptism</li></ol>
გემოჲ|gemoy	<i>noun</i><br><ol><li>palate, taste, sweetness</li><li>pleasure, gratification</li></ol>
გერი|geri	<i>noun</i><br><ol><li>wild plant (plant that grew in wild; without planting)</li><li>(figuratively) stepchild (a child only from a different father)</li></ol>
გზაჲ|gzay	<i>noun</i><br><ol><li>way</li></ol>
გორა|gora	<i>noun</i><br><ol><li>hill</li></ol>
გრგჳნვა|grgwinva	<i>noun</i><br><ol><li>thunder</li></ol>
გრძელი|grʒeli	<i>adj</i><br><ol><li>long</li></ol>
გრწყილი|grc̣q̇ili	<i>noun</i><br><ol><li>flea</li></ol>
გუგაჲ|gugay	<i>noun</i><br><ol><li>eye pupil</li></ol>
გუელი|gueli	<i>noun</i><br><ol><li>snake</li><li>(Georgian mythology) giant</li></ol>
გუელის-მბრძოლი|guelis-mbrʒoli	<i>noun</i><br><ol><li>ichneumon, Herpestes ichneumon</li></ol>
გული|guli	<i>noun</i><br><ol><li>heart</li><li>will, certain state of mind</li><li>middle part of something</li></ol>
გჳრგჳნი|gwirgwini	<i>noun</i><br><ol><li>crown</li></ol>
დაბადება|dabadeba	<i>noun</i><br><ol><li>bible</li><li>birth</li><li>the beginning of something</li><li>the creation of the world</li></ol>
დაბაჲ|dabay	<i>noun</i><br><ol><li>village, settlement</li><li>cornfield</li></ol>
დათჳ|datwi	<i>noun</i><br><ol><li>bear</li></ol>
დანგი|dangi	<i>noun</i><br><ol><li>small coin</li></ol>
დარიჩინი|daričini	<i>noun</i><br><ol><li>cinnamon</li></ol>
დარუბანდი|darubandi	<i>name</i><br><ol><li>Derbent</li></ol>
დაფნი|dapni	<i>noun</i><br><ol><li>laurel (Laurus)</li></ol>
დაჲ|day	<i>noun</i><br><ol><li>sister</li></ol>
დედაჲ|deday	<i>noun</i><br><ol><li>mother</li><li>nun</li><li>woman</li><li>an original, unedited, genuine, authentic object</li></ol>
დიდი|didi	<i>adj</i><br><ol><li>large, big</li><li>glorious, great (person)</li></ol>
დიკაჲ|diḳay	<i>noun</i><br><ol><li>Persian wheat (Triticum turgidum subsp. carthlicum)</li></ol>
დილეგი|dilegi	<i>noun</i><br><ol><li>fortress; dungeon</li></ol>
დროშა|droša	<i>noun</i><br><ol><li>flag</li></ol>
დღჱ|dɣē	<i>noun</i><br><ol><li>day</li></ol>
ელვაჲ|elvay	<i>noun</i><br><ol><li>lightning</li></ol>
ენაჲ|enay	<i>noun</i><br><ol><li>tongue</li><li>language</li></ol>
ერთი|erti	<i>num</i><br><ol><li>one</li></ol><br><i>adj</i><br><ol><li>full, whole</li></ol>
ერთშაბათი|ertšabati	<i>noun</i><br><ol><li>Sunday</li></ol>
ერისთავი|eristavi	<i>noun</i><br><ol><li>eristavi</li></ol>
ექუსი|ekusi	<i>num</i><br><ol><li>six</li></ol>
ეშვი|ešvi	<i>noun</i><br><ol><li>wild boar</li></ol>
ეჩუეჲ|ečoy|ečuey|ეჩუაჲ|ეჩოჲ|ečuay	<i>noun</i><br><ol><li>adze</li></ol>
ვაზი|vazi	<i>noun</i><br><ol><li>branch, shoot (of vine)</li></ol>
ვანი|vani	<i>noun</i><br><ol><li>habitation, house</li></ol>
ვაშლი|vašli	<i>noun</i><br><ol><li>apple (fruit)</li></ol>
ვაცი|vaci	<i>noun</i><br><ol><li>billy goat</li></ol>
ვაჭარი|vač̣ari	<i>noun</i><br><ol><li>merchant, tradesman</li></ol>
ვაჰანაკრაჲ|vahanaḳray	<i>noun</i><br><ol><li>aspidochelone</li></ol>
ვენაჴი|venaqi	<i>noun</i><br><ol><li>vine</li><li>(by extension) vineyard</li></ol>
ვერაგი|veragi	<i>adj</i><br><ol><li>perfidious, serpentine</li></ol><br><i>noun</i><br><ol><li>perfidious, serpentine person</li></ol>
ვერძი|verʒi	<i>noun</i><br><ol><li>Aries</li><li>male sheep, ram</li></ol>
ვერხჳ|verxwi	<i>noun</i><br><ol><li>asp, aspen, asps</li></ol>
ვეფხი|vepxi	<i>noun</i><br><ol><li>tiger</li><li>leopard</li></ol>
ვეფხისტყაოსანი|vepxisṭq̇aosani	<i>name</i><br><ol><li>The Knight in the Panther's Skin</li></ol>
ვეცხლი|vecxli	<i>noun</i><br><ol><li>silver</li><li>money</li></ol>
ვიგრი|vigri|igri|იგრი	<i>noun</i><br><ol><li>Uncertain, but it could have been a type of large animal. see usage notes.</li></ol>
ზამთარი|zamtari	<i>noun</i><br><ol><li>winter</li></ol>
ზარადი|zaradi	<i>noun</i><br><ol><li>aventail</li></ol>
ზაფხული|zapxuli	<i>noun</i><br><ol><li>summer</li></ol>
ზრქელი|zrkeli|სქელი|skeli	<i>adj</i><br><ol><li>thick, stout, rotund</li></ol>
ზღუაჲ|zɣuay	<i>noun</i><br><ol><li>sea</li></ol>
თაგჳ|tagwi	<i>noun</i><br><ol><li>mouse</li></ol>
თავი|tavi	<i>noun</i><br><ol><li>head</li><li>topmost, foremost or leading part.</li><li>head, leader</li><li>starter (of a fight, etc.)</li><li>important, main</li></ol>
თავისუფალი|tavisupali	<i>adj</i><br><ol><li>free, independent (person or object)</li></ol>
თათბირი|tatbiri	<i>noun</i><br><ol><li>order</li><li>arrangement</li><li>council</li></ol>
თაფლი|tapli	<i>noun</i><br><ol><li>honey</li></ol>
თეთრი|tetri	<i>adj</i><br><ol><li>white</li></ol>
თელაჲ|telay	<i>noun</i><br><ol><li>elm</li></ol>
თთუჱ|თუთჱ|tutē|tuē|ttuē|თუჱ	<i>noun</i><br><ol><li>month</li></ol>
თიბვა|tibva	<i>noun</i><br><ol><li>the act of reaping, harvesting, mowing</li></ol>
თივა|tiva	<i>noun</i><br><ol><li>hay, grass</li></ol>
თითი|titi	<i>noun</i><br><ol><li>finger</li></ol>
თიჴაჲ|tiqay	<i>noun</i><br><ol><li>clay</li></ol>
თმაჲ|tmay	<i>noun</i><br><ol><li>hair</li></ol>
თოვლი|tovli	<i>noun</i><br><ol><li>snow</li></ol>
თოჴი|toqi	<i>noun</i><br><ol><li>hoe</li></ol>
თუალი|tuali	<i>noun</i><br><ol><li>eye</li><li>gemstone</li><li>wheel</li><li>source of a stream</li></ol>
თქუენ|tkuen	<i>pron</i><br><ol><li>you (plural, or polite singular)</li></ol>
თხაჲ|txay	<i>noun</i><br><ol><li>goat</li></ol>
თხელი|txeli	<i>adj</i><br><ol><li>thin, slim</li></ol>
იავარი|iavari	<i>noun</i><br><ol><li>plunder, booty</li></ol>
იგი|igi	<i>article</i><br><ol><li>Served as something like a definitive article</li></ol>
იდაყჳ|idaq̇wi	<i>noun</i><br><ol><li>elbow</li></ol>
ინჩაჴუ|inčaqu|iquanči|იჴუანჩი	<i>noun</i><br><ol><li>(anatomy) crop, craw</li></ol>
ისანი|isani	<i>name</i><br><ol><li>Avlabari</li></ol>
ისარი|isari	<i>noun</i><br><ol><li>arrow</li></ol>
იფქლი|ipkli	<i>noun</i><br><ol><li>wheat</li><li>fruit (the seed-bearing part of a plant)</li></ol>
იქნამონი|iknamoni	<i>noun</i><br><ol><li>ichneumon, Herpestes ichneumon</li></ol>
იხჳ|იხუ|ixu|ixwi	<i>noun</i><br><ol><li>duck</li><li>goose</li></ol>
კათხაჲ|ḳatxay	<i>noun</i><br><ol><li>wooden vessel</li></ol>
კაკაბი|ḳaḳabi	<i>noun</i><br><ol><li>partridge</li></ol>
კალნაბი|ḳalnabi	<i>noun</i><br><ol><li>cabbage</li></ol>
კაპარი|ḳaṗari	<i>noun</i><br><ol><li>caper, Capparis</li></ol>
კარგი|ḳargi	<i>noun</i><br><ol><li>order, custom</li><li>decency, propriety</li></ol><br><i>adj</i><br><ol><li>good</li></ol>
კართი|კარსი|კარსნი|ḳarti|კართნი|karsi	<i>noun</i><br><ol><li>(anatomy) vein</li><li>(anatomy) calf (the back of the leg below the knee)</li><li>(anatomy) knee tendons</li></ol>
კაცი|კაცნი|ḳaci	<i>adv</i><br><ol><li>nobody</li></ol><br><i>noun</i><br><ol><li>man</li><li>human</li><li>husband</li><li>used as a unit of measurement (implying the height of an average man).</li></ol>
კბილი|ḳbili	<i>noun</i><br><ol><li>tooth</li></ol>
კედელი|ḳedeli	<i>noun</i><br><ol><li>wall, fence</li><li>edge, barrier, railing</li></ol>
კეთება|ḳeteba	<i>noun</i><br><ol><li>to make</li></ol>
კეთილი|ḳetili	<i>adj</i><br><ol><li>good</li></ol>
კითხვა|ḳitxva	<i>noun</i><br><ol><li>question</li><li>to read</li></ol>
კინამოჲ|ḳinamoy	<i>noun</i><br><ol><li>cinnamon</li></ol>
კიცჳ|ḳicu|ḳicwi|კიცუ	<i>noun</i><br><ol><li>colt</li></ol>
კლდეჲ|ḳldey	<i>noun</i><br><ol><li>crag, scar, rock</li></ol>
კოვზი|ḳovzi	<i>noun</i><br><ol><li>spoon</li></ol>
კოლტი|ḳolṭi	<i>noun</i><br><ol><li>a herd of pigs, oxen or camels</li></ol>
კრავი|ḳravi	<i>noun</i><br><ol><li>lamb</li></ol>
კრებაჲ|ḳrebay	<i>noun</i><br><ol><li>meeting, congregation, convention</li></ol>
კრვა|ḳrva	<i>noun</i><br><ol><li>to bind, to tie up</li><li>to strike, to beat; to push</li></ol>
კროკონი|ḳroḳoni	<i>noun</i><br><ol><li>crocus, crocum</li></ol>
კუალი|ḳuali	<i>noun</i><br><ol><li>trail, trace, footprint</li><li>contribution</li></ol>
კუამლი|ḳuamli	<i>noun</i><br><ol><li>smoke</li></ol>
კუარცხლბერკი|კუარცხლბეკი|ḳuarcxlberḳi|ḳuarcxlbeḳi	<i>noun</i><br><ol><li>pedestal</li><li>footstool</li></ol>
კუდი|ḳudi	<i>noun</i><br><ol><li>tail</li></ol>
კუეთს|ḳuets	<i>verb</i><br><ol><li>He/she/it is cutting</li><li>He/she/it is dissecting</li></ol>
კუერნა|ḳuerna	<i>noun</i><br><ol><li>marten</li></ol>
კუერცხი|ḳuercxi	<i>noun</i><br><ol><li>egg</li></ol>
კუესი|ḳuesi	<i>noun</i><br><ol><li>firestriker</li></ol>
კუნძული|ḳunʒuli	<i>noun</i><br><ol><li>island</li><li>corner, nook</li></ol>
კურასტანი|ḳurasṭani	<i>noun</i><br><ol><li>crystal</li></ol>
კუჲ|ḳuvi|კუვი|ḳuy	<i>noun</i><br><ol><li>tortoise</li></ol>
კჳპაროსი|ḳwiṗarosi	<i>noun</i><br><ol><li>cypress</li></ol>
კჳრიონი|ḳwirioni	<i>noun</i><br><ol><li>kingfisher, halcyon (Alcedo atthis)</li></ol>
ლაგჳნი|lagwini	<i>noun</i><br><ol><li>pitcher, jug</li></ol>
ლაროსი|larosi	<i>noun</i><br><ol><li>Larus</li><li>Gavia</li></ol>
ლბილი|lbili	<i>adj</i><br><ol><li>soft</li><li>calm (person)</li></ol>
ლეკჳ|leḳwi	<i>noun</i><br><ol><li>offspring, descendant, child (of all mammals except humans)</li><li>puppy</li></ol>
ლექსი|leksi	<i>noun</i><br><ol><li>lyric, poem, verse</li></ol>
ლეღჳ|leɣwi	<i>noun</i><br><ol><li>fig</li></ol>
ლირბი|lirbi	<i>adj</i><br><ol><li>impudent, brazen</li></ol>
ლირწი|lirc̣i	<i>adj</i><br><ol><li>impudent, brazen</li></ol>
ლოგინი|logini	<i>noun</i><br><ol><li>bed</li></ol>
ლომაჲ|lomay	<i>noun</i><br><ol><li>mite, small piece of money</li></ol>
ლომი|lomi	<i>noun</i><br><ol><li>lion</li><li>(astronomy) Leo</li></ol>
მადლი|madli	<i>noun</i><br><ol><li>favor, gift</li><li>grace, mercy</li></ol>
მაკე|maḳe	<i>noun</i><br><ol><li>pregnant animal</li></ol>
მამაჲ|mamay	<i>noun</i><br><ol><li>father</li><li>(religion) father, ecclesiarch</li></ol>
მანგალი|mangali	<i>noun</i><br><ol><li>sickle</li></ol>
მანდრაგორი|mandragori	<i>noun</i><br><ol><li>mandragora, mandrake</li></ol>
მარგალიტი|margaliṭi|margariṭi|მარგარიტი	<i>noun</i><br><ol><li>pearl</li><li>mother-of-pearl</li></ol>
მართუჱ|martuē	<i>noun</i><br><ol><li>eaglet</li></ol>
მარმალი|marmali	<i>noun</i><br><ol><li>marble</li></ol>
მარმარილოჲ|marmariloy	<i>noun</i><br><ol><li>marble</li></ol>
მარტორქაჲ|marṭorkay	<i>noun</i><br><ol><li>unicorn</li></ol>
მარტჳლი|marṭwili|marṭwiri|მარტჳრი	<i>noun</i><br><ol><li>martyr</li></ol>
მარჯუენა|marǯuena	<i>noun</i><br><ol><li>right hand</li></ol>
მასპინძელი|masṗinʒeli	<i>noun</i><br><ol><li>host, hostess</li></ol>
მატაკარანი|maṭaḳarani	<i>noun</i><br><ol><li>chief baker</li><li>chief of hangmen</li></ol>
მატიანე|maṭiani|maṭiane|მატიანი	<i>noun</i><br><ol><li>story</li><li>book</li><li>deed (document)</li></ol>
მატყლი|maṭq̇li	<i>noun</i><br><ol><li>fleece, wool</li></ol>
მაქმაჲ|makmay	<i>noun</i><br><ol><li>thick cloth or a net</li></ol>
მაყუალი|maq̇uali	<i>noun</i><br><ol><li>blackberry (Rubus)</li></ol>
მაშკი|mašḳi	<i>noun</i><br><ol><li>blanket, covering (made of skins)</li><li>tent covering</li><li>niqab, yashmak</li></ol>
მაჩჳ|mačwi	<i>noun</i><br><ol><li>badger</li><li>rabbit</li></ol>
მახჳლი|maxwili	<i>noun</i><br><ol><li>sword, sabre</li><li>razor</li><li>(rare) object made out of iron</li></ol><br><i>adj</i><br><ol><li>sharpened (sword or knife)</li><li>fiery, quick-tempered</li><li>cruel</li></ol>
მგელი|mgeli	<i>noun</i><br><ol><li>wolf</li></ol>
მგოსანი|mgosani	<i>noun</i><br><ol><li>minstrel, gusan</li></ol>
მდელოჲ|mdeloy	<i>noun</i><br><ol><li>grass</li><li>soap</li></ol>
მე|me	<i>pron</i><br><ol><li>I, me</li></ol>
მეგობარი|megobari	<i>noun</i><br><ol><li>friend, relative, comrade</li></ol>
მეგრელი|megreli	<i>noun</i><br><ol><li>Mingrelian</li></ol>
მეზობელი|mezobeli	<i>noun</i><br><ol><li>neighbour</li></ol><br><i>adj</i><br><ol><li>brotherly</li></ol>
მერცხალი|mercxali	<i>noun</i><br><ol><li>swallow (bird)</li></ol>
მეფე|მეფჱ|meupē|mepē|mepe|მეუფჱ	<i>noun</i><br><ol><li>king</li></ol>
მზჱ|მზეჲ|mzē|mzey|მზე|mze	<i>name</i><br><ol><li>Sun</li></ol>
მთოვარე|mtovare	<i>noun</i><br><ol><li>(astronomy) moon</li></ol>
მიმინოჲ|miminoy	<i>noun</i><br><ol><li>Eurasian sparrowhawk (Accipiter nisus)</li></ol>
მიწა|mic̣a	<i>noun</i><br><ol><li>land</li><li>dust</li></ol>
მკალი|mḳali	<i>noun</i><br><ol><li>grasshopper</li></ol>
მკერდი|mḳerdi	<i>noun</i><br><ol><li>breast, chest</li></ol>
მკუდარი|mḳudari	<i>adj</i><br><ol><li>dead</li></ol><br><i>noun</i><br><ol><li>corpse</li></ol>
მოგჳ|mogwi|მოგუ̂სა|მოგჳსა	<i>noun</i><br><ol><li>(religious) Zoroastrian</li><li>magician, astrologer</li></ol>
მოდი|modi	<i>noun</i><br><ol><li>modius, a unit of dry measure (especially for grain) of about a peck or 9 L</li></ol>
მოკლჱ|moḳlē	<i>adj</i><br><ol><li>short</li></ol>
მოლოქი|maloki|მოლოქაჲ|molokay|მალოქი|moloki	<i>noun</i><br><ol><li>mallow</li></ol>
მონაზონი|monazoni|molozoni|მოლოზონი|molazoni|მოლაზონი	<i>noun</i><br><ol><li>monk, nun</li></ol>
მსუენ-ლომი|msuen-lomi	<i>noun</i><br><ol><li>chameleon</li></ol>
მურტი|murṭi	<i>noun</i><br><ol><li>myrtle</li></ol>
მუტრიბი|muṭribi	<i>noun</i><br><ol><li>lutenist, harp/lyre-player; minstrel</li></ol>
მუხაჲ|muxay	<i>noun</i><br><ol><li>oak</li></ol>
მუჴლი|muqli	<i>noun</i><br><ol><li>knee</li></ol>
მყარი|mq̇ari	<i>adj</i><br><ol><li>hard, solid, firm</li></ol>
მყუარი|mq̇uari	<i>noun</i><br><ol><li>frog</li></ol>
მშჳლდი|mšwildi	<i>noun</i><br><ol><li>bow (weapon)</li><li>rainbow</li></ol>
მძორი|mʒori	<i>noun</i><br><ol><li>carrion, corpse</li></ol>
მწავი|mc̣avi	<i>noun</i><br><ol><li>otter</li></ol>
მწარე|mc̣are	<i>adj</i><br><ol><li>bitter, spicy (usually food)</li></ol>
მწერი|mc̣eri	<i>noun</i><br><ol><li>insect</li><li>fly</li></ol>
მწეროჲ|mc̣eroy	<i>noun</i><br><ol><li>crane (Grus spp.)</li></ol>
მჭედელი|mč̣edeli	<i>noun</i><br><ol><li>smith, blacksmith</li></ol>
მხავსი|mxavsi	<i>noun</i><br><ol><li>moss</li></ol>
მჴარი|mqari	<i>noun</i><br><ol><li>(anatomy) shoulder</li><li>(anatomy, rare) back</li><li>(anatomy, rare) armpit</li></ol>
ნათელი|nateli	<i>adj</i><br><ol><li>(figuratively) obvious, blatant</li><li>clean</li></ol><br><i>noun</i><br><ol><li>light</li><li>(beam of light) ray</li><li>candle</li></ol>
ნაკუჱრცხალი|naḳuērcxali	<i>noun</i><br><ol><li>ember</li></ol>
ნარდი|nardi	<i>noun</i><br><ol><li>nard plant, spikenard, nardin</li></ol>
ნარკი|narḳi	<i>noun</i><br><ol><li>stingray, electric ray</li></ol>
ნაძჳ|naʒu|ნაძუ|naʒwi	<i>noun</i><br><ol><li>spruce</li><li>cypress</li></ol>
ნახპეტი|naxṗeṭi	<i>noun</i><br><ol><li>governor, head of a city</li><li>tribal chief</li></ol>
ნაჴშირი|naqširi|ნაყშირი|naq̇širi	<i>noun</i><br><ol><li>coal</li></ol>
ნედლი|nedli	<i>adj</i><br><ol><li>damp, sodden, moist</li><li>fresh, green</li></ol>
ნემსი|nemsi	<i>noun</i><br><ol><li>needle</li></ol>
ნერწყჳ|nerc̣q̇u|ნერწყუ|nerc̣q̇wi	<i>noun</i><br><ol><li>spit, saliva</li></ol>
ნიადაგი|niadagi	<i>adv</i><br><ol><li>always</li></ol>
ნისლი|nisli	<i>noun</i><br><ol><li>fog, mist</li></ol>
ნიში|niši	<i>noun</i><br><ol><li>sign; omen; miracle</li></ol>
ნიჩური|ničuri	<i>noun</i><br><ol><li>muzzle</li><li>trunk</li></ol>
ოთხი|otxi	<i>num</i><br><ol><li>four</li></ol>
ორბი|orbi	<i>noun</i><br><ol><li>eagle</li></ol>
ორი|ori	<i>num</i><br><ol><li>two</li></ol>
ოქროქვაჲ|okrokvay	<i>noun</i><br><ol><li>chrysolite</li></ol>
ოქროჲ|okroy	<i>noun</i><br><ol><li>gold</li><li>silver, money</li></ol>
ოცი|oci	<i>num</i><br><ol><li>twenty</li></ol>
პავასაკი|ṗavasaḳi	<i>noun</i><br><ol><li>bag, sack</li></ol>
პაპა|ṗaṗa	<i>noun</i><br><ol><li>grandfather</li></ol>
პარჭუკი|parčuki	<i>noun</i><br><ol><li>luggage made by small things.</li></ol>
პატარა|ṗaṭara	<i>noun</i><br><ol><li>small piece of bread</li></ol>
პატიჟი|ṗaṭiži	<i>noun</i><br><ol><li>punishment</li></ol>
პატრუკი|ṗaṭruḳi	<i>noun</i><br><ol><li>wick</li></ol>
პეპელი|ṗeṗeli	<i>noun</i><br><ol><li>butterfly</li></ol>
პეტობა|ṗeṭoba	<i>noun</i><br><ol><li>supremacy, lordship</li></ol>
პილენძი|ṗilenʒi	<i>noun</i><br><ol><li>copper</li></ol>
პილწი|bilc̣i|ṗilc̣i|ბილწი	<i>adj</i><br><ol><li>filthy, abominable</li></ol>
პირი|ṗiri	<i>noun</i><br><ol><li>face, countenance</li><li>lip</li><li>muzzle, snout</li><li>job of some kind</li><li>blade, sharp edge of a weapon</li><li>edge</li></ol>
პრასაჲ|ṗrasay	<i>noun</i><br><ol><li>leek</li></ol>
რახსი|raxsi	<i>name</i><br><ol><li>Araks</li></ol>
რეზი|rezi	<i>noun</i><br><ol><li>shroud, graveclothes; body bandage</li></ol>
რვაჲ|rvay	<i>num</i><br><ol><li>eight</li></ol>
რკინაჲ|rḳinay	<i>noun</i><br><ol><li>iron</li><li>sword, blade</li><li>chain</li></ol>
რკინება|rḳineba	<i>noun</i><br><ol><li>combat, battle</li></ol>
რუ|ru|ruy|რუჲ	<i>noun</i><br><ol><li>runnel</li></ol>
საკართული|saḳartuli	<i>noun</i><br><ol><li>garter</li></ol>
საკუთარი|saḳutari	<i>adj</i><br><ol><li>own</li></ol>
სამი|sami	<i>num</i><br><ol><li>three</li></ol>
სარდიონი|sardioni	<i>noun</i><br><ol><li>cornelian</li></ol>
სარკე|sarḳe	<i>noun</i><br><ol><li>mirror</li></ol>
საროჲ|saroy	<i>noun</i><br><ol><li>cypress</li></ol>
სარტყელი|sarṭq̇eli	<i>noun</i><br><ol><li>belt, girdle</li></ol>
სატანაჲ|saṭanay	<i>noun</i><br><ol><li>adversary, opponent</li></ol>
საფეთქელი|sapetkeli	<i>noun</i><br><ol><li>(anatomy) temple</li></ol>
საფირონი|sapironi|საპფირონი|saṗpironi	<i>noun</i><br><ol><li>sapphire</li></ol>
საყუარელი|saq̇uareli	<i>noun</i><br><ol><li>friend</li></ol><br><i>adj</i><br><ol><li>lovable, favourite, dearly, beloved</li></ol>
საწმისი|sac̣misi	<i>noun</i><br><ol><li>fleece, wool</li></ol>
სახელი|saxeli	<i>noun</i><br><ol><li>name</li><li>glory, fame</li><li>(feudalism) rank, title</li><li>(rare) Alternative form of სახლი (saxli)</li></ol>
სახლი|saxli	<i>noun</i><br><ol><li>house, home, dwelling</li><li>temple (building for worship)</li><li>room</li><li>castle, fortress</li></ol>
სელი|seli	<i>noun</i><br><ol><li>flax</li><li>linen</li></ol>
სიარული|siaruli	<i>noun</i><br><ol><li>walking, going, traversing</li></ol>
სიგრძჱ|sigrʒē	<i>noun</i><br><ol><li>length</li></ol>
სიზმარი|sizmari	<i>noun</i><br><ol><li>dream (imaginary events seen in the mind while sleeping)</li></ol>
სიკუდილი|siḳudili	<i>noun</i><br><ol><li>death</li></ol>
სირაქლემი|siraklemi	<i>noun</i><br><ol><li>ostrich (Struthio camelus)</li></ol>
სირი|siri	<i>noun</i><br><ol><li>bird, chick, fledgling</li></ol>
სისხლი|sisxli	<i>noun</i><br><ol><li>blood</li></ol>
სიტყუაჲ|siṭq̇uay	<i>noun</i><br><ol><li>word</li><li>speech</li></ol>
სიყუარული|siq̇uaruli	<i>noun</i><br><ol><li>love</li><li>friendship</li></ol>
სიცილი|sicili	<i>noun</i><br><ol><li>laughter</li></ol>
სიცხჱ|sicxē	<i>noun</i><br><ol><li>heat</li></ol>
სიძჱ|siʒē|სიძეჲ|siʒey	<i>noun</i><br><ol><li>son-in-law</li><li>groom</li></ol>
სკაროსი|sḳarosi	<i>noun</i><br><ol><li>parrotfish</li></ol>
სლვა|slva	<i>noun</i><br><ol><li>walking, moving, going</li></ol>
სოველი|soveli	<i>adj</i><br><ol><li>wet</li></ol>
სოვი|sovi	<i>noun</i><br><ol><li>vulture</li></ol>
სომეხი|somexi	<i>noun</i><br><ol><li>Armenian, a person from Armenia or of Armenian descent</li></ol>
სპანიაჲ|sṗaniay	<i>name</i><br><ol><li>Hispania</li></ol>
სპარსეთი|sṗarseti	<i>name</i><br><ol><li>Persia</li></ol>
სპარსი|sṗarsi	<i>noun</i><br><ol><li>A person from Persia</li></ol>
სრა|sra	<i>noun</i><br><ol><li>palace</li></ol>
სტიქონი|სტრიქონი|sṭikoni|sṭrikoni	<i>noun</i><br><ol><li>a line of poetry, a verse</li></ol>
სტუმარი|sṭumari	<i>noun</i><br><ol><li>guest</li></ol>
სუანი|suani	<i>noun</i><br><ol><li>a person from Svaneti; Svan.</li></ol>
სუეტი|sueṭi	<i>noun</i><br><ol><li>pillar</li></ol>
სუეტიცხოველი|sueṭicxoveli	<i>name</i><br><ol><li>Svetitskhoveli, a 4th century orthodox cathedral in Mtskheta, Georgia.</li></ol>
სული|suli	<i>noun</i><br><ol><li>man, person</li><li>ghost, particularly an "evil" one</li><li>corpse (?)</li><li>head</li><li>air</li><li>wind</li><li>the act of breathing</li><li>steam</li><li>odour, smell</li><li>Holy Spirit</li></ol>
სფჳრიდი|ფსჳრიდი|spwiridi|spiridi|სფირიდი|pswiridi	<i>noun</i><br><ol><li>basket of cylindrical shape</li></ol>
სძჱ|sʒē|სძეჲ|sʒey|sʒe|სძე	<i>noun</i><br><ol><li>milk</li></ol>
სხალი|sxali	<i>noun</i><br><ol><li>pear</li><li>Pyrus (pear tree)</li></ol>
სხუაჲ|sxuay	<i>pron</i><br><ol><li>other</li></ol>
სხჳლი|sxwili|sxuili|სხუილი	<i>adj</i><br><ol><li>thick</li></ol>
სჳნდისი|swinidisi|swindisi|სჳნიდისი	<i>noun</i><br><ol><li>conscience</li></ol>
ტაბლაჲ|ṭablay	<i>noun</i><br><ol><li>table</li></ol>
ტაგარი|ṭagari	<i>noun</i><br><ol><li>clay bowl/pitcher</li><li>grapepressing trough</li></ol>
ტაკუკი|ṭaḳuḳi	<i>noun</i><br><ol><li>a small wine vessel</li></ol>
ტაპაკი|ṭaṗaḳi	<i>noun</i><br><ol><li>frying pan</li></ol>
ტაროსი|ṭarosi	<i>noun</i><br><ol><li>climate</li><li>good weather</li></ol>
ტაძარი|ṭaʒari	<i>noun</i><br><ol><li>cathedral, sanctuary, temple</li><li>palace</li><li>feast, banquet</li></ol>
ტახტი|ṭaxṭi	<i>noun</i><br><ol><li>seat, bench</li></ol>
ტბაჲ|ṭbay	<i>noun</i><br><ol><li>lake</li></ol>
ტეგანი|ṭegani	<i>noun</i><br><ol><li>rue, Ruta</li></ol>
ტერება|tereba	<i>noun</i><br><ol><li>to take care (of), to look after</li></ol>
ტერემინთოჲ|ṭeremintoy	<i>noun</i><br><ol><li>terebinth (Pistacia terebinthus)</li></ol>
ტილი|ṭili	<i>noun</i><br><ol><li>louse</li></ol>
ტკბილი|ṭḳbili	<i>adj</i><br><ol><li>sweet</li></ol>
ტკივილი|ṭḳivili	<i>noun</i><br><ol><li>the act of feeling sorry, bad about someone or something</li></ol>
ტრედი|ṭredi	<i>noun</i><br><ol><li>pigeon, dove</li></ol>
ტფილი|ṭpili	<i>adj</i><br><ol><li>warm</li></ol>
ტფილისი|ṭpilisi	<i>name</i><br><ol><li>Tbilisi</li></ol>
ტყავი|ṭq̇avi	<i>noun</i><br><ol><li>leather</li><li>skin</li></ol>
ტყჱ|ṭq̇ē	<i>noun</i><br><ol><li>forest</li></ol>
ტყჳვი|ṭq̇wivi	<i>noun</i><br><ol><li>lead (metal, chemical element), tin (metal), plumbum (chemical element)</li></ol>
ტჳნი|ṭwini	<i>noun</i><br><ol><li>brain</li></ol>
უბნობაჲ|ubnobay	<i>noun</i><br><ol><li>conversation</li></ol>
უბნობს|ubnobs|უბნობაჲ|ubnobay	<i>verb</i><br><ol><li>(intransitive) to say</li></ol>
უნაგირი|unagiri	<i>noun</i><br><ol><li>saddle</li></ol>
ურაკპარაკი|uraḳṗaraḳi	<i>noun</i><br><ol><li>public place, public square, street</li></ol>
უროჲ|uroy	<i>noun</i><br><ol><li>hammer, sledgehammer</li></ol>
ურჩხი|určxi	<i>noun</i><br><ol><li>large intestine</li></ol>
უტევანი|uṭevani	<i>noun</i><br><ol><li>stadium (measure of distance)</li></ol>
უფალი|upali	<i>noun</i><br><ol><li>The Lord</li></ol>
უჩს|učs	<i>verb</i><br><ol><li>(intransitive) to see as, to consider as, to think as</li></ol>
ფაკელი|paḳeli	<i>noun</i><br><ol><li>phelonion</li><li>headscarf</li></ol>
ფაკეოლი|paḳeoli	<i>noun</i><br><ol><li>face towel, handkerchief</li></ol>
ფანდური|panduri	<i>noun</i><br><ol><li>panduri</li></ol>
ფარშამანგი|paršamagi|ფარშამაგი|paršamangi	<i>noun</i><br><ol><li>peacock, peafowl</li></ol>
ფაწალი|pac̣ala|pac̣ali|ფაწალა	<i>noun</i><br><ol><li>(anatomy) spleen</li></ol>
ფერჴი|ფეჴი|perqi|peqi	<i>noun</i><br><ol><li>foot</li></ol>
ფეტჳ|peṭwi	<i>noun</i><br><ol><li>millet</li></ol>
ფილაკვანი|pilaḳvani	<i>noun</i><br><ol><li>siege catapult</li></ol>
ფირტჳ|pirṭwi|pirṭu|ფირტუ	<i>noun</i><br><ol><li>lung</li></ol>
ფიცი|pici	<i>noun</i><br><ol><li>adjuration, oath</li></ol>
ფიჭჳ|pič̣wi	<i>noun</i><br><ol><li>pine</li></ol>
ფოლი|poli	<i>noun</i><br><ol><li>money</li></ol>
ფუვინკაჲ|puvinḳay	<i>noun</i><br><ol><li>phoenix</li></ol>
ფურცელი|purceli	<i>noun</i><br><ol><li>leaf (part of a plant)</li><li>paper</li></ol>
ფუტკარი|puṭḳari	<i>noun</i><br><ol><li>bee</li></ol>
ფუტურო|puṭuro	<i>noun</i><br><ol><li>hollow (in a tree)</li><li>rotten tree</li></ol>
ფუშჳ|pušwi	<i>noun</i><br><ol><li>hernia</li></ol>
ფქვილი|pkvili	<i>noun</i><br><ol><li>flour</li><li>millstone</li></ol>
ფჳნიქსი|pwiniksi	<i>noun</i><br><ol><li>phoenix</li></ol>
ქათამი|katami	<i>noun</i><br><ol><li>chicken</li></ol>
ქალაქი|kalaki	<i>noun</i><br><ol><li>city</li></ol>
ქალაქპეტი|kalakṗeṭi	<i>noun</i><br><ol><li>politarch, ruler, governor, mayor (of a city)</li></ol>
ქალი|kali	<i>noun</i><br><ol><li>woman</li><li>wife</li></ol>
ქარანძავი|karanʒavi	<i>noun</i><br><ol><li>cave</li></ol>
ქართველი|kartveli	<i>noun</i><br><ol><li>(person) Georgian</li></ol>
ქართლი|kartli	<i>name</i><br><ol><li>kingdom of Georgia</li><li>Kartli (region)</li></ol>
ქართული|kartuli	<i>adj</i><br><ol><li>(of inanimate objects) Georgian</li></ol><br><i>noun</i><br><ol><li>Georgian language</li></ol>
ქერი|keri	<i>noun</i><br><ol><li>barley</li></ol>
ქვაჲ|kvay	<i>noun</i><br><ol><li>stone, boulder</li><li>(rare) eye</li></ol>
ქინძი|kinʒi	<i>noun</i><br><ol><li>coriander</li></ol>
ქმარი|kmari	<i>noun</i><br><ol><li>husband</li></ol>
ქონი|koni	<i>noun</i><br><ol><li>fat</li></ol>
ქორი|kori	<i>noun</i><br><ol><li>northern goshawk (Accipiter gentilis)</li><li>upstairs</li><li>room (upstairs)</li><li>(rare) home</li></ol>
ქუეყანა|kueq̇ana	<i>noun</i><br><ol><li>ground, earth</li><li>(by extension) land, territory</li><li>(by extension) country</li></ol>
ქურქუმაჲ|kurkumay	<i>noun</i><br><ol><li>crocus, crocum</li></ol>
ღამე|ɣamē|ɣame|ღამჱ	<i>noun</i><br><ol><li>night</li></ol>
ღმერთი|ɣmerti	<i>noun</i><br><ol><li>god</li></ol>
ღობჱ|ɣobē	<i>noun</i><br><ol><li>fence, hedge</li></ol>
ღორი|ɣori	<i>noun</i><br><ol><li>pig</li></ol>
ღრმაჲ|ɣrmay	<i>adj</i><br><ol><li>deep, profound</li></ol>
ღუარძლი|ɣuarʒli	<i>noun</i><br><ol><li>darnel, poison darnel (Lolium temulentum)</li></ol>
ღუედი|ɣuedi	<i>noun</i><br><ol><li>belt, strap</li><li>leash, twine of yoke</li></ol>
ღჳვი|ɣwivi	<i>noun</i><br><ol><li>juniper tree</li></ol>
ღჳნო|ɣwino	<i>noun</i><br><ol><li>wine</li><li>vinegar</li></ol>
ღჳძლი|ɣwiʒli	<i>noun</i><br><ol><li>(anatomy) liver</li></ol>
ყანაჲ|q̇anay	<i>noun</i><br><ol><li>cornfield</li><li>ploughed field</li></ol>
ყანჩი|q̇anči	<i>noun</i><br><ol><li>vulture</li></ol>
ყაჭი|q̇ač̣i	<i>noun</i><br><ol><li>silk</li></ol>
ყელი|q̇eli	<i>noun</i><br><ol><li>throat</li></ol>
ყიაჲ|q̇iay	<i>noun</i><br><ol><li>gullet, throat, glottis</li></ol>
ყიდვა|q̇idva	<i>noun</i><br><ol><li>to buy</li><li>to bribe</li></ol>
ყინელი|q̇ineli	<i>noun</i><br><ol><li>cold (weather, object etc.)</li><li>freeze (a period of intensely cold weather.)</li></ol><br><i>adj</i><br><ol><li>freezing</li><li>cold</li></ol>
ყრუ|q̇ru	<i>noun</i><br><ol><li>a deaf person</li></ol>
ყუელი|q̇ueli	<i>noun</i><br><ol><li>cheese</li></ol>
ყური|q̇uri	<i>noun</i><br><ol><li>ear</li><li>handle (part of an object which is held in the hand when used or moved)</li></ol>
ყურძენი|q̇urʒeni	<i>noun</i><br><ol><li>grape</li></ol>
ყჳთელი|q̇witeli	<i>adj</i><br><ol><li>yellow</li></ol>
ყჳნი|q̇wini	<i>noun</i><br><ol><li>forehead</li></ol>
შაბათი|šapati|šabati|შაფათი	<i>noun</i><br><ol><li>Saturday</li></ol>
შალილი|šalili	<i>noun</i><br><ol><li>corpse, cadaver</li></ol>
შარავანდი|šaravandi	<i>noun</i><br><ol><li>royal crown</li></ol>
შაფირი|šapiri	<i>noun</i><br><ol><li>sapphire</li></ol>
შაშუ|šašu	<i>noun</i><br><ol><li>thrush (Turdidae)</li></ol>
შენ|šen	<i>pron</i><br><ol><li>you</li></ol>
შეშაჲ|šešay	<i>noun</i><br><ol><li>firewood</li><li>tree</li></ol>
შვილი|švili	<i>noun</i><br><ol><li>child, son, daughter</li></ol>
შობაჲ|šobay	<i>noun</i><br><ol><li>birth, delivery</li><li>(Christianity) Christmas</li></ol>
შოლტი|šolṭi	<i>noun</i><br><ol><li>whip</li></ol>
შროშანი|šrošani	<i>noun</i><br><ol><li>lily</li></ol>
შუბლი|šubli	<i>noun</i><br><ol><li>forehead</li></ol>
შუენიერი|šuenieri	<i>noun</i><br><ol><li>beautiful, beauteous</li><li>kind</li><li>honest, truthful, forthright</li></ol>
შურდული|šurduli	<i>noun</i><br><ol><li>sling</li></ol>
შუშპარი|šušṗari	<i>noun</i><br><ol><li>circle dance</li></ol>
შჳდი|šwidi	<i>num</i><br><ol><li>seven</li></ol>
ჩაფი|čapi	<i>noun</i><br><ol><li>jug</li></ol>
ჩაფლაჲ|čaplay	<i>noun</i><br><ol><li>shoe, sandal</li></ol>
ჩაჴჳ|čaqwi	<i>noun</i><br><ol><li>small leather bag</li></ol>
ჩუენ|čuen	<i>pron</i><br><ol><li>we</li></ol>
ჩუენი|čueni	<i>pron</i><br><ol><li>our</li></ol>
ჩხიკჳ|ჩხიკუ|čxiḳu|čxiḳwi	<i>noun</i><br><ol><li>(bird): jay</li></ol>
ცაცხჳ|cacxwi	<i>noun</i><br><ol><li>lime tree, linden</li></ol>
ცაჲ|cay	<i>noun</i><br><ol><li>sky</li></ol>
ცელი|celi	<i>noun</i><br><ol><li>scythe</li></ol>
ცერი|ceri	<i>noun</i><br><ol><li>thumb</li></ol>
ცეცხლი|cecxli	<i>noun</i><br><ol><li>fire</li><li>ember</li><li>stove, cooker</li></ol>
ციცხჳ|cicxwi	<i>noun</i><br><ol><li>wooden ladle</li></ol>
ციხჱ|cixē	<i>noun</i><br><ol><li>fortress</li><li>jail, prison</li></ol>
ცოლი|coli	<i>noun</i><br><ol><li>wife</li></ol>
ცოცხალი|cocxali	<i>adj</i><br><ol><li>alive</li><li>healthy</li></ol>
ცუდი|cudi	<i>adj</i><br><ol><li>futile, vain</li></ol>
ცხელი|cxeli	<i>noun</i><br><ol><li>hot</li></ol>
ცხენი|cxeni	<i>noun</i><br><ol><li>horse</li></ol>
ცხოვარი|cxovari	<i>noun</i><br><ol><li>livestock</li></ol>
ცხოველი|cxoveli	<i>noun</i><br><ol><li>animal</li><li>beast</li></ol><br><i>adj</i><br><ol><li>alive, animate</li></ol>
ცხორებაჲ|cxorebay	<i>noun</i><br><ol><li>life</li><li>adventure</li><li>enlightenment (often religious)</li></ol>
ცხრაჲ|cxray	<i>num</i><br><ol><li>nine</li></ol>
ცხჳრი|cxwiri	<i>noun</i><br><ol><li>nose</li><li>snout, muzzle</li></ol>
ცჳლი|ცჳნი|cwini|cwili	<i>noun</i><br><ol><li>wax</li></ol>
ძალი|ʒali	<i>noun</i><br><ol><li>power, force, strength</li></ol>
ძამლი|ʒamli	<i>noun</i><br><ol><li>rat</li></ol>
ძარღჳ|ʒarɣu|ძარღუ|ʒarɣwi	<i>noun</i><br><ol><li>(blood vessel) vein</li><li>capillary</li><li>artery</li></ol>
ძაღლი|ʒaɣli	<i>noun</i><br><ol><li>dog</li></ol>
ძელი|ʒeli	<i>noun</i><br><ol><li>tree, wood</li><li>an improvised boat; raft</li><li>boat</li><li>stick</li><li>cross</li></ol>
ძელქვაჲ|ʒelkvay	<i>noun</i><br><ol><li>Populus alba, a kind of a tree.</li></ol>
ძერი|ʒeri	<i>noun</i><br><ol><li>kite, falcon</li></ol>
ძეწნი|ʒec̣ni	<i>noun</i><br><ol><li>willow (Salix)</li></ol>
ძილი|ʒili	<i>noun</i><br><ol><li>sleep</li></ol>
ძირი|ʒiri	<i>noun</i><br><ol><li>bilge</li><li>root, bottom</li></ol>
ძლიერი|ʒlieri	<i>adj</i><br><ol><li>strong</li></ol>
ძმარი|ʒmari	<i>noun</i><br><ol><li>vinegar</li></ol>
ძმაჲ|ʒmay	<i>noun</i><br><ol><li>brother</li></ol>
ძუალი|ʒuali	<i>noun</i><br><ol><li>bone</li></ol>
ძუელი|ʒueli	<i>adj</i><br><ol><li>old</li></ol>
ძუძუჲ|ʒuʒuy	<i>noun</i><br><ol><li>(anatomy) breast (female)</li></ol>
ძჱ|ძეჲ|ʒē|ძენი|ʒey	<i>noun</i><br><ol><li>son</li></ol>
წალკოტი|c̣alḳoṭi	<i>noun</i><br><ol><li>(magnificent) garden/orchard</li></ol>
წამალი|c̣amali	<i>noun</i><br><ol><li>paint, dye</li><li>medicine</li></ol>
წამი|c̣ami	<i>noun</i><br><ol><li>minute (one-sixtieth of an hour)</li><li>moment</li><li>eyelash</li></ol>
წამწამი|c̣amc̣ami	<i>noun</i><br><ol><li>eyelash</li></ol>
წარბი|c̣arbi	<i>noun</i><br><ol><li>eyebrow</li></ol>
წებო|c̣ebo	<i>noun</i><br><ol><li>glue</li></ol>
წელი|c̣eli	<i>noun</i><br><ol><li>year</li><li>intestine</li></ol>
წითელი|c̣iteli	<i>adj</i><br><ol><li>red</li><li>table of contents (of a book)</li><li>ark</li></ol>
წმიდა|c̣mida	<i>adj</i><br><ol><li>holy</li></ol>
წოდებაჲ|c̣odebay	<i>noun</i><br><ol><li>title, rank</li></ol>
წუა|c̣ua	<i>noun</i><br><ol><li>the act of burning</li></ol>
წუენი|c̣ueni	<i>noun</i><br><ol><li>soup</li><li>juice, sap</li></ol>
წუერი|c̣ueri	<i>noun</i><br><ol><li>beard</li><li>top, point</li></ol>
წუთი|c̣uti	<i>adj</i><br><ol><li>momentary</li></ol>
წული|c̣uli	<i>noun</i><br><ol><li>child, son, daughter</li></ol>
წუხილი|c̣uxili	<i>noun</i><br><ol><li>anxiety, grief, sadness</li></ol>
წყალი|c̣q̇ali	<i>noun</i><br><ol><li>water</li><li>river</li></ol>
წჳმაჲ|c̣wimay	<i>noun</i><br><ol><li>rain</li></ol>
ჭაკუნტელი|č̣aḳunṭeli	<i>noun</i><br><ol><li>beetroot</li></ol>
ჭამა|č̣ama	<i>noun</i><br><ol><li>to eat</li></ol>
ჭაჰრი|č̣ahri	<i>noun</i><br><ol><li>a kind of bird, possibly gull or osprey</li></ol>
ჭიქაჲ|č̣ikay	<i>noun</i><br><ol><li>glass, cup, mug</li></ol>
ჭორტი|č̣orṭi	<i>noun</i><br><ol><li>cairn, heap of stones</li></ol>
ჭრელი|č̣reli	<i>adj</i><br><ol><li>particoloured, piebald, pied, pockmarked, variegated, motley, multicolored</li></ol>
ჭური|č̣uri	<i>noun</i><br><ol><li>vessel, container, wine jug</li></ol>
ხარაბუზი|xarabuzi	<i>noun</i><br><ol><li>a kind of wild goat or antelope</li></ol>
ხარკი|xarḳi	<i>noun</i><br><ol><li>levy, tax</li></ol>
ხარჭი|xarč̣i	<i>noun</i><br><ol><li>concubine</li></ol>
ხე|xe	<i>noun</i><br><ol><li>tree</li></ol>
ხეთქა|xetka	<i>verb</i><br><ol><li>[He/she/it] cracked, tore, broke, burst</li></ol>
ხელი|xeli	<i>noun</i><br><ol><li>insane</li></ol>
ხენეში|xeneši	<i>adj</i><br><ol><li>bad, evil</li></ol>
ხერხი|xerxi	<i>noun</i><br><ol><li>saw (tool for sawing)</li></ol>
ხნარცვი|xnarcvi	<i>noun</i><br><ol><li>pit</li></ol>
ხუთი|xuti	<i>num</i><br><ol><li>five</li></ol>
ხუცესი|ხუცესნი|xuc'esi	<i>noun</i><br><ol><li>priest</li></ol>
ჯაჭუ|ჯაჭჳ|ǯač̣wi|ǯač̣u	<i>noun</i><br><ol><li>chain</li><li>fetters</li><li>chain mail</li></ol>
ჯინჭარი|ǯinč̣ari	<i>noun</i><br><ol><li>nettle</li></ol>
ჯინჭველი|ǯinč̣veli	<i>noun</i><br><ol><li>ant</li></ol>
ჯიპოსი|ǯiṗosi	<i>noun</i><br><ol><li>vulture</li></ol>
ჯუარი|ǯuari	<i>noun</i><br><ol><li>cross</li><li>(Christianity) cross</li></ol>
ჰამო|hamo	<i>adj</i><br><ol><li>delicious</li><li>pleasant, delightful</li></ol>
ჰანი|hani	<i>noun</i><br><ol><li>grandmother</li></ol>
ჰასაკი|hasaḳi	<i>noun</i><br><ol><li>age</li><li>height, stature</li></ol>
ჰურიაჲ|huriay	<i>noun</i><br><ol><li>Jew</li></ol>
ჴამლი|qamli	<i>noun</i><br><ol><li>a certain type of medieval footwear, usually made out of sheep skin; essentially a turnshoe</li></ol>
ჴარი|qari	<i>noun</i><br><ol><li>ox</li></ol>
ჴევი|qevi	<i>noun</i><br><ol><li>ravine, gorge</li><li>valley</li></ol>
ჴელი|qeli|xeli|ხელი	<i>noun</i><br><ol><li>(anatomy) hand</li><li>document</li><li>signature</li></ol>
ჴიდი|qidi	<i>noun</i><br><ol><li>bridge</li></ol>
ჴმალი|qmali	<i>noun</i><br><ol><li>sword</li></ol>
ჴმაჲ|qmay	<i>noun</i><br><ol><li>sound, voice</li></ol>
ჴორცი|qorci	<i>noun</i><br><ol><li>flesh</li><li>meat</li></ol>
ჴოჴობი|qoqobi	<i>noun</i><br><ol><li>pheasant</li></ol>
ჴუამალდი|quamaldi	<i>noun</i><br><ol><li>ship, boat</li></ol>
ჴუეზაჲ|quezay	<i>noun</i><br><ol><li>loaf of bread, pie</li></ol>
ჴუნდი|qundi	<i>noun</i><br><ol><li>(leg) shackles, stocks</li></ol>
