Rotta|Rotta.	
a|ā	<i>noun</i><br><ol><li>river, stream, water</li></ol>
afterthinsan	<i>verb</i><br><ol><li>to pull back</li><li>to pull away</li></ol>
aftir	<i>prep</i><br><ol><li>after</li></ol>
aginnan|āginnan	<i>verb</i><br><ol><li>to begin</li></ol>
ahton	
al|allu|olla|allan|allin|allis|allon|allno|allro|alle|allo|alla|allrō	<i>adj</i><br><ol><li>all, every</li><li>whole, entire</li></ol><br><i>adv</i><br><ol><li>completely, wholly</li></ol><br><i>conj</i><br><ol><li>even though</li></ol>
also|alsō	<i>adv</i><br><ol><li>so, thus</li><li>so, to that degree</li><li>therefore</li></ol><br><i>conj</i><br><ol><li>as, like</li><li>as if</li><li>when</li><li>because</li><li>so that</li></ol>
alt|alda|alde|aldrō|aldo|aldin|aldro|aldon|aldis|aldan|aldno|aldu	<i>adj</i><br><ol><li>old</li></ol>
ambahtman	<i>noun</i><br><ol><li>servant, civil servant</li></ol>
anafallan	<i>verb</i><br><ol><li>to let oneself fall upon, to attack</li></ol>
anafan	<i>verb</i><br><ol><li>to commence, to begin</li></ol>
anafehtan	<i>verb</i><br><ol><li>to fight against, to combat</li></ol>
anafindan	<i>verb</i><br><ol><li>to find, to come across</li></ol>
anagan|anagān	<i>verb</i><br><ol><li>to go, to walk</li><li>to undergo, to suffer</li></ol>
ananeman	
anasian	<i>verb</i><br><ol><li>to watch, to view</li></ol>
anasprecan	<i>verb</i><br><ol><li>to speak to, to address</li></ol>
anastotan|anastōtan	<i>verb</i><br><ol><li>to bump against</li></ol>
ande	<i>conj</i><br><ol><li>and</li></ol>
ando	<i>noun</i><br><ol><li>zeal</li></ol>
andon	<i>verb</i><br><ol><li>to be jealous of</li></ol>
antbidan|antbidin|antbīdunt|antbeid|antbīdit|antbīdandi|antbīdes|antbīd|antbidi|antbidun|antbīdist|antbīdan|antbīde|antbidis|antbīdis|antbīdu|antbidint|antbidut|antbīdent|antbīdet|antbidit|antbidist|antbīdon|geantbidon|antbīdest|antbīden	<i>verb</i><br><ol><li>to wait for, to expect</li></ol>
antbindan	<i>verb</i><br><ol><li>to untie, to loosen</li></ol>
antfan|antfān	<i>verb</i><br><ol><li>to receive, to get</li><li>to take in</li></ol>
antfliegan	<i>verb</i><br><ol><li>to fly away, to escape by flying</li></ol>
antgan|antgān	<i>verb</i><br><ol><li>to get away, to escape</li></ol>
antgeldan	<i>verb</i><br><ol><li>to pay for (as punishment)</li></ol>
antlatan|antlātan	<i>verb</i><br><ol><li>to let go</li></ol>
antlucan|antlūcan	<i>verb</i><br><ol><li>to open</li></ol>
antquethan	<i>verb</i><br><ol><li>to answer</li></ol>
antrinnan	<i>verb</i><br><ol><li>to escape, to run away</li></ol>
antstan|antstān	<i>verb</i><br><ol><li>to begin, to come</li></ol>
anttian	<i>verb</i><br><ol><li>to not give, to refuse, to keep from</li></ol>
antwican|antwīcan	<i>verb</i><br><ol><li>to disappear, to go away</li></ol>
antworden	<i>verb</i><br><ol><li>to answer</li></ol>
appoldro	<i>noun</i><br><ol><li>Apeldoorn (a city in modern Gelderland, the Netherlands)</li></ol>
ardon	<i>verb</i><br><ol><li>to live, to dwell</li></ol>
arm	<i>noun</i><br><ol><li>arm</li></ol><br><i>adj</i><br><ol><li>poor</li></ol>
armo	<i>noun</i><br><ol><li>poor person</li></ol>
arnon	<i>verb</i><br><ol><li>to earn</li></ol>
ars	<i>noun</i><br><ol><li>arse, buttock</li></ol>
aton|āton	<i>verb</i><br><ol><li>to feed</li></ol>
avacuman	<i>verb</i><br><ol><li>to rid oneself of, to distance oneself from</li></ol>
avagan|avagān	<i>verb</i><br><ol><li>to leave, to go away from</li><li>to stray from, to not follow</li></ol>
avaneman	<i>verb</i><br><ol><li>to take from, to take away</li></ol>
avaslan|avaslān	<i>verb</i><br><ol><li>to slice off, to sever</li></ol>
avastan|avastān	<i>verb</i><br><ol><li>to separate oneself from, to leave</li><li>to relinquish, to give up</li></ol>
baco	<i>noun</i><br><ol><li>bacon</li></ol>
balco	<i>noun</i><br><ol><li>beam, log</li></ol>
bar	<i>adj</i><br><ol><li>bare, naked</li></ol>
baron	<i>verb</i><br><ol><li>to reveal, to make public</li><li>to reveal, to lay bare, to make public</li></ol>
bathon	<i>verb</i><br><ol><li>to bathe</li></ol>
bedon	<i>verb</i><br><ol><li>to worship</li></ol>
behalvo	<i>adv</i><br><ol><li>back</li></ol>
beki|beke	<i>noun</i><br><ol><li>brook</li></ol>
belgan	<i>verb</i><br><ol><li>to get angry</li></ol>
ben|bēnis|bēn|bēnon|bēno|bēne	<i>noun</i><br><ol><li>leg</li><li>bone</li></ol>
beran	<i>verb</i><br><ol><li>to bear, to carry</li></ol>
berg	<i>noun</i><br><ol><li>mountain, hill</li></ol>
bergan	<i>verb</i><br><ol><li>to shelter, to hide</li></ol>
bethiu	<i>adv</i><br><ol><li>therefore, thus</li></ol>
bevar	<i>noun</i><br><ol><li>beaver</li></ol>
bi|bī	<i>prep</i><br><ol><li>by, near</li><li>at, with</li></ol>
bia|bīa	<i>noun</i><br><ol><li>bee</li></ol>
bicuman	<i>verb</i><br><ol><li>to approach, to come to meet</li></ol>
bidan|bidut|bīdunt|gebidon|bidint|bidist|bidit|bīdist|bīdet|bīdan|bīd|bīdandi|bīdis|bīdon|bīden|bīdest|bīdent|bidun|bīde|bīdit|bīdes|bidis|beid|bīdu|bidi|bidin	<i>verb</i><br><ol><li>to wait</li><li>to remain, stay</li></ol>
bidden	<i>verb</i><br><ol><li>to ask urgently, to request, to beg</li></ol>
bidriegan	<i>verb</i><br><ol><li>to deceive</li></ol>
biedan	<i>verb</i><br><ol><li>to offer</li></ol>
bifan|bifān	<i>verb</i><br><ol><li>to catch, to grab</li><li>to learn, to understand</li></ol>
bifelan	<i>verb</i><br><ol><li>to entrust to</li><li>to command</li></ol>
bifindan	<i>verb</i><br><ol><li>to find out</li><li>to experience</li></ol>
bigan|bigān	<i>verb</i><br><ol><li>to do, to carry out</li><li>to hold, to celebrate</li></ol>
bigian	<i>verb</i><br><ol><li>to profess, to acknowledge (God)</li></ol>
biginnan	<i>verb</i><br><ol><li>to begin</li><li>to form</li></ol>
biglidan|biglīdan	<i>verb</i><br><ol><li>to slide away</li></ol>
bigravan	<i>verb</i><br><ol><li>to bury</li></ol>
bigripan|bigrīpan	<i>verb</i><br><ol><li>to encompass, to include</li><li>to enclose</li><li>to conquer</li></ol>
bihaldan	<i>verb</i><br><ol><li>to keep, to hold</li><li>to retain</li><li>to rescue</li></ol>
bihelan	<i>verb</i><br><ol><li>to hide, to conceal</li></ol>
bihouwan	<i>verb</i><br><ol><li>to work by hewing</li></ol>
bilithen	<i>verb</i><br><ol><li>to form, to shape</li><li>to raise, to educate</li><li>to follow, to imitate</li></ol>
bilivan|bilīvan	<i>verb</i><br><ol><li>to remain, to stay, to continue</li><li>to remain behind, to stay behind</li><li>to dwell</li><li>to die</li></ol>
bilucan|bilūcan	<i>verb</i><br><ol><li>to close, to shut</li><li>to lock up</li></ol>
bindan|bindit|binde|bint|bundint|bundut|bundist|bindandi|gebundon|bant|bindest|bundi|bindu|binden|bindon|bindent|bindes|bundit|bindis|bindet|bindist|bindunt|bundin|bundun|bundis	<i>verb</i><br><ol><li>to bind, to join</li></ol>
bineman	<i>verb</i><br><ol><li>to take from, to rob of</li></ol>
biradan|birādan	<i>verb</i><br><ol><li>to advise</li></ol>
birinnan	<i>verb</i><br><ol><li>to wash over, to flood</li></ol>
bisian	<i>verb</i><br><ol><li>to look at, to inspect</li></ol>
bisitten	<i>verb</i><br><ol><li>to own</li></ol>
bislidan|bislīdan	<i>verb</i><br><ol><li>to lubricate, to make slippery</li></ol>
bisnithan|bisnīthan	<i>verb</i><br><ol><li>to circumcise</li></ol>
bisprecan	<i>verb</i><br><ol><li>to discuss</li></ol>
bistan|bistān	<i>verb</i><br><ol><li>to continue, to persevere</li></ol>
bisweren	<i>verb</i><br><ol><li>to beg, to request urgently</li></ol>
biswican|biswīcan	<i>verb</i><br><ol><li>to make stumble, to make fall down</li><li>to deceive</li></ol>
bitan|bītunt|bitis|bitist|bitit|bīten|bītis|bitun|bitin|bītist|bitint|bītit|bīton|gebiton|bēt|bītandi|bīte|biti|bītan|bītest|bitut|bīt|bītu|bītet|bītent|bītes	<i>verb</i><br><ol><li>to bite</li></ol>
bithervi	<i>adj</i><br><ol><li>brave, bold</li></ol>
bithwingan	<i>verb</i><br><ol><li>to restrain, to subdue</li></ol>
biwaldan	<i>verb</i><br><ol><li>to possess</li></ol>
biwellan	<i>verb</i><br><ol><li>to dirty, to soil</li><li>to defile</li><li>to curse</li></ol>
biwerpan	<i>verb</i><br><ol><li>to reject</li></ol>
blican|blīcan	<i>verb</i><br><ol><li>to shine</li></ol>
blindo	<i>noun</i><br><ol><li>blind person</li></ol>
blint|blindo|blindrō|blindno|blindan|blindin|blinda|blindis|blindu|blinde|blindro|blindon	<i>adj</i><br><ol><li>blind</li></ol>
blithen|blīthen	<i>verb</i><br><ol><li>to be/become happy</li></ol>
blithi|blīthi	<i>adj</i><br><ol><li>calm</li><li>happy</li></ol>
bliuwan	<i>verb</i><br><ol><li>to beat</li></ol>
blivan|blivist|blīvent|blīve|blīvu|blivit|blivi|blīven|blēf|blīvan|blīvunt|blīvest|blīvandi|blīvit|blīv|blīvis|blivin|blivint|blivun|blīvet|blīves|blivut|blīvist|geblivon|blīvon|blivis	<i>verb</i><br><ol><li>to remain</li><li>to stay</li></ol>
bluoien	<i>verb</i><br><ol><li>to bloom</li></ol>
bluot|bluote|bluoton|bluoto|bluotis	<i>noun</i><br><ol><li>blood</li></ol>
bodo	<i>noun</i><br><ol><li>messenger</li></ol>
bogen	<i>verb</i><br><ol><li>to cause to bend</li></ol>
bogo|bogin|bogono|bogon	<i>noun</i><br><ol><li>bow (weapon)</li></ol>
bom|bōm	<i>noun</i><br><ol><li>tree</li></ol>
bona|bōna	<i>noun</i><br><ol><li>bean</li></ol>
bort	<i>noun</i><br><ol><li>board, plank</li></ol>
bosi|bōsi	<i>adj</i><br><ol><li>evil</li></ol>
bradan|brādan	<i>verb</i><br><ol><li>to roast</li></ol>
brado|brādo	<i>noun</i><br><ol><li>roast, roasted meat</li></ol>
brecan|breket|breku|brākist|breken|brekandi|brākin|breke|gebrokon|brāki|brik|brikis|brākit|brekent|brekes|brikist|brekunt|brikit|brekon|brak|brākint|brekest|brākun|brākut|brākis|brekan	<i>verb</i><br><ol><li>to break</li></ol>
bred|brēd	<i>adj</i><br><ol><li>broad, wide</li></ol>
breiden	<i>verb</i><br><ol><li>to widen, to broaden</li></ol>
brennen	<i>verb</i><br><ol><li>to burn</li></ol>
brestan	<i>verb</i><br><ol><li>to burst</li><li>to be missing</li></ol>
bringan|bringon|gebraht|brāhti|brāhtis|bringandi|bringu|bringes|bringis|bringunt|bringit|brāhtin|brāhtun|bring|brāhtist|bringet|bringen|bringe|braht|bringist|bringent|brāhtut|brāhtit|bringest|brāhtint	<i>verb</i><br><ol><li>to bring</li></ol>
brinnan	<i>verb</i><br><ol><li>to burn</li></ol>
brudigomo|brūdigomo	<i>noun</i><br><ol><li>bridegroom</li></ol>
brugga	<i>noun</i><br><ol><li>bridge</li></ol>
brunno	<i>noun</i><br><ol><li>well, source</li></ol>
bruoc	<i>noun</i><br><ol><li>trousers, pants, breeches</li><li>wetland, marsh</li></ol>
buc|būc	<i>noun</i><br><ol><li>buck, male goat</li><li>belly, stomach</li><li>womb</li></ol>
budilio	<i>noun</i><br><ol><li>Budel (a village in modern North Brabant, the Netherlands)</li></ol>
bugan|būgan	<i>verb</i><br><ol><li>to bend</li></ol>
buok|Book.	
burg	<i>noun</i><br><ol><li>fortress, castle</li><li>city</li></ol>
burstil	<i>noun</i><br><ol><li>bristle, prickle</li></ol>
busc	<i>noun</i><br><ol><li>bush</li></ol>
calf	<i>noun</i><br><ol><li>calf</li></ol>
casto	<i>noun</i><br><ol><li>cupboard</li></ol>
clagon	<i>verb</i><br><ol><li>to complain</li></ol>
cleini	<i>adj</i><br><ol><li>small</li></ol>
clievan	<i>verb</i><br><ol><li>to cleave</li></ol>
climban	<i>verb</i><br><ol><li>to climb</li></ol>
clingan	<i>verb</i><br><ol><li>to sound</li></ol>
clivan|clīvan	<i>verb</i><br><ol><li>to stick, to cling</li></ol>
clivon	<i>verb</i><br><ol><li>to be stuck</li></ol>
cnapo	<i>noun</i><br><ol><li>servant, assistant</li></ol>
cnio	<i>noun</i><br><ol><li>knee</li></ol>
copon|cōpon	<i>verb</i><br><ol><li>to buy</li></ol>
coron	<i>verb</i><br><ol><li>to assess, to test</li></ol>
craft	<i>noun</i><br><ol><li>strength, power, force</li></ol>
craien|krāien	<i>verb</i><br><ol><li>to crow</li></ol>
crampo	<i>noun</i><br><ol><li>cramp</li></ol>
crano|cranon|cranin|cranono	<i>noun</i><br><ol><li>crane (bird)</li></ol>
crigan|crīgan	<i>verb</i><br><ol><li>to strive</li><li>to gain</li></ol>
crimpan	<i>verb</i><br><ol><li>to shrink</li></ol>
criscan|crīscan	<i>verb</i><br><ol><li>to scream, to screech</li></ol>
critan|crītan	<i>verb</i><br><ol><li>to shout</li><li>to call out, scream</li></ol>
crudan|crūdan	<i>verb</i><br><ol><li>to push</li></ol>
crupan|crūpan	<i>verb</i><br><ol><li>to creep</li></ol>
cuman	<i>verb</i><br><ol><li>to come</li></ol>
cunden	<i>verb</i><br><ol><li>to announce, to make known</li><li>to preach</li></ol>
cundo|cundin|cundono|cundon	<i>noun</i><br><ol><li>acquaintance, familiar person</li></ol>
cunnan	<i>verb</i><br><ol><li>to know, to be familiar with</li><li>(auxiliary) can, to be able to</li></ol>
cunt	<i>adj</i><br><ol><li>known, familiar</li></ol>
cuo	<i>noun</i><br><ol><li>cow</li></ol>
dag|daga|dagon|dago|dage|dages	<i>noun</i><br><ol><li>day</li></ol>
dal	<i>noun</i><br><ol><li>valley</li></ol>
delvan|delvest|delves|dulvist|delvent|dulvin|dulvint|gedulvon|delvunt|delven|delvit|dulvun|dulvit|dalv|delvu|delvandi|delve|dulvi|delvist|dulvis|delvon|delvet|delvis|dulvut|delv	<i>verb</i><br><ol><li>to dig, excavate</li></ol>
dier	<i>noun</i><br><ol><li>animal</li></ol>
diuri	<i>adj</i><br><ol><li>precious, valuable</li></ol>
dodo|dōdon|dōdono|dōdo|dōdin	<i>noun</i><br><ol><li>dead person</li></ol>
dopen|dōpen	<i>verb</i><br><ol><li>to dip, to immerse</li><li>to baptise</li></ol>
dot|dōt	<i>adj</i><br><ol><li>dead</li></ol>
dragan	<i>verb</i><br><ol><li>to carry</li><li>to wear (clothes)</li></ol>
dragon	<i>verb</i><br><ol><li>to behave</li><li>to acquire</li></ol>
dran|drān	<i>verb</i><br><ol><li>to emit an odour</li></ol>
drenken	<i>verb</i><br><ol><li>to give drink to</li><li>to drench, to drown</li></ol>
drepan	<i>verb</i><br><ol><li>to reach (a place)</li><li>to achieve, accomplish</li></ol>
driegan	<i>verb</i><br><ol><li>to deceive</li></ol>
driepan	<i>verb</i><br><ol><li>to drip</li></ol>
drincan|drincunt|druncin|druncist|druncut|drincit|druncis|drincu|gedruncon|drincis|drincet|drinces|druncit|drincent|druncun|drinc|drince|druncint|drincon|dranc|drincen|drincist|drincest|drunci|drincandi	<i>verb</i><br><ol><li>to drink</li></ol>
dritan|drītan	<i>verb</i><br><ol><li>to defecate</li></ol>
drivan|drīvan	<i>verb</i><br><ol><li>to drive</li></ol>
droppon	<i>verb</i><br><ol><li>to drip</li></ol>
druhtin|druftin	<i>noun</i><br><ol><li>lord</li></ol>
druoven	<i>verb</i><br><ol><li>to confuse</li></ol>
ducan|dūcan	<i>verb</i><br><ol><li>to duck, dive</li></ol>
dugan	<i>verb</i><br><ol><li>to have value</li></ol>
duomen	<i>verb</i><br><ol><li>to judge, to deem</li></ol>
duon|duos|duo|duont|duot|duost	<i>verb</i><br><ol><li>to do</li><li>to put, to place</li></ol>
durran	<i>verb</i><br><ol><li>to dare, to have the courage</li><li>may</li></ol>
duva|dūva	<i>noun</i><br><ol><li>dove, pigeon</li></ol>
dwelan	<i>verb</i><br><ol><li>to wander</li></ol>
dwinan|dwīnan|dwini|dwīne|dwīnen|dwīnandi|dwīnest|dwinin|dwīnist|dwīnunt|dwinist|dwīnu|dwinut|dwinit|dwinint|dwīnit|dwīnon|dwinis|dwīnent|dwīnes|dwīnis|dwīn|dwinun|gedwinon|dwein|dwīnet	<i>verb</i><br><ol><li>to wither</li><li>to go away, pass away</li></ol>
ecorno|ēcornono|ēcornin|ēcornon|ēcorno	<i>noun</i><br><ol><li>squirrel</li></ol>
einis	<i>adv</i><br><ol><li>once</li></ol>
emiceio	<i>adv</i><br><ol><li>always</li></ol>
enden	<i>verb</i><br><ol><li>to end, to make end</li></ol>
endi|ende|endo|endon|endes	<i>noun</i><br><ol><li>end</li></ol>
enon|ēnon	<i>verb</i><br><ol><li>to agree</li></ol>
er|ēr	<i>prep</i><br><ol><li>before, earlier than</li></ol><br><i>conj</i><br><ol><li>ere, afore</li></ol><br><i>adv</i><br><ol><li>previously, in an earlier period, in a bygone time</li><li>earlier, before a certain time or period</li></ol>
era|ēra	<i>noun</i><br><ol><li>honour</li><li>dignity</li></ol>
eresloch|ereslōch	<i>noun</i><br><ol><li>Eersel (a village in modern North Brabant, the Netherlands)</li></ol>
ertha	<i>noun</i><br><ol><li>earth</li></ol>
etan	<i>verb</i><br><ol><li>to eat</li></ol>
ethili	<i>adj</i><br><ol><li>noble</li></ol>
facon	<i>verb</i><br><ol><li>to sleep</li></ol>
fadar	<i>noun</i><br><ol><li>father</li></ol>
falco|falcono|falcin|falcon	<i>noun</i><br><ol><li>falcon</li></ol>
fallan	<i>verb</i><br><ol><li>to fall</li><li>to descend</li></ol>
fan|fān	<i>prep</i><br><ol><li>off, from</li></ol><br><i>verb</i><br><ol><li>to catch</li></ol>
fano	<i>noun</i><br><ol><li>cloth, banner</li></ol>
faran|fuor|far|fare|faron|fuorun|fuorint|farandi|farest|faru|fuoris|fuorist|fuori|faren|fuorit|farent|faret|farunt|gefaron|fares|farit|farist|fuorut|faris|fuorin	<i>verb</i><br><ol><li>to go, sail</li></ol>
farbergan	<i>verb</i><br><ol><li>to hide, to conceal</li></ol>
farbrestan	<i>verb</i><br><ol><li>to burst, to tear</li></ol>
farbrinnan	<i>verb</i><br><ol><li>to burn up, to perish by fire</li></ol>
fardervan	<i>verb</i><br><ol><li>to perish, to be destroyed</li><li>to destroy</li></ol>
fardrincan	<i>verb</i><br><ol><li>to drown</li></ol>
fardrivan|fardrīvan	<i>verb</i><br><ol><li>to drive away, to chase away</li></ol>
farfaran	<i>verb</i><br><ol><li>to disappear, to perish</li></ol>
farfehtan	<i>verb</i><br><ol><li>to defeat</li></ol>
fargan|fargān	<i>verb</i><br><ol><li>to pass, to go by (of time)</li><li>to perish, to expire</li></ol>
fargeldan	<i>verb</i><br><ol><li>to pay for, to reimburse</li></ol>
fargetan	<i>verb</i><br><ol><li>to forget</li></ol>
farhelan	<i>verb</i><br><ol><li>to hide, to conceal</li></ol>
farkiesan	<i>verb</i><br><ol><li>to reject</li></ol>
farlatan|farlātan	<i>verb</i><br><ol><li>to abandon</li><li>to leave, to depart from</li></ol>
farlian|farlīan	<i>verb</i><br><ol><li>to grant</li></ol>
farliesan	<i>verb</i><br><ol><li>to lose (possession)</li></ol>
farlithan|farlīthan	<i>verb</i><br><ol><li>to pass</li><li>to disappear</li></ol>
farmithan|farmīthan	<i>verb</i><br><ol><li>to avoid</li></ol>
farneman	<i>verb</i><br><ol><li>to hear about, to learn of</li><li>to hear</li><li>to notice</li><li>to understand</li><li>to capture</li></ol>
farnietan	<i>verb</i><br><ol><li>to use up, to consume</li></ol>
farplegan	
farradan|farrādan	<i>verb</i><br><ol><li>to kill treacherously</li></ol>
farro|farrin|farrono|farron	<i>noun</i><br><ol><li>bull</li></ol>
farsacan	<i>verb</i><br><ol><li>to disavow</li><li>to swear off</li></ol>
farsian	
farsinnan	<i>verb</i><br><ol><li>to come to one's senses</li><li>to consider, to think about, to plot</li></ol>
farskeithan	<i>verb</i><br><ol><li>to die</li></ol>
farslitan|farslītan	<i>verb</i><br><ol><li>to break into pieces</li></ol>
farstan|farstān	<i>verb</i><br><ol><li>to understand</li></ol>
farstotan|farstōtan	<i>verb</i><br><ol><li>to push away, to reject, to expel</li></ol>
farswelgan	<i>verb</i><br><ol><li>to devour</li></ol>
farswindan	<i>verb</i><br><ol><li>to disappear</li></ol>
farthrietan	<i>verb</i><br><ol><li>to displease, bother</li></ol>
farwatan|farwātan	<i>verb</i><br><ol><li>to curse, to swear</li></ol>
farwellan	<i>verb</i><br><ol><li>to curse, to damn</li></ol>
farwerden	<i>verb</i><br><ol><li>to tempt, to ruin</li></ol>
farwerpan	<i>verb</i><br><ol><li>to cast down, away</li><li>to reject, to cast out</li></ol>
farwerthan	<i>verb</i><br><ol><li>to go wrong</li><li>to stray</li></ol>
farwinnan	<i>verb</i><br><ol><li>to defeat</li><li>to convince, to persuade</li></ol>
farwitan|farwītan	<i>verb</i><br><ol><li>to blame</li></ol>
fehtan	<i>verb</i><br><ol><li>to fight</li></ol>
felisa	<i>noun</i><br><ol><li>Velsen (a village in modern North Holland, the Netherlands)</li></ol>
felt	<i>noun</i><br><ol><li>field</li></ol>
feni	<i>noun</i><br><ol><li>fen, marsh, swamp</li></ol>
findan|fundun|findandi|findunt|fand|fundit|findit|find|fundi|findist|findest|fundist|fundin|findis|findon|findet|findent|finden|fundint|fundis|findes|finde|gefundon|fundut|findu	<i>verb</i><br><ol><li>to find</li></ol>
fingar	<i>noun</i><br><ol><li>finger</li></ol>
firon|fīron	<i>verb</i><br><ol><li>to rest, to take a day off</li><li>to celebrate</li></ol>
fisc	<i>noun</i><br><ol><li>fish</li></ol>
flehtan|flehtent|flehtis|flehtandi|flehtit|fluhtut|fluhti|flehtes|flehtet|flehte|flehton|flehten|flehtu|fluhtis|gefluhton|fluhtin|fluhtun|flehtunt|fluhtit|fleht|flaht|fluhtint|flehtist|flehtest|fluhtist	<i>verb</i><br><ol><li>to weave, braid</li></ol>
flesc|flēsc|flēscis|flēsco|flēsce|flēscon	<i>noun</i><br><ol><li>meat, flesh</li><li>body (as opposed to mind)</li><li>mortal, human</li></ol>
flian	<i>verb</i><br><ol><li>to flee</li></ol>
fliegan|fliegandi|flugint|flieges|fliegen|flieget|flugis|flugist|fliegis|flugit|fliege|flōg|flugun|fliegu|flieg|fliegit|fliegest|geflogon|fliegent|fliegunt|fliegon|flugin|flugi|fliegist|flugut	<i>verb</i><br><ol><li>to fly</li></ol>
flietan	<i>verb</i><br><ol><li>to float</li><li>to flow</li><li>to melt</li></ol>
flitan|flītan	<i>verb</i><br><ol><li>to strive, to make an effort</li></ol>
flo|flō	<i>noun</i><br><ol><li>flea</li></ol>
fniesan	<i>verb</i><br><ol><li>to sneeze</li></ol>
fogal|fogalon|fogale|fogalo|fogales|fogala|vogal	<i>noun</i><br><ol><li>bird</li></ol>
folc	<i>noun</i><br><ol><li>people, folk</li></ol>
folgon	<i>verb</i><br><ol><li>to follow</li></ol>
folo|folono|folin|folon	<i>noun</i><br><ol><li>foal</li></ol>
forathian|forathīan	<i>verb</i><br><ol><li>to thrive onward, to continue thriving</li></ol>
forno|fornin|fornono|fornon	<i>noun</i><br><ol><li>roach (fish)</li></ol>
fort	<i>adv</i><br><ol><li>away</li></ol>
fragon|frāgon	<i>verb</i><br><ol><li>to ask</li></ol>
fremithi	<i>adj</i><br><ol><li>foreign, strange</li></ol>
fremmen	<i>verb</i><br><ol><li>to complete, to accomplish</li></ol>
fri|frī	<i>adj</i><br><ol><li>free, unbound</li></ol>
friesan|fruri|friesis|fruris|friese|frurint|friesist|friesen|frurin|friesu|friesandi|frurut|friesest|friesit|frurun|frieses|frurit|frurist|gefroron|frieson|frieset|frōs|friesent|fries|friesunt	<i>verb</i><br><ol><li>to freeze</li></ol>
frithu|fritho	<i>noun</i><br><ol><li>peace</li></ol>
fruo	<i>adv</i><br><ol><li>early</li></ol>
fuogen	<i>verb</i><br><ol><li>to bring together</li></ol>
fuot|fuoti|fuoto|fuote|fuoton|fuotis	<i>noun</i><br><ol><li>foot</li></ol>
fur	<i>prep</i><br><ol><li>for</li></ol>
furi	<i>prep</i><br><ol><li>for</li></ol>
fus	<i>noun</i><br><ol><li>fox</li></ol>
galico|galīco	<i>adv</i><br><ol><li>suddenly</li></ol>
gan|gengit|gengut|gengist|gān|gā|gengun|geng|gest|gengi|gāt|gengis|gānt|get|gāst|gengin|gangandi|gegangon|gās	<i>verb</i><br><ol><li>to go</li></ol>
ganipi	<i>noun</i><br><ol><li>Gennep (a village in modern Limburg, the Netherlands)</li></ol>
gardo	<i>noun</i><br><ol><li>garden</li></ol>
gebet|gebete|gebetis|gebeto|gebeton	<i>noun</i><br><ol><li>prayer</li></ol>
gedan	<i>verb</i><br><ol><li>to weed</li></ol>
gefadero|gefaderon|gefaderono|gefaderen	<i>noun</i><br><ol><li>godfather</li></ol>
geit	<i>noun</i><br><ol><li>goat</li></ol>
geldan|geldon|guldun|guldut|geldandi|geldent|geldu|guldis|geguldon|gald|geldunt|gelde|geld|geldet|guldist|guldint|geldest|geldist|guldi|guldin|geldes|guldit|geldis|geldit|gelden	<i>verb</i><br><ol><li>to pay</li></ol>
gelo	<i>adj</i><br><ol><li>yellow</li></ol>
ger|gēr	<i>noun</i><br><ol><li>spear, pike, javelin</li></ol>
gero	<i>noun</i><br><ol><li>lust, desire</li></ol>
geron	<i>verb</i><br><ol><li>to desire, to wish</li></ol>
gerwen	<i>verb</i><br><ol><li>to prepare, to make ready</li><li>to finish, to decorate</li></ol>
gevan|gāvut|gāvun|gaf|givit|gāvis|geven|gāvist|gevu|gevest|gāvin|gevandi|gāvit|gevent|gevunt|geve|givis|geves|gāvint|gegevon|gif|gevet|gevon|givist|gāvi	<i>verb</i><br><ol><li>to give</li></ol>
gi|gī	<i>pron</i><br><ol><li>you (plural)</li></ol>
gian	<i>verb</i><br><ol><li>to acknowledge, to recognise</li><li>to declare</li></ol>
gibergan	<i>verb</i><br><ol><li>to hide</li></ol>
gibiedan	<i>verb</i><br><ol><li>to command, to order</li></ol>
gibosi|gibōsi	<i>adj</i><br><ol><li>worthless</li></ol>
gibrestan	<i>verb</i><br><ol><li>to be missing, to lack</li></ol>
gidelo|gidēlo	
gietan|gietu|gietent|gietandi|gieton|gotint|gietit|gietunt|gotist|gietis|gotun|giete|gōt|gotin|gietest|gotit|gieten|goti|gietes|gotis|gegoton|gietist|gotut|gietet|giet	<i>verb</i><br><ol><li>to pour</li></ol>
gifindan	<i>verb</i><br><ol><li>to find</li><li>to encounter</li></ol>
gigripan|grīpan	<i>verb</i><br><ol><li>to seize, grasp</li></ol>
gikiesan	<i>verb</i><br><ol><li>to choose</li><li>to see, to perceive</li></ol>
gilic|gilīc	<i>adj</i><br><ol><li>equal</li></ol>
gilico|gilīco	<i>noun</i><br><ol><li>equal</li></ol>
gilithan|gilīthan	<i>verb</i><br><ol><li>to suffer</li><li>to endure</li></ol>
gilovo|gilōvo	<i>noun</i><br><ol><li>belief, faith</li></ol>
gimanagfaldon|gemanohfaldon	<i>verb</i><br><ol><li>to multiply</li></ol>
ginatha|ginātha	<i>noun</i><br><ol><li>mercy, grace</li></ol>
ginietan	<i>verb</i><br><ol><li>to enjoy</li></ol>
girinnan	<i>verb</i><br><ol><li>to flow, to stream</li></ol>
gisinnan	<i>verb</i><br><ol><li>to realise</li><li>to reconsider</li></ol>
giskinan|giskīnan	<i>verb</i><br><ol><li>to appear, to become visible</li></ol>
gistervan	<i>verb</i><br><ol><li>to die, to perish</li></ol>
gistigan|gistīgan	<i>verb</i><br><ol><li>to climb, to ascend</li></ol>
githanco	<i>noun</i><br><ol><li>thinking, thought</li></ol>
githian|githīan	<i>verb</i><br><ol><li>to grow, to become larger</li><li>to thrive</li></ol>
githingo	<i>noun</i><br><ol><li>hope, faith</li></ol>
gitian	<i>verb</i><br><ol><li>to pull</li></ol>
gitriuwi	<i>adj</i><br><ol><li>faithful</li></ol>
giwerthan	<i>verb</i><br><ol><li>to occur, to happen</li><li>to arise, to emerge</li></ol>
giwinnan	<i>verb</i><br><ol><li>to receive, to aquire</li><li>to conquer, to aquire through battle</li></ol>
giwisso	<i>adv</i><br><ol><li>certainly</li></ol>
glidan|glīdan	<i>verb</i><br><ol><li>to slide</li></ol>
golda|goldā	<i>noun</i><br><ol><li>Gouda (a city in modern South Holland, the Netherlands)</li></ol>
golt	<i>noun</i><br><ol><li>gold</li></ol>
got|godis|gode|godon|godô|goda	<i>noun</i><br><ol><li>god</li></ol>
gravan	<i>verb</i><br><ol><li>to dig</li></ol>
gravo|grāvo|gravin|gravon	<i>noun</i><br><ol><li>count; servant of the king with a specific supervisory task</li></ol>
grawon|grāwon	<i>verb</i><br><ol><li>to be grey</li></ol>
grinan|grīnan	<i>verb</i><br><ol><li>to grin</li><li>to grimace</li></ol>
gripan|grēp|grīpen|grīpandi|gripun|gripin|grīpe|grīpet|grīpan|grīpest|grīpent|gripi|gripint|grīpist|grīpon|grīpunt|griput|gegripon|grīp|grīpes|gripist|grīpit|gripis|grīpis|grīpu|gripit	<i>verb</i><br><ol><li>to seize, grasp</li></ol>
grot|grōt	<i>adj</i><br><ol><li>big, large</li><li>great</li></ol>
grunt	<i>noun</i><br><ol><li>ground</li></ol>
gruoien	<i>verb</i><br><ol><li>to grow</li></ol>
gruoni	<i>adj</i><br><ol><li>green</li></ol>
guot|guodo|guodu|guodno|guodro|betst|guodin|guodon|guode|guodan|guodrō|guodis|guoda|betiro	<i>adj</i><br><ol><li>good</li></ol>
gurden	<i>verb</i><br><ol><li>to gird</li></ol>
hagal	<i>noun</i><br><ol><li>hail (balls of ice)</li></ol>
haldan	<i>verb</i><br><ol><li>to hold, to keep</li></ol>
halton	<i>verb</i><br><ol><li>to limp</li></ol>
hano|hanono|hanon|hanin	<i>noun</i><br><ol><li>rooster</li></ol>
hant|handa|handi|handon|hando	<i>noun</i><br><ol><li>hand</li></ol>
har|hār	<i>noun</i><br><ol><li>hair</li></ol>
haralem	<i>noun</i><br><ol><li>Haarlem (a city in modern North Holland, the Netherlands)</li></ol>
harmo	<i>noun</i><br><ol><li>stoat, ermine</li></ol>
hart|hardist|hardin|hardo|hardon|harde|hardan|hardno|hardiro|hardis|hardrō|harda|hardro|hardu	<i>adj</i><br><ol><li>hard</li></ol>
haso|hasin|hasono|hason	<i>noun</i><br><ol><li>hare</li></ol>
haton	<i>verb</i><br><ol><li>to hate</li></ol>
hebben	<i>verb</i><br><ol><li>to have</li></ol>
heffen	<i>verb</i><br><ol><li>to lift, to raise</li></ol>
heil	<i>adj</i><br><ol><li>whole, healthy</li></ol>
heileginlo	<i>noun</i><br><ol><li>Heiloo (a village in modern North Holland, the Netherlands)</li></ol>
heilig	<i>adj</i><br><ol><li>holy, sacred</li></ol>
heiligo|heiligin|heiligono|heiligon	<i>noun</i><br><ol><li>holy person, saint</li></ol>
helan	<i>verb</i><br><ol><li>to hide, to conceal</li></ol>
helpan	<i>verb</i><br><ol><li>to help, to assist [+dative]</li></ol>
hem|hēm	<i>noun</i><br><ol><li>home, house</li><li>hamlet</li></ol>
heritogo	<i>noun</i><br><ol><li>army leader</li><li>duke</li></ol>
herla	<i>noun</i><br><ol><li>Heerlen (a city in modern Limburg, the Netherlands)</li></ol>
hermilo|hermilon|hermilono|hermilin	<i>noun</i><br><ol><li>stoat, ermine</li></ol>
herro|hērron|hērrono|hērrin|hērro	<i>noun</i><br><ol><li>master, lord</li></ol>
herta|hertin|herton|hertno	<i>noun</i><br><ol><li>heart</li></ol>
hetan|hētan	<i>verb</i><br><ol><li>to call, to name</li><li>to be called/named</li><li>to command</li><li>to promise</li></ol>
hie	<i>pron</i><br><ol><li>he</li></ol>
hiera	<i>adv</i><br><ol><li>here</li></ol>
himil	<i>noun</i><br><ol><li>heaven, sky</li></ol>
hinanwerpan	<i>verb</i><br><ol><li>to throw away</li><li>to relinquish</li></ol>
hinanwican|hinanwīcan	<i>verb</i><br><ol><li>to disappear, to go away</li></ol>
hirut	<i>noun</i><br><ol><li>deer</li></ol>
hit	<i>pron</i><br><ol><li>it</li></ol>
hiudo	<i>adv</i><br><ol><li>today</li></ol>
hof	<i>noun</i><br><ol><li>court, farmstead</li></ol>
holt	<i>noun</i><br><ol><li>wood (the material)</li><li>tree</li><li>a wood, a forest</li></ol>
honen|hōnen	<i>verb</i><br><ol><li>to mock, to humiliate</li></ol>
honi|hōni	<i>adj</i><br><ol><li>despicable</li></ol>
hopon	<i>verb</i><br><ol><li>to hope</li></ol>
horcon	<i>verb</i><br><ol><li>to listen</li></ol>
horo	<i>noun</i><br><ol><li>mud</li></ol>
houwan	<i>verb</i><br><ol><li>to hew, chop</li></ol>
hovit|hōvitis|hōvit|hōvite|hōvito|hōviton	<i>noun</i><br><ol><li>head</li></ol>
hovitman|hōvitman|hōvitmanno|hōvitmannon|hōvitmanne|hōvitmanna|hōvitmannis	<i>noun</i><br><ol><li>captain; leader, head</li></ol>
hulpere|hulperon|hulperes|hulpero	<i>noun</i><br><ol><li>helper</li></ol>
hunt	<i>noun</i><br><ol><li>dog</li></ol>
huo	<i>adv</i><br><ol><li>how</li></ol>
huoden	<i>verb</i><br><ol><li>to heed, to protect</li><li>to care for, to tend [+genitive]</li></ol>
huova	<i>noun</i><br><ol><li>plot of land</li></ol>
hupi	<i>noun</i><br><ol><li>hip</li></ol>
hus|hūs	<i>noun</i><br><ol><li>house</li></ol>
igil	<i>noun</i><br><ol><li>hedgehog</li></ol>
ik|iro|unsig|thu|it|uns|imo|unsa|wī|is|im|mī|sia|ic|ir|hē|iuwa|ik|gī|tu|ih|thīn|sie (masc. plur.)|iu|thik|mīn|thū|mik|hie|unser|sīn|wīr|mic|thic|thī|iuwer	<i>pron</i><br><ol><li>I</li></ol>
io	<i>adv</i><br><ol><li>always, every time, continuously</li><li>ever, at some point, sometime</li></ol>
irbelgan	<i>verb</i><br><ol><li>to become angry</li></ol>
irskellan	<i>verb</i><br><ol><li>to shout loudly</li></ol>
irskinan|irskīnan	<i>verb</i><br><ol><li>to appear, to become visible</li></ol>
irwervan	<i>verb</i><br><ol><li>to acquire</li><li>to win</li></ol>
jar|jār	<i>noun</i><br><ol><li>year</li></ol>
judo	<i>noun</i><br><ol><li>Jew</li></ol>
jugithen	<i>verb</i><br><ol><li>to become younger</li></ol>
jungiro	<i>noun</i><br><ol><li>apostle, disciple</li></ol>
keiser	<i>noun</i><br><ol><li>emperor</li></ol>
kempo	<i>noun</i><br><ol><li>fighter, warrior</li></ol>
kennen	<i>verb</i><br><ol><li>to know, to be aware of</li></ol>
kervan|kervest|kurvint|kurvun|kurvist|gekorvon|kervis|kervent|kervet|kervon|kerv|kurvut|kurvis|kurvi|kerves|karv|kerven|kervandi|kervist|kerve|kervunt|kurvit|kervu|kervit|kurvin	<i>verb</i><br><ol><li>to cut</li></ol>
kiesan	<i>verb</i><br><ol><li>to choose</li></ol>
kinan|kīnan	<i>verb</i><br><ol><li>to split, to tear</li></ol>
kint	<i>noun</i><br><ol><li>child</li></ol>
kirica	<i>noun</i><br><ol><li>church</li></ol>
kiuwan	<i>verb</i><br><ol><li>to chew</li></ol>
kruci	<i>noun</i><br><ol><li>cross</li></ol>
krucigon	<i>verb</i><br><ol><li>To crucify</li></ol>
kuning|kuninga|kuningon|kuningis|kuningo|kuninge	<i>noun</i><br><ol><li>king</li></ol>
kunink	<i>noun</i><br><ol><li>king</li></ol>
kuo|Cow.	
kuol|kuolrō|kuolno|kuolro|kuolo|kuole|kuolu|kuolis|kuolon|kuolin|kuola|kuolan	<i>adj</i><br><ol><li>cool, fresh</li></ol>
lant	<i>noun</i><br><ol><li>land (as opposed to water)</li><li>land, terrain</li><li>territory</li></ol>
latan|lātan	<i>verb</i><br><ol><li>to leave (behind, over)</li><li>to let go</li><li>to refrain from, to not do</li><li>to let, to allow</li></ol>
lathon	<i>verb</i><br><ol><li>to call</li><li>to invite</li></ol>
lavon	<i>verb</i><br><ol><li>to refresh with food or drink</li></ol>
leccon	<i>verb</i><br><ol><li>to lick</li></ol>
leggen	<i>verb</i><br><ol><li>to lay, to place</li></ol>
leiden	<i>verb</i><br><ol><li>to lead, to bring</li></ol>
leido|leidon|leidono|leidin	<i>noun</i><br><ol><li>leader</li></ol>
lenen|lēnen	<i>verb</i><br><ol><li>To lean, to rest.</li></ol>
leppa	<i>noun</i><br><ol><li>lip</li></ol>
lera|lēra	<i>noun</i><br><ol><li>teaching, lore</li></ol>
leren|lēren	<i>verb</i><br><ol><li>to learn</li><li>to teach</li></ol>
lernon	<i>verb</i><br><ol><li>to learn</li><li>to teach</li></ol>
lesan	<i>verb</i><br><ol><li>to gather, to collect</li><li>to read</li></ol>
lesken	<i>verb</i><br><ol><li>to extinguish</li><li>to lessen</li></ol>
levara	<i>noun</i><br><ol><li>liver</li></ol>
lian|līan	<i>verb</i><br><ol><li>to lend, to grant</li><li>to lend</li></ol>
licon|līcon	<i>verb</i><br><ol><li>(transitive) to please</li><li>(transitive) to be in good favour with</li><li>(transitive) to be liked by</li></ol>
liegan	<i>verb</i><br><ol><li>to lie, to tell untruth</li></ol>
lieht	<i>noun</i><br><ol><li>light</li></ol><br><i>adj</i><br><ol><li>light, bright</li></ol>
liehtfat	<i>noun</i><br><ol><li>lamp, lantern</li></ol>
liggen	<i>verb</i><br><ol><li>to lie</li><li>to be located</li></ol>
lithan|lēthint|lēthun|līth|līthist|līthit|līthe|līthen|lēthit|līthon|līthis|līthes|lēthis|lēthi|gelidon|līthu|lēthist|lēthut|līthent|lēthin|līthan|līthandi|līthunt|līthet|līthest	<i>verb</i><br><ol><li>to go, sail</li><li>to endure</li></ol>
liut	<i>noun</i><br><ol><li>(in the singular) people, population</li><li>(in the plural) people, persons</li></ol>
lo|lō	<i>noun</i><br><ol><li>forest</li><li>pool</li></ol>
loccon	<i>verb</i><br><ol><li>to lure</li></ol>
logon	<i>verb</i><br><ol><li>to light up, to flame</li></ol>
lopan|lōpan	<i>verb</i><br><ol><li>to run, to walk, to go</li><li>to flow</li></ol>
lovon	<i>verb</i><br><ol><li>to praise</li></ol>
lucan|lūcan	<i>verb</i><br><ol><li>to close, shut</li></ol>
ludon|lūdon	<i>verb</i><br><ol><li>to sound</li></ol>
luoien	<i>verb</i><br><ol><li>to low</li></ol>
macon	<i>verb</i><br><ol><li>to make</li><li>to cause</li></ol>
magith	<i>noun</i><br><ol><li>virgin, young female</li></ol>
mago|magono|magin|magon	<i>noun</i><br><ol><li>stomach</li></ol>
mahalon	<i>verb</i><br><ol><li>to marry</li></ol>
malsc	<i>adj</i><br><ol><li>haughty</li></ol>
malthan	
malthon	<i>verb</i><br><ol><li>to say, to declare, to state</li></ol>
man|mannon|manne|manno|manna|mannis	<i>noun</i><br><ol><li>human, person</li><li>man, male</li></ol>
mano|mānon|māno|mānin|mānono	<i>noun</i><br><ol><li>moon</li></ol>
manon	<i>verb</i><br><ol><li>to urge, to exhort</li></ol>
mari|māri	<i>adj</i><br><ol><li>famous</li></ol>
marsna	<i>noun</i><br><ol><li>Maarssen (a village in modern Utrecht, the Netherlands)</li></ol>
martilon	<i>verb</i><br><ol><li>to torture</li></ol>
maton|māton	<i>verb</i><br><ol><li>to bring into agreement with</li></ol>
medemolaca	<i>noun</i><br><ol><li>A stream in North Holland, the Netherlands</li><li>Medemblik (a city in modern North Holland, the Netherlands)</li></ol>
medu	<i>noun</i><br><ol><li>mead</li></ol>
menden	<i>verb</i><br><ol><li>to rejoice, to cheer</li></ol>
menen|mēnen	<i>verb</i><br><ol><li>to mean, to intend</li></ol>
mennisco	<i>noun</i><br><ol><li>human, person</li></ol>
merken	<i>verb</i><br><ol><li>to mark, to put a mark on</li></ol>
metan	<i>verb</i><br><ol><li>to measure</li></ol>
migan|mīgit|mīgan|migut|migi|mīgent|mīgandi|mīget|mēg|gemigon|mīgis|mīg|mīgunt|mīgen|migit|mīgu|mīge|migist|migun|mīges|mīgest|migint|mīgon|mīgist|migin|migis	<i>verb</i><br><ol><li>to urinate</li></ol>
mikil|mikilro|mikilrō|mikilo|mikilin|mikile|mikilon|mikilis|mikilu|mikila|mikilan|mikilno	<i>adj</i><br><ol><li>great, big</li><li>a large amount of</li></ol>
mildi	<i>adj</i><br><ol><li>mild, soft</li><li>tame, friendly</li></ol>
milta	<i>noun</i><br><ol><li>spleen</li></ol>
min|mīnis|mīnro|mīna|mīn|mīnon|mīnin	<i>det</i><br><ol><li>my</li><li>mine</li></ol>
minnon	<i>verb</i><br><ol><li>to love</li></ol>
misken	<i>verb</i><br><ol><li>to mix</li></ol>
mit	<i>prep</i><br><ol><li>with</li></ol>
mithan|mīthan	<i>verb</i><br><ol><li>to avoid</li></ol>
morth	<i>noun</i><br><ol><li>murder</li></ol>
mugan	<i>verb</i><br><ol><li>may, to be allowed to</li><li>can, to be able to</li></ol>
munt	<i>noun</i><br><ol><li>mouth</li></ol>
muoder	<i>noun</i><br><ol><li>mother</li></ol>
muos	<i>noun</i><br><ol><li>Food, nourishment, mush.</li></ol>
muotan	<i>verb</i><br><ol><li>can, to be able to</li><li>must, to have to</li></ol>
muothen	<i>verb</i><br><ol><li>to tire, to become tired</li></ol>
muothi	<i>adj</i><br><ol><li>tired</li></ol>
mus|mūs	<i>noun</i><br><ol><li>mouse</li></ol>
naht	<i>noun</i><br><ol><li>night</li></ol>
naken|nāken	<i>verb</i><br><ol><li>to approach, to near, to come closer</li></ol>
namo|namno|namon|namin	<i>noun</i><br><ol><li>name</li></ol>
naruthi	<i>noun</i><br><ol><li>Naarden (a city in modern North Holland, the Netherlands)</li></ol>
neigen	<i>verb</i><br><ol><li>to cause to bend down</li><li>to incline</li></ol>
neman	<i>verb</i><br><ol><li>to take</li><li>to take away</li></ol>
nenden	<i>verb</i><br><ol><li>to focus on</li></ol>
niedon	<i>verb</i><br><ol><li>to behove, to satisfy</li></ol>
niesan	<i>verb</i><br><ol><li>to sneeze</li></ol>
nietan	<i>verb</i><br><ol><li>to use, to employ</li><li>to take possession of</li></ol>
nigan|nigun|nīgunt|nīgu|nīgest|nigit|nīget|nigis|nīgon|nīgent|nīges|nigint|nīgist|nigin|nīge|nīgen|neig|nīgit|nīg|nigist|nīgis|nīgan|nīgandi|nigut|genigon|nigi	<i>verb</i><br><ol><li>to bend</li><li>to bow</li></ol>
nistilon	<i>verb</i><br><ol><li>to nestle</li></ol>
nitan|nītan	<i>verb</i><br><ol><li>to knock, to butt against</li></ol>
nithen|nīthen	<i>verb</i><br><ol><li>to hate, to despise, to be hostile towards</li></ol>
nither	<i>adv</i><br><ol><li>down</li></ol>
nitherscuvan|nitherscūvan	<i>verb</i><br><ol><li>to shove down, to knock down</li></ol>
nitherstigan|nitherstīgan	<i>verb</i><br><ol><li>to descend, to go down</li></ol>
nitherwerpan	<i>verb</i><br><ol><li>to throw down</li></ol>
niumaga	<i>noun</i><br><ol><li>Nijmegen (a city in modern Gelderland, the Netherlands)</li></ol>
niuwi	<i>adj</i><br><ol><li>new</li></ol>
niwanne	<i>adv</i><br><ol><li>never</li></ol>
noh	<i>adv</i><br><ol><li>still</li></ol>
nu|nū	<i>adv</i><br><ol><li>now</li></ol>
nutu	<i>noun</i><br><ol><li>nut</li></ol>
of	<i>conj</i><br><ol><li>if, whether</li></ol>
oga|ōga	<i>noun</i><br><ol><li>eye</li></ol>
ogen|ōgen	<i>verb</i><br><ol><li>to show</li><li>to point out</li></ol>
opanon	<i>verb</i><br><ol><li>to open</li><li>to make known</li></ol>
ora|ōra	<i>noun</i><br><ol><li>ear</li></ol>
oroscoth	<i>noun</i><br><ol><li>Oirschot (a village in modern North Brabant, the Netherlands)</li></ol>
osso|ossin|osson|ossono	<i>noun</i><br><ol><li>ox</li></ol>
ottar	<i>noun</i><br><ol><li>otter</li></ol>
overlithan|overlīthan	<i>verb</i><br><ol><li>to travel over, to travel across</li><li>to pull over, to pull across</li></ol>
overspringan	<i>verb</i><br><ol><li>to jump over</li><li>to jump across</li></ol>
pipan|pīpan	<i>verb</i><br><ol><li>to chirp, to peep (of birds)</li></ol>
plagon|plāgon	<i>verb</i><br><ol><li>to torment, to trouble</li></ol>
planton	<i>verb</i><br><ol><li>to plant</li><li>to found</li></ol>
plegan	<i>verb</i><br><ol><li>to care for</li><li>to carry out</li><li>to use</li></ol>
predicon	<i>verb</i><br><ol><li>to preach</li></ol>
quedden	<i>verb</i><br><ol><li>to greet</li><li>to speak positively</li></ol>
quethan	<i>verb</i><br><ol><li>to say, to tell</li></ol>
quicken	<i>verb</i><br><ol><li>to come to life</li></ol>
radan|rādan	<i>verb</i><br><ol><li>to advise</li></ol>
raston	<i>verb</i><br><ol><li>to rest</li></ol>
ravan	<i>noun</i><br><ol><li>raven</li></ol>
regan	<i>noun</i><br><ol><li>rain</li></ol>
reganon	<i>verb</i><br><ol><li>to rain</li></ol>
reht	<i>adj</i><br><ol><li>right</li></ol>
reiken	<i>verb</i><br><ol><li>to reach</li></ol>
reinen	<i>verb</i><br><ol><li>to clean, to purify</li></ol>
reini	<i>adj</i><br><ol><li>clean, clear</li><li>pure, free from evil</li></ol>
respen	<i>verb</i><br><ol><li>to scold, to reprimand</li></ol>
ridan|rīdan	<i>verb</i><br><ol><li>to ride</li></ol>
riecan|rucan|rūcan	<i>verb</i><br><ol><li>to smell</li></ol>
riki|rīki	<i>noun</i><br><ol><li>realm</li></ol><br><i>adj</i><br><ol><li>powerful</li></ol>
rinan|gerinon|rīnis|rīnu|rīnist|rēn|rinit|rīnit|rīn|rinint|rinis|rinun|rīnan|rīnest|rini|rinut|rīnet|rīnes|rinin|rīnandi|rīne|rīnent|rīnon|rīnen|rīnunt|rinist	<i>verb</i><br><ol><li>to touch</li><li>to brush</li></ol>
ring	<i>noun</i><br><ol><li>ring, circle</li></ol>
rinnan	<i>verb</i><br><ol><li>to run</li></ol>
risan|rīs|rīsen|rīsist|risut|rīsu|rēs|risint|gerison|rīsest|risit|rīsan|rīson|rīses|rīse|risun|rīset|rīsit|rīsent|risin|rīsis|risist|rīsunt|rīsandi|risi|risis	<i>verb</i><br><ol><li>to rise</li></ol>
ritan|rītis|rītan|ritit|ritin|rīt|ritun|rītu|rītet|rītunt|rītist|rītandi|rītest|ritut|rīten|geriton|riti|ritist|rītes|rītit|rīte|rēt|rītent|ritis|ritint|rīton	<i>verb</i><br><ol><li>to carve</li><li>to rip, tear</li></ol>
riuwan	<i>verb</i><br><ol><li>to regret</li></ol>
rot|rōt	<i>adj</i><br><ol><li>red</li></ol>
ruoken	<i>verb</i><br><ol><li>to focus on, to long for</li></ol>
ruopan	<i>verb</i><br><ol><li>to shout</li><li>to call</li></ol>
safti|sāfti	<i>adj</i><br><ol><li>soft</li><li>mild, calm</li></ol>
salt	<i>noun</i><br><ol><li>salt</li></ol><br><i>adj</i><br><ol><li>salty</li></ol>
salvon	<i>verb</i><br><ol><li>to anoint</li></ol>
samanon	<i>verb</i><br><ol><li>to gather</li></ol>
samen	<i>adv</i><br><ol><li>together</li></ol>
sant	<i>noun</i><br><ol><li>sand</li></ol>
scagha	<i>noun</i><br><ol><li>Schagen (a city in modern North Holland, the Netherlands)</li></ol>
scamon	<i>verb</i><br><ol><li>to be ashamed</li></ol>
scap|scāp	<i>noun</i><br><ol><li>sheep</li></ol>
scapon	<i>verb</i><br><ol><li>to make</li><li>to form</li></ol>
scathon	<i>verb</i><br><ol><li>to damage</li><li>to condemn</li></ol>
sconi|scōni	<i>adj</i><br><ol><li>beautiful</li><li>pure, clean</li></ol>
scoronlo	<i>noun</i><br><ol><li>Schoorl (a village in modern North Holland, the Netherlands)</li></ol>
scouwon	<i>verb</i><br><ol><li>to view, to see</li></ol>
scrian|scrīan	<i>verb</i><br><ol><li>to scream</li><li>to cry</li></ol>
scrithan|scrīthan	<i>verb</i><br><ol><li>to stride</li></ol>
scrivan|scrīvan	<i>verb</i><br><ol><li>to write</li></ol>
scrodan|skrōdan	<i>verb</i><br><ol><li>to prune, shear off</li></ol>
scudden	<i>verb</i><br><ol><li>to shake, to rid oneself of</li></ol>
sculdero|sculderon|sculderono|sculderin	<i>noun</i><br><ol><li>shoulder</li></ol>
scunden	<i>verb</i><br><ol><li>to lead, to bring</li></ol>
scurgen	<i>verb</i><br><ol><li>to knock over</li><li>to push aside</li></ol>
scuvan|scūvan	<i>verb</i><br><ol><li>to slide</li><li>to shove</li></ol>
seganon	<i>verb</i><br><ol><li>to bless</li></ol>
sela|sēla	<i>noun</i><br><ol><li>soul</li></ol>
selvo	<i>pron</i><br><ol><li>self</li></ol>
senden	<i>verb</i><br><ol><li>to send</li></ol>
seo|sēo	<i>noun</i><br><ol><li>sea</li></ol>
sia|iro|unsig|thu|it|uns|imo|unsa|wī|is|im|mī|sia|ic|ir|hē|iuwa|ik|gī|tu|ih|thīn|sie (masc. plur.)|iu|thik|mīn|thū|mik|hie|unser|sīn|wīr|mic|thic|thī|iuwer	<i>pron</i><br><ol><li>they</li></ol>
sian|sīan	<i>verb</i><br><ol><li>to see</li><li>to filter</li></ol>
siecon	<i>verb</i><br><ol><li>to be sick</li></ol>
siethan|suthun|suthut|siethunt|siethandi|siethist|suthi|siethen|siethit|siethu|sōth|gesothon|siethet|siethon|siethes|suthis|siethe|siethent|suthist|siethest|siethis|sieth|suthit|suthint|suthin	<i>verb</i><br><ol><li>to boil</li></ol>
sigan|sīgan	<i>verb</i><br><ol><li>to sink, to drop</li></ol>
sin|sīn|sīna|sīnin|sīnro|sīnis|sīnon	<i>det</i><br><ol><li>his, its, hers</li></ol>
sincan	<i>verb</i><br><ol><li>to sink</li></ol>
singan|singist|sungun|gesungon|sing|sungi|singis|singest|singe|singet|singon|sungist|sang|singent|sungis|singunt|singit|singandi|singes|sungin|sungit|singu|sungint|singen|sungut	<i>verb</i><br><ol><li>to sing</li></ol>
sinnan|sinne|sann|sinnes|sinnent|sinnis|sinnist|sinnandi|sinnu|sunnin|sunnit|sunnut|sinnon|sunnist|sinnet|sunni|sinnen|sinn|sunnun|gesunnon|sunnis|sinnunt|sinnit|sinnest|sunnint	<i>verb</i><br><ol><li>to feel, to sense</li><li>to consider, to think about, to plot</li></ol>
sitten	<i>verb</i><br><ol><li>to sit</li><li>to be situated, to live</li></ol>
siu|iro|unsig|thu|it|uns|imo|unsa|wī|is|im|mī|sia|ic|hiro|ir|hē|iuwa|ik|gī|tu|ih|thīn|sie (masc. plur.)|iu|thik|mīn|thū|mik|hie|unser|sīn|wīr|mic|thic|thī|iuwer	<i>pron</i><br><ol><li>she</li></ol>
skeinen	<i>verb</i><br><ol><li>to show, to present</li><li>to demonstrate</li><li>to show oneself</li></ol>
skeithan	<i>verb</i><br><ol><li>to leave, to separate from</li></ol>
skeldan	<i>verb</i><br><ol><li>to accuse</li></ol>
skellan	<i>verb</i><br><ol><li>to sound</li></ol>
skenken	<i>verb</i><br><ol><li>to pour</li></ol>
skeppen	<i>verb</i><br><ol><li>to create</li><li>to scoop</li></ol>
skeran	<i>verb</i><br><ol><li>to shave</li><li>to split, to divide</li></ol>
skerpen	<i>verb</i><br><ol><li>to sharpen</li></ol>
skietan	<i>verb</i><br><ol><li>to shoot</li><li>to shoot at</li></ol>
skilt	<i>noun</i><br><ol><li>shield</li></ol>
skinan|skīnan	<i>verb</i><br><ol><li>to shine</li><li>to be visible</li></ol>
skirmen	<i>verb</i><br><ol><li>to protect</li></ol>
skitan|skītan	<i>verb</i><br><ol><li>to defecate, to shit</li></ol>
skiuwen	<i>verb</i><br><ol><li>to avoid</li></ol>
slan|slān	<i>verb</i><br><ol><li>to hit, to beat</li></ol>
slango|slangon|slangin|slangono	<i>noun</i><br><ol><li>snake</li></ol>
slapan|slāpan	<i>verb</i><br><ol><li>to sleep</li></ol>
slappon	<i>verb</i><br><ol><li>to weaken, to slacken</li></ol>
slidan|slīdan	<i>verb</i><br><ol><li>to slide, to slip</li></ol>
slipan|slīpan	<i>verb</i><br><ol><li>to sharpen</li><li>to grind</li></ol>
slitan|gesliton|slitin|slītit|slīte|slitun|slitit|slītet|slīt|slēt|slitis|slītandi|slīten|slītist|slītunt|slītu|slitint|slītan|slītes|slitut|slīton|slitist|slītent|slītest|sliti|slītis	<i>verb</i><br><ol><li>to tear</li></ol>
slumen|slūmen	<i>verb</i><br><ol><li>to slumber, to sleep</li></ol>
slupan|slūpan	<i>verb</i><br><ol><li>to creep, to sneak</li></ol>
slutan|slūtes|slūtent|slūton|slutint|gesloton|slūten|slōt|slutis|slūtest|slūte|slūtandi|slūtu|slutin|slūtet|slutut|slūt|slūtit|slūtis|slūtist|slūtunt|slutun|slutist|sluti|slutit|slūtan	<i>verb</i><br><ol><li>to close, shut</li></ol>
smal	<i>adj</i><br><ol><li>small</li></ol>
smecken	<i>verb</i><br><ol><li>to taste, to have a certain taste</li><li>to be pleasing</li><li>to taste, to sense the taste of</li></ol>
smeltan|smultin|smeltes|smultint|smultun|smultit|smelt|smeltet|gesmulton|smelte|smeltis|smulti|smelten|smeltandi|smultut|smultis|smeltunt|smeltu|smeltit|smelton|smultist|smeltent|smeltist|smeltest|smalt	<i>verb</i><br><ol><li>(intransitive) to melt</li></ol>
smelten	<i>verb</i><br><ol><li>(transitive) to melt</li></ol>
smitan|smītest|smītan|gesmiton|smitin|smīt|smīte|smīton|smītent|smītes|smitint|smītit|smitun|smiti|smēt|smitis|smītu|smītet|smitit|smītis|smītist|smītandi|smīten|smitut|smītunt|smitist	<i>verb</i><br><ol><li>to hit, smite</li><li>to hurl, throw</li></ol>
smith	<i>noun</i><br><ol><li>smith</li></ol>
smithon	<i>verb</i><br><ol><li>to smith, to forge</li></ol>
smugan|smūgan	<i>verb</i><br><ol><li>to creep, to sneak</li></ol>
sneo|snēo	<i>noun</i><br><ol><li>snow</li></ol>
snithan|snīthan	<i>verb</i><br><ol><li>to cut</li></ol>
sniwan|snīwan	<i>verb</i><br><ol><li>to snow</li></ol>
so|sō	<i>adv</i><br><ol><li>so, like that, in that manner</li></ol>
sorgon	<i>verb</i><br><ol><li>to worry</li></ol>
spellon	<i>verb</i><br><ol><li>to explain</li></ol>
spinnan|spann|spunnin|spunnut|spunni|spinnit|spunnit|spinne|spinnu|spinnent|spinnandi|gespunnon|spunnis|spunnun|spinnunt|spinnon|spinnen|spinnis|spinnet|spunnist|spunnint|spinnes|spinnest|spinnist|spinn	<i>verb</i><br><ol><li>to spin</li></ol>
spiwan|spīwan	<i>verb</i><br><ol><li>to spew, to spit</li></ol>
sprecan	<i>verb</i><br><ol><li>to speak</li></ol>
springan|springu|sprungis|springon|sprungun|springist|springunt|springet|springe|springis|sprungut|gesprungon|springandi|springent|sprang|springes|spring|springen|sprungist|sprungi|sprungint|sprungit|sprungin|springit|springest	<i>verb</i><br><ol><li>to jump, spring</li></ol>
sprutan|sprutint|sprūtandi|sprutis|sprūtis|sprūte|sprūtes|sprōt|gesproton|sprutist|sprūtan|sprūtit|sprūt|sprutun|sprūten|sprūtist|spruti|sprūtet|sprutut|sprutin|sprūtest|sprūton|sprutit|sprūtent|sprūtu|sprūtunt	<i>verb</i><br><ol><li>to sprout, spring up</li></ol>
stampon	<i>verb</i><br><ol><li>to stomp</li></ol>
stan|stān	<i>verb</i><br><ol><li>To stand.</li></ol>
stat	<i>noun</i><br><ol><li>place, location</li><li>house, abode</li><li>town, inhabited place</li></ol>
stecan	<i>verb</i><br><ol><li>to sting, to prick</li></ol>
stelan|stālun|stelest|stālist|stālint|stele|stālit|stelunt|stilis|gestolon|stal|stelent|steles|stil|stelen|stilist|stāli|stelon|stilit|stālis|stālin|stelet|stelandi|stelu|stālut	<i>verb</i><br><ol><li>to steal</li></ol>
stempen	<i>verb</i><br><ol><li>to stomp</li></ol>
sten|stēn	<i>noun</i><br><ol><li>stone</li></ol>
sterken	<i>verb</i><br><ol><li>to strengthen, to make/become stronger</li></ol>
stervan	<i>verb</i><br><ol><li>to die</li></ol>
sticken	<i>verb</i><br><ol><li>to stick, to prick</li></ol>
stier	<i>noun</i><br><ol><li>A bull.</li></ol>
stigan|stīgan	<i>verb</i><br><ol><li>to climb, to ascend</li></ol>
stilli	<i>adj</i><br><ol><li>still, quiet</li></ol>
stincan	<i>verb</i><br><ol><li>to give off a smell</li></ol>
stotan|stōtan	<i>verb</i><br><ol><li>to bump, to knock</li><li>to rile up</li></ol>
strata|strāta	<i>noun</i><br><ol><li>street, paved road</li></ol>
strecken	<i>verb</i><br><ol><li>to stretch</li></ol>
strican|strīcan	<i>verb</i><br><ol><li>to stroke</li></ol>
stridan|strīdan	<i>verb</i><br><ol><li>to fight, to battle</li></ol>
strivan|strīvan	<i>verb</i><br><ol><li>to strive</li></ol>
stuol	<i>noun</i><br><ol><li>chair, seat</li></ol>
stuvan|stūvan	<i>verb</i><br><ol><li>to give off or throw up dust</li></ol>
sucan|sūcan	<i>verb</i><br><ol><li>to suck</li></ol>
suert|suertis|suerton|suerte|suerto	<i>noun</i><br><ol><li>sword</li></ol>
sugan|sūgan	<i>verb</i><br><ol><li>to suck</li></ol>
sulan	<i>verb</i><br><ol><li>to owe</li><li>(auxiliary) must</li><li>(auxiliary) will, shall; forms the future tense</li></ol>
sunna|sunnun|sunnon|̈*sunnon|sunneno	<i>noun</i><br><ol><li>sun</li><li>Son (a village in modern North Brabant, the Netherlands)</li></ol>
suoken	<i>verb</i><br><ol><li>to seek, to look for</li><li>to seek, to try to get</li><li>to request, to ask</li></ol>
suoti	<i>adj</i><br><ol><li>sweet, pleasant</li></ol>
supan|sūpet|sūpandi|supis|sūpunt|supun|sūp|sūpest|sūpent|supin|supint|sūpan|gesopon|sūpes|sūpe|supist|supi|sūpu|sūpon|sōp|sūpit|sūpist|sūpis|supit|suput|sūpen	<i>verb</i><br><ol><li>to drink</li></ol>
swelgan|swelg|swelget|geswulgon|swulgi|swulgut|swelges|swelgen|swulgist|swelgandi|swelgest|swulgint|swelge|swelgent|swelgunt|swulgit|swelgis|swelgit|swulgin|swulgis|swelgon|swelgist|swalg|swulgun|swelgu	<i>verb</i><br><ol><li>to devour, swallow</li></ol>
swellan|swelle|geswullon|swullun|swall|swellet|swellis|swellit|swellist|swellu|swullist|swullis|swellen|swullit|swelles|swellent|swellon|swullut|swullint|swullin|swellunt|swellandi|swulli|swellest|swell	<i>verb</i><br><ol><li>to swell</li></ol>
sweltan|swultint|swultut|swelten|sweltunt|swelte|swalt|swultun|sweltist|sweltest|swultis|sweltet|swelton|sweltu|swultit|swultin|sweltit|sweltis|swultist|sweltandi|geswulton|sweltent|sweltes|swelt|swulti	<i>verb</i><br><ol><li>to die, succumb</li></ol>
sweren	<i>verb</i><br><ol><li>to swear (an oath)</li></ol>
swert|swerto|swertis|swerte|swerton	<i>noun</i><br><ol><li>sword</li></ol>
swican|swīcan	<i>verb</i><br><ol><li>to give way</li></ol>
swimman|swimme|swimmest|swummint|swummist|swimmandi|swimmet|swimmist|swimmen|swimmon|swam|swummit|geswummon|swimmit|swimment|swimm|swimmes|swummin|swimmu|swummi|swummis|swummut|swummun|swimmis|swimmunt	<i>verb</i><br><ol><li>to swim</li></ol>
swindan	<i>verb</i><br><ol><li>to dwindle</li></ol>
tant	<i>noun</i><br><ol><li>tooth</li></ol>
tellen	<i>verb</i><br><ol><li>to tell, to say</li><li>to count</li></ol>
teman	<i>verb</i><br><ol><li>to fit, to suit</li></ol>
tesamanebindan	<i>verb</i><br><ol><li>to tie together</li><li>to bundle</li></ol>
tesamanethwingan	<i>verb</i><br><ol><li>to force together</li></ol>
teslitan|teslītan	<i>verb</i><br><ol><li>to tear, to rip</li></ol>
tewerpan	<i>verb</i><br><ol><li>to destroy, to defeat</li></ol>
tha|thā	<i>adv</i><br><ol><li>then</li></ol>
than	<i>adv</i><br><ol><li>then</li></ol>
thancon	<i>verb</i><br><ol><li>to thank</li></ol>
thar|thār	<i>adv</i><br><ol><li>there</li></ol>
tharm	<i>noun</i><br><ol><li>intestine, gut</li></ol>
tharvon	<i>verb</i><br><ol><li>to lose</li></ol>
thas	<i>noun</i><br><ol><li>badger, European badger</li></ol>
that|thie|thie-a|thia|thīu|themo|thes|then|thana|thero|thiu|there	<i>pron</i><br><ol><li>that, that one</li></ol><br><i>det</i><br><ol><li>that</li></ol>
thecken	<i>verb</i><br><ol><li>to cover</li><li>to roof</li></ol>
thenken	<i>verb</i><br><ol><li>to think</li></ol>
thennen	<i>verb</i><br><ol><li>to reach towards</li><li>to stretch, to strain</li></ol>
these|thiusa|theses|thesemo|thit|thesum|thiese|therro|thise|thesa|thesen|therre	<i>det</i><br><ol><li>this, these</li></ol>
thian|thīan	<i>verb</i><br><ol><li>to grow, to thrive</li></ol>
thicki	<i>adj</i><br><ol><li>thick, wide</li></ol>
thie|thia|thīu|themo|thes|thana|that|then|thero|thiu|thie-a|there	<i>pron</i><br><ol><li>that, that one</li></ol><br><i>det</i><br><ol><li>that</li></ol>
thienon	<i>verb</i><br><ol><li>to serve, to be in service of</li></ol>
thin|thīnin|thīnon|thīna|thīnis|thīnro|thīn	<i>det</i><br><ol><li>thy, your (singular)</li><li>thine, yours</li></ol>
thing|thinge|thingis|thingo|thingon	<i>noun</i><br><ol><li>thing, object</li><li>case, matter, issue</li></ol>
thinsan	<i>verb</i><br><ol><li>to drag</li><li>to draw out, to extract</li></ol>
thio|thīo	<i>noun</i><br><ol><li>thigh</li></ol>
thiudisc	<i>adj</i><br><ol><li>of the people, vernacular</li></ol>
tholon	<i>verb</i><br><ol><li>to suffer, to endure</li><li>to tolerate</li></ol>
thorp	<i>noun</i><br><ol><li>village</li></ol>
thradi|thrādi	<i>adj</i><br><ol><li>fast, quick</li><li>violent, intense</li></ol>
thraien|thrāien	<i>verb</i><br><ol><li>to turn, to rotate</li></ol>
threscan	<i>verb</i><br><ol><li>to thresh</li></ol>
thringan|thrungun|thringon|thringet|thrungit|thringist|thrang|thrungint|gethrungon|thring|thringu|thringent|thringest|thringen|thringunt|thrungi|thringandi|thringit|thrungis|thringes|thringis|thrungin|thrungist|thrungut|thringe	<i>verb</i><br><ol><li>to press, push</li></ol>
thu|iro|unsig|it|thu|uns|imo|unsa|wī|is|im|mī|sia|ic|ir|hē|iuwa|ik|gī|tu|ih|thīn|sie (masc. plur.)|iu|thik|mīn|thū|mik|hie|unser|sīn|wīr|mic|thic|thī|iuwer	<i>pron</i><br><ol><li>thou, you (singular)</li></ol>
thunken	<i>verb</i><br><ol><li>to seem, to appear</li></ol>
thuro	<i>prep</i><br><ol><li>through</li></ol>
thurolithan|thurolīthan	<i>verb</i><br><ol><li>to travel through</li><li>to continue traveling</li><li>to pull through</li></ol>
thurostrican|thurostrīcan	<i>verb</i><br><ol><li>to pass through</li></ol>
thurvan	<i>verb</i><br><ol><li>to need</li><li>to be required</li><li>may, to be allowed to</li></ol>
thusunt|thūsunt	<i>num</i><br><ol><li>thousand</li></ol>
thwan|thwān	<i>verb</i><br><ol><li>to wash, to clean</li></ol>
thwingan	<i>verb</i><br><ol><li>to force</li></ol>
tian|tīan	<i>verb</i><br><ol><li>to pull</li><li>to raise (a child)</li><li>to feed</li><li>to accuse, to blame</li></ol>
tilon	<i>verb</i><br><ol><li>to hurry</li><li>to toil, to work towards</li></ol>
togen|tōgen	<i>verb</i><br><ol><li>to show</li></ol>
tredan|trādist|tredest|trādut|tredu|trādi|trede|tredon|trādis|treden|tredunt|tredis|trad|tredandi|tred|trādun|tredes|trādin|tredent|trādit|tredist|getredon|trādint|tredet|tredit	<i>verb</i><br><ol><li>to tread</li></ol>
triuwi	<i>adj</i><br><ol><li>faithful, loyal</li></ol>
trosten|trōsten	<i>verb</i><br><ol><li>to console, to comfort</li></ol>
tumon|tūmon	<i>verb</i><br><ol><li>to turn, to tumble</li></ol>
tunga|tungon|tungno	<i>noun</i><br><ol><li>tongue</li></ol>
uilo	<i>adv</i><br><ol><li>much</li></ol>
umbe	<i>prep</i><br><ol><li>about, around</li></ol>
umbigripan|umbigrīpan	<i>verb</i><br><ol><li>to grab around</li><li>to envelop</li></ol>
under	<i>prep</i><br><ol><li>under</li></ol>
underthringan	<i>verb</i><br><ol><li>to press away</li><li>to repress</li></ol>
underwindan	<i>verb</i><br><ol><li>to take responsibility for</li></ol>
unreini	<i>adj</i><br><ol><li>unclean</li></ol>
unsuoti	<i>adj</i><br><ol><li>unpleasant, hostile</li></ol>
untes	<i>conj</i><br><ol><li>until</li></ol>
up|ūp	<i>adv</i><br><ol><li>up, upwards</li></ol>
upstigan|upstīgan	<i>verb</i><br><ol><li>to ascend, to go up</li></ol>
ut|ūt	<i>adv</i><br><ol><li>out</li></ol>
utgietan|ūtgietan	<i>verb</i><br><ol><li>to pour out</li><li>to express one's emotions</li><li>to slip away</li></ol>
utgitian	<i>verb</i><br><ol><li>to pull out, to remove</li></ol>
utthinsan|ūtthinsan	<i>verb</i><br><ol><li>to pull out</li><li>to pull lose</li></ol>
wacon	<i>verb</i><br><ol><li>to wake, to be awake</li></ol>
waden|wāden	<i>verb</i><br><ol><li>to clothe, to dress</li></ol>
waien|wāien	<i>verb</i><br><ol><li>to blow (of wind)</li></ol>
wala	<i>adv</i><br><ol><li>well</li></ol>
waldan	<i>verb</i><br><ol><li>to rule</li></ol>
wallan	<i>verb</i><br><ol><li>to boil</li></ol>
walt	<i>noun</i><br><ol><li>forest, wood</li></ol>
wanda	<i>conj</i><br><ol><li>for, because</li></ol><br><i>adv</i><br><ol><li>because</li></ol>
wanen|wānen	<i>verb</i><br><ol><li>to think, to suppose</li></ol>
wanne	<i>adv</i><br><ol><li>when, at what time</li></ol>
wardon	<i>verb</i><br><ol><li>to guard, to watch</li><li>to stand guard</li><li>to pay attention to</li></ol>
warnon	<i>verb</i><br><ol><li>to warn</li></ol>
wascan	<i>verb</i><br><ol><li>to wash</li></ol>
wassan	<i>verb</i><br><ol><li>to grow, to wax</li><li>to rise in level (of water)</li></ol>
wat	<i>pron</i><br><ol><li>what</li></ol>
watar|watron|watare|watro|watre|watris	<i>noun</i><br><ol><li>water</li></ol>
wecken	<i>verb</i><br><ol><li>to wake, to cause to wake up</li></ol>
weg|wego|wegon|weges|wege|wega	<i>noun</i><br><ol><li>way, path</li></ol>
wegen|wēgen	<i>verb</i><br><ol><li>to torment, to treat badly</li></ol>
weithinon	<i>verb</i><br><ol><li>to put (animals) out to graze</li></ol>
wellan	<i>verb</i><br><ol><li>to dirty, to soil</li></ol>
wellen	<i>verb</i><br><ol><li>to choose</li></ol>
wenden	<i>verb</i><br><ol><li>to wend, to turn</li></ol>
wenon|wēnon	<i>verb</i><br><ol><li>to weep, to cry</li></ol>
wernon	<i>verb</i><br><ol><li>to tire, to weaken</li></ol>
werpan	<i>verb</i><br><ol><li>to throw, to cast</li></ol>
werthan	<i>verb</i><br><ol><li>to become</li></ol>
wervan	<i>verb</i><br><ol><li>to turn; turn away from</li><li>to turn out; cause</li><li>to strive; work for</li></ol>
wesan|sīs|wārut|sīst|wāri|geweson|sīt|ist|bim|wes|wesandi|wārit|bis|sint|was|wārin|wārist|sī|wārun|wāris|sīn|bist|wesat	<i>verb</i><br><ol><li>to be</li></ol>
wesepa	<i>noun</i><br><ol><li>Weesp (a city in modern North Holland, the Netherlands)</li></ol>
wevan	<i>verb</i><br><ol><li>to weave</li></ol>
wi|iro|unsig|thu|it|uns|imo|unsa|wī|is|im|mī|sia|ic|ir|hē|iuwa|ik|gī|tu|ih|thīn|sie (masc. plur.)|iu|thik|mīn|thū|mik|hie|unser|sīn|wīr|mic|thic|thī|iuwer	<i>pron</i><br><ol><li>we</li></ol>
wican|wīcan	<i>verb</i><br><ol><li>to yield, to make way</li><li>to retreat</li></ol>
wie|uuie	<i>pron</i><br><ol><li>who</li></ol>
wien|wīen	<i>verb</i><br><ol><li>to bless, to sanctify</li></ol>
wildi	<i>adj</i><br><ol><li>wild</li></ol>
willen	<i>verb</i><br><ol><li>to want, to desire</li><li>(auxiliary) to want to</li><li>to wish</li></ol>
win|wīn	<i>noun</i><br><ol><li>wine</li></ol>
windan|windes|windist|windent|windon|wundin|wundint|windit|windis|winde|wundis|wundi|windu|wundut|gewundon|winden|windest|windandi|windet|wind|wundist|wand|wundun|wundit|windunt	<i>verb</i><br><ol><li>to wind, wrap</li></ol>
wini|wines|wino|winon|wine	<i>noun</i><br><ol><li>friend</li></ol>
winnan	<i>verb</i><br><ol><li>to earn</li></ol>
winter	<i>noun</i><br><ol><li>winter</li></ol>
wirken	<i>verb</i><br><ol><li>to work</li><li>to build, to make</li></ol>
wis|wīson|wīsro|wīsin|wīse|wīsu|wīsan|wīsrō|wīsno|wīs|wīsa|wīso|wīsis	<i>adj</i><br><ol><li>wise</li></ol>
wisken	<i>verb</i><br><ol><li>to wipe away/out</li></ol>
wislico|wīslīco	<i>adv</i><br><ol><li>wisely</li></ol>
witan|wītan	<i>verb</i><br><ol><li>to know</li><li>to blame, to hold accountable</li></ol>
witherdrivan|witherdrīvan	<i>verb</i><br><ol><li>to expel</li><li>to drive back</li></ol>
witherkiesan	<i>verb</i><br><ol><li>to reject</li></ol>
witherstridan|witherstrīdan	<i>verb</i><br><ol><li>to oppose, to resist</li></ol>
wonon	<i>verb</i><br><ol><li>to live, to dwell</li></ol>
wort|worde|wordon|wordes|wordo	<i>noun</i><br><ol><li>word</li></ol>
wringan|wringit|wrungut|wrungun|wrungit|wringandi|wringes|wrungist|wrungi|wringon|wringest|wringis|wrungis|wrungin|wrang|wringist|wringen|wring|wringent|gewrungon|wringu|wringunt|wringe|wrungint|wringet	<i>verb</i><br><ol><li>to wring</li></ol>
writan|writi|writun|wrītent|wrītan|wrītandi|wrītu|wrītunt|wrītet|gewriton|wrītis|wrīte|wrītit|wrīton|writis|wrīten|wrītest|wreit|wrīt|writint|writit|writut|wrītist|writin|wrītes|writist	<i>verb</i><br><ol><li>to carve</li><li>to inscribe, engrave</li></ol>
wrivan|wrīvan	<i>verb</i><br><ol><li>to rub</li></ol>
wulf	<i>noun</i><br><ol><li>wolf</li></ol>
wuopan	<i>verb</i><br><ol><li>to weep, to lament</li></ol>
wuosti	<i>adj</i><br><ol><li>desolate, waste</li></ol>
ᚨᚾᚾ|ann	<i>verb</i><br><ol><li>to give, to grant, to bestow (first and third person singular present)</li></ol>
