adĕg	<i>verb</i><br><ol><li>to stand</li></ol>
agajih	<i>adj</i><br><ol><li>fatty</li><li>greasy</li></ol>
agni	<i>noun</i><br><ol><li>fire</li></ol>
agöṅ|agĕṅ|göṅ|aguṅ|magĕṅ|magöṅ	<i>adj</i><br><ol><li>big</li><li>large</li><li>great</li><li>strong</li></ol>
ajudi	<i>verb</i><br><ol><li>to gamble</li></ol>
aku	<i>pron</i><br><ol><li>I (personal pronoun)</li><li>me (direct object of a verb)</li><li>me (object of a preposition)</li><li>me (indirect object of a verb)</li><li>my (belonging to me)</li></ol>
akṣara	<i>noun</i><br><ol><li>letter (of the alphabet)</li></ol>
alas	<i>noun</i><br><ol><li>wood, forest</li><li>quantity of flowers or plants growing in a thick cluster</li></ol>
alas-alas	<i>noun</i><br><ol><li>grove</li></ol>
alas-alasan	<i>noun</i><br><ol><li>woodland</li><li>wasteland</li></ol>
alun	<i>noun</i><br><ol><li>long rolling wave</li><li>swell of the sea</li></ol>
alĕmu	<i>adj</i><br><ol><li>fat</li></ol>
amarwa	<i>verb</i><br><ol><li>(transitive) to halve, divide in two</li><li>(intransitive) to become two</li></ol>
amarwani	<i>verb</i><br><ol><li>to occupy half,</li><li>to share with another</li></ol>
ambo	<i>noun</i><br><ol><li>escort (who walks beside a horse, etc.)</li></ol>
anak	<i>noun</i><br><ol><li>child (a female or male child, a daughter or son)</li></ol>
aneh	<i>adj</i><br><ol><li>foreign</li></ol>
antan	<i>noun</i><br><ol><li>pestle</li></ol>
antru	<i>noun</i><br><ol><li>beam</li></ol>
aparwa	<i>adj</i><br><ol><li>divided, split in two;</li><li>(of the mind) wavering, drawn in two directions</li></ol><br><i>verb</i><br><ol><li>to compose a story</li><li>to be the subject of a story</li></ol>
api	<i>noun</i><br><ol><li>fire</li></ol>
apuy	<i>noun</i><br><ol><li>fire (oxidation reaction)</li></ol>
ari	<i>noun</i><br><ol><li>younger sibling (sister or brother)</li></ol>
artha	<i>noun</i><br><ol><li>aim, purpose.</li><li>wealth, possessions; money</li><li>sense, meaning.</li></ol>
arus	<i>noun</i><br><ol><li>(water) current, tidal current, breaker</li></ol>
asu	<i>noun</i><br><ol><li>dog</li></ol>
athawa	<i>conj</i><br><ol><li>or</li></ol>
ayam alas	<i>noun</i><br><ol><li>jungle fowl</li></ol>
aḍi	<i>noun</i><br><ol><li>sibling ((younger) person who shares same parents)</li></ol>
aḍom	<i>adj</i><br><ol><li>cold</li></ol>
aṅantiga	<i>verb</i><br><ol><li>to lay eggs</li></ol>
aṅapuy	<i>verb</i><br><ol><li>to set of fire, inflame</li></ol>
aṅdilahi	<i>verb</i><br><ol><li>to kindle</li></ol>
aṇḍa	<i>noun</i><br><ol><li>egg</li><li>world egg</li></ol>
aṇḍaja	<i>noun</i><br><ol><li>bird</li><li>egg</li></ol>
bahitra	<i>noun</i><br><ol><li>vessel</li></ol>
bahu	<i>noun</i><br><ol><li>shoulder</li></ol>
bala	<i>noun</i><br><ol><li>strength, power</li><li>troops, army, soldiers of lesser rank</li></ol>
balabag	<i>noun</i><br><ol><li>plank</li></ol>
balumbang	<i>noun</i><br><ol><li>pond</li></ol>
baluṅ	<i>noun</i><br><ol><li>bone</li></ol>
bebek	<i>noun</i><br><ol><li>duck</li></ol>
belaṅ|bêlang	<i>noun</i><br><ol><li>tan line (the division between skin that has darkened or tanned from exposure to sun and skin that has not been exposed to sun)</li></ol>
besar	<i>adj</i><br><ol><li>big (of a great size)</li><li>big (adult)</li></ol>
bhagala	<i>noun</i><br><ol><li>male goat</li></ol>
bhagalī	<i>noun</i><br><ol><li>female goat</li></ol>
bhakti	<i>noun</i><br><ol><li>devotion, attachment, trust, homage, worship, piety, faith, loyalty</li></ol><br><i>adj</i><br><ol><li>devoted</li><li>faithful</li><li>loyal</li></ol>
bhaṭāra	<i>noun</i><br><ol><li>god</li></ol>
bheda	<i>adj</i><br><ol><li>other, different, wrong</li></ol><br><i>noun</i><br><ol><li>difference, separation, division, partition</li></ol>
bhāṣa	<i>noun</i><br><ol><li>speech</li><li>language</li><li>poem</li></ol>
bhūpati	<i>noun</i><br><ol><li>king</li></ol>
biru	<i>adj</i><br><ol><li>blue</li></ol>
biāṅlala	<i>noun</i><br><ol><li>rainbow (multicoloured arch in the sky)</li></ol>
blĕḍog	<i>verb</i><br><ol><li>to explode</li></ol>
bot	<i>adj</i><br><ol><li>heavy</li></ol>
botoh|bobotoh	<i>verb</i><br><ol><li>to bet</li><li>to wager</li></ol><br><i>noun</i><br><ol><li>gambler</li></ol>
bubuk	<i>noun</i><br><ol><li>weevil</li></ol>
buhaya	<i>noun</i><br><ol><li>crocodile</li></ol>
bulan	<i>noun</i><br><ol><li>moon (largest natural satellite of planet Earth)</li><li>month (period into which a year is divided)</li></ol>
buntut	<i>noun</i><br><ol><li>tail (of an animal)</li></ol>
buntĕr	<i>adj</i><br><ol><li>round</li></ol>
buru	<i>verb</i><br><ol><li>to hunt</li></ol>
buḍĕg	<i>adj</i><br><ol><li>deaf</li></ol>
buṭak	<i>adj</i><br><ol><li>bald (having no hair)</li></ol>
bwat	<i>noun</i><br><ol><li>weight, heaviness</li><li>burden</li><li>severity</li><li>force</li><li>intensity</li><li>violence</li></ol>
bĕcik	<i>adj</i><br><ol><li>good</li><li>beautiful</li></ol>
bĕḍisil	<i>noun</i><br><ol><li>young goat</li></ol>
candra	<i>noun</i><br><ol><li>moon</li></ol>
candu	<i>noun</i><br><ol><li>a kind of unguent, a kind of dye.</li></ol>
cangkem	<i>noun</i><br><ol><li>mouth</li></ol>
caṇḍi	<i>noun</i><br><ol><li>temple</li><li>sanctuary (in which the deity descends, worshipped, and made contact with those who are blessed)</li></ol>
coloṅ	<i>verb</i><br><ol><li>to steal</li></ol>
cêmani	<i>noun</i><br><ol><li>thoroughly black (even to the inner part).</li></ol>
cĕcak	<i>noun</i><br><ol><li>house lizard (Hemidactylus frenatus)</li></ol>
cĕcĕk	<i>noun</i><br><ol><li>house lizard (Hemidactylus frenatus)</li></ol>
cĕkĕl	<i>verb</i><br><ol><li>to catch</li></ol>
dadi	<i>verb</i><br><ol><li>to become</li><li>to be born</li></ol>
dagaṅ	<i>verb</i><br><ol><li>to trade</li></ol>
dagiṅ	<i>noun</i><br><ol><li>meat</li><li>flesh</li></ol>
dalan	<i>noun</i><br><ol><li>path, way</li></ol>
dalem	<i>adj</i><br><ol><li>interior (inner part)</li><li>inner part of the kraton</li></ol>
dalu	<i>adj</i><br><ol><li>great</li></ol><br><i>noun</i><br><ol><li>night</li></ol>
dampatī	<i>noun</i><br><ol><li>man and wife</li><li>a couple, a pair</li></ol><br><i>adj</i><br><ol><li>forming a pair</li><li>with his wife</li></ol>
dara|darā	<i>noun</i><br><ol><li>pigeon</li><li>dove</li><li>wife</li><li>(literary) virgin</li></ol>
dawa	<i>adj</i><br><ol><li>long</li></ol>
dilah	<i>noun</i><br><ol><li>flame</li></ol>
dina|dintĕn	<i>noun</i><br><ol><li>day</li><li>daylight</li></ol>
dol	<i>verb</i><br><ol><li>to sell</li></ol>
duh	<i>noun</i><br><ol><li>juice</li><li>sap</li><li>oil (for a lamp)</li></ol>
duk	<i>noun</i><br><ol><li>stab</li></ol>
dukut	<i>noun</i><br><ol><li>grass</li></ol>
dum	<i>noun</i><br><ol><li>part</li></ol>
dumilah	<i>adj</i><br><ol><li>flaming</li><li>shining</li></ol><br><i>verb</i><br><ol><li>to flame</li><li>to shine</li></ol>
duri	<i>noun</i><br><ol><li>thorn</li></ol>
dĕku	<i>verb</i><br><ol><li>to kneel</li></ol>
dĕkung	<i>noun</i><br><ol><li>knee</li></ol>
dĕlo	<i>verb</i><br><ol><li>to see</li></ol>
eka	<i>num</i><br><ol><li>one</li></ol>
enem	<i>num</i><br><ol><li>six</li></ol>
eṇḍut	<i>noun</i><br><ol><li>mud</li></ol>
gajih	<i>noun</i><br><ol><li>fat (of animal)</li></ol>
gamelan|gamêlan|gångså	<i>noun</i><br><ol><li>gamelan (genre of music)</li></ol>
gaway	<i>noun</i><br><ol><li>work, task, occupation</li><li>work, product</li><li>feast, celebration</li><li>use, purpose</li></ol><br><i>verb</i><br><ol><li>to work, to do</li></ol>
giri	<i>noun</i><br><ol><li>mountain</li></ol>
grih	<i>noun</i><br><ol><li>small dried salt fish</li></ol>
gugut	<i>verb</i><br><ol><li>to chew</li></ol>
gulu	<i>noun</i><br><ol><li>neck</li></ol>
gunung	<i>noun</i><br><ol><li>mountain</li></ol>
gunuṅ alas	<i>noun</i><br><ol><li>wooded mountain</li></ol>
guru	<i>noun</i><br><ol><li>teacher</li></ol>
göṅ|guṅ|gĕṅ	<i>noun</i><br><ol><li>bigness</li><li>largeness</li><li>strength</li></ol><br><i>adv</i><br><ol><li>very</li></ol>
gĕbyog	<i>noun</i><br><ol><li>wooden house wall</li></ol>
gĕgĕt	<i>verb</i><br><ol><li>to bite</li></ol>
gĕlĕpung	<i>noun</i><br><ol><li>flour</li></ol>
gĕni	<i>noun</i><br><ol><li>fire</li></ol>
gĕtih	<i>noun</i><br><ol><li>sap, juice</li></ol>
gĕḍe	<i>noun</i><br><ol><li>bigness, largeness</li></ol>
gĕḍoṅ	<i>noun</i><br><ol><li>building: a closed structure with walls and a roof.</li></ol>
gṛha	<i>noun</i><br><ol><li>house, home, habitation, abode.</li></ol>
haji	<i>noun</i><br><ol><li>king</li></ol>
hala	<i>adj</i><br><ol><li>bad, evil</li></ol>
halun	<i>noun</i><br><ol><li>long rolling wave</li><li>swell of the sea</li></ol>
hangin	<i>noun</i><br><ol><li>wind (movement of air)</li></ol>
hangĕt	<i>adj</i><br><ol><li>warm, hot</li></ol>
hantiga|antiga	<i>noun</i><br><ol><li>egg</li></ol>
hantimun	<i>noun</i><br><ol><li>cucumber</li></ol>
hantrini	<i>noun</i><br><ol><li>egg</li></ol>
hantĕlu	<i>noun</i><br><ol><li>egg</li></ol>
harĕp	<i>noun</i><br><ol><li>front</li></ol><br><i>verb</i><br><ol><li>to wish</li></ol>
harĕṅ	<i>noun</i><br><ol><li>charcoal</li></ol>
hasin	<i>adj</i><br><ol><li>salty</li></ol>
hati	<i>noun</i><br><ol><li>(anatomy) liver (organ of the body)</li><li>heart (emotions or kindness)</li></ol>
hawu	<i>noun</i><br><ol><li>ash</li></ol>
hañar	<i>adj</i><br><ol><li>new</li></ol>
haḍĕp	<i>noun</i><br><ol><li>front</li></ol>
hibĕr	<i>verb</i><br><ol><li>to fly</li></ol>
hidĕr	<i>verb</i><br><ol><li>to turn, to revolve</li></ol>
hijo	<i>adj</i><br><ol><li>green</li></ol>
himba	<i>noun</i><br><ol><li>brow</li></ol>
hirung	<i>noun</i><br><ol><li>nose</li></ol>
hirĕng	<i>adj</i><br><ol><li>dark</li></ol>
hisĕp	<i>verb</i><br><ol><li>to suck</li></ol>
hotot	<i>noun</i><br><ol><li>muscle</li><li>meat</li></ol>
hri	<i>noun</i><br><ol><li>thorn</li><li>sting</li></ol>
huntu	<i>noun</i><br><ol><li>tooth</li></ol>
hurang	<i>noun</i><br><ol><li>shrimp (decapod crustacean)</li><li>prawn</li><li>lobster</li></ol>
hurip	<i>noun</i><br><ol><li>life</li></ol>
hwab	<i>verb</i><br><ol><li>to yawn</li></ol>
hyaṅ	<i>noun</i><br><ol><li>god, goddess, deified being, divinity,</li><li>sacred place,</li><li>sacred thing or body</li><li>sacred person, such as anchorite, monk, nun.</li></ol>
hĕni	<i>noun</i><br><ol><li>sand</li></ol>
hĕnu	<i>noun</i><br><ol><li>way, path</li></ol>
ibu	<i>noun</i><br><ol><li>mother</li></ol>
idu	<i>noun</i><br><ol><li>saliva</li></ol>
ilat	<i>noun</i><br><ol><li>tongue</li></ol>
ili	<i>verb</i><br><ol><li>to flow</li></ol>
indah	<i>verb</i><br><ol><li>hear, listen</li></ol><br><i>adj</i><br><ol><li>being different, extraordinary beauty</li></ol>
ipe	<i>noun</i><br><ol><li>sister-in-law or brother-in-law</li></ol>
ipi	<i>noun</i><br><ol><li>dream</li></ol>
isin	<i>noun</i><br><ol><li>shame</li></ol>
isuk	<i>adj</i><br><ol><li>early</li></ol>
itik	<i>noun</i><br><ol><li>duck</li></ol>
iwak	<i>noun</i><br><ol><li>fish</li></ol>
iwu	<i>num</i><br><ol><li>thousand</li></ol>
jagat	<i>noun</i><br><ol><li>world</li></ol>
jajaka	<i>noun</i><br><ol><li>umarried young man</li></ol>
jaka	<i>noun</i><br><ol><li>unmarried young man</li></ol>
jambat	<i>adj</i><br><ol><li>slow</li></ol>
jambu	<i>noun</i><br><ol><li>rose apple tree and its fruit</li></ol>
janggut	<i>noun</i><br><ol><li>chin</li></ol>
jaran	<i>noun</i><br><ol><li>horse</li></ol>
jariji	<i>noun</i><br><ol><li>finger</li></ol>
jro	<i>noun</i><br><ol><li>inside</li></ol>
jruk	<i>noun</i><br><ol><li>citrus, lemon, orange</li><li>pickled meat</li></ol>
judi	<i>noun</i><br><ol><li>gambling, betting</li><li>gambler</li></ol>
kabotohan	<i>noun</i><br><ol><li>gambling house</li></ol>
kaca	<i>noun</i><br><ol><li>glass</li></ol>
kacak	<i>adj</i><br><ol><li>chatting</li></ol>
kacaṅ	<i>noun</i><br><ol><li>bean</li></ol>
kadal	<i>noun</i><br><ol><li>skink</li></ol>
kalapa	<i>noun</i><br><ol><li>coconut</li></ol>
kali	<i>noun</i><br><ol><li>river</li><li>deep watercourse</li><li>river-bed</li><li>channel</li></ol>
kaluṅ	<i>noun</i><br><ol><li>necklace</li></ol>
kambiṅ	<i>noun</i><br><ol><li>goat</li></ol>
kamūḍhan	<i>noun</i><br><ol><li>stupidity, foolishness</li></ol>
kanakaweśma	<i>noun</i><br><ol><li>golden house</li></ol>
kanan	<i>adj</i><br><ol><li>right (of direction)</li></ol>
kandĕl	<i>adj</i><br><ol><li>thick</li></ol>
kapan	<i>pron</i><br><ol><li>when</li></ol>
kaparwan	<i>verb</i><br><ol><li>to occupy half,</li><li>to share with another</li></ol>
kapisan	<i>adv</i><br><ol><li>at once</li></ol>
karĕm	<i>verb</i><br><ol><li>to sink</li></ol>
kawat	<i>noun</i><br><ol><li>wire</li></ol>
kawaśa	<i>adj</i><br><ol><li>overpowered, dominated, mastered, subdued</li></ol>
kayu	<i>noun</i><br><ol><li>wood, tree</li></ol>
kaṇḍa	<i>noun</i><br><ol><li>a story</li></ol>
keleleb	<i>verb</i><br><ol><li>to sink</li></ol>
kering	<i>adj</i><br><ol><li>left, opposite of right</li></ol>
keriṅ	<i>adj</i><br><ol><li>left</li></ol>
kidul	<i>noun</i><br><ol><li>south</li></ol>
kilat	<i>noun</i><br><ol><li>lightning</li></ol>
kirim	<i>verb</i><br><ol><li>to send</li></ol>
kiwa	<i>adj</i><br><ol><li>left</li></ol>
ko	<i>pron</i><br><ol><li>you</li></ol>
krama	<i>noun</i><br><ol><li>course, order</li><li>state, condition</li><li>conduct, behaviour</li><li>custom</li><li>thereupon, then; duly</li></ol>
kuku	<i>noun</i><br><ol><li>nail (anatomy)</li></ol>
kulit	<i>noun</i><br><ol><li>skin (outer covering of the body of a person)</li><li>leather (material produced by tanning animal skin)</li><li>shell (covering of a nut)</li></ol>
kulwan	<i>noun</i><br><ol><li>west</li></ol><br><i>adj</i><br><ol><li>west (western)</li></ol>
kumbah	<i>verb</i><br><ol><li>to wash (clothes)</li></ol>
kuṇḍi	<i>noun</i><br><ol><li>bowl; pitcher; pot</li></ol>
kuṭa	<i>noun</i><br><ol><li>fort, stronghold, fortified encampment</li><li>walled palace</li><li>wall</li></ol>
kweh	<i>noun</i><br><ol><li>amount</li></ol>
kĕbo	<i>noun</i><br><ol><li>buffalo</li></ol>
kĕbwan	<i>noun</i><br><ol><li>garden</li></ol>
kĕmbar	<i>noun</i><br><ol><li>twin</li></ol>
kĕmbaṅ|kĕmbang	<i>noun</i><br><ol><li>flower</li></ol>
kĕndang	<i>noun</i><br><ol><li>drum</li></ol>
kĕsĕl	<i>adj</i><br><ol><li>tired</li></ol>
kĕṭok	<i>verb</i><br><ol><li>to cut</li></ol>
kṛta	<i>adj</i><br><ol><li>done, made, performed</li><li>prosperous, flourishing, thriving</li><li>accomplished, perfect</li></ol><br><i>noun</i><br><ol><li>the lucky or winning die</li><li>the golden age</li></ol>
kṣatriya	<i>noun</i><br><ol><li>warrior,</li><li>nobleman</li></ol>
lalawa	<i>noun</i><br><ol><li>bat</li></ol>
lali	<i>verb</i><br><ol><li>to forget</li></ol>
lalĕr	<i>noun</i><br><ol><li>a fly (insect)</li></ol>
lama	<i>adj</i><br><ol><li>old</li></ol>
langkah	<i>noun</i><br><ol><li>step</li></ol>
lapa	<i>adj</i><br><ol><li>hungry</li></ol>
lara	<i>adj</i><br><ol><li>ill, sick</li><li>sad</li><li>suffering</li></ol>
latu	<i>noun</i><br><ol><li>spark</li></ol>
lawas	<i>adj</i><br><ol><li>old</li></ol>
lawaṅ	<i>noun</i><br><ol><li>door</li><li>gate</li><li>entrance</li></ol>
layar	<i>noun</i><br><ol><li>sail</li></ol>
layu	<i>verb</i><br><ol><li>to run</li></ol>
laṅit	<i>noun</i><br><ol><li>sky</li><li>firmament</li></ol>
laṅit-laṅit	<i>noun</i><br><ol><li>canopy</li></ol>
laṇḍĕp	<i>adj</i><br><ol><li>sharp</li></ol>
lima	<i>num</i><br><ol><li>five</li></ol>
limut	<i>noun</i><br><ol><li>fog</li></ol>
lingsir	<i>verb</i><br><ol><li>slide down.</li><li>fall.</li></ol>
liṅsa	<i>noun</i><br><ol><li>egg of a louse</li></ol>
luh	<i>noun</i><br><ol><li>tear</li></ol>
lunga	<i>verb</i><br><ol><li>to go</li></ol>
lungguh	<i>verb</i><br><ol><li>to sit</li></ol>
lĕba	<i>adj</i><br><ol><li>wide</li></ol>
lĕmah	<i>noun</i><br><ol><li>earth</li></ol>
lĕmbu	<i>noun</i><br><ol><li>ox, cow, bull</li></ol>
lĕmbut	<i>adj</i><br><ol><li>soft</li></ol>
lĕmu	<i>noun</i><br><ol><li>fatness</li></ol>
lĕnga	<i>noun</i><br><ol><li>oil</li></ol>
macan	<i>noun</i><br><ol><li>tiger</li></ol>
madhu	<i>noun</i><br><ol><li>honey</li></ol>
manuk	<i>noun</i><br><ol><li>bird</li></ol>
marica	<i>noun</i><br><ol><li>black pepper</li></ol>
martyapada	<i>noun</i><br><ol><li>earth</li></ol>
marwa	<i>verb</i><br><ol><li>(transitive) to halve, divide in two</li><li>(intransitive) to become two</li></ol>
mata	<i>noun</i><br><ol><li>eye (organ)</li></ol>
maṇi	<i>noun</i><br><ol><li>pearl</li><li>gem</li></ol>
megha	<i>noun</i><br><ol><li>cloud</li></ol>
menda	<i>noun</i><br><ol><li>ram</li><li>sheep</li></ol>
meru	<i>noun</i><br><ol><li>(literately) mountain.</li><li>centre of the world</li><li>pagoda-like building in the temple compound.</li></ol>
minda	<i>noun</i><br><ol><li>sheep</li></ol>
mpu|empu	<i>noun</i><br><ol><li>a distinguished person</li><li>religious persons (brahmans and others)</li><li>sir, master, lord</li><li>the honorable or reverend</li></ol>
mrak	<i>noun</i><br><ol><li>peacock</li></ol>
mungsuh	<i>noun</i><br><ol><li>enemy</li></ol>
mārga	<i>noun</i><br><ol><li>track, road, way.</li><li>vehicle, mean.</li><li>manner, method, way of life.</li></ol>
mĕtah	<i>adj</i><br><ol><li>raw</li></ol>
mūḍha	<i>adj</i><br><ol><li>stupid, foolish</li><li>unwise</li></ol>
nagara	<i>noun</i><br><ol><li>palace</li><li>court</li><li>residence</li><li>capital</li><li>state; realm</li></ol>
nanah	<i>noun</i><br><ol><li>pus (fluid found in regions of infection)</li></ol>
naraka	<i>noun</i><br><ol><li>hell</li></ol>
nasi|ꦤꦱꦶ	<i>noun</i><br><ol><li>cooked rice</li></ol>
nastapa	<i>adj</i><br><ol><li>sorry</li><li>miserable</li><li>downhearted</li><li>sad</li></ol><br><i>noun</i><br><ol><li>sadness</li></ol>
natar	<i>noun</i><br><ol><li>background colour in batik.</li><li>backyard</li></ol>
nek	<i>verb</i><br><ol><li>to ascend, to go up</li></ol>
ngaran	<i>noun</i><br><ol><li>name</li></ol>
nguḍa	<i>adj</i><br><ol><li>young</li></ol>
niścaya	<i>adv</i><br><ol><li>certain, sure, convinced</li></ol>
nwam	<i>adj</i><br><ol><li>young</li></ol>
nūsa	<i>noun</i><br><ol><li>island (area of land completely surrounded by water)</li></ol>
nūsāntara	<i>noun</i><br><ol><li>the outer islands (from Java island perspective); these islands or achipelagic region later known as Indonesia in modern-day.</li></ol>
pahat	<i>noun</i><br><ol><li>chisel</li></ol>
pahit	<i>adj</i><br><ol><li>bitter</li></ol>
pajudyan	<i>noun</i><br><ol><li>gambling house</li></ol>
pakacaṅan	<i>noun</i><br><ol><li>peanut field</li></ol>
palaṅka	<i>noun</i><br><ol><li>couch, seat, bench, throne</li></ol>
palu	<i>noun</i><br><ol><li>hammer</li></ol>
panah	<i>noun</i><br><ol><li>arrow</li></ol>
panas	<i>adj</i><br><ol><li>warm</li></ol>
panjaṅ	<i>adj</i><br><ol><li>long</li></ol>
pantĕs	<i>adj</i><br><ol><li>fitting, appropriate</li><li>in accordance with all the rules</li></ol>
parahu	<i>noun</i><br><ol><li>boat</li></ol>
pari	<i>noun</i><br><ol><li>rice (plant)</li></ol>
parwa	<i>noun</i><br><ol><li>half</li><li>part (book) of the Mahābhārata epic</li></ol>
parwan	<i>verb</i><br><ol><li>half</li></ol>
pasabhan	<i>noun</i><br><ol><li>place for public meeting</li><li>audience place</li><li>frequented place</li></ol>
pat	<i>num</i><br><ol><li>four</li></ol>
pawiwāha	<i>noun</i><br><ol><li>paraphernalia at a marriage ceremony</li></ol>
pawiwāhan	<i>noun</i><br><ol><li>marriage, wedding</li></ol>
payuṅ	<i>noun</i><br><ol><li>umbrella</li></ol>
paścat	<i>adv</i><br><ol><li>then, next; finally</li><li>complete, finished.</li></ol>
paṅ	<i>noun</i><br><ol><li>branch</li><li>prong, fork</li></ol>
paṇḍak	<i>adj</i><br><ol><li>short</li></ol>
paṇḍe	<i>noun</i><br><ol><li>blacksmith</li></ol>
paṇḍita	<i>noun</i><br><ol><li>sage,</li><li>holy man</li></ol>
pelaṅ|pêlang	<i>noun</i><br><ol><li>stripe, striped</li></ol>
phala	<i>noun</i><br><ol><li>fruit.</li><li>consequence.</li></ol>
picĕk	<i>adj</i><br><ol><li>one-eyed</li></ol>
pilih	<i>verb</i><br><ol><li>to choose</li></ol>
pinarwa	<i>verb</i><br><ol><li>(transitive) to halve, divide in two</li><li>(intransitive) to become two</li></ol>
pinarwakĕn	<i>verb</i><br><ol><li>to take half of</li><li>to divide in two</li></ol>
pinarwan	<i>verb</i><br><ol><li>to occupy half,</li><li>to share with another</li></ol>
pinggir	<i>noun</i><br><ol><li>edge, border</li></ol>
pira	<i>pron</i><br><ol><li>how many</li></ol>
pirak	<i>noun</i><br><ol><li>silver</li></ol>
pisaṅ	<i>noun</i><br><ol><li>banana</li></ol>
pisaṅ alas	<i>noun</i><br><ol><li>wild banana</li></ol>
pitik	<i>noun</i><br><ol><li>fowl, hen, chicken</li></ol>
pitu	<i>num</i><br><ol><li>seven</li></ol>
piturun	<i>noun</i><br><ol><li>visible manifestation, embodiment</li></ol>
piṅ	<i>det</i><br><ol><li>times</li></ol>
pracaya	<i>verb</i><br><ol><li>to believe, to have trust</li></ol>
pramukha	<i>noun</i><br><ol><li>leader</li></ol>
priṅ	<i>noun</i><br><ol><li>bamboo</li></ol>
pucuk	<i>noun</i><br><ol><li>tip, point, peak</li></ol>
pulih	<i>verb</i><br><ol><li>to return</li></ol>
punti	<i>noun</i><br><ol><li>banana</li></ol>
pupu	<i>noun</i><br><ol><li>thigh</li></ol>
pura	<i>noun</i><br><ol><li>castle (fortified building)</li><li>palace, royal residence</li><li>residential section of a palace</li><li>town</li><li>court</li><li>capital</li><li>kingdom</li></ol>
purī|puri	<i>noun</i><br><ol><li>castle (fortified building)</li><li>palace, royal residence</li><li>residential section of a palace</li><li>town</li><li>court</li><li>capital</li><li>kingdom</li></ol>
putĕr	<i>verb</i><br><ol><li>to turn</li></ol>
puṇḍak	<i>noun</i><br><ol><li>shoulder</li></ol>
pāśraman	<i>noun</i><br><ol><li>hermitage</li></ol>
pĕtĕng	<i>adj</i><br><ol><li>dark</li></ol>
pūrṇama	<i>noun</i><br><ol><li>full moon</li></ol>
rah	<i>noun</i><br><ol><li>blood</li></ol>
rasa	<i>noun</i><br><ol><li>sap, juice; taste, flavour</li><li>feeling, opinion, intention</li><li>content, substance, meaning</li><li>mercury</li></ol>
rat	<i>noun</i><br><ol><li>land</li></ol>
rata	<i>adj</i><br><ol><li>flat</li></ol>
ratu	<i>noun</i><br><ol><li>king</li></ol>
rawa	<i>noun</i><br><ol><li>swamp</li></ol>
raṇḍa	<i>noun</i><br><ol><li>widow</li></ol>
ri	<i>noun</i><br><ol><li>thorn</li><li>thorny plant</li></ol>
ron	<i>noun</i><br><ol><li>leaf</li></ol>
roto	<i>noun</i><br><ol><li>egg of ant</li></ol>
ruhur	<i>adj</i><br><ol><li>high</li></ol>
rwa	<i>num</i><br><ol><li>two</li></ol>
rwi	<i>noun</i><br><ol><li>thorn</li><li>thorny plant</li></ol>
rāma|arama	<i>noun</i><br><ol><li>father (once: mother in Udyogaparwa), also used for uncle, guru, etc.</li><li>the eldest, senior (in religious community, village, army)</li></ol>
sabhā	<i>noun</i><br><ol><li>assembly, court.</li><li>frequented place.</li></ol>
saga	<i>noun</i><br><ol><li>jequirity (Abrus precatorius)</li></ol>
saka	<i>noun</i><br><ol><li>post (pillar)</li></ol>
salaka	<i>noun</i><br><ol><li>silver</li></ol>
sambuṅ	<i>verb</i><br><ol><li>to join</li></ol>
samādhi	<i>noun</i><br><ol><li>samadhi: concentration of the thoughts, profound or abstract meditation, intense contemplation of any particular object.</li></ol>
sanga	<i>num</i><br><ol><li>nine</li></ol>
sapu	<i>noun</i><br><ol><li>broom</li></ol>
sapuluh	<i>num</i><br><ol><li>ten</li></ol>
sawah	<i>noun</i><br><ol><li>field</li></ol>
sawat	<i>verb</i><br><ol><li>to throw</li></ol>
siddha	<i>adj</i><br><ol><li>accomplished, fulfilled</li><li>successful</li></ol><br><i>noun</i><br><ol><li>siddha</li></ol>
siku	<i>noun</i><br><ol><li>elbow</li></ol>
singha	<i>noun</i><br><ol><li>lion</li></ol>
siṅha	<i>noun</i><br><ol><li>lion</li></ol>
sore	<i>noun</i><br><ol><li>afternoon</li></ol>
strī	<i>noun</i><br><ol><li>woman, female;</li><li>wife</li></ol>
suduk	<i>verb</i><br><ol><li>to stab, to pierce</li></ol>
sugih	<i>adj</i><br><ol><li>rich</li></ol>
suji	<i>noun</i><br><ol><li>spine, quill (of a porcupine)</li><li>embroidery</li></ol>
sukĕt	<i>adj</i><br><ol><li>leafy</li></ol>
sumur	<i>noun</i><br><ol><li>a well</li></ol>
sungu	<i>noun</i><br><ol><li>horn</li></ol>
surat	<i>noun</i><br><ol><li>letter (written message)</li></ol>
surup	<i>verb</i><br><ol><li>to enter</li><li>to pass</li><li>to sink</li></ol>
susun	<i>verb</i><br><ol><li>to arrange</li></ol>
susup	<i>verb</i><br><ol><li>to infiltrate</li></ol>
swara	<i>noun</i><br><ol><li>sound</li></ol>
syapa	<i>pron</i><br><ol><li>who</li></ol>
sādhu	<i>adj</i><br><ol><li>good, virtuous</li></ol><br><i>noun</i><br><ol><li>sadhu: a holy man, saint, sage, seer.</li></ol>
sāgara	<i>noun</i><br><ol><li>ocean</li></ol>
sākṣī	<i>noun</i><br><ol><li>witness</li></ol>
sānak	<i>noun</i><br><ol><li>brother, sister, relative; with his brother(s)</li></ol>
sătus	<i>num</i><br><ol><li>one hundred</li></ol>
sĕmbah	<i>noun</i><br><ol><li>respect</li></ol>
sĕsĕk	<i>adj</i><br><ol><li>crowded</li></ol>
sūrya|surya	<i>noun</i><br><ol><li>sun</li></ol>
tahulan	<i>noun</i><br><ol><li>bone, especially fishbone</li></ol>
tahun	<i>noun</i><br><ol><li>year</li><li>seasonal crop</li></ol>
tajĕm	<i>adj</i><br><ol><li>sharp</li></ol>
takwan	<i>verb</i><br><ol><li>to ask, to question</li></ol>
talaga	<i>noun</i><br><ol><li>a well</li><li>lake</li><li>tank</li><li>pool, pond</li></ol>
tali	<i>noun</i><br><ol><li>rope</li></ol>
taman	<i>adv</i><br><ol><li>not</li></ol>
tambaga	<i>noun</i><br><ol><li>copper</li></ol>
tambeh	<i>verb</i><br><ol><li>to add</li></ol>
tampa	<i>verb</i><br><ol><li>to receive</li></ol>
tamuy	<i>noun</i><br><ol><li>guest</li></ol>
tandur	<i>verb</i><br><ol><li>to plant</li></ol>
tangis	<i>verb</i><br><ol><li>to cry, to weep</li></ol>
tangkeb	<i>verb</i><br><ol><li>to catch</li></ol>
tarik	<i>verb</i><br><ol><li>to pull</li></ol>
tarima	<i>verb</i><br><ol><li>to receive</li></ol>
tasak	<i>adj</i><br><ol><li>ripe</li><li>cooked</li></ol><br><i>verb</i><br><ol><li>to ripen</li><li>to cook</li></ol>
tatu	<i>noun</i><br><ol><li>wound</li></ol>
tawwan	<i>noun</i><br><ol><li>bee</li></ol>
taña	<i>verb</i><br><ol><li>to ask (a question)</li></ol>
taṅan	<i>noun</i><br><ol><li>hand</li></ol>
taṅgal	<i>noun</i><br><ol><li>the waxing (of the moon),</li><li>first half of the lunar month (1-15),</li><li>day in the first half of the lunar month</li></ol>
taṇḍa	<i>noun</i><br><ol><li>ensign, standard, banner.</li><li>(figuratively) official</li></ol>
tetes	<i>noun</i><br><ol><li>drop, drip</li></ol>
tiba	<i>verb</i><br><ol><li>to fall</li></ol>
tiga	<i>num</i><br><ol><li>three</li></ol>
tilik	<i>verb</i><br><ol><li>to visit.</li></ol>
timah	<i>noun</i><br><ol><li>tin (element)</li></ol>
timba	<i>noun</i><br><ol><li>bucket for drawing water from a well</li></ol>
tipis	<i>adj</i><br><ol><li>thin</li></ol>
tom	<i>noun</i><br><ol><li>indigo (plant)</li></ol>
ton	<i>verb</i><br><ol><li>to see; to look</li></ol>
toya|ꦠꦺꦴꦪ	<i>noun</i><br><ol><li>water</li></ol>
tuding	<i>verb</i><br><ol><li>to point</li></ol>
tugĕl	<i>verb</i><br><ol><li>to break</li></ol>
tuha	<i>adj</i><br><ol><li>old</li></ol>
tuhu	<i>adv</i><br><ol><li>truly</li></ol>
tulak	<i>verb</i><br><ol><li>to push</li></ol>
tulis	<i>noun</i><br><ol><li>book, letter, drawing</li></ol>
tulup	<i>noun</i><br><ol><li>blowpipe</li></ol>
tuluṅ	<i>verb</i><br><ol><li>to help</li></ol>
tuma	<i>noun</i><br><ol><li>head louse</li></ol>
tumbuk	<i>verb</i><br><ol><li>to hit with a thump</li></ol>
tunggal	<i>num</i><br><ol><li>one</li></ol>
tunu	<i>verb</i><br><ol><li>to burn</li></ol>
turu	<i>verb</i><br><ol><li>to sleep</li></ol>
tutup	<i>verb</i><br><ol><li>to cover</li></ol>
tuwuh	<i>verb</i><br><ol><li>to grow</li></ol><br><i>noun</i><br><ol><li>growth, growing</li><li>life, age</li><li>condition of life, lot</li><li>body</li></ol>
tāman|taman	<i>noun</i><br><ol><li>garden</li></ol>
tĕbu	<i>noun</i><br><ol><li>sugar cane</li></ol>
tĕka	<i>verb</i><br><ol><li>to come</li></ol>
tĕkĕn	<i>noun</i><br><ol><li>staff</li></ol>
tĕlu	<i>num</i><br><ol><li>three</li></ol>
tĕlĕs	<i>adj</i><br><ol><li>wet</li></ol>
tĕmu	<i>noun</i><br><ol><li>meeting, encounter</li><li>a kind of plant</li></ol>
tĕngah	<i>noun</i><br><ol><li>middle</li></ol>
tĕngĕn	<i>adj</i><br><ol><li>right (direction)</li></ol>
tĕnun	<i>verb</i><br><ol><li>to weave</li></ol>
tĕpi	<i>noun</i><br><ol><li>edge</li><li>border</li><li>side</li></ol>
tĕtĕsan	<i>noun</i><br><ol><li>what is hatched out, brood</li></ol>
tĕṅĕn	<i>adj</i><br><ol><li>right (of direction)</li></ol>
tīrtha	<i>noun</i><br><ol><li>bathing-place.</li><li>holy water.</li></ol>
tṛṣṇa	<i>noun</i><br><ol><li>desire</li><li>love</li></ol>
udan	<i>noun</i><br><ol><li>rain</li></ol>
uga	<i>conj</i><br><ol><li>also</li></ol>
ukir	<i>verb</i><br><ol><li>carve</li><li>chisel (out)</li><li>sculpture</li><li>provide (adorn) with carvings (sculptures, reliefs)</li></ol><br><i>noun</i><br><ol><li>Alternative letter-case form of Ukir</li></ol>
ukur	<i>verb</i><br><ol><li>to measure (ascertain the quantity of a unit)</li></ol>
ulā	<i>noun</i><br><ol><li>snake (legless reptile).</li></ol>
ulă	<i>noun</i><br><ol><li>snake (legless reptile).</li></ol>
umah	<i>noun</i><br><ol><li>abode, home or house</li></ol>
uni|ṅuni	<i>noun</i><br><ol><li>sound</li></ol>
upacāra	<i>noun</i><br><ol><li>ceremony</li></ol>
upil	<i>noun</i><br><ol><li>snot</li></ol>
urat	<i>noun</i><br><ol><li>nerve, sinew----</li></ol>
urub	<i>noun</i><br><ol><li>flame</li></ol>
utah	<i>verb</i><br><ol><li>to vomit</li></ol>
utĕk	<i>noun</i><br><ol><li>brain</li></ol>
uwur-uwur	<i>noun</i><br><ol><li>jellyfish</li></ol>
uṇḍa	<i>verb</i><br><ol><li>to ascend, to go up</li></ol>
uṣadha|oṣadha	<i>noun</i><br><ol><li>medicine</li></ol>
wa	<i>noun</i><br><ol><li>ember, glowing coal</li></ol>
waca	<i>verb</i><br><ol><li>to read</li></ol>
wadwa	<i>noun</i><br><ol><li>subject,</li><li>follower,</li><li>troops</li></ol>
wadwan	<i>noun</i><br><ol><li>woman, female</li></ol>
wagus	<i>adj</i><br><ol><li>fine</li><li>good</li></ol>
wah	<i>noun</i><br><ol><li>flood</li></ol>
wai	<i>noun</i><br><ol><li>water</li></ol>
walakaṅ	<i>noun</i><br><ol><li>the back</li></ol>
walaṅ	<i>noun</i><br><ol><li>locust</li></ol>
wales	<i>noun</i><br><ol><li>answer</li></ol>
wali	<i>verb</i><br><ol><li>to repeat</li></ol>
walik	<i>verb</i><br><ol><li>to return</li></ol>
waliraṅ|wariraṅ	<i>noun</i><br><ol><li>sulfur</li></ol>
walu	<i>noun</i><br><ol><li>widow</li></ol>
waluku	<i>noun</i><br><ol><li>plough</li></ol>
walĕr	<i>noun</i><br><ol><li>boundary, limit, end</li></ol>
wana	<i>noun</i><br><ol><li>forest, wood</li></ol>
waneh	<i>adv</i><br><ol><li>also, further</li></ol>
wangi	<i>noun</i><br><ol><li>smell, fragrance</li></ol>
wangke	<i>noun</i><br><ol><li>corpse</li></ol>
wangun	<i>verb</i><br><ol><li>to rise, to get up</li></ol>
wani	<i>adj</i><br><ol><li>brave, courageous</li></ol>
wanita	<i>noun</i><br><ol><li>a woman</li></ol>
wanwa	<i>noun</i><br><ol><li>continent</li></ol>
warah	<i>verb</i><br><ol><li>to say</li></ol>
warah-warah	<i>noun</i><br><ol><li>communication,</li><li>information,</li><li>report,</li><li>instruction,</li><li>teaching</li></ol>
warak	<i>noun</i><br><ol><li>rhinoceros</li></ol>
warĕg	<i>adj</i><br><ol><li>full, sated</li></ol>
warṇṇa	<i>noun</i><br><ol><li>form, shape</li><li>color</li></ol>
warṣa	<i>noun</i><br><ol><li>year</li><li>rain</li><li>region</li></ol>
watang	<i>noun</i><br><ol><li>trunk (of trees)</li></ol>
watu	<i>noun</i><br><ol><li>stone</li></ol>
watuk	<i>noun</i><br><ol><li>a cough</li></ol>
watĕs	<i>noun</i><br><ol><li>limit</li></ol>
wawa	<i>verb</i><br><ol><li>to bring, to carry</li></ol>
wayah	<i>noun</i><br><ol><li>time</li></ol>
wayaṅ	<i>noun</i><br><ol><li>shadow</li></ol>
waṅśa	<i>noun</i><br><ol><li>lineage,</li><li>dynasty,</li><li>posterity</li></ol>
waṇija	<i>noun</i><br><ol><li>merchant, trader</li></ol>
wesi	<i>noun</i><br><ol><li>(physics, chemistry, metallurgy) iron (element)</li></ol>
weśma	<i>noun</i><br><ol><li>house</li><li>dwelling</li></ol>
wiji	<i>noun</i><br><ol><li>seed, kernel</li><li>content, substance</li><li>unit in counting</li></ol>
wilaṅ	<i>noun</i><br><ol><li>number</li></ol>
winih	<i>noun</i><br><ol><li>seed</li></ol>
wintaṅ	<i>noun</i><br><ol><li>star</li></ol>
wisa	<i>verb</i><br><ol><li>to poison</li></ol>
wisik	<i>verb</i><br><ol><li>to whisper</li></ol>
wisma	<i>noun</i><br><ol><li>house</li></ol>
wit	<i>noun</i><br><ol><li>tree</li></ol>
wiwi	<i>noun</i><br><ol><li>goat</li></ol>
wiwis alas	<i>noun</i><br><ol><li>wild goat</li></ol>
wiwāha	<i>noun</i><br><ol><li>marriage</li></ol>
wolu	<i>num</i><br><ol><li>eight</li></ol>
wruh	<i>verb</i><br><ol><li>to know</li></ol>
wuda	<i>adj</i><br><ol><li>naked</li></ol>
wuduk	<i>noun</i><br><ol><li>fat, grease</li></ol>
wukir	<i>noun</i><br><ol><li>mountain</li></ol>
wulan	<i>noun</i><br><ol><li>moon</li></ol>
wulu	<i>noun</i><br><ol><li>hair</li></ol>
wunga	<i>noun</i><br><ol><li>flower</li></ol>
wungkuk	<i>noun</i><br><ol><li>hump</li></ol>
wuni	<i>verb</i><br><ol><li>to hide</li></ol>
wur	<i>verb</i><br><ol><li>to fly</li></ol>
wuri	<i>noun</i><br><ol><li>back</li></ol>
wuta	<i>adj</i><br><ol><li>blind</li></ol>
wuyah	<i>noun</i><br><ol><li>salt</li></ol>
wwang	<i>noun</i><br><ol><li>man, person, human being</li></ol>
wwe	<i>noun</i><br><ol><li>water</li></ol>
wĕas	<i>noun</i><br><ol><li>husked rice</li></ol>
wĕdi	<i>noun</i><br><ol><li>fear</li></ol>
wĕhaṅ	<i>noun</i><br><ol><li>jaw</li></ol>
wĕkas	<i>noun</i><br><ol><li>trace (residue)</li></ol>
wĕnga|mĕnga	<i>verb</i><br><ol><li>to open</li></ol>
wĕngis	<i>adj</i><br><ol><li>furious</li></ol>
wĕtis	<i>noun</i><br><ol><li>calf (of leg)</li></ol>
wĕtĕng	<i>noun</i><br><ol><li>belly</li></ol>
wĕḍus	<i>noun</i><br><ol><li>sheep</li><li>goat</li></ol>
wĕṅi	<i>noun</i><br><ol><li>night</li></ol>
wők	<i>noun</i><br><ol><li>pig</li></ol>
wőr	<i>verb</i><br><ol><li>to fly</li></ol>
wṛhaspati	<i>noun</i><br><ol><li>Thursday</li></ol><br><i>name</i><br><ol><li>Jupiter</li><li>Brihaspati</li></ol>
yan	<i>conj</i><br><ol><li>if</li></ol>
yaya	<i>conj</i><br><ol><li>as if</li></ol>
ācāra	<i>noun</i><br><ol><li>conduct, behaviour</li><li>custom, practice</li><li>established rule.</li></ol>
ādi	<i>noun</i><br><ol><li>beginning, commencement</li><li>first, principal, chief</li><li>excellent, exquisite, fine, eminent</li></ol>
āgama	<i>noun</i><br><ol><li>religion (system of beliefs dealing with soul, deity and/or life after death)</li><li>collection of such doctrines</li><li>sacred work.</li></ol>
āśrama	<i>noun</i><br><ol><li>hermitage, abode of ascetics; stage in the life of a brahman.</li></ol>
ĕri	<i>noun</i><br><ol><li>thorn, prickle</li><li>sting</li></ol>
ĕṇḍog	<i>noun</i><br><ol><li>egg</li></ol>
śakti	<i>noun</i><br><ol><li>power,</li><li>strength</li></ol><br><i>adj</i><br><ol><li>powerful,</li><li>mighty</li></ol>
śarīra	<i>noun</i><br><ol><li>body</li></ol>
śatru	<i>noun</i><br><ol><li>enemy, foe</li><li>rival</li></ol>
śaśi|sasih	<i>noun</i><br><ol><li>moon</li></ol>
śiṣya	<i>noun</i><br><ol><li>student</li></ol>
śāla	<i>noun</i><br><ol><li>house, mansion</li><li>hall, large room</li><li>stable</li></ol>
śūnyagṛha	<i>noun</i><br><ol><li>empty house</li><li>solitary house</li></ol>
ḍaḍa	<i>noun</i><br><ol><li>chest</li></ol>
ḍaṅ	<i>noun</i><br><ol><li>copper pot in which the kukusan is placed for steaming rice</li></ol>
ꦄꦒ꧀ꦤꦶ|agni	<i>noun</i><br><ol><li>fire</li></ol>
ꦏꦕ|kaca	<i>noun</i><br><ol><li>glass</li></ol>
ꦒꦼꦝꦺ|gedhé	<i>noun</i><br><ol><li>bigness, largeness</li></ol>
ꦒꦼꦤꦶ|geni	<i>noun</i><br><ol><li>fire</li></ol>
ꦢꦫ|dara|darā	<i>noun</i><br><ol><li>dove</li><li>pigeon</li></ol>
ꦢꦭꦸ|dalu	<i>adj</i><br><ol><li>great</li></ol><br><i>noun</i><br><ol><li>night</li></ol>
ꦢꦶꦤ|ꦢꦶꦤ꧀ꦠꦼꦤ꧀|dina|dintĕn|dinten	<i>noun</i><br><ol><li>day</li><li>daylight</li></ol>
ꦧꦭ|bala	<i>noun</i><br><ol><li>strength, power</li><li>troops, army, soldiers of lesser rank</li></ol>
ꦨꦺꦢ|bhéda	<i>noun</i><br><ol><li>separation, division, partition</li></ol><br><i>adj</i><br><ol><li>different, wrong</li></ol>
ꦫꦺꦴꦠꦺꦴ|roto	<i>noun</i><br><ol><li>egg of ant</li></ol>
ꦭꦠꦸ|latu	<i>noun</i><br><ol><li>spark</li></ol>
ꦮꦤ|wana	<i>noun</i><br><ol><li>forest, wood</li></ol>
ꦮꦭꦶꦫꦁ|ꦮꦫꦶꦫꦁ|walirang|warirang	<i>noun</i><br><ol><li>sulfur</li></ol>
ꦮꦼꦔꦶ|wengi	<i>noun</i><br><ol><li>night</li></ol>
ꦮ꧀​ꦮꦃ|ꦮ꧀ꦮꦃ|wwah	<i>noun</i><br><ol><li>fruit</li></ol>
ꦲꦡꦮ|ațawa	<i>conj</i><br><ol><li>or</li></ol>
ꦲꦱꦸ|asu	<i>noun</i><br><ol><li>dog</li></ol>
