Adooleessa	<i>name</i><br><ol><li>July</li></ol>
Amajjii	<i>name</i><br><ol><li>January</li></ol>
Bitootessa	<i>name</i><br><ol><li>March</li></ol>
Caamsaa	<i>name</i><br><ol><li>April</li></ol>
Dilbata	<i>name</i><br><ol><li>Sunday</li></ol>
Ebla	<i>name</i><br><ol><li>May</li></ol>
Faasiikaa	<i>name</i><br><ol><li>Easter</li></ol>
Finfinnee	<i>name</i><br><ol><li>ancient name of Addis Ababa</li></ol>
Fulbaana	<i>name</i><br><ol><li>September</li></ol>
Guraandhala	<i>name</i><br><ol><li>February</li></ol>
Haggaya	<i>name</i><br><ol><li>August</li></ol>
Jimmata	<i>name</i><br><ol><li>Friday</li></ol>
Kamsa	<i>name</i><br><ol><li>Thursday</li></ol>
Kibxata	<i>name</i><br><ol><li>Tuesday</li></ol>
Kirooshiyaa	<i>name</i><br><ol><li>Croatia</li></ol>
Muddee	<i>name</i><br><ol><li>December</li></ol>
Onkoloolessa	<i>name</i><br><ol><li>October</li></ol>
Roobii	<i>name</i><br><ol><li>Wednesday</li></ol>
Sadaasa	<i>name</i><br><ol><li>November</li></ol>
Sanbata	<i>name</i><br><ol><li>Saturday</li></ol>
Waaqa	<i>name</i><br><ol><li>God, the single deity of various monotheistic religions, especially the deity of Wakeffata, Judaism, Christianity, and Islam</li></ol>
Waaqayyo	<i>noun</i><br><ol><li>God</li></ol>
Waaxabajjii	<i>name</i><br><ol><li>June</li></ol>
Wiixata	<i>name</i><br><ol><li>Monday</li></ol>
a|aa	<i>noun</i><br><ol><li>The first letter of the Oromo alphabet, written in the Latin script.</li></ol><br><i>character</i><br><ol><li>a the first letter of Kayan alphabet.</li></ol><br><i>pron</i><br><ol><li>used for he, she, third person.</li></ol>
a'aa	<i>noun</i><br><ol><li>moan, painful voice of sharp pain.</li><li>no..., don't</li><li>butter (dialect case)</li></ol>
a'ama	<i>noun</i><br><ol><li>jaw</li></ol>
aada	<i>noun</i><br><ol><li>moan, painful voice of sharp pain.</li></ol>
aadnaa	<i>noun</i><br><ol><li>moan, painful voice of sharp pain.</li></ol>
aaduu	<i>verb</i><br><ol><li>to moan, groan</li></ol>
aallaattii	<i>noun</i><br><ol><li>pelican</li></ol>
aanaa	<i>noun</i><br><ol><li>district</li></ol>
aangoo	<i>noun</i><br><ol><li>authority</li></ol>
aannan	<i>noun</i><br><ol><li>milk</li></ol>
aare	<i>verb</i><br><ol><li>angry</li></ol>
aarii	<i>noun</i><br><ol><li>anger</li></ol>
aaruu|nanaara|aaraartu|haa aartu|aarteetti|ni aartu|aari|aaraarti|haa aaru|aarte|ni aaru|aaraniiru|aaraa|ni aarta|aarteetta|aaraarta|Overview of Conjugation|aarneerra|ni aarti|aaraarra|aare|haa aarnu|aartan|aaraaru|ni aara|Verb Conjugation|ni aarna|aartaniittu|haa aaran|aaraan jira|PRONOUN|aaran|aarne|aareera|aaraara	<i>verb</i><br><ol><li>be smoke</li><li>be angry, annoy</li></ol>
abaaboo	<i>noun</i><br><ol><li>flower</li></ol>
abaaruu	<i>verb</i><br><ol><li>to curse</li></ol>
abbaa	<i>noun</i><br><ol><li>father</li></ol>
abboomamuu	<i>verb</i><br><ol><li>to obey</li></ol>
abboommachuu	<i>verb</i><br><ol><li>to control</li></ol>
abbummaa	<i>noun</i><br><ol><li>ownership</li></ol>
abbuudduu	<i>noun</i><br><ol><li>thumb</li></ol>
abdachuu	<i>verb</i><br><ol><li>to trust</li></ol>
abidda	<i>noun</i><br><ol><li>fire</li></ol>
abjuu	<i>noun</i><br><ol><li>dream</li></ol>
abuduroo	<i>noun</i><br><ol><li>ancestor</li></ol>
adaadaa	<i>noun</i><br><ol><li>aunt</li></ol>
adaala	<i>noun</i><br><ol><li>desert</li></ol>
adabuu	<i>verb</i><br><ol><li>to punish</li></ol>
adamsuu	<i>verb</i><br><ol><li>to hunt</li></ol>
adanyoo	<i>noun</i><br><ol><li>allergy</li></ol>
adda	<i>noun</i><br><ol><li>forehead</li></ol>
addunyaa	<i>noun</i><br><ol><li>world</li></ol>
adeemuu	<i>verb</i><br><ol><li>to walk</li></ol>
adii	<i>adj</i><br><ol><li>white</li></ol>
adurree	<i>noun</i><br><ol><li>cat</li></ol>
aduu	<i>noun</i><br><ol><li>the sun</li></ol>
afaa	<i>noun</i><br><ol><li>carpet, rug</li></ol>
afaan	<i>noun</i><br><ol><li>mouth</li><li>language</li></ol>
afachuu	<i>verb</i><br><ol><li>to wait</li></ol>
affeeluu	<i>verb</i><br><ol><li>to cook</li></ol>
affeeruu	<i>verb</i><br><ol><li>to invite</li></ol>
afoola	<i>noun</i><br><ol><li>folklore</li></ol>
afur	<i>num</i><br><ol><li>four</li></ol>
afurtama	<i>num</i><br><ol><li>forty</li></ol>
agarsiisuu	<i>verb</i><br><ol><li>to show, indicate</li></ol>
ajaagaarii	<i>noun</i><br><ol><li>tomato</li></ol>
ajaja	<i>noun</i><br><ol><li>command, order</li></ol>
akaafaa	<i>noun</i><br><ol><li>shovel</li></ol>
akaakayyuu	<i>noun</i><br><ol><li>grandfather</li></ol>
akankarreettii	<i>noun</i><br><ol><li>parasite</li></ol>
akkayyaa	<i>noun</i><br><ol><li>grandmother</li></ol>
akkeessuu	<i>verb</i><br><ol><li>to mimic</li></ol>
alaabaa	<i>noun</i><br><ol><li>flag, banner</li></ol>
alkoo	<i>noun</i><br><ol><li>old woman</li></ol>
amanaa	<i>noun</i><br><ol><li>believer</li></ol>
amanuu	<i>verb</i><br><ol><li>to believe</li></ol>
ammayyoomsuu	<i>verb</i><br><ol><li>to update</li></ol>
anaanaasii	<i>noun</i><br><ol><li>pineapple</li></ol>
anaaxii	<i>noun</i><br><ol><li>carpenter</li></ol>
anaaxummaa	<i>noun</i><br><ol><li>carpentry</li></ol>
annan	<i>noun</i><br><ol><li>milk</li></ol>
antuuta	<i>noun</i><br><ol><li>rat</li></ol>
araddee	<i>noun</i><br><ol><li>meadow</li></ol>
aramuu	<i>verb</i><br><ol><li>to weed</li></ol>
arbaa	<i>noun</i><br><ol><li>elephant</li></ol>
areeda	<i>noun</i><br><ol><li>beard</li><li>mustache</li></ol>
areeruu	<i>verb</i><br><ol><li>to pollute</li></ol>
arfaasaa	<i>noun</i><br><ol><li>spring, springtime</li></ol>
arfii	<i>noun</i><br><ol><li>alphabet</li></ol>
argaa	<i>noun</i><br><ol><li>gift, present</li></ol>
argachuu	<i>verb</i><br><ol><li>to find</li><li>to earn</li></ol>
ariifachuu	<i>verb</i><br><ol><li>to hurry</li></ol>
arraabuu	<i>verb</i><br><ol><li>to lick</li></ol>
arrabsoo	<i>noun</i><br><ol><li>insult</li></ol>
arrabsuu	<i>verb</i><br><ol><li>to insult</li></ol>
arrii	<i>noun</i><br><ol><li>silk</li></ol>
arroolee	<i>noun</i><br><ol><li>antelope</li></ol>
asoosama	<i>noun</i><br><ol><li>novel (work of fiction)</li></ol>
atara	<i>noun</i><br><ol><li>pea</li></ol>
awwaala	<i>noun</i><br><ol><li>burial</li></ol>
awwaara	<i>noun</i><br><ol><li>dust</li></ol>
awwagii	<i>noun</i><br><ol><li>package</li></ol>
aʼa|a'aawwan	<i>noun</i><br><ol><li>(Afaan Oromo) painful voice of sharp pain.</li></ol>
baacuu	<i>verb</i><br><ol><li>to carry</li></ol>
baadiyyaa	<i>noun</i><br><ol><li>countryside</li></ol>
baaduu	<i>noun</i><br><ol><li>cheese</li></ol>
baaldii	<i>noun</i><br><ol><li>bucket</li></ol>
baallee	<i>noun</i><br><ol><li>feather</li></ol>
baankii	<i>noun</i><br><ol><li>bank (financial institution)</li></ol>
baaqelaa	<i>noun</i><br><ol><li>bean</li></ol>
baargamoo	<i>noun</i><br><ol><li>eucalyptus</li></ol>
baasii	<i>noun</i><br><ol><li>expense</li></ol>
baatii	<i>noun</i><br><ol><li>month</li></ol>
baatuu	<i>verb</i><br><ol><li>to leave</li></ol>
baay'isuu	<i>verb</i><br><ol><li>to multiply</li></ol>
baccuu	<i>verb</i><br><ol><li>to joke, jest</li></ol>
bacoo	<i>noun</i><br><ol><li>bedbug</li></ol>
badaa	<i>adj</i><br><ol><li>bad</li></ol>
badaduu	<i>verb</i><br><ol><li>to try, attempt</li></ol>
baddaa	<i>noun</i><br><ol><li>highland</li></ol>
baduu	<i>verb</i><br><ol><li>to disappear, vanish</li></ol>
baha	<i>noun</i><br><ol><li>east</li></ol>
bahiisa aduu	<i>noun</i><br><ol><li>sunrise</li></ol>
bakakkaa	<i>noun</i><br><ol><li>thunder</li></ol>
bakka	<i>noun</i><br><ol><li>place, site, location</li></ol>
balaa	<i>noun</i><br><ol><li>accident</li></ol>
balaqqeessa	<i>noun</i><br><ol><li>lightning</li></ol>
balbala	<i>noun</i><br><ol><li>door, gate</li></ol>
balfaa	<i>noun</i><br><ol><li>garbage, trash, waste</li></ol>
banjaa	<i>noun</i><br><ol><li>blanket</li></ol>
bantuu	<i>noun</i><br><ol><li>key</li></ol>
banuu	<i>verb</i><br><ol><li>to open</li></ol>
baqachuu	<i>verb</i><br><ol><li>to flee, run away</li></ol>
baqqanaa	<i>noun</i><br><ol><li>island</li></ol>
baraaxuu	<i>verb</i><br><ol><li>to waste</li></ol>
barachuu	<i>verb</i><br><ol><li>to learn</li></ol>
barbaaduu	<i>verb</i><br><ol><li>to need</li></ol>
barreertuu	<i>noun</i><br><ol><li>password</li></ol>
barreessuu	<i>verb</i><br><ol><li>to write</li></ol>
barrisuu	<i>verb</i><br><ol><li>to fly</li></ol>
barsiisuu	<i>verb</i><br><ol><li>to teach</li></ol>
barumsa	<i>noun</i><br><ol><li>lesson</li></ol>
baruu	<i>verb</i><br><ol><li>to know</li></ol>
bashananuu	<i>verb</i><br><ol><li>to relax</li></ol>
beekuu	<i>verb</i><br><ol><li>to know</li></ol>
bidiruu	<i>noun</i><br><ol><li>canoe</li></ol>
biiftuu	<i>noun</i><br><ol><li>sun</li></ol>
biillaacha	<i>noun</i><br><ol><li>butterfly</li></ol>
biiraa	<i>noun</i><br><ol><li>beer</li></ol>
bikkooma	<i>noun</i><br><ol><li>measurement</li></ol>
bilbila	<i>noun</i><br><ol><li>small bell</li><li>telephone</li></ol>
bilisummaa	<i>noun</i><br><ol><li>freedom, liberty</li></ol>
birraa	<i>noun</i><br><ol><li>autumn, fall</li></ol>
birtukaanii	<i>noun</i><br><ol><li>orange (fruit)</li></ol>
bisaani	<i>noun</i><br><ol><li>(Borana, Orma, Waata) water</li></ol>
bishaan	<i>noun</i><br><ol><li>(Harar, Maca, Qottu) water</li></ol>
bituu	<i>verb</i><br><ol><li>to buy</li></ol>
biyyoo	<i>noun</i><br><ol><li>soil</li></ol>
biyyoomaa	<i>noun</i><br><ol><li>citizen</li></ol>
bo'oo	<i>noun</i><br><ol><li>ditch</li></ol>
boba'aa	<i>noun</i><br><ol><li>fuel</li></ol>
bobaa	<i>noun</i><br><ol><li>armpit</li></ol>
bofa	<i>noun</i><br><ol><li>snake, serpent</li></ol>
bokkaa	<i>noun</i><br><ol><li>rain</li></ol>
bona	<i>noun</i><br><ol><li>winter</li></ol>
boo'uu	<i>verb</i><br><ol><li>to weep. cry, shed tears</li></ol>
booharsuu	<i>verb</i><br><ol><li>to satisfy</li></ol>
bookee	<i>noun</i><br><ol><li>gnat</li></ol>
boolii	<i>noun</i><br><ol><li>toilet</li></ol>
boona	<i>noun</i><br><ol><li>pride</li></ol>
boongoo	<i>noun</i><br><ol><li>cave</li></ol>
boorsaa	<i>noun</i><br><ol><li>bag, sack</li></ol>
booyee	<i>noun</i><br><ol><li>pig</li></ol>
boqqolloo	<i>noun</i><br><ol><li>corn, maize</li></ol>
boraatii	<i>noun</i><br><ol><li>pillow</li></ol>
boronqii	<i>noun</i><br><ol><li>chalk</li></ol>
bosona	<i>noun</i><br><ol><li>forest</li></ol>
bu'uu	<i>verb</i><br><ol><li>to get off, dismount</li></ol>
bubbee	<i>noun</i><br><ol><li>wind</li></ol>
bulchaa	<i>noun</i><br><ol><li>governor</li></ol>
bulchuu	<i>verb</i><br><ol><li>to govern</li></ol>
bulguu	<i>noun</i><br><ol><li>monster</li></ol>
buluu	<i>verb</i><br><ol><li>to spend the night</li></ol>
buna	<i>noun</i><br><ol><li>coffee</li></ol>
buqqee mataa	<i>noun</i><br><ol><li>skull</li></ol>
buusaa	<i>noun</i><br><ol><li>knuckle</li></ol>
buusuu	<i>verb</i><br><ol><li>to lower, bring down</li></ol>
caabii	<i>noun</i><br><ol><li>plate</li></ol>
caasaa	<i>noun</i><br><ol><li>structure, framework</li></ol>
caasluga	<i>noun</i><br><ol><li>grammar</li></ol>
cabaqa	<i>noun</i><br><ol><li>dialect</li></ol>
cabbii	<i>noun</i><br><ol><li>ice</li></ol>
caffee	<i>noun</i><br><ol><li>swamp</li></ol>
calleensa	<i>noun</i><br><ol><li>silence</li></ol>
calleessuu	<i>verb</i><br><ol><li>to winnow</li></ol>
carraa	<i>noun</i><br><ol><li>fortune, luck</li></ol>
cidha	<i>noun</i><br><ol><li>wedding</li></ol>
cifaa	<i>noun</i><br><ol><li>ladle</li></ol>
ciibsuu	<i>verb</i><br><ol><li>to lay down an object</li></ol>
ciisuu	<i>verb</i><br><ol><li>to sleep</li></ol>
cimmiiguu	<i>verb</i><br><ol><li>to squeeze</li></ol>
ciniintuu	<i>noun</i><br><ol><li>pliers</li></ol>
ciniinuu	<i>verb</i><br><ol><li>to bite</li></ol>
cinqursuu	<i>verb</i><br><ol><li>to oppress</li></ol>
ciqilee	<i>noun</i><br><ol><li>elbow</li></ol>
cir'achaa	<i>noun</i><br><ol><li>sand</li></ol>
cittoo	<i>noun</i><br><ol><li>itch</li></ol>
cooma	<i>noun</i><br><ol><li>fat (bodily tissue)</li></ol>
cubbuu	<i>noun</i><br><ol><li>sin</li></ol>
cufuu	<i>verb</i><br><ol><li>to close, shut</li></ol>
cuunfaa	<i>noun</i><br><ol><li>juice</li></ol>
cuuphaa	<i>noun</i><br><ol><li>christening</li></ol>
da'oo	<i>noun</i><br><ol><li>shelter</li></ol>
da'uu	<i>verb</i><br><ol><li>to give birth</li></ol>
daa'ima	<i>noun</i><br><ol><li>baby, infant</li></ol>
daakiyyee|daakiyyeewwan|dákiýé	<i>noun</i><br><ol><li>duck</li><li>which swims in water</li><li>An aquatic bird of the family Anatidae, having a flat bill and webbed feet.</li></ol>
daakuu	<i>verb</i><br><ol><li>to swim</li></ol>
daalacha	<i>adj</i><br><ol><li>gray</li></ol>
daammii	<i>adj</i><br><ol><li>brown</li></ol>
daangaa	<i>noun</i><br><ol><li>boundary</li></ol>
daannoo	<i>noun</i><br><ol><li>fort</li></ol>
daaraa	<i>noun</i><br><ol><li>ashes</li></ol>
daaw'achuu	<i>verb</i><br><ol><li>to visit</li></ol>
daaw'ataa	<i>noun</i><br><ol><li>visitor</li></ol>
dabaluu	<i>verb</i><br><ol><li>to include</li></ol>
dafquu	<i>verb</i><br><ol><li>to sweat</li></ol>
dagachuu	<i>verb</i><br><ol><li>to forget</li><li>to neglect</li></ol>
dakiiyyee	<i>noun</i><br><ol><li>duck</li></ol>
dakuu	<i>verb</i><br><ol><li>to swim</li></ol>
daldala	<i>noun</i><br><ol><li>trade</li></ol>
daldaluu	<i>verb</i><br><ol><li>to trade</li></ol>
dalgeeta	<i>noun</i><br><ol><li>width</li></ol>
dallaa	<i>noun</i><br><ol><li>fence</li></ol>
damma	<i>noun</i><br><ol><li>honey</li></ol>
dammaqsuu	<i>verb</i><br><ol><li>to wake up (transitive)</li></ol>
dammaquu	<i>verb</i><br><ol><li>to wake up (intransitive)</li></ol>
danfisuu	<i>noun</i><br><ol><li>plantation</li></ol>
daraartuu|daraaraa	<i>adj</i><br><ol><li>something that flowers.</li></ol>
darbachuu	<i>verb</i><br><ol><li>to throw</li></ol>
deebi'uu	<i>verb</i><br><ol><li>to come back, return</li></ol>
deebisuu	<i>verb</i><br><ol><li>to give back an object, return</li></ol>
deemsa	<i>noun</i><br><ol><li>journey, trip</li></ol>
deemuu|deemaan jira|ni deemna|ni deemtu|deemte|deemaarta|deemi|deemtaniittu|deemaarra|haa deeman|ni deemta|deemne|Overview of Conjugation|deemaarti|deemaniiru|Verb Conjugation|deemaartu|haa deemtu|deemaaru|deemteetta|deemneerra|deemaara|PRONOUN|nandeema|deeme|deemaa|deemteetti|deeman|deemeera|haa deemnu|haa deemu|deemtan|ni deema|ni deemu|ni deemti	<i>verb</i><br><ol><li>to go</li></ol>
demdemoo	<i>noun</i><br><ol><li>ceiling</li></ol>
dha'uu	<i>verb</i><br><ol><li>to hit, strike</li></ol>
dhaaluu	<i>verb</i><br><ol><li>to inherit</li></ol>
dhadhaa	<i>noun</i><br><ol><li>butter</li></ol>
dhaga'uu	<i>verb</i><br><ol><li>to hear</li></ol>
dhagaa	<i>noun</i><br><ol><li>stone</li></ol>
dhaggeeffachuu	<i>verb</i><br><ol><li>to listen</li></ol>
dhandhama	<i>noun</i><br><ol><li>taste, flavor</li></ol>
dhangala'uu	<i>verb</i><br><ol><li>to pour</li></ol>
dheeduu	<i>verb</i><br><ol><li>to graze</li></ol>
dheeraa	<i>adj</i><br><ol><li>long</li></ol>
dheerina	<i>noun</i><br><ol><li>length</li></ol>
dhiba	<i>num</i><br><ol><li>hundred</li></ol>
dhibba	<i>num</i><br><ol><li>hundred</li></ol>
dhiheessuu	<i>verb</i><br><ol><li>to supply</li></ol>
dhiibuu	<i>verb</i><br><ol><li>to push</li></ol>
dhiiga	<i>noun</i><br><ol><li>blood</li></ol>
dhiiguu	<i>verb</i><br><ol><li>to bleed</li></ol>
dhiira	<i>noun</i><br><ol><li>man</li></ol>
dhiituu	<i>verb</i><br><ol><li>to kick</li></ol>
dhiphachuu	<i>verb</i><br><ol><li>to worry</li></ol>
dhiphina	<i>noun</i><br><ol><li>frustration</li></ol>
dhiphoo	<i>adj</i><br><ol><li>narrow, tight</li></ol>
dho'uu	<i>verb</i><br><ol><li>to explode</li></ol>
dhoqqee	<i>noun</i><br><ol><li>mud</li></ol>
dhorkaa	<i>adj</i><br><ol><li>forbidden</li></ol>
dhowwaa	<i>noun</i><br><ol><li>prohibition</li></ol>
dhugaa	<i>noun</i><br><ol><li>truth</li></ol>
dhugaatii	<i>noun</i><br><ol><li>a drink</li></ol>
dhuguu	<i>verb</i><br><ol><li>to drink</li></ol>
dhukkuba	<i>noun</i><br><ol><li>disease, illness</li></ol>
dhuma	<i>noun</i><br><ol><li>end</li></ol>
dhungachuu	<i>verb</i><br><ol><li>to kiss</li></ol>
dhungoo	<i>noun</i><br><ol><li>a kiss</li></ol>
dhuufuu	<i>noun</i><br><ol><li>fart</li></ol>
dibaabee	<i>noun</i><br><ol><li>umbrella</li></ol>
dibbee	<i>noun</i><br><ol><li>drum</li></ol>
diduu	<i>verb</i><br><ol><li>to disobey</li><li>to refuse</li></ol>
digdama	<i>num</i><br><ol><li>twenty</li></ol>
diimaa	<i>adj</i><br><ol><li>red</li></ol>
diina	<i>noun</i><br><ol><li>enemy</li></ol>
dimbilaala	<i>noun</i><br><ol><li>coriander</li></ol>
dindaa	<i>noun</i><br><ol><li>beet</li></ol>
dinnicha	<i>noun</i><br><ol><li>potato</li></ol>
dinqisiisuu	<i>verb</i><br><ol><li>to surprise</li></ol>
dirree	<i>noun</i><br><ol><li>field</li></ol>
dogoggora	<i>noun</i><br><ol><li>error, fault</li></ol>
doolaarii	<i>noun</i><br><ol><li>dollar</li></ol>
doonii	<i>noun</i><br><ol><li>ship</li></ol>
doorsisa	<i>noun</i><br><ol><li>threat</li></ol>
du'a	<i>noun</i><br><ol><li>death</li></ol>
du'aa	<i>adj</i><br><ol><li>dead, deceased</li></ol>
du'uu	<i>verb</i><br><ol><li>to die</li></ol>
dubara	<i>noun</i><br><ol><li>girl</li></ol>
dubarti	<i>noun</i><br><ol><li>woman</li></ol>
dubbachiftu	<i>noun</i><br><ol><li>(phonetics) vowel</li></ol>
dubbifamaa	<i>noun</i><br><ol><li>consonant</li></ol>
dubbisuu	<i>verb</i><br><ol><li>to greet</li></ol>
dugaadhaan	<i>noun</i><br><ol><li>sincerity</li></ol>
dukkana	<i>noun</i><br><ol><li>darkness</li></ol>
dulaaba	<i>noun</i><br><ol><li>shelf</li></ol>
dullaa	<i>noun</i><br><ol><li>abscess</li></ol>
dulloo	<i>noun</i><br><ol><li>bottle</li></ol>
dulloomuu	<i>verb</i><br><ol><li>to age, grow old</li></ol>
durbii	<i>noun</i><br><ol><li>cousin</li></ol>
duudaa	<i>adj</i><br><ol><li>deaf</li></ol>
duumessa	<i>noun</i><br><ol><li>cloud</li></ol>
duwwaa	<i>adj</i><br><ol><li>empty</li></ol>
eebba	<i>noun</i><br><ol><li>blessing</li></ol>
eeboo	<i>noun</i><br><ol><li>spear</li></ol>
eegaluu	<i>verb</i><br><ol><li>to start, begin</li></ol>
eegee	<i>noun</i><br><ol><li>tail</li></ol>
eeguu	<i>verb</i><br><ol><li>to guard, protect</li></ol>
eela	<i>noun</i><br><ol><li>pond, pool</li></ol>
eeruu	<i>verb</i><br><ol><li>to nominate</li></ol>
eessuma	<i>noun</i><br><ol><li>uncle (maternal)</li></ol>
ekeraa	<i>noun</i><br><ol><li>ghost</li></ol>
elmuu	<i>verb</i><br><ol><li>to milk</li></ol>
ergaa	<i>noun</i><br><ol><li>message</li></ol>
erguu	<i>verb</i><br><ol><li>to send</li></ol>
faalama	<i>noun</i><br><ol><li>pollution</li></ol>
faana	<i>noun</i><br><ol><li>footprint</li></ol>
faanchoo	<i>noun</i><br><ol><li>forgiveness</li></ol>
faaqqee	<i>noun</i><br><ol><li>comb</li></ol>
facaasuu	<i>verb</i><br><ol><li>to sow seeds</li><li>to scatter</li></ol>
fagaara	<i>noun</i><br><ol><li>buttocks</li></ol>
fakkaachuu	<i>verb</i><br><ol><li>to seem</li></ol>
fakkeenya	<i>noun</i><br><ol><li>example</li></ol>
fakkeessuu	<i>verb</i><br><ol><li>to pretend</li></ol>
fallaana	<i>noun</i><br><ol><li>spoon</li></ol>
falmii	<i>noun</i><br><ol><li>argument</li></ol>
falquu	<i>verb</i><br><ol><li>to hate</li></ol>
farda|fardeen	<i>noun</i><br><ol><li>horse</li></ol>
fardeen	<i>noun</i><br><ol><li>horses, plural of farda.</li></ol>
fattee	<i>noun</i><br><ol><li>frog</li></ol>
fayyadamuu	<i>verb</i><br><ol><li>to use</li></ol>
fayyisuu	<i>verb</i><br><ol><li>to cure</li></ol>
fedhuu	<i>verb</i><br><ol><li>to want, desire, wish</li></ol>
fiduu	<i>verb</i><br><ol><li>to bring</li></ol>
fiiguu	<i>verb</i><br><ol><li>to run</li></ol>
filannoo	<i>noun</i><br><ol><li>election</li></ol>
filuu	<i>verb</i><br><ol><li>to choose</li><li>to vote</li></ol>
fincaa'aa	<i>noun</i><br><ol><li>waterfall</li></ol>
fincaan	<i>noun</i><br><ol><li>urine</li></ol>
fincila	<i>noun</i><br><ol><li>rebellion</li></ol>
firaashii	<i>noun</i><br><ol><li>mattress</li></ol>
fireenii	<i>noun</i><br><ol><li>brake</li></ol>
fixeensa	<i>noun</i><br><ol><li>dew</li></ol>
fixuu	<i>verb</i><br><ol><li>to finish</li></ol>
fo'aa	<i>noun</i><br><ol><li>wick (of a candle or lamp)</li></ol>
foddaa	<i>noun</i><br><ol><li>window</li></ol>
foksoo	<i>noun</i><br><ol><li>mop</li></ol>
fonqolchuu	<i>verb</i><br><ol><li>to uproot</li></ol>
foolii	<i>noun</i><br><ol><li>smell, scent, odor</li></ol>
foon	<i>noun</i><br><ol><li>meat</li></ol>
fooxaa	<i>noun</i><br><ol><li>towel</li></ol>
fooyyessuu	<i>verb</i><br><ol><li>to improve, modify</li></ol>
fuduraa	<i>noun</i><br><ol><li>fruit</li></ol>
fullee	<i>noun</i><br><ol><li>glass (material)</li></ol>
funyaan	<i>noun</i><br><ol><li>nose</li></ol>
funyoo	<i>noun</i><br><ol><li>rope</li></ol>
furdaa	<i>adj</i><br><ol><li>thick</li></ol>
furmaata	<i>noun</i><br><ol><li>solution</li></ol>
furnoo	<i>noun</i><br><ol><li>oven</li></ol>
futee	<i>noun</i><br><ol><li>anus, rectum</li></ol>
fuula	<i>noun</i><br><ol><li>face</li></ol>
fuulduratti	<i>noun</i><br><ol><li>future</li></ol>
ga'uu	<i>verb</i><br><ol><li>to suffice, be enough</li></ol>
gaa'ela	<i>noun</i><br><ol><li>marriage</li></ol>
gaaddisa	<i>noun</i><br><ol><li>shadow</li></ol>
gaafachuu	<i>verb</i><br><ol><li>to ask, inquire</li></ol>
gaafannoo	<i>noun</i><br><ol><li>interview</li></ol>
gaaffii	<i>noun</i><br><ol><li>question</li></ol>
gaala	<i>noun</i><br><ol><li>camel</li></ol>
gaangee	<i>noun</i><br><ol><li>mules</li></ol>
gaazexaa	<i>noun</i><br><ol><li>newspaper</li></ol>
gabaa	<i>noun</i><br><ol><li>market</li></ol>
gabaabaa	<i>adj</i><br><ol><li>short</li></ol>
gadda	<i>noun</i><br><ol><li>sorrow</li></ol>
gaddisiisuu	<i>verb</i><br><ol><li>to disappoint</li></ol>
gadduu	<i>verb</i><br><ol><li>to grieve</li></ol>
gafaarsa	<i>noun</i><br><ol><li>buffalo</li></ol>
gajaraa	<i>noun</i><br><ol><li>machete</li></ol>
galata	<i>noun</i><br><ol><li>praise</li><li>thanks</li></ol>
galma	<i>noun</i><br><ol><li>hall</li></ol>
galmee jechootaa	<i>noun</i><br><ol><li>dictionary</li></ol>
galuu	<i>verb</i><br><ol><li>to enter</li></ol>
gammachuu	<i>noun</i><br><ol><li>joy</li></ol>
gamoo	<i>noun</i><br><ol><li>building</li></ol>
ganama	<i>noun</i><br><ol><li>morning</li></ol>
ganda	<i>noun</i><br><ol><li>village</li></ol>
ganna	<i>noun</i><br><ol><li>summer</li></ol>
garaa kaasa	<i>noun</i><br><ol><li>diarrhoea</li></ol>
garaacha	<i>noun</i><br><ol><li>stomach</li></ol>
garba	<i>noun</i><br><ol><li>sea</li></ol>
garbummaa	<i>noun</i><br><ol><li>slavery</li></ol>
garbuu	<i>noun</i><br><ol><li>barley</li></ol>
gargaarsa	<i>noun</i><br><ol><li>help, assistance</li></ol>
gargaaruu	<i>verb</i><br><ol><li>to help, aid</li></ol>
gartuu	<i>noun</i><br><ol><li>team</li></ol>
gasharee	<i>noun</i><br><ol><li>orphan</li></ol>
gatii falmuu	<i>verb</i><br><ol><li>to haggle</li></ol>
gatiittii	<i>noun</i><br><ol><li>shoulder</li></ol>
geeddaruu	<i>verb</i><br><ol><li>to exchange</li></ol>
geengoo	<i>noun</i><br><ol><li>circle</li></ol>
geggeessaa	<i>noun</i><br><ol><li>leader</li></ol>
geggeessuu	<i>verb</i><br><ol><li>to lead</li></ol>
giiftii	<i>noun</i><br><ol><li>lady</li></ol>
gingilchuu	<i>verb</i><br><ol><li>to sift</li></ol>
gochima	<i>noun</i><br><ol><li>verb</li></ol>
godaannisa	<i>noun</i><br><ol><li>bruise</li></ol>
godaansa	<i>noun</i><br><ol><li>migration</li></ol>
godaanuu	<i>verb</i><br><ol><li>to immigrate</li></ol>
gogaa	<i>noun</i><br><ol><li>skin</li></ol>
golloo	<i>noun</i><br><ol><li>(Afan Oromo) aardwolf</li></ol>
gommaa	<i>noun</i><br><ol><li>tire (for a wheel)</li></ol>
googa	<i>noun</i><br><ol><li>skin</li></ol>
goota	<i>adj</i><br><ol><li>brave</li></ol>
goraa	<i>noun</i><br><ol><li>berry</li></ol>
gorduba	<i>noun</i><br><ol><li>living room</li></ol>
gorra'uu	<i>verb</i><br><ol><li>to slaughter</li></ol>
gosa	<i>noun</i><br><ol><li>type, kind</li><li>tribe</li></ol>
gowoomsuu	<i>verb</i><br><ol><li>to deceive, cheat, trick</li></ol>
gowwaa	<i>noun</i><br><ol><li>idiot</li></ol>
gubaa	<i>noun</i><br><ol><li>fever</li></ol>
guddachuu	<i>verb</i><br><ol><li>to grow up, become an adult</li></ol>
guddisuu	<i>verb</i><br><ol><li>to magnify, increase</li></ol>
gufachiisuu	<i>verb</i><br><ol><li>to impede, hamper, hinder</li></ol>
gufachuu	<i>verb</i><br><ol><li>to stumble</li></ol>
gufufuu	<i>verb</i><br><ol><li>to mourn</li></ol>
gumna	<i>noun</i><br><ol><li>prostitute, whore</li></ol>
gunaa	<i>noun</i><br><ol><li>bribe</li></ol>
gurguruu	<i>verb</i><br><ol><li>to sell</li></ol>
gurmeessuu	<i>verb</i><br><ol><li>to organize</li></ol>
gurra	<i>noun</i><br><ol><li>ear</li></ol>
gurraacha	<i>adj</i><br><ol><li>black</li></ol>
guru'uu	<i>verb</i><br><ol><li>to growl</li></ol>
guuchii	<i>noun</i><br><ol><li>ostrich</li></ol>
guutuu	<i>verb</i><br><ol><li>to fill</li></ol>
haadha	<i>noun</i><br><ol><li>mother</li></ol>
haaduu	<i>noun</i><br><ol><li>knife</li><li>razor</li></ol><br><i>verb</i><br><ol><li>to shave</li></ol>
haamtuu	<i>noun</i><br><ol><li>sickle</li></ol>
haara	<i>noun</i><br><ol><li>smoke (of fire)</li></ol>
haaraa	<i>adj</i><br><ol><li>new</li></ol>
haasa'uu	<i>verb</i><br><ol><li>to chat</li></ol>
haasaa	<i>noun</i><br><ol><li>conversation</li></ol>
hafuu	<i>verb</i><br><ol><li>to remain, stay</li></ol>
hafuura	<i>noun</i><br><ol><li>breath</li></ol>
hakiimii	<i>noun</i><br><ol><li>physician, medical doctor</li></ol>
hakiimii ilkaanii	<i>noun</i><br><ol><li>dentist</li></ol>
halkan	<i>noun</i><br><ol><li>night</li></ol>
halluu	<i>noun</i><br><ol><li>color</li><li>paint</li></ol>
hambisuu	<i>verb</i><br><ol><li>to save, keep</li></ol>
hamfala	<i>noun</i><br><ol><li>skirt</li></ol>
hammachuu	<i>verb</i><br><ol><li>to hug</li></ol>
hammamaa	<i>noun</i><br><ol><li>size</li></ol>
hammeenya	<i>noun</i><br><ol><li>cruelty</li></ol>
hanqaaquu	<i>noun</i><br><ol><li>egg</li></ol>
haphee	<i>noun</i><br><ol><li>glue</li></ol>
hara	<i>noun</i><br><ol><li>lake</li></ol>
harataa	<i>noun</i><br><ol><li>broom (domestic utensil)</li></ol>
harka	<i>noun</i><br><ol><li>hand</li></ol>
harkisuu	<i>verb</i><br><ol><li>to pull, drag</li></ol>
haroo	<i>noun</i><br><ol><li>lake</li></ol>
harreddiidoo	<i>noun</i><br><ol><li>zebra</li></ol>
harree	<i>noun</i><br><ol><li>donkey</li></ol>
harruu	<i>noun</i><br><ol><li>palm (of the hand)</li></ol>
haruu	<i>verb</i><br><ol><li>to clean</li></ol>
hattuu	<i>noun</i><br><ol><li>thief</li></ol>
hatuu	<i>verb</i><br><ol><li>to steal</li></ol>
haxaa'uu	<i>verb</i><br><ol><li>to wipe, rub clean</li></ol>
heduu	<i>verb</i><br><ol><li>to guess</li></ol>
hidduu	<i>verb</i><br><ol><li>to sting</li></ol>
hidhaa	<i>noun</i><br><ol><li>imprisonment</li></ol>
hidhii	<i>noun</i><br><ol><li>lip</li></ol>
hidhuu	<i>verb</i><br><ol><li>to tie, bind</li><li>to imprison</li></ol>
hiikuu	<i>verb</i><br><ol><li>to untie</li><li>to translate</li></ol>
hinaaffii	<i>noun</i><br><ol><li>envy</li><li>jealousy</li></ol>
hirqinfuu	<i>noun</i><br><ol><li>hiccup</li></ol>
hiyyummaa	<i>noun</i><br><ol><li>poverty</li></ol>
hodhuu	<i>verb</i><br><ol><li>to sew</li></ol>
hojii	<i>noun</i><br><ol><li>job</li></ol>
hojjaa	<i>noun</i><br><ol><li>height</li></ol>
hojjechuu	<i>verb</i><br><ol><li>to work, labor</li></ol>
honnee	<i>noun</i><br><ol><li>heart</li></ol>
hookaa	<i>noun</i><br><ol><li>hay</li></ol>
hoolaa	<i>noun</i><br><ol><li>sheep</li></ol>
hooqqisiisuu	<i>verb</i><br><ol><li>to vomit</li></ol>
hordofuu	<i>verb</i><br><ol><li>to follow</li></ol>
horgoggee	<i>noun</i><br><ol><li>doll</li></ol>
horii	<i>noun</i><br><ol><li>cattle</li></ol>
hoteela	<i>noun</i><br><ol><li>hotel</li></ol>
hoxxee	<i>noun</i><br><ol><li>hut</li></ol>
hubachuu	<i>verb</i><br><ol><li>to understand</li></ol>
hubannaa	<i>noun</i><br><ol><li>understanding</li><li>awareness</li></ol>
hubuu	<i>verb</i><br><ol><li>to harm, injure</li></ol>
huffee	<i>noun</i><br><ol><li>desert</li></ol>
humna	<i>noun</i><br><ol><li>energy</li></ol>
humnaa	<i>noun</i><br><ol><li>power, force</li></ol>
hundee	<i>noun</i><br><ol><li>root</li></ol>
hundeessuu	<i>verb</i><br><ol><li>to establish, found</li></ol>
hurka	<i>noun</i><br><ol><li>steam</li></ol>
hurreessuu	<i>verb</i><br><ol><li>to shatter, smash, crush</li></ol>
hurrii	<i>noun</i><br><ol><li>fog</li></ol>
huura	<i>noun</i><br><ol><li>weed</li></ol>
huuroo	<i>noun</i><br><ol><li>jar</li></ol>
huusoo	<i>noun</i><br><ol><li>excrement</li></ol>
ibidda	<i>noun</i><br><ol><li>fire</li></ol>
ibsa	<i>noun</i><br><ol><li>description</li></ol>
ibsuu	<i>verb</i><br><ol><li>to describe</li></ol>
iccitii	<i>noun</i><br><ol><li>secret</li></ol>
ida'ama	<i>noun</i><br><ol><li>sum</li></ol>
ija	<i>noun</i><br><ol><li>eye</li></ol>
ijaarsa	<i>noun</i><br><ol><li>construction</li></ol>
ijaaruu	<i>verb</i><br><ol><li>to build</li></ol>
ilaaluu	<i>verb</i><br><ol><li>to see</li></ol>
ilkaan	<i>noun</i><br><ol><li>tooth</li></ol>
ilma	<i>noun</i><br><ol><li>son</li></ol>
ilmoo	<i>noun</i><br><ol><li>offspring</li></ol>
imalla	<i>noun</i><br><ol><li>passenger</li><li>traveler</li></ol>
immimamaan	<i>noun</i><br><ol><li>tear (eye)</li></ol>
intala	<i>noun</i><br><ol><li>daughter</li></ol>
ippistimooloojii	<i>noun</i><br><ol><li>epistemology</li></ol>
irbaata	<i>noun</i><br><ol><li>supper</li></ol>
irree	<i>noun</i><br><ol><li>arm</li></ol>
itittuu	<i>noun</i><br><ol><li>yogurt</li></ol>
ittisuu	<i>verb</i><br><ol><li>to prevent, prohibit</li></ol>
ittoo	<i>noun</i><br><ol><li>sauce</li></ol>
iyyata	<i>noun</i><br><ol><li>complaint</li></ol>
iyyuu	<i>verb</i><br><ol><li>to scream</li></ol>
ja'a	<i>num</i><br><ol><li>six</li></ol>
jaabi	<i>noun</i><br><ol><li>calf (young animal)</li></ol>
jaalachuu	<i>verb</i><br><ol><li>to love, like</li></ol>
jaamaa	<i>adj</i><br><ol><li>blind</li></ol>
jaannama	<i>noun</i><br><ol><li>hell</li></ol>
jaarraa	<i>noun</i><br><ol><li>century</li></ol>
jaatama	<i>num</i><br><ol><li>sixty</li></ol>
jabaa	<i>adj</i><br><ol><li>strong</li></ol>
jabina	<i>noun</i><br><ol><li>strength</li></ol>
jalaanii	<i>noun</i><br><ol><li>underwear</li></ol>
jalaatii	<i>noun</i><br><ol><li>ice cream</li></ol>
jaldeesii	<i>noun</i><br><ol><li>baboon</li></ol>
jalqabuu	<i>verb</i><br><ol><li>to begin, start</li></ol>
jecha	<i>noun</i><br><ol><li>word</li></ol>
jedhuu	<i>verb</i><br><ol><li>to say</li></ol>
jeedala|jeedalawwan	<i>noun</i><br><ol><li>jackal, fox</li></ol>
jeequmsa	<i>noun</i><br><ol><li>violence</li></ol>
ji'a	<i>noun</i><br><ol><li>moon</li></ol>
jibba	<i>noun</i><br><ol><li>hate, hatred</li></ol>
jibbuu	<i>verb</i><br><ol><li>to dislike</li></ol>
jiisuu	<i>verb</i><br><ol><li>to wet</li></ol>
jija	<i>noun</i><br><ol><li>happiness</li></ol>
jila	<i>noun</i><br><ol><li>festival</li></ol>
jilba	<i>noun</i><br><ol><li>knee</li></ol>
jiraachuu	<i>verb</i><br><ol><li>to live</li></ol>
jiruu	<i>noun</i><br><ol><li>life</li></ol>
ka'uu	<i>verb</i><br><ol><li>to get up</li><li>to rise</li></ol>
kaa'uu	<i>verb</i><br><ol><li>to put, place</li><li>to store</li></ol>
kaacha	<i>noun</i><br><ol><li>sexual intercourse, copulation</li></ol>
kaadhimaa	<i>noun</i><br><ol><li>fiancee</li></ol>
kaanniissa	<i>noun</i><br><ol><li>bee</li></ol>
kaarooti	<i>noun</i><br><ol><li>carrot</li></ol>
kaasuu	<i>verb</i><br><ol><li>to lift up, raise</li></ol>
kaawuyyaa	<i>noun</i><br><ol><li>iron (for pressing clothes)</li></ol>
kadhata	<i>noun</i><br><ol><li>prayer</li></ol>
kaffaluu	<i>verb</i><br><ol><li>to pay</li></ol>
kakaasuu	<i>verb</i><br><ol><li>to inspire, motivate</li></ol>
kalaa	<i>noun</i><br><ol><li>eyeglasses, spectacles</li></ol>
kalee	<i>noun</i><br><ol><li>kidney</li></ol>
kantiibaa	<i>noun</i><br><ol><li>mayor</li></ol>
karaa	<i>noun</i><br><ol><li>road</li></ol>
karabaatii	<i>noun</i><br><ol><li>necktie</li></ol>
karkaarro	<i>noun</i><br><ol><li>rhinoceros</li></ol>
karoora	<i>noun</i><br><ol><li>plan</li></ol>
kasala	<i>noun</i><br><ol><li>charcoal</li></ol>
kassabuu	<i>verb</i><br><ol><li>to harvest</li></ol>
katabuu	<i>verb</i><br><ol><li>to write</li></ol>
keessummaa	<i>noun</i><br><ol><li>guest</li></ol>
kelloo	<i>adj</i><br><ol><li>yellow</li></ol>
kennaa	<i>noun</i><br><ol><li>talent</li></ol>
kennuu	<i>verb</i><br><ol><li>to give</li></ol>
kibba	<i>noun</i><br><ol><li>south</li></ol>
kiisi	<i>noun</i><br><ol><li>pocket</li></ol>
kiisii	<i>noun</i><br><ol><li>pocket</li></ol>
kijibuu	<i>verb</i><br><ol><li>to lie, fib, tell an untruth</li></ol>
kinniinii	<i>noun</i><br><ol><li>pill</li></ol>
kireessuu	<i>verb</i><br><ol><li>to rent</li></ol>
kirkira lafaa	<i>noun</i><br><ol><li>earthquake</li></ol>
kitila	<i>num</i><br><ol><li>million</li></ol>
kobbee	<i>noun</i><br><ol><li>pen</li></ol>
kokkee	<i>noun</i><br><ol><li>throat</li></ol>
kolbaa	<i>noun</i><br><ol><li>button</li></ol>
kolfa	<i>noun</i><br><ol><li>laughter</li></ol>
kolfuu	<i>verb</i><br><ol><li>to laugh</li></ol>
komachuu	<i>verb</i><br><ol><li>to blame</li></ol>
kookii	<i>noun</i><br><ol><li>peach</li><li>apricot</li></ol>
koomee	<i>noun</i><br><ol><li>ankle</li></ol>
koonkoolata	<i>noun</i><br><ol><li>vehicle</li></ol>
kooraa	<i>noun</i><br><ol><li>saddle</li></ol>
kophee	<i>noun</i><br><ol><li>shoe</li></ol>
korata	<i>noun</i><br><ol><li>gravel</li></ol>
kormaa	<i>noun</i><br><ol><li>rooster</li></ol>
koro'oo	<i>noun</i><br><ol><li>purse</li></ol>
korojoo	<i>noun</i><br><ol><li>wallet</li></ol>
korophiissa	<i>noun</i><br><ol><li>grasshopper</li></ol>
kosii	<i>noun</i><br><ol><li>compost</li></ol>
kudhan	<i>num</i><br><ol><li>ten.</li></ol>
kufuu	<i>verb</i><br><ol><li>to fail</li></ol>
kuma	<i>num</i><br><ol><li>thousand</li></ol>
kuphaa	<i>noun</i><br><ol><li>ball</li></ol>
kuphaa kaachoo	<i>noun</i><br><ol><li>basketball</li></ol>
kuufama	<i>noun</i><br><ol><li>collection</li></ol>
kuusaa	<i>noun</i><br><ol><li>storeroom</li></ol>
kuuta	<i>noun</i><br><ol><li>room, chamber</li></ol>
laakkaa	<i>noun</i><br><ol><li>bracelet</li></ol>
laaqana	<i>noun</i><br><ol><li>lunch</li></ol>
lafee	<i>noun</i><br><ol><li>bone</li></ol>
laga	<i>noun</i><br><ol><li>river</li></ol>
lakkaa'uu	<i>verb</i><br><ol><li>to count</li></ol>
lakkuu	<i>noun</i><br><ol><li>twin</li></ol>
lallabuu	<i>verb</i><br><ol><li>to preach</li></ol>
lama	<i>num</i><br><ol><li>two</li></ol>
leemmana	<i>noun</i><br><ol><li>bamboo</li></ol>
liifaa	<i>noun</i><br><ol><li>sponge</li></ol>
lilimmoo	<i>noun</i><br><ol><li>needle</li></ol>
lillixa	<i>noun</i><br><ol><li>bat (flying mammal)</li></ol>
liqimsu	<i>verb</i><br><ol><li>to swallow</li></ol>
liqimsuu	<i>verb</i><br><ol><li>to ingest</li></ol>
lixa	<i>noun</i><br><ol><li>west</li></ol>
locaa	<i>noun</i><br><ol><li>nausea</li></ol>
loluu	<i>verb</i><br><ol><li>to fight</li></ol>
loomii	<i>noun</i><br><ol><li>lemon</li><li>lime</li></ol>
loon	<i>noun</i><br><ol><li>cattle</li></ol>
lootii	<i>noun</i><br><ol><li>earring</li></ol>
lubbuu	<i>noun</i><br><ol><li>soul, spirit</li></ol>
luka	<i>noun</i><br><ol><li>leg</li></ol>
lukkuu	<i>noun</i><br><ol><li>hen</li></ol>
maamila	<i>noun</i><br><ol><li>customer</li></ol>
maandisa	<i>noun</i><br><ol><li>engineer</li></ol>
maandisummaa	<i>noun</i><br><ol><li>engineering</li></ol>
maangoo	<i>noun</i><br><ol><li>mango</li></ol>
maappii	<i>noun</i><br><ol><li>map</li></ol>
maarashaa	<i>noun</i><br><ol><li>plow</li></ol>
maashaalee	<i>noun</i><br><ol><li>muscle</li></ol>
maashinii	<i>noun</i><br><ol><li>machine</li></ol>
maastiikaa	<i>noun</i><br><ol><li>chewing gum</li></ol>
maatii	<i>noun</i><br><ol><li>family</li></ol>
machaa'aa	<i>noun</i><br><ol><li>drunk, intoxicated</li></ol>
machooftuu	<i>noun</i><br><ol><li>drunk, intoxicated</li></ol>
madaa	<i>noun</i><br><ol><li>wound, injury</li></ol>
maddii	<i>noun</i><br><ol><li>cheek</li></ol>
maddisaa	<i>noun</i><br><ol><li>generator (of electricity)</li></ol>
magaala	<i>adj</i><br><ol><li>blackish brown</li></ol>
magaalaa	<i>noun</i><br><ol><li>city, town</li></ol>
magarisa	<i>adj</i><br><ol><li>green</li></ol>
makara	<i>noun</i><br><ol><li>harvest</li></ol>
maktafa	<i>noun</i><br><ol><li>cutting board</li></ol>
malaa	<i>noun</i><br><ol><li>pus</li></ol>
mallattoo	<i>noun</i><br><ol><li>signature</li></ol>
mammaaksa	<i>noun</i><br><ol><li>proverb, saying</li></ol>
mana	<i>noun</i><br><ol><li>house</li></ol>
mana barumsaa	<i>noun</i><br><ol><li>school</li></ol>
mana hakiimii	<i>noun</i><br><ol><li>clinic</li></ol>
mana hidhaa	<i>noun</i><br><ol><li>prison</li></ol>
mana nyaataa	<i>noun</i><br><ol><li>restaurant</li></ol>
mana poostaa	<i>noun</i><br><ol><li>post office</li></ol>
mana qorichaa	<i>noun</i><br><ol><li>pharmacy</li></ol>
mana sagaaggaltuu	<i>noun</i><br><ol><li>brothel, bordello, whorehouse</li></ol>
mandhee	<i>noun</i><br><ol><li>nest</li></ol>
manduubee	<i>noun</i><br><ol><li>garden</li></ol>
manfullee	<i>noun</i><br><ol><li>greenhouse</li></ol>
maqaa	<i>noun</i><br><ol><li>name</li><li>noun</li></ol>
maqadhaal	<i>noun</i><br><ol><li>pronoun</li></ol>
maqxuu	<i>noun</i><br><ol><li>scissors</li></ol>
mar'ummaan	<i>noun</i><br><ol><li>intestine, gut</li></ol>
maraataa	<i>adj</i><br><ol><li>crazy, insane</li></ol>
marayoo	<i>noun</i><br><ol><li>net</li></ol>
marga	<i>noun</i><br><ol><li>grass</li></ol>
marsuu	<i>verb</i><br><ol><li>to surround</li></ol>
masgiida	<i>noun</i><br><ol><li>mosque</li></ol>
mataa	<i>noun</i><br><ol><li>head</li></ol>
mataa bowwuu	<i>noun</i><br><ol><li>headache</li></ol>
maxaaxisha	<i>noun</i><br><ol><li>sweet potato</li></ol>
maxabashaa	<i>noun</i><br><ol><li>frying pan</li></ol>
maxinoo	<i>noun</i><br><ol><li>pancake</li></ol>
maxxansuu	<i>verb</i><br><ol><li>to print</li></ol>
meejoo	<i>noun</i><br><ol><li>sugarcane</li></ol>
meeqa	<i>adv</i><br><ol><li>how many?</li></ol>
meeshaa	<i>noun</i><br><ol><li>instrument</li></ol>
meexxii	<i>noun</i><br><ol><li>palm tree</li></ol>
mi'aa	<i>noun</i><br><ol><li>sweet</li></ol>
mi'aawaa	<i>adj</i><br><ol><li>sweet</li><li>delicious</li></ol>
mi'eessaa	<i>noun</i><br><ol><li>juniper</li></ol>
mi'eessuu	<i>verb</i><br><ol><li>to sweeten</li></ol>
michuu	<i>noun</i><br><ol><li>friend</li></ol>
midhaan	<i>noun</i><br><ol><li>grain</li></ol>
miiccuu	<i>verb</i><br><ol><li>to launder, wash clothes</li></ol>
miilla	<i>noun</i><br><ol><li>foot</li></ol>
miira	<i>noun</i><br><ol><li>emotion</li></ol>
miliquu	<i>verb</i><br><ol><li>to escape</li></ol>
milkaa'uu	<i>verb</i><br><ol><li>to succeed</li></ol>
mindaa	<i>noun</i><br><ol><li>salary</li></ol>
mindeessuu	<i>verb</i><br><ol><li>to hire</li></ol>
minjaala	<i>noun</i><br><ol><li>table</li></ol>
minnii	<i>noun</i><br><ol><li>tapeworm</li></ol>
miqiqqirii	<i>noun</i><br><ol><li>spine, backbone</li></ol>
mirree	<i>noun</i><br><ol><li>pair</li></ol>
mo'icha	<i>noun</i><br><ol><li>victory</li></ol>
mo'uu	<i>verb</i><br><ol><li>to win</li></ol>
moggoyyaa	<i>noun</i><br><ol><li>synonym</li></ol>
moloksee	<i>noun</i><br><ol><li>monk</li></ol>
moofaa	<i>adj</i><br><ol><li>old</li></ol>
moogaa	<i>noun</i><br><ol><li>diamond</li></ol>
mootummaa	<i>noun</i><br><ol><li>government</li></ol>
morma	<i>noun</i><br><ol><li>neck</li></ol>
mucucaachuu	<i>verb</i><br><ol><li>to slip</li></ol>
mufachiisuu	<i>verb</i><br><ol><li>to offend</li></ol>
mufannaa	<i>noun</i><br><ol><li>disappointment</li></ol>
muka	<i>noun</i><br><ol><li>tree</li></ol>
mul'isuu	<i>verb</i><br><ol><li>to signify, mean</li></ol>
murteessuu	<i>verb</i><br><ol><li>to decide</li></ol>
murtii	<i>noun</i><br><ol><li>decision, judgement</li></ol>
muruu	<i>verb</i><br><ol><li>to cut</li></ol>
muuzii	<i>noun</i><br><ol><li>banana</li></ol>
na'uu	<i>adv</i><br><ol><li>(Afaan Oromo) aback</li></ol>
naacha	<i>noun</i><br><ol><li>crocodile</li></ol>
naaduraa	<i>noun</i><br><ol><li>binoculars</li></ol>
naafa	<i>noun</i><br><ol><li>a cripple</li></ol>
naasuu	<i>noun</i><br><ol><li>horror</li></ol>
nafa	<i>noun</i><br><ol><li>body</li></ol>
naga'ee	<i>noun</i><br><ol><li>receipt</li></ol>
nagaa	<i>noun</i><br><ol><li>peace</li></ol>
nagaa gaafachuu	<i>phrase</i><br><ol><li>greeting</li></ol>
nahuu	<i>adv</i><br><ol><li>(Afaan Oromo) aback</li></ol>
namicha	<i>noun</i><br><ol><li>man</li></ol>
niitii	<i>noun</i><br><ol><li>wife</li></ol>
ninniga	<i>noun</i><br><ol><li>jug</li></ol>
noolaa	<i>noun</i><br><ol><li>microphone</li></ol>
nyaachisa	<i>noun</i><br><ol><li>feast</li></ol>
nyaachuu	<i>verb</i><br><ol><li>to eat</li></ol>
nyaara	<i>noun</i><br><ol><li>eyelash</li></ol>
nyaata	<i>noun</i><br><ol><li>food</li></ol>
nyanyee	<i>noun</i><br><ol><li>rabies</li></ol>
o'a	<i>noun</i><br><ol><li>heat</li></ol>
obboleessa	<i>noun</i><br><ol><li>brother</li></ol>
obboleettii	<i>noun</i><br><ol><li>sister</li></ol>
obboroo	<i>noun</i><br><ol><li>dawn</li></ol>
obsa	<i>noun</i><br><ol><li>patience</li></ol>
ocholoonii	<i>noun</i><br><ol><li>peanut</li></ol>
ogiyo	<i>noun</i><br><ol><li>cardamon</li></ol>
ogummaa	<i>noun</i><br><ol><li>profession, career</li></ol>
okkoluu	<i>verb</i><br><ol><li>to limp</li></ol>
ollaa	<i>noun</i><br><ol><li>neighbor</li></ol>
olokee	<i>noun</i><br><ol><li>aardvark</li></ol>
oofuu	<i>verb</i><br><ol><li>to drive</li></ol>
ooluu	<i>verb</i><br><ol><li>to spend the day</li></ol>
oomacha	<i>noun</i><br><ol><li>foam</li></ol>
oomisha	<i>noun</i><br><ol><li>product</li></ol>
oomishuu	<i>verb</i><br><ol><li>to manufacture, produce</li></ol>
osolee	<i>noun</i><br><ol><li>squirrel</li></ol>
otobisii	<i>noun</i><br><ol><li>bus</li></ol>
poolisii	<i>noun</i><br><ol><li>police</li></ol>
poomii	<i>noun</i><br><ol><li>apple</li></ol>
poostaa	<i>noun</i><br><ol><li>envelope</li></ol>
qaanqee	<i>noun</i><br><ol><li>spark</li></ol>
qaaraa	<i>noun</i><br><ol><li>green pepper</li></ol>
qabatto	<i>noun</i><br><ol><li>belt</li></ol>
qabeenyaa	<i>noun</i><br><ol><li>property</li></ol>
qabuu	<i>verb</i><br><ol><li>to have, possess</li></ol>
qajeelummaa	<i>noun</i><br><ol><li>justice</li></ol>
qallaa	<i>adj</i><br><ol><li>thin</li></ol>
qallabuu	<i>verb</i><br><ol><li>to fail</li></ol>
qamalee	<i>noun</i><br><ol><li>ape</li></ol>
qarafaa	<i>noun</i><br><ol><li>cinnamon</li></ol>
qaraxa	<i>noun</i><br><ol><li>tax</li></ol>
qarree	<i>noun</i><br><ol><li>summit, peak (of a mountain)</li></ol>
qarshii	<i>noun</i><br><ol><li>money</li></ol>
qaruu	<i>verb</i><br><ol><li>to sharpen</li></ol>
qawwee	<i>noun</i><br><ol><li>gun</li></ol>
qayii	<i>noun</i><br><ol><li>incense</li></ol>
qeensa	<i>noun</i><br><ol><li>fingernail</li></ol>
qeerramsa	<i>noun</i><br><ol><li>tiger</li></ol>
qeerroo	<i>noun</i><br><ol><li>bachelor</li></ol>
qilleensa	<i>noun</i><br><ol><li>air</li></ol>
qimixuu	<i>noun</i><br><ol><li>cheese</li></ol>
qocaa	<i>noun</i><br><ol><li>turtle</li></ol>
qokkee	<i>noun</i><br><ol><li>larynx</li></ol>
qollofuu	<i>verb</i><br><ol><li>to lock</li></ol>
qonnaa	<i>noun</i><br><ol><li>agriculture</li></ol>
qoobii	<i>noun</i><br><ol><li>hat, cap</li></ol>
qoonqoo	<i>noun</i><br><ol><li>tongue</li></ol>
qoosaa	<i>noun</i><br><ol><li>joke</li></ol>
qoosxaa	<i>noun</i><br><ol><li>spinach</li><li>kale</li></ol>
qophaa'uu	<i>verb</i><br><ol><li>Alternate form of qopphaa'uu</li></ol>
qopphaa'uu	<i>verb</i><br><ol><li>to be prepared</li></ol>
qoraan	<i>noun</i><br><ol><li>firewood</li></ol>
qorannoo	<i>noun</i><br><ol><li>research</li></ol>
qorqorroo	<i>noun</i><br><ol><li>tin</li></ol>
qottoo	<i>noun</i><br><ol><li>axe</li></ol>
qotuu	<i>verb</i><br><ol><li>to plough</li><li>to farm</li></ol>
qu'achuu	<i>verb</i><br><ol><li>to study</li></ol>
quba	<i>noun</i><br><ol><li>finger</li></ol>
quba miillaa	<i>noun</i><br><ol><li>toe</li></ol>
qubee	<i>noun</i><br><ol><li>alphabet</li></ol>
qubeelaa	<i>noun</i><br><ol><li>ring (worn on finger)</li></ol>
qubeessaa	<i>noun</i><br><ol><li>pencil</li></ol>
qufa'uu	<i>verb</i><br><ol><li>to cough</li></ol>
qufaa	<i>noun</i><br><ol><li>cough, coughing</li></ol>
qulfii	<i>noun</i><br><ol><li>lock (mechanism to hold shut)</li></ol>
qullubbii	<i>noun</i><br><ol><li>garlic</li></ol>
qulqulleessituu	<i>noun</i><br><ol><li>janitor</li></ol>
quncisuu	<i>verb</i><br><ol><li>to peel</li></ol>
qurxummii	<i>noun</i><br><ol><li>fish</li></ol>
quunnamtii	<i>noun</i><br><ol><li>communication</li></ol>
quuxessuu	<i>verb</i><br><ol><li>to intimidate</li></ol>
quyyifa	<i>noun</i><br><ol><li>spice</li></ol>
raadiyoo	<i>noun</i><br><ol><li>radio</li></ol>
raafuu	<i>noun</i><br><ol><li>cabbage</li></ol>
raajuu	<i>verb</i><br><ol><li>to predict</li></ol>
raamma'uu	<i>verb</i><br><ol><li>to rot, decay</li></ol>
raayyaa	<i>noun</i><br><ol><li>army</li></ol>
raffu	<i>verb</i><br><ol><li>to sleep</li></ol>
rakkisuu	<i>verb</i><br><ol><li>to bother, annoy</li></ol>
rakkoo	<i>noun</i><br><ol><li>problem</li></ol>
ramaddii	<i>noun</i><br><ol><li>category</li></ol>
re'ee	<i>noun</i><br><ol><li>goat</li></ol>
rifachuu|rifachaarra|rifadhe|rifataniiru|rifaeetti|rifadhaa|ni rifata|haa rifattu|ni rifatu|rifachaartu|rifachaan jira|rifaneerra|ni rifanna|rifanne|rifachaara|Overview of Conjugation|rifattaniittu|haa rifatan|rifachaaru|rifate|Verb Conjugation|rifatte|rifachaarta|rifateera|haa rifadhu|rifadheera|PRONOUN|nanrifadha|rifatteetta|rifattan|ni rifattu|rifadhu|rifatan|ni rifatti|haa rifau|haa rifatu|ni rifatta|rifachaarti	<i>verb</i><br><ol><li>aback, be shock</li></ol>
rifeensa	<i>noun</i><br><ol><li>hair (on head)</li></ol>
rigaa	<i>noun</i><br><ol><li>toothpick</li></ol>
rimma	<i>noun</i><br><ol><li>termite</li></ol>
riqicha	<i>noun</i><br><ol><li>bridge</li></ol>
rogsadee	<i>noun</i><br><ol><li>triangle</li></ol>
roobuu	<i>verb</i><br><ol><li>to rain</li></ol>
rukutuu|ni rukutti|rukuttaniittu|rukutaarti|haa rukutan|rukutaarra|ni rukuttu|rukutte|ni rukutta|rukuti|rukutaaru|nanrukuta|rukutaartu|rukutaan jira|rukutaa|ni rukutu|Overview of Conjugation|rukuttan|rukute|rukutaarta|Verb Conjugation|rukutneerra|haa rukutnu|haa rukutu|rukutan|rukutaniiru|rukutaara|ni rukutna|rukutteetti|rukutne|haa rukuttu|PRONOUN|rukuteera|ni rukuta|rukutteetta	<i>verb</i><br><ol><li>to hit, to strike</li></ol>
ruuga	<i>noun</i><br><ol><li>candidate</li></ol>
ruuzii	<i>noun</i><br><ol><li>rice</li></ol>
saahiba	<i>noun</i><br><ol><li>friend</li></ol>
saalaa	<i>noun</i><br><ol><li>oryx</li></ol>
saamtuu	<i>noun</i><br><ol><li>mugger</li></ol>
saamunaa	<i>noun</i><br><ol><li>soap</li></ol>
saamuu	<i>verb</i><br><ol><li>to rob</li></ol>
saanduqa	<i>noun</i><br><ol><li>box</li></ol>
saanqaa	<i>noun</i><br><ol><li>timber</li></ol>
saantima	<i>noun</i><br><ol><li>coin</li></ol>
saatii	<i>noun</i><br><ol><li>hour</li></ol>
saawwa	<i>noun</i><br><ol><li>cow</li></ol>
saaxoo	<i>noun</i><br><ol><li>bush</li></ol>
sadarya	<i>noun</i><br><ol><li>vest</li></ol>
saddeet	<i>num</i><br><ol><li>eight</li></ol>
saddeettama	<i>num</i><br><ol><li>eighty</li></ol>
sadii	<i>num</i><br><ol><li>three</li></ol>
safarachuu	<i>verb</i><br><ol><li>to try on</li></ol>
sagal	<i>num</i><br><ol><li>nine</li></ol>
sagalee	<i>noun</i><br><ol><li>voice</li><li>sound</li></ol>
sagaltama	<i>num</i><br><ol><li>ninety</li></ol>
sagantee	<i>noun</i><br><ol><li>schedule</li></ol>
sakatta'uu	<i>verb</i><br><ol><li>to inspect</li></ol>
salaaxaa	<i>noun</i><br><ol><li>salad</li></ol>
salganee	<i>noun</i><br><ol><li>jury</li></ol>
salma	<i>noun</i><br><ol><li>sexual intercourse, copulation</li></ol>
salpha	<i>adj</i><br><ol><li>easy</li></ol>
salphina	<i>noun</i><br><ol><li>disgrace</li><li>humiliation</li></ol>
samii	<i>noun</i><br><ol><li>sky</li></ol>
sanadii	<i>noun</i><br><ol><li>document</li></ol>
sangaa	<i>noun</i><br><ol><li>ox</li></ol>
sanyii	<i>noun</i><br><ol><li>seed</li></ol>
sattawwaa	<i>noun</i><br><ol><li>giraffe</li></ol>
sawwa	<i>noun</i><br><ol><li>cow</li></ol>
sayyuu	<i>noun</i><br><ol><li>sister-in-law</li></ol>
seenaa	<i>noun</i><br><ol><li>history</li></ol>
seensa	<i>noun</i><br><ol><li>introduction</li></ol>
seensa aduu	<i>noun</i><br><ol><li>sunset</li></ol>
seequu	<i>verb</i><br><ol><li>to smile, grin</li></ol>
seera	<i>noun</i><br><ol><li>law</li></ol>
seeruu	<i>verb</i><br><ol><li>to saw</li></ol>
shaakaluu	<i>verb</i><br><ol><li>to practice</li></ol>
shaamaa	<i>noun</i><br><ol><li>candle</li></ol>
shaanaa	<i>noun</i><br><ol><li>cabbage</li></ol>
shaanii	<i>noun</i><br><ol><li>dish, plate</li></ol>
shakkii	<i>noun</i><br><ol><li>doubt</li><li>suspicion</li></ol>
shakkuu	<i>verb</i><br><ol><li>to suspect</li></ol>
shamizii	<i>noun</i><br><ol><li>shirt</li></ol>
shan	<i>num</i><br><ol><li>five.</li></ol>
shantama	<i>num</i><br><ol><li>fifty</li></ol>
shashara	<i>noun</i><br><ol><li>mushroom</li></ol>
sheena'uu	<i>verb</i><br><ol><li>to regret</li></ol>
shikee	<i>noun</i><br><ol><li>fart</li></ol>
shimbiro	<i>noun</i><br><ol><li>bird</li></ol>
shokorkota	<i>noun</i><br><ol><li>nonsense</li></ol>
shorbaa	<i>noun</i><br><ol><li>soup</li></ol>
shororkaa	<i>noun</i><br><ol><li>panic</li></ol>
shubbisuu	<i>verb</i><br><ol><li>to dance</li></ol>
shukkaaraa	<i>noun</i><br><ol><li>sugar</li></ol>
shunburaa	<i>noun</i><br><ol><li>chickpea</li></ol>
shurraaba	<i>noun</i><br><ol><li>sweater</li></ol>
sibiilaa	<i>noun</i><br><ol><li>iron (metal)</li></ol>
siddisa	<i>noun</i><br><ol><li>clover</li></ol>
siibaagoo	<i>noun</i><br><ol><li>string</li></ol>
siidaa	<i>noun</i><br><ol><li>monument</li></ol>
siissuu	<i>verb</i><br><ol><li>to whistle</li></ol>
simbira	<i>noun</i><br><ol><li>bird</li></ol>
simbirroo	<i>noun</i><br><ol><li>bird</li></ol>
singiggoo	<i>noun</i><br><ol><li>heartburn</li></ol>
siree	<i>noun</i><br><ol><li>bed</li></ol>
sirna	<i>noun</i><br><ol><li>system</li></ol>
sirna awaalaa	<i>noun</i><br><ol><li>funeral</li></ol>
sirnakkoo	<i>noun</i><br><ol><li>ecosystem</li></ol>
sirreessuu	<i>verb</i><br><ol><li>to correct</li></ol>
siyaasa	<i>noun</i><br><ol><li>politics</li></ol>
soba	<i>noun</i><br><ol><li>lie, falsehood</li></ol>
sodaa	<i>noun</i><br><ol><li>fear</li></ol>
sodaachiisuu	<i>verb</i><br><ol><li>to frighten, scare</li></ol>
sodoma	<i>num</i><br><ol><li>thirty</li></ol>
somba	<i>noun</i><br><ol><li>lung</li></ol>
sooftii	<i>noun</i><br><ol><li>tissue paper</li></ol>
soogidda	<i>noun</i><br><ol><li>salt</li></ol>
soquu	<i>verb</i><br><ol><li>to dig</li></ol>
sukkaara	<i>noun</i><br><ol><li>sugar</li></ol>
suluula	<i>noun</i><br><ol><li>valley</li></ol>
summaa'u nyaata	<i>noun</i><br><ol><li>food poisoning</li></ol>
summii	<i>noun</i><br><ol><li>poison</li></ol>
sumuda	<i>noun</i><br><ol><li>stamp (for letters)</li></ol>
suphee	<i>noun</i><br><ol><li>clay</li></ol>
suphuu	<i>verb</i><br><ol><li>to repair, fix</li></ol>
surree	<i>noun</i><br><ol><li>pants, trousers</li></ol>
surrii	<i>noun</i><br><ol><li>brain</li></ol>
suulaa	<i>noun</i><br><ol><li>storm</li></ol>
suuqii	<i>noun</i><br><ol><li>shop, store</li></ol>
suura	<i>noun</i><br><ol><li>photograph</li></ol>
taa'uu	<i>verb</i><br><ol><li>to sit</li></ol>
taaksii	<i>noun</i><br><ol><li>taxi</li></ol>
tabba	<i>noun</i><br><ol><li>hill</li></ol>
tafkii	<i>noun</i><br><ol><li>flea</li></ol>
tajaajiluu	<i>verb</i><br><ol><li>to serve</li></ol>
talaallii	<i>noun</i><br><ol><li>vaccination</li></ol>
talaaluu	<i>verb</i><br><ol><li>to immunize</li></ol>
tashaa	<i>noun</i><br><ol><li>midget</li></ol>
teessoo	<i>noun</i><br><ol><li>address</li></ol>
tilmaama	<i>noun</i><br><ol><li>a guess</li></ol>
tiruu	<i>noun</i><br><ol><li>liver</li></ol>
tisiisa	<i>noun</i><br><ol><li>fly (insect)</li></ol>
tokko	<i>num</i><br><ol><li>one</li></ol>
tolcha	<i>noun</i><br><ol><li>magic</li></ol>
torba	<i>num</i><br><ol><li>seven</li></ol>
torban	<i>noun</i><br><ol><li>week</li></ol>
torbatama	<i>num</i><br><ol><li>seventy</li></ol>
tortoruu	<i>verb</i><br><ol><li>to rot, decay</li></ol>
tuchee	<i>noun</i><br><ol><li>ant</li></ol>
tufuu	<i>verb</i><br><ol><li>to spit</li></ol>
tulluu	<i>noun</i><br><ol><li>mountain</li></ol>
tumtuu	<i>noun</i><br><ol><li>blacksmith</li></ol>
tuquu	<i>verb</i><br><ol><li>to touch, contact</li></ol>
turuu	<i>verb</i><br><ol><li>to stay</li></ol>
tuullaa	<i>noun</i><br><ol><li>heap, pile</li></ol>
tuuluu	<i>verb</i><br><ol><li>to pile</li></ol>
udaan	<i>noun</i><br><ol><li>excrement</li></ol>
uffachuu	<i>verb</i><br><ol><li>to wear</li></ol>
uffarmaa	<i>noun</i><br><ol><li>scarf</li></ol>
uffata	<i>noun</i><br><ol><li>clothes</li></ol>
ujummoo	<i>noun</i><br><ol><li>pipe, tube</li></ol>
ulee	<i>noun</i><br><ol><li>stick</li></ol>
ulfa	<i>adj</i><br><ol><li>pregnant</li></ol>
ulfaataa	<i>adj</i><br><ol><li>heavy</li></ol>
ulfina	<i>noun</i><br><ol><li>weight</li></ol>
urgi	<i>noun</i><br><ol><li>star</li></ol>
urjii	<i>noun</i><br><ol><li>star</li></ol>
uruu	<i>verb</i><br><ol><li>to impale</li></ol>
uruungguu	<i>noun</i><br><ol><li>owl</li></ol>
ususuu	<i>verb</i><br><ol><li>to gossip</li></ol>
utaaluu	<i>verb</i><br><ol><li>to jump</li></ol>
uummata	<i>noun</i><br><ol><li>population</li></ol>
uumuu	<i>verb</i><br><ol><li>to create, invent</li></ol>
waabdii	<i>noun</i><br><ol><li>guarantee, assurance</li></ol>
waaduu	<i>verb</i><br><ol><li>to roast</li></ol>
waajjira	<i>noun</i><br><ol><li>office</li></ol>
waamicha	<i>noun</i><br><ol><li>invitation</li></ol>
waandansaa	<i>noun</i><br><ol><li>quality</li></ol>
waanta	<i>noun</i><br><ol><li>thing</li></ol>
waaqa	<i>noun</i><br><ol><li>god</li></ol>
waarii	<i>noun</i><br><ol><li>midnight</li></ol>
waaroo	<i>noun</i><br><ol><li>tent</li></ol>
waggaa	<i>noun</i><br><ol><li>year</li></ol>
walaloo	<i>noun</i><br><ol><li>poetry</li><li>poem</li></ol>
walbadiinsa	<i>noun</i><br><ol><li>disagreement</li></ol>
wallaalummaa	<i>noun</i><br><ol><li>ignorance</li></ol>
wangoo	<i>noun</i><br><ol><li>jackal</li></ol>
wankii	<i>noun</i><br><ol><li>prison, jail</li></ol>
waraana	<i>noun</i><br><ol><li>war</li></ol>
waraqaa	<i>noun</i><br><ol><li>paper</li></ol>
wareeruu	<i>verb</i><br><ol><li>to startle</li></ol>
warqee	<i>noun</i><br><ol><li>gold</li></ol>
washoo	<i>noun</i><br><ol><li>pot</li></ol>
wasiila	<i>noun</i><br><ol><li>uncle (paternal)</li></ol>
waxii	<i>noun</i><br><ol><li>stew</li></ol>
wayyeessuu	<i>verb</i><br><ol><li>to make better</li></ol>
weeddisuu	<i>verb</i><br><ol><li>to sing</li></ol>
weedduu	<i>noun</i><br><ol><li>song</li></ol>
weerara	<i>noun</i><br><ol><li>invasion</li></ol>
xaa'oo	<i>noun</i><br><ol><li>fertilizer</li></ol>
xaasaa	<i>noun</i><br><ol><li>can (container)</li></ol>
xafxafoo	<i>noun</i><br><ol><li>ladder</li></ol>
xiinxanii	<i>noun</i><br><ol><li>corruption</li></ol>
xiqqeessuu	<i>verb</i><br><ol><li>to reduce, decrease</li></ol>
xiyyaa	<i>noun</i><br><ol><li>arrow</li></ol>
xiyyaara	<i>noun</i><br><ol><li>airplane</li></ol>
xumura	<i>noun</i><br><ol><li>summary</li></ol>
xuubii	<i>noun</i><br><ol><li>brick</li></ol>
xuurumbullee	<i>adj</i><br><ol><li>beautiful</li></ol>
yaa'ii	<i>noun</i><br><ol><li>conference</li></ol>
yaa'uu	<i>verb</i><br><ol><li>to flow</li></ol>
yaadachiisuu	<i>verb</i><br><ol><li>to remind</li></ol>
yaadachuu	<i>verb</i><br><ol><li>to remember</li></ol>
yaadanno	<i>noun</i><br><ol><li>notebook</li></ol>
yaadda'uu	<i>verb</i><br><ol><li>to worry</li></ol>
yaaduu	<i>verb</i><br><ol><li>to think</li><li>to imagine</li></ol>
yaaluu	<i>verb</i><br><ol><li>to try, attempt</li></ol>
yaatoo	<i>noun</i><br><ol><li>liquid</li></ol>
yaddachuu	<i>verb</i><br><ol><li>to memorize</li></ol>
yakka	<i>noun</i><br><ol><li>crime</li></ol>
yarsuma	<i>noun</i><br><ol><li>teenager</li></ol>
yeeyyii	<i>noun</i><br><ol><li>wolf</li></ol>
yeroo	<i>noun</i><br><ol><li>time</li></ol>
