А|а|a	<i>character</i><br><ol><li>The first letter of the Ossetian alphabet, written in the Cyrillic script.</li></ol>
Афгъанистан|Afǧanistan	<i>name</i><br><ol><li>Afghanistan (a country in Asia)</li></ol>
Б|б|b|B	<i>character</i><br><ol><li>The third letter of the Ossetian alphabet, written in the Cyrillic script.</li></ol>
В|V|в|v	<i>character</i><br><ol><li>The fourth letter of the Ossetian alphabet, written in the Cyrillic script.</li></ol>
Г|g|г	<i>character</i><br><ol><li>The fifth letter of the Ossetian alphabet, written in the Cyrillic script.</li></ol>
Гуырдзыстон|Guyrdzyston	<i>name</i><br><ol><li>Georgia</li></ol>
Дагъистан|Daǧistan	<i>name</i><br><ol><li>Daghistan</li></ol>
Дж|ǵ|Ǵ|дж	<i>character</i><br><ol><li>The eighth letter of the Ossetian alphabet, written in the Cyrillic script.</li></ol>
Ирыстон|Iryston	<i>name</i><br><ol><li>Ossetia</li></ol>
Калак|Kalak	<i>name</i><br><ol><li>(South Ossetia) Tbilisi</li></ol>
Мӕхъӕл|Mæqæl	<i>noun</i><br><ol><li>Ingushetia</li></ol>
Огайо|Ogajo	<i>name</i><br><ol><li>Ohio (a state of the United States)</li><li>Ohio (a river in the central United States)</li></ol>
Сомех|Somix	<i>name</i><br><ol><li>(Digor) Armenia (a country in Europe and Asia)</li></ol>
Сомих|Somix	<i>name</i><br><ol><li>(Iron) Armenia (a country in Europe and Asia)</li></ol>
Сомихыстон|Somixyston	<i>name</i><br><ol><li>Armenia</li></ol>
Тӕтӕрстан|Tætærstan	<i>name</i><br><ol><li>Tatarstan</li></ol>
Украинӕ|Ukrainæ	<i>name</i><br><ol><li>Ukraine</li></ol>
Уӕрӕсе|Wæræse	<i>name</i><br><ol><li>Russia</li></ol>
Цхинвал|Cxinvál|Цхинва́л	<i>name</i><br><ol><li>Tskhinvali (the capital city of South Ossetia, a de-facto independent country internationally recognized as part of the country of Georgia)</li></ol>
Чъреба	<i>name</i><br><ol><li>Tskhinvali (the capital city of South Ossetia, a de-facto independent country internationally recognized as part of the country of Georgia)</li></ol>
а|А|a	<i>character</i><br><ol><li>The first letter of the Ossetian alphabet, written in the Cyrillic script.</li></ol>
абана|abána|аба́на	<i>noun</i><br><ol><li>(Iron, Digor) bathhouse</li></ol>
абон|abon	<i>noun</i><br><ol><li>today</li></ol>
авг|avg	<i>noun</i><br><ol><li>(Iron) glass</li><li>(Iron) bottle</li></ol>
авгӕ|avgæ|ӕвгитӕ	<i>noun</i><br><ol><li>(Digor) Alternative form of авг (avg)</li></ol>
авд|avd	<i>num</i><br><ol><li>seven</li></ol>
авдисӕр|avdisær	<i>noun</i><br><ol><li>(Digor) Monday</li></ol>
агъд|aǧd	<i>noun</i><br><ol><li>thigh</li></ol>
ад|ad	<i>noun</i><br><ol><li>taste</li></ol>
адӕг|adæg	<i>noun</i><br><ol><li>(Agriculture) harrow (of the kind used in the mountain villages)</li></ol>
адӕймаг|adæjmag	<i>noun</i><br><ol><li>(Iron, Digor) man, human being, person</li></ol>
аз|az	<i>noun</i><br><ol><li>year</li></ol>
айдӕн|ajdæn	<i>noun</i><br><ol><li>mirror</li></ol>
айк|ӕйчытӕ|ajk	<i>noun</i><br><ol><li>(Iron) egg</li></ol>
айкӕ|ajkæ|æйкитæ	<i>noun</i><br><ol><li>(Digor) egg</li></ol>
айнӕг|ajnæg	<i>noun</i><br><ol><li>cliff, rock face, precipice, crag</li></ol>
амад|amad	<i>adj</i><br><ol><li>constructed, built, laid out</li><li>composed of</li></ol><br><i>noun</i><br><ol><li>building, construction</li><li>masonry, stonework</li></ol>
амонын|amonyn	<i>verb</i><br><ol><li>to teach</li></ol>
амӕлын|amælyn	<i>noun</i><br><ol><li>to die</li></ol>
арв|arv	<i>noun</i><br><ol><li>sky</li></ol>
аргъ|arǧ	<i>noun</i><br><ol><li>price</li></ol>
аргъуан|arǧwan	<i>noun</i><br><ol><li>church</li></ol>
ард|ard|æрдтæ	<i>noun</i><br><ol><li>oath</li></ol>
арм|arm|æрмттæ	<i>noun</i><br><ol><li>hand</li></ol>
арс|ӕрсытӕ|ars	<i>noun</i><br><ol><li>bear</li></ol>
арт|ӕртытӕ|ӕрттӕ|ӕрттитӕ	<i>noun</i><br><ol><li>fire</li><li>campfire</li></ol>
арфӕ|arfæ	<i>noun</i><br><ol><li>gratitude, greeting</li><li>blessing</li><li>harp</li></ol>
арц|arc	<i>noun</i><br><ol><li>spear, pike, lance</li></ol>
арцъиу|arc’iw	<i>noun</i><br><ol><li>eagle</li></ol>
арӕн|aræn	<i>noun</i><br><ol><li>(Iron, Digor) border, boundary</li><li>limit, edge</li></ol>
аст|ast	<i>num</i><br><ol><li>eight</li></ol>
аууон|awuon	<i>noun</i><br><ol><li>shadow</li></ol>
ауындзын|awynʒyn	<i>verb</i><br><ol><li>to hang (cause to be suspended)</li></ol>
афтид|aftid	<i>adj</i><br><ol><li>empty</li></ol>
афӕрсын|afærsyn	<i>verb</i><br><ol><li>to ask, to inquire</li></ol>
ахсын|axsyn	<i>verb</i><br><ol><li>to catch, capture, seize, detain</li><li>to arrest</li><li>to take</li></ol>
ахӕм|axæm	<i>adv</i><br><ol><li>thus, in this way, in this manner</li></ol>
ацц|acc	<i>noun</i><br><ol><li>(Iron) wild duck</li></ol>
ацца|acca	<i>noun</i><br><ol><li>(Digor) wild duck</li></ol>
б|B|Б|b	<i>character</i><br><ol><li>The third letter of the Ossetian alphabet, written in the Cyrillic script.</li></ol>
бабуз|babuz	<i>noun</i><br><ol><li>(Digot dialect) duck</li></ol>
бабузфий|babuzfij	<i>noun</i><br><ol><li>(Digor) platypus</li></ol>
бабыз|babyz	<i>noun</i><br><ol><li>(Iron) duck</li></ol>
бабызвындз|babyzvynʒ	<i>noun</i><br><ol><li>(Iron) platypus</li></ol>
бадын|badyn	<i>verb</i><br><ol><li>to sit</li></ol>
баз|baz	<i>noun</i><br><ol><li>(Iron, Digor) pillow</li></ol>
базар|bazar	<i>noun</i><br><ol><li>market</li><li>trade</li></ol>
базыр|bazyr	<i>noun</i><br><ol><li>wing</li></ol>
бал|бали|bal|bali	<i>noun</i><br><ol><li>(Iron) cherry</li></ol>
бамбӕрзын|bambærzyn	<i>verb</i><br><ol><li>to cover</li></ol>
бар|bar	<i>noun</i><br><ol><li>right</li><li>permission</li></ol>
барчъи	<i>noun</i><br><ol><li>sack, bag</li></ol>
бел|bel	<i>noun</i><br><ol><li>shovel</li></ol>
берӕ|beræ	<i>adv</i><br><ol><li>(Digor) Alternative form of бирӕ (biræ)</li></ol><br><i>adj</i><br><ol><li>(Digor) Alternative form of бирӕ (biræ)</li></ol><br><i>noun</i><br><ol><li>(Digor) Alternative form of бирӕ (biræ)</li></ol>
берӕгъ|beræǧ	<i>noun</i><br><ol><li>(Digor) wolf</li></ol>
беурӕ|bewræ	<i>adv</i><br><ol><li>(Digor) Alternative form of бирӕ (biræ)</li></ol><br><i>adj</i><br><ol><li>(Digor) Alternative form of бирӕ (biræ)</li></ol><br><i>noun</i><br><ol><li>(Digor) Alternative form of бирӕ (biræ)</li></ol>
бирӕ|би́рӕ|bíræ	<i>adv</i><br><ol><li>(Iron) many, much; very, too, too much; significantly</li><li>(Iron) long (of time)</li></ol><br><i>adj</i><br><ol><li>(Iron) sizeable, substantial, significant, numerous</li></ol><br><i>noun</i><br><ol><li>(Iron) sizeable, substantial, significant, numerous</li></ol>
бирӕгъ|biræǧ	<i>noun</i><br><ol><li>(Iron) wolf</li></ol>
битъына|bit’yna	<i>noun</i><br><ol><li>mint</li></ol>
богъ|boǧ	<i>noun</i><br><ol><li>bull</li></ol>
болгӕ|болгитӕ|bolgæ	<i>noun</i><br><ol><li>(Digor) radish</li><li>(Digor) turnip</li></ol>
бон|bon	<i>noun</i><br><ol><li>day</li></ol>
боцъо|boc’o	<i>noun</i><br><ol><li>beard</li></ol>
буд|bud	<i>noun</i><br><ol><li>(Iron) incense, frankincense</li></ol>
бузныг|buznyg	<i>intj</i><br><ol><li>thank you</li></ol>
булкъ|булчъытæ|bulk’	<i>noun</i><br><ol><li>(Iron) radish</li><li>(Iron) turnip</li></ol>
бур|bur	<i>adj</i><br><ol><li>yellow</li></ol>
бурдӕн|burdæn	<i>noun</i><br><ol><li>(Digor) snowstorm</li></ol>
быдыр|bydyr	<i>noun</i><br><ol><li>(Iron) flatness, plane</li><li>plain, steppe, field</li><li>(physics) field</li></ol>
был|byl	<i>noun</i><br><ol><li>lip</li></ol>
бын|byn	<i>noun</i><br><ol><li>bottom</li></ol>
бындз|bynʒ	<i>noun</i><br><ol><li>fly (insect)</li></ol>
бӕгъа|bæǧa	<i>noun</i><br><ol><li>mallow</li></ol>
бӕгънӕг|bæǧnæg	<i>adj</i><br><ol><li>naked</li></ol>
бӕгъӕмсар|bæǧǽmsar|бӕгъӕ́мсар	<i>adj</i><br><ol><li>(Iron) bareheaded</li></ol>
бӕгъӕнсар|bæǧænsar	<i>adj</i><br><ol><li>(Digor) Alternative form of бӕгъӕмсар (bæǧæmsar)</li></ol>
бӕлас|бӕлӕстӕ|bælas	<i>noun</i><br><ol><li>(Iron) tree</li></ol>
бӕласӕ|бӕлӕстӕ|bælasæ	<i>noun</i><br><ol><li>(Digor) tree</li></ol>
бӕлон|bælon	<i>noun</i><br><ol><li>pigeon</li></ol>
бӕлтӕрна|bæltærna	<i>noun</i><br><ol><li>mustard</li></ol>
бӕмбӕг|бӕмбӕ́г|bæmbǽg|бӕмбӕджытӕ	<i>noun</i><br><ol><li>(Iron) cotton</li><li>(Iron) absorbent cotton, cotton wool, wadding, batting</li></ol>
бӕмпӕг|bæmpæg|бӕмпӕгутӕ	<i>noun</i><br><ol><li>(Digor) Alternative form of бӕмбӕг (bæmbæg)</li></ol>
бӕндӕн|bændæn	<i>noun</i><br><ol><li>rope, cord</li></ol>
бӕрз|bærz|берзы́тӕ	<i>noun</i><br><ol><li>(Iron) birch</li></ol>
бӕрзонд|бӕрзо́нд|bærzónd	<i>adj</i><br><ol><li>high, tall</li><li>big, great</li></ol><br><i>adv</i><br><ol><li>high</li></ol><br><i>noun</i><br><ol><li>height, high place</li><li>summit</li></ol>
бӕрзӕ|бӕрзитӕ|bærzæ	<i>noun</i><br><ol><li>(Digor) Alternative form of бӕрз (bærz)</li></ol>
бӕрӕзе|bæræze	<i>noun</i><br><ol><li>elder, Sambucus</li></ol>
бӕстӕ|бӕстӕтау|бӕстӕты|бӕстӕтимӕ|bæstæ|бӕстӕтыл|бӕстӕйы|бӕстӕйӕн|бӕстӕимӕ|бӕстӕтӕм|бӕстӕтӕй|бӕстӕмӕ|бӕстӕйау|бӕстӕйыл|бӕстӕтӕ|бӕстӕтӕн|бӕстӕйӕ	<i>noun</i><br><ol><li>region, area, locality, district</li><li>country, land, terrain, domain, realm</li><li>oblast</li></ol>
бӕттын|bættyn	<i>verb</i><br><ol><li>to tie, to bind, to connect</li></ol>
бӕх|bæx	<i>noun</i><br><ol><li>horse</li></ol>
бӕхдон|bæxdon	<i>noun</i><br><ol><li>stable</li></ol>
в|V|v|В	<i>character</i><br><ol><li>The fourth letter of the Ossetian alphabet, written in the Cyrillic script.</li></ol>
г|g|Г	<i>character</i><br><ol><li>The fifth letter of the Ossetian alphabet, written in the Cyrillic script.</li></ol>
гага|gaga	<i>noun</i><br><ol><li>grain, kernel, berry</li></ol>
галуан|galwan	<i>noun</i><br><ol><li>castle</li></ol>
гауыз|gawyz	<i>noun</i><br><ol><li>carpet, rug</li></ol>
геуӕргибон|geuærgibon	<i>noun</i><br><ol><li>(Digor) Tuesday</li></ol>
голлаг|gollag	<i>noun</i><br><ol><li>bag</li></ol>
гом|gom	<i>adj</i><br><ol><li>open</li></ol>
гон|gon	<i>noun</i><br><ol><li>barn</li></ol>
горӕт|goræt	<i>noun</i><br><ol><li>town</li></ol>
гутон|guton	<i>noun</i><br><ol><li>plough</li></ol>
гуыдыр	<i>noun</i><br><ol><li>lock</li></ol>
гъ|Гъ|ǧ	<i>character</i><br><ol><li>The sixth letter of the Ossetian alphabet, written in the Cyrillic script.</li></ol>
гъог|g”og	<i>noun</i><br><ol><li>(Digor) cow</li></ol>
гъӕлӕс|ǧælæs	<i>noun</i><br><ol><li>(Digor) mouth</li><li>(Digor) throat</li><li>(Digor) Alternative form of хъӕлӕс (qælæs)</li></ol>
гыркъо|gyrk’o	<i>noun</i><br><ol><li>acorn</li></ol>
гӕгкуыри	<i>noun</i><br><ol><li>lizard</li></ol>
гӕды|gædy	<i>noun</i><br><ol><li>cat</li></ol>
гӕккуыритӕ	<i>noun</i><br><ol><li>lizard</li></ol>
гӕн|gæn	<i>noun</i><br><ol><li>flax, Linum</li></ol>
д|Д|d	<i>character</i><br><ol><li>The seventh letter of the Ossetian alphabet, written in the Cyrillic script.</li></ol>
дæ бон хорз|dæ bon xorz	<i>intj</i><br><ol><li>(Iron) good day</li></ol>
давын|davyn	<i>verb</i><br><ol><li>to steal</li></ol>
даргъ|darǧ	<i>adj</i><br><ol><li>long</li></ol>
дард|dard	<i>adj</i><br><ol><li>distant</li></ol><br><i>adv</i><br><ol><li>far</li></ol>
дарын|daryn	<i>verb</i><br><ol><li>to hold</li></ol>
денджыз|denǵyz	<i>noun</i><br><ol><li>sea</li></ol>
дж|Дж|Ǵ|ǵ	<i>character</i><br><ol><li>The eighth letter of the Ossetian alphabet, written in the Cyrillic script.</li></ol>
джеджджын|ǵeǵǵyn	<i>noun</i><br><ol><li>savory</li></ol>
дз|ʒ|Дз	<i>character</i><br><ol><li>The ninth letter of the Ossetian alphabet, written in the Cyrillic script.</li></ol>
дзала|ʒala	<i>noun</i><br><ol><li>sedge</li></ol>
дзаума|ʒawma	<i>noun</i><br><ol><li>dress, garment</li></ol>
дзиликъу|ʒilik’u	<i>noun</i><br><ol><li>Jerusalem artichoke (Helianthus tuberosus)</li></ol>
дзогӕ|ʒogæ	<i>noun</i><br><ol><li>(Digor) Alternative form of дзуг (ʒug)</li></ol>
дзуапп|ʒwapp	<i>noun</i><br><ol><li>response, answer, reply</li><li>account</li><li>(Iron) responsibility</li></ol>
дзуар|ʒwar	<i>noun</i><br><ol><li>cross</li></ol>
дзуг|дзугтӕ|ʒug	<i>noun</i><br><ol><li>(Iron) herd, flock (of cattle)</li><li>(Iron) pack (of birds)</li></ol>
дзугун|ʒugun	<i>noun</i><br><ol><li>(Digor) wild yak, Bos mutus</li></ol>
дзурдуат|ʒurdwat	<i>noun</i><br><ol><li>(Digor) Alternative form of дзырдуат (ʒyrdwat)</li></ol>
дзыгъуыр|ʒyǧwyr	<i>adj</i><br><ol><li>variegated, speckled, spotted, freckled</li></ol>
дзылакъуы	<i>noun</i><br><ol><li>Allium oreoprasum</li></ol>
дзылат|ʒylat	<i>noun</i><br><ol><li>tall tower, minaret</li></ol>
дзыпп|ʒypp	<i>noun</i><br><ol><li>pocket</li></ol>
дзырд|ʒyrd	<i>noun</i><br><ol><li>word</li></ol>
дзырдуат|дзырдуӕттӕ|ʒyrdwát|дзырдуа́т	<i>noun</i><br><ol><li>(Iron) dictionary</li></ol>
дзых|ʒyx	<i>noun</i><br><ol><li>mouth</li></ol>
дзӕмбы|ʒæmby	<i>noun</i><br><ol><li>(Iron) claw</li><li>paw</li></ol>
дзӕндӕл|ʒændæl	<i>adj</i><br><ol><li>slow, sluggish, clumsy, inept</li></ol>
дзӕргъ|дзӕргъӕ|ʒærǧæ|ʒærǧ	<i>noun</i><br><ol><li>sow (female pig)</li></ol>
дидинӕг|didinæg	<i>noun</i><br><ol><li>flower</li></ol>
домбай|dombaj	<i>noun</i><br><ol><li>bison</li><li>(transferred sense) lion</li></ol><br><i>adj</i><br><ol><li>(figuratively) strong, powerful</li></ol>
дон|дæнттæ|don|дæттæ	<i>noun</i><br><ol><li>water</li><li>river</li><li>juice</li></ol>
донивылд|donivyld	<i>noun</i><br><ol><li>flood</li></ol>
дуар|дуæрттæ|duar	<i>noun</i><br><ol><li>door</li><li>goals (in some sports)</li></ol>
дуне|dune	<i>noun</i><br><ol><li>world</li></ol>
дур|dur	<i>noun</i><br><ol><li>stone</li></ol>
дурвӕткъуы	<i>noun</i><br><ol><li>hawthorn, Crataegus</li></ol>
дурын|duryn	<i>adj</i><br><ol><li>stone, built or made of stone</li><li>clay, earthenware, made of clay</li></ol><br><i>noun</i><br><ol><li>an earthenware jug, a clay pot</li></ol>
дурынгӕнӕг|duryngænæg	<i>noun</i><br><ol><li>potter</li></ol>
дурӕ|duræ	<i>noun</i><br><ol><li>(Digor) cone</li></ol>
дуцын|ducyn	<i>verb</i><br><ol><li>to milk</li></ol>
ды|dy	<i>pron</i><br><ol><li>you</li></ol>
дымгӕ|dymgæ	<i>noun</i><br><ol><li>wind</li></ol>
дымын|dymyn	<i>verb</i><br><ol><li>to blow</li></ol>
дымӕг|dymæg	<i>noun</i><br><ol><li>tail</li></ol>
дыргъ|dyrǧ	<i>noun</i><br><ol><li>fruit</li></ol>
дыууӕ|dywwæ	<i>num</i><br><ol><li>two</li></ol>
дыццӕг|dyccag	<i>noun</i><br><ol><li>(Iron) Tuesday</li></ol>
дӕгъӕл|dæǧæl	<i>noun</i><br><ol><li>key</li></ol>
дӕйын|dæjyn	<i>verb</i><br><ol><li>to suck</li></ol>
дӕлвӕз|dælvæz	<i>noun</i><br><ol><li>(Iron, Digor) valley, lowland</li></ol>
дӕндаг|дæндæгтæ|dændag	<i>noun</i><br><ol><li>tooth</li><li>spoke (of a wheel)</li><li>clove (of garlic)</li></ol>
дӕр|dær	<i>adv</i><br><ol><li>also, too</li></ol>
дӕс|dæs	<i>num</i><br><ol><li>ten</li></ol>
е|e|Е	<i>character</i><br><ol><li>The tenth letter of the Ossetian alphabet, written in the Cyrillic script.</li></ol>
егар|е́гар|égar|егӕрттӕ	<i>noun</i><br><ol><li>greyhound</li></ol>
егӕр|egær	<i>noun</i><br><ol><li>(Digor) liver</li></ol>
еуу|ewu	<i>noun</i><br><ol><li>millet</li></ol>
ефс|ефсытӕ|efs	<i>noun</i><br><ol><li>(Iron) mare</li></ol>
ж|Ж|ž	<i>character</i><br><ol><li>The twelfth letter of the Ossetian alphabet, written in the Cyrillic script.</li></ol>
з|З|z	<i>character</i><br><ol><li>The thirteenth letter of the Ossetian alphabet, written in the Cyrillic script.</li></ol>
зæхкусæг|zæxkusæg	<i>noun</i><br><ol><li>peasant, arable farmer, tiller</li></ol>
зад|zad	<i>noun</i><br><ol><li>malt</li></ol><br><i>verb</i><br><ol><li>to give birth to</li></ol>
заддаг|zaddag	<i>noun</i><br><ol><li>(Digor) grain to be used for malting</li></ol>
зарын|zaryn	<i>verb</i><br><ol><li>to sing</li></ol>
згъӕрӕфтыд|zǧæræftyd	<i>noun</i><br><ol><li>armour</li></ol>
зилын|zilyn	<i>verb</i><br><ol><li>to turn</li></ol>
змис|zmis	<i>noun</i><br><ol><li>(Iron) sand.</li></ol>
знаг|znag	<i>noun</i><br><ol><li>enemy</li></ol>
знон|znon	<i>adv</i><br><ol><li>yesterday</li></ol>
зонд|zond	<i>noun</i><br><ol><li>intellect</li></ol>
зоныг|зонгуытæ|zonyg	<i>noun</i><br><ol><li>knee</li></ol>
зонын|zonyn	<i>verb</i><br><ol><li>to know</li></ol>
зыгуым	<i>noun</i><br><ol><li>(Iron) chaff (from grinding grain)</li></ol>
зым|zym	<i>noun</i><br><ol><li>snowcock</li></ol>
зымӕг|zymæg	<i>noun</i><br><ol><li>winter</li></ol>
зырзыраг|zyrzyrag	<i>noun</i><br><ol><li>poppy</li></ol>
зӕлдаг|zældag	<i>noun</i><br><ol><li>silk</li></ol>
зӕмбын|zæmbyn	<i>verb</i><br><ol><li>to yawn</li></ol>
зӕнӕг|zænæg	<i>noun</i><br><ol><li>children, offspring</li></ol>
зӕппадз|zæppaʒ	<i>noun</i><br><ol><li>crypt, tomb</li></ol>
зӕрдӕ|zærdæ	<i>noun</i><br><ol><li>heart</li><li>soul</li></ol>
зӕронд|zærónd|зӕрӕдтӕ|зӕро́нд	<i>adj</i><br><ol><li>old; ancient, archaic</li></ol><br><i>noun</i><br><ol><li>old age, senility</li></ol>
зӕтхӕ|zætxæ	<i>noun</i><br><ol><li>oats</li></ol>
зӕхх|zæxx|зӕххытӕ	<i>noun</i><br><ol><li>the Earth</li><li>soil</li><li>floor (earthen)</li></ol>
и|И|i	<i>character</i><br><ol><li>The fourteenth letter of the Ossetian alphabet, written in the Cyrillic script.</li></ol>
игӕр|igær	<i>noun</i><br><ol><li>(Iron) liver</li></ol>
идӕдз|idæʒ	<i>adj</i><br><ol><li>widowed</li></ol>
ир|ir	<i>noun</i><br><ol><li>Ossetians, the Ossetian nation</li><li>the speakers of the Iron dialect of the Ossetic language</li></ol>
ирд|ird	<i>adj</i><br><ol><li>bright</li></ol>
ирон|in Iron dialect ирӕттӕ|iron|in Digor dialect ирӕнттӕ	<i>noun</i><br><ol><li>Ossetian person</li><li>an Ossetian, speaking the Iron dialect of the Ossetian language</li></ol><br><i>adj</i><br><ol><li>Ossetian</li><li>pertaining to the speakers of the Iron dialect of the Ossetian language, or the dialect itself</li></ol>
иту|itu	<i>noun</i><br><ol><li>clothes iron</li></ol>
иу|iw	<i>num</i><br><ol><li>one</li></ol>
иумӕ|iwmæ	<i>adv</i><br><ol><li>together</li></ol>
их|ix	<i>noun</i><br><ol><li>ice</li></ol>
й|j|Й	<i>character</i><br><ol><li>The fifteenth letter of the Ossetian alphabet, written in the Cyrillic script.</li></ol>
йӕуу|jæwu	<i>noun</i><br><ol><li>millet</li></ol>
к|К	<i>character</i><br><ol><li>The sixteenth letter of the Ossetian alphabet, written in the Cyrillic script.</li></ol>
калак|ка́лак|kálak	<i>noun</i><br><ol><li>city</li></ol>
калм|kalm	<i>noun</i><br><ol><li>snake</li><li>worm</li></ol>
кард|kard|кæрдтæ	<i>noun</i><br><ol><li>knife</li><li>sword</li></ol>
карк|kark	<i>noun</i><br><ol><li>hen</li></ol>
киунугӕ|kiwnugæ|киунугутӕ	<i>noun</i><br><ol><li>(Digor) Alternative form of чиныг (ḱinyg)</li></ol>
ком|kom	<i>noun</i><br><ol><li>(Iron, Digor) mouth, jaws</li><li>canyon, ravine, gorge</li><li>blade, point, cutting edge</li></ol>
косгифиццагбон|kosgificcagbon	<i>noun</i><br><ol><li>(Digor) Tuesday</li></ol>
куй|kuj|куйтӕ	<i>noun</i><br><ol><li>(Digor) Alternative form of куыдз (k°yʒ)</li></ol>
куыд	<i>adv</i><br><ol><li>how?</li></ol><br><i>noun</i><br><ol><li>weeping</li></ol>
куыдз|куы́дз|куыйтӕ́	<i>noun</i><br><ol><li>(Iron) dog</li></ol>
куырдадз	<i>noun</i><br><ol><li>forge</li></ol>
куырм	<i>adj</i><br><ol><li>blind</li></ol>
куыройгӕс	<i>noun</i><br><ol><li>miller</li></ol>
куырӕт	<i>noun</i><br><ol><li>(Iron) beshmet</li></ol>
куыси	<i>noun</i><br><ol><li>scoop</li><li>bucket</li></ol>
куыст|куыстыл|куыстимӕ|куыстытӕм|куыстытыл|куыстытӕй|куыстытимӕ|куыстӕй|куыстмӕ|куыстытау|куыстытӕ|куысты|куыстыты|куыстӕн|куыстытӕн|куыстау	<i>noun</i><br><ol><li>work, labor</li></ol>
къ|Къ|k’	<i>character</i><br><ol><li>The seventeenth letter of the Ossetian alphabet, written in the Cyrillic script.</li></ol>
къала|k’ala	<i>noun</i><br><ol><li>tin</li></ol>
къалати|k’alati	<i>noun</i><br><ol><li>wicker basket</li><li>cage</li></ol>
къалиу|k’aliw	<i>noun</i><br><ol><li>branch</li></ol>
къалмахи|k’almaxi|Ossetia	<i>noun</i><br><ol><li>trout</li></ol>
къамбец|къа́мбец|k’ámbec	<i>noun</i><br><ol><li>buffalo</li></ol>
къах|k’ax	<i>noun</i><br><ol><li>foot</li></ol>
къирӕ|k’iræ	<i>noun</i><br><ol><li>(Digor) lime, calcium oxide</li></ol>
къобала|къобола|k’obola|k’obala	<i>noun</i><br><ol><li>stick with a knob, club</li></ol>
къофи|k’ofi	<i>noun</i><br><ol><li>coffee</li></ol>
къуди|k’udi	<i>noun</i><br><ol><li>tail</li></ol>
къул|k’ul	<i>noun</i><br><ol><li>wall (interior)</li></ol>
къумбул|k’umbul	<i>noun</i><br><ol><li>(Digor) beet</li></ol>
къуту|k’utu	<i>noun</i><br><ol><li>granary, barn</li><li>basket</li></ol>
къух|k’ux	<i>noun</i><br><ol><li>hand</li></ol>
къуымбил	<i>noun</i><br><ol><li>wool</li></ol>
къуыпп|къуыппимӕ|къуыппау|къуыппытӕ|къуыппы|къуыппӕй|къуыппыты|къуыппытӕй|къуыппытыл|къуыппыл|къуыппмӕ|къуыппытау|къуыппӕн|къуыппытӕн|къуыппытӕм|къуыппытимӕ	<i>noun</i><br><ol><li>hill, mound, knoll</li><li>hump</li></ol>
къуыри	<i>noun</i><br><ol><li>(Iron) week</li></ol>
къуырисӕр	<i>noun</i><br><ol><li>(Iron) Monday</li></ol>
къӕвда|k’ævda	<i>noun</i><br><ol><li>rain</li></ol>
къӕдз|k’æʒ	<i>adj</i><br><ol><li>crooked</li></ol>
къӕдздым|k’æʒdym	<i>noun</i><br><ol><li>(Iron) scorpion</li></ol>
къӕдзӕх|k’æʒæx	<i>noun</i><br><ol><li>(Iron, Digor) cliff, crag, rock face</li><li>mountain peak, ridge</li></ol>
къӕдор|k’ædor	<i>noun</i><br><ol><li>curds, cheese</li></ol>
къӕй|k’æj	<i>noun</i><br><ol><li>(Iron) stone slab</li><li>(geology) stratum, bed</li><li>schist, shale, slate</li><li>a schistose cliff</li></ol>
къӕм|k’æm	<i>noun</i><br><ol><li>(Iron) speck, flake</li><li>(anatomy) placenta</li></ol>
къӕпи|k’æpi	<i>noun</i><br><ol><li>hoe, mattock</li></ol>
къӕпу|k’æpu	<i>noun</i><br><ol><li>(Digor) Alternative form of къӕпы (k’æpy)</li></ol>
къӕпы|къӕпы́|k’æpý	<i>noun</i><br><ol><li>(Iron) kefir yeast</li><li>(Iron) kefir</li></ol>
къӕрных|k’ærnyx	<i>noun</i><br><ol><li>thief</li></ol>
къӕу|k’æw	<i>noun</i><br><ol><li>(Digor, anatomy) vulva</li></ol>
кӕд|kæd	<i>pron</i><br><ol><li>when</li></ol>
кӕм|kæm	<i>pron</i><br><ol><li>where</li></ol>
кӕнын|kænyn	<i>verb</i><br><ol><li>to do</li></ol>
кӕрдаг|kærdag	<i>noun</i><br><ol><li>grass</li></ol>
кӕрддзӕм|kærdʒæm	<i>noun</i><br><ol><li>sheath</li></ol>
кӕрдо|kærdo	<i>noun</i><br><ol><li>pear</li></ol>
кӕрз|kærz	<i>noun</i><br><ol><li>ash (tree)</li></ol>
кӕрон|kæron	<i>noun</i><br><ol><li>edge</li></ol>
кӕрт|kært	<i>noun</i><br><ol><li>court, courtyard</li></ol>
кӕрц|kærc|кӕрцытӕ	<i>noun</i><br><ol><li>(Iron) fur coat; sheepskin coat</li></ol>
кӕрцӕ|kærcæ|кӕрцитӕ	<i>noun</i><br><ol><li>(Digor) fur coat; sheepskin coat</li></ol>
кӕсаг|kæság|кӕсӕгтӕ	<i>noun</i><br><ol><li>(Iron) fish</li></ol>
кӕсалгӕ|кӕсӕлгитӕ|kæsalgæ	<i>noun</i><br><ol><li>(Digor) fish</li></ol>
л|Л|l	<i>character</i><br><ol><li>The eighteenth letter of the Ossetian alphabet, written in the Cyrillic script.</li></ol>
лакъон|lak’on	<i>noun</i><br><ol><li>sediment, silt</li></ol>
лацин|lacin	<i>noun</i><br><ol><li>gyrfalcon</li></ol>
лӕг|læg	<i>noun</i><br><ol><li>adult male</li><li>man, human being</li><li>husband</li></ol>
лӕгӕт|lægæt	<i>noun</i><br><ol><li>cave</li><li>den, lair</li></ol>
лӕппу|læppu	<i>noun</i><br><ol><li>youth (young man)</li><li>boy</li></ol>
лӕсӕг|læsæg	<i>noun</i><br><ol><li>(Digor) salmon</li></ol>
лӕсӕн|læsæn	<i>noun</i><br><ol><li>creek, stream</li></ol>
м|М	<i>character</i><br><ol><li>The nineteenth letter of the Ossetian alphabet, written in the Cyrillic script.</li></ol>
ма|ma	<i>particle</i><br><ol><li>(Iron, Difor) prohibitive particle</li></ol>
магъз|maǧz	<i>noun</i><br><ol><li>brain</li><li>marrow</li></ol>
мад|mad|мадӕлтӕ	<i>noun</i><br><ol><li>(Iron) mother</li></ol>
мадӕ|madæ|мадтӕлтӕ	<i>noun</i><br><ol><li>mother (Digor)</li></ol>
мадӕл|madæl	<i>adj</i><br><ol><li>female</li></ol>
майрӕмбон|majræmbon	<i>noun</i><br><ol><li>(Iron) Friday</li></ol>
майрӕнбон|majrænbon	<i>noun</i><br><ol><li>(Digor) Friday</li></ol>
маламар|malamar	<i>noun</i><br><ol><li>celery</li></ol>
малусӕг|малусӕгтӕ|málusæg|ма́лусӕг	<i>noun</i><br><ol><li>(Iron) snowdrop</li></ol>
марг|marg	<i>noun</i><br><ol><li>poison</li></ol>
маргъ|marǧ	<i>noun</i><br><ol><li>(Iron, Digor) bird</li></ol>
мард|mard	<i>adj</i><br><ol><li>dead</li></ol>
маст|mast	<i>noun</i><br><ol><li>(Iron, Digor) gall, bile</li><li>bitterness, unpleasantness, grief, vexation, anger</li></ol>
мах|max	<i>pron</i><br><ol><li>we</li></ol>
ми|mi	<i>noun</i><br><ol><li>thing</li></ol>
мигъ|miǧ	<i>noun</i><br><ol><li>fog</li><li>cloud</li></ol>
мидхӕст|midxæst	<i>noun</i><br><ol><li>civil war</li></ol>
мин|min	<i>num</i><br><ol><li>thousand</li></ol>
мит|mit	<i>noun</i><br><ol><li>snow</li></ol>
мой|moj	<i>noun</i><br><ol><li>husband</li></ol>
муд|mud	<i>noun</i><br><ol><li>(Digor) honey</li></ol>
мус|mus	<i>noun</i><br><ol><li>threshing floor</li></ol>
мыг|myg	<i>noun</i><br><ol><li>seed</li></ol>
мыд|myd	<i>noun</i><br><ol><li>(Iron) honey</li></ol>
мыдгӕрдӕг|mydgærdæg	<i>noun</i><br><ol><li>sage, Salvia</li></ol>
мыдыбындз|mydybyndz	<i>noun</i><br><ol><li>bee (insect)</li></ol>
мызд|myzd	<i>noun</i><br><ol><li>pay, wage</li></ol>
мыст|myst	<i>noun</i><br><ol><li>mouse</li></ol>
мыстахс|mystaxs	<i>noun</i><br><ol><li>(Iron) harrier</li></ol>
мӕдух|mædux	<i>noun</i><br><ol><li>(Digor) Alternative form of мӕтых (mætyx)</li></ol>
мӕй|mæj	<i>noun</i><br><ol><li>moon, month</li></ol>
мӕйбулкъ|mæjbulk’	<i>noun</i><br><ol><li>radish</li></ol>
мӕкъулӕг|mæk’ulæg	<i>noun</i><br><ol><li>lizard</li></ol>
мӕлдзыг|mælʒyg	<i>noun</i><br><ol><li>ant</li></ol>
мӕлӕт|mælæt	<i>noun</i><br><ol><li>death</li></ol>
мӕнг|mæng	<i>noun</i><br><ol><li>lie, deception, fraud</li></ol><br><i>adj</i><br><ol><li>false, fictitious, imaginary</li><li>empty</li></ol>
мӕнӕргъы|mænærǧy	<i>noun</i><br><ol><li>raspberry</li></ol>
мӕр|mær	<i>noun</i><br><ol><li>soil, earth</li></ol>
мӕсыг|mæsyg	<i>noun</i><br><ol><li>tower</li><li>minaret</li></ol>
мӕтых|mætýx|мӕты́х	<i>noun</i><br><ol><li>(Iron) locust</li></ol>
н|Н	<i>character</i><br><ol><li>The twentieth letter of the Ossetian alphabet, written in the Cyrillic script.</li></ol>
наз|naz	<i>noun</i><br><ol><li>spruce</li><li>cypress</li></ol>
найын|najyn	<i>verb</i><br><ol><li>to bathe someone</li></ol>
намыс|namys	<i>noun</i><br><ol><li>honor, glory</li></ol>
нарт|nart	<i>name</i><br><ol><li>(mythology) Nart</li></ol>
нарӕг|naræg	<i>adj</i><br><ol><li>narrow</li></ol>
нау|наутӕ|naw	<i>noun</i><br><ol><li>(Iron) ship</li></ol>
науӕ|nawæ	<i>noun</i><br><ol><li>(Digor) Alternative form of нау (naw)</li></ol>
науӕр|nawær	<i>noun</i><br><ol><li>(Digor) Alternative form of нуар (nwar)</li></ol>
ног|nog	<i>adj</i><br><ol><li>(Iron) new</li><li>(Iron) fresh</li><li>(Iron) young</li></ol>
ном|нӕмттӕ|nom	<i>noun</i><br><ol><li>name</li><li>esteem, repute</li></ol>
ностӕ|nostæ	<i>noun</i><br><ol><li>daughter-in-law</li></ol>
нуазын|nwazyn	<i>verb</i><br><ol><li>to drink</li></ol>
нуар|нуа́р|nwár|нуӕрттӕ	<i>noun</i><br><ol><li>(Iron) tendon, sinew</li></ol>
нудизм|nudizm	<i>noun</i><br><ol><li>nudism (the belief in or practice of social, non-sexual nudity).</li></ol>
нуры|nury	<i>noun</i><br><ol><li>garlic</li></ol>
ныв|nyv	<i>noun</i><br><ol><li>picture</li></ol>
ныккӕнд|nykkænd	<i>noun</i><br><ol><li>cellar, root cellar</li><li>dugout</li></ol>
нымӕт|nymæt	<i>noun</i><br><ol><li>felt</li><li>a felt cloak worn in the caucuses</li><li>burka</li></ol>
ныр|nyr	<i>adv</i><br><ol><li>now</li></ol>
ных|nyx	<i>noun</i><br><ol><li>nail, fingernail</li></ol>
нӕ|næ	<i>adv</i><br><ol><li>not</li></ol>
нӕл|næl	<i>noun</i><br><ol><li>a male</li></ol>
нӕлсӕгъ|nælsæǧ	<i>noun</i><br><ol><li>goat</li></ol>
нӕмыг|næmyg	<i>noun</i><br><ol><li>grain</li><li>seed</li><li>bullet</li></ol>
нӕуу|næwu	<i>noun</i><br><ol><li>grass</li></ol>
нӕуӕг|næwæg	<i>adj</i><br><ol><li>(Digor) new</li><li>(Digor) fresh</li><li>(Digor) young</li></ol>
о|О|o	<i>character</i><br><ol><li>The twenty-first letter of the Ossetian alphabet, written in the Cyrillic script.</li></ol>
обау|obaw	<i>noun</i><br><ol><li>burial mound, kurgan</li><li>hill</li></ol>
п|p|П	<i>character</i><br><ol><li>The twenty-second letter of the Ossetian alphabet, written in the Cyrillic script.</li></ol>
пакъуы	<i>noun</i><br><ol><li>feather</li></ol>
пиала|piala	<i>noun</i><br><ol><li>cup</li></ol>
пил|pil	<i>noun</i><br><ol><li>(Digor) elephant</li></ol>
пириндз|pirinʒ	<i>noun</i><br><ol><li>(Digor) rice</li></ol>
поезд|poezd	<i>noun</i><br><ol><li>train</li></ol>
порнографи|pornografi	<i>noun</i><br><ol><li>pornography</li></ol>
пъ|p’|Пъ	<i>character</i><br><ol><li>The twenty-third letter of the Ossetian alphabet, written in the Cyrillic script.</li></ol>
пъӕнӕз|p’ænæz	<i>noun</i><br><ol><li>adze, hatchet</li></ol>
пыл|pyl	<i>noun</i><br><ol><li>(Iron) elephant</li></ol>
пырындз|пыры́ндз|pyrýnʒ	<i>noun</i><br><ol><li>(Iron) rice</li></ol>
р|r|Р	<i>character</i><br><ol><li>The twenty-fourth letter of the Ossetian alphabet, written in the Cyrillic script.</li></ol>
рагон|ragon	<i>adj</i><br><ol><li>ancient</li></ol>
рад|rad|рæдтæ	<i>noun</i><br><ol><li>(Iron) order; turn</li></ol>
райсом|rajsom	<i>noun</i><br><ol><li>morning</li><li>tomorrow</li></ol>
раст|rast	<i>adv</i><br><ol><li>truly, honestly</li><li>correctly</li><li>directly</li><li>just ...</li></ol><br><i>adj</i><br><ol><li>true, honest, credible</li><li>correct, righteous</li><li>exact</li><li>straight</li><li>fair</li><li>direct</li></ol><br><i>noun</i><br><ol><li>truth</li></ol>
расыг|rasyg	<i>adj</i><br><ol><li>drunk</li></ol>
раттын|rattyn	<i>verb</i><br><ol><li>(Iron) to give, render to, present with</li><li>to bestow, grant, confer</li></ol>
рахиз|raxiz	<i>adj</i><br><ol><li>right</li></ol>
риу|riw	<i>noun</i><br><ol><li>breast</li></ol>
робас|robas	<i>noun</i><br><ol><li>(Digor) fox</li></ol>
рог|rog	<i>adj</i><br><ol><li>light (of weight)</li></ol>
рон|ron	<i>noun</i><br><ol><li>belt, sash</li><li>bosom</li></ol>
роцъо|roc’o	<i>noun</i><br><ol><li>(Iron, Digor) chin</li><li>(Digor) a small beard</li></ol>
рувас|ruvas	<i>noun</i><br><ol><li>(Iron) fox</li></ol>
рудзынг|rudzyng	<i>noun</i><br><ol><li>window</li></ol>
рухс|ruxs	<i>noun</i><br><ol><li>light</li></ol>
ручкӕ|ruḱkæ	<i>noun</i><br><ol><li>pen</li></ol>
рыг|ryg	<i>noun</i><br><ol><li>dust</li><li>(botany) pollen</li></ol>
рыст|ryst	<i>noun</i><br><ol><li>pain</li></ol>
рӕдовун|rædovun	<i>verb</i><br><ol><li>(Digor) Alternative form of рӕдувын (ræduvyn)</li></ol>
рӕдувын|rædúvyn|рӕду́вын	<i>verb</i><br><ol><li>(Iron) to pull out</li><li>(Iron) to scratch</li></ol>
рӕзӕ|ræzæ	<i>noun</i><br><ol><li>fruit</li></ol>
рӕйын|ræjyn	<i>verb</i><br><ol><li>to bark</li></ol>
рӕстдзийнадӕ|ræstdzijnadæ	<i>noun</i><br><ol><li>(Digor) truth, justice</li></ol>
рӕстдзинад|ræstdzinad	<i>noun</i><br><ol><li>(Iron) truth, justice</li></ol>
рӕтӕн|rætæn	<i>noun</i><br><ol><li>rope</li></ol>
рӕхджы|ræxǵy	<i>adv</i><br><ol><li>soon</li></ol>
с|С	<i>character</i><br><ol><li>The twenty-fifth letter of the Ossetian alphabet, written in the Cyrillic script.</li></ol>
сабат|sabat	<i>noun</i><br><ol><li>Saturday</li></ol>
саби|sabi	<i>noun</i><br><ol><li>baby</li><li>little child</li></ol>
сабыр|sabyr	<i>adj</i><br><ol><li>quiet, peaceful</li><li>silent, noiseless</li></ol>
саг|sag	<i>noun</i><br><ol><li>deer</li></ol>
сакъадах|saqadax	<i>noun</i><br><ol><li>island</li></ol>
сапон|sapon	<i>noun</i><br><ol><li>soap</li></ol>
саргъ|sarǧ	<i>noun</i><br><ol><li>saddle</li></ol>
сарӕзт|saræzt	<i>noun</i><br><ol><li>construction, building</li><li>formation, creation</li></ol>
сау|sáu|са́у	<i>adj</i><br><ol><li>(Iron, Digor) black</li></ol>
сахар|saxar	<i>noun</i><br><ol><li>town</li><li>city</li></ol>
сахат|saxat	<i>noun</i><br><ol><li>hour</li><li>clock, watch (instrument used to measure or keep track of time)</li></ol>
сиахс|сиæхстæ|siaxs	<i>noun</i><br><ol><li>son-in-law</li></ol>
сисамайӕг|sisamajæg	<i>noun</i><br><ol><li>stonemason</li></ol>
скувын|skuvyn	<i>verb</i><br><ol><li>to pray</li></ol>
скъӕт|sk’æt	<i>noun</i><br><ol><li>barn, stable, cowshed, pigsty, enclosure or roof for livestock</li></ol>
сойджын|sojǵyn	<i>adj</i><br><ol><li>fat</li><li>oily</li><li>fertile</li></ol>
сомех|somex	<i>noun</i><br><ol><li>(Digor) the Armenians</li></ol>
сомехаг|сомехӕгтӕ|somexag	<i>noun</i><br><ol><li>(Digor) Alternative form of сомихаг (somixag)</li></ol><br><i>adj</i><br><ol><li>(Digor) Alternative form of сомихаг (somixag)</li></ol>
сомих|somix	<i>noun</i><br><ol><li>the Armenians</li></ol>
сомихаг|сомихӕгтӕ|somixag	<i>noun</i><br><ol><li>(Iron) an Armenian person</li></ol><br><i>adj</i><br><ol><li>(Iron) Armenian</li></ol>
сор|sor	<i>adj</i><br><ol><li>(Digor) dry.</li></ol>
ставд|stavd	<i>adj</i><br><ol><li>thick</li></ol>
старц|starc	<i>noun</i><br><ol><li>(iron) mace (weapon)</li></ol>
стонг|stong	<i>adj</i><br><ol><li>hungry</li></ol><br><i>noun</i><br><ol><li>hunger</li></ol>
стъалы|st'aly	<i>noun</i><br><ol><li>star</li></ol>
стыг|styg	<i>noun</i><br><ol><li>lock of hair</li></ol>
стын|styn	<i>verb</i><br><ol><li>to stand up</li></ol>
стыр|styr	<i>adj</i><br><ol><li>large, great, big</li></ol>
стӕг|stæg	<i>noun</i><br><ol><li>bone</li></ol>
судзин|suʒin	<i>noun</i><br><ol><li>needle</li></ol>
судзын|suʒyn	<i>verb</i><br><ol><li>to burn (consumed by fire)</li></ol>
сурӕт|suræt	<i>noun</i><br><ol><li>picture</li></ol>
сусхъӕд|susqæd	<i>noun</i><br><ol><li>lime tree</li></ol>
сыгъд|syǧd	<i>noun</i><br><ol><li>(Iron) flame, fire</li></ol>
сыгъзӕрин|syǧzærin	<i>noun</i><br><ol><li>gold</li></ol>
сызгъӕрин|syzǧærin	<i>noun</i><br><ol><li>gold</li></ol>
сыкъа|syk’a	<i>noun</i><br><ol><li>horn</li></ol>
сымах|symax	<i>pron</i><br><ol><li>you</li></ol>
сырх|syrx	<i>adj</i><br><ol><li>red</li></ol>
сысджы|sysǵy	<i>noun</i><br><ol><li>oats</li></ol>
сыст|syst	<i>noun</i><br><ol><li>louse</li></ol>
сыстын|systyn	<i>verb</i><br><ol><li>to stand up</li></ol>
сыф|syf	<i>noun</i><br><ol><li>(botany) leaf</li></ol>
сычъи	<i>noun</i><br><ol><li>chamois</li></ol>
сӕгъ|sæǧ	<i>noun</i><br><ol><li>goat</li></ol>
сӕдӕ|sædæ	<i>num</i><br><ol><li>hundred</li></ol>
сӕкӕр|sækær	<i>noun</i><br><ol><li>sugar</li></ol>
сӕмӕн|sæmæn	<i>noun</i><br><ol><li>axle</li></ol>
сӕндон|sændon	<i>noun</i><br><ol><li>vineyard</li><li>wine cellar</li><li>wine store</li></ol>
сӕнк|sænk	<i>noun</i><br><ol><li>hogweed, Heracleum</li></ol>
сӕр|сӕрӕы|сӕрaу|сӕримӕ|сӕртӕ|сӕрмӕ|сӕрӕн|сӕртыл|сӕртӕы|сӕры|сӕртӕм|sær|сӕртимӕ|сӕртӕн|сӕрты|сӕртaу|сӕрыл	<i>noun</i><br><ol><li>(anatomy) head</li><li>roof</li><li>lid, cover</li><li>top, summit</li><li>beginning</li><li>occasion, cause, reason</li></ol>
сӕрвӕтты|særvætty	<i>noun</i><br><ol><li>pasture</li></ol>
сӕрд|særd	<i>noun</i><br><ol><li>(Iron) summer</li></ol>
сӕрдӕ|særdæ	<i>noun</i><br><ol><li>(Digor) Alternative form of сӕрд (særd)</li></ol>
сӕттын|sættyn	<i>verb</i><br><ol><li>to break (to cause to break)</li></ol>
сӕтӕлӕг|sætælæg	<i>noun</i><br><ol><li>snail</li></ol>
сӕфтӕг|sæftæg	<i>noun</i><br><ol><li>hoof</li></ol>
т|Т|t	<i>character</i><br><ol><li>The twenty-sixth letter of the Ossetian alphabet, written in the Cyrillic script.</li></ol>
тавын|tavyn	<i>verb</i><br><ol><li>to warm</li></ol>
тайын|tajyn	<i>verb</i><br><ol><li>to melt</li></ol>
тамако|tamako	<i>noun</i><br><ol><li>tobacco</li></ol>
тар|tar	<i>adj</i><br><ol><li>dark</li></ol>
тас|tas	<i>noun</i><br><ol><li>fear</li></ol>
тауын|tawyn	<i>verb</i><br><ol><li>to sow</li></ol>
тел|tel	<i>noun</i><br><ol><li>wire</li><li>telegram</li></ol>
теуа|tewa	<i>noun</i><br><ol><li>camel</li></ol>
тинт|tint	<i>noun</i><br><ol><li>squirrel</li><li>sable</li></ol>
тог|tog	<i>noun</i><br><ol><li>(Digor) blood</li></ol>
топп|topp	<i>noun</i><br><ol><li>rifle</li></ol>
ту|tu	<i>noun</i><br><ol><li>spit, spittle</li></ol>
ту кӕнын|tu kænyn	<i>verb</i><br><ol><li>to spit</li></ol>
туг|tug	<i>noun</i><br><ol><li>(Iron) blood</li></ol>
тулдз|tulʒ	<i>noun</i><br><ol><li>oak</li></ol>
туруса|turusa	<i>noun</i><br><ol><li>(Digor) flag</li></ol>
тута|tuta	<i>noun</i><br><ol><li>mulberry tree</li><li>mulberry fruit</li></ol>
тути|tuti	<i>noun</i><br><ol><li>parrot</li></ol>
тъ|Тъ|t’	<i>character</i><br><ol><li>The twenty-seventh letter of the Ossetian alphabet, written in the Cyrillic script.</li></ol>
тымыгъ|tymyǧ	<i>noun</i><br><ol><li>snowstorm</li></ol>
тыргъ|tyrǧ	<i>noun</i><br><ol><li>(Iron) porch, veranda, vestibule</li></ol>
тырты|tyrty	<i>noun</i><br><ol><li>barberry</li></ol>
тырын|tyryn	<i>noun</i><br><ol><li>(Iron) baby; adolescent, youth, boy</li></ol>
тырыса|tyrýsa|тыры́са	<i>noun</i><br><ol><li>(Iron) flag</li></ol>
тӕвд|tævd	<i>adj</i><br><ol><li>hot</li></ol>
тӕнӕг|tænæg	<i>adj</i><br><ol><li>thin</li></ol>
тӕраз|tæraz	<i>noun</i><br><ol><li>scales, balance</li></ol>
тӕрин|tærin	<i>noun</i><br><ol><li>(Digor) adolescent, youth, boy</li></ol>
тӕрс|tærs|тӕрсимӕ|тӕрсӕн|тӕрсытӕн|тӕрсау|тӕрсытӕ|тӕрсыл|тӕрсытимӕ|тӕрсы|тӕрсытыл|тӕрсытау|тӕрсмӕ|тӕрсыты|тӕрсытӕй|тӕрсытӕм|тӕрсӕй	<i>noun</i><br><ol><li>beech</li><li>plane, Platanus</li></ol>
тӕрхъос|tærqos	<i>noun</i><br><ol><li>(Digor) Alternative form of тӕрхъус (tærqus)</li></ol>
тӕрхъус|tærqús|тӕрхъу́с	<i>noun</i><br><ol><li>(Iron) hare</li></ol>
у|У|u	<i>character</i><br><ol><li>The twenty-eighth letter of the Ossetian alphabet, written in the Cyrillic script.</li></ol>
уæрдон|uærdon	<i>noun</i><br><ol><li>cart, carriage</li></ol>
уагъылы|waǧyly	<i>noun</i><br><ol><li>rosehip</li></ol>
уад|wad	<i>noun</i><br><ol><li>wind</li></ol>
уазал|wazal	<i>adj</i><br><ol><li>cold</li></ol>
уазӕг|wazæg	<i>noun</i><br><ol><li>guest</li></ol>
уалдзӕг|walʒæg	<i>noun</i><br><ol><li>spring-time</li></ol>
уарди|wardi	<i>noun</i><br><ol><li>rose</li></ol>
уари|wari	<i>noun</i><br><ol><li>falcon</li></ol>
уарт|wart	<i>noun</i><br><ol><li>(Iron, Digor) shield</li></ol>
уарын|wáryn|уа́рын	<i>verb</i><br><ol><li>(Iron) to rain</li><li>(Iron) to fall (of precipitation)</li></ol><br><i>noun</i><br><ol><li>(Iron) rain</li></ol>
уат|уæттæ|уа́т|wat	<i>noun</i><br><ol><li>room</li><li>bed</li><li>bedroom</li></ol>
уафын|wafyn	<i>verb</i><br><ol><li>to weave</li></ol>
уафынад|wafynad	<i>noun</i><br><ol><li>weaving</li></ol>
уд|ud	<i>noun</i><br><ol><li>soul</li></ol>
узун|uzun	<i>noun</i><br><ol><li>(Digor) hedgehog</li></ol>
уисой|wisoj	<i>noun</i><br><ol><li>broom</li></ol>
урдӕ|урдитӕ|urdæ	<i>noun</i><br><ol><li>(Digor) otter</li></ol>
урс|urs	<i>adj</i><br><ol><li>white</li></ol>
ус|us	<i>noun</i><br><ol><li>woman</li></ol>
уыг|wyg	<i>noun</i><br><ol><li>(Iron) owl</li></ol>
уызын|wyzýn|уызы́н	<i>noun</i><br><ol><li>(Iron) hedgehog</li></ol>
уый|wyj	<i>pron</i><br><ol><li>he</li></ol>
уын|wyn	<i>verb</i><br><ol><li>to be</li></ol>
уынын|wynyn	<i>verb</i><br><ol><li>see</li></ol>
уыр|wyr	<i>noun</i><br><ol><li>cobble, pebble, gravel, crushed stone</li><li>(geology) detritus</li></ol>
уырг|wyrg	<i>noun</i><br><ol><li>kidney</li></ol>
уырд|уырдтæ|wyrd	<i>noun</i><br><ol><li>(Iron) otter</li></ol>
уыриын|wyriyn	<i>verb</i><br><ol><li>to believe</li></ol>
уыры|уырытӕ|wyry	<i>noun</i><br><ol><li>rat</li></ol>
уырыдзы|wyryʒy	<i>noun</i><br><ol><li>(Iron) carrot</li></ol>
уыцы|wycy	<i>pron</i><br><ol><li>that, that one</li></ol>
уӕз|wæz	<i>noun</i><br><ol><li>weight</li></ol>
уӕззау|wæzzaw	<i>adj</i><br><ol><li>heavy</li></ol>
уӕлдзарм|wælʒarm	<i>noun</i><br><ol><li>sheepskin</li></ol>
уӕллаг|wællág|уæлла́г	<i>adj</i><br><ol><li>upper</li></ol>
уӕнг|wæng	<i>noun</i><br><ol><li>member</li></ol>
уӕрм|wærm	<i>noun</i><br><ol><li>pit</li></ol>
уӕрцц|wærcc	<i>noun</i><br><ol><li>quail</li></ol>
уӕрыкк|wærykk	<i>noun</i><br><ol><li>lamb</li></ol>
уӕрӕх|wæræx	<i>adj</i><br><ol><li>wide</li></ol>
уӕхск|wæxsk	<i>noun</i><br><ol><li>shoulder</li></ol>
ф|Ф	<i>character</i><br><ol><li>The twenty-ninth letter of the Ossetian alphabet, written in the Cyrillic script.</li></ol>
фалер|faler	<i>noun</i><br><ol><li>trout</li></ol>
фараст|farast	<i>num</i><br><ol><li>nine</li></ol>
фарн|farn	<i>noun</i><br><ol><li>peace, tranquility</li><li>happiness</li><li>abundance, well-being, prosperity</li></ol>
фарс|fars|фӕрстӕ́	<i>noun</i><br><ol><li>(Iron, Digor) side</li><li>(Iron, Digor) page</li><li>(Iron, Digor) wall</li><li>(Iron, Digor) shore</li></ol>
фарст|farst	<i>noun</i><br><ol><li>question</li></ol>
фарста|farsta	<i>noun</i><br><ol><li>question</li></ol>
фат|fat	<i>noun</i><br><ol><li>arrow</li></ol>
фатер|fater	<i>noun</i><br><ol><li>apartment</li></ol>
фатхъӕд|fatqæd	<i>noun</i><br><ol><li>hornbeam</li></ol>
фехъусын|fequsyn	<i>verb</i><br><ol><li>(Iron) to hear</li></ol>
фидар|fidar	<i>noun</i><br><ol><li>stronghold, bulwark, holdout</li><li>fort, fortification, citadel</li><li>guarantee</li><li>endurance</li><li>protector, patron, defender</li></ol>
фидын|fidyn	<i>verb</i><br><ol><li>pay</li></ol>
фидӕ|фидтӕлтӕ|fidæ	<i>noun</i><br><ol><li>(Digor) father</li></ol>
фий|fij	<i>noun</i><br><ol><li>(Digor) nose</li><li>(Digor) tip</li><li>(Digor) edge, point</li></ol>
фиййау|fijjaw	<i>noun</i><br><ol><li>shepherd</li></ol>
фист|fist	<i>noun</i><br><ol><li>wool (from the spring shearing)</li></ol>
фондз|fonʒ	<i>num</i><br><ol><li>five</li></ol>
фонс|fons	<i>noun</i><br><ol><li>(Digor) cattle</li><li>(Digor) property; goods; wealth</li><li>(Digor) booty, spoil</li></ol>
фос|fos	<i>noun</i><br><ol><li>(Iron) cattle</li><li>(Iron) property; goods; wealth</li></ol>
фугӕ|fugæ	<i>noun</i><br><ol><li>rhododendron, (Rhododendron caucasicum)</li></ol>
фурд|furd	<i>noun</i><br><ol><li>sea</li><li>big river</li></ol>
фыд|фыдтӕ|fyd|фыдӕлтӕ	<i>noun</i><br><ol><li>meat</li><li>millstone</li><li>father</li><li>evil, pest</li><li>fault</li></ol><br><i>adj</i><br><ol><li>bad, evil</li></ol>
фыдгул|fydgul	<i>noun</i><br><ol><li>enemy</li></ol>
фыдлӕг|fydlæg	<i>noun</i><br><ol><li>monster</li></ol>
фын|fyn	<i>noun</i><br><ol><li>dream</li></ol>
фындз|fynʒ|фындзтӕ	<i>noun</i><br><ol><li>(Iron) nose</li><li>(Iron) tip</li><li>(Iron) edge, point</li></ol>
фынк|fynk	<i>noun</i><br><ol><li>foam</li></ol>
фыр|фырытæ|fyr	<i>adv</i><br><ol><li>very</li><li>extremely</li></ol><br><i>noun</i><br><ol><li>ram</li></ol>
фыранк|fyrank	<i>noun</i><br><ol><li>(Iron) leopard, snow leopard</li></ol>
фырт|fyrt	<i>noun</i><br><ol><li>son</li></ol>
фыс|fys	<i>noun</i><br><ol><li>sheep</li></ol>
фыссын|fyssyn	<i>verb</i><br><ol><li>to write</li></ol>
фыцын|fycyn	<i>verb</i><br><ol><li>to cook</li></ol>
фӕд|fæd	<i>noun</i><br><ol><li>footstep</li><li>trace</li></ol>
фӕзгон|fæzgon	<i>noun</i><br><ol><li>udder</li></ol>
фӕздӕг|fæzdæg	<i>noun</i><br><ol><li>smoke</li></ol>
фӕздӕгдзон|fæzdægʒon	<i>noun</i><br><ol><li>chimney</li></ol>
фӕззӕг|fæzzæg	<i>noun</i><br><ol><li>autumn</li></ol>
фӕзуат|fæzwat	<i>noun</i><br><ol><li>area</li></ol>
фӕлдзӕгъдӕн|fælʒæǧdæn	<i>noun</i><br><ol><li>(Iron, Digor) snowstorm, squall, blizzard</li></ol>
фӕлывд|fælyvd	<i>noun</i><br><ol><li>deceit, deception</li></ol>
фӕнд|fænd	<i>noun</i><br><ol><li>advice, counsel</li><li>thought, intention</li><li>will</li><li>decision</li></ol>
фӕндаг|fændag	<i>noun</i><br><ol><li>way</li></ol>
фӕндӕг|fændæg	<i>noun</i><br><ol><li>way</li></ol>
фӕрв|færv	<i>noun</i><br><ol><li>alder</li></ol>
фӕрск|færsk	<i>noun</i><br><ol><li>rib</li></ol>
фӕрӕт|færæt	<i>noun</i><br><ol><li>axe</li></ol>
фӕсм|fæsm	<i>noun</i><br><ol><li>wool</li></ol>
фӕсонтӕ|fæsontæ	<i>noun</i><br><ol><li>the back</li></ol>
фӕткъу|fætk’u	<i>noun</i><br><ol><li>(Digor) Alternative form of фӕткъуы (fætk’°y)</li></ol>
фӕткъуы	<i>noun</i><br><ol><li>(Iron) apple</li></ol>
фӕтӕг|fætæg	<i>noun</i><br><ol><li>leader</li></ol>
фӕтӕн|fætæn	<i>noun</i><br><ol><li>width</li></ol>
х|Х|x	<i>character</i><br><ol><li>The thirtieth letter of the Ossetian alphabet, written in the Cyrillic script.</li></ol>
хабар|xabar	<i>noun</i><br><ol><li>news</li><li>event, happening, occurrence</li></ol>
халон|xalon	<i>noun</i><br><ol><li>crow</li></ol>
хид|хед|xid|xed	<i>noun</i><br><ol><li>bridge</li><li>sweat</li></ol>
хо|xo	<i>noun</i><br><ol><li>(Iron) sister</li></ol>
хом|xom	<i>adj</i><br><ol><li>raw</li></ol>
хонын|xonyn	<i>verb</i><br><ol><li>to call</li></ol>
хор|xor	<i>noun</i><br><ol><li>(Digor) sun</li></ol>
хорз|xorz	<i>adj</i><br><ol><li>good</li></ol>
хос|xos	<i>noun</i><br><ol><li>medicine, drug</li><li>remedy</li><li>cure</li><li>hay</li></ol>
хох|хæхтæ|xox	<i>noun</i><br><ol><li>mountain</li></ol>
худ|xud	<i>noun</i><br><ol><li>hat</li></ol>
худын|xudyn	<i>verb</i><br><ol><li>to laugh</li></ol>
хуийын|xwijyn	<i>verb</i><br><ol><li>to sew</li></ol>
хур|xur	<i>noun</i><br><ol><li>(Iron) sun</li></ol>
хус|xus	<i>adj</i><br><ol><li>dry</li></ol>
хуцау|хуцæуттæ|xucaw	<i>noun</i><br><ol><li>(Digor) god</li></ol>
хуцаубон|xucawbon	<i>noun</i><br><ol><li>(Digor) Sunday</li></ol>
хуы	<i>noun</i><br><ol><li>pig</li></ol>
хуыдырбулкъ	<i>noun</i><br><ol><li>turnip</li></ol>
хуылф	<i>noun</i><br><ol><li>chickpeas</li></ol>
хуымӕллӕг	<i>noun</i><br><ol><li>(Iron) hop (plant)</li></ol>
хуыссын	<i>verb</i><br><ol><li>to sleep</li></ol>
хуыцау|хуыца́у|хуыцæуттæ	<i>noun</i><br><ol><li>(Iron) god</li></ol>
хуыцаубон	<i>noun</i><br><ol><li>(Iron) Sunday</li></ol>
хуӕрӕ|хуӕртӕ|xwæræ	<i>noun</i><br><ol><li>(Digor) sister</li></ol>
хъ|q|Хъ	<i>character</i><br><ol><li>The thirty-first letter of the Ossetian alphabet, written in the Cyrillic script.</li></ol>
хъаз|qaz	<i>noun</i><br><ol><li>goose</li></ol>
хъалон|qalon	<i>noun</i><br><ol><li>(Iron, Digor) tax, levy</li><li>tribute</li></ol>
хъама|qama	<i>noun</i><br><ol><li>dagger</li></ol>
хъарм|qarm	<i>adj</i><br><ol><li>warm, hot</li></ol>
хъауа|qawa	<i>noun</i><br><ol><li>coffee</li></ol>
хъис|qis	<i>noun</i><br><ol><li>(Iron) bristle</li><li>(Iron) string</li></ol>
хъомгӕс|qomgæs	<i>noun</i><br><ol><li>shepherd</li></ol>
хъонтхора|qontxora	<i>noun</i><br><ol><li>dill</li></ol>
хъуг|x”ug	<i>noun</i><br><ol><li>(Iron) cow</li></ol>
хъул|qul	<i>noun</i><br><ol><li>(anatomy) vertebra</li><li>pit, stone</li><li>sphere</li><li>bone</li></ol>
хъус|qus	<i>noun</i><br><ol><li>ear</li></ol>
хъусын|qusyn	<i>verb</i><br><ol><li>to hear</li></ol>
хъуын|qwyn	<i>noun</i><br><ol><li>hair, wool, the fleece of one sheep</li></ol>
хъуыр|qwyr	<i>noun</i><br><ol><li>throat</li><li>neck</li></ol>
хъызылбаш|qyzylbaš	<i>noun</i><br><ol><li>a Qizilbash</li></ol>
хъӕд|qæd	<i>noun</i><br><ol><li>wood</li></ol>
хъӕдабӕ|qædabæ	<i>noun</i><br><ol><li>velvet</li></ol>
хъӕдур|qædur	<i>noun</i><br><ol><li>lentil</li></ol>
хъӕдурхос|qædurxos	<i>noun</i><br><ol><li>vetch</li></ol>
хъӕдындз|qædynʒ	<i>noun</i><br><ol><li>onion</li></ol>
хъӕздыг|qæzdyg	<i>adj</i><br><ol><li>rich</li></ol>
хъӕлӕс|qælǽs|хъӕлӕ́с	<i>noun</i><br><ol><li>(Iron) voice</li></ol>
хӕбозӕ|xæbozæ	<i>noun</i><br><ol><li>chicken pox (Digor)</li></ol>
хӕбуз|xæbuz	<i>noun</i><br><ol><li>chicken pox (Iron)</li></ol>
хӕзна|xæzna	<i>noun</i><br><ol><li>treasure</li></ol>
хӕлаф|xælaf	<i>noun</i><br><ol><li>trousers</li></ol>
хӕлын|xælyn	<i>noun</i><br><ol><li>leather, calfskin, sheepskin</li></ol>
хӕлынбыттыр|xælynbyttyr	<i>noun</i><br><ol><li>(Iron) bat</li></ol>
хӕрд|xærd	<i>noun</i><br><ol><li>(Iron) food</li><li>slope, rise</li></ol>
хӕрис|xæris	<i>noun</i><br><ol><li>willow</li></ol>
хӕрын|xæryn	<i>verb</i><br><ol><li>to eat</li></ol>
хӕрӕг|xæræg	<i>noun</i><br><ol><li>donkey</li></ol>
хӕст|hæst	<i>noun</i><br><ol><li>war</li></ol>
хӕтӕл|xætæl	<i>noun</i><br><ol><li>(Iron, Digor) stem, stalk</li><li>chimney, pipe, hose</li><li>cane</li><li>barrel (of a gun)</li><li>(Digor) fife, pipe</li></ol>
хӕфс|xæfs	<i>noun</i><br><ol><li>(Iron) frog</li></ol>
хӕцӕнгарз|xæcængarz	<i>noun</i><br><ol><li>weapon, arms</li></ol>
ц|c|Ц	<i>character</i><br><ol><li>The thirty-second letter of the Ossetian alphabet, written in the Cyrillic script.</li></ol>
цав|cav	<i>noun</i><br><ol><li>ceiling</li></ol>
цад|cad	<i>noun</i><br><ol><li>lake</li></ol>
цалх|calx	<i>noun</i><br><ol><li>wheel</li></ol>
цанс|cans	<i>noun</i><br><ol><li>(Digor) loop (of a snare, bashlyk, or while weaving); noose; snare</li></ol>
царм|carm	<i>noun</i><br><ol><li>skin, hide</li></ol>
цасм|casm	<i>noun</i><br><ol><li>(Iron) loop (of a snare, bashlyk, or while weaving); noose; snare</li></ol>
цатыр|catyr	<i>noun</i><br><ol><li>tent</li></ol>
цирт|cirt	<i>noun</i><br><ol><li>grave</li></ol>
цирхъ|cirq	<i>noun</i><br><ol><li>sword</li></ol>
цонг|цæнгтæ|cong	<i>noun</i><br><ol><li>(anatomy) arm</li></ol>
цуан|cwan	<i>noun</i><br><ol><li>hunt</li></ol>
цуанон|cwanon	<i>noun</i><br><ol><li>hunter</li></ol>
цуппӕрӕн|cuppæræn	<i>noun</i><br><ol><li>(Digor) Thursday</li></ol>
цухъхъа|cuqqa	<i>noun</i><br><ol><li>chokha, Circassian coat</li></ol>
цъ|Цъ|c’	<i>character</i><br><ol><li>The thirty-third letter of the Ossetian alphabet, written in the Cyrillic script.</li></ol>
цъай|c’aj	<i>noun</i><br><ol><li>a well</li></ol>
цъахгӕр|c’axgær	<i>noun</i><br><ol><li>comfrey</li></ol>
цъыдагъ|c’ydaǧ	<i>noun</i><br><ol><li>tar</li></ol>
цъыф|c’yf	<i>noun</i><br><ol><li>(Iron) mud, puddle, slush</li></ol>
цъыфдзаст|c’yfʒast	<i>noun</i><br><ol><li>bog, marsh, swamp, quagmire</li></ol>
цъӕх|c’æx	<i>adj</i><br><ol><li>green</li></ol>
цъӕхдидин|c’æxdidin	<i>noun</i><br><ol><li>Echium</li></ol>
цы|cy	<i>pron</i><br><ol><li>what</li></ol>
цыллӕ|cyllæ	<i>noun</i><br><ol><li>(raw unprocessed) silk</li></ol>
цыппар|cyppar	<i>num</i><br><ol><li>four</li></ol>
цыппӕрӕм	<i>noun</i><br><ol><li>(Iron) Thursday</li></ol>
цырагъ|cyraǧ	<i>noun</i><br><ol><li>lamp, candle</li></ol>
цыргъ|cyrǧ	<i>adj</i><br><ol><li>sharp</li></ol>
цырт|cyrt	<i>noun</i><br><ol><li>gravestone</li><li>monument</li></ol>
цыхт|cyxt	<i>noun</i><br><ol><li>cheese</li></ol>
цӕргӕс|cærgæs	<i>noun</i><br><ol><li>eagle</li></ol>
цӕрын|cæryn	<i>verb</i><br><ol><li>(Iron) to live</li></ol>
цӕсгом|cæsgom	<i>noun</i><br><ol><li>face</li></ol>
цӕст|cæst	<i>noun</i><br><ol><li>eye (organ of sight)</li></ol>
цӕу|cæw	<i>noun</i><br><ol><li>(Iron, Digor) goat (uncastrated)</li></ol>
цӕугӕдон|cæwgædon|цӕугӕдӕттӕ	<i>noun</i><br><ol><li>river</li></ol>
цӕуын|cæwyn	<i>verb</i><br><ol><li>to walk, to go</li></ol>
цӕфхад|cæfxad	<i>noun</i><br><ol><li>horseshoe</li></ol>
цӕхх|cæxx	<i>noun</i><br><ol><li>salt</li></ol>
ч|ḱ|Ч	<i>character</i><br><ol><li>The thirty-fourth letter of the Ossetian alphabet, written in the Cyrillic script.</li></ol>
чеса|ḱesa	<i>noun</i><br><ol><li>box tree, Buxus</li></ol>
чи|кæуылты|кæмæнты|кæимæты|кæмыты|кæйты|кæмæй|кæмæйты|кæуыл|кæимæ|кæйау|кæмæн|кæмæ|кæмæты|читæ|кæм|ḱi|кæй|чемæ	<i>pron</i><br><ol><li>who</li></ol>
чиныг|чи́ныг|ḱínyg|чингуытӕ	<i>noun</i><br><ol><li>(Iron) book</li><li>(Iron, archaic) letter, writing; document</li></ol>
чъ|Чъ|ḱ’	<i>character</i><br><ol><li>The thirty-fifth letter of the Ossetian alphabet, written in the Cyrillic script.</li></ol>
чъерами|къерами|k’erami	<i>noun</i><br><ol><li>apricot</li></ol>
чъирифыссӕн	<i>noun</i><br><ol><li>mallow</li></ol>
чъиу	<i>noun</i><br><ol><li>resin, rosin, pitch</li><li>gum</li></ol>
чъыр	<i>noun</i><br><ol><li>(Iron) lime, calcium oxide</li></ol>
чъырдур	<i>noun</i><br><ol><li>limestone</li></ol>
чызг|ḱyzg	<i>noun</i><br><ol><li>girl</li><li>daughter</li></ol>
чылауи|ḱylawi	<i>noun</i><br><ol><li>plum</li></ol>
ш|Ш|š	<i>character</i><br><ol><li>The thirty-sixth letter of the Ossetian alphabet, written in the Cyrillic script.</li></ol>
щ|Щ|šč	<i>character</i><br><ol><li>The thirty-seventh letter of the Ossetian alphabet, written in the Cyrillic script.</li></ol>
ъ|Ъ|ʺ	<i>character</i><br><ol><li>The thirty-eighth letter of the Ossetian alphabet, written in the Cyrillic script.</li></ol>
ы|y|Ы	<i>character</i><br><ol><li>The thirty-ninth letter of the Ossetian alphabet, written in the Cyrillic script.</li></ol>
ь|Ь	<i>character</i><br><ol><li>The fortieth letter of the Ossetian alphabet, written in the Cyrillic script.</li></ol>
э|Э|è	<i>character</i><br><ol><li>The forty-first letter of the Ossetian alphabet, written in the Cyrillic script.</li></ol>
ю|Ю|ju	<i>character</i><br><ol><li>The forty-second letter of the Ossetian alphabet, written in the Cyrillic script.</li></ol>
я|ja|Я	<i>character</i><br><ol><li>The forty-third letter of the Ossetian alphabet, written in the Cyrillic script.</li></ol>
ё|Ё|ë	<i>character</i><br><ol><li>The eleventh letter of the Ossetian alphabet, written in the Cyrillic script.</li></ol>
Ӕ|æ|ӕ|Æ	<i>character</i><br><ol><li>The second letter of the Ossetian alphabet, written in the Cyrillic script.</li></ol>
ӕ|æ|Ӕ|Æ	<i>character</i><br><ol><li>The second letter of the Ossetian alphabet, written in the Cyrillic script.</li></ol>
ӕвзаг|ӕвза́г|ӕвзӕгтӕ|ævzág	<i>noun</i><br><ol><li>language</li><li>sting</li></ol>
ӕвзалы|ævzaly	<i>noun</i><br><ol><li>coal</li></ol>
ӕвзист|ævzist	<i>noun</i><br><ol><li>(Iron) silver</li><li>(Digor) a wave, gesture</li><li>an insulting gesture</li></ol>
ӕвзонг|ævzong	<i>adj</i><br><ol><li>young</li></ol>
ӕвзӕр|ævzær	<i>adj</i><br><ol><li>bad</li></ol>
ӕврагъ|ævraǧ	<i>noun</i><br><ol><li>cloud</li></ol>
ӕвӕрӕн|æværæn	<i>noun</i><br><ol><li>cellar, storeroom</li><li>supply, reserves</li><li>savings</li></ol>
ӕгас|ægas	<i>adj</i><br><ol><li>whole</li></ol>
ӕда|æda	<i>noun</i><br><ol><li>grandfather</li></ol>
ӕддаг|æddag	<i>adj</i><br><ol><li>outer</li><li>outside</li></ol>
ӕз|æz	<i>pron</i><br><ol><li>I</li></ol>
ӕлдар|ældar	<i>noun</i><br><ol><li>lord, master, ruler, landowner, grandee</li><li>(zoology) queen bee</li><li>(Digor) prince</li></ol>
ӕлутон|ӕлу́тон|ælúton	<i>noun</i><br><ol><li>(Iron, Digor) a kind of beer</li></ol>
ӕлыг|ælyg	<i>noun</i><br><ol><li>clay</li></ol>
ӕмбонд|æmbond	<i>noun</i><br><ol><li>fence</li></ol>
ӕмбӕрзын|æmbærzyn	<i>verb</i><br><ol><li>to cover</li></ol>
ӕмӕ|æmæ	<i>conj</i><br><ol><li>and</li></ol>
ӕнгуз|ænguz	<i>noun</i><br><ol><li>walnut</li></ol>
ӕнгурӕ|ænguræ	<i>noun</i><br><ol><li>(Digor) fishing hook</li></ol>
ӕнгуылдз	<i>noun</i><br><ol><li>finger</li></ol>
ӕнгуыр	<i>noun</i><br><ol><li>(Iron) fishing rod</li></ol>
ӕндагон|ændagon	<i>adj</i><br><ol><li>(Digor) outward, external</li><li>(Digor) foreign</li></ol>
ӕндӕ|ændæ	<i>adv</i><br><ol><li>(Iron) outside</li></ol>
ӕндӕр|ændær	<i>det</i><br><ol><li>other, another, different</li></ol><br><i>particle</i><br><ol><li>more</li><li>else</li></ol><br><i>conj</i><br><ol><li>besides, in addition</li></ol>
ӕнос|ænos	<i>noun</i><br><ol><li>(Digor) Alternative form of ӕнус (ænus)</li></ol>
ӕнус|ӕну́с|ænús	<i>noun</i><br><ol><li>(Iron) eternity</li><li>(Iron) century</li><li>(Iron) age</li></ol>
ӕнцад|ӕнца́д|æncád	<i>adj</i><br><ol><li>peaceful, quiet, tranquil</li></ol><br><i>noun</i><br><ol><li>quiet, tranquility</li></ol>
ӕппӕт|æppæt	<i>det</i><br><ol><li>all</li></ol>
ӕппӕт бӕстӕты пролетартӕ, баиу ут|baiw ut|æppæt bæstæty proletartæ|ӕппӕт бӕстӕты пролетартӕ|баиу ут	<i>phrase</i><br><ol><li>workers of the world, unite!</li></ol>
ӕпхӕ|æpxæ	<i>noun</i><br><ol><li>(Digor) carrot</li></ol>
ӕрвад|ærvad|ӕрвадӕлтӕ	<i>noun</i><br><ol><li>(Iron) kinsman, relative, second brother</li></ol>
ӕрвадӕ|ærvadæ	<i>noun</i><br><ol><li>(Digor) brother</li></ol>
ӕргъай|ærǧaj	<i>noun</i><br><ol><li>salmon</li></ol>
ӕрдын|ærdyn	<i>noun</i><br><ol><li>bow (weapon)</li><li>bow (tool for playing musical instruments)</li><li>rainbow</li></ol>
ӕрдӕг|ærdæg	<i>noun</i><br><ol><li>one half</li></ol>
ӕрзӕ|ærzæ	<i>num</i><br><ol><li>thousand</li></ol>
ӕртиккӕг|ærtikkæg	<i>noun</i><br><ol><li>(Digor) Wednesday</li></ol>
ӕртыхст|ærtyxst	<i>noun</i><br><ol><li>(Iron) siege</li><li>encirclement</li></ol>
ӕртыццӕг|ærtyccæg	<i>noun</i><br><ol><li>(Iron) Wednesday</li></ol>
ӕртӕ|ærtæ	<i>num</i><br><ol><li>three</li></ol>
ӕрфуг|ærfug	<i>noun</i><br><ol><li>(Digor) eyebrow</li></ol>
ӕрфыг|ærfyg	<i>noun</i><br><ol><li>(Iron) eyebrow</li></ol>
ӕрхуы|ærxuy	<i>noun</i><br><ol><li>(Iron) copper</li></ol>
ӕрцӕуын|ærcæwyn	<i>verb</i><br><ol><li>to come</li></ol>
ӕрыгон|ærygon	<i>adj</i><br><ol><li>young</li></ol>
ӕфсад|ӕфсӕдтӕ|æfsád|ӕфса́д	<i>noun</i><br><ol><li>(Iron, Digor) troops</li><li>(Iron, Digor) army</li></ol>
ӕфсир|æfsir	<i>noun</i><br><ol><li>ear of corn</li></ol>
ӕфсымӕр|æfsymær	<i>noun</i><br><ol><li>brother</li></ol>
ӕфсӕ|ӕфситӕ|æfsæ	<i>noun</i><br><ol><li>(Digor) mare</li></ol>
ӕфсӕн|æfsǽn|ӕфсӕ́н	<i>noun</i><br><ol><li>(Iron, Digor) iron</li><li>(Iron, Digor, mineralogy) ironstone</li><li>(Iron, Digor) ploughshare</li></ol>
ӕфсӕр|æfsær	<i>noun</i><br><ol><li>(anatomy) jaw</li></ol>
ӕфсӕрм|æfsærm	<i>noun</i><br><ol><li>shame</li></ol>
ӕфцӕг|æfcæg	<i>noun</i><br><ol><li>neck (part of body connecting the head and the trunk)</li><li>(transferred sense) mountain pass</li></ol>
ӕфцӕггот|æfcæggot|ӕфцӕггуатӕ|æfcæggwatæ|æfcæk’watæ|ӕфцӕкъуатӕ	<i>noun</i><br><ol><li>collar (fabric garment part fitting around throat)</li></ol>
ӕхсар|æxsar	<i>noun</i><br><ol><li>(Iron) bravery, courage, heroism</li></ol>
ӕхсед|æxsed	<i>noun</i><br><ol><li>(Digor) Alternative form of ӕхсид (æxsid)</li></ol>
ӕхсид|æxsíd|ӕхси́д	<i>noun</i><br><ol><li>(Iron) dawn</li></ol>
ӕхсин|ӕхси́н|æxsín	<i>noun</i><br><ol><li>(Iron) lady, mistress</li><li>(Iron) princess</li></ol><br><i>adj</i><br><ol><li>(Iron, Digor) dark grey; blue-gray</li></ol>
ӕхсон|æxson	<i>noun</i><br><ol><li>(Iron, Digor) flint</li></ol>
ӕхсын|æxsyn	<i>verb</i><br><ol><li>to wash</li></ol>
ӕхсыр|æxsyr	<i>noun</i><br><ol><li>milk</li></ol>
ӕхсӕв|æxsæv	<i>noun</i><br><ol><li>night</li></ol>
ӕхсӕз|æxsæz	<i>num</i><br><ol><li>six</li></ol>
ӕхсӕлы|æxsæly	<i>noun</i><br><ol><li>juniper</li></ol>
ӕхсӕрӕг|æxsæræg	<i>noun</i><br><ol><li>squirrel</li></ol>
ӕххуыс	<i>noun</i><br><ol><li>help</li></ol>
ჽ|Mkhedruli	<i>character</i><br><ol><li>A Georgian letter formerly used in the Ossetian alphabet</li></ol>
