Aa-Be-Ze	<i>noun</i><br><ol><li>alphabet</li></ol>
Aadler	<i>noun</i><br><ol><li>eagle</li></ol>
Aag|Aage	<i>noun</i><br><ol><li>eye</li></ol>
Aageblick	<i>noun</i><br><ol><li>moment</li></ol>
Aaguscht|Auguschde	<i>noun</i><br><ol><li>August (month)</li></ol>
Aarm|Aerm	<i>noun</i><br><ol><li>arm</li></ol>
Aarsch	<i>noun</i><br><ol><li>ass, posterior, buttocks</li><li>butt end of an egg</li></ol>
Aazeeche	<i>noun</i><br><ol><li>token</li><li>omen, sign</li></ol>
Abbel	<i>noun</i><br><ol><li>apple</li></ol>
Abschnitt	<i>noun</i><br><ol><li>section</li></ol>
Aendi|Aendis	<i>noun</i><br><ol><li>aunt</li></ol>
Aent|Aents	<i>noun</i><br><ol><li>aunt</li></ol>
Aerdabbel	<i>noun</i><br><ol><li>artichoke</li></ol>
Aerdschwamm	<i>noun</i><br><ol><li>mushroom</li></ol>
Aff|Affe	<i>noun</i><br><ol><li>ape</li><li>monkey</li><li>silly person</li></ol>
Ahorn|Ahorne	<i>noun</i><br><ol><li>(rare) maple</li></ol>
Ambos|Ambose	<i>noun</i><br><ol><li>anvil</li></ol>
Amerika|Amerikaa	<i>name</i><br><ol><li>America (the continents of North America and South America)</li><li>America, United States of America (a country in North America)</li></ol>
Amschel|Amschelche|Amschle	<i>noun</i><br><ol><li>American robin, Turdus migratorius</li></ol>
Appel|Eppel	<i>noun</i><br><ol><li>apple</li></ol>
Aprill	<i>noun</i><br><ol><li>April (month)</li></ol>
Arewet	<i>noun</i><br><ol><li>work, labor</li></ol>
Ausgang|Ausgeng	<i>noun</i><br><ol><li>outlet</li><li>issue</li></ol>
Ax|Ex|Axe	<i>noun</i><br><ol><li>axle</li><li>ax, axe</li></ol>
Axel	<i>noun</i><br><ol><li>shoulder</li></ol>
Baad|Baade	<i>noun</i><br><ol><li>bath</li></ol>
Baadschtubb|Baadschtuwwe	<i>noun</i><br><ol><li>bathroom</li></ol>
Baam|Baem|Beem	<i>noun</i><br><ol><li>tree</li></ol>
Baamgaarde	<i>noun</i><br><ol><li>orchard</li></ol>
Baargeld	<i>noun</i><br><ol><li>cash</li></ol>
Baart|Baert	<i>noun</i><br><ol><li>beard</li><li>chin</li></ol>
Baas	<i>noun</i><br><ol><li>boss</li></ol>
Baawoll	<i>noun</i><br><ol><li>cotton</li></ol>
Babier|Babiere	<i>noun</i><br><ol><li>paper</li></ol>
Backeschtee	<i>noun</i><br><ol><li>brick</li></ol>
Baer|Baere	<i>noun</i><br><ol><li>bear</li></ol>
Balle	<i>noun</i><br><ol><li>ball</li><li>bale</li></ol>
Band|Benner	<i>noun</i><br><ol><li>band</li><li>ribbon</li><li>hinge</li><li>bandage</li><li>ligature</li><li>bond</li><li>certificate of indebtedness</li></ol>
Bank|Benk	<i>noun</i><br><ol><li>bench</li><li>workbench</li></ol>
Barig|Barige	<i>noun</i><br><ol><li>hill</li><li>mountain</li></ol>
Bauer	<i>noun</i><br><ol><li>farmer</li></ol>
Bauerei|Bauereie	<i>noun</i><br><ol><li>farm</li></ol>
Bax|Baxe	<i>noun</i><br><ol><li>box (container)</li></ol>
Beddelmann|Beddelmenner|Beddelleit	<i>noun</i><br><ol><li>beggar</li></ol>
Bee	<i>noun</i><br><ol><li>leg</li></ol>
Beer|Beere	<i>noun</i><br><ol><li>berry</li><li>pear</li></ol>
Bei	<i>noun</i><br><ol><li>cradle</li></ol>
Beidel	<i>noun</i><br><ol><li>purse</li><li>scrotum</li></ol>
Beil|Beile	<i>noun</i><br><ol><li>hatchet</li></ol>
Bels|Belse	<i>noun</i><br><ol><li>pelt, fur</li></ol>
Belsnickel	<i>name</i><br><ol><li>A companion of St. Nicholas in some Germanophone regions, with various cultural roles, including rewarding well-behaved children with gifts and punishing ill-behaved children by corporal punishment or by spiriting them away from their homes. Homologous with Krampus in other regions.</li><li>St. Nicholas.</li><li>Santa Claus.</li></ol>
Bennel	<i>noun</i><br><ol><li>string</li><li>tape</li><li>lines on a road</li></ol>
Bensil	<i>noun</i><br><ol><li>pencil</li></ol>
Bese	<i>noun</i><br><ol><li>broom</li></ol>
Betdaag	<i>noun</i><br><ol><li>Thanksgiving</li></ol>
Bett|Bedder	<i>noun</i><br><ol><li>bed</li></ol>
Bettzeit|Bettzeide	<i>noun</i><br><ol><li>bedtime</li></ol>
Bewi|Bewis	<i>noun</i><br><ol><li>baby</li></ol>
Bief	<i>noun</i><br><ol><li>beef</li></ol>
Bier|Biere	<i>noun</i><br><ol><li>beer</li></ol>
Bierhef|Bierhefe	<i>noun</i><br><ol><li>yeast</li></ol>
Biewel	<i>noun</i><br><ol><li>Bible</li></ol>
Bild|Bilder	<i>noun</i><br><ol><li>picture, image</li></ol>
Bips	<i>noun</i><br><ol><li>penis</li></ol>
Bischel	<i>noun</i><br><ol><li>small woods</li><li>small handful of grass or weeds</li></ol>
Bisniss|Bisnisse	<i>noun</i><br><ol><li>business</li></ol>
Bissel	<i>noun</i><br><ol><li>little bit</li><li>little</li><li>short while</li></ol>
Blaan|Blaane	<i>noun</i><br><ol><li>plan, design</li></ol>
Blacke	<i>noun</i><br><ol><li>patch, small piece of fabric</li><li>spot</li></ol>
Blaeckbeer|Blaeckbeere	<i>noun</i><br><ol><li>blackberry</li></ol>
Blaeckschmitt	<i>noun</i><br><ol><li>blacksmith</li></ol>
Blans|Blanse	<i>noun</i><br><ol><li>plant</li></ol>
Blatt|Bledder	<i>noun</i><br><ol><li>leaf</li><li>blade</li><li>page</li></ol>
Blatz|Bletz	<i>noun</i><br><ol><li>place</li><li>farmstead</li></ol>
Blovoggel|Bloveggel	<i>noun</i><br><ol><li>bluebird</li></ol>
Blug|Blieg	<i>noun</i><br><ol><li>plow, plough</li></ol>
Blumm|Blumme	<i>noun</i><br><ol><li>flower</li></ol>
Blut	<i>noun</i><br><ol><li>blood</li></ol>
Bluug	<i>noun</i><br><ol><li>plow, plough</li></ol>
Boddel|Boddele	<i>noun</i><br><ol><li>bottle</li></ol>
Boge	<i>noun</i><br><ol><li>bow</li><li>sheet of paper</li><li>arc, arch</li></ol>
Bohn|Bohne	<i>noun</i><br><ol><li>bean</li></ol>
Boi|Boie	<i>noun</i><br><ol><li>pie</li></ol>
Bord	<i>noun</i><br><ol><li>board</li></ol>
Braucherei	<i>noun</i><br><ol><li>powwowing (folk faith medicine)</li></ol>
Brauerei|Brauereie	<i>noun</i><br><ol><li>brewery</li></ol>
Breeding|Breedinge	<i>noun</i><br><ol><li>width, breadth</li></ol>
Brett|Bredder	<i>noun</i><br><ol><li>bracket</li><li>board</li></ol>
Bretzel|Bretzle	<i>noun</i><br><ol><li>pretzel</li></ol>
Brick|Bricke	<i>noun</i><br><ol><li>bridge</li></ol>
Brief	<i>noun</i><br><ol><li>letter (written message)</li><li>package</li></ol>
Brieh|Briehe	<i>noun</i><br><ol><li>gravy</li><li>broth</li><li>juice</li><li>slop</li></ol>
Brill|Brille	<i>noun</i><br><ol><li>glasses, spectacles</li></ol>
Briwwi|Briwwis	<i>noun</i><br><ol><li>outhouse, privy</li></ol>
Brot	<i>noun</i><br><ol><li>bread</li></ol>
Brotschank|Brotschenk	<i>noun</i><br><ol><li>cupboard</li><li>pantry</li></ol>
Bruch|Brich	<i>noun</i><br><ol><li>quarry</li><li>breach</li><li>hernia</li></ol>
Bruder|Brieder	<i>noun</i><br><ol><li>brother</li></ol>
Bruscht|Brischt	<i>noun</i><br><ol><li>breast, chest (anatomy)</li></ol>
Bsuch|Bsuche	<i>noun</i><br><ol><li>visit</li><li>visitor</li></ol>
Bsucherei	<i>noun</i><br><ol><li>visiting</li></ol>
Buch|Bicher	<i>noun</i><br><ol><li>book</li></ol>
Buchweeze	<i>noun</i><br><ol><li>buckwheat</li></ol>
Budder	<i>noun</i><br><ol><li>butter</li></ol>
Buh|Buwe|Bu|Bub	<i>noun</i><br><ol><li>a boy</li></ol>
Buhn|Buhne	<i>noun</i><br><ol><li>bean</li></ol>
Bulwer	<i>noun</i><br><ol><li>powder</li></ol>
Bundel	<i>noun</i><br><ol><li>bundle</li></ol>
Busch|Bisch	<i>noun</i><br><ol><li>woods, forest</li><li>country</li></ol>
Buschtaawe	<i>noun</i><br><ol><li>letter, character (of the alphabet)</li></ol>
Butscher	<i>noun</i><br><ol><li>butcher</li></ol>
Daadi|Daadis	<i>noun</i><br><ol><li>dad</li><li>grandpa</li></ol>
Daaf|Daafe	<i>noun</i><br><ol><li>baptism</li></ol>
Daag|Dag|Dage|Daage	<i>noun</i><br><ol><li>day</li></ol>
Daagbuch|Daagbicher	<i>noun</i><br><ol><li>diary, journal</li></ol>
Daal|Deeler|Daale|Daaler|Daeler	<i>noun</i><br><ol><li>valley</li></ol>
Dach|Decher	<i>noun</i><br><ol><li>roof</li></ol>
Daefer	<i>noun</i><br><ol><li>baptist</li></ol>
Dank	<i>noun</i><br><ol><li>thanks, gratitude</li><li>reward</li></ol>
Daub|Dauwe	<i>noun</i><br><ol><li>stave (of a barrel)</li><li>dove</li><li>pigeon</li></ol>
Daume	<i>noun</i><br><ol><li>thumb</li></ol>
Deckel	<i>noun</i><br><ol><li>lid</li><li>hat</li></ol>
Deeg|Deege	<i>noun</i><br><ol><li>dough</li></ol>
Deel|Deele	<i>noun</i><br><ol><li>part</li><li>share</li></ol>
Deitsch	<i>name</i><br><ol><li>the German or Pennsylvania German language</li></ol>
Deiwel	<i>noun</i><br><ol><li>devil</li></ol>
Deiwelsgewalt	<i>noun</i><br><ol><li>force</li><li>might, power</li></ol>
Deller	<i>noun</i><br><ol><li>plate</li></ol>
Dellerduch|Dellerdicher	<i>noun</i><br><ol><li>napkin</li></ol>
Deppich	<i>noun</i><br><ol><li>blanket, bedspread</li></ol>
Desch|Desche	<i>noun</i><br><ol><li>mouth</li><li>vagina</li></ol>
Dezember	<i>noun</i><br><ol><li>December (month)</li></ol>
Dieb|Diewe	<i>noun</i><br><ol><li>thief</li></ol>
Dier|Diere	<i>noun</i><br><ol><li>door</li><li>animal, beast</li></ol>
Ding|Dinge	<i>noun</i><br><ol><li>thing</li></ol>
Dingel	<i>noun</i><br><ol><li>little thing</li></ol>
Dinschdaag|Dinschdaage	<i>noun</i><br><ol><li>Tuesday</li></ol>
Dinscht|Dinschde	<i>noun</i><br><ol><li>service</li></ol>
Disch	<i>noun</i><br><ol><li>table</li></ol>
Dischdel|Dischdle	<i>noun</i><br><ol><li>thistle</li></ol>
Dischdelfink|Dischdelfinke	<i>noun</i><br><ol><li>goldfinch</li></ol>
Dischduch|Dischdicher	<i>noun</i><br><ol><li>tablecloth</li></ol>
Dochder|Dechder	<i>noun</i><br><ol><li>daughter</li></ol>
Dod	<i>noun</i><br><ol><li>death</li></ol>
Dodder	<i>noun</i><br><ol><li>egg yolk</li></ol>
Dodesfall|Dodesfelle	<i>noun</i><br><ol><li>death</li></ol>
Draag|Draage	<i>noun</i><br><ol><li>bier</li><li>stretcher</li></ol>
Draam|Draame	<i>noun</i><br><ol><li>dream</li></ol>
Drach|Drache	<i>noun</i><br><ol><li>dragon</li><li>kite</li><li>meteor</li><li>will o' the wisp</li></ol>
Draen|Draene	<i>noun</i><br><ol><li>tear, teardrop</li></ol>
Draub|Drauwe	<i>noun</i><br><ol><li>grape</li></ol>
Dress|Dresse	<i>noun</i><br><ol><li>dress</li></ol>
Drinke	<i>noun</i><br><ol><li>drink</li><li>strong drink</li><li>drinking</li></ol>
Duch|Dicher	<i>noun</i><br><ol><li>cloth, handkerchief</li></ol>
Dunnerschdaag|Dunnerschdaage	<i>noun</i><br><ol><li>Thursday</li></ol>
Duwack	<i>noun</i><br><ol><li>tobacco</li></ol>
Eck|Ecke	<i>noun</i><br><ol><li>corner</li><li>angle</li><li>section</li></ol>
Eeche	<i>noun</i><br><ol><li>oak tree</li></ol>
Eechel|Eechle	<i>noun</i><br><ol><li>acorn</li></ol>
Eechhaas|Eechhaase	<i>noun</i><br><ol><li>squirrel</li></ol>
Eel	<i>noun</i><br><ol><li>oil</li></ol>
Eemer	<i>noun</i><br><ol><li>bucket</li></ol>
Effning|Effninge	<i>noun</i><br><ol><li>opening</li></ol>
Ehr|Ehr|Ehre	<i>noun</i><br><ol><li>honor</li><li>eye (of a needle)</li></ol>
Eider	<i>noun</i><br><ol><li>udder</li></ol>
Eidex|Eidexe	<i>noun</i><br><ol><li>lizard</li></ol>
Eigang|Eigeng	<i>noun</i><br><ol><li>entrance</li></ol>
Eil|Eile	<i>noun</i><br><ol><li>owl</li><li>haste</li></ol>
Eis	<i>noun</i><br><ol><li>ice</li></ol>
Eise	<i>noun</i><br><ol><li>iron (metal)</li></ol>
Eisraahm	<i>noun</i><br><ol><li>ice cream</li></ol>
Eiwuhner	<i>noun</i><br><ol><li>inhabitant</li></ol>
Ellboge	<i>noun</i><br><ol><li>elbow</li></ol>
End|Enner	<i>noun</i><br><ol><li>end</li><li>limit</li></ol>
Engel	<i>noun</i><br><ol><li>angel (celestial being, messenger)</li></ol>
Enkel|Enkle	<i>noun</i><br><ol><li>grandson</li></ol>
Enkelin|Enkelinne	<i>noun</i><br><ol><li>granddaughter</li></ol>
Ent|Ende	<i>noun</i><br><ol><li>duck</li></ol>
Erd	<i>noun</i><br><ol><li>earth</li><li>the world</li></ol>
Erfaahring|Erfaahringe	<i>noun</i><br><ol><li>experience</li></ol>
Erleesung|Erleesunge	<i>noun</i><br><ol><li>salvation</li><li>redemption</li></ol>
Eschdooni	<i>name</i><br><ol><li>Estonia</li></ol>
Esel	<i>noun</i><br><ol><li>ass, mule</li></ol>
Esse	<i>noun</i><br><ol><li>food</li><li>meal</li></ol>
Essschtick|Essschticker	<i>noun</i><br><ol><li>lunch</li></ol>
Essschtubb|Essschtuwwe	<i>noun</i><br><ol><li>dining room</li></ol>
Faahrt|Faahrde	<i>noun</i><br><ol><li>drive, trip</li></ol>
Fackel|Fackle	<i>noun</i><br><ol><li>torch</li><li>bundle of straw for thatching</li></ol>
Fall|Falle|Felle	<i>noun</i><br><ol><li>fall</li><li>case, event</li><li>trap</li></ol>
Familye	<i>noun</i><br><ol><li>family</li></ol>
Familyenaame	<i>noun</i><br><ol><li>last name, surname</li></ol>
Fatz	<i>noun</i><br><ol><li>fart</li></ol>
Febrewaar	<i>noun</i><br><ol><li>February (month)</li></ol>
Fecht	<i>noun</i><br><ol><li>fight</li></ol>
Fedder|Feddre	<i>noun</i><br><ol><li>feather</li><li>pen (writing implement)</li><li>spring (coil)</li></ol>
Feier|Feire	<i>noun</i><br><ol><li>fire</li></ol>
Feiervoggel|Feierveggel	<i>noun</i><br><ol><li>firefly, lightning bug</li></ol>
Feind	<i>noun</i><br><ol><li>enemy</li></ol>
Feld|Felder	<i>noun</i><br><ol><li>field</li></ol>
Fels|Felse	<i>noun</i><br><ol><li>rock</li></ol>
Felse	<i>noun</i><br><ol><li>rock</li></ol>
Fens|Fenz|Fense	<i>noun</i><br><ol><li>fence</li></ol>
Fenschder|Fenschdre	<i>noun</i><br><ol><li>window</li></ol>
Fenschderlaade|Fenschderlaede	<i>noun</i><br><ol><li>window shutter</li></ol>
Fensemaus|Fensemeis	<i>noun</i><br><ol><li>chipmunk</li></ol>
Fescht|Feschde	<i>noun</i><br><ol><li>feast, festival</li></ol>
Fett	<i>noun</i><br><ol><li>fat</li><li>lard</li><li>grease</li><li>suet</li></ol>
Fiewer	<i>noun</i><br><ol><li>fever</li></ol>
Filadelfi	<i>name</i><br><ol><li>Philadelphia (a large city in Pennsylvania, United States)</li></ol>
Fill|Filler	<i>noun</i><br><ol><li>abundance</li><li>fill</li><li>colt</li></ol>
Finger	<i>noun</i><br><ol><li>finger</li></ol>
Fink|Finke	<i>noun</i><br><ol><li>finch</li></ol>
Fisch	<i>noun</i><br><ol><li>fish</li></ol>
Flamm|Flamme	<i>noun</i><br><ol><li>flame</li></ol>
Fleddermaus|Fleddermeis	<i>noun</i><br><ol><li>butterfly, moth</li><li>bat (animal)</li></ol>
Fleesch	<i>noun</i><br><ol><li>meat</li></ol>
Fliggel	<i>noun</i><br><ol><li>wing</li></ol>
Flint|Flinde	<i>noun</i><br><ol><li>gun</li></ol>
Fraa|Weiwer	<i>noun</i><br><ol><li>woman</li><li>wife</li></ol>
Frack|Fracke	<i>noun</i><br><ol><li>dress</li><li>frock</li></ol>
Freidaag|Freidaage	<i>noun</i><br><ol><li>Friday</li></ol>
Freide	<i>noun</i><br><ol><li>joy, delight</li></ol>
Freind	<i>noun</i><br><ol><li>friend</li></ol>
Friehyaahr|Friehyaahre	<i>noun</i><br><ol><li>spring (season)</li></ol>
Frissel	<i>noun</i><br><ol><li>rash (irritation of the skin)</li></ol>
Frog|Froge	<i>noun</i><br><ol><li>question</li></ol>
Frosch|Fresch	<i>noun</i><br><ol><li>frog</li></ol>
Fuder|Fuder	<i>noun</i><br><ol><li>feed, fodder</li><li>lining (of a garment)</li></ol>
Fuuss|Fiess	<i>noun</i><br><ol><li>foot</li></ol>
Fux|Fix	<i>noun</i><br><ol><li>fox</li></ol>
Gaarde	<i>noun</i><br><ol><li>garden</li></ol>
Gaardesach|Gaardesache	<i>noun</i><br><ol><li>vegetable, greens</li><li>garden truck</li></ol>
Gaerdel	<i>noun</i><br><ol><li>belt</li><li>girdle</li></ol>
Gaerscht	<i>noun</i><br><ol><li>barley</li></ol>
Gans|Ganse	<i>noun</i><br><ol><li>goose</li></ol>
Garyel|Garyele	<i>noun</i><br><ol><li>throat</li><li>gargle</li></ol>
Gascht|Gescht	<i>noun</i><br><ol><li>guest</li></ol>
Gaul|Geil	<i>noun</i><br><ol><li>horse</li></ol>
Gawwel|Gawwle	<i>noun</i><br><ol><li>fork</li></ol>
Gebei	<i>noun</i><br><ol><li>building</li></ol>
Gebottsdaag|Gebottsdaage	<i>noun</i><br><ol><li>birthday</li></ol>
Gedraesch	<i>noun</i><br><ol><li>trash, rubbish, refuse, garbage</li></ol>
Geescht|Geischder|Geischt|Geeschder	<i>noun</i><br><ol><li>spirit</li><li>mind</li><li>apparition</li></ol>
Geess	<i>noun</i><br><ol><li>goat</li></ol>
Gehlrieb|Gehlriewe	<i>noun</i><br><ol><li>carrot</li></ol>
Geiz	<i>noun</i><br><ol><li>avarice</li></ol>
Geld	<i>noun</i><br><ol><li>money</li></ol>
Gemies	<i>noun</i><br><ol><li>vegetable</li><li>vegetables (collective noun)</li></ol>
Gewalt	<i>noun</i><br><ol><li>power</li><li>violence</li></ol>
Gfaahr	<i>noun</i><br><ol><li>danger, peril</li></ol>
Gfecht	<i>noun</i><br><ol><li>fighting, quarreling (continual or ongoing)</li></ol>
Gfiehl	<i>noun</i><br><ol><li>feeling</li><li>sense of touch</li></ol>
Gfrees	<i>noun</i><br><ol><li>trash, rubbish, refuse, garbage</li></ol>
Gift	<i>noun</i><br><ol><li>poison</li><li>poison ivy, ivy poisoning</li></ol>
Giftschwamm|Giftschwemm	<i>noun</i><br><ol><li>toadstool</li></ol>
Glaag|Glaage	<i>noun</i><br><ol><li>complaint</li></ol>
Glaas|Glesser	<i>noun</i><br><ol><li>glass (material)</li><li>drinking glass</li></ol>
Glaawe	<i>noun</i><br><ol><li>belief</li><li>faith, creed</li></ol>
Glang|Glenge	<i>noun</i><br><ol><li>sound</li></ol>
Glee	<i>noun</i><br><ol><li>clover</li></ol>
Gleed|Gleeder	<i>noun</i><br><ol><li>garment</li></ol>
Gleeder	<i>noun</i><br><ol><li>clothing</li></ol>
Glick	<i>noun</i><br><ol><li>luck, fortune</li><li>good luck</li></ol>
Glock|Glocke	<i>noun</i><br><ol><li>bell</li></ol>
Glut|Glude	<i>noun</i><br><ol><li>glow</li><li>heat</li></ol>
Gmee	<i>noun</i><br><ol><li>congregation, community</li></ol>
Gnall	<i>noun</i><br><ol><li>clap</li><li>loud report</li><li>crack</li></ol>
Gnallhitt|Gnallhidde	<i>noun</i><br><ol><li>hovel, delapidated building</li><li>bawdy house, brothel</li></ol>
Gnie	<i>noun</i><br><ol><li>knee</li></ol>
Gnowwelich	<i>noun</i><br><ol><li>garlic</li></ol>
Goddesdinscht|Goddesdinschde	<i>noun</i><br><ol><li>worship service, divine service, liturgy, mass (Christianity)</li></ol>
Gold	<i>noun</i><br><ol><li>gold</li></ol>
Gott|Gedder	<i>noun</i><br><ol><li>god</li></ol>
Graad	<i>noun</i><br><ol><li>degree</li><li>measure</li></ol>
Graas|Gresser	<i>noun</i><br><ol><li>grass</li></ol>
Graft|Grefde	<i>noun</i><br><ol><li>power, strength</li><li>vigor</li></ol>
Grankheet|Grankheete	<i>noun</i><br><ol><li>disease, illness</li></ol>
Grans|Granse	<i>noun</i><br><ol><li>border</li><li>wreath</li><li>garland</li></ol>
Graut|Greider	<i>noun</i><br><ol><li>cabbage</li><li>vegetation</li><li>herb</li><li>weed</li></ol>
Grebs	<i>noun</i><br><ol><li>Cancer (constellation, zodiacal sign)</li><li>crab</li></ol>
Grees|Greese	<i>noun</i><br><ol><li>circle</li></ol>
Greess|Greesse	<i>noun</i><br><ol><li>size</li><li>extent, magnitude</li><li>height</li></ol>
Greiz|Greize	<i>noun</i><br><ol><li>cross</li><li>crucifix</li><li>misfortune</li><li>small of the back</li></ol>
Grenk|Grenks	<i>noun</i><br><ol><li>crank</li><li>handle</li></ol>
Grens|Grense	<i>noun</i><br><ol><li>border</li><li>limit</li></ol>
Grick|Gricke	<i>noun</i><br><ol><li>creek</li><li>crutch</li></ol>
Grieg|Griege	<i>noun</i><br><ol><li>war</li></ol>
Griff|Griffe	<i>noun</i><br><ol><li>grip</li><li>clip (of a horseshoe)</li></ol>
Grisch	<i>noun</i><br><ol><li>cry, scream, shout</li></ol>
Grischt|Grischde	<i>name</i><br><ol><li>Christ</li><li>Christian</li></ol>
Grischtbaam|Grischtbeem|Grischtbaem	<i>noun</i><br><ol><li>Christmas tree</li></ol>
Grischtdaag	<i>name</i><br><ol><li>Christmas</li></ol>
Grischtmunet	<i>noun</i><br><ol><li>December (month)</li></ol>
Groossdaadi|Grossdaadis	<i>noun</i><br><ol><li>grandfather</li></ol>
Groosseldre	<i>noun</i><br><ol><li>grandparents</li></ol>
Groossmammi|Groossmammis	<i>noun</i><br><ol><li>grandmother</li></ol>
Grossdaadi|Grossdaadis	<i>noun</i><br><ol><li>grandfather</li></ol>
Grossmammi|Grossmammis	<i>noun</i><br><ol><li>grandmother</li></ol>
Grott|Grodde	<i>noun</i><br><ol><li>toad</li></ol>
Gruck|Grick|Gricke	<i>noun</i><br><ol><li>jug</li><li>pitcher</li><li>mug</li></ol>
Grumbeer|Grumbier|Grumbeere|Grumbiere	<i>noun</i><br><ol><li>potato</li></ol>
Grund	<i>noun</i><br><ol><li>ground</li><li>foundation</li><li>soil</li><li>reason</li></ol>
Grundsau|Grundsei	<i>noun</i><br><ol><li>groundhog, woodchuck</li></ol>
Grundsow	<i>noun</i><br><ol><li>Synonym of Grundsau</li></ol>
Gruuss|Griesse	<i>noun</i><br><ol><li>greeting, salutation</li><li>compliments</li></ol>
Gscharr|Gscharre	<i>noun</i><br><ol><li>harness</li><li>dishes</li><li>implements, tools</li></ol>
Gscharrschank|Gscharrschenk	<i>noun</i><br><ol><li>cupboard</li><li>pantry</li></ol>
Gscheft|Gschefde	<i>noun</i><br><ol><li>business</li></ol>
Gschicht|Gschichde	<i>noun</i><br><ol><li>story, tale</li><li>affair</li><li>history</li></ol>
Gschmok	<i>noun</i><br><ol><li>(continual) smoking</li></ol>
Gschpuck	<i>noun</i><br><ol><li>spook, ghost</li><li>hobgoblin</li></ol>
Gschtell|Gschteller	<i>noun</i><br><ol><li>frame, framework</li></ol>
Gschwarl	<i>noun</i><br><ol><li>squirrel</li></ol>
Gschwei|Gschweie	<i>noun</i><br><ol><li>sister-in-law</li></ol>
Gsetz|Gsetze	<i>noun</i><br><ol><li>law</li><li>statute</li></ol>
Gsicht|Gsichder	<i>noun</i><br><ol><li>face</li></ol>
Guck|Gucke	<i>noun</i><br><ol><li>look</li><li>looks, appearance</li></ol>
Guckbax|Guckbaxe	<i>noun</i><br><ol><li>television, tv</li></ol>
Gummer|Gummre	<i>noun</i><br><ol><li>cucumber</li></ol>
Haahne	<i>noun</i><br><ol><li>rooster, cock</li></ol>
Haapt	<i>noun</i><br><ol><li>principal or main thing</li></ol>
Haaptman|Haaptmenner	<i>noun</i><br><ol><li>leader, President</li></ol>
Haar	<i>noun</i><br><ol><li>(anatomy) hair</li></ol>
Haas|Haase	<i>noun</i><br><ol><li>rabbit</li></ol>
Hack|Hacke	<i>noun</i><br><ol><li>hoe</li><li>lash, blow</li><li>cutting rejoinder</li></ol>
Haerbscht	<i>noun</i><br><ol><li>autumn, fall (season)</li></ol>
Haffe|Heffe	<i>noun</i><br><ol><li>pot, crock</li><li>chamber</li></ol>
Hals|Hels	<i>noun</i><br><ol><li>neck</li><li>throat</li></ol>
Halsduch|Halsdicher	<i>noun</i><br><ol><li>scarf</li></ol>
Hammel	<i>noun</i><br><ol><li>wether, castrated ram</li></ol>
Hammelfleesch	<i>noun</i><br><ol><li>mutton</li></ol>
Hammer|Hemmer	<i>noun</i><br><ol><li>hammer</li></ol>
Hand|Hend	<i>noun</i><br><ol><li>hand</li><li>handwriting</li></ol>
Handgriff|Handgriffe	<i>noun</i><br><ol><li>grip (of a hand)</li><li>handle</li></ol>
Hann|Hanner	<i>noun</i><br><ol><li>brain</li><li>horn</li></ol>
Hanning	<i>noun</i><br><ol><li>February (month)</li></ol>
Harf|Harfe	<i>noun</i><br><ol><li>harp</li></ol>
Harning	<i>noun</i><br><ol><li>February (month)</li></ol>
Harr	<i>noun</i><br><ol><li>Lord (religious context)</li><li>mister</li></ol>
Harrevoggel|Harreveggel	<i>noun</i><br><ol><li>blue jay</li></ol>
Harrisbarrig	<i>name</i><br><ol><li>Harrisburg (the capital city of Pennsylvania)</li></ol>
Hasch	<i>noun</i><br><ol><li>deer</li></ol>
Hass	<i>noun</i><br><ol><li>hate, hatred</li><li>spite</li></ol>
Hatz|Hatze	<i>noun</i><br><ol><li>heart</li></ol>
Haufe|Heife	<i>noun</i><br><ol><li>heap, pile, stack</li></ol>
Hauptman|Haaptmenner	<i>noun</i><br><ol><li>Synonym of Haaptman</li></ol>
Haus|Heiser	<i>noun</i><br><ol><li>house</li></ol>
Hausuhr|Hausuhre	<i>noun</i><br><ol><li>clock</li></ol>
Haut|Heit	<i>noun</i><br><ol><li>skin, hide</li><li>cuticle</li><li>membrane</li><li>film</li></ol>
Hawwer	<i>noun</i><br><ol><li>oats</li></ol>
Heb|Hewe	<i>noun</i><br><ol><li>handle (of a basket)</li></ol>
Heemet|Heemedde	<i>noun</i><br><ol><li>home</li></ol>
Heemweh	<i>noun</i><br><ol><li>homesickness</li></ol>
Heft	
Heid|Heide	<i>noun</i><br><ol><li>heathen</li></ol>
Heiraat|Heiraade	<i>noun</i><br><ol><li>marriage, matrimony</li></ol>
Hell	<i>noun</i><br><ol><li>hell</li></ol>
Hembeer|Hembeere	<i>noun</i><br><ol><li>raspberry</li></ol>
Hemm|Hemmer	<i>noun</i><br><ol><li>shirt</li></ol>
Hendel	<i>noun</i><br><ol><li>handle</li><li>bail</li></ol>
Hengscht	<i>noun</i><br><ol><li>stallion</li><li>lecherous man, lecher</li></ol>
Henk|Henke	<i>noun</i><br><ol><li>handle</li><li>hinge</li></ol>
Hensching	<i>noun</i><br><ol><li>glove</li><li>mitten</li></ol>
Hex|Hexe	<i>noun</i><br><ol><li>witch</li></ol>
Hexerei|Hexereie	<i>noun</i><br><ol><li>magic</li><li>sorcery, witchcraft</li><li>something strange</li></ol>
Hiegel	<i>noun</i><br><ol><li>hill</li><li>knoll</li></ol>
Himmel|Himmle	<i>noun</i><br><ol><li>heaven</li></ol>
Himmelfardaag|Himmelfardaage	<i>noun</i><br><ol><li>Ascension Day (Christian holiday)</li></ol>
Hinkel	<i>noun</i><br><ol><li>chicken</li></ol>
Hinnerdeel	<i>noun</i><br><ol><li>rear, hind part</li><li>stern</li><li>ass, arse</li></ol>
Hinnerschunke	<i>noun</i><br><ol><li>ham</li></ol>
Hitt|Hidde	<i>noun</i><br><ol><li>hut</li><li>cabin</li></ol>
Hiwwel	<i>noun</i><br><ol><li>hill</li><li>knoll</li></ol>
Hochdeitsch	<i>noun</i><br><ol><li>(standard) German</li></ol>
Hof|Heef	<i>noun</i><br><ol><li>yard</li><li>farm place</li></ol>
Hoffning	<i>noun</i><br><ol><li>hope</li><li>expectation</li></ol>
Hoi	<i>noun</i><br><ol><li>hay</li></ol>
Hoiet	<i>noun</i><br><ol><li>hay harvest</li><li>the time or month of the hay harvest</li></ol>
Hoigawwel|Hoigawwle	<i>noun</i><br><ol><li>pitchfork</li></ol>
Hoke	<i>noun</i><br><ol><li>hook</li><li>scribbling</li><li>awkward person, awkward horse</li></ol>
Hokegreiz|Hokegreize	<i>noun</i><br><ol><li>swastika</li></ol>
Hols	<i>noun</i><br><ol><li>wood</li></ol>
Hosse	<i>noun</i><br><ol><li>(in the plural) pants, trousers</li></ol>
Huf|Hufe	<i>noun</i><br><ol><li>hoof</li></ol>
Hufeise	<i>noun</i><br><ol><li>horseshoe</li></ol>
Hund|Hundli|Hundlin	<i>noun</i><br><ol><li>dog</li></ol>
Hundli|Hundlin	<i>noun</i><br><ol><li>puppy</li><li>little dog</li></ol>
Hunnich	<i>noun</i><br><ol><li>honey</li></ol>
Hur|Hure	<i>noun</i><br><ol><li>whore, prostitute</li></ol>
Hut|Hiet	<i>noun</i><br><ol><li>hat</li></ol>
Iem|Ieme	<i>noun</i><br><ol><li>honeybee</li></ol>
Iewing	<i>noun</i><br><ol><li>practice</li></ol>
Iwwerhosse	<i>noun</i><br><ol><li>(in the plural) jeans</li><li>(in the plural) overalls</li></ol>
Iwwerschtock|Iwwerschteck	<i>noun</i><br><ol><li>skirt</li></ol>
Iwwersetzer	<i>noun</i><br><ol><li>translator</li></ol>
Iwwersetzing|Iwwersetzinge	<i>noun</i><br><ol><li>translation</li></ol>
Kaendi|Kaendis	<i>noun</i><br><ol><li>candy, sweet</li></ol>
Kaer|Kaers|Kaere	<i>noun</i><br><ol><li>car, automobile</li></ol>
Kaerbs|Kaerbse	<i>noun</i><br><ol><li>pumpkin</li><li>squash</li></ol>
Kaerper	<i>noun</i><br><ol><li>body (biological)</li></ol>
Kaes	<i>noun</i><br><ol><li>cheese</li></ol>
Kaesch	<i>noun</i><br><ol><li>cash</li></ol>
Kaffi	<i>noun</i><br><ol><li>coffee</li></ol>
Kaffibohn|Kaffibohne	<i>noun</i><br><ol><li>coffee bean</li></ol>
Kaffikann|Kaffikanne	<i>noun</i><br><ol><li>coffee pot</li></ol>
Kalb|Kelwer	<i>noun</i><br><ol><li>calf</li><li>fool</li></ol>
Kalenner	<i>noun</i><br><ol><li>calendar</li></ol>
Kall|Kalls	<i>noun</i><br><ol><li>fellow</li></ol>
Kallick	<i>noun</i><br><ol><li>lime (calcium-based material)</li></ol>
Kann|Kanne	<i>noun</i><br><ol><li>rye</li><li>kernel, seed</li><li>can</li></ol>
Kapp|Kappe|Keppche|Keppcher	<i>noun</i><br><ol><li>cap (headwear)</li><li>hood</li><li>biretta</li></ol>
Kar|Kars	<i>noun</i><br><ol><li>car, automobile</li></ol>
Karich|Kaerich|Kariche|Kaeriche	<i>noun</i><br><ol><li>church</li></ol>
Karichesitz|Karichesitze	<i>noun</i><br><ol><li>pew</li></ol>
Karichhof|Kaerichhof|Karichheef|Kaerichheef	<i>noun</i><br><ol><li>churchyard</li><li>cemetery</li></ol>
Kasch	<i>noun</i><br><ol><li>cherry</li></ol>
Kaschde	<i>noun</i><br><ol><li>chest, box, case</li></ol>
Katz|Katze	<i>noun</i><br><ol><li>cat</li></ol>
Kaundi|Kaundis	<i>noun</i><br><ol><li>county</li></ol>
Keenich|Keenichne|Keenichn	<i>noun</i><br><ol><li>king</li></ol>
Keenichn|Keenich|Keenichne	<i>noun</i><br><ol><li>queen</li></ol>
Keffer	<i>noun</i><br><ol><li>beetle</li></ol>
Kefferbrieh	<i>noun</i><br><ol><li>bug juice (liquor, moonshine)</li></ol>
Kehl|Kehle	<i>noun</i><br><ol><li>throat</li></ol>
Kell|Kelle	<i>noun</i><br><ol><li>ladle</li><li>trowel</li></ol>
Kellich	<i>noun</i><br><ol><li>chalice</li><li>cup</li><li>ciborium</li></ol>
Kerze	<i>noun</i><br><ol><li>candle</li></ol>
Kessel|Kessle	<i>noun</i><br><ol><li>kettle</li></ol>
Kich|Kiche	<i>noun</i><br><ol><li>kitchen</li></ol>
Kicheschank|Kicheschenk	<i>noun</i><br><ol><li>kitchen cupboard</li></ol>
Kiddel	<i>noun</i><br><ol><li>blouse</li><li>smock, light coat</li></ol>
Kind|Kinner	<i>noun</i><br><ol><li>child, kid</li></ol>
Kinnskind|Kinnskinner	<i>noun</i><br><ol><li>grandchild</li></ol>
Kischt|Kischde	<i>noun</i><br><ol><li>chest, box</li></ol>
Kisse	<i>noun</i><br><ol><li>cushion</li></ol>
Kitsch	<i>noun</i><br><ol><li>rake</li><li>scraper (for scraping up ashes)</li></ol>
Kohl|Kohle	<i>noun</i><br><ol><li>coal</li></ol>
Kopp|Keppche|Keppcher|Kepp	<i>noun</i><br><ol><li>head</li></ol>
Koppche|Koppcher	<i>noun</i><br><ol><li>teacup</li></ol>
Koppekisse	<i>noun</i><br><ol><li>pillow</li></ol>
Koschde	<i>noun</i><br><ol><li>cost, expense</li></ol>
Kossin|Kossins	<i>noun</i><br><ol><li>cousin</li></ol>
Kotz	<i>noun</i><br><ol><li>vomit, puke</li></ol>
Krick|Kricke	<i>noun</i><br><ol><li>creek</li></ol>
Kuche	<i>noun</i><br><ol><li>cake</li></ol>
Kuh|Kieh	<i>noun</i><br><ol><li>cow</li></ol>
Kunscht|Kinschde	<i>noun</i><br><ol><li>art</li><li>skill</li><li>science, craft</li><li>knack</li></ol>
Kuschen|Kuschens	<i>noun</i><br><ol><li>cushion</li></ol>
Laab|Laawe	<i>noun</i><br><ol><li>leaf</li><li>foliage</li></ol>
Laad|Laade|Laede	<i>noun</i><br><ol><li>coffin</li><li>load</li></ol>
Laade|Laede	<i>noun</i><br><ol><li>window shutter</li></ol>
Ladann|Ladanne	<i>noun</i><br><ol><li>lantern</li></ol>
Lamm|Lemmer	<i>noun</i><br><ol><li>lamb</li></ol>
Land|Lenner	<i>noun</i><br><ol><li>land</li><li>country</li><li>soil, garden bed</li></ol>
Langohr|Langohre	<i>noun</i><br><ol><li>ass, mule</li></ol>
Lascht|Laschde	<i>noun</i><br><ol><li>load, burden</li></ol>
Laus|Leis	<i>noun</i><br><ol><li>louse</li></ol>
Laut	<i>noun</i><br><ol><li>sound</li></ol>
Leeb|Leewe	<i>noun</i><br><ol><li>loaf (of bread)</li><li>lion</li><li>Leo (astrological sign)</li></ol>
Leeder|Leedre	<i>noun</i><br><ol><li>ladder</li></ol>
Leffel|Leffle	<i>noun</i><br><ol><li>spoon</li></ol>
Leich|Leiche	<i>noun</i><br><ol><li>corpse, body (deceased)</li></ol>
Leim	<i>noun</i><br><ol><li>glue</li></ol>
Leit	<i>noun</i><br><ol><li>(in the plural) people</li></ol>
Lewe	<i>noun</i><br><ol><li>life</li><li>living</li><li>livelihood</li><li>bustle</li></ol>
Licht|Lichder	<i>noun</i><br><ol><li>light</li><li>lamp, candle</li></ol>
Lieb	<i>noun</i><br><ol><li>love</li></ol>
Lied|Lieder	<i>noun</i><br><ol><li>song</li><li>hymn</li></ol>
Liedel	<i>noun</i><br><ol><li>song</li></ol>
Lieg|Liege	<i>noun</i><br><ol><li>lie (untruth)</li></ol>
Lifdel	<i>noun</i><br><ol><li>breeze</li></ol>
Lischt|Lischde	<i>noun</i><br><ol><li>list, roll, series of data</li><li>shrewdness</li><li>cunning</li></ol>
Loch|Lecher	<i>noun</i><br><ol><li>hole</li><li>rent</li><li>burrow</li></ol>
Lodel	<i>noun</i><br><ol><li>drunken fellow</li></ol>
Loh|Leh	<i>noun</i><br><ol><li>wage, wages</li></ol>
Luft|Lifde	<i>noun</i><br><ol><li>air</li><li>the sky</li></ol>
Lumbe|Lumpe	<i>noun</i><br><ol><li>rag, piece of cloth</li></ol>
Lumperei	<i>noun</i><br><ol><li>trash</li><li>trouble, bad business</li><li>mix-up</li></ol>
Luscht|Luschde	<i>noun</i><br><ol><li>joy, pleasure</li><li>treat</li><li>enjoyment</li><li>mirth, merriment</li></ol>
Lutzer|Lutzre	<i>noun</i><br><ol><li>lantern</li></ol>
Maage|Meege	<i>noun</i><br><ol><li>stomach, maw (digestive organ)</li></ol>
Macht	<i>noun</i><br><ol><li>might</li><li>power</li></ol>
Mad	<i>noun</i><br><ol><li>murder, slaying</li></ol>
Maedel|Maed	<i>noun</i><br><ol><li>girl</li></ol>
Mammi|Mammis	<i>noun</i><br><ol><li>mom, mother, ma</li><li>grandma</li></ol>
Mann|Menner	<i>noun</i><br><ol><li>man (male human)</li><li>husband</li></ol>
Marick|Maricker	<i>noun</i><br><ol><li>mark</li><li>sign</li><li>market, marketplace</li></ol>
Mariye	<i>noun</i><br><ol><li>morning</li></ol>
Mariyeesse	<i>noun</i><br><ol><li>breakfast</li></ol>
Matz	<i>noun</i><br><ol><li>March (month)</li></ol>
Maul|Meiler	<i>noun</i><br><ol><li>mouth</li></ol>
Maus|Meis	<i>noun</i><br><ol><li>mouse</li></ol>
Mauskatz|Mauskatze	<i>noun</i><br><ol><li>mouser</li></ol>
Meebel	<i>noun</i><br><ol><li>maple tree</li></ol>
Meening|Meeninge	<i>noun</i><br><ol><li>opinion, view</li><li>meaning, sense</li></ol>
Mehl	<i>noun</i><br><ol><li>flour, meal</li></ol>
Melassichriwwelkuche	<i>noun</i><br><ol><li>shoofly pie, shoofly cake</li></ol>
Memm|Memme	<i>noun</i><br><ol><li>mom, mother, ma</li></ol>
Mennischt|Mennischde	<i>noun</i><br><ol><li>Mennonite</li></ol>
Messer	<i>noun</i><br><ol><li>knife</li></ol>
Metaall	<i>noun</i><br><ol><li>metal</li></ol>
Middaag|Middaage	<i>noun</i><br><ol><li>noon</li><li>midday</li><li>dinner</li></ol>
Middaagesse	<i>noun</i><br><ol><li>dinner (midday meal)</li></ol>
Miehl|Miehle	<i>noun</i><br><ol><li>mill</li></ol>
Mildaa	<i>noun</i><br><ol><li>mildew</li></ol>
Millich	<i>noun</i><br><ol><li>milk</li></ol>
Millichhaus|Millichheiser	<i>noun</i><br><ol><li>dairy (place where dairy products are made)</li></ol>
Mischt	<i>noun</i><br><ol><li>manure</li></ol>
Mischthaufe|Mischtheife	<i>noun</i><br><ol><li>dung heap</li></ol>
Mittwoch|Mittwoche	<i>noun</i><br><ol><li>Wednesday</li></ol>
Moi	<i>noun</i><br><ol><li>May (month)</li></ol>
Molke|Molken	<i>noun</i><br><ol><li>whey</li></ol>
Moondaag|Moondaage	<i>noun</i><br><ol><li>Monday</li></ol>
Moos	<i>noun</i><br><ol><li>measure</li><li>moss</li></ol>
Moschdert	<i>noun</i><br><ol><li>mustard</li><li>charlock</li></ol>
Mudder|Midder	<i>noun</i><br><ol><li>mother</li></ol>
Mudderschof	<i>noun</i><br><ol><li>ewe</li></ol>
Mudderschprooch|Mudderschprooche	<i>noun</i><br><ol><li>mother tongue</li></ol>
Muhn|Muhne	<i>noun</i><br><ol><li>moon</li></ol>
Mundaag|Mundaage|Muundaag	<i>noun</i><br><ol><li>Monday</li></ol>
Munet|Munete	<i>noun</i><br><ol><li>month</li></ol>
Naame	<i>noun</i><br><ol><li>name</li></ol>
Naas|Nees	<i>noun</i><br><ol><li>nose</li></ol>
Nacht|Nachde	<i>noun</i><br><ol><li>night</li></ol>
Nadde	<i>noun</i><br><ol><li>north</li></ol>
Naggel|Neggel	<i>noun</i><br><ol><li>nail</li></ol>
Narr|Narre	<i>noun</i><br><ol><li>fool</li></ol>
Nascht|Neschder|Nescht	<i>noun</i><br><ol><li>branch, stick, twig</li></ol>
Neffyu|Neffyus	<i>noun</i><br><ol><li>nephew</li></ol>
Neid	<i>noun</i><br><ol><li>envy</li></ol>
Nescht|Neschder	<i>noun</i><br><ol><li>nest</li></ol>
Niess|Niesses|Niesse	<i>noun</i><br><ol><li>niece</li></ol>
Nochber|Nochbere	<i>noun</i><br><ol><li>neighbor</li></ol>
Nodel|Nodle	<i>noun</i><br><ol><li>needle</li></ol>
Nowember	<i>noun</i><br><ol><li>November (month)</li></ol>
Nudel|Nudle	<i>noun</i><br><ol><li>noodle, pasta</li><li>vermicelli</li></ol>
Nummidaag|Nummidaage	<i>noun</i><br><ol><li>afternoon</li></ol>
Nuss|Niss	<i>noun</i><br><ol><li>nut</li></ol>
Obscht	<i>noun</i><br><ol><li>fruit</li></ol>
Odem	<i>noun</i><br><ol><li>breath</li></ol>
Offe|Effe	<i>noun</i><br><ol><li>oven</li><li>stove</li></ol>
Ohr|Ohre	<i>noun</i><br><ol><li>ear (hearing organ)</li></ol>
Oi|Oier	<i>noun</i><br><ol><li>egg</li></ol>
Oidodder	<i>noun</i><br><ol><li>egg yolk</li></ol>
Oktower	<i>noun</i><br><ol><li>October (month)</li></ol>
Onkel	<i>noun</i><br><ol><li>uncle</li></ol>
Oschder	<i>name</i><br><ol><li>Easter holiday</li></ol>
Oschderhaas|Oschderhaase	<i>noun</i><br><ol><li>Easter Bunny</li></ol>
Oschderoi|Oschderoier	<i>noun</i><br><ol><li>Easter egg</li></ol>
Oscht	<i>noun</i><br><ol><li>east</li></ol>
Owed|Owedde	<i>noun</i><br><ol><li>evening</li></ol>
Owwerichkeit	<i>noun</i><br><ol><li>(uncommon) government</li></ol>
Ox|Oxe	<i>noun</i><br><ol><li>ox</li></ol>
Paad|Paade	<i>noun</i><br><ol><li>path</li></ol>
Paep|Paeps	<i>noun</i><br><ol><li>pa, pops</li></ol>
Pann|Panne	<i>noun</i><br><ol><li>pan</li></ol>
Pannhaas	<i>noun</i><br><ol><li>scrapple</li></ol>
Pasching	<i>noun</i><br><ol><li>peach</li></ol>
Peffer	<i>noun</i><br><ol><li>pepper</li></ol>
Peif|Peife|Peifli	<i>noun</i><br><ol><li>pipe</li></ol>
Peil|Peiler	<i>noun</i><br><ol><li>arrow</li></ol>
Pennsilfaani	<i>name</i><br><ol><li>Pennsylvania (US state)</li></ol>
Pennsilfaanisch	<i>adj</i><br><ol><li>Pennsylvanian</li></ol>
Pfalz	<i>name</i><br><ol><li>Palatinate, Pfalz</li></ol>
Pikder	<i>noun</i><br><ol><li>picture</li></ol>
Portsch|Bortsch	<i>noun</i><br><ol><li>porch</li></ol>
Raabe	<i>noun</i><br><ol><li>raven</li></ol>
Raache	<i>noun</i><br><ol><li>revenge</li></ol>
Raad|Redder	<i>noun</i><br><ol><li>wheel</li></ol>
Raahm	<i>noun</i><br><ol><li>cream</li></ol>
Ratt|Radde	<i>noun</i><br><ol><li>rat</li></ol>
Reche	<i>noun</i><br><ol><li>rake</li></ol>
Reddich	<i>noun</i><br><ol><li>radish</li></ol>
Regge	<i>noun</i><br><ol><li>rain</li></ol>
Reggeboge	<i>noun</i><br><ol><li>rainbow</li></ol>
Rewwer|Rewwere	<i>noun</i><br><ol><li>river</li></ol>
Rick|Ricke	<i>noun</i><br><ol><li>(anatomy) back</li></ol>
Rickguck|Rickgucke	<i>noun</i><br><ol><li>review, look-back</li></ol>
Ricksack|Rickseck	<i>noun</i><br><ol><li>backpack</li></ol>
Rieb|Riewe	<i>noun</i><br><ol><li>turnip</li></ol>
Ries|Riese	<i>noun</i><br><ol><li>giant</li></ol>
Riesel	<i>noun</i><br><ol><li>proboscis</li><li>snout</li><li>nose</li><li>mouth</li></ol>
Rock|Reck	<i>noun</i><br><ol><li>coat</li></ol>
Rot	<i>noun</i><br><ol><li>counsel, advice</li></ol>
Rotrieb|Rotriewe	<i>noun</i><br><ol><li>beet</li></ol>
Ruh	<i>noun</i><br><ol><li>silence</li></ol>
Runn|Runne	<i>noun</i><br><ol><li>brook, run</li></ol>
Saam|Saame	<i>noun</i><br><ol><li>hem</li><li>seam</li></ol>
Saame	<i>noun</i><br><ol><li>seed</li><li>growing grain</li></ol>
Sach|Sache	<i>noun</i><br><ol><li>thing</li><li>affair, matter, business</li></ol>
Sack|Seck	<i>noun</i><br><ol><li>bag, sack</li></ol>
Saeg|Saege	<i>noun</i><br><ol><li>saw (cutting tool)</li></ol>
Sals	<i>noun</i><br><ol><li>salt</li></ol>
Samschdaag|Samschdaage	<i>noun</i><br><ol><li>Saturday</li></ol>
Satt|Sadde	<i>noun</i><br><ol><li>sort, kind, type</li></ol>
Satz	<i>noun</i><br><ol><li>yeast, leaven</li><li>coffee grounds</li></ol>
Sau|Sei	<i>noun</i><br><ol><li>sow (female pig)</li><li>filthy person</li></ol>
Schaam	<i>noun</i><br><ol><li>modesty</li><li>shame</li><li>foam</li><li>scum</li><li>froth</li></ol>
Schall|Schalle	<i>noun</i><br><ol><li>sound</li><li>echo</li></ol>
Schand	<i>noun</i><br><ol><li>disgrace, dishonor, shame</li></ol>
Schank|Schenk	<i>noun</i><br><ol><li>cupboard</li></ol>
Schatz|Schatz	<i>noun</i><br><ol><li>treasure</li><li>sweetheart, darling</li><li>apron</li></ol>
Schaufel|Schaufle	<i>noun</i><br><ol><li>shovel (broad)</li><li>scoop shovel</li></ol>
Scheed|Scheede	<i>noun</i><br><ol><li>sheath</li><li>scabbard</li><li>case</li></ol>
Scheib|Scheiwe	<i>noun</i><br><ol><li>pane of glass</li><li>disc</li><li>target</li></ol>
Scheier|Scheire	<i>noun</i><br><ol><li>barn</li></ol>
Schenkel	<i>noun</i><br><ol><li>thigh</li><li>leg</li></ol>
Scher|Schere	<i>noun</i><br><ol><li>pair of scissors</li><li>shears</li></ol>
Schiewer	<i>noun</i><br><ol><li>drawer</li><li>sliding bolt of a door</li><li>slide</li></ol>
Schild|Schilder	<i>noun</i><br><ol><li>shield</li><li>sign</li></ol>
Schillgrott|Schillgrodde	<i>noun</i><br><ol><li>tortoise</li><li>turtle</li></ol>
Schinke	<i>noun</i><br><ol><li>ham</li></ol>
Schipp|Schippe	<i>noun</i><br><ol><li>shovel, scoop</li><li>spade (card suit)</li></ol>
Schissel|Schissle	<i>noun</i><br><ol><li>bowl</li><li>dish</li></ol>
Schlaegerei	<i>noun</i><br><ol><li>fight, brawl</li></ol>
Schlang|Schlange	<i>noun</i><br><ol><li>snake, serpent</li></ol>
Schlof	<i>noun</i><br><ol><li>sleep</li></ol>
Schlofschtubb|Schlofschtuwwe	<i>noun</i><br><ol><li>bedroom</li></ol>
Schloss|Schlesser	<i>noun</i><br><ol><li>lock</li></ol>
Schlucker	<i>noun</i><br><ol><li>throat</li></ol>
Schlupp|Schlipp	<i>noun</i><br><ol><li>necktie, bowtie</li><li>loop</li><li>noose</li></ol>
Schmatze	<i>noun</i><br><ol><li>pain</li></ol>
Schmier|Schmiere	<i>noun</i><br><ol><li>grease</li><li>salve, ointment</li></ol>
Schmierkaes	<i>noun</i><br><ol><li>cottage cheese, smear case</li></ol>
Schmitt	<i>noun</i><br><ol><li>smith</li></ol>
Schnawwel	<i>noun</i><br><ol><li>beak, bill</li><li>mouth</li></ol>
Schnee	<i>noun</i><br><ol><li>snow</li></ol>
Schnickel	<i>noun</i><br><ol><li>penis</li></ol>
Schnuppduch|Schnuppdicher	<i>noun</i><br><ol><li>handkerchief</li></ol>
Schnut|Schnude	<i>noun</i><br><ol><li>snout</li><li>wry mouth</li></ol>
Schof	<i>noun</i><br><ol><li>sheep</li></ol>
Schoffleesch	<i>noun</i><br><ol><li>mutton</li></ol>
Schopp|Schepp	<i>noun</i><br><ol><li>shed</li></ol>
Schpaa|Schpae	<i>noun</i><br><ol><li>chip</li></ol>
Schpeck	<i>noun</i><br><ol><li>bacon</li><li>profit</li></ol>
Schpeckmaus|Schpeckmeis	<i>noun</i><br><ol><li>bat (flying mammal)</li></ol>
Schpeech|Schpeeche	<i>noun</i><br><ol><li>spoke</li></ol>
Schpeecht	<i>noun</i><br><ol><li>woodpecker</li><li>flicker</li></ol>
Schpetzli|Schpetzlin	<i>noun</i><br><ol><li>any small bird</li></ol>
Schpiel	<i>noun</i><br><ol><li>play</li></ol>
Schpielbank|Schpielbenk	<i>noun</i><br><ol><li>sink</li></ol>
Schpielsach|Schpielsache	<i>noun</i><br><ol><li>toy</li></ol>
Schpiggel	<i>noun</i><br><ol><li>mirror</li></ol>
Schpitz|Schpitze	<i>noun</i><br><ol><li>penis</li></ol>
Schpotyaahr|Schpotyaahre	<i>noun</i><br><ol><li>autumn, fall (season)</li></ol>
Schprooch|Schprooche	<i>noun</i><br><ol><li>language</li></ol>
Schprung|Schpring	<i>noun</i><br><ol><li>leap, jump</li><li>crack</li></ol>
Schpuck	<i>noun</i><br><ol><li>spook, ghost</li><li>hobgoblin</li></ol>
Schraub|Schrauwe	<i>noun</i><br><ol><li>screw</li></ol>
Schtaab|Schtaawe	<i>noun</i><br><ol><li>staff</li><li>dust</li></ol>
Schtall|Schtelle|Schtell	<i>noun</i><br><ol><li>stable, stall</li></ol>
Schtann|Schtanne	<i>noun</i><br><ol><li>star</li><li>forehead</li></ol>
Schteddel	<i>noun</i><br><ol><li>town, village</li></ol>
Schtee	<i>noun</i><br><ol><li>stone</li></ol>
Schteeesel	<i>noun</i><br><ol><li>male donkey</li></ol>
Schteeg|Schteege	<i>noun</i><br><ol><li>stairs</li><li>footbridge</li></ol>
Schtell|Schtelle	<i>noun</i><br><ol><li>place, position</li><li>employment</li></ol>
Schtick|Schticker	<i>noun</i><br><ol><li>piece, slice, part</li></ol>
Schtiel	<i>noun</i><br><ol><li>handle, helve, stick</li></ol>
Schtimm|Schtimme	<i>noun</i><br><ol><li>voice</li><li>vote</li></ol>
Schtiwwel	<i>noun</i><br><ol><li>boot</li></ol>
Schtock|Schteck	<i>noun</i><br><ol><li>stick, cane</li><li>stack</li><li>plant, bush</li><li>story of a building, floor</li><li>skirt of a dress</li></ol>
Schtols	<i>noun</i><br><ol><li>pride</li></ol>
Schtor|Schtore	<i>noun</i><br><ol><li>store, shop</li></ol>
Schtori|Schtoris	<i>noun</i><br><ol><li>story</li></ol>
Schtrick	<i>noun</i><br><ol><li>rope</li></ol>
Schtroh	<i>noun</i><br><ol><li>straw (hay)</li></ol>
Schtrom|Schtreem	<i>noun</i><br><ol><li>stream</li><li>current</li></ol>
Schtrump|Schtrimp	<i>noun</i><br><ol><li>stocking</li></ol>
Schtubb|Schtuwwe	<i>noun</i><br><ol><li>a room in a building or house</li></ol>
Schtuhl|Schtiehl	<i>noun</i><br><ol><li>chair</li></ol>
Schtund|Schtunde	<i>noun</i><br><ol><li>hour</li></ol>
Schtunn|Schtunne	<i>noun</i><br><ol><li>hour</li></ol>
Schubblaad|Schubblaade	<i>noun</i><br><ol><li>drawer</li></ol>
Schuh	<i>noun</i><br><ol><li>shoe</li></ol>
Schul|Schule	<i>noun</i><br><ol><li>school (place of learning)</li></ol>
Schunke	<i>noun</i><br><ol><li>ham</li></ol>
Schunkefleesch	<i>noun</i><br><ol><li>ham</li></ol>
Schwaer|Schwaere	<i>noun</i><br><ol><li>father-in-law</li></ol>
Schwaerdaadi|Schwaerdaadis	<i>noun</i><br><ol><li>father-in-law</li></ol>
Schwaermammi|Schwaermammis	<i>noun</i><br><ol><li>mother-in-law</li></ol>
Schwarz	<i>noun</i><br><ol><li>black</li></ol>
Schwatzvoggel|Schwatzveggel	<i>noun</i><br><ol><li>blackbird</li></ol>
Schweess	<i>noun</i><br><ol><li>sweat</li></ol>
Schweschder|Schweschdre	<i>noun</i><br><ol><li>sister</li><li>nun</li></ol>
Schwiegerdochder|Schwiegerdechder	<i>noun</i><br><ol><li>daughter-in-law</li></ol>
Schwiegermudder|Schwiegermidder	<i>noun</i><br><ol><li>mother-in-law</li></ol>
Schwiegern|Schwiegerne	<i>noun</i><br><ol><li>mother-in-law</li></ol>
Schwiegersoh|Schwiegerseh	<i>noun</i><br><ol><li>son-in-law</li></ol>
Schwiegervadder|Schwiegervedder	<i>noun</i><br><ol><li>father-in-law</li></ol>
Schwitz	<i>noun</i><br><ol><li>sweat</li></ol>
Schwoger|Schwaeger	<i>noun</i><br><ol><li>brother-in-law</li></ol>
See	<i>noun</i><br><ol><li>lake</li><li>sea, ocean</li></ol>
Seef	<i>noun</i><br><ol><li>soap</li></ol>
Seelichkeet	<i>noun</i><br><ol><li>salvation</li></ol>
Sege	<i>noun</i><br><ol><li>blessing, benediction</li></ol>
Seit|Seide	<i>noun</i><br><ol><li>side</li></ol>
Sepdember	<i>noun</i><br><ol><li>September (month)</li></ol>
Sicht|Sichde	<i>noun</i><br><ol><li>outlook, view</li></ol>
Silwer	<i>noun</i><br><ol><li>silver</li></ol>
Sims	<i>noun</i><br><ol><li>cornice</li><li>shelf</li></ol>
Sitz|Sitze	<i>noun</i><br><ol><li>seat</li></ol>
Sitzloch|Sitzlecher	<i>noun</i><br><ol><li>anus</li><li>ass</li></ol>
Soh|Seh	<i>noun</i><br><ol><li>son</li></ol>
Soot	<i>noun</i><br><ol><li>seed</li><li>growing grain</li><li>season for sowing winter cereals</li></ol>
Sudde	<i>noun</i><br><ol><li>south</li></ol>
Sunn|Sunne	<i>noun</i><br><ol><li>the sun</li></ol>
Sunndaag|Sunndaage	<i>noun</i><br><ol><li>Sunday</li></ol>
Sunndaagsgleeder	<i>noun</i><br><ol><li>Sunday clothes (plural)</li></ol>
Supp|Suppe	<i>noun</i><br><ol><li>soup</li></ol>
Tee	<i>noun</i><br><ol><li>tea</li></ol>
Tomaet|Tomaets	<i>noun</i><br><ol><li>tomato</li></ol>
Ton|Teen	<i>noun</i><br><ol><li>sound</li><li>tone</li></ol>
Tschab|Tschabs	<i>noun</i><br><ol><li>job</li></ol>
Tschaepp	<i>noun</i><br><ol><li>fellow</li></ol>
Tscheel|Tscheels	<i>noun</i><br><ol><li>jail, gaol</li></ol>
Tschulei	<i>noun</i><br><ol><li>July (month)</li></ol>
Uffning	<i>noun</i><br><ol><li>opening</li></ol>
Uhr|Uhre	<i>noun</i><br><ol><li>clock</li><li>o'clock</li></ol>
Umhang|Umheng	<i>noun</i><br><ol><li>curtain</li></ol>
Unglick|Unglicke	<i>noun</i><br><ol><li>misfortune, accident, bad luck</li></ol>
Ungraut	<i>noun</i><br><ol><li>weeds</li></ol>
Unkel	<i>noun</i><br><ol><li>uncle</li></ol>
Vaddel	<i>noun</i><br><ol><li>quarter (fraction rather than coin)</li></ol>
Vadder|Vedder	<i>noun</i><br><ol><li>father</li></ol>
Versammling|Fersommlinge|Fersommling|Versammlinge	<i>noun</i><br><ol><li>meeting, assembly, congregation</li><li>fersommling</li></ol>
Verschpreche	<i>noun</i><br><ol><li>promise</li></ol>
Vieh	<i>noun</i><br><ol><li>(collective) livestock, cattle</li></ol>
Voggel|Veggel	<i>noun</i><br><ol><li>bird</li></ol>
Volk	<i>noun</i><br><ol><li>people, folk</li></ol>
Vorhang|Vorheng	<i>noun</i><br><ol><li>curtain</li></ol>
Waache	<i>noun</i><br><ol><li>wagon</li></ol>
Waddebuch|Waddebicher	<i>noun</i><br><ol><li>dictionary</li></ol>
Wagge|Wegge	<i>noun</i><br><ol><li>wagon</li></ol>
Wammes|Wemmes	<i>noun</i><br><ol><li>jacket</li><li>jumper</li><li>blouse</li></ol>
Wand|Wend	<i>noun</i><br><ol><li>interior wall</li></ol>
Wans|Wanse	<i>noun</i><br><ol><li>bedbug</li></ol>
Warkzeich	<i>noun</i><br><ol><li>tool, implement</li></ol>
Warscht|Warschde	<i>noun</i><br><ol><li>sausage</li></ol>
Wasser	<i>noun</i><br><ol><li>water</li></ol>
Watt|Wadde	<i>noun</i><br><ol><li>word</li></ol>
Watzel|Watzle	<i>noun</i><br><ol><li>root</li></ol>
Web|Wewe	<i>noun</i><br><ol><li>web</li></ol>
Weck	<i>noun</i><br><ol><li>small light cake</li><li>bread roll</li></ol>
Wedder	<i>noun</i><br><ol><li>weather</li><li>storm, thunderstorm</li></ol>
Wedding|Weddinge	<i>noun</i><br><ol><li>bet</li></ol>
Weed|Weede	<i>noun</i><br><ol><li>pasture</li></ol>
Weeze	<i>noun</i><br><ol><li>wheat</li></ol>
Weg|Wege	<i>noun</i><br><ol><li>way</li><li>road</li><li>direction</li></ol>
Weh	<i>noun</i><br><ol><li>soreness, pain</li></ol>
Wei	<i>noun</i><br><ol><li>wine</li></ol>
Weib|Weiwer	<i>noun</i><br><ol><li>wife</li><li>woman</li></ol>
Weigeischt	<i>noun</i><br><ol><li>alcohol</li></ol>
Welschhaahne	<i>noun</i><br><ol><li>turkey</li><li>turkey gobbler</li></ol>
Welschhinkel	<i>noun</i><br><ol><li>turkey</li></ol>
Welschkann	<i>noun</i><br><ol><li>corn, maize</li></ol>
Welt|Welder	<i>noun</i><br><ol><li>world</li></ol>
Wesch	<i>noun</i><br><ol><li>wash, laundry</li></ol>
Weschp|Weschpe	<i>noun</i><br><ol><li>wasp</li></ol>
Wescht	<i>noun</i><br><ol><li>west</li></ol>
Wese	<i>noun</i><br><ol><li>being</li><li>fuss, row</li></ol>
Wexel|Wexel	<i>noun</i><br><ol><li>change</li><li>sudden turn</li><li>change (money)</li></ol>
Wilkum	<i>noun</i><br><ol><li>welcome</li></ol>
Willkumm	<i>noun</i><br><ol><li>welcome</li></ol>
Winder	<i>noun</i><br><ol><li>winter</li></ol>
Winkel	<i>noun</i><br><ol><li>square</li><li>angle</li><li>corner</li><li>gusset</li></ol>
Woch|Woche	<i>noun</i><br><ol><li>week</li></ol>
Woi	<i>noun</i><br><ol><li>hawk</li></ol>
Wolf|Welf	<i>noun</i><br><ol><li>wolf</li></ol>
Woll	<i>noun</i><br><ol><li>wool</li></ol>
Wuhnschtubb|Wuhnschtuwwe	<i>noun</i><br><ol><li>living room</li></ol>
Wutz|Wutze	<i>noun</i><br><ol><li>pig</li></ol>
Wutzli|Wutzlin	<i>noun</i><br><ol><li>piglet</li><li>piggy, little pig</li></ol>
Yaahr|Yaahre	<i>noun</i><br><ol><li>year</li></ol>
Yaahreszeit|Yaahreszeide	<i>noun</i><br><ol><li>season</li></ol>
Yaeger	<i>noun</i><br><ol><li>hunter</li></ol>
Yanuaar	<i>noun</i><br><ol><li>January (month)</li></ol>
Yenner	<i>noun</i><br><ol><li>January (month)</li></ol>
Yingling	<i>noun</i><br><ol><li>young, youth</li></ol>
Yoch|Yocher	<i>noun</i><br><ol><li>yoke</li></ol>
Yuli	<i>noun</i><br><ol><li>July (month)</li></ol>
Yuni	<i>noun</i><br><ol><li>June (month)</li></ol>
Yuuchend	<i>noun</i><br><ol><li>youth</li></ol>
Yux	<i>noun</i><br><ol><li>jerk</li><li>shout</li><li>Indian whoop</li></ol>
Zaah|Zaeh	<i>noun</i><br><ol><li>tooth</li></ol>
Zacke	<i>noun</i><br><ol><li>prong, projection</li><li>branch</li><li>fruit spur</li><li>tooth, tine</li><li>scallop-edge</li></ol>
Zappe	<i>noun</i><br><ol><li>faucet</li></ol>
Zeeche	<i>noun</i><br><ol><li>sign, omen</li><li>clock hand</li><li>zodiac sign</li></ol>
Zehe	<i>noun</i><br><ol><li>toe</li></ol>
Zeiding|Zeidinge	<i>noun</i><br><ol><li>newspaper</li></ol>
Zeit|Zeide	<i>noun</i><br><ol><li>time</li></ol>
Zeitverdreib	<i>noun</i><br><ol><li>pastime, diversion</li></ol>
Zelt|Zelder	<i>noun</i><br><ol><li>tent</li></ol>
Zier	<i>noun</i><br><ol><li>ornament</li><li>sweetheart</li></ol>
Zieraat|Zieraade	<i>noun</i><br><ol><li>ornament</li></ol>
Zung|Zunge	<i>noun</i><br><ol><li>tongue</li></ol>
Zwarich	<i>noun</i><br><ol><li>dwarf</li></ol>
Zweiwel|Zweiwle	<i>noun</i><br><ol><li>doubt</li></ol>
Zwiwwel|Zwiwwle	<i>noun</i><br><ol><li>onion</li><li>bulb (plant)</li></ol>
aa	<i>adv</i><br><ol><li>also</li></ol><br><i>prep</i><br><ol><li>on</li><li>to</li></ol>
aabetungswaerdich	<i>adj</i><br><ol><li>adorable</li></ol>
aadechtich	<i>adj</i><br><ol><li>attentive</li><li>devotional</li></ol><br><i>adv</i><br><ol><li>attentively</li><li>devotionally</li></ol>
aadreffe	<i>verb</i><br><ol><li>to meet</li></ol>
aaduh	<i>verb</i><br><ol><li>(reflexive) to get dressed</li></ol>
aafange	<i>verb</i><br><ol><li>to begin, to start</li></ol>
aafingre	<i>verb</i><br><ol><li>to touch, to handle</li></ol>
aagebore	<i>adj</i><br><ol><li>hereditary</li><li>inborn</li><li>innate</li><li>intuitive</li></ol>
aagebroche	<i>adj</i><br><ol><li>opened</li></ol>
aagelegge	<i>adj</i><br><ol><li>concerned for</li><li>solicitous</li></ol>
aagenehm	<i>adj</i><br><ol><li>agreeable</li><li>delightful</li><li>welcome</li></ol>
aagenehmlicherweiss	<i>adj</i><br><ol><li>agreeable</li><li>pleasant</li></ol>
aagescheinlich	<i>adj</i><br><ol><li>evident</li></ol>
aagfault	<i>adj</i><br><ol><li>rotten</li></ol>
aagrisse	<i>adj</i><br><ol><li>torn</li></ol>
aagschpellt	<i>adj</i><br><ol><li>pinned (on)</li></ol>
aagschtoche	<i>adj</i><br><ol><li>worm-eaten</li></ol>
aagwaxe	<i>adj</i><br><ol><li>pleuritic</li></ol>
aahaltend	<i>adj</i><br><ol><li>continuous</li></ol>
aahawwe	<i>verb</i><br><ol><li>to wear, to have on</li></ol>
aaheemlich	<i>adj</i><br><ol><li>comfortable</li><li>homelike</li></ol>
aahengisch	<i>adj</i><br><ol><li>clinging</li><li>sticky</li><li>tenacious</li></ol>
aalache	<i>verb</i><br><ol><li>to smile</li><li>to attract</li></ol>
aardich	<i>adj</i><br><ol><li>decent</li></ol>
aarem	<i>adj</i><br><ol><li>needy</li><li>in need</li><li>poor</li></ol>
aaremseelich	<i>adj</i><br><ol><li>paltry</li><li>pitiful</li><li>poor</li><li>needy</li></ol>
aarensch	<i>adj</i><br><ol><li>orange</li></ol>
aarufe|daet aarufe|rufscht aa|rufe aa|ruf aa|hot aagerufe|ruft aa|waerd aarufe	<i>verb</i><br><ol><li>to call, to phone, to ring</li></ol>
aatme	<i>verb</i><br><ol><li>to breathe</li></ol>
aawaerre|aawaerre v	<i>phrase</i><br><ol><li>get rid of</li></ol>
ab	<i>prep</i><br><ol><li>off</li><li>from</li><li>away</li></ol>
abaddich	<i>adj</i><br><ol><li>particular</li><li>special</li><li>dainty</li><li>select</li><li>exclusive</li></ol><br><i>adv</i><br><ol><li>particularly</li><li>especially</li></ol>
abkoche	<i>verb</i><br><ol><li>to boil</li><li>to parboil</li></ol>
achde	<i>num</i><br><ol><li>eight</li><li>eighth</li></ol><br><i>adj</i><br><ol><li>eighth</li></ol>
acht	<i>num</i><br><ol><li>eight</li><li>eighth</li></ol><br><i>adj</i><br><ol><li>eighth</li></ol>
acht un dreissich	<i>num</i><br><ol><li>thirty-eight</li></ol>
acht un fuffzich	<i>num</i><br><ol><li>fifty-eight</li></ol>
acht un neinzich	<i>num</i><br><ol><li>ninety-eight</li></ol>
acht un sechzich	<i>num</i><br><ol><li>sixty-eight</li></ol>
acht un siwwezich	<i>num</i><br><ol><li>seventy-eight</li></ol>
acht un varzich	<i>num</i><br><ol><li>forty-eight</li></ol>
acht un zwansich	<i>num</i><br><ol><li>twenty-eight</li></ol>
achtzeh	<i>num</i><br><ol><li>eighteen</li></ol>
achtzeht	<i>adj</i><br><ol><li>eighteenth</li></ol><br><i>num</i><br><ol><li>eighteenth</li></ol>
achtzich	<i>num</i><br><ol><li>eighty</li></ol>
achzeh	<i>num</i><br><ol><li>eighteen</li></ol>
aehnlich	<i>adj</i><br><ol><li>similar, like</li></ol>
all	<i>adj</i><br><ol><li>all</li></ol>
allebeed	<i>pron</i><br><ol><li>both</li></ol>
allee	<i>adj</i><br><ol><li>alone</li></ol><br><i>adv</i><br><ol><li>alone</li></ol>
alleenich	<i>adj</i><br><ol><li>alone</li></ol>
allesmenanner	<i>pron</i><br><ol><li>everything</li></ol>
allezwee	<i>pron</i><br><ol><li>both</li></ol>
alliebber	<i>pron</i><br><ol><li>everyone, everybody</li></ol>
allrecht	<i>adv</i><br><ol><li>all right</li></ol>
allsfatt	<i>adv</i><br><ol><li>always</li></ol>
alsemol	<i>adv</i><br><ol><li>sometimes</li></ol>
alsfatt	<i>adv</i><br><ol><li>always</li></ol>
alt|elder|eltscht	<i>adj</i><br><ol><li>old</li></ol>
angle	<i>verb</i><br><ol><li>to fish, angle</li></ol>
anner	<i>adj</i><br><ol><li>other</li></ol><br><i>pron</i><br><ol><li>(indefinite) other</li></ol>
arrig	<i>adv</i><br><ol><li>very</li></ol>
aryets	<i>adv</i><br><ol><li>somewhere</li></ol>
as	<i>conj</i><br><ol><li>as</li><li>than</li><li>but</li></ol><br><i>pron</i><br><ol><li>(relative) which</li><li>(relative) who</li></ol>
aus	<i>prep</i><br><ol><li>out of, from</li></ol>
aussehne	<i>verb</i><br><ol><li>to look, to appear</li></ol>
awwer|awer	<i>conj</i><br><ol><li>but</li></ol>
baar	<i>adj</i><br><ol><li>bare</li><li>naked</li></ol>
backe	<i>verb</i><br><ol><li>to bake</li></ol>
baddere	<i>verb</i><br><ol><li>to bother</li></ol>
balwiere	<i>verb</i><br><ol><li>to shave</li></ol>
bang	<i>adj</i><br><ol><li>afraid, scared, fearful</li><li>timid</li><li>uneasy</li></ol>
barye	<i>verb</i><br><ol><li>to borrow</li><li>to loan</li><li>to trust</li><li>to give credit</li></ol>
baue	<i>verb</i><br><ol><li>to build</li></ol>
bauere	<i>verb</i><br><ol><li>to farm, to cultivate</li></ol>
bedaerfe	<i>verb</i><br><ol><li>to want</li><li>to need</li></ol>
bedauerlich	<i>adj</i><br><ol><li>sad</li></ol>
bede	<i>verb</i><br><ol><li>to pray</li></ol>
beed	<i>adj</i><br><ol><li>both</li></ol>
bees	<i>adj</i><br><ol><li>angry</li><li>offended</li></ol>
begreife	<i>verb</i><br><ol><li>to understand, comprehend</li></ol>
bei	<i>prep</i><br><ol><li>near</li><li>at, at the house of</li><li>amidst, among</li><li>by</li><li>in</li><li>with</li><li>during</li></ol>
beile	<i>verb</i><br><ol><li>to hew</li><li>to cut</li></ol>
beriehmt	<i>adj</i><br><ol><li>famous, renowned</li><li>celebrated</li><li>distinguished</li></ol>
bewillkumme	<i>verb</i><br><ol><li>to welcome</li></ol>
bezaahle	<i>verb</i><br><ol><li>to pay</li></ol>
bidde	<i>verb</i><br><ol><li>to ask, to request</li><li>to beseech</li></ol>
biede	<i>verb</i><br><ol><li>to bid, to offer</li><li>to beat, to excel, to surpass, to triumph over</li></ol>
binne	<i>verb</i><br><ol><li>to bind together</li><li>to tie</li></ol>
bissich	<i>adj</i><br><ol><li>biting, scathing</li></ol>
blaffe	<i>verb</i><br><ol><li>to bark</li></ol>
blaudre	<i>verb</i><br><ol><li>to talk, to chat</li></ol>
bleiwe	<i>verb</i><br><ol><li>to stay, to remain</li></ol>
bletzlich	<i>adv</i><br><ol><li>suddenly</li></ol>
bloh	<i>adj</i><br><ol><li>blue</li></ol>
blooss	<i>adj</i><br><ol><li>bare</li><li>naked</li></ol><br><i>adv</i><br><ol><li>simply, merely</li></ol>
blose	<i>verb</i><br><ol><li>to blow</li><li>to brag</li><li>to scold</li></ol>
bluge	<i>verb</i><br><ol><li>to plow</li></ol>
bosse	<i>verb</i><br><ol><li>to kiss</li></ol>
braav	<i>adj</i><br><ol><li>brave</li><li>good, honest</li></ol>
brau	<i>adj</i><br><ol><li>brown</li></ol>
brauche|daet brauche|braucht|hot gebraucht|brauchscht|waerd brauche|brauch	<i>verb</i><br><ol><li>to need</li><li>to use</li><li>to stand in need of</li></ol>
breche	<i>verb</i><br><ol><li>to break</li></ol>
breet	<i>adj</i><br><ol><li>broad, wide</li></ol>
brenne	<i>verb</i><br><ol><li>to burn</li></ol>
briehe	<i>verb</i><br><ol><li>to scald</li><li>to parboil</li></ol>
bringe	<i>verb</i><br><ol><li>to bring</li></ol>
brockle	<i>verb</i><br><ol><li>to crumble</li><li>to break</li></ol>
brode	<i>verb</i><br><ol><li>to fry</li></ol>
browiere	<i>verb</i><br><ol><li>to try, to attempt</li></ol>
brumme	<i>verb</i><br><ol><li>to hum</li><li>to buzz</li><li>to grumble</li></ol>
bucklich	<i>adj</i><br><ol><li>uneven</li><li>hilly</li><li>humpbacked, hunchbacked</li><li>stooped</li></ol>
daafe	<i>verb</i><br><ol><li>to baptize</li></ol>
daerfe	<i>verb</i><br><ol><li>may, to be allowed to do something</li><li>to dare</li></ol>
dappich|doppich	<i>adj</i><br><ol><li>clumsy</li></ol>
darrich	<i>prep</i><br><ol><li>through, throughout</li></ol>
dart|datt	<i>adv</i><br><ol><li>there</li></ol>
dausend	<i>num</i><br><ol><li>thousand</li></ol>
de|Ne|en|es|du|uns|ihne|Sie|mir|ihm|ihre|ihn|dem|er|Ihne|dir|sie|der|mer|ne|mich|em|dich|dihr|die|re|ich|de|eich|se	<i>article</i><br><ol><li>the</li></ol><br><i>pron</i><br><ol><li>you</li></ol>
deede|waerd deede|hot gedeet|deet|daet deede|dihr deet|deetscht	<i>verb</i><br><ol><li>to kill</li></ol>
deheem	<i>adv</i><br><ol><li>at home, home</li></ol>
dei|deim|deine|deinre	<i>adj</i><br><ol><li>(possessive) your</li></ol>
deier	<i>adj</i><br><ol><li>dear</li><li>expensive</li></ol>
deitsch	<i>adj</i><br><ol><li>German or Pennsylvania German</li></ol>
dem|es|em|de|die|dem|der	<i>article</i><br><ol><li>the</li></ol>
denke	<i>verb</i><br><ol><li>to think</li></ol>
denowed	<i>adv</i><br><ol><li>this evening</li></ol>
der|Ne|en|es|du|uns|ihne|Sie|mir|ihm|ihre|ihn|dem|er|Ihne|dir|sie|der|mer|ne|mich|em|dich|dihr|die|re|ich|de|eich|se	<i>article</i><br><ol><li>the</li></ol><br><i>pron</i><br><ol><li>to you</li></ol>
deswege	<i>adv</i><br><ol><li>therefore</li></ol>
dich|Ne|en|es|du|uns|ihne|Sie|mir|ihm|ihre|ihn|er|Ihne|dir|sie|der|mer|ne|mich|em|dich|dihr|re|ich|de|eich|se	<i>pron</i><br><ol><li>you</li></ol>
dicht	<i>adj</i><br><ol><li>dense</li><li>close, nearby</li></ol>
dick	<i>adj</i><br><ol><li>thick</li><li>close</li><li>stout</li></ol>
die|die|es|em|de|der|dem	<i>article</i><br><ol><li>the</li></ol>
dief	<i>adj</i><br><ol><li>deep</li></ol>
dihr|Ne|en|es|du|uns|ihne|Sie|mir|ihm|ihre|ihn|er|Ihne|dir|sie|der|mer|ne|mich|em|dich|dihr|re|ich|de|eich|se	<i>pron</i><br><ol><li>you (plural)</li></ol>
dinn	<i>adj</i><br><ol><li>thin</li></ol>
dir|Ne|en|es|du|uns|ihne|Sie|mir|ihm|ihre|ihn|er|Ihne|dir|sie|der|mer|ne|mich|em|dich|dihr|re|ich|de|eich|se	<i>pron</i><br><ol><li>to you</li></ol>
dischder	<i>adj</i><br><ol><li>dim</li><li>dusky</li></ol>
do	<i>adv</i><br><ol><li>here</li></ol>
dot	<i>adj</i><br><ol><li>dead</li></ol>
dotmache|machscht dot|mach dot|hot dotgemacht|waerd dotmache|daet dotmache|dihr macht dot|mache dot|macht dot	<i>verb</i><br><ol><li>to kill</li></ol>
draame	<i>verb</i><br><ol><li>to dream</li></ol>
draurich	<i>adj</i><br><ol><li>sad</li><li>afflicted</li></ol>
dreckich	<i>adj</i><br><ol><li>dirty, filthy</li></ol>
drede	<i>verb</i><br><ol><li>to tread</li><li>to kick</li><li>to step</li></ol>
drei	<i>num</i><br><ol><li>three</li></ol>
drei un achtzich	<i>num</i><br><ol><li>eighty-three</li></ol>
drei un dreissich	<i>num</i><br><ol><li>thirty-three</li></ol>
drei un fuffzich	<i>num</i><br><ol><li>fifty-three</li></ol>
drei un neinzich	<i>num</i><br><ol><li>ninety-three</li></ol>
drei un sechzich	<i>num</i><br><ol><li>sixty-three</li></ol>
drei un siwwezich	<i>num</i><br><ol><li>seventy-three</li></ol>
drei un varzich	<i>num</i><br><ol><li>forty-three</li></ol>
drei un zwansich	<i>num</i><br><ol><li>twenty-three</li></ol>
dreissich	<i>num</i><br><ol><li>thirty</li></ol>
dreiwe	<i>verb</i><br><ol><li>to drive</li><li>to put forth leaves</li><li>to engage in</li><li>to do</li></ol>
dreizeh	<i>num</i><br><ol><li>thirteen</li></ol>
dreizeht	<i>adj</i><br><ol><li>thirteenth</li></ol><br><i>num</i><br><ol><li>thirteenth</li></ol>
drenke	<i>verb</i><br><ol><li>to water plants or animals</li><li>to suckle</li></ol>
drinke|drinkt|waerd drinke|hot gedrunke|drinkscht|drink	<i>verb</i><br><ol><li>to drink</li></ol>
dritt	<i>adj</i><br><ol><li>third</li></ol><br><i>num</i><br><ol><li>third</li></ol>
driwwe	<i>adv</i><br><ol><li>over there</li><li>on the other side</li></ol>
du|Ne|en|es|uns|du|Sie|ihne|mir|ihm|ihre|ihn|er|Ihne|dir|sie|der|mer|ne|mich|em|dich|dihr|re|ich|de|eich|se	<i>pron</i><br><ol><li>you</li></ol>
duh|duhscht|dutt|hot geduh|daede|daet|waerd duh|duhne|daetscht	<i>verb</i><br><ol><li>to do</li></ol>
dunkel	<i>adj</i><br><ol><li>dark</li></ol>
ebber	<i>pron</i><br><ol><li>someone, somebody</li></ol>
ebbes|eppes	<i>pron</i><br><ol><li>something</li></ol>
eefachdich	<i>adj</i><br><ol><li>single</li></ol>
eefacht	<i>adj</i><br><ol><li>single</li></ol>
een un achtzich	<i>num</i><br><ol><li>eighty-one</li></ol>
een un dreissich	<i>num</i><br><ol><li>thirty-one</li></ol>
een un fuffzich	<i>num</i><br><ol><li>fifty-one</li></ol>
een un neinzich	<i>num</i><br><ol><li>ninety-one</li></ol>
een un sechzich	<i>num</i><br><ol><li>sixty-one</li></ol>
een un siwwezich	<i>num</i><br><ol><li>seventy-one</li></ol>
een un varzich	<i>num</i><br><ol><li>forty-one</li></ol>
een un zwansich	<i>num</i><br><ol><li>twenty-one</li></ol>
eens	<i>num</i><br><ol><li>one</li></ol>
eensel	<i>adj</i><br><ol><li>single</li></ol><br><i>adv</i><br><ol><li>singly</li></ol>
eeschtlich	<i>adj</i><br><ol><li>easterly</li><li>eastern</li></ol>
efders	<i>adv</i><br><ol><li>often, frequently</li></ol>
effne	<i>verb</i><br><ol><li>to open</li></ol>
eich|Ne|en|es|du|uns|ihne|Sie|mir|ihm|ihre|ihn|er|Ihne|dir|sie|der|mer|ne|mich|em|dich|dihr|re|ich|de|eich|se	<i>pron</i><br><ol><li>accusative and dative of dihr; you, yourselves</li></ol>
eier	<i>adj</i><br><ol><li>(possessive) your (plural)</li></ol>
elf	<i>num</i><br><ol><li>eleven</li></ol>
elft	<i>adj</i><br><ol><li>eleventh</li></ol><br><i>num</i><br><ol><li>eleventh</li></ol>
em|Ne|en|es|du|uns|ihne|Sie|mir|ihm|ihre|ihn|dem|er|Ihne|dir|sie|der|mer|ne|mich|em|dich|dihr|die|re|ich|de|eich|se	<i>article</i><br><ol><li>the</li></ol><br><i>pron</i><br><ol><li>to him</li></ol>
en|Ne|en|es|du|uns|ihne|Sie|mir|ihm|ihre|ihn|er|Ihne|dir|sie|der|mer|ne|me|mich|em|dich|dihr|re|ich|de|eich|se	<i>article</i><br><ol><li>a, an</li></ol><br><i>pron</i><br><ol><li>him</li></ol>
en Latt	<i>noun</i><br><ol><li>a lot (many, much)</li></ol>
endlich	<i>adv</i><br><ol><li>finally</li></ol>
ennere	<i>verb</i><br><ol><li>to change, alter</li></ol>
er|Ne|en|es|du|uns|ihne|Sie|mir|ihm|ihre|ihn|er|Ihne|dir|sie|der|mer|ne|mich|em|dich|dihr|re|ich|de|eich|se	<i>pron</i><br><ol><li>he</li></ol>
erscht	<i>adj</i><br><ol><li>first</li></ol><br><i>num</i><br><ol><li>first</li></ol>
erwaarde	<i>verb</i><br><ol><li>to expect</li><li>to await, to wait for</li></ol>
es|Ne|en|es|du|uns|ihne|Sie|mir|ihm|ihre|ihn|dem|er|Ihne|dir|sie|der|mer|ne|mich|em|dich|dihr|die|re|ich|de|eich|se	<i>article</i><br><ol><li>the</li></ol><br><i>pron</i><br><ol><li>it</li></ol>
esse|esst|daet esse|esscht|hot gesse|waerd esse|dihr esst|ess	<i>verb</i><br><ol><li>to eat</li></ol>
ewe	<i>adj</i><br><ol><li>even</li><li>level</li></ol>
faahre|daet faahre|faahrscht|iss gfaahre|waerd faahre|faahr|faahrt	<i>verb</i><br><ol><li>to drive, to ride</li></ol>
faddich	<i>adj</i><br><ol><li>done</li><li>finished</li><li>ready</li></ol>
falle	<i>verb</i><br><ol><li>to fall</li><li>to be contributed</li></ol>
fange	<i>verb</i><br><ol><li>to catch, to seize</li></ol>
farichde	<i>verb</i><br><ol><li>to fear</li><li>(reflexive) to be afraid</li></ol>
fatzay	<i>num</i><br><ol><li>fourteen</li></ol>
fatze	<i>verb</i><br><ol><li>to fart</li></ol>
fechde	<i>verb</i><br><ol><li>to fight</li></ol>
feese	<i>verb</i><br><ol><li>to face</li><li>to faze</li></ol>
fege	<i>verb</i><br><ol><li>to sweep</li><li>to clean</li></ol>
fer	<i>prep</i><br><ol><li>for</li></ol>
ferwas	<i>adv</i><br><ol><li>(interrogatory) why</li></ol><br><i>conj</i><br><ol><li>why</li></ol>
fett	<i>adj</i><br><ol><li>fat</li><li>fleshy</li><li>rich (of soil)</li></ol>
fiah	<i>num</i><br><ol><li>four</li></ol>
ficke	<i>verb</i><br><ol><li>(vulgar) to fuck</li></ol>
fiedre	<i>verb</i><br><ol><li>to feed</li></ol>
fiehle	<i>verb</i><br><ol><li>to feel</li></ol>
fierra	<i>num</i><br><ol><li>four</li></ol>
fille	<i>verb</i><br><ol><li>to fill</li><li>to farce</li><li>to foal</li></ol>
fimf	<i>num</i><br><ol><li>five</li></ol>
fimf un achtzich	<i>num</i><br><ol><li>eighty-five</li></ol>
fimf un dreissich	<i>num</i><br><ol><li>thirty-five</li></ol>
fimf un fuffzich	<i>num</i><br><ol><li>fifty-five</li></ol>
fimf un neinzich	<i>num</i><br><ol><li>ninety-five</li></ol>
fimf un sechzich	<i>num</i><br><ol><li>sixty-five</li></ol>
fimf un siwwezich	<i>num</i><br><ol><li>seventy-five</li></ol>
fimf un varzich	<i>num</i><br><ol><li>forty-five</li></ol>
fimf un zwansich	<i>num</i><br><ol><li>twenty-five</li></ol>
fimft	<i>adj</i><br><ol><li>fifth</li></ol><br><i>num</i><br><ol><li>fifth</li></ol>
fingre	<i>verb</i><br><ol><li>to finger</li></ol>
finne	<i>verb</i><br><ol><li>to find</li><li>to furnish</li></ol>
finschder	<i>adj</i><br><ol><li>dark</li></ol>
fleissich	<i>adj</i><br><ol><li>industrious</li><li>diligent</li></ol>
folye	<i>verb</i><br><ol><li>to follow</li></ol>
freehlich	<i>adj</i><br><ol><li>joyful, merry, cheerful</li></ol>
frehlich	<i>adj</i><br><ol><li>merry, cheerful</li></ol>
frei	<i>adj</i><br><ol><li>free</li><li>exempt</li><li>clear</li></ol>
fremm	<i>adj</i><br><ol><li>strange, unacquainted</li></ol>
frieh	<i>adv</i><br><ol><li>early</li></ol>
friehzeidich	<i>adj</i><br><ol><li>early</li></ol>
froge	<i>verb</i><br><ol><li>to ask, to question</li></ol>
froh	<i>adj</i><br><ol><li>happy, glad, joyful</li></ol>
fromm	<i>adj</i><br><ol><li>pious, devout</li><li>gentle, tractable (of animals)</li></ol>
fuffzeh	<i>num</i><br><ol><li>fifteen</li></ol>
fuffzeht	<i>adj</i><br><ol><li>fifteenth</li></ol><br><i>num</i><br><ol><li>fifteenth</li></ol>
fuffzich	<i>num</i><br><ol><li>fifty</li></ol>
fuftzay	<i>num</i><br><ol><li>fifteen</li></ol>
garn	<i>adv</i><br><ol><li>gladly</li><li>willingly</li><li>be likely to</li></ol>
gauze	<i>verb</i><br><ol><li>to bark</li></ol>
gege	<i>prep</i><br><ol><li>toward</li><li>against</li></ol>
geh|gehscht|iss gange|gehne|geht|waerd geh	<i>verb</i><br><ol><li>to go</li></ol>
gehl	<i>adj</i><br><ol><li>yellow</li></ol>
geize	<i>verb</i><br><ol><li>to be stingy</li><li>to scrimp</li></ol>
geizich	<i>adj</i><br><ol><li>stingy, miserly</li></ol>
gelege	<i>adj</i><br><ol><li>opportune</li></ol>
genunk	<i>adv</i><br><ol><li>enough</li></ol><br><i>det</i><br><ol><li>enough</li></ol>
geschder	<i>adv</i><br><ol><li>yesterday</li></ol>
gettlich	<i>adj</i><br><ol><li>divine</li><li>godly</li></ol>
gewwe|geebt|waerd gewwe|gebt|geb|gebscht|hot gegewwe	<i>verb</i><br><ol><li>to give</li></ol>
giesse	<i>verb</i><br><ol><li>to pour</li><li>to sprinkle</li><li>to cast (metal)</li></ol>
gilbse	<i>verb</i><br><ol><li>to yell, to shout</li></ol>
glaawe|hot geglaabt|glaab|waerd glaawe|glaabscht|daet glaawe|glaabt	<i>verb</i><br><ol><li>to believe</li><li>to think, to suppose</li></ol>
gleddere	<i>verb</i><br><ol><li>to climb</li></ol>
glee	<i>adj</i><br><ol><li>small</li></ol>
gleich	<i>adj</i><br><ol><li>equal</li><li>like</li><li>same</li></ol>
gleiche|gleich|gleicht|gleichscht|hot gegliche|waerd gleiche	<i>verb</i><br><ol><li>to like</li><li>to love</li></ol>
glewe	<i>verb</i><br><ol><li>to stick to, to adhere</li></ol>
graad	<i>adj</i><br><ol><li>straight</li><li>right</li></ol><br><i>adv</i><br><ol><li>right</li><li>exactly</li><li>at once, now</li></ol>
graase	<i>verb</i><br><ol><li>to graze</li><li>to weed (a lawn)</li></ol>
grank	<i>adj</i><br><ol><li>ill, sick</li></ol>
greiziche	<i>verb</i><br><ol><li>to crucify</li></ol>
grie	<i>adj</i><br><ol><li>green</li></ol>
griege|griegt|grickscht|waerd griege|daet griege|grickt|grick|hot grickt	<i>verb</i><br><ol><li>to get, obtain</li></ol>
gro	<i>adj</i><br><ol><li>gray, grey</li></ol>
gross|greesser|greescht	<i>adj</i><br><ol><li>big, large</li></ol>
gscheit	<i>adj</i><br><ol><li>clever, intelligent</li></ol>
gucke	<i>verb</i><br><ol><li>to look</li><li>to appear</li><li>to stare</li></ol>
guder Daag	<i>phrase</i><br><ol><li>good day, hello (greeting)</li></ol>
gut|bescht|besser	<i>adj</i><br><ol><li>good</li><li>kind</li></ol>
hallich	<i>adj</i><br><ol><li>happy, lucky, prosperous</li></ol>
hariche|harichscht|haricht|harich|hot gharicht|daet hariche|waerd hariche	<i>verb</i><br><ol><li>to listen</li><li>to hearken</li><li>to obey</li></ol>
hasse	<i>verb</i><br><ol><li>to hate</li></ol>
hawwe|hett|hedde|hoscht|hab|hen|hot ghatt|waerd hawwe|hot	<i>verb</i><br><ol><li>to have</li></ol>
hawwich	<i>abbrev</i><br><ol><li>hawwe in the first person singular form "hab" + ich</li></ol>
heem	<i>adv</i><br><ol><li>home</li></ol>
heere|heerscht|daet heere|hot gheert|heert|heer|waerd heere	<i>verb</i><br><ol><li>to hear</li><li>to obey</li><li>to listen</li></ol>
heess	<i>adj</i><br><ol><li>hot</li></ol>
heidesdaags	<i>adv</i><br><ol><li>nowadays</li></ol>
heiere|heierscht|heier|hot geheiert|heiert|waerd heiere|daet heiere	<i>verb</i><br><ol><li>to marry</li></ol>
heilich	<i>adj</i><br><ol><li>holy, sacred</li></ol>
heit	<i>adv</i><br><ol><li>today</li></ol>
hesslich	<i>adj</i><br><ol><li>ugly</li><li>terrible</li></ol><br><i>adv</i><br><ol><li>awfully</li></ol>
hewe	<i>verb</i><br><ol><li>to hold</li><li>to lift</li></ol>
hexe	<i>verb</i><br><ol><li>to perform magic</li></ol>
hibsch	<i>adj</i><br><ol><li>pretty, handsome</li></ol>
hinner	<i>adj</i><br><ol><li>back, rear</li></ol><br><i>prep</i><br><ol><li>behind</li><li>after</li></ol>
hinnere	<i>verb</i><br><ol><li>to hinder</li><li>to prevent</li></ol>
hinnich	<i>prep</i><br><ol><li>behind</li></ol>
hiwwe	<i>adv</i><br><ol><li>over here</li><li>on this side</li></ol>
hiwwe wie driwwe	<i>phrase</i><br><ol><li>on both sides</li><li>on either side</li></ol>
hocke	<i>verb</i><br><ol><li>to sit</li><li>to squat</li><li>to seat</li><li>(reflexive) to sit down</li></ol>
hole	<i>verb</i><br><ol><li>to fetch</li></ol>
hooch	<i>adj</i><br><ol><li>high</li><li>tall</li></ol>
hunnert	<i>num</i><br><ol><li>hundred</li></ol>
hure	<i>verb</i><br><ol><li>to fornicate</li></ol>
huuschde|waerd huuschde|hot ghuscht|huuschtscht|huuscht|daet huuschde	<i>verb</i><br><ol><li>to cough</li></ol>
ich|Ne|en|es|du|uns|ihne|Sie|mir|ihm|ihre|ihn|er|Ihne|dir|sie|der|mer|ne|mich|em|dich|dihr|re|ich|de|eich|se	<i>pron</i><br><ol><li>I</li></ol>
ihm|Ne|en|es|du|uns|ihne|Sie|mir|ihre|ihm|ihn|er|Ihne|dir|sie|der|mer|ne|mich|em|dich|dihr|re|ich|de|eich|se	<i>pron</i><br><ol><li>to him</li><li>to it</li></ol>
ihn|Ne|en|es|du|uns|ihne|Sie|mir|ihm|ihre|ihn|er|Ihne|dir|sie|der|mer|ne|mich|em|dich|dihr|re|ich|de|eich|se	<i>pron</i><br><ol><li>him</li></ol>
ihne|Ne|en|es|du|uns|Sie|ihne|mir|ihm|ihre|ihn|er|Ihne|dir|sie|der|mer|ne|mich|em|dich|dihr|re|ich|de|eich|se	<i>pron</i><br><ol><li>to them</li></ol>
ihre|Ne|en|es|du|uns|ihne|Sie|mir|ihm|ihre|ihn|er|Ihne|dir|sie|der|mer|ne|mich|em|dich|dihr|re|ich|de|eich|se	<i>pron</i><br><ol><li>to her</li></ol><br><i>adj</i><br><ol><li>(possessive) her</li><li>(possessive) their</li></ol>
in	<i>prep</i><br><ol><li>in</li></ol>
inner	<i>adj</i><br><ol><li>inner</li></ol>
iwwel	<i>adj</i><br><ol><li>evil</li><li>bad</li><li>calamitous</li><li>nauseous</li></ol>
iwwer	<i>prep</i><br><ol><li>over</li><li>past</li><li>above</li><li>during</li><li>while</li></ol>
iwwersetze	<i>verb</i><br><ol><li>to translate</li><li>to ferry</li><li>to reset, to set over</li></ol>
iwwersichdich	<i>adj</i><br><ol><li>cross-eyed</li></ol>
ja	<i>intj</i><br><ol><li>yes, yeah</li></ol>
kaafe	<i>verb</i><br><ol><li>to buy, to purchase</li></ol>
kalt|kelder|keltscht	<i>adj</i><br><ol><li>cold</li></ol>
katz	<i>adj</i><br><ol><li>short</li></ol>
kaue	<i>verb</i><br><ol><li>to chew</li></ol>
kee|kem|kee|ken|kenre	<i>article</i><br><ol><li>no</li></ol>
kehre	<i>verb</i><br><ol><li>to sweep</li></ol>
kem|kem|kee|ken|kenre	<i>article</i><br><ol><li>no</li></ol>
ken|kem|kee|ken|kenre	<i>article</i><br><ol><li>no</li></ol>
kenne|hot gekennt|kennt|kenn|kannscht|daet kenne|waerd kenne|kenne|kann|kennscht	<i>verb</i><br><ol><li>to can; to be able to</li><li>(transitive) to know</li><li>(transitive) to understand</li><li>to know</li><li>to be acquainted with</li></ol>
kenre|kem|kee|ken|kenre	<i>article</i><br><ol><li>no</li></ol>
kiehl	<i>adj</i><br><ol><li>cool</li><li>chilly</li></ol>
kisse	<i>verb</i><br><ol><li>kiss</li></ol>
koche	<i>verb</i><br><ol><li>to cook</li><li>to boil</li><li>to simmer</li><li>to seethe</li></ol>
koschde	<i>verb</i><br><ol><li>to cost</li></ol>
koschdefrei	<i>adj</i><br><ol><li>free of charge, gratis</li></ol>
kumme|kummt|kummscht|kumm|iss kumme|waerd kumme	<i>noun</i><br><ol><li>to come</li></ol>
laade	<i>verb</i><br><ol><li>to load</li><li>to charge up</li></ol>
laafe	<i>verb</i><br><ol><li>to run</li></ol>
laahm	<i>adj</i><br><ol><li>lame</li></ol>
laawe	<i>verb</i><br><ol><li>to shed leaves</li><li>to refresh</li></ol>
lang	<i>adj</i><br><ol><li>long</li><li>diluted</li></ol>
lange	<i>verb</i><br><ol><li>to hand</li></ol>
laschtbaar	<i>adj</i><br><ol><li>onerous</li></ol>
lauere	<i>verb</i><br><ol><li>to listen</li><li>to watch</li><li>to lurk</li><li>to lie in wait</li></ol>
lauschdere	<i>verb</i><br><ol><li>to listen</li><li>to eavesdrop</li></ol>
lausche	<i>verb</i><br><ol><li>to listen</li><li>to hearken</li></ol>
lechle	<i>verb</i><br><ol><li>to smile</li></ol>
leer	<i>adj</i><br><ol><li>empty</li></ol>
lege	<i>verb</i><br><ol><li>to lay</li><li>to put, to place</li></ol>
lehne	<i>verb</i><br><ol><li>to lend, to loan</li><li>to borrow</li></ol>
leicht	<i>adj</i><br><ol><li>light, easy, simple</li></ol>
leie	<i>verb</i><br><ol><li>to lie, to rest</li><li>to be sick in bed</li><li>to loaf</li></ol>
lendlich	<i>adj</i><br><ol><li>rural</li></ol>
lese|waerd lese|daet lese|lest|lescht|les|hot gelese	<i>verb</i><br><ol><li>to read</li><li>to pick up</li></ol>
lewe	<i>verb</i><br><ol><li>to live</li></ol>
lewich	<i>adj</i><br><ol><li>lively, active</li></ol>
liege	<i>verb</i><br><ol><li>to tell a lie</li></ol>
liewe	<i>verb</i><br><ol><li>to love</li><li>to like</li><li>to caress</li></ol>
link	<i>adj</i><br><ol><li>left, left-hand</li></ol>
links	<i>adv</i><br><ol><li>left, to the left</li></ol>
lodder	<i>adj</i><br><ol><li>loose</li><li>shaky, rickety</li></ol>
losse	<i>verb</i><br><ol><li>to let, to allow</li><li>to let have</li><li>to leave undone</li><li>to leave in possession</li></ol>
lutsche	<i>verb</i><br><ol><li>to suck</li></ol>
mach's	<i>abbrev</i><br><ol><li>mach + es</li></ol>
mach's gut	<i>phrase</i><br><ol><li>good bye</li></ol>
mache|mach	<i>verb</i><br><ol><li>to make</li><li>to do</li></ol>
madde	<i>verb</i><br><ol><li>to murder, to slay</li><li>to assassinate</li></ol>
maehe	<i>verb</i><br><ol><li>to mow</li></ol>
matt	<i>adj</i><br><ol><li>weak, faint</li></ol>
me|re|me|en	<i>article</i><br><ol><li>a, an</li></ol>
meege	<i>verb</i><br><ol><li>(auxiliary) to like to</li></ol>
meeglich	<i>adj</i><br><ol><li>possible</li></ol>
meene	<i>verb</i><br><ol><li>(transitive) to think, to opine</li><li>(transitive) to mean, to be sincere/serious about</li><li>(transitive) to mean, to signify</li></ol>
meh	<i>adj</i><br><ol><li>more</li></ol><br><i>adv</i><br><ol><li>any longer</li><li>more</li><li>anymore</li></ol>
mehne	<i>verb</i><br><ol><li>to mean, to think</li><li>to be of the opinion</li></ol>
mei|meine|meinre|meim	<i>adj</i><br><ol><li>(possessive) my</li></ol>
melke	<i>verb</i><br><ol><li>to milk</li></ol>
mennlich	<i>adj</i><br><ol><li>manly</li><li>male</li></ol>
mer|Ne|en|es|du|uns|ihne|Sie|mir|ihm|ihre|ihn|er|Ihne|dir|sie|der|ne|mer|mich|em|dich|dihr|re|ich|de|eich|se	<i>pron</i><br><ol><li>we, first person plural nominative pronoun.</li><li>me, to me, first person singular dative pronoun.</li><li>one, indefinite third person singular nominative pronoun.</li></ol>
mich|Ne|en|es|du|uns|ihne|Sie|mir|ihm|ihre|ihn|er|Ihne|dir|sie|der|mer|ne|mich|em|dich|dihr|re|ich|de|eich|se	<i>pron</i><br><ol><li>me</li></ol>
mied	<i>adj</i><br><ol><li>tired</li></ol>
mir|Ne|en|es|du|uns|ihne|Sie|mir|ihm|ihre|ihn|er|Ihne|dir|sie|der|mer|ne|mich|em|dich|dihr|re|ich|de|eich|se	<i>pron</i><br><ol><li>to me</li><li>we</li></ol>
misse	<i>verb</i><br><ol><li>(auxiliary) must, to have to</li></ol>
mit	<i>adv</i><br><ol><li>along</li></ol><br><i>prep</i><br><ol><li>with</li></ol>
mitaus	<i>prep</i><br><ol><li>without: Synonym of unne</li></ol>
mudderlich	<i>adj</i><br><ol><li>maternal, motherly</li></ol>
nackich	<i>adj</i><br><ol><li>naked</li></ol>
nadierlich	<i>adj</i><br><ol><li>natural</li><li>physical</li><li>naive</li></ol><br><i>adv</i><br><ol><li>naturally</li><li>of course</li></ol>
naegscht	<i>adj</i><br><ol><li>near, close</li><li>next</li><li>nearest</li></ol>
naehe	<i>verb</i><br><ol><li>to sew</li></ol>
nau	<i>adv</i><br><ol><li>now</li></ol>
nee	<i>intj</i><br><ol><li>no</li></ol>
nei	<i>adj</i><br><ol><li>new</li></ol>
neide	<i>verb</i><br><ol><li>to envy</li></ol>
neidich	<i>adj</i><br><ol><li>envious</li></ol>
neidisch	<i>adj</i><br><ol><li>envious</li></ol>
nein	<i>num</i><br><ol><li>nine</li></ol>
nein un achtzich	<i>num</i><br><ol><li>eighty-nine</li></ol>
nein un dreissich	<i>num</i><br><ol><li>thirty-nine</li></ol>
nein un fuffzich	<i>num</i><br><ol><li>fifty-nine</li></ol>
nein un neinzich	<i>num</i><br><ol><li>ninety-nine</li></ol>
nein un sechzich	<i>num</i><br><ol><li>sixty-nine</li></ol>
nein un siwwezich	<i>num</i><br><ol><li>seventy-nine</li></ol>
nein un varzich	<i>num</i><br><ol><li>forty-nine</li></ol>
nein un zwansich	<i>num</i><br><ol><li>twenty-nine</li></ol>
neint	<i>adj</i><br><ol><li>ninth</li></ol><br><i>num</i><br><ol><li>ninth</li></ol>
neinzeh	<i>num</i><br><ol><li>nineteen</li></ol>
neinzehte	<i>adj</i><br><ol><li>nineteenth</li></ol><br><i>num</i><br><ol><li>nineteenth</li></ol>
neinzich	<i>num</i><br><ol><li>ninety</li></ol>
nemme	<i>verb</i><br><ol><li>to take, to appropriate</li><li>to receive</li></ol>
nenne|hot genennt|waerd nenne|nenn|daet nenne|nennscht|nennt	<i>verb</i><br><ol><li>to name; to give someone a name; to call (someone something)</li></ol>
net	<i>adv</i><br><ol><li>not</li></ol>
newe	<i>prep</i><br><ol><li>beside, by the side of</li><li>alongside, along the side of</li></ol>
nexe	<i>verb</i><br><ol><li>to tease</li><li>to chaff</li></ol>
nidder	<i>adj</i><br><ol><li>low</li><li>down</li><li>base</li></ol>
niese|nies|daet niese|hot geniest|waerd niese|niescht|niest	<i>verb</i><br><ol><li>to sneeze</li></ol>
nix	<i>pron</i><br><ol><li>nothing</li></ol>
noch	<i>adv</i><br><ol><li>yet</li><li>still</li></ol><br><i>prep</i><br><ol><li>to, towards</li><li>after</li></ol>
nooch	<i>prep</i><br><ol><li>after</li></ol>
null	<i>num</i><br><ol><li>zero</li></ol>
nunner	<i>adv</i><br><ol><li>down</li></ol>
odder	<i>conj</i><br><ol><li>or</li></ol>
oft	<i>adv</i><br><ol><li>often, frequently</li></ol>
oftmols	<i>adv</i><br><ol><li>often, frequently</li><li>oftentimes</li></ol>
ordlich	<i>adj</i><br><ol><li>local</li></ol>
owwe	<i>adv</i><br><ol><li>above</li></ol>
petze	<i>verb</i><br><ol><li>to pinch</li></ol>
pingscht	<i>adj</i><br><ol><li>pink</li></ol>
re|re|me|en	<i>article</i><br><ol><li>a, an</li></ol>
reche	<i>verb</i><br><ol><li>to rake</li></ol>
recht	<i>adj</i><br><ol><li>right-hand</li></ol>
rechts	<i>adv</i><br><ol><li>right, to the right</li></ol>
redde	<i>verb</i><br><ol><li>to rescue, to save</li></ol>
redder	<i>adv</i><br><ol><li>rather</li></ol>
reeschde	<i>verb</i><br><ol><li>to roast</li></ol>
reggere	<i>verb</i><br><ol><li>to rain</li></ol>
reggerich	<i>adj</i><br><ol><li>rainy</li></ol>
reide	<i>verb</i><br><ol><li>to ride (on horseback)</li></ol>
richdich	<i>adj</i><br><ol><li>correct</li></ol>
rode	<i>verb</i><br><ol><li>to advise, to counsel</li><li>to guess</li></ol>
rooschde	<i>verb</i><br><ol><li>to roast</li></ol>
rot	<i>adj</i><br><ol><li>red</li></ol>
rum	<i>adv</i><br><ol><li>around</li></ol>
rumschpringe	<i>verb</i><br><ol><li>to run around</li></ol>
saage	<i>verb</i><br><ol><li>to say</li></ol>
saege	<i>verb</i><br><ol><li>to saw (cutting tool)</li></ol>
saehe	<i>verb</i><br><ol><li>to sow, to seed</li></ol>
salse	<i>verb</i><br><ol><li>to salt</li></ol>
salsich	<i>adj</i><br><ol><li>salty</li><li>pricy</li></ol>
schadde	<i>verb</i><br><ol><li>to harm</li></ol>
schaerfe	<i>verb</i><br><ol><li>to sharpen</li></ol>
schaffe|hot gschafft|schaff|waerd schaffe|schafft|schaffscht	<i>verb</i><br><ol><li>to work, to labor</li></ol>
schaufle	<i>verb</i><br><ol><li>to shovel</li><li>to cultivate</li><li>to eat rapidly</li></ol>
schee	<i>adj</i><br><ol><li>pretty, beautiful</li></ol>
scheede	<i>verb</i><br><ol><li>to separate</li><li>to divorce</li></ol>
scheine	<i>verb</i><br><ol><li>to shine</li><li>to seem</li><li>to appear</li><li>to glitter</li></ol>
scheisse	<i>verb</i><br><ol><li>to shit</li></ol>
scheppe	<i>verb</i><br><ol><li>to dip</li><li>to shovel</li></ol>
schidde	<i>verb</i><br><ol><li>to pour</li></ol>
schiesse	<i>verb</i><br><ol><li>to shoot</li><li>to blast</li><li>to move fast</li></ol>
schiewe	<i>verb</i><br><ol><li>to push, to shove</li></ol>
schlampich	<i>adj</i><br><ol><li>slovenly</li></ol>
schlecht	<i>adj</i><br><ol><li>bad</li><li>wicked</li></ol><br><i>adv</i><br><ol><li>poorly</li></ol>
schliesse	<i>verb</i><br><ol><li>to lock</li><li>to conclude</li></ol>
schlimm	<i>adj</i><br><ol><li>bad</li><li>sad</li><li>serious, grave</li><li>very ill</li></ol>
schlofe	<i>verb</i><br><ol><li>to sleep</li></ol>
schlucke	<i>verb</i><br><ol><li>to swallow</li></ol>
schmacke	<i>verb</i><br><ol><li>to taste</li><li>to smell</li></ol>
schmatze	<i>verb</i><br><ol><li>to pain, to cause pain</li><li>to smack, to make smacking sounds with the mouth</li></ol>
schmecke	<i>verb</i><br><ol><li>to taste</li><li>to smell</li></ol>
schmeisse	<i>verb</i><br><ol><li>to throw</li></ol>
schmoke	<i>verb</i><br><ol><li>to smoke</li></ol>
schmore	<i>verb</i><br><ol><li>to stew</li><li>to fry</li></ol>
schmunsle	<i>verb</i><br><ol><li>to smile</li></ol>
schnaufe	<i>verb</i><br><ol><li>to breathe</li></ol>
schneide	<i>verb</i><br><ol><li>to cut</li><li>to reap grain with a sickle</li><li>to castrate, to spay</li></ol>
schockle	<i>verb</i><br><ol><li>to rock (as in a cradle)</li></ol>
schpaare	<i>verb</i><br><ol><li>to save (up)</li><li>to spare</li><li>to economize</li></ol>
schpaue	<i>verb</i><br><ol><li>to spit</li></ol>
schpautze	<i>verb</i><br><ol><li>to spit</li></ol>
schpiele	<i>verb</i><br><ol><li>to play</li><li>to rinse</li></ol>
schpiere	<i>verb</i><br><ol><li>to track (game or prey)</li><li>to feel, to sense</li></ol>
schpot	<i>adj</i><br><ol><li>late</li></ol>
schpringe	<i>verb</i><br><ol><li>to run</li><li>to jump</li><li>to spring (of lumber)</li></ol>
schpucke	<i>verb</i><br><ol><li>to spit</li></ol>
schpure	<i>verb</i><br><ol><li>to track, to trace</li></ol>
schreiwe	
schtarewe|schtaerebt|daet schtarewe|waerd schtarewe|schtarebt|schtaerebscht|waerd schtaerewe|daet schtaerewe|schtaerewe|schtaereb|schtareb|schtarebscht|iss gschtaerewe|iss gschtarewe	<i>verb</i><br><ol><li>to die</li></ol>
schteh	<i>verb</i><br><ol><li>to stand</li></ol>
schteige	<i>verb</i><br><ol><li>to rise, ascend</li><li>to increase</li></ol>
schtelle	<i>verb</i><br><ol><li>to put, to place</li><li>to set up</li></ol>
schtill	<i>verb</i><br><ol><li>silent, quiet</li></ol>
schtille	<i>verb</i><br><ol><li>to silence</li></ol>
schtoosse	<i>verb</i><br><ol><li>to push</li><li>to jostle</li><li>to poke</li><li>to kick</li><li>to churn butter</li></ol>
schtrutze	<i>verb</i><br><ol><li>to strut</li><li>to parade</li></ol>
schtupid	<i>adj</i><br><ol><li>stupid</li></ol>
schunn	<i>adv</i><br><ol><li>already</li></ol>
schwaer	<i>adj</i><br><ol><li>heavy</li><li>difficult</li></ol>
schwarz	<i>adj</i><br><ol><li>black</li></ol>
schwatz	<i>adj</i><br><ol><li>black</li></ol>
schweige	<i>verb</i><br><ol><li>to be silent</li></ol>
schwetze|hot gschwetzt|schwetzt|daet schwetze|schwetscht|schwetz|waerd schwetze|schwetzscht	<i>verb</i><br><ol><li>to speak</li></ol>
schwimme	<i>verb</i><br><ol><li>to swim</li></ol>
se	<i>pron</i><br><ol><li>she</li><li>her</li></ol>
sechs	<i>num</i><br><ol><li>six</li></ol>
sechtzay	<i>num</i><br><ol><li>sixteen</li></ol>
sechzeh	<i>num</i><br><ol><li>sixteen</li></ol>
sechzeht	<i>adj</i><br><ol><li>sixteenth</li></ol><br><i>num</i><br><ol><li>sixteenth</li></ol>
sechzich	<i>num</i><br><ol><li>sixty</li></ol>
seefe	<i>verb</i><br><ol><li>to soap</li></ol>
seefich	<i>adj</i><br><ol><li>soapy</li></ol>
seelich	<i>adj</i><br><ol><li>happy</li><li>saved</li><li>blessed</li></ol>
segne	<i>verb</i><br><ol><li>to bless</li></ol>
sehne|seh|sehscht|waerd sehne|seht|hot gsehne	<i>verb</i><br><ol><li>to see</li></ol>
sei|seine|iss|waerd sei|sin|seid|waere|bischt|waerscht|waer|iss gewest|seim|seinre|waeret|bin	<i>adj</i><br><ol><li>(possessive) his</li><li>(possessive) its</li></ol><br><i>verb</i><br><ol><li>to be</li></ol>
sell|sellere|sellre|sellem|sem|seller|selli|selle	<i>pron</i><br><ol><li>that one</li></ol><br><i>det</i><br><ol><li>that</li></ol>
setze	<i>verb</i><br><ol><li>to set</li><li>(reflexive) to sit down</li></ol>
sex	<i>num</i><br><ol><li>six</li></ol>
sex un achtzich	<i>num</i><br><ol><li>eighty-six</li></ol>
sex un dreissich	<i>num</i><br><ol><li>thirty-six</li></ol>
sex un fuffzich	<i>num</i><br><ol><li>fifty-six</li></ol>
sex un neinzich	<i>num</i><br><ol><li>ninety-six</li></ol>
sex un sechzich	<i>num</i><br><ol><li>sixty-six</li></ol>
sex un siwwezich	<i>num</i><br><ol><li>seventy-six</li></ol>
sex un varzich	<i>num</i><br><ol><li>forty-six</li></ol>
sex un zwansich	<i>num</i><br><ol><li>twenty-six</li></ol>
sext	<i>adj</i><br><ol><li>sixth</li></ol><br><i>num</i><br><ol><li>sixth</li></ol>
sexzeh	<i>num</i><br><ol><li>sixteen</li></ol>
sidder	<i>prep</i><br><ol><li>since</li></ol>
sie|Ne|en|es|du|uns|ihne|Sie|mir|ihm|ihre|ihn|er|Ihne|dir|der|sie|mer|ne|mich|em|dich|dihr|re|ich|de|eich|se	<i>pron</i><br><ol><li>she</li><li>they</li></ol>
siess	<i>adj</i><br><ol><li>sweet</li></ol>
singe	<i>verb</i><br><ol><li>to sing</li></ol>
siwwe	<i>num</i><br><ol><li>seven</li></ol>
siwwe un achtzich	<i>num</i><br><ol><li>eighty-seven</li></ol>
siwwe un dreissich	<i>num</i><br><ol><li>thirty-seven</li></ol>
siwwe un fuffzich	<i>num</i><br><ol><li>fifty-seven</li></ol>
siwwe un neinzich	<i>num</i><br><ol><li>ninety-seven</li></ol>
siwwe un sechzich	<i>num</i><br><ol><li>sixty-seven</li></ol>
siwwe un siwwezich	<i>num</i><br><ol><li>seventy-seven</li></ol>
siwwe un varzich	<i>num</i><br><ol><li>forty-seven</li></ol>
siwwe un zwansich	<i>num</i><br><ol><li>twenty-seven</li></ol>
siwwet	<i>adj</i><br><ol><li>seventh</li></ol><br><i>num</i><br><ol><li>seventh</li></ol>
siwwezeh	<i>num</i><br><ol><li>seventeen</li></ol>
siwwezeht	<i>adj</i><br><ol><li>seventeenth</li></ol><br><i>num</i><br><ol><li>seventeenth</li></ol>
siwwezich	<i>num</i><br><ol><li>seventy</li></ol>
solle	<i>verb</i><br><ol><li>should, to be supposed to do something</li><li>shall</li></ol>
suche	<i>verb</i><br><ol><li>to seek, to search for</li></ol>
sunnich	<i>adj</i><br><ol><li>sunny</li></ol>
trei	<i>adj</i><br><ol><li>faithful</li><li>true</li></ol>
tschaae	<i>verb</i><br><ol><li>to chew</li></ol>
uff	<i>prep</i><br><ol><li>on</li></ol>
uff Zeit	<i>phrase</i><br><ol><li>on time (timely, punctually)</li></ol>
uffe	<i>adj</i><br><ol><li>open</li></ol>
uffne	<i>adj</i><br><ol><li>open</li></ol>
um	<i>prep</i><br><ol><li>around</li></ol>
umeeglich	<i>adj</i><br><ol><li>impossible</li></ol>
un	<i>conj</i><br><ol><li>and</li></ol>
unne	<i>adv</i><br><ol><li>below</li></ol><br><i>prep</i><br><ol><li>without</li></ol>
unnerschiddlich	<i>noun</i><br><ol><li>different</li><li>various</li></ol>
unnerschittlich	<i>adj</i><br><ol><li>various</li><li>different</li></ol>
uns|Ne|en|es|du|uns|ihne|Sie|mir|ihm|ihre|ihn|er|Ihne|dir|sie|der|mer|ne|mich|em|dich|dihr|re|ich|de|eich|se	<i>pron</i><br><ol><li>us</li><li>to us</li></ol>
unser	<i>adj</i><br><ol><li>(possessive) our</li></ol>
vaerzeh	<i>num</i><br><ol><li>fourteen</li></ol>
varzeh	<i>num</i><br><ol><li>fourteen</li></ol>
varzeht	<i>adj</i><br><ol><li>fourteenth</li></ol><br><i>num</i><br><ol><li>fourteenth</li></ol>
varzich	<i>num</i><br><ol><li>forty</li></ol>
vatzeh	<i>num</i><br><ol><li>fourteen</li></ol>
vatzich	<i>num</i><br><ol><li>forty</li></ol>
vedder	<i>adj</i><br><ol><li>fore, front</li></ol>
vellich	<i>adv</i><br><ol><li>fully</li></ol>
ver	<i>prep</i><br><ol><li>before</li></ol>
verkaafe	<i>verb</i><br><ol><li>to sell</li></ol>
verlehne	<i>verb</i><br><ol><li>to rent, to let, to lease</li></ol>
verliere	<i>verb</i><br><ol><li>to lose</li></ol>
verlosse	<i>verb</i><br><ol><li>abandon</li></ol>
verrickt	<i>adj</i><br><ol><li>crazy</li><li>zany</li></ol>
verschiddlich	<i>adj</i><br><ol><li>different</li></ol>
verschpreche	<i>verb</i><br><ol><li>to promise</li></ol>
verschteh	<i>verb</i><br><ol><li>to understand, comprehend</li></ol>
viel|meh|menscht	<i>det</i><br><ol><li>much, a lot of</li></ol>
vier	<i>num</i><br><ol><li>four</li></ol>
vier un achtzich	<i>num</i><br><ol><li>eighty-four</li></ol>
vier un dreissich	<i>num</i><br><ol><li>thirty-four</li></ol>
vier un fuffzich	<i>num</i><br><ol><li>fifty-four</li></ol>
vier un neinzich	<i>num</i><br><ol><li>ninety-four</li></ol>
vier un sechzich	<i>num</i><br><ol><li>sixty-four</li></ol>
vier un siwwezich	<i>num</i><br><ol><li>seventy-four</li></ol>
vier un varzich	<i>num</i><br><ol><li>forty-four</li></ol>
vier un zwansich	<i>num</i><br><ol><li>twenty-four</li></ol>
viert	<i>adj</i><br><ol><li>fourth</li></ol><br><i>num</i><br><ol><li>fourth</li></ol>
voll	<i>adj</i><br><ol><li>full</li></ol>
waade	<i>verb</i><br><ol><li>to wade</li></ol>
waarde	<i>verb</i><br><ol><li>to wait</li></ol>
waarum	<i>adv</i><br><ol><li>(interrogatory) why</li></ol>
waere	<i>verb</i><br><ol><li>to wear (clothing)</li></ol>
waerre|iss waerre|waerd waerre|waerret|waer|waerrscht|waerd	<i>verb</i><br><ol><li>will, shall (future tense)</li><li>to become</li></ol>
wann	<i>adv</i><br><ol><li>(interrogatory) when</li><li>(relative) when</li></ol><br><i>conj</i><br><ol><li>when</li><li>if</li></ol>
ware|iss ware|wa|dihr watt|watt|daet ware|wascht|war|waerd ware	<i>verb</i><br><ol><li>to become</li></ol>
waricklich	<i>adv</i><br><ol><li>really, truly</li></ol>
was	<i>pron</i><br><ol><li>(interrogative) what</li></ol>
weck	<i>adv</i><br><ol><li>away</li></ol>
weeich	<i>prep</i><br><ol><li>because of</li><li>on account of, due to</li><li>about</li></ol>
wege	<i>prep</i><br><ol><li>because of</li><li>on account of, due to</li><li>about</li></ol>
weh	<i>adj</i><br><ol><li>sore, painful</li></ol>
weiblich	<i>adj</i><br><ol><li>womanly</li><li>effeminate</li></ol>
weiss	<i>adj</i><br><ol><li>white</li></ol>
weit	<i>adj</i><br><ol><li>far</li><li>wide</li><li>long</li></ol>
well	<i>adv</i><br><ol><li>which</li></ol><br><i>pron</i><br><ol><li>which</li></ol>
weltlich	<i>adj</i><br><ol><li>secular, worldly</li></ol>
wennich	<i>adj</i><br><ol><li>little</li><li>few</li></ol>
wesche	<i>verb</i><br><ol><li>to wash</li></ol>
weschtlich	<i>adj</i><br><ol><li>west, western, westerly</li></ol>
wessre	<i>verb</i><br><ol><li>to water</li></ol>
wewe	<i>verb</i><br><ol><li>to weave</li></ol>
wie	<i>adv</i><br><ol><li>(interrogatory) how</li></ol>
wilkum	<i>noun</i><br><ol><li>Alternative letter-case form of Wilkum</li></ol>
willkumm	<i>adj</i><br><ol><li>welcome</li></ol><br><i>intj</i><br><ol><li>welcome</li></ol>
winsche	<i>verb</i><br><ol><li>to wish</li></ol>
wolle|hot gewollt|witt|will|wollt|waerd wolle	<i>verb</i><br><ol><li>to want to do something</li><li>to intend to</li><li>to want</li></ol>
wu	<i>adv</i><br><ol><li>(interrogative, relative) where</li></ol>
wuhne	<i>verb</i><br><ol><li>to reside, to live, to dwell, to inhabit</li></ol>
ya	<i>intj</i><br><ol><li>yes, yeah</li></ol>
yaemere	<i>verb</i><br><ol><li>to groan</li></ol>
yeder	<i>adj</i><br><ol><li>every</li><li>each</li></ol>
yohle	<i>verb</i><br><ol><li>to yell, to shout</li></ol>
yubele	<i>verb</i><br><ol><li>to shout</li></ol>
yung	<i>adj</i><br><ol><li>young</li></ol>
yuscht|juscht	<i>adv</i><br><ol><li>just</li><li>just now</li><li>only</li></ol>
yuxich	<i>adj</i><br><ol><li>boisterous</li><li>sportive</li></ol>
zaahm	<i>adj</i><br><ol><li>tame</li></ol>
zaehle	<i>verb</i><br><ol><li>to count</li><li>to intend</li><li>to calculate</li></ol>
zamme	<i>adv</i><br><ol><li>together</li></ol>
zehe	<i>num</i><br><ol><li>ten</li></ol>
zehet	<i>adj</i><br><ol><li>tenth</li></ol><br><i>num</i><br><ol><li>tenth</li></ol>
zerick	<i>adv</i><br><ol><li>back</li></ol>
zeyya	<i>num</i><br><ol><li>ten</li></ol>
zidder	<i>prep</i><br><ol><li>since</li></ol>
ziege|waerd ziege|ziegscht|ziegt|dihr ziegt|daet ziege|hot gezogge|hot gezoge|zieg	<i>verb</i><br><ol><li>to pull</li></ol>
zimmlich	<i>adv</i><br><ol><li>pretty</li></ol>
zu	<i>prep</i><br><ol><li>at, to</li></ol>
zum	<i>abbrev</i><br><ol><li>to or for the (contraction of zu + dem)</li><li>to or for a (contraction of zu + einem)</li></ol>
zumache	<i>verb</i><br><ol><li>to shut, to close</li></ol>
zwansich	<i>num</i><br><ol><li>twenty</li></ol>
zwansichscht	<i>adj</i><br><ol><li>twentieth</li></ol><br><i>num</i><br><ol><li>twentieth</li></ol>
zwarwle	<i>verb</i><br><ol><li>to whirl</li><li>to eddy</li></ol>
zwee	<i>num</i><br><ol><li>two</li></ol>
zwee un achtzich	<i>num</i><br><ol><li>eighty-two</li></ol>
zwee un dreissich	<i>num</i><br><ol><li>thirty-two</li></ol>
zwee un fuffzich	<i>num</i><br><ol><li>fifty-two</li></ol>
zwee un neinzich	<i>num</i><br><ol><li>ninety-two</li></ol>
zwee un sechzich	<i>num</i><br><ol><li>sixty-two</li></ol>
zwee un siwwezich	<i>num</i><br><ol><li>seventy-two</li></ol>
zwee un varzich	<i>num</i><br><ol><li>forty-two</li></ol>
zwee un zwansich	<i>num</i><br><ol><li>twenty-two</li></ol>
zwelf	<i>num</i><br><ol><li>twelve</li></ol>
zwelfe	<i>num</i><br><ol><li>twelve</li></ol>
zwelft	<i>adj</i><br><ol><li>twelfth</li></ol><br><i>num</i><br><ol><li>twelfth</li></ol>
zwett	<i>adj</i><br><ol><li>second</li></ol><br><i>num</i><br><ol><li>second</li></ol>
