Brɨθon	<i>noun</i><br><ol><li>Briton, speaker of a British Celtic language</li></ol>
Düβnėnt	<i>name</i><br><ol><li>Devon, the main territory of the historic Dumnonian kingdom and a later county of England.</li></ol>
Eβrọg	<i>name</i><br><ol><li>York</li></ol>
Gwodọðin	<i>name</i><br><ol><li>Celtic tribe of ancient southeast Scotland and northeast England.</li></ol>
Haβren	<i>name</i><br><ol><li>Severn, a river of England and Wales that flows into the Bristol Channel.</li><li>A legendary Celtic princess.</li></ol>
Iwerðon	<i>name</i><br><ol><li>Ireland</li></ol>
Körnɨw	<i>name</i><br><ol><li>Cornwall, a territory of the Dumnonian kingdom and subsequently a county of England.</li><li>Cornouaille, a historical region of Brittany.</li></ol>
Llọw	<i>name</i><br><ol><li>Lleu, a pre-Christian deity continued as a mythological hero. See Lleu Llaw Gyffes.</li></ol>
Nadọlɨg	<i>name</i><br><ol><li>Christmas</li></ol>
Nọdọlɨg	<i>name</i><br><ol><li>Christmas</li></ol>
Pask|Paskow	<i>name</i><br><ol><li>(Christianity) Easter</li></ol>
Sėɨs|Saɨsnes|Saɨson	<i>noun</i><br><ol><li>Anglo-Saxon, Englishman</li></ol>
Uɨsk	<i>name</i><br><ol><li>A river name, perhaps originally meaning "abundant in fish".</li></ol>
aber	<i>noun</i><br><ol><li>mouth, confluence (of a river)</li></ol>
aberθ	<i>noun</i><br><ol><li>sacrifice</li></ol>
abrant	<i>noun</i><br><ol><li>eyelid</li></ol>
adėn	<i>noun</i><br><ol><li>wing, feather</li></ol>
adβarnad	<i>verb</i><br><ol><li>to repeal, reverse judgement</li></ol>
alnad	<i>verb</i><br><ol><li>to approach</li></ol>
alɨd	<i>verb</i><br><ol><li>to nourish, grow</li></ol>
ammaɨθ|ėmmėɨθ	<i>noun</i><br><ol><li>servant, worker, laborer</li></ol>
anadl	<i>noun</i><br><ol><li>breath</li></ol>
angel	<i>noun</i><br><ol><li>(Christianity) angel</li></ol>
anw|anwan|ėnwėn	<i>noun</i><br><ol><li>name</li></ol>
ar	<i>prep</i><br><ol><li>in front of</li></ol><br><i>noun</i><br><ol><li>ploughing, ploughed land</li></ol>
aradr|ėrėdr	<i>noun</i><br><ol><li>plow/plough</li></ol>
araβ̃	<i>adj</i><br><ol><li>quiet, calm</li></ol>
argoɨd	<i>noun</i><br><ol><li>surrounding forest</li></ol>
arxangel	<i>noun</i><br><ol><li>(Christianity) archangel</li></ol>
arɣant	<i>noun</i><br><ol><li>silver, money</li></ol>
arβ̃or	<i>noun</i><br><ol><li>coast, seacoast, coastal region</li></ol>
arθ|ėrθ	<i>noun</i><br><ol><li>bear</li></ol>
arọd	<i>noun</i><br><ol><li>prayer, oration</li></ol>
assow	<i>adj</i><br><ol><li>left</li></ol>
awel	<i>noun</i><br><ol><li>breeze, wind</li></ol>
awr	<i>noun</i><br><ol><li>gold</li></ol>
axọs	<i>noun</i><br><ol><li>occasion, reason</li></ol>
að	<i>prep</i><br><ol><li>to</li></ol>
aɨr	<i>noun</i><br><ol><li>battle, carnage</li></ol>
aɨron|aɨronenn	<i>noun</i><br><ol><li>berries</li></ol>
aβal	<i>noun</i><br><ol><li>apple</li></ol>
aβaln	<i>noun</i><br><ol><li>apple tree</li></ol>
aβon	<i>noun</i><br><ol><li>river</li></ol>
aβuɨn	<i>noun</i><br><ol><li>bridle, rein</li></ol>
aβʉ	<i>noun</i><br><ol><li>liver</li></ol>
aβ̃laβar	<i>adj</i><br><ol><li>dumb, mute</li></ol>
aθreβ	<i>noun</i><br><ol><li>settlement, dwelling</li></ol>
bann	<i>noun</i><br><ol><li>top, peak</li></ol>
barnad	<i>verb</i><br><ol><li>to judge</li></ol>
barð|bėrð	<i>noun</i><br><ol><li>poet, bard</li></ol>
barðọl	<i>adj</i><br><ol><li>poetic, bardic</li></ol>
bedu	<i>noun</i><br><ol><li>birch tree</li></ol>
ben	<i>noun</i><br><ol><li>woman</li></ol>
bendiθ	<i>noun</i><br><ol><li>(Christianity) blessing, benediction</li></ol>
ber|berow	<i>noun</i><br><ol><li>(cooking) spit</li></ol>
berθ	<i>adj</i><br><ol><li>beautiful, bright, fine</li></ol>
blėð	<i>noun</i><br><ol><li>wolf</li></ol>
blọd	<i>noun</i><br><ol><li>flour</li><li>flower</li></ol>
bolɣ	<i>noun</i><br><ol><li>sack, bag, stomach</li></ol>
bos	<i>noun</i><br><ol><li>hand</li></ol>
boðar	<i>adj</i><br><ol><li>deaf</li></ol>
brad	<i>noun</i><br><ol><li>deceit, treachery</li></ol>
bran|brėn	<i>noun</i><br><ol><li>crow, raven</li></ol>
braɨn	<i>adj</i><br><ol><li>foul, stinking, putrid</li></ol>
breɣ	<i>noun</i><br><ol><li>hill</li></ol>
briθ|breiθ	<i>noun</i><br><ol><li>charm, incantation</li></ol><br><i>adj</i><br><ol><li>painted, speckled, variegated</li></ol>
bronn	<i>noun</i><br><ol><li>breast</li></ol>
brox	<i>noun</i><br><ol><li>badger</li></ol>
broɣ|broɣɨð	<i>noun</i><br><ol><li>country, region, territory</li></ol>
bröɣɨr	<i>noun</i><br><ol><li>noble</li></ol>
brėx	<i>noun</i><br><ol><li>(anatomy) arm</li></ol>
brėβ̃ɨd	<i>verb</i><br><ol><li>to make noise</li></ol>
brɨd	<i>noun</i><br><ol><li>thought, mind, intent</li></ol>
brɨɣėnt	<i>noun</i><br><ol><li>privilege, birthright</li></ol>
brɨɣėntin	<i>noun</i><br><ol><li>lord, king</li></ol>
bujɨd	<i>verb</i><br><ol><li>to be</li><li>to become</li></ol>
bulx	<i>noun</i><br><ol><li>cleft</li></ol>
bux	<i>noun</i><br><ol><li>goat</li></ol>
buɨd	<i>noun</i><br><ol><li>food</li></ol>
büβal	<i>noun</i><br><ol><li>buffalo</li><li>drinking-horn</li></ol>
bėrɨd|berintor|ber|berimm|beridor|bėriβ̃|berissɨd|beridɨd|berissont|berissomm|beridėnt|berir|beriss|berint|berissɨð(?)|berid|berissed|bėrid|bėrið	<i>verb</i><br><ol><li>to flow, carry</li></ol>
bɨd|bɨdow	<i>noun</i><br><ol><li>world</li></ol>
bɨnad|bɨnað|bɨnant|bɨnamm|bɨnaβ̃|bɨnador|bɨnėss|bɨnėdɨd|bɨnassomm|bɨnassont|bɨnėssɨd|bɨn|bɨnantor|bɨnėssɨð(?)|bɨnar|bɨnėdėnt|bɨnassed|bɨnass	<i>verb</i><br><ol><li>to strike, hit</li></ol>
bɨrr|berr	<i>adj</i><br><ol><li>short</li></ol>
bɨw	<i>adj</i><br><ol><li>alive, living</li></ol><br><i>noun</i><br><ol><li>life</li></ol>
bɨx	<i>adj</i><br><ol><li>small</li></ol>
bʉ	<i>noun</i><br><ol><li>cow</li></ol>
bʉgöl|bʉgölɨð	<i>noun</i><br><ol><li>herdsman</li></ol>
bʉx	<i>noun</i><br><ol><li>cow</li></ol>
bọreɣ	<i>noun</i><br><ol><li>morning</li></ol>
dadl	<i>noun</i><br><ol><li>assembly, meeting</li></ol>
dadβarnad	<i>verb</i><br><ol><li>to revoke, nullify</li></ol>
dall	<i>adj</i><br><ol><li>blind</li></ol>
dant	<i>noun</i><br><ol><li>tooth</li></ol>
dar	<i>noun</i><br><ol><li>oak tree</li></ol>
daβ̃ad|dėβ̃ėd	<i>noun</i><br><ol><li>sheep</li></ol>
deg	<i>num</i><br><ol><li>ten</li></ol>
degβ̃ed	<i>adj</i><br><ol><li>tenth</li></ol>
dexouluss	<i>noun</i><br><ol><li>southernwood</li></ol>
dexow	<i>adj</i><br><ol><li>right</li><li>southern</li></ol>
diaβul	<i>noun</i><br><ol><li>(Christianity) devil</li></ol>
dig	<i>noun</i><br><ol><li>anger</li></ol>
dillüngɨd	<i>verb</i><br><ol><li>to set free, release</li></ol>
din	<i>noun</i><br><ol><li>a hill, fortified hill, fort</li></ol>
dinėr	<i>noun</i><br><ol><li>penny, denarius</li></ol>
diskɨnnɨd	<i>verb</i><br><ol><li>to descend</li></ol>
diweð	<i>noun</i><br><ol><li>end, ending</li></ol>
dið	<i>noun</i><br><ol><li>day, daytime</li></ol>
diβarnad	<i>verb</i><br><ol><li>to condemn, convict</li></ol>
diβėrɨd	<i>verb</i><br><ol><li>to trickle, dribble, fall in drops</li></ol>
dremm	<i>noun</i><br><ol><li>sight, vision</li><li>face</li></ol>
drug	<i>adj</i><br><ol><li>bad</li></ol>
drüw|drüwɨð	<i>noun</i><br><ol><li>druid, seer</li></ol>
drɨngɨd|drɨngið|dringidėnt|dringiss|dringidor|dringimm|drɨngid|dringir|dringidɨd|dringintor|dringissɨð(?)|dring|drɨngiβ̃|dringissɨd|dringissont|dringissomm|dringissed|dringint|dringid	<i>verb</i><br><ol><li>to advance</li><li>to climb</li></ol>
dugɨd	<i>verb</i><br><ol><li>to lead, pull</li></ol>
duɨw	<i>noun</i><br><ol><li>god</li><li>(proper noun) God</li></ol>
duβ	<i>adj</i><br><ol><li>black</li></ol>
duβn|doβn	<i>adj</i><br><ol><li>deep</li></ol>
duβr	<i>noun</i><br><ol><li>water</li></ol>
dün	<i>noun</i><br><ol><li>human, person</li></ol>
düβrgi|duβrgun	<i>noun</i><br><ol><li>otter</li></ol>
dėrwin	<i>adj</i><br><ol><li>oaken, strong, robust, made of oak</li></ol>
dọn	<i>noun</i><br><ol><li>gift, blessing</li></ol>
dọw|düi	<i>num</i><br><ol><li>two</li></ol>
dọβ̃	<i>noun</i><br><ol><li>son-in-law</li><li>client, retainer</li></ol>
eb	<i>noun</i><br><ol><li>horse</li></ol>
ebọl	<i>noun</i><br><ol><li>foal</li></ol>
edn|ɨdn	<i>noun</i><br><ol><li>bird</li></ol>
egluɨs|egluɨsow	<i>noun</i><br><ol><li>(Christianity) church</li></ol>
ehọg	<i>noun</i><br><ol><li>salmon</li></ol>
eskob|eskɨb	<i>noun</i><br><ol><li>(Christianity) bishop</li></ol>
estrọn|estrọnjon	<i>adj</i><br><ol><li>foreign, strange</li></ol><br><i>noun</i><br><ol><li>foreigner, stranger</li></ol>
ex	<i>prep</i><br><ol><li>from, out of</li></ol>
exoβn	<i>adj</i><br><ol><li>fearless, bold</li></ol>
exoβneð	<i>noun</i><br><ol><li>fearlessness, boldness, confidence</li></ol>
exuɨð	<i>noun</i><br><ol><li>evening</li></ol>
eðenn	<i>noun</i><br><ol><li>ivy</li></ol>
eβengɨl	<i>noun</i><br><ol><li>(Christianity) gospel</li></ol>
eβor	<i>noun</i><br><ol><li>The meaning of this term is uncertain. Possibilities include: yew, cow parsnip, hogweed, buckthorn</li></ol>
fer	<i>noun</i><br><ol><li>heel</li></ol>
fin	<i>noun</i><br><ol><li>boundary, border, limit</li><li>(possibly) end</li></ol>
forð	<i>noun</i><br><ol><li>road, path</li><li>(by extension) way, manner</li></ol>
froɨn	<i>noun</i><br><ol><li>nose</li></ol>
frud	<i>noun</i><br><ol><li>stream, river</li><li>flow, current</li></ol>
fruɨθ	<i>noun</i><br><ol><li>fruit</li></ol>
funtọn	<i>noun</i><br><ol><li>spring, well, fountain</li></ol>
gal	<i>noun</i><br><ol><li>might, ability</li></ol>
garan	<i>noun</i><br><ol><li>crane, heron</li></ol>
garr	<i>noun</i><br><ol><li>shank, calf of leg</li></ol>
gaβl	<i>noun</i><br><ol><li>fork</li></ol>
gaβr	<i>noun</i><br><ol><li>goat</li></ol>
gell	<i>adj</i><br><ol><li>yellow, brown, tawny</li></ol>
gen|genow	<i>noun</i><br><ol><li>chin, jaw</li><li>cheek</li></ol>
geβ̃ell	<i>noun</i><br><ol><li>twin</li></ol>
glan	<i>adj</i><br><ol><li>clean, clear</li></ol>
glas	<i>adj</i><br><ol><li>green, blue; grue</li></ol>
glin	<i>noun</i><br><ol><li>knee</li></ol>
glow	<i>noun</i><br><ol><li>coal</li></ol>
gluɨw	<i>adj</i><br><ol><li>bright, shining, sparkling</li></ol>
glɨnn	<i>noun</i><br><ol><li>glen, dale, valley</li></ol>
glʉr	<i>adj</i><br><ol><li>clear, pure, bright</li></ol>
gnọd	<i>adj</i><br><ol><li>known, recognised</li></ol>
gorθ	<i>noun</i><br><ol><li>enclosure, garden</li></ol>
grọn	<i>noun</i><br><ol><li>grain</li></ol>
grọw	<i>noun</i><br><ol><li>gravel, pebbles</li></ol>
gurm	<i>adj</i><br><ol><li>dun, dark, blue</li></ol>
guɨstl	<i>noun</i><br><ol><li>hostage</li><li>bail</li></ol>
gwag	<i>adj</i><br><ol><li>empty, vacant</li></ol>
gwaladr|gwėlėdr	<i>noun</i><br><ol><li>ruler</li></ol>
gwehantuɨn	<i>noun</i><br><ol><li>spring</li></ol>
gwellt	<i>noun</i><br><ol><li>grass</li></ol>
gwen	<i>noun</i><br><ol><li>smile</li></ol>
gwennọl	<i>noun</i><br><ol><li>swallow</li></ol>
gwenuɨn	<i>noun</i><br><ol><li>poison, venom</li></ol>
gwerθ	<i>noun</i><br><ol><li>worth, price</li></ol>
gwesper	<i>noun</i><br><ol><li>evening, vesper</li></ol>
gweðw	<i>noun</i><br><ol><li>widow</li></ol>
gweβl	<i>noun</i><br><ol><li>lip</li></ol>
gwin	<i>noun</i><br><ol><li>wine</li></ol>
gwir	<i>adj</i><br><ol><li>true</li></ol>
gwlad	<i>noun</i><br><ol><li>sovereignty, country</li></ol>
gwlan	<i>noun</i><br><ol><li>wool</li></ol>
gwleð	<i>noun</i><br><ol><li>feast, banquet</li></ol>
gwliθ	<i>noun</i><br><ol><li>dew</li></ol>
gwlėdig	<i>adj</i><br><ol><li>civil, secular, established, national</li></ol>
gwlɨb|gwleb	<i>adj</i><br><ol><li>wet</li></ol>
gwogleð	<i>noun</i><br><ol><li>north</li></ol>
gwollt	<i>noun</i><br><ol><li>hair (of the head)</li></ol>
gwolltọg	<i>adj</i><br><ol><li>hairy, long-haired</li></ol>
gwolọd	<i>noun</i><br><ol><li>wealth</li></ol>
gwolọdọg	<i>adj</i><br><ol><li>wealthy</li></ol>
gworuɨð	<i>noun</i><br><ol><li>horse</li></ol>
gwoɨl|gwoɨθhaβ̃|gwoɨθ	<i>adj</i><br><ol><li>bad</li><li>miserable</li></ol>
gwoɨθl	<i>noun</i><br><ol><li>dispute</li></ol>
gwrėg|gwrageð	<i>noun</i><br><ol><li>woman, female human</li><li>wife</li></ol>
gwrėɣɨd	<i>verb</i><br><ol><li>to do</li><li>to make</li></ol>
gwrʉg	<i>noun</i><br><ol><li>heather</li></ol>
gwur|gwɨr	<i>noun</i><br><ol><li>man</li><li>husband</li></ol>
gwuɨl	<i>noun</i><br><ol><li>feast, feast day</li><li>vigil</li><li>curtain</li><li>sail of a ship</li></ol>
gwuɨlann	<i>noun</i><br><ol><li>gull, seagull</li></ol>
gwuɨð	<i>noun</i><br><ol><li>appearance, presence, face, sight, image</li></ol>
gwöllüngɨd	<i>verb</i><br><ol><li>to let go of, drop</li></ol>
gwölɨɣ	<i>noun</i><br><ol><li>bed</li></ol>
gwöniθ	<i>noun</i><br><ol><li>wheat</li></ol>
gwüxī	<i>noun</i><br><ol><li>wasp</li></ol>
gwėlɨð	<i>adj</i><br><ol><li>strong, mighty</li></ol>
gwėnɨd|gwėniβ̃|gwen|gwenidor|gwenimm|gwenissed|gwenissɨð(?)|gwenintor|gwenissont|gwenissɨd|gwėnið|gwenidėnt|gwenidɨd|gwenid|gwenint|gwenissomm|gwenir|gwėnid|gweniss	<i>verb</i><br><ol><li>to strike, kill</li></ol>
gwėɣin	<i>noun</i><br><ol><li>sheath</li></ol>
gwɨbod	<i>noun</i><br><ol><li>knowing</li><li>to know (verbal noun to *gwuɨr)</li></ol>
gwɨdr|gwɨdrow	<i>noun</i><br><ol><li>glass</li></ol>
gwɨmon	<i>noun</i><br><ol><li>seaweed</li></ol>
gwɨnn|gwenn	<i>adj</i><br><ol><li>white</li></ol>
gwɨnt	<i>noun</i><br><ol><li>wind</li></ol>
gwɨrð	<i>adj</i><br><ol><li>green, verdant</li></ol>
gwɨrθ	<i>noun</i><br><ol><li>miracle, sign</li></ol>
gwɨs	<i>noun</i><br><ol><li>knowledge</li><li>research</li></ol>
gwɨwer	<i>noun</i><br><ol><li>squirrel</li></ol>
gwɨð	<i>noun</i><br><ol><li>wood, trees</li></ol>
gwɨðn	<i>adj</i><br><ol><li>flexible, pliable</li><li>durable</li></ol>
gyọ	<i>noun</i><br><ol><li>sinew</li></ol>
gėlwɨd	<i>verb</i><br><ol><li>to call</li></ol>
gėnjed	<i>verb</i><br><ol><li>to be born</li></ol>
gėr	<i>noun</i><br><ol><li>word, speech</li></ol>
haluɨn	<i>noun</i><br><ol><li>salt</li></ol>
hanoɨθ	<i>noun</i><br><ol><li>tonight</li></ol>
haβ̃	<i>noun</i><br><ol><li>summer</li></ol>
haβ̃al	<i>adj</i><br><ol><li>like, similar, resembling</li></ol><br><i>prep</i><br><ol><li>like, as</li></ol>
haβ̃ar	<i>noun</i><br><ol><li>summer fallow</li></ol>
haβ̃areg	<i>noun</i><br><ol><li>fallow land, summer pasture</li></ol>
heb	<i>prep</i><br><ol><li>besides</li><li>without</li></ol>
hen	<i>adj</i><br><ol><li>old</li></ol>
hil	<i>noun</i><br><ol><li>race, lineage</li></ol>
hir	<i>adj</i><br><ol><li>long, tall</li></ol>
hiraɨθ	<i>noun</i><br><ol><li>nostalgia, longing, yearning, homesickness</li></ol>
hoɨdl	<i>noun</i><br><ol><li>life, age</li></ol>
hux	<i>noun</i><br><ol><li>pig</li></ol>
huɨr	<i>adj</i><br><ol><li>late</li></ol>
hwegr	<i>noun</i><br><ol><li>mother-in-law</li></ol>
hwehir	<i>noun</i><br><ol><li>sister</li></ol>
hwerw	<i>adj</i><br><ol><li>bitter</li></ol>
hwex	<i>num</i><br><ol><li>six</li></ol>
hwexed	<i>adj</i><br><ol><li>sixth</li></ol>
hwi|ti	<i>pron</i><br><ol><li>you pl</li></ol>
hwuɨs	<i>noun</i><br><ol><li>sweat, perspiration</li></ol>
hwuɨð	<i>noun</i><br><ol><li>swelling</li></ol>
hwɨβid	<i>verb</i><br><ol><li>to move, recede</li></ol>
hwɨθɨd	<i>verb</i><br><ol><li>to blow</li></ol>
hüβol	<i>noun</i><br><ol><li>fetter, shackle, bonds</li></ol>
hėbɨd	<i>verb</i><br><ol><li>to say</li></ol>
hɨnt|hɨntow	<i>noun</i><br><ol><li>path, way</li></ol>
hɨsp	<i>adj</i><br><ol><li>dry</li></ol>
hʉd	<i>noun</i><br><ol><li>magic, charm</li></ol>
hʉn	<i>noun</i><br><ol><li>sleep</li></ol>
ir	<i>adj</i><br><ol><li>fresh, new</li></ol>
iss	<i>prep</i><br><ol><li>under, below</li></ol>
issel	<i>adj</i><br><ol><li>low, depressed, low-lying, shallow</li></ol>
jaɣ	<i>noun</i><br><ol><li>ice</li></ol>
jeiθ	<i>noun</i><br><ol><li>language</li></ol>
jorx	<i>noun</i><br><ol><li>roebuck</li></ol>
jowank	<i>adj</i><br><ol><li>young</li></ol>
jʉð	<i>noun</i><br><ol><li>lord, judge</li></ol>
jọw	<i>noun</i><br><ol><li>yoke</li></ol>
kad	<i>noun</i><br><ol><li>battle</li></ol>
kaduɨr	<i>noun</i><br><ol><li>chair</li></ol>
kalon	<i>noun</i><br><ol><li>heart</li></ol>
kant	<i>num</i><br><ol><li>hundred</li></ol>
kantl	<i>noun</i><br><ol><li>song, singing</li></ol>
kantuɨll	<i>noun</i><br><ol><li>candle</li><li>light</li></ol>
kar|karant|kėrėnt	<i>noun</i><br><ol><li>friend, relative</li></ol>
kareð	<i>noun</i><br><ol><li>mistake, sin</li></ol>
karr|kėrr	<i>noun</i><br><ol><li>wagon</li><li>cart</li><li>load</li></ol>
karw	<i>noun</i><br><ol><li>deer, stag</li></ol>
karɨd	<i>verb</i><br><ol><li>to love</li></ol>
kas	<i>noun</i><br><ol><li>hate</li></ol>
kaw	<i>adj</i><br><ol><li>hollow</li></ol>
kawl	<i>noun</i><br><ol><li>cabbage</li></ol>
kax	<i>noun</i><br><ol><li>dung, excrement</li></ol>
kaɨ	<i>noun</i><br><ol><li>animal pen, enclosure, field</li></ol>
kaɨr	<i>noun</i><br><ol><li>a fort or fortified town; a stronghold.</li></ol>
kaɨθ	<i>adj</i><br><ol><li>captive, bound</li></ol>
kaθ	<i>noun</i><br><ol><li>cat</li></ol>
kedor	<i>noun</i><br><ol><li>pubic hair</li></ol>
ki|kun	<i>noun</i><br><ol><li>dog</li></ol>
kiwdọd	<i>noun</i><br><ol><li>people, tribe</li><li>town</li></ol>
klaβ̃	<i>adj</i><br><ol><li>ill, sick, leprous</li></ol>
kleð	<i>adj</i><br><ol><li>left</li><li>northern</li></ol>
klog	<i>noun</i><br><ol><li>stone, rock</li></ol>
kluɨreg	<i>noun</i><br><ol><li>clerk, cleric</li></ol>
kluɨt	<i>noun</i><br><ol><li>palisade, hurdle</li></ol>
klüwid	<i>verb</i><br><ol><li>to hear</li></ol>
klėðɨd	<i>verb</i><br><ol><li>to dig, bury</li></ol>
klėβ̃ɨd	<i>noun</i><br><ol><li>sickness, illness, disease, fever</li></ol>
klɨd|kled	<i>adj</i><br><ol><li>warm, sheltered</li></ol>
klʉst	<i>noun</i><br><ol><li>(anatomy) ear</li></ol>
klọr	<i>noun</i><br><ol><li>board, cover, plank</li></ol>
klọw	<i>noun</i><br><ol><li>bolt</li></ol>
know|knowenn	<i>noun</i><br><ol><li>nuts</li></ol>
knox	<i>noun</i><br><ol><li>hill, mound</li></ol>
knud	<i>noun</i><br><ol><li>crop, produce</li></ol>
kolɨn	<i>noun</i><br><ol><li>holly</li></ol>
komm	<i>noun</i><br><ol><li>valley</li></ol>
korf	<i>noun</i><br><ol><li>(anatomy) body</li></ol>
korr	<i>noun</i><br><ol><li>dwarf, pygmy, stunted individual</li></ol>
korruɨ	<i>noun</i><br><ol><li>thong, lace</li></ol>
korug	<i>noun</i><br><ol><li>coracle</li></ol>
koɨd	<i>noun</i><br><ol><li>wood, forest</li></ol>
koɨg	<i>adj</i><br><ol><li>one-eyed, blind</li></ol>
koɨs	<i>noun</i><br><ol><li>leg, shank, stem</li></ol>
krank	<i>noun</i><br><ol><li>crab</li></ol>
kreθ	<i>noun</i><br><ol><li>body, frame, shape</li></ol>
krow	<i>noun</i><br><ol><li>blood</li></ol>
krunn	<i>adj</i><br><ol><li>round</li></ol>
kruɨdr	<i>noun</i><br><ol><li>sieve, winnowing fan</li></ol>
krėdid|kredissomm|kredir|kredid|kredissed|kredissɨd|kredidɨd|kredissont|krėdið|kredintor|krėdiβ̃|kredidor|kredint|kredidėnt|kred|kredimm|kredissɨð(?)|krediss	<i>verb</i><br><ol><li>to believe</li></ol>
krɨx	<i>adj</i><br><ol><li>curly, frizzy</li></ol>
krɨβ̃	<i>adj</i><br><ol><li>strong</li></ol>
krʉn	<i>noun</i><br><ol><li>skin</li></ol>
kuml	<i>noun</i><br><ol><li>cloud (visible mass of water droplets)</li></ol>
kummėrɨd	<i>verb</i><br><ol><li>to seize, take possession, lead away</li></ol>
kummɨnad	<i>verb</i><br><ol><li>to fell, cut down, kill, hew</li></ol>
kummɨskad	<i>verb</i><br><ol><li>to mingle, confuse, mix</li></ol>
kunikl	<i>noun</i><br><ol><li>rabbit</li></ol>
kurr	<i>noun</i><br><ol><li>corner, edge</li></ol>
kuskɨd	<i>verb</i><br><ol><li>to sleep</li></ol>
kuwann	<i>noun</i><br><ol><li>owl</li></ol>
kuɨlð	<i>noun</i><br><ol><li>servant, companion</li></ol>
kuɨn	<i>noun</i><br><ol><li>supper, meal</li></ol>
kuɨr	<i>noun</i><br><ol><li>wax</li></ol>
kuβ̃oɨθ	<i>noun</i><br><ol><li>wealth, riches</li><li>power, influence</li></ol>
kuβ̃oɨθọg	<i>adj</i><br><ol><li>wealthy, rich</li><li>powerful, influential</li></ol>
kuβ̃ruɨɣ	<i>noun</i><br><ol><li>binding, bond</li></ol>
kömroɣ|kɵ̇mrüɣ	<i>noun</i><br><ol><li>compatriot, comrade</li></ol>
körxɨð	<i>noun</i><br><ol><li>heron</li></ol>
köwir	<i>adj</i><br><ol><li>true, genuine, loyal, honest, correct</li></ol>
küwėr	<i>adj</i><br><ol><li>complete</li></ol>
kėfɨl	<i>noun</i><br><ol><li>horse</li></ol>
kėfɨlọg	<i>noun</i><br><ol><li>woodcock</li></ol>
kėgin	<i>noun</i><br><ol><li>kitchen</li></ol>
kėljọg	<i>noun</i><br><ol><li>rooster</li></ol>
kėlβ̃ɨð	<i>adj</i><br><ol><li>skillful, skilled</li></ol>
kėnėw|kanawon	<i>noun</i><br><ol><li>whelp, young animal</li></ol>
kėnɨd|kenissomm|kėnid|kenidėnt|kenissed|kenintor|kenissont|kenidor|kėniβ̃|kenissɨd|keniss|kenissɨð(?)|kenimm|kenid|kenint|kenidɨd|kenir|ken|kėnið	<i>verb</i><br><ol><li>to sing</li></ol>
kėres	<i>noun</i><br><ol><li>cherry</li></ol>
kɨnt|kɨnthaβ̃	<i>adj</i><br><ol><li>earlier, sooner, before, former, previous</li></ol>
kɵ̇nniβ̃jad	<i>noun</i><br><ol><li>fighter, warrior</li></ol>
kʉl	<i>noun</i><br><ol><li>narrow</li></ol>
kʉβɨgl	<i>noun</i><br><ol><li>cubicle, bedchamber</li></ol>
kọs	<i>noun</i><br><ol><li>cheese</li></ol>
lin	<i>noun</i><br><ol><li>flax</li><li>linen</li><li>flow, fluid</li></ol>
llann	<i>noun</i><br><ol><li>land, area, plot</li><li>sacred place, churchyard</li></ol>
llað	<i>noun</i><br><ol><li>slaying, slaughter</li></ol>
llaɣw|llaɣü|llaɣhaβ̃	<i>adj</i><br><ol><li>small</li><li>bad</li></ol>
llaɨθ	<i>noun</i><br><ol><li>milk</li></ol>
llaβar	<i>adj</i><br><ol><li>prone to talking, eloquent</li></ol>
llaθ	<i>noun</i><br><ol><li>rod, staff, stick, spear, beam, rafter, pole</li></ol>
lled	<i>noun</i><br><ol><li>breadth, side</li></ol>
lledr	<i>noun</i><br><ol><li>leather</li></ol>
llenn	<i>noun</i><br><ol><li>cloak</li><li>curtain, veil</li></ol>
llew	<i>noun</i><br><ol><li>lion</li></ol>
llex	<i>noun</i><br><ol><li>(flat) stone</li></ol>
lleɣ	<i>noun</i><br><ol><li>place</li></ol>
lleɣenn	<i>noun</i><br><ol><li>literature, learning</li></ol>
lliw	<i>noun</i><br><ol><li>colour</li></ol>
lliɣɨd	<i>verb</i><br><ol><li>to lick</li></ol>
llowadr	<i>noun</i><br><ol><li>washbasin</li></ol>
llowen	<i>adj</i><br><ol><li>merry, cheerful, joyful</li></ol>
llowern	<i>noun</i><br><ol><li>fox</li></ol>
lloɨr	<i>noun</i><br><ol><li>moon</li></ol>
lloβ̃an	<i>noun</i><br><ol><li>rope, string</li></ol>
llug|llugodenn|llugod	<i>noun</i><br><ol><li>mouse</li></ol>
llugad	<i>noun</i><br><ol><li>eye</li></ol>
lluss	<i>noun</i><br><ol><li>herb</li></ol>
lluɨd	<i>adj</i><br><ol><li>grey</li></ol>
lluɨɣ	<i>noun</i><br><ol><li>spoon, scoop, ladle, trowel</li></ol>
lluβoɣorθ	<i>noun</i><br><ol><li>herb garden, vegetable garden</li></ol>
llüu	<i>noun</i><br><ol><li>rudder</li></ol>
llėðjad	<i>noun</i><br><ol><li>slayer, murderer, slaughterer</li></ol>
llėβėrjad	<i>noun</i><br><ol><li>speaker, one who speaks or talks</li></ol>
llɨdan	<i>adj</i><br><ol><li>broad, wide</li></ol>
llɨdaw	<i>noun</i><br><ol><li>continent, mainland (of Europe)</li><li>(proper noun) Brittany</li></ol>
llɨnad|llɨnamm|llɨnassomm|llɨnantor|llɨnass|llɨnant|llɨnėdɨd|llɨnað|llɨnassed|llɨnėss|llɨnėssɨd|llɨnėssɨð(?)|llɨnassont|llɨnar|llɨnador|llɨnaβ̃|llɨnėdėnt|llɨn	<i>verb</i><br><ol><li>to stick, cling</li></ol>
llɨβr	<i>noun</i><br><ol><li>book</li></ol>
llʉɣ	<i>noun</i><br><ol><li>troop</li></ol>
llọn	<i>adj</i><br><ol><li>full</li></ol>
llọr	<i>noun</i><br><ol><li>floor</li></ol>
llọβ̃	<i>noun</i><br><ol><li>palm, hand</li></ol>
mab	<i>noun</i><br><ol><li>son</li></ol>
mad	<i>adj</i><br><ol><li>good</li></ol>
maguɨr	<i>noun</i><br><ol><li>wall</li></ol>
maluɨn	<i>adj</i><br><ol><li>evil, accursed</li></ol>
mamm	<i>noun</i><br><ol><li>mother, as used by a child</li></ol>
manax	<i>noun</i><br><ol><li>(Christianity) monk</li></ol>
marw	<i>adj</i><br><ol><li>dead</li></ol>
marwọd	<i>verb</i><br><ol><li>to die</li></ol>
marx	<i>noun</i><br><ol><li>horse</li></ol>
marxọg|marxọgjon	<i>noun</i><br><ol><li>horseman</li></ol>
maɣl	<i>noun</i><br><ol><li>noble, chief</li></ol>
maɣɨn|meɣin	<i>noun</i><br><ol><li>stone</li></ol>
meið	<i>noun</i><br><ol><li>whey</li></ol>
mennɨd	<i>verb</i><br><ol><li>to will, wish</li></ol>
menw	<i>noun</i><br><ol><li>thought, mind</li></ol>
mer	<i>noun</i><br><ol><li>marrow</li></ol>
merx	<i>noun</i><br><ol><li>daughter</li></ol>
merθɨr	<i>noun</i><br><ol><li>(Christianity) martyr</li><li>(in toponyms) martyrium; burial place of a martyr</li></ol>
með	<i>noun</i><br><ol><li>mead</li></ol>
meβl	<i>noun</i><br><ol><li>shame, disgrace</li></ol>
meβ̃or	<i>noun</i><br><ol><li>memory</li></ol>
mi	<i>pron</i><br><ol><li>I, me</li></ol>
mil	<i>noun</i><br><ol><li>animal, beast</li></ol><br><i>num</i><br><ol><li>thousand</li></ol>
mollt	<i>noun</i><br><ol><li>ram, wether</li></ol>
molọd|molad|mol|molọntor|molọr|molọmm|molass|molassomm|mölėss|molassed|molọnt|mölėssɨð(?)|molọdor|molassont|mölėdėnt|mölėssɨd|mölọβ̃|mölėdɨd|mölọd|mölọð	<i>verb</i><br><ol><li>to praise, laud</li></ol><br><i>noun</i><br><ol><li>praise, exaltation</li></ol>
mor|moreð	<i>noun</i><br><ol><li>sea</li></ol>
moruɨn	<i>noun</i><br><ol><li>girl, maiden</li></ol>
mox	<i>noun</i><br><ol><li>pigs</li></ol><br><i>adv</i><br><ol><li>soon, early</li></ol>
munβ̃ent	<i>noun</i><br><ol><li>graveyard, churchyard</li></ol>
muɨn	<i>adj</i><br><ol><li>beautiful</li></ol><br><i>noun</i><br><ol><li>ore, metal</li><li>mine</li></ol>
mönɨð	<i>noun</i><br><ol><li>mountain</li></ol>
möxjad	<i>noun</i><br><ol><li>swineherd</li></ol>
mėdɨd	<i>verb</i><br><ol><li>to reap</li><li>to cut</li></ol>
mėgin	<i>noun</i><br><ol><li>bellows</li></ol>
mėnɨβr	<i>noun</i><br><ol><li>hilt, handle</li></ol>
mėðjɨd	<i>verb</i><br><ol><li>to break, knead</li></ol>
mėðɨd	<i>verb</i><br><ol><li>to measure, judge</li></ol>
mɨsk	<i>prep</i><br><ol><li>amid, amidst</li></ol>
mɨskad	<i>verb</i><br><ol><li>to blend, mix, confuse</li></ol>
mọdreb	<i>noun</i><br><ol><li>aunt</li></ol>
mọr	<i>adj</i><br><ol><li>great, large</li></ol>
nant	<i>noun</i><br><ol><li>stream, river</li><li>valley</li></ol>
naw	<i>num</i><br><ol><li>nine</li></ol>
nei	<i>noun</i><br><ol><li>nephew</li></ol>
nerθ	<i>noun</i><br><ol><li>strength, force, power</li></ol>
neɨθjuɨr	<i>adv</i><br><ol><li>last night</li></ol>
neɨθjọr	<i>noun</i><br><ol><li>wedding feast</li></ol>
neβ̃	<i>noun</i><br><ol><li>heaven, sky</li></ol>
ni	<i>adv</i><br><ol><li>not</li></ol>
niβ̃er	<i>noun</i><br><ol><li>number</li></ol>
niθ	<i>adj</i><br><ol><li>winnowed</li><li>(substantive) something winnowed, wheat</li></ol>
niθjɨd	<i>verb</i><br><ol><li>to winnow</li></ol>
noɨθ	<i>noun</i><br><ol><li>naked, bare</li></ol>
nėdr	<i>noun</i><br><ol><li>snake</li></ol>
nėðɨd	<i>verb</i><br><ol><li>to carve</li></ol>
nėθ	<i>noun</i><br><ol><li>niece</li></ol>
nɨθ	<i>noun</i><br><ol><li>nest</li></ol>
nọβ̃	<i>noun</i><br><ol><li>the act of swimming</li><li>a place to swim</li></ol>
nọβ̃ed	<i>adj</i><br><ol><li>ninth</li></ol>
o	<i>prep</i><br><ol><li>from</li></ol>
oged	<i>noun</i><br><ol><li>harrow</li></ol>
oɨd	<i>noun</i><br><ol><li>time, period, era</li></ol>
oɨs	<i>noun</i><br><ol><li>age</li></ol>
oβn	<i>noun</i><br><ol><li>fear</li></ol>
pal	<i>noun</i><br><ol><li>shovel, spade</li></ol>
palad	<i>verb</i><br><ol><li>to dig (up)</li></ol>
paladr	<i>noun</i><br><ol><li>spear, shaft, pike, lance</li></ol>
paraduɨs	<i>noun</i><br><ol><li>(Christianity) paradise</li></ol>
paruɨd	<i>noun</i><br><ol><li>wall</li></ol>
parθ|parθow	<i>noun</i><br><ol><li>area, region, zone</li></ol>
parọd	<i>adj</i><br><ol><li>ready, prepared</li></ol>
pedwar|pedeir	<i>num</i><br><ol><li>four</li></ol>
penn	<i>noun</i><br><ol><li>head</li></ol>
per|perenn	<i>noun</i><br><ol><li>pears</li></ol>
perθ	<i>noun</i><br><ol><li>bush, thicket</li></ol>
pexad|pexassont|pex|pexėssɨð(?)|pexassomm|pexador|pexað|pexar|pexantor|pexaβ̃|pexėssɨd|pexėdɨd|pexassed|pexass|pexamm|pexėss|pexėdėnt|pexant	<i>verb</i><br><ol><li>to sin, offend</li></ol>
pexadʉr|pexadʉres	<i>noun</i><br><ol><li>sinner</li></ol>
pexọd|pexọdow	<i>noun</i><br><ol><li>sin</li></ol>
peθ	<i>noun</i><br><ol><li>piece, portion, segment</li></ol>
pluɨβ	<i>noun</i><br><ol><li>countryside, parish</li><li>common people, parishioners</li></ol>
plʉβ̃|plʉβ̃ɨnn|plʉβ̃enn	<i>noun</i><br><ol><li>feathers</li></ol>
plʉβ̃ọg	<i>noun</i><br><ol><li>cushion, pillow</li></ol>
pobl	<i>noun</i><br><ol><li>(countable) people</li></ol>
pobɨd	<i>verb</i><br><ol><li>to cook, bake</li></ol>
pont	<i>noun</i><br><ol><li>bridge</li></ol>
porxell	<i>noun</i><br><ol><li>piglet</li></ol>
porθ	<i>noun</i><br><ol><li>door, gate, gateway</li><li>port, harbor; haven</li></ol>
poɨθ	<i>adj</i><br><ol><li>cooked, hot</li></ol>
prenn	<i>noun</i><br><ol><li>wood, tree</li></ol>
prið	<i>noun</i><br><ol><li>clay, mud, earth</li></ol>
profuɨd	<i>noun</i><br><ol><li>prophet</li></ol>
prɨd	<i>noun</i><br><ol><li>shape, form</li><li>time</li></ol>
prɨnad|prɨnaβ̃|prɨnantor|prɨnėssɨð(?)|prɨnėdėnt|prɨnador|prɨnėdɨd|prɨnað|prɨnamm|prɨn|prɨnėssɨd|prɨnass|prɨnassed|prɨnassont|prɨnar|prɨnassomm|prɨnant|prɨnėss	<i>verb</i><br><ol><li>to buy</li></ol>
prɨβ̃	<i>noun</i><br><ol><li>worm</li></ol>
puɨll	<i>noun</i><br><ol><li>mind</li><li>sense, wisdom, intelligence</li><li>meaning</li></ol>
puɨs	<i>noun</i><br><ol><li>weight</li></ol>
pėdwėrɨð|pedwareð	<i>adj</i><br><ol><li>fourth</li></ol>
pɨg	<i>noun</i><br><ol><li>pitch, tar</li></ol>
pɨmp	<i>num</i><br><ol><li>five</li></ol>
pɨmped	<i>adj</i><br><ol><li>fifth</li></ol>
pɨnnag	<i>adv</i><br><ol><li>whatsoever, whosoever</li></ol>
pɨsk|pɨskọd|pɨskọdɨnn	<i>noun</i><br><ol><li>fish</li></ol>
pɨskọd|pɨskọdɨnn	<i>noun</i><br><ol><li>(possibly) food fish, fish meat used as food</li></ol>
rraθɨd	<i>verb</i><br><ol><li>to rub, scrape (off)</li><li>to make smooth, file</li></ol>
rreiθ|rreiθow	<i>noun</i><br><ol><li>rule, law</li></ol>
rriɣ	<i>noun</i><br><ol><li>king</li></ol>
rriɣėn|rriɣaneð	<i>noun</i><br><ol><li>queen</li></ol>
rriβ̃	<i>noun</i><br><ol><li>number</li></ol>
rriθ	<i>noun</i><br><ol><li>form, appearance</li></ol>
rrod	<i>noun</i><br><ol><li>wheel</li></ol>
rros	<i>noun</i><br><ol><li>moor, heath</li></ol>
rruɨd	<i>noun</i><br><ol><li>net</li></ol>
rruɨð	<i>adj</i><br><ol><li>sparse, rare, loose</li></ol>
rrɨd	<i>noun</i><br><ol><li>ford</li></ol>
rrɨx	<i>noun</i><br><ol><li>furrow</li></ol>
rrɨð|rreð	<i>adj</i><br><ol><li>free</li></ol>
rrʉð	<i>adj</i><br><ol><li>red</li></ol>
ruɨβ̃	<i>noun</i><br><ol><li>oar</li></ol>
saɣeθ|saɣeθow	<i>noun</i><br><ol><li>arrow</li></ol>
seiθ	<i>num</i><br><ol><li>seven</li></ol>
selsig|selsigenn	<i>noun</i><br><ol><li>sausages</li></ol>
seɨθβ̃ed	<i>adj</i><br><ol><li>seventh</li></ol>
skol	<i>noun</i><br><ol><li>school</li></ol>
skuɨd	<i>noun</i><br><ol><li>shield</li></ol>
skuβarn	<i>noun</i><br><ol><li>(anatomy) ear</li></ol>
skuβarnọg	<i>noun</i><br><ol><li>hare</li></ol>
skọd	<i>noun</i><br><ol><li>shadow, shade</li></ol>
son	<i>noun</i><br><ol><li>sound</li></ol>
spɨrɨd	<i>noun</i><br><ol><li>spirit</li></ol>
staɨn	<i>noun</i><br><ol><li>tin</li></ol>
ster|sterenn	<i>noun</i><br><ol><li>stars</li></ol>
stor	<i>noun</i><br><ol><li>resin</li></ol>
streɨl	<i>noun</i><br><ol><li>horse-comb</li></ol>
strodʉr	<i>noun</i><br><ol><li>saddle</li></ol>
stüngɨd	<i>verb</i><br><ol><li>to bend</li></ol>
sux	<i>noun</i><br><ol><li>plowshare</li></ol>
suɨβ̃	<i>noun</i><br><ol><li>grease</li></ol>
sɨx|sex	<i>adj</i><br><ol><li>dry</li></ol>
tad|tėd	<i>noun</i><br><ol><li>father</li></ol>
talx	<i>noun</i><br><ol><li>fragment, piece</li></ol>
tan	<i>prep</i><br><ol><li>under</li></ol><br><i>noun</i><br><ol><li>fire</li></ol>
tann	<i>noun</i><br><ol><li>green oak</li></ol>
tanẹw|tanaw	<i>adj</i><br><ol><li>thin</li></ol>
taradr|tėrėdr	<i>noun</i><br><ol><li>auger, borer, drill</li></ol>
tarw	<i>noun</i><br><ol><li>bull</li></ol>
tarðad	<i>verb</i><br><ol><li>to explode</li></ol>
taβern	<i>noun</i><br><ol><li>inn, tavern</li></ol>
teɣ	<i>adj</i><br><ol><li>thick</li></ol>
ti|hwi	<i>pron</i><br><ol><li>you (singular), thou</li></ol>
tir	<i>noun</i><br><ol><li>land</li></ol>
towɨssọg	<i>noun</i><br><ol><li>leader, chief, king</li><li>prince</li></ol>
toɣ	<i>noun</i><br><ol><li>roof, ceiling</li></ol>
toɨs	<i>noun</i><br><ol><li>dough</li></ol>
traɨθ	<i>noun</i><br><ol><li>beach</li><li>(Southwestern Brythonic) sand</li></ol>
treβ	<i>noun</i><br><ol><li>town, settlement</li></ol>
treβn	<i>noun</i><br><ol><li>room, chamber</li></ol>
tri|teir	<i>num</i><br><ol><li>three</li></ol>
trindọd	<i>noun</i><br><ol><li>(Christianity) Trinity</li></ol>
trum|trom	<i>adj</i><br><ol><li>heavy</li></ol>
trɨdɨð|trɨdeð	<i>adj</i><br><ol><li>third</li></ol>
tuɨg	<i>noun</i><br><ol><li>covering</li><li>gown, garment</li></ol>
tuβ̃	<i>noun</i><br><ol><li>strength, growth</li></ol>
tüβ̃id	<i>verb</i><br><ol><li>to grow, develop</li></ol>
tɨner	<i>noun</i><br><ol><li>soft, tender, delicate</li></ol>
tɨɣ	<i>noun</i><br><ol><li>house</li></ol>
tɨɣern	<i>noun</i><br><ol><li>lord, ruler</li></ol>
tɨɣernọg	<i>adj</i><br><ol><li>lordly, noble</li></ol>
tɨβ̃uɨl	<i>noun</i><br><ol><li>darkness</li></ol>
tʉd	<i>noun</i><br><ol><li>people</li></ol>
tọðɨd	<i>verb</i><br><ol><li>to thaw</li></ol>
uɨβ	<i>noun</i><br><ol><li>drinker</li></ol>
uβ̃ɨl	<i>adj</i><br><ol><li>humble</li></ol>
ödjon	<i>noun</i><br><ol><li>ox, bull</li></ol>
üiθ	<i>num</i><br><ol><li>eight</li></ol>
üɨθβ̃ed	<i>adj</i><br><ol><li>eighth</li></ol>
ėdwėnɨd	<i>verb</i><br><ol><li>to strike again</li></ol>
ėdβėrɨd	<i>verb</i><br><ol><li>to reclaim, retrieve, recover</li></ol>
ėgin	<i>noun</i><br><ol><li>shoot, sprout</li></ol>
ėiriβ̃	<i>noun</i><br><ol><li>a number, counting</li></ol>
ėl	<i>adj</i><br><ol><li>second, other</li></ol>
ėllüngɨd	<i>verb</i><br><ol><li>to loose, release, set free</li></ol>
ėlβɨð	<i>noun</i><br><ol><li>world</li></ol>
ėnib	<i>noun</i><br><ol><li>face</li></ol>
ėrxɨd|arxissomm|arxidor|arxintor|arxissɨd|arxir|arxid|arxiss|ėrxid|arxidɨd|arxissed|ėrxiβ̃|arxissont|arximm|arxissɨð(?)|arx|ėrxið|arxidėnt|arxint	<i>verb</i><br><ol><li>to ask, plead</li></ol>
ėrðɨd|ėrðid|arðissɨð(?)|arðiss|arðissɨd|ėrðið|arðint|arðintor|arðidor|ėrðiβ̃|arðidɨd|arðissed|arðissont|arðidėnt|arðissomm|arðid|arðir|arð|arðimm	<i>verb</i><br><ol><li>to plough</li></ol>
ėrɣ	<i>noun</i><br><ol><li>snow</li></ol>
ėrβėrɨd	<i>verb</i><br><ol><li>to make use of, employ, take</li></ol>
ėɣɨd|ėɣið|aɣidɨd|aɣid|aɣissɨð(?)|aɣimm|aɣidor|aɣir|aɣint|aɣissomm|aɣintor|aɣiss|aɣissont|ėɣiβ̃|aɣissɨd|aɣissed|ėɣid|aɣidėnt|aɣ	<i>verb</i><br><ol><li>to drive, go</li></ol>
ɨmperọdr	<i>noun</i><br><ol><li>emperor</li></ol>
ɨn	<i>prep</i><br><ol><li>in</li></ol>
ɨn mɨsk	<i>prep</i><br><ol><li>among</li></ol>
ɨntr	<i>prep</i><br><ol><li>between</li></ol>
ɨnɨs|ɨnɨseð	<i>noun</i><br><ol><li>island</li></ol>
ɨβɨd	<i>verb</i><br><ol><li>to drink</li></ol>
ʉn	<i>num</i><br><ol><li>one</li></ol>
ʉx	<i>prep</i><br><ol><li>above, on top of, over</li></ol>
ʉxel	<i>adj</i><br><ol><li>high, elevated</li></ol>
ʉxer	<i>noun</i><br><ol><li>evening, vesper</li></ol>
ʉθ	<i>noun</i><br><ol><li>horror</li></ol>
β̃lin	<i>adj</i><br><ol><li>weary, tired</li><li>tiring, tiresome</li></ol>
ọr|ọr f}	<i>noun</i><br><ol><li>hour</li></ol>
