A|a	<i>character</i><br><ol><li>The first letter of the Romani alphabet, written in the Latin script.</li></ol>
B|b	<i>character</i><br><ol><li>The second letter of the Romani alphabet, written in the Latin script.</li></ol>
Bakro	<i>name</i><br><ol><li>an unknown-gender given name</li></ol>
C|c	<i>character</i><br><ol><li>The third letter of the Romani alphabet, written in the Latin script.</li></ol>
D|d	<i>character</i><br><ol><li>The sixth letter of the Romani alphabet, written in the Latin script.</li></ol>
Devel|Del|Devles|Devleça|Devl!a	<i>name</i><br><ol><li>God</li></ol>
Dumali	<i>name</i><br><ol><li>an unknown-gender given name</li></ol>
Dž|dž	<i>character</i><br><ol><li>(Pan-Vlax) The seventh letter of the Romani alphabet, written in the Latin script.</li></ol>
E|e	<i>character</i><br><ol><li>(International Standard) The seventh letter of the Romani alphabet, written in the Latin script.</li><li>(Pan-Vlax) The eighth letter of the Romani alphabet, written in the Latin script.</li></ol>
F|f	<i>character</i><br><ol><li>(International Standard) The eighth letter of the Romani alphabet, written in the Latin script.</li><li>(Pan-Vlax) The ninth letter of the Romani alphabet, written in the Latin script.</li></ol>
G|g	<i>character</i><br><ol><li>(International Standard) The ninth letter of the Romani alphabet, written in the Latin script.</li><li>(Pan-Vlax) The tenth letter of the Romani alphabet, written in the Latin script.</li></ol>
H|h	<i>character</i><br><ol><li>(International Standard) The tenth letter of the Romani alphabet, written in the Latin script.</li><li>(Pan-Vlax) The eleventh letter of the Romani alphabet, written in the Latin script.</li></ol>
I|i	<i>character</i><br><ol><li>(International Standard) The twelfth letter of the Romani alphabet, written in the Latin script.</li><li>(Pan-Vlax) The thirteenth letter of the Romani alphabet, written in the Latin script.</li></ol>
J|j	<i>character</i><br><ol><li>(International Standard) The thirteenth letter of the Romani alphabet, written in the Latin script.</li><li>(Pan-Vlax) The fourteenth letter of the Romani alphabet, written in the Latin script.</li></ol>
K|k	<i>character</i><br><ol><li>(International Standard) The fourteenth letter of the Romani alphabet, written in the Latin script.</li><li>(Pan-Vlax) The fifteenth letter of the Romani alphabet, written in the Latin script.</li></ol>
Kh|kh	<i>character</i><br><ol><li>(International Standard) The fifteenth letter of the Romani alphabet, written in the Latin script.</li><li>(Pan-Vlax) The sixteenth letter of the Romani alphabet, written in the Latin script.</li></ol>
L|l	<i>character</i><br><ol><li>(International Standard) The sixteenth letter of the Romani alphabet, written in the Latin script.</li><li>(Pan-Vlax) The seventeenth letter of the Romani alphabet, written in the Latin script.</li></ol>
M|m	<i>character</i><br><ol><li>(International Standard) The seventeenth letter of the Romani alphabet, written in the Latin script.</li><li>(Pan-Vlax) The eighteenth letter of the Romani alphabet, written in the Latin script.</li></ol>
N|n	<i>character</i><br><ol><li>(International Standard) The eighteenth letter of the Romani alphabet, written in the Latin script.</li><li>(Pan-Vlax) The nineteenth letter of the Romani alphabet, written in the Latin script.</li></ol>
O|o	<i>character</i><br><ol><li>(International Standard) The nineteenth letter of the Romani alphabet, written in the Latin script.</li><li>(Pan-Vlax) The twentieth letter of the Romani alphabet, written in the Latin script.</li></ol>
P|p	<i>character</i><br><ol><li>(International Standard) The twentieth letter of the Romani alphabet, written in the Latin script.</li><li>(Pan-Vlax) The twenty-first letter of the Romani alphabet, written in the Latin script.</li></ol>
Patrin	<i>name</i><br><ol><li>an unknown-gender given name</li></ol>
Ph|ph	<i>character</i><br><ol><li>(International Standard) The twenty-first letter of the Romani alphabet, written in the Latin script.</li><li>(Pan-Vlax) The twenty-second letter of the Romani alphabet, written in the Latin script.</li></ol>
Porajmos	<i>name</i><br><ol><li>the Porajmos; the planned and attempted genocide of the Romani by National Socialist Germany</li></ol>
Q|q	<i>character</i><br><ol><li>(International Standard) Used to represent the dative and genitive cases.</li></ol>
R|r	<i>character</i><br><ol><li>(International Standard) The twenty-second letter of the Romani alphabet, written in the Latin script.</li><li>(Pan-Vlax) The twenty-third letter of the Romani alphabet, written in the Latin script.</li></ol>
Rr|rr	<i>character</i><br><ol><li>(International Standard) The twenty-third letter of the Romani alphabet, written in the Latin script.</li></ol>
Rumùnia|Rumuniya|i Rumùnia	<i>name</i><br><ol><li>(International Standard) Romania</li></ol>
S|s	<i>character</i><br><ol><li>(International Standard) The twenty-fourth letter of the Romani alphabet, written in the Latin script.</li><li>(Pan-Vlax) The twenty-fifth letter of the Romani alphabet, written in the Latin script.</li></ol>
Samudaripen	<i>name</i><br><ol><li>Synonym of Porajmos</li></ol>
T|t	<i>character</i><br><ol><li>(International Standard) The twenty-sixth letter of the Romani alphabet, written in the Latin script.</li><li>(Pan-Vlax) The twenty-seventh letter of the Romani alphabet, written in the Latin script.</li></ol>
Th|th	<i>character</i><br><ol><li>(International Standard) The twenty-seventh letter of the Romani alphabet, written in the Latin script.</li><li>(Pan-Vlax) The twenty-eighth letter of the Romani alphabet, written in the Latin script.</li></ol>
Trasta	<i>name</i><br><ol><li>an unknown-gender given name</li></ol>
U|u	<i>character</i><br><ol><li>(International Standard) The twenty-eighth letter of the Romani alphabet, written in the Latin script.</li><li>(Pan-Vlax) The twenty-ninth letter of the Romani alphabet, written in the Latin script.</li></ol>
V|v	<i>character</i><br><ol><li>(International Standard) The twenty-ninth letter of the Romani alphabet, written in the Latin script.</li><li>(Pan-Vlax) The thirtieth letter of the Romani alphabet, written in the Latin script.</li></ol>
W|w	<i>character</i><br><ol><li>A letter used to represent the voiced labial-velar approximant (/w/) in the International Standard orthography.</li></ol>
X|x	<i>character</i><br><ol><li>(International Standard) The eleventh letter of the Romani alphabet, written in the Latin script.</li><li>(Pan-Vlax) The twelfth letter of the Romani alphabet, written in the Latin script.</li></ol>
Z|z	<i>character</i><br><ol><li>(International Standard) The thirtieth letter of the Romani alphabet, written in the Latin script.</li><li>(Pan-Vlax) The thirty-first letter of the Romani alphabet, written in the Latin script.</li></ol>
a|A	<i>character</i><br><ol><li>The first letter of the Romani alphabet, written in the Latin script.</li></ol><br><i>intj</i><br><ol><li>oh, ah</li></ol>
ab	<i>noun</i><br><ol><li>river</li></ol>
abǎv	<i>noun</i><br><ol><li>(International Standard) Alternative form of biav</li></ol>
akhor|akhora	<i>noun</i><br><ol><li>walnut</li><li>nut</li></ol>
akhorin|akhorinǎ	<i>noun</i><br><ol><li>walnut (tree)</li></ol>
amal|amalen|amala|amales	<i>noun</i><br><ol><li>friend</li></ol>
amaro|amare|amari	<i>det</i><br><ol><li>our</li></ol><br><i>pron</i><br><ol><li>ours</li></ol>
ambrol|ambrola	<i>noun</i><br><ol><li>pear</li></ol>
ambrolin|ambrolinǎ	<i>noun</i><br><ol><li>pear (tree)</li></ol>
amen|ame	<i>pron</i><br><ol><li>we, us</li></ol>
ando|ande	<i>postp</i><br><ol><li>in</li></ol>
andre|āndre	<i>adv</i><br><ol><li>inside</li></ol>
angar|angara	<i>noun</i><br><ol><li>coal</li><li>charcoal</li></ol>
angla	<i>prep</i><br><ol><li>in front of, before</li></ol>
anglicko|anglicki	<i>adj</i><br><ol><li>English (of or pertaining to England, its people or language)</li></ol><br><i>noun</i><br><ol><li>English (language)</li></ol>
anglo|angle	<i>noun</i><br><ol><li>Englishman</li></ol>
anglojka	<i>noun</i><br><ol><li>Englishwoman</li></ol>
anro	<i>noun</i><br><ol><li>egg</li></ol>
arro|aře|ařo|aro|arre	<i>noun</i><br><ol><li>(International Standard) flour</li></ol>
asal|assal	<i>verb</i><br><ol><li>(intransitive) to laugh</li></ol>
ashunel	<i>verb</i><br><ol><li>Anglicized form of śunel</li></ol>
avel	<i>verb</i><br><ol><li>to come</li></ol>
aver|kaver	<i>adj</i><br><ol><li>other</li></ol>
aćh Devleça	<i>phrase</i><br><ol><li>(International Standard) goodbye, literally "stay with God" (said to the person remaining)</li></ol>
aćhel|ачел|acsel|ačel|aćh|aćhen|ačhel	<i>verb</i><br><ol><li>to stay</li><li>to remain</li></ol>
aćhen Devleça	<i>phrase</i><br><ol><li>(International Standard) goodbye, literally "stay with God" (said to those remaining)</li></ol>
b|B	<i>character</i><br><ol><li>The second letter of the Romani alphabet, written in the Latin script.</li></ol>
bakro|bakrěn|bakres|bakrǎ|bakri|bakre|bakren	<i>noun</i><br><ol><li>sheep</li></ol>
bal|bala	<i>noun</i><br><ol><li>a single hair</li><li>(in the plural) hair</li></ol>
balo|bale	<i>noun</i><br><ol><li>pig</li></ol>
balval|balvalǎ|balvala	<i>noun</i><br><ol><li>wind</li></ol>
bar|barǎ|bara	<i>noun</i><br><ol><li>enclosure</li></ol>
baramda	<i>noun</i><br><ol><li>verandah</li></ol>
barari|barara	<i>noun</i><br><ol><li>gardener, horticulturist</li></ol>
baro|bari|bare	<i>adj</i><br><ol><li>big</li></ol>
baro pani|bare panǎ|bare paja|baro paji	<i>noun</i><br><ol><li>lake</li><li>sea</li></ol>
barr|bar|bara|barra	<i>noun</i><br><ol><li>(International Standard) stone, rock</li></ol>
barvalo|barvale|barvali	<i>adj</i><br><ol><li>rich</li></ol>
baxt|baxtya|baxtǎ	<i>noun</i><br><ol><li>luck</li><li>happiness</li></ol>
baxtalo|baxtali|baxtale	<i>adj</i><br><ol><li>lucky</li><li>happy</li></ol>
beng|benges|bengen|benga	<i>noun</i><br><ol><li>(theology) devil</li></ol>
bersh|bersha	<i>noun</i><br><ol><li>Anglicized form of berś (“year”)</li></ol>
berś|berš|berša|berśa	<i>noun</i><br><ol><li>(International Standard) year</li></ol>
beśel|beshel	<i>verb</i><br><ol><li>to dwell, live</li><li>to sit</li></ol>
biav|abav|bijav|biava	<i>noun</i><br><ol><li>wedding</li></ol>
bibi|bibǎ	<i>noun</i><br><ol><li>aunt</li></ol>
bikinel	<i>verb</i><br><ol><li>(transitive) to sell</li></ol>
biś	<i>num</i><br><ol><li>(International Standard) twenty</li></ol>
bokh|bokha	<i>noun</i><br><ol><li>hunger (need for food)</li></ol>
bokoli	<i>noun</i><br><ol><li>cake,</li><li>ring-shaped bread</li><li>round flat bread, pancake bread</li></ol>
boldel	<i>verb</i><br><ol><li>to turn</li></ol>
bongo|bonge|bongi	<i>adj</i><br><ol><li>left</li></ol>
bori|borǎ	<i>noun</i><br><ol><li>bride, newly-wed woman</li><li>daughter-in-law</li><li>sister-in-law</li></ol>
bosh	<i>noun</i><br><ol><li>fiddle</li></ol>
bov|bova	<i>noun</i><br><ol><li>oven, stove</li></ol>
brishind|brishinda	<i>noun</i><br><ol><li>Anglicized form of briśind</li></ol>
briśind|briśinda	<i>noun</i><br><ol><li>(International Standard) rain</li></ol>
briśindali|briśindalǎ|brishindalya|brishindalyi	<i>noun</i><br><ol><li>(International Standard) umbrella</li></ol>
buko	<i>noun</i><br><ol><li>liver</li><li>lung</li></ol>
bul|bulya	<i>noun</i><br><ol><li>buttocks</li></ol>
but|bute	<i>adj</i><br><ol><li>much</li><li>many</li></ol><br><i>adv</i><br><ol><li>very</li></ol>
butyi|butya	<i>noun</i><br><ol><li>Anglicized form of butǐ (“work”)</li></ol>
butyi kerel	<i>verb</i><br><ol><li>to work</li></ol>
butǐ|butǎ	<i>noun</i><br><ol><li>work</li><li>matter</li></ol>
buxlo|buxle|buxli|bulyho|bulyhi|bulyhe	<i>adj</i><br><ol><li>wide</li></ol>
búrnek|burnek	<i>noun</i><br><ol><li>a handful.</li></ol>
bǎv	<i>noun</i><br><ol><li>(International Standard) Alternative form of biav</li></ol>
c|C	<i>character</i><br><ol><li>The third letter of the Romani alphabet, written in the Latin script.</li></ol>
cerra	<i>adj</i><br><ol><li>few</li></ol>
chacho|chache|chachi	<i>adj</i><br><ol><li>Anglicized form of ćaćo (“right; correct; straight”)</li></ol>
chalavel	<i>verb</i><br><ol><li>to hit</li></ol>
chang|changa	<i>noun</i><br><ol><li>(anatomy) leg</li><li>knee</li></ol>
char|chara	<i>noun</i><br><ol><li>Anglicized form of ćar</li></ol>
chavo|chave	<i>noun</i><br><ol><li>Anglicized form of ćhavo</li></ol>
chavorro|chavorre	<i>noun</i><br><ol><li>Anglicized form of ćhavorro</li></ol>
cheri|chera	<i>noun</i><br><ol><li>sky</li></ol>
chiriklyi|chiriklya	<i>noun</i><br><ol><li>Anglicized form of ćirikli (“bird”)</li></ol>
chorel	<i>verb</i><br><ol><li>Anglicized form of ćorel</li></ol>
chorro|chorre|chorri	<i>adj</i><br><ol><li>Anglicized form of ćorro</li></ol>
chuchi|chucha	<i>noun</i><br><ol><li>Anglicized form of ćući</li></ol>
chuchi del	<i>verb</i><br><ol><li>to breastfeed, nurse, suckle</li></ol>
chuchi pel	<i>verb</i><br><ol><li>to suck</li></ol>
chumi	<i>noun</i><br><ol><li>Anglicized form of ćumi (“kiss”)</li></ol>
chumid|chumida	<i>noun</i><br><ol><li>kiss</li></ol>
chumidel	<i>verb</i><br><ol><li>Anglicized form of ćumidel (“to kiss”)</li></ol>
cirdel	<i>verb</i><br><ol><li>to pull</li></ol>
d|D	<i>character</i><br><ol><li>The sixth letter of the Romani alphabet, written in the Latin script.</li></ol>
dad|dada|daden|dades	<i>noun</i><br><ol><li>father</li></ol>
dade	<i>noun</i><br><ol><li>Dolenjski form of dad (“father”)</li></ol>
daj|daja	<i>noun</i><br><ol><li>mother</li></ol>
dand|danda	<i>noun</i><br><ol><li>tooth</li></ol>
dar	<i>noun</i><br><ol><li>fear</li></ol>
daral	<i>verb</i><br><ol><li>to fear</li><li>to be afraid</li><li>he fears</li></ol>
del|devla|devlen|devles	<i>verb</i><br><ol><li>to give</li></ol>
desh	<i>num</i><br><ol><li>Anglicized form of deś (“ten”)</li></ol>
devel|devla|devlen|devles|del	<i>noun</i><br><ol><li>god</li><li>sky</li><li>heaven</li></ol>
deś|deš	<i>num</i><br><ol><li>(International Standard) ten</li></ol>
deśuduj	<i>num</i><br><ol><li>(International Standard) twelve</li></ol>
deśujekh|dešujekh	<i>num</i><br><ol><li>(International Standard) eleven</li></ol>
didandel	<i>verb</i><br><ol><li>to bite</li></ol>
dikhel	<i>verb</i><br><ol><li>to see</li></ol>
dilo|dili|dile	<i>adj</i><br><ol><li>mad, crazy, insane</li></ol>
dives|divesa|dyes	<i>noun</i><br><ol><li>day</li></ol>
diz|dizǎ|dyiz|dyiza	<i>noun</i><br><ol><li>town, city</li><li>castle</li></ol>
dobroj tumen	<i>phrase</i><br><ol><li>good day (said to two or more people)</li></ol>
dobroj tut	<i>phrase</i><br><ol><li>good day (said to one person)</li></ol>
dorija	<i>noun</i><br><ol><li>river</li></ol>
drab	<i>noun</i><br><ol><li>medicine</li><li>root</li></ol>
drabarni|drabarnǎ	<i>noun</i><br><ol><li>witch</li><li>female reader</li></ol>
drago|dragi	<i>adj</i><br><ol><li>dear</li></ol>
drakh|drakha	<i>noun</i><br><ol><li>grape</li><li>grapes, bunch of grapes</li></ol>
drom|droma|dromença	<i>noun</i><br><ol><li>way, road</li></ol>
dudum|duduma	<i>noun</i><br><ol><li>pumpkin, (marrow) squash</li></ol>
duj	<i>num</i><br><ol><li>two</li></ol>
dukh|dukha	<i>noun</i><br><ol><li>pain</li><li>ache</li></ol>
dumo|dume	<i>noun</i><br><ol><li>back (body part)</li><li>shoulder</li></ol>
dur	<i>adv</i><br><ol><li>far</li></ol>
děs|děsa	<i>noun</i><br><ol><li>(International Standard) Alternative form of dives</li></ol>
dž|Dž	<i>character</i><br><ol><li>(Pan-Vlax) The seventh letter of the Romani alphabet, written in the Latin script.</li></ol>
dǐves|dǐvesa	<i>noun</i><br><ol><li>(International Standard) Alternative form of dives (“day”)</li></ol>
e|E	<i>character</i><br><ol><li>(International Standard) The seventh letter of the Romani alphabet, written in the Latin script.</li><li>(Pan-Vlax) The eighth letter of the Romani alphabet, written in the Latin script.</li></ol>
efta	<i>num</i><br><ol><li>seven</li></ol>
enia|inja	<i>num</i><br><ol><li>(International Standard) nine</li></ol>
enǎ	<i>num</i><br><ol><li>(International Standard) Alternative form of enia (“nine”)</li></ol>
f|F	<i>character</i><br><ol><li>(International Standard) The eighth letter of the Romani alphabet, written in the Latin script.</li><li>(Pan-Vlax) The ninth letter of the Romani alphabet, written in the Latin script.</li></ol>
fal man miśto	<i>phrase</i><br><ol><li>(International Standard) pleased to meet you</li></ol>
falka|falki	<i>noun</i><br><ol><li>chin</li></ol>
falkono|falkone	<i>noun</i><br><ol><li>falcon (bird)</li></ol>
famìlia|familije|famìlie|familija	<i>noun</i><br><ol><li>(International Standard) family</li></ol>
felǎstra|felyastra|felǎstri|felyastri	<i>noun</i><br><ol><li>window</li></ol>
foni	<i>noun</i><br><ol><li>ring</li></ol>
fujeri	<i>noun</i><br><ol><li>leg</li></ol>
fòros|fòrurǎ	<i>noun</i><br><ol><li>(International Standard) town</li></ol>
g|G	<i>character</i><br><ol><li>(International Standard) The ninth letter of the Romani alphabet, written in the Latin script.</li><li>(Pan-Vlax) The tenth letter of the Romani alphabet, written in the Latin script.</li></ol>
gav|gava	<i>noun</i><br><ol><li>village</li></ol>
gaʒikano|gaʒikani|gaʒikane	<i>adj</i><br><ol><li>(International Standard) non-Romani</li></ol>
gaʒo|gaʒes|gadjo|gadži|gadje|gaʒe|gaʒi|gaʒen|gadže|gaʒǎ|gadžo|gadji|gadja	<i>noun</i><br><ol><li>(International Standard) gadje (non-Romani) man</li></ol>
gemula	<i>noun</i><br><ol><li>camel</li></ol>
gili|gilǎ|gilya|gilyi	<i>noun</i><br><ol><li>song</li></ol>
gilyabel	<i>verb</i><br><ol><li>to sing</li></ol>
ginadyi|ginadya	<i>noun</i><br><ol><li>book</li></ol>
ginavel	<i>verb</i><br><ol><li>to count</li><li>to read</li></ol>
giv|giva	<i>noun</i><br><ol><li>wheat</li></ol>
glàso	<i>noun</i><br><ol><li>(International Standard) voice</li></ol>
grasni|grasněn|grasnǎ	<i>noun</i><br><ol><li>mare</li></ol>
grast|grasten|grastes|grasta|grajes|graj|graja|grajen	<i>noun</i><br><ol><li>horse</li></ol>
gudlo|gudle|gudli	<i>adj</i><br><ol><li>sweet</li></ol>
gurumni	<i>noun</i><br><ol><li>cow</li></ol>
guruv|guruves|guruva|guruven	<i>noun</i><br><ol><li>ox</li><li>bull</li></ol>
h|H	<i>character</i><br><ol><li>(International Standard) The tenth letter of the Romani alphabet, written in the Latin script.</li><li>(Pan-Vlax) The eleventh letter of the Romani alphabet, written in the Latin script.</li></ol>
hanavel|hunavel	<i>verb</i><br><ol><li>to dig</li></ol>
hilpa|hilpi	<i>noun</i><br><ol><li>fox</li></ol>
hirč	<i>noun</i><br><ol><li>bear</li></ol>
hudel	<i>verb</i><br><ol><li>to catch, grab, snatch</li></ol>
i|e|I|o	<i>character</i><br><ol><li>(International Standard) The twelfth letter of the Romani alphabet, written in the Latin script.</li><li>(Pan-Vlax) The thirteenth letter of the Romani alphabet, written in the Latin script.</li></ol><br><i>article</i><br><ol><li>the; feminine singular definite article</li></ol>
ilo|ile|jile|jilo	<i>noun</i><br><ol><li>(anatomy) heart</li></ol>
iv|jiva|iva|jiv	<i>noun</i><br><ol><li>snow</li></ol>
ivend|ivenda|jivend	<i>noun</i><br><ol><li>winter</li></ol>
j|J	<i>character</i><br><ol><li>(International Standard) The thirteenth letter of the Romani alphabet, written in the Latin script.</li><li>(Pan-Vlax) The fourteenth letter of the Romani alphabet, written in the Latin script.</li></ol>
jag|jaga	<i>noun</i><br><ol><li>fire</li></ol>
jakh|jakha	<i>noun</i><br><ol><li>eye</li></ol>
jekh|ekh	<i>num</i><br><ol><li>one</li></ol>
k|K	<i>character</i><br><ol><li>(International Standard) The fourteenth letter of the Romani alphabet, written in the Latin script.</li><li>(Pan-Vlax) The fifteenth letter of the Romani alphabet, written in the Latin script.</li></ol>
kado|kadi	<i>pron</i><br><ol><li>this</li></ol>
kaj	<i>adv</i><br><ol><li>where? (interrogative)</li></ol>
kak|kaka|kako	<i>noun</i><br><ol><li>uncle</li></ol>
kalo|kale|kali	<i>adj</i><br><ol><li>black</li></ol>
kamel	<i>verb</i><br><ol><li>to love</li><li>to want</li></ol>
kan|kana	<i>noun</i><br><ol><li>ear</li></ol>
kana	<i>adv</i><br><ol><li>when</li></ol>
kangli|kanglǎ	<i>noun</i><br><ol><li>comb</li></ol>
kar	<i>noun</i><br><ol><li>penis</li></ol>
kat|katǎ	<i>noun</i><br><ol><li>scissors</li></ol>
kathe	<i>adv</i><br><ol><li>here</li></ol>
kaśt|kashta|kaśta|kasht	<i>noun</i><br><ol><li>(International Standard) wood</li><li>tree</li></ol>
ke	<i>conj</i><br><ol><li>because</li></ol>
kerel	<i>verb</i><br><ol><li>to do</li><li>to make, create, produce</li></ol>
kerno|kerni|kerne	<i>adj</i><br><ol><li>rotten</li></ol>
kesi	<i>noun</i><br><ol><li>pouch</li></ol>
kh|Kh	<i>character</i><br><ol><li>(International Standard) The fifteenth letter of the Romani alphabet, written in the Latin script.</li><li>(Pan-Vlax) The sixteenth letter of the Romani alphabet, written in the Latin script.</li></ol>
khak|thaka|khaka|thak	<i>noun</i><br><ol><li>armpit</li></ol>
kham|khama	<i>noun</i><br><ol><li>sun</li></ol>
khangeri|khangerǎ	<i>noun</i><br><ol><li>church, mosque, temple</li></ol>
khelel	<i>verb</i><br><ol><li>to play</li><li>to dance</li></ol>
kher|khera	<i>noun</i><br><ol><li>house</li></ol>
khere	<i>adv</i><br><ol><li>home, at home</li></ol>
khil|khila	<i>noun</i><br><ol><li>butter</li></ol>
khino|khine|khini	<i>adj</i><br><ol><li>tired</li></ol>
khor	<i>adj</i><br><ol><li>deep</li></ol>
khosel	<i>verb</i><br><ol><li>to wipe</li></ol>
khuro|khure|khuren|khures	<i>noun</i><br><ol><li>foal, colt</li></ol>
kikidel	<i>verb</i><br><ol><li>to squeeze</li></ol>
kilka|kilki	<i>noun</i><br><ol><li>bun (hairstyle)</li></ol>
kilo|kile	<i>noun</i><br><ol><li>stake</li></ol>
kindyilo|kindyili|kindyile	<i>adj</i><br><ol><li>wet</li></ol>
kinel	<i>verb</i><br><ol><li>(transitive) to buy</li></ol>
kingo|kinge|kingi	<i>adj</i><br><ol><li>wet</li></ol>
kináva|kinava	<i>verb</i><br><ol><li>to buy</li></ol>
kir	<i>noun</i><br><ol><li>ant</li></ol>
kiral|kirala	<i>noun</i><br><ol><li>cheese</li></ol>
kirmo|kirme|kermo	<i>noun</i><br><ol><li>worm</li></ol>
kiśaj|kishaja|kiśaja|kishaj	<i>noun</i><br><ol><li>(International Standard) sand</li></ol>
kodo|kodi	<i>pron</i><br><ol><li>that</li></ol>
kon|kas	<i>pron</i><br><ol><li>who? (interrogative)</li></ol>
kopal	<i>noun</i><br><ol><li>mallet</li><li>(washerwoman's) beetle</li></ol>
korca	<i>noun</i><br><ol><li>bark</li></ol>
korkoro|korkori|korkore	<i>adv</i><br><ol><li>alone, by oneself, on one's own</li></ol>
korr|korra|korrǎ	<i>noun</i><br><ol><li>neck</li></ol>
korrijakh|korrijakha	<i>noun</i><br><ol><li>(anatomy) temple</li></ol>
kotor|kotora	<i>noun</i><br><ol><li>piece</li></ol>
kris|krisa	<i>noun</i><br><ol><li>(law) trial</li></ol>
kurko|kurke	<i>noun</i><br><ol><li>Sunday</li><li>week</li></ol>
kòkalo|kòkala|kokalo|kokala	<i>noun</i><br><ol><li>(International Standard) bone</li></ol>
l|L	<i>character</i><br><ol><li>(International Standard) The sixteenth letter of the Romani alphabet, written in the Latin script.</li><li>(Pan-Vlax) The seventeenth letter of the Romani alphabet, written in the Latin script.</li></ol>
lasharel	<i>verb</i><br><ol><li>to repair</li></ol>
laćhi rǎt	<i>phrase</i><br><ol><li>(International Standard) good evening</li></ol>
laćhi texarin	<i>phrase</i><br><ol><li>(International Standard) good morning</li></ol>
laćho|laćhi|laćhe|feder	<i>adj</i><br><ol><li>(International Standard) good, right, nice</li></ol>
laćho dǐves	<i>phrase</i><br><ol><li>(International Standard) good day</li></ol>
lačho|lačhe|lačhi	<i>adj</i><br><ol><li>Pan-Vlax form of laćho (“good”)</li></ol>
laʒ|ladž|laʒa	<i>noun</i><br><ol><li>(International Standard) shame</li></ol>
len	<i>noun</i><br><ol><li>river</li></ol>
loko|lokó	<i>adj</i><br><ol><li>light, not heavy</li><li>light, upbeat</li></ol><br><i>adv</i><br><ol><li>a little, a bit, quietly</li></ol>
lolo|loli|lole	<i>adj</i><br><ol><li>red</li></ol>
lon	<i>noun</i><br><ol><li>salt</li></ol>
love	<i>noun</i><br><ol><li>money</li></ol>
lovo|love	<i>noun</i><br><ol><li>coin</li><li>(in the plural) money</li></ol>
luj|luja	<i>noun</i><br><ol><li>Monday</li></ol>
luludǎrel|luludyarel	<i>verb</i><br><ol><li>(International Standard) to make a flower blossom</li></ol>
luludǐ|luludya|luludyi|luludǎ	<i>noun</i><br><ol><li>(International Standard) flower</li></ol>
luludǒl|luludyol	<i>verb</i><br><ol><li>(International Standard) to blossom, to flourish</li></ol>
lyivinel	<i>verb</i><br><ol><li>to shoot, fire, shoot down, shoot dead</li></ol>
lùja|lùje	<i>noun</i><br><ol><li>(International Standard) Alternative form of luj</li></ol>
m|M	<i>character</i><br><ol><li>(International Standard) The seventeenth letter of the Romani alphabet, written in the Latin script.</li><li>(Pan-Vlax) The eighteenth letter of the Romani alphabet, written in the Latin script.</li></ol>
ma	<i>particle</i><br><ol><li>don't (prohibitive particle)</li></ol>
mach	<i>noun</i><br><ol><li>fly (insect)</li></ol>
magočka|magočki|mogočka|mogočki	<i>noun</i><br><ol><li>(botany) seed</li></ol>
mamux|mamúx|mamuxa	<i>noun</i><br><ol><li>sloe</li></ol>
mangel	<i>verb</i><br><ol><li>to ask for</li><li>to beg</li></ol>
manro|manre	<i>noun</i><br><ol><li>bread</li></ol>
manush|manusha	<i>noun</i><br><ol><li>Anglicized form of manuś</li></ol>
manuś|manuśen|manuśes|manušni|manuśni|manushni|manuśa	<i>noun</i><br><ol><li>(International Standard) man (human)</li></ol>
manuš|manuša	<i>noun</i><br><ol><li>Pan-Vlax form of manuś</li></ol>
marel	<i>verb</i><br><ol><li>to beat</li><li>to fight</li></ol>
martǐ|martǎ|marca|marci	<i>noun</i><br><ol><li>(International Standard) Tuesday</li></ol>
mas|masa	<i>noun</i><br><ol><li>meat</li></ol>
mashkar|mashkara	<i>noun</i><br><ol><li>waist</li></ol><br><i>prep</i><br><ol><li>between, in the middle</li></ol>
maski	<i>noun</i><br><ol><li>skin</li></ol>
maćho|maćhe	<i>noun</i><br><ol><li>fish</li><li>muscle</li></ol>
me|mança|man	<i>pron</i><br><ol><li>I</li></ol>
me sem rrom	<i>phrase</i><br><ol><li>I am Romani (male)</li></ol>
me sem rromni	<i>phrase</i><br><ol><li>I am Romani (female)</li></ol>
melalo|melali|melale	<i>adj</i><br><ol><li>dirty</li></ol>
merel	<i>verb</i><br><ol><li>to die</li><li>to love passionately</li></ol>
mesèli|mesalya|mesèlǎ|mesalyi	<i>noun</i><br><ol><li>table</li></ol>
milaj|milaja	<i>noun</i><br><ol><li>summer</li></ol>
minʒ|mizh|minʒa|mizha	<i>noun</i><br><ol><li>vagina</li><li>vulva</li></ol>
miro|mirri|mire|mirre|muro|miri|mirro	<i>det</i><br><ol><li>my</li></ol>
mirro nav si	<i>phrase</i><br><ol><li>my name is</li></ol>
miśto	<i>adv</i><br><ol><li>(International Standard) well</li></ol><br><i>phrase</i><br><ol><li>(International Standard) I'm fine</li></ol>
miśto avile	<i>intj</i><br><ol><li>(International Standard) welcome (greeting multiple people)</li></ol>
miśto avilǎn	<i>intj</i><br><ol><li>(International Standard) welcome (greeting a single person)</li></ol>
mišto	<i>adv</i><br><ol><li>Pan-Vlax form of miśto (“well”)</li></ol><br><i>phrase</i><br><ol><li>Pan-Vlax form of miśto (“I'm fine”)</li></ol>
morthǐ|morcha|morchi	<i>noun</i><br><ol><li>(International Standard) skin</li></ol>
mudarel	<i>verb</i><br><ol><li>to kill</li><li>to murder</li><li>to terminate (a contract, etc)</li><li>to turn off (an appliance), extinguish (a flame)</li><li>to finish off (the last of some food, etc)</li><li>to wear out (a tire, etc)</li><li>to defeat (a purpose)</li><li>to put out of business</li><li>to pass or kill (time)</li><li>(figuratively) to impress (someone), to blow away</li></ol>
muglya	<i>noun</i><br><ol><li>fog</li></ol>
muj|muja	<i>noun</i><br><ol><li>mouth</li><li>face</li></ol>
mulo|mule|muli	<i>adj</i><br><ol><li>dead, deceased</li></ol><br><i>noun</i><br><ol><li>dead person, the deceased</li><li>(folklore) ghost</li></ol>
mursh|mursha	<i>noun</i><br><ol><li>Anglicized form of murś (“man”)</li></ol>
murś|murśa	<i>noun</i><br><ol><li>(International Standard) man (regardless of whether he is Romani or not)</li></ol>
murš|murša	<i>noun</i><br><ol><li>Pan-Vlax form of murś (“man (regardless of whether he is Romani or not)”)</li></ol>
muter|mutra|mutera	<i>noun</i><br><ol><li>urine</li></ol>
mutrel	<i>verb</i><br><ol><li>to urinate</li></ol>
mùca	<i>noun</i><br><ol><li>(International Standard) cat</li></ol>
n|N	<i>character</i><br><ol><li>(International Standard) The eighteenth letter of the Romani alphabet, written in the Latin script.</li><li>(Pan-Vlax) The nineteenth letter of the Romani alphabet, written in the Latin script.</li></ol>
na	<i>adv</i><br><ol><li>not</li></ol><br><i>intj</i><br><ol><li>right?; tag question</li></ol><br><i>particle</i><br><ol><li>no</li></ol>
na-i sosqe	<i>phrase</i><br><ol><li>(International Standard) you're welcome</li></ol>
nais tumenqe	<i>phrase</i><br><ol><li>(International Standard) thank you (to more than one person)</li></ol>
nais tuqe	<i>phrase</i><br><ol><li>(International Standard) thank you (to one person)</li></ol>
naj|naja	<i>noun</i><br><ol><li>finger</li></ol>
nakh|nakha	<i>noun</i><br><ol><li>nose</li></ol>
nalaćho|nalačho|nalache|nalachi|nalacho|nalaćhe|nalačhe|nalačhi|nalaćhi	<i>adj</i><br><ol><li>(International Standard) bad</li></ol>
nasul|nasule	<i>adj</i><br><ol><li>bad, evil</li></ol>
nasvalo	<i>adj</i><br><ol><li>ill, sick</li></ol>
nav|anava|nava|anav	<i>noun</i><br><ol><li>name</li></ol>
naśel|našel	<i>verb</i><br><ol><li>(intransitive, International Standard) to run away, to flee</li></ol>
nevo|nevi|neve	<i>adj</i><br><ol><li>new</li></ol>
noro|norura	<i>noun</i><br><ol><li>cloud</li></ol>
o|e|O|i	<i>character</i><br><ol><li>(International Standard) The nineteenth letter of the Romani alphabet, written in the Latin script.</li><li>(Pan-Vlax) The twentieth letter of the Romani alphabet, written in the Latin script.</li></ol><br><i>article</i><br><ol><li>the</li></ol>
oblo|obli	<i>adj</i><br><ol><li>round</li></ol>
ogi|ogǎ	<i>noun</i><br><ol><li>soul, spirit</li><li>breath</li></ol>
oj	<i>pron</i><br><ol><li>she</li></ol>
on	<i>pron</i><br><ol><li>they</li></ol>
ov	<i>pron</i><br><ol><li>he</li></ol>
oxto	<i>num</i><br><ol><li>eight</li></ol>
p|P	<i>character</i><br><ol><li>(International Standard) The twentieth letter of the Romani alphabet, written in the Latin script.</li><li>(Pan-Vlax) The twenty-first letter of the Romani alphabet, written in the Latin script.</li></ol>
paho	<i>noun</i><br><ol><li>ice</li></ol>
pahosajvel	<i>verb</i><br><ol><li>to freeze</li></ol>
palikerav tumenqe	<i>phrase</i><br><ol><li>(International Standard) thank you (to more than one person)</li></ol>
palikerav tuqe	<i>phrase</i><br><ol><li>(International Standard) thank you (to one person)</li></ol>
pandž	<i>num</i><br><ol><li>Pan-Vlax form of panʒ (“five”)</li></ol>
pani|panǎ	<i>noun</i><br><ol><li>water</li></ol>
panzh	<i>num</i><br><ol><li>Anglicized form of panʒ (“five”)</li></ol>
panʒ	<i>num</i><br><ol><li>(International Standard) five</li></ol>
papuka|papuchi	<i>noun</i><br><ol><li>shoe</li></ol>
paramìsi|paramìsǎ	<i>noun</i><br><ol><li>(International Standard) story, (fairy/folk) tale</li></ol>
paraven|paravén	<i>noun</i><br><ol><li>greeting, salute; salutation</li></ol>
paraśtuj|parashtuja|parashtuj|paraśtuja	<i>noun</i><br><ol><li>(International Standard) Friday</li></ol>
parno|parni|parne	<i>adj</i><br><ol><li>white</li></ol>
pashe	<i>adv</i><br><ol><li>near</li></ol>
pashlyol	<i>verb</i><br><ol><li>to lie</li></ol>
pato|patura	<i>noun</i><br><ol><li>bed</li></ol>
patrin|pajtra|patra|patrinǎ	<i>noun</i><br><ol><li>leaf</li></ol>
patǐv|patǐva|pativ|patǐvǎ	<i>noun</i><br><ol><li>(International Standard) honesty, honor</li></ol>
pedo|peda	<i>noun</i><br><ol><li>animal</li></ol>
pel	<i>verb</i><br><ol><li>to drink</li></ol>
pen	<i>pron</i><br><ol><li>themselves (third-person plural reflexive pronoun)</li></ol>
per|pir|pera	<i>noun</i><br><ol><li>(anatomy) abdomen, belly</li></ol>
perel	<i>verb</i><br><ol><li>to fall</li></ol>
pes	<i>pron</i><br><ol><li>himself, herself (third-person singular reflexive pronoun)</li></ol>
ph|Ph	<i>character</i><br><ol><li>(International Standard) The twenty-first letter of the Romani alphabet, written in the Latin script.</li><li>(Pan-Vlax) The twenty-second letter of the Romani alphabet, written in the Latin script.</li></ol>
phabaj|phaba|phabaja	<i>noun</i><br><ol><li>apple</li></ol>
phabalin|phabajina|phabalinǎ|phabajin	<i>noun</i><br><ol><li>apple tree</li></ol>
phabol	<i>verb</i><br><ol><li>(intransitive) to burn</li></ol>
phakh|phak|phaka	<i>noun</i><br><ol><li>wing</li></ol>
phandel	<i>verb</i><br><ol><li>to tie</li></ol>
pharo|phari|phare	<i>adj</i><br><ol><li>heavy</li></ol>
pharravel	<i>verb</i><br><ol><li>to split</li></ol>
phen|phenya|pheněn|phenǎ|pheny	<i>noun</i><br><ol><li>sister</li></ol>
phenel	<i>verb</i><br><ol><li>to say, to tell</li></ol>
pherdo|pherde|pherdi	<i>adj</i><br><ol><li>full</li></ol>
phiko|phike	<i>noun</i><br><ol><li>shoulder</li></ol>
phirel	<i>verb</i><br><ol><li>to walk</li><li>he/she walks</li></ol>
phral|plural phralen|plural phrala|phrales|phrala	<i>noun</i><br><ol><li>brother</li></ol>
phreny	<i>noun</i><br><ol><li>sister</li></ol>
phurdel	<i>verb</i><br><ol><li>to blow</li></ol>
phuro|phure|phureder|phuri	<i>adj</i><br><ol><li>old (animate)</li></ol><br><i>noun</i><br><ol><li>old man</li></ol>
phuv|phuva|phuvǎ	<i>noun</i><br><ol><li>earth</li></ol>
pijel	<i>verb</i><br><ol><li>to drink</li></ol>
pindro|pindre	<i>noun</i><br><ol><li>foot, sole</li></ol>
piramno|piramnya|piramnes|piramnen|piramne|piramni|piramnyi|piramnǎ|piramněn	<i>noun</i><br><ol><li>boyfriend, lover</li></ol>
pizdel	<i>verb</i><br><ol><li>to push</li></ol>
plaj	<i>noun</i><br><ol><li>mountain</li></ol>
plemel	<i>verb</i><br><ol><li>to swim, to float</li></ol>
por|por{{{4}}}	<i>noun</i><br><ol><li>feather</li></ol>
pori|puri	<i>noun</i><br><ol><li>tail</li><li>entrails, bowels</li></ol>
poriá|poria	<i>noun</i><br><ol><li>(Spanish Romani) Synonym of per (“belly, abdomen”)</li></ol>
porr|porra|porrǎ	<i>noun</i><br><ol><li>bowel, intestine</li></ol>
posh	<i>noun</i><br><ol><li>dust</li></ol>
poshík|poshik	<i>noun</i><br><ol><li>earth</li></ol>
praho	<i>noun</i><br><ol><li>dust</li></ol>
primavara|primavari	<i>noun</i><br><ol><li>spring</li></ol>
punro|punre	<i>noun</i><br><ol><li>(anatomy) foot</li></ol>
purano|purani|phurani|phurane|phurano|purane	<i>adj</i><br><ol><li>old (inanimate)</li></ol>
pusavel	<i>verb</i><br><ol><li>to stab</li></ol>
q|Q	<i>character</i><br><ol><li>(International Standard) Used to represent the dative and genitive cases.</li></ol>
r|R	<i>character</i><br><ol><li>(International Standard) The twenty-second letter of the Romani alphabet, written in the Latin script.</li><li>(Pan-Vlax) The twenty-third letter of the Romani alphabet, written in the Latin script.</li></ol>
raj|rajni|raji|rani|rajnǎ|ranǎ|raněn|raja	<i>noun</i><br><ol><li>lord, master</li><li>gentleman, Sir, Mr</li></ol>
rajo|rajura	<i>noun</i><br><ol><li>heaven</li><li>paradise</li></ol>
raklo|rakle|raklen|raklyi|rakles|rakli|raklǎ|raklya	<i>noun</i><br><ol><li>gadje (non-Romani) boy</li></ol>
rang	<i>noun</i><br><ol><li>colour</li></ol>
rashaj|rashaja	<i>noun</i><br><ol><li>Anglicized form of raśaj (“priest”)</li></ol>
rat|ratyi|ratǎ|rata|ratya	<i>noun</i><br><ol><li>blood</li><li>night</li></ol>
raśaj|raśajen|raśajes|raśaja	<i>noun</i><br><ol><li>(International Standard) priest</li></ol>
rašaj|rašaja	<i>noun</i><br><ol><li>Pan-Vlax form of raśaj (“priest”)</li></ol>
rikono|rikone	<i>noun</i><br><ol><li>puppy</li></ol>
rotya|rotyi	<i>noun</i><br><ol><li>skirt</li></ol>
rozavo|rozavi	<i>adj</i><br><ol><li>pink</li></ol>
rr|Rr	<i>character</i><br><ol><li>(International Standard) The twenty-third letter of the Romani alphabet, written in the Latin script.</li></ol>
rroj|rroja	<i>noun</i><br><ol><li>spoon</li></ol>
rrom|rromes|řom|rromença|řoma|rromen|rom|roma|rroma|rroma!len|rromenqo|rromesθe	<i>noun</i><br><ol><li>Romani man</li><li>husband</li></ol>
rromanes|romanes|řomanes	<i>adv</i><br><ol><li>in the Romani way</li><li>in the Romani language</li></ol>
rromani ćhib	<i>noun</i><br><ol><li>(International Standard) Romani language</li></ol>
rromanipen|rromanimàta	<i>noun</i><br><ol><li>(International Standard) The quality, state or characteristic of being Romani.</li></ol>
rromano|romani|rromani|romano|rromane|romane	<i>adj</i><br><ol><li>(International Standard) Romani</li></ol>
rromni|řomnja|romni|rromnǎ|řomňa|rromněn|romnya|romnyi|řomni	<i>noun</i><br><ol><li>Romani woman</li><li>wife</li></ol>
rròta|roti|rròte|rota	<i>noun</i><br><ol><li>(International Standard) wheel</li></ol>
rukh|rukha	<i>noun</i><br><ol><li>tree</li></ol>
rup|rupa	<i>noun</i><br><ol><li>silver (metal)</li></ol>
rupalo|rupali|rupale	<i>adj</i><br><ol><li>silvery</li></ol>
rupuno|rupuni|rupune	<i>adj</i><br><ol><li>silver (made of silver)</li></ol><br><i>noun</i><br><ol><li>silver coin</li></ol>
ruv|ruvni|ruvnyi|ruvnǎ|ruva|ruvnya	<i>noun</i><br><ol><li>wolf</li></ol>
rǎt|rǎtǎ	<i>noun</i><br><ol><li>(International Standard) Alternative form of rat (“night”)</li></ol>
s|S	<i>character</i><br><ol><li>(International Standard) The twenty-fourth letter of the Romani alphabet, written in the Latin script.</li><li>(Pan-Vlax) The twenty-fifth letter of the Romani alphabet, written in the Latin script.</li></ol>
sa	<i>pron</i><br><ol><li>all</li></ol>
sako|sake|saki	<i>adj</i><br><ol><li>every</li></ol>
samtalo|samtale|samtali	<i>adj</i><br><ol><li>flat, smooth</li></ol>
sap|sapa	<i>noun</i><br><ol><li>snake</li></ol>
sar	<i>adv</i><br><ol><li>how? (interrogative)</li></ol>
sar san	<i>phrase</i><br><ol><li>how are you (to one person)</li></ol>
sar sen	<i>phrase</i><br><ol><li>how are you (to more than one person)</li></ol>
sastro|sastre	<i>noun</i><br><ol><li>father-in-law</li></ol>
sasuj|sasvi	<i>noun</i><br><ol><li>mother-in-law</li></ol>
sen	<i>verb</i><br><ol><li>second-person plural or formal singular present indicative of si</li></ol>
shanshel	<i>verb</i><br><ol><li>to breathe</li></ol>
shavo|shave	<i>noun</i><br><ol><li>Anglicized form of ćhavo</li></ol>
shero|shere	<i>noun</i><br><ol><li>Anglicized form of śero (“head”)</li></ol>
shib|shiba	<i>noun</i><br><ol><li>Anglicized form of ćhib</li></ol>
shil|shila	<i>noun</i><br><ol><li>Anglicized form of śil (“cold”)</li></ol>
shilalo|shilale|shilali	<i>adj</i><br><ol><li>Anglicized form of śilalo (“cold”)</li></ol>
shinel	<i>verb</i><br><ol><li>to cut</li></ol>
shkola|shkoli	<i>noun</i><br><ol><li>(Lovari Romani) school</li></ol>
shlyappi|shlyappa	<i>noun</i><br><ol><li>slipper</li></ol>
shon	<i>noun</i><br><ol><li>Anglicized form of ćhon (“moon; month”)</li></ol>
shordyol	<i>verb</i><br><ol><li>to flow</li></ol>
shoshoj|shoshoja	<i>noun</i><br><ol><li>Anglicized form of śośoj (“rabbit”)</li></ol>
shov	<i>num</i><br><ol><li>Anglicized form of śov (“six”)</li></ol>
shtar	<i>num</i><br><ol><li>Anglicized form of śtar (“four”)</li></ol>
shudel	<i>verb</i><br><ol><li>to throw</li></ol>
shudro|shudre|shudri	<i>adj</i><br><ol><li>Anglicized form of śudro (“cold”)</li></ol>
shukar	<i>adj</i><br><ol><li>Anglicized form of śukar</li></ol>
shukho|shukhi|shukhe	<i>adj</i><br><ol><li>Anglicized form of śuko (“dry; thin, slim, lean”)</li></ol>
shuko|shuki|shuke	<i>adj</i><br><ol><li>Anglicized form of śuko (“dry; thin, slim, lean”)</li></ol>
shulyol	<i>verb</i><br><ol><li>to swell</li></ol>
si|avesa|sinesas|te avav|te aves|sanas|te oves|avelas|avilǎnas|semas|avena|avilemas|avavas|sem|samas|avilǎmas|oven|sasas|te avas|av (ov)|avenas|te aven|avasa|sas|te ovel|avava|te avel|avela|sen|aven|avilǎsas|te oven|avilenas|te ovav|avesas|san|senas|avasas|sam|te ovas	<i>verb</i><br><ol><li>to be</li><li>there be</li><li>Used before an accusative personal pronoun to indicate possession.</li></ol>
skamin|skamina	<i>noun</i><br><ol><li>chair</li></ol>
so	<i>pron</i><br><ol><li>what?</li></ol>
so maj keren	<i>phrase</i><br><ol><li>how are you (to more than one person)</li></ol>
so maj keres	<i>phrase</i><br><ol><li>how are you (to one person)</li></ol>
sov Devleça	<i>phrase</i><br><ol><li>(International Standard) good night, literally "sleep with God" (said to one person)</li></ol>
sovel	<i>verb</i><br><ol><li>to sleep</li></ol>
soven Devleça	<i>phrase</i><br><ol><li>(International Standard) good night, literally "sleep with God" (said to two or more people)</li></ol>
sumburo	<i>noun</i><br><ol><li>(botany) seed</li></ol>
sungal	<i>verb</i><br><ol><li>to smell (sense a smell or smells)</li></ol>
suno|sune	<i>noun</i><br><ol><li>dream (imaginary events seen in the mind while sleeping)</li></ol>
sura|sur	<i>noun</i><br><ol><li>sword</li></ol>
suvel	<i>verb</i><br><ol><li>to sew</li></ol>
sàvato|savato|savate|sàvaturǎ	<i>noun</i><br><ol><li>Saturday</li></ol>
t|T	<i>character</i><br><ol><li>(International Standard) The twenty-sixth letter of the Romani alphabet, written in the Latin script.</li><li>(Pan-Vlax) The twenty-seventh letter of the Romani alphabet, written in the Latin script.</li></ol>
tato|tati|tate	<i>adj</i><br><ol><li>warm</li></ol>
taxtaj|taxtaja	<i>noun</i><br><ol><li>drinking glass, cup</li></ol>
te	<i>conj</i><br><ol><li>if</li></ol>
te aven baxtale	<i>phrase</i><br><ol><li>hello, literally "be lucky" (addressing two or more people)</li></ol>
te aves baxtali	<i>phrase</i><br><ol><li>hello, literally "be lucky" (addressing a female)</li></ol>
te aves baxtalo	<i>phrase</i><br><ol><li>hello, literally "be lucky" (addressing a male)</li></ol>
terno|terne|terni	<i>adj</i><br><ol><li>young</li></ol>
tetradyi|tetradya	<i>noun</i><br><ol><li>Anglicized form of tetradǐ (“Wednesday”)</li></ol>
tetradǐ|tetradǎ	<i>noun</i><br><ol><li>(International Standard) Wednesday</li></ol>
th|Th	<i>character</i><br><ol><li>(International Standard) The twenty-seventh letter of the Romani alphabet, written in the Latin script.</li><li>(Pan-Vlax) The twenty-eighth letter of the Romani alphabet, written in the Latin script.</li></ol>
thagar|thagaren|thagara|thagares	<i>noun</i><br><ol><li>king</li></ol>
thagarni|thagarněn|thagarnǎ	<i>noun</i><br><ol><li>queen</li></ol>
thaj	<i>conj</i><br><ol><li>and</li></ol>
them|thema	<i>noun</i><br><ol><li>country</li></ol>
therel	<i>verb</i><br><ol><li>(transitive) to possess, to own</li></ol>
thovel	<i>verb</i><br><ol><li>to wash</li></ol>
thud|tood|thuda	<i>noun</i><br><ol><li>milk</li></ol>
thulo|thule|thuli	<i>adj</i><br><ol><li>fat</li><li>thick</li></ol>
thuv	<i>noun</i><br><ol><li>smoke</li></ol>
tikno|cino|tikni|cini|cine|cikno|tikne	<i>adj</i><br><ol><li>small, little</li></ol>
tomna|tomni	<i>noun</i><br><ol><li>autumn</li></ol>
tordǒl|tordyol	<i>verb</i><br><ol><li>to rest</li><li>to stop</li><li>to stand</li></ol>
trin	<i>num</i><br><ol><li>three</li></ol>
trupo|trupura	<i>noun</i><br><ol><li>(anatomy) body</li></ol>
trushul|trushula	<i>noun</i><br><ol><li>Anglicized form of truśul (“cross”)</li></ol>
truśul|truśula	<i>noun</i><br><ol><li>(International Standard) cross</li></ol>
tu|tut	<i>pron</i><br><ol><li>you (singular)</li></ol>
tumaro|tumari|tumare	<i>det</i><br><ol><li>your (second-person plural)</li></ol>
tumen|tume	<i>pron</i><br><ol><li>you pl (nominative and accusative)</li></ol>
u|U	<i>character</i><br><ol><li>(International Standard) The twenty-eighth letter of the Romani alphabet, written in the Latin script.</li><li>(Pan-Vlax) The twenty-ninth letter of the Romani alphabet, written in the Latin script.</li></ol>
uchito|uchiti|uchite	<i>adj</i><br><ol><li>correct</li></ol>
ucho|uche|uchi	<i>adj</i><br><ol><li>high</li></ol>
ungriko|ungriki|ungrike	<i>adj</i><br><ol><li>Hungarian</li></ol>
ungro	<i>noun</i><br><ol><li>male Hungarian</li></ol>
ungrojka	<i>noun</i><br><ol><li>female Hungarian</li></ol>
ural	<i>verb</i><br><ol><li>to fly</li></ol>
urnel	<i>verb</i><br><ol><li>to float</li></ol>
ućhar|ućhara|ushar|ushara	<i>noun</i><br><ol><li>(International Standard) ash</li></ol>
uśt|uśta	<i>noun</i><br><ol><li>(International Standard) lip</li></ol>
v|V	<i>character</i><br><ol><li>(International Standard) The twenty-ninth letter of the Romani alphabet, written in the Latin script.</li><li>(Pan-Vlax) The thirtieth letter of the Romani alphabet, written in the Latin script.</li></ol>
vaj	<i>conj</i><br><ol><li>or</li></ol>
vast|vasta	<i>noun</i><br><ol><li>(anatomy) hand</li></ol>
vesh|vesha	<i>noun</i><br><ol><li>Anglicized form of veś</li></ol>
veś|veśa|veš	<i>noun</i><br><ol><li>(International Standard) forest</li></ol>
vordon|vurdona|vurdon|vordona	<i>noun</i><br><ol><li>car, horse-drawn carriage</li></ol>
vudar|vudara	<i>noun</i><br><ol><li>door</li></ol>
vundya|vundyi	<i>noun</i><br><ol><li>fingernail</li><li>toenail</li></ol>
vuneto|vuneti	<i>adj</i><br><ol><li>blue</li></ol>
vusht|vushta	<i>noun</i><br><ol><li>Anglicized form of uśt (“lip”)</li></ol>
vuš	<i>noun</i><br><ol><li>flax</li><li>(Hungary) hemp</li></ol>
vòrta	<i>adv</i><br><ol><li>(International Standard) Alternative form of òrta (“straight (ahead)”)</li></ol>
w|W	<i>character</i><br><ol><li>A letter used to represent the voiced labial-velar approximant (/w/) in the International Standard orthography.</li></ol>
x|X	<i>character</i><br><ol><li>(International Standard) The eleventh letter of the Romani alphabet, written in the Latin script.</li><li>(Pan-Vlax) The twelfth letter of the Romani alphabet, written in the Latin script.</li></ol>
xaben|xamàta	<i>noun</i><br><ol><li>food</li></ol>
xal|khal	<i>verb</i><br><ol><li>to eat</li></ol>
xanamik	<i>noun</i><br><ol><li>co-father-in-law</li><li>co-mother-in-law</li></ol>
xarundel	<i>verb</i><br><ol><li>to scratch</li></ol>
xoraxaj|xoraxajes|xoraxajen|xoraxaja	<i>noun</i><br><ol><li>Turk</li><li>Muslim</li></ol>
xoro|xod	<i>adj</i><br><ol><li>(German Romani) deep</li></ol>
xumer|xumera|khomer	<i>noun</i><br><ol><li>dough</li></ol>
xutyilel	<i>verb</i><br><ol><li>to hold</li></ol>
yek	<i>num</i><br><ol><li>Anglicized form of jekh (“one”)</li></ol>
z|Z	<i>character</i><br><ol><li>(International Standard) The thirtieth letter of the Romani alphabet, written in the Latin script.</li><li>(Pan-Vlax) The thirty-first letter of the Romani alphabet, written in the Latin script.</li></ol>
zubuno|zubunura	<i>noun</i><br><ol><li>coat</li></ol>
zumi	<i>noun</i><br><ol><li>soup</li><li>broth</li></ol>
zèleno|zelenone	<i>adj</i><br><ol><li>(International Standard) green</li></ol>
À|à	<i>character</i><br><ol><li>(International Standard) The letter A with the grave accent.</li></ol>
Ä	<i>character</i><br><ol><li>(International Standard) Used to represent a dialectal centralized vowel.</li></ol>
Ç|ç	<i>character</i><br><ol><li>(International Standard) Used to represent -ça.</li></ol>
Ë|ë	<i>character</i><br><ol><li>(International Standard) The letter E with the umlaut.</li></ol>
Ï|ï	<i>character</i><br><ol><li>(International Standard) The letter I with the umlaut.</li></ol>
Ö|ö	<i>character</i><br><ol><li>(International Standard) The letter O with the umlaut.</li></ol>
à|À	<i>character</i><br><ol><li>(International Standard) The letter a with the grave accent.</li></ol>
áshel	<i>verb</i><br><ol><li>(Hungary) Alternative form of aćhel</li></ol>
ä|Ä	<i>character</i><br><ol><li>(International Standard) Used to represent a dialectal centralized vowel.</li></ol>
ë|Ë	<i>character</i><br><ol><li>(International Standard) The letter e with the umlaut.</li></ol>
ï|Ï	<i>character</i><br><ol><li>(International Standard) The letter i with the umlaut.</li></ol>
òrta	<i>adv</i><br><ol><li>(International Standard) straight (ahead)</li></ol>
ö|Ö	<i>character</i><br><ol><li>(International Standard) The letter o with the umlaut.</li></ol>
Ć|ć	<i>character</i><br><ol><li>(International Standard) The fourth letter of the Romani alphabet, written in the Latin script.</li></ol>
Ćh|ćh	<i>character</i><br><ol><li>(International Standard) The fifth letter of the Romani alphabet, written in the Latin script.</li></ol>
ć|Ć	<i>character</i><br><ol><li>(International Standard) The fourth letter of the Romani alphabet, written in the Latin script.</li></ol>
ćar|čar|ćarǎ	<i>noun</i><br><ol><li>(International Standard) grass</li></ol>
ćaćipen|čačipen	<i>noun</i><br><ol><li>(International Standard) truth</li></ol>
ćaćo|čači|čače|čačo|ćaće|ćaći	<i>adj</i><br><ol><li>(International Standard) true</li></ol>
ćexrain|cherhaj|cherhaja|ćexrainǎ	<i>noun</i><br><ol><li>(International Standard) star</li></ol>
ćh|Ćh	<i>character</i><br><ol><li>(International Standard) The fifth letter of the Romani alphabet, written in the Latin script.</li></ol>
ćhaj|čhaja|čhaj|ćhajorrǎ|ćhajen|ćhaja|ćhajorri	<i>noun</i><br><ol><li>Romani girl</li><li>daughter</li></ol>
ćham|ćhamǎ	<i>noun</i><br><ol><li>(International Standard) cheek</li></ol>
ćhavo|ćhaven|čhavo|ćhave|ćhava!len|ćhaves|čhave	<i>noun</i><br><ol><li>Romani boy</li><li>son</li></ol>
ćhavorro|ćhavorre|ćhavorres|ćhavorren	<i>noun</i><br><ol><li>little boy (Romani)</li><li>little son</li></ol>
ćhib|ćhibǎ|ćhiba|čhib	<i>noun</i><br><ol><li>tongue</li><li>language</li></ol>
ćhon|ćhona|čhon|čhona	<i>noun</i><br><ol><li>moon</li><li>month</li></ol>
ćhungàrdel	<i>verb</i><br><ol><li>(International Standard) to spit</li></ol>
ćhuri|ćhurǎ|čhuri|shuri|shura	<i>noun</i><br><ol><li>(International Standard) knife</li></ol>
ćhàdel|shandel	<i>verb</i><br><ol><li>(International Standard) to vomit, to be sick</li></ol>
ćiriklo|ćirikli|ćiriklǎ|ćirikle|chirikli	<i>noun</i><br><ol><li>bird</li><li>háček</li></ol>
ćor|ćora|chor|chora	<i>noun</i><br><ol><li>(International Standard) thief</li></ol>
ćorel	<i>verb</i><br><ol><li>(International Standard) to steal</li></ol>
ćorro|ćorri|ćorre	<i>adj</i><br><ol><li>(International Standard) poor</li></ol>
ćovaxani|čoxani|čovaxani|ćovaxanǎ|čovexani	<i>noun</i><br><ol><li>ghost, apparition</li><li>witch, sorceress</li></ol>
ćovaxano|čovexano|čovaxano|čoxano	<i>noun</i><br><ol><li>ghost</li><li>wizard, sorcerer</li></ol>
ćoxani	<i>noun</i><br><ol><li>(International Standard) Alternative form of ćovaxani</li></ol>
ćumi|ćumǎ	<i>noun</i><br><ol><li>(International Standard) kiss</li></ol>
ćumidel	<i>verb</i><br><ol><li>(International Standard) to kiss</li></ol>
ćući|ćućǎ	<i>noun</i><br><ol><li>(International Standard, anatomy) breast</li></ol>
ćùngra|ćùngre|chunri|chunra	<i>noun</i><br><ol><li>plait (of hair)</li></ol>
Č|č	<i>character</i><br><ol><li>(Pan-Vlax) The fourth letter of the Romani alphabet, written in the Latin script.</li></ol>
Čh|čh	<i>character</i><br><ol><li>(Pan-Vlax) The fifth letter of the Romani alphabet, written in the Latin script.</li></ol>
č|Č	<i>character</i><br><ol><li>(Pan-Vlax) The fourth letter of the Romani alphabet, written in the Latin script.</li></ol>
čai|čaia	<i>noun</i><br><ol><li>Pan-Vlax form of ćhaj</li></ol>
čh|Čh	<i>character</i><br><ol><li>(Pan-Vlax) The fifth letter of the Romani alphabet, written in the Latin script.</li></ol>
Ě|ě	<i>character</i><br><ol><li>(International Standard) The letter with E with the háček.</li></ol>
ě|Ě	<i>character</i><br><ol><li>(International Standard) The letter with e with the háček.</li></ol>
Ř|ř	<i>character</i><br><ol><li>(Pan-Vlax) The twenty-fourth letter of the Romani alphabet, written in the Latin script.</li></ol>
ř|Ř	<i>character</i><br><ol><li>(Pan-Vlax) The twenty-fourth letter of the Romani alphabet, written in the Latin script.</li></ol>
Ś|ś	<i>character</i><br><ol><li>(International Standard) The twenty-fifth letter of the Romani alphabet, written in the Latin script.</li><li>(Pan-Vlax) Used to respresent a dialectal pronunciation of Čh.</li></ol>
ś|Ś	<i>character</i><br><ol><li>(International Standard) The twenty-fifth letter of the Romani alphabet, written in the Latin script.</li><li>(Pan-Vlax) Used to respresent a dialectal pronunciation of čh.</li></ol>
śel|śela	<i>num</i><br><ol><li>(International Standard) hundred</li></ol>
śelo|śele|shelo	<i>noun</i><br><ol><li>(International Standard) rope</li></ol>
śero|śere	<i>noun</i><br><ol><li>(International Standard) head</li></ol>
śil|śila|šil|šila	<i>noun</i><br><ol><li>(International Standard) cold</li></ol>
śilalo|śilali|śilale	<i>adj</i><br><ol><li>icy, frozen</li><li>cold</li><li>cold-sensitive</li></ol>
śing|shing	<i>noun</i><br><ol><li>(International Standard) horn</li></ol>
śov|šov	<i>num</i><br><ol><li>(International Standard) six</li></ol>
śośoj|śośoja	<i>noun</i><br><ol><li>(International Standard) rabbit</li></ol>
śtar|štar	<i>num</i><br><ol><li>(International Standard) four</li></ol>
śudro|śudri|šudre|šudri|šudro|śudre	<i>adj</i><br><ol><li>(International Standard) cold</li></ol>
śukar|šukar|śukare	<i>adj</i><br><ol><li>(International Standard) beautiful, handsome</li></ol><br><i>adv</i><br><ol><li>(International Standard) beautifully</li></ol>
śuko|šuko|šuke|śuki|šuki|śuke	<i>adj</i><br><ol><li>dry</li><li>thin, slim, lean</li></ol>
śunel|shunel	<i>verb</i><br><ol><li>(International Standard) to hear</li></ol>
Š|š	<i>character</i><br><ol><li>(Pan-Vlax) The twenty-sixth letter of the Romani alphabet, written in the Latin script.</li></ol>
š|Š	<i>character</i><br><ol><li>(Pan-Vlax) The twenty-sixth letter of the Romani alphabet, written in the Latin script.</li></ol>
Ź|ź	<i>character</i><br><ol><li>(International Standard) The thirty-first letter of the Romani alphabet, written in the Latin script.</li><li>(Pan-Vlax) Used to respresent a dialectal pronunciation of Dž.</li></ol>
Źapònia|i Źapònia	<i>name</i><br><ol><li>(International Standard) Japan</li></ol>
ź|Ź	<i>character</i><br><ol><li>(International Standard) The thirty-first letter of the Romani alphabet, written in the Latin script.</li><li>(Pan-Vlax) Used to respresent a dialectal pronunciation of dž.</li></ol>
źoj|zhoja|źoja|zhoje	<i>noun</i><br><ol><li>(International Standard) Thursday</li></ol>
Ž|ž	<i>character</i><br><ol><li>(Pan-Vlax) The thirty-second letter of the Romani alphabet, written in the Latin script.</li></ol>
ž|Ž	<i>character</i><br><ol><li>(Pan-Vlax) The thirty-second letter of the Romani alphabet, written in the Latin script.</li></ol>
Ʒ|ʒ	<i>character</i><br><ol><li>(International Standard) The thirty-second letter of the Romani alphabet, written in the Latin script.</li></ol>
Ǎ|ǎ	<i>character</i><br><ol><li>(International Standard) The letter with A with the háček.</li></ol>
ǎ|Ǎ	<i>character</i><br><ol><li>(International Standard) The letter with a with the háček.</li></ol>
Ǐ|ǐ	<i>character</i><br><ol><li>(International Standard) The letter with I with the háček.</li></ol>
ǐ|Ǐ	<i>character</i><br><ol><li>(International Standard) The letter with i with the háček.</li></ol>
Ǒ|ǒ	<i>character</i><br><ol><li>(International Standard) The letter with O with the háček.</li></ol>
ǒ|Ǒ	<i>character</i><br><ol><li>(International Standard) The letter with o with the háček.</li></ol>
Ǔ|ǔ	<i>character</i><br><ol><li>(International Standard) The letter with U with the háček.</li></ol>
ǔ|Ǔ	<i>character</i><br><ol><li>(International Standard) The letter with u with the háček.</li></ol>
ʒ|Ʒ	<i>character</i><br><ol><li>(International Standard) The thirty-second letter of the Romani alphabet, written in the Latin script.</li></ol>
ʒa Devleça	<i>phrase</i><br><ol><li>(International Standard) goodbye, literally "go with God" (said to the person leaving)</li></ol>
ʒal|džal	<i>verb</i><br><ol><li>(International Standard) to go</li></ol>
ʒamutro|džamutre|ʒamutres|zhamutro|ʒamutre|ʒamutren|džamutro|zhamutre	<i>noun</i><br><ol><li>son-in-law</li><li>bridegroom</li></ol>
ʒan Devleça	<i>phrase</i><br><ol><li>(International Standard) goodbye, literally "go with God" (said to those leaving)</li></ol>
ʒanel|zhanel	<i>verb</i><br><ol><li>(International Standard) to know</li></ol>
ʒeno|ʒene|ʒenen|ʒenǎ|dženo|ʒenes|dženi|ʒeni	<i>noun</i><br><ol><li>(International Standard) person</li></ol>
ʒivel|zhuvel	<i>verb</i><br><ol><li>(International Standard) to live</li></ol>
ʒukel|ʒuklen|zhukel|zhukeloro|ʒukelorro|ʒukelorre|džukel|ʒukles|zhukla|ʒukela|zhukelore	<i>noun</i><br><ol><li>(International Standard) dog</li></ol>
ʒuv|zhuv|ʒuva|zhuva	<i>noun</i><br><ol><li>(International Standard) louse</li></ol>
ʒuvli|zhulyi|ʒuvlǎ|džuvli|zhulya	<i>noun</i><br><ol><li>woman</li><li>lady</li></ol>
ʒuvliʒeni	<i>noun</i><br><ol><li>(International Standard) person</li></ol>
θ|ϴ	<i>character</i><br><ol><li>(International Standard) Used to represent -θar and -θe.</li></ol>
ϴ|θ	<i>character</i><br><ol><li>(International Standard) Used to represent -θar and -θe.</li></ol>
◌̀	<i>character</i><br><ol><li>(International Standard) A diacritical mark of the Latin script in Romani, and found on À/à, È/è, Ì/ì, Ò/ò and Ù/ù.</li></ol>
◌́	<i>character</i><br><ol><li>A diacritical mark of the Latin script in Romani, and found on Ć/ć, Ćh/ćh, Dź/dź, Ŕ/ŕ, Ś/ś and Ź/ź.</li></ol>
◌̈	<i>character</i><br><ol><li>A diacritical mark of the Latin script in Romani, and found on Ä/ä, Ë/ë, Ï/ï, Ö/ö and Ü/ü.</li></ol>
◌̌	<i>character</i><br><ol><li>(International Standard) marking palatalization of the preceding consonant.</li><li>(Pan-Vlax) marking patalization of the consonant below.</li></ol>
