Argovia	<i>name</i><br><ol><li>Aargau, Argovia</li></ol>
Aserbeidschan	<i>name</i><br><ol><li>Azerbaijan (a country in Europe and Asia)</li></ol>
Asia	<i>name</i><br><ol><li>Asia (a continent)</li></ol>
Bassa|La Bassa	<i>name</i><br><ol><li>the parts of Switzerland that are lower than Grisons</li></ol>
Berna	<i>name</i><br><ol><li>Bern (the capital city of Switzerland)</li><li>Bern (a canton of Switzerland)</li></ol>
Cambodscha	<i>name</i><br><ol><li>Cambodia</li></ol>
Chiasso	<i>name</i><br><ol><li>Chiasso: A village and former commune of Mendrisio, Ticino canton, Switzerland</li></ol>
Cipra|La Cipra	<i>name</i><br><ol><li>(Rumantsch Grischun, Sursilvan, Surmiran, Puter, Vallader) Cyprus</li></ol>
Closomat|Closomats	<i>noun</i><br><ol><li>a toilet with a built-in intimate washing facility</li></ol>
Corea	<i>name</i><br><ol><li>Korea</li></ol>
Corea dal Nord	<i>name</i><br><ol><li>North Korea</li></ol>
Corea dal Sid	<i>name</i><br><ol><li>South Korea</li></ol>
Corean|Coreans|Coreanas|Coreana	<i>noun</i><br><ol><li>Korean person (male or unspecified)</li></ol>
Croazia	<i>name</i><br><ol><li>Croatia</li></ol>
Egipta	<i>name</i><br><ol><li>Egypt</li></ol>
Emirats Arabs|Ils Emirats Arabs	<i>name</i><br><ol><li>the United Arab Emirates</li></ol>
Engiadina	<i>name</i><br><ol><li>(Rumantsch Grischun, Sursilvan, Puter, Vallader) Engadin (a valley in Switzerland)</li></ol>
Engiadina bassa	<i>name</i><br><ol><li>(Rumantsch Grischun, Sursilvan, Puter, Vallader) Lower Engadin</li></ol>
Europa|L'Europa	<i>name</i><br><ol><li>(geography) Europe</li><li>(astronomy) Europa</li></ol>
Filippinas|Las Filippinas	<i>name</i><br><ol><li>the Philippines</li></ol>
Frantscha|La Frantscha	<i>name</i><br><ol><li>(Rumantsch Grischun, Surmiran, Vallader) France</li></ol>
Frauntscha|La Frauntscha	<i>name</i><br><ol><li>(Puter) France</li></ol>
Frontscha|La Frontscha	<i>name</i><br><ol><li>(Sursilvan) France</li></ol>
Fràntscha|La Fràntscha	<i>name</i><br><ol><li>(Sutsilvan) France</li></ol>
Genevra	<i>name</i><br><ol><li>Geneva (a city in Switzerland)</li><li>Geneva (a canton of Switzerland)</li></ol>
Genevrin|Genevrinas|Genevrins|Genevrina	<i>noun</i><br><ol><li>Genevan</li></ol>
Giadina	<i>name</i><br><ol><li>(Sursilvan) Engadin (a valley in Switzerland)</li></ol>
Giamaica	<i>name</i><br><ol><li>Jamaica (an island and country in the Caribbean)</li></ol>
Gidegna	<i>name</i><br><ol><li>(Sutsilvan) Engadin (a valley in Switzerland)</li></ol>
Grischun	<i>name</i><br><ol><li>(Rumantsch Grischun, Sursilvan, Surmiran, Puter, Vallader) Grisons, Graubünden</li></ol>
Grischùn	<i>name</i><br><ol><li>(Sutsilvan) Grisons, Graubünden</li></ol>
Gronda Britannia	<i>name</i><br><ol><li>Great Britain</li></ol>
Holanda	<i>name</i><br><ol><li>(Sutsilvan, Surmiran) Holland, the Netherlands</li></ol>
Inslas britanicas	<i>name</i><br><ol><li>(geography, Sutsilvan) the British Isles</li></ol>
Inslas britannicas	<i>name</i><br><ol><li>(geography, Rumantsch Grischun, Sursilvan, Surmiran) the British Isles</li></ol>
Inslas da Marshall	<i>name</i><br><ol><li>Marshall Islands</li></ol>
Inslas da Salomon	<i>name</i><br><ol><li>Solomon Islands</li></ol>
Irlanda	<i>name</i><br><ol><li>Ireland (a country in Europe)</li></ol>
Irlanda dal nord	<i>name</i><br><ol><li>Northern Ireland</li></ol>
Islas Britannicas	<i>name</i><br><ol><li>(geography, Puter) the British Isles</li></ol>
Islas britannicas	<i>name</i><br><ol><li>(geography, Vallader) the British Isles</li></ol>
Jangtse	<i>name</i><br><ol><li>Yangtze (a river in China)</li></ol>
Kirghisia	<i>name</i><br><ol><li>Kyrgyzstan</li></ol>
Lag da Genevra	<i>name</i><br><ol><li>(Sursilvan) Geneva (lake)</li></ol>
Lai Leman	<i>name</i><br><ol><li>(Vallader) Geneva (lake)</li></ol>
Lai da Genevra	<i>name</i><br><ol><li>(Rumantsch Grischun, Sutsilvan, Surmiran) Geneva (lake)</li></ol>
Lej Leman	<i>name</i><br><ol><li>(Puter) Geneva (lake)</li></ol>
Leman	<i>name</i><br><ol><li>(Sutsilvan, Surmiran) Geneva (lake)</li></ol>
Lisbona	<i>name</i><br><ol><li>Lisbon (the capital city of Portugal)</li></ol>
Losanna	<i>name</i><br><ol><li>Lausanne (a city in Switzerland)</li></ol>
Lucerna	<i>name</i><br><ol><li>(Rumantsch Grischun, Sursilvan, Surmiran, Puter, Vallader) Lucerne (the capital city of the canton of Lucerne, Switzerland)</li><li>(Rumantsch Grischun, Sursilvan, Surmiran, Puter, Vallader) Lucerne (a canton of Switzerland)</li></ol>
Lucernais|Lucernaisa|Lucernaisas	<i>noun</i><br><ol><li>(Rumantsch Grischun, Puter, Vallader) citizen, native or inhabitant of Lucerne</li></ol>
Lucernes|Lucernesas|Lucernesa	<i>noun</i><br><ol><li>(Sursilvan, Surmiran) citizen, native or inhabitant of Lucerne</li></ol>
Luzerna	<i>name</i><br><ol><li>(Sutsilvan) Lucerne (the capital city of the canton of Lucerne, Switzerland)</li><li>(Sutsilvan) Lucerne (a canton of Switzerland)</li></ol>
Luzernes|Luzernesa|Luzernesas	<i>noun</i><br><ol><li>(Sutsilvan) citizen, native or inhabitant of Lucerne</li></ol>
Nadal	<i>name</i><br><ol><li>Christmas</li></ol>
Nagiadegna	<i>name</i><br><ol><li>(Surmiran) Engadin (a valley in Switzerland)</li></ol>
Ollanda|L'Ollanda	<i>name</i><br><ol><li>(Rumantsch Grischun, Sursilvan, Puter, Vallader) Holland, the Netherlands</li></ol>
Pajais Bass	<i>name</i><br><ol><li>(Rumantsch Grischun, Puter, Vallader) the Netherlands, Low Countries</li></ol>
Papua-Nova Guinea	<i>name</i><br><ol><li>Papua New Guinea</li></ol>
Pologna	<i>name</i><br><ol><li>Poland</li></ol>
Ragn	<i>name</i><br><ol><li>(Sutsilvan, Surmiran) the Rhine (a river in Central Europe)</li></ol>
Rain	<i>name</i><br><ol><li>(Rumantsch Grischun, Puter, Vallader) the Rhine (a river in Western Europe)</li></ol>
Reginavel Unì	<i>name</i><br><ol><li>(Rumantsch Grischun) the United Kingdom</li></ol>
Reginavel unì dal la Gronda Britannia ed Irlanda dal nord	<i>name</i><br><ol><li>(Rumantsch Grischun) the United Kingdom of Great Britain and Northern Ireland</li></ol>
Rein	<i>name</i><br><ol><li>(Sursilvan) the Rhine (a river in Central Europe)</li></ol>
Republica Corea	<i>name</i><br><ol><li>South Korea</li></ol>
Romontsch|Romontschs|Romontschas|Romontscha	<i>noun</i><br><ol><li>(Sursilvan) (male) Romansch-speaker, Romansch man</li></ol>
Romontscha|Romontschas	<i>noun</i><br><ol><li>(Sursilvan) (female) Romansch-speaker, Romansch woman</li></ol>
Rumantsch|Rumantschs|Rumantschas|Rumantscha	<i>noun</i><br><ol><li>(Rumantsch Grischun, Surmiran, Vallader) (male) Romansch-speaker, Romansch man</li></ol>
Rumantsch Grischun	<i>name</i><br><ol><li>standard literary Romansch</li></ol>
Rumantscha|Rumantschas	<i>noun</i><br><ol><li>(Rumantsch Grischun, Surmiran, Vallader) (female) Romansch-speaker, Romansch woman</li></ol>
Rumauntsch|Rumauntscha|Rumauntschs|Rumauntschas	<i>noun</i><br><ol><li>(Puter) (male) Romansch-speaker, Romansch man</li></ol>
Rumauntscha|Rumauntschas	<i>noun</i><br><ol><li>(Puter) (female) Romansch-speaker, Romansch woman</li></ol>
Rumenia	<i>name</i><br><ol><li>Romania</li></ol>
Rumàntsch|Rumàntschas|Rumàntscha|Rumàntschs	<i>noun</i><br><ol><li>(Sutsilvan) (male) Romansch-speaker, Romansch man</li></ol>
Rumàntscha|Rumàntschas	<i>noun</i><br><ol><li>(Sutsilvan) (female) Romansch-speaker, Romansch woman</li></ol>
Scozia|la Scozia	<i>name</i><br><ol><li>Scotland (a country in the United Kingdom, Europe)</li></ol>
Spagna|la Spagna	<i>name</i><br><ol><li>(Rumantsch Grischun, Sursilvan, Sutsilvan, Surmiran, Puter) Spain (a country in Europe)</li></ol>
Spogna|la Spagna	<i>name</i><br><ol><li>(Vallader) Spain (a country in Europe)</li></ol>
Stadis Unids	<i>name</i><br><ol><li>(Rumantsch Grischun, Vallader) the United States</li></ol>
Stadis Unids da l'America	<i>name</i><br><ol><li>(Rumantsch Grischun, Vallader) United States of America (a country in North America)</li></ol>
Sviz	<i>name</i><br><ol><li>Schwyz (a town and canton of Switzerland)</li></ol>
Svizra	<i>name</i><br><ol><li>Switzerland</li></ol>
Tansania	<i>name</i><br><ol><li>Tanzania</li></ol>
Terchia	<i>name</i><br><ol><li>(Sursilvan) Turkey</li></ol>
Tertgeia	<i>name</i><br><ol><li>(Surmiran) Turkey</li></ol>
Tertgia	<i>name</i><br><ol><li>(Sutsilvan) Turkey</li></ol>
Timor da l'Ost	<i>name</i><br><ol><li>East Timor</li></ol>
Tirchia	<i>name</i><br><ol><li>(Rumantsch Grischun) Turkey</li></ol>
Tschecheia	<i>name</i><br><ol><li>(Surmiran) the Czech Republic</li></ol>
Tschechia	<i>name</i><br><ol><li>(Rumantsch Grischun, Sursilvan) the Czech Republic</li></ol>
Tschehia	<i>name</i><br><ol><li>(Sutsilvan) the Czech Republic</li></ol>
Tschekia	<i>name</i><br><ol><li>(Sutsilvan, Puter, Vallader) the Czech Republic</li></ol>
Turcmenia	<i>name</i><br><ol><li>Turkmenistan</li></ol>
Turich	<i>name</i><br><ol><li>(Puter, Vallader) Zurich (the capital city of Zurich canton, Switzerland)</li><li>(Puter, Vallader) Zurich (a canton of Switzerland)</li></ol>
Turitg	<i>name</i><br><ol><li>(Rumantsch Grischun, Sursilvan, Sutsilvan, Surmiran) Zurich (the capital city of Zurich canton, Switzerland)</li><li>(Rumantsch Grischun, Sursilvan, Sutsilvan, Surmiran) Zurich (a canton of Switzerland)</li></ol>
Türchia	<i>name</i><br><ol><li>(Puter, Vallader) Turkey</li></ol>
Uniun europeica	<i>name</i><br><ol><li>European Union</li></ol>
Valisa	<i>name</i><br><ol><li>Wales</li></ol>
Vichipedia	<i>name</i><br><ol><li>Wikipedia</li></ol>
Zipra|La Zipra	<i>name</i><br><ol><li>(Sutsilvan) Cyprus</li></ol>
adina	<i>adv</i><br><ol><li>(Rumantsch Grischun, Sursilvan) always</li></ol>
affon|affons	<i>noun</i><br><ol><li>(Sursilvan) child</li></ol>
affon persul|affons persuls	<i>noun</i><br><ol><li>(Sursilvan) only child</li></ol>
agentura|agenturas	<i>noun</i><br><ol><li>(Rumantsch Grischun, Sursilvan, Surmiran, Puter, Vallader) agency</li></ol>
agenzeia|agenzeias	<i>noun</i><br><ol><li>(Sutsilvan) agency</li></ol>
agenzia|agenzias	<i>noun</i><br><ol><li>(Rumantsch Grischun, Sursilvan, Puter, Vallader) agency</li></ol>
agnè|agnels	<i>noun</i><br><ol><li>lamb</li></ol>
aguoglia|aguoglias	<i>noun</i><br><ol><li>(Puter, Vallader) needle</li></ol>
aguotta|aguottas	<i>noun</i><br><ol><li>(carpentry, Puter) nail</li></ol>
ajer	<i>noun</i><br><ol><li>(Puter, Vallader) air</li></ol>
ala|alas	<i>noun</i><br><ol><li>(Rumantsch Grischun, Sursilvan, Sutsilvan, Surmiran, Vallader) wing</li><li>mouldboard</li></ol>
alb|alba|albs|albas	<i>adj</i><br><ol><li>(Vallader) white</li></ol>
alb d'öv	<i>noun</i><br><ol><li>(Vallader) egg white, albumen</li></ol>
allegra	<i>intj</i><br><ol><li>hello</li></ol>
alpin|alpins|alpinas|alpina	<i>adj</i><br><ol><li>mountainous</li></ol>
alv|alvs|alva|alvas	<i>adj</i><br><ol><li>(Rumantsch Grischun, Sursilvan, Sutsilvan, Surmiran, Puter) white</li></ol>
alv d'ov	<i>noun</i><br><ol><li>(Rumantsch Grischun, Sutsilvan, Surmiran) egg white, albumen</li></ol>
alv d'öv	<i>noun</i><br><ol><li>(Puter) egg white, albumen</li></ol>
amalada|amaladas	<i>noun</i><br><ol><li>(Vallader) (female) patient</li></ol>
amaleda|amaledas	<i>noun</i><br><ol><li>(Vallader) (female) patient</li></ol>
amalo|amalos	<i>noun</i><br><ol><li>(Puter) patient</li></ol>
amalà|amalats	<i>noun</i><br><ol><li>(Vallader) patient</li></ol>
amei|ameia|ameias|ameis	<i>noun</i><br><ol><li>(Surmiran) (male) friend, boyfriend</li></ol>
ameia|ameias	<i>noun</i><br><ol><li>(Surmiran) (female) friend, girlfriend</li></ol>
ami|amis	<i>noun</i><br><ol><li>(Rumantsch Grischun, Vallader) (male) friend, boyfriend</li></ol>
amia|amias	<i>noun</i><br><ol><li>(Rumantsch Grischun, Puter, Vallader) (female) friend, girlfriend</li></ol>
amih|amihs	<i>noun</i><br><ol><li>(Puter) (male) friend, boyfriend</li></ol>
amitg|amitgs	<i>noun</i><br><ol><li>(Sursilvan, Sutsilvan) (male) friend, boyfriend</li></ol>
amitga|amitgas	<i>noun</i><br><ol><li>(Sursilvan, Sutsilvan) (female) friend, girlfriend</li></ol>
an|ans	<i>noun</i><br><ol><li>(Puter) year</li></ol>
ancurir	<i>verb</i><br><ol><li>(Sutsilvan) to look up, look for, search, seek</li></ol>
anda|andas	<i>noun</i><br><ol><li>(Rumantsch Grischun, Sursilvan, Sutsilvan, Surmiran, Puter, Vallader) duck</li></ol>
anda selvadia	<i>noun</i><br><ol><li>mallard</li></ol>
anel|anels	<i>noun</i><br><ol><li>(Surmiran) ring</li></ol>
anghel|anghels	<i>noun</i><br><ol><li>(Rumantsch Grischun, Surmiran, religion) angel</li><li>(Surmiran, Sursilvan) angle</li></ol>
anguel|anguels	<i>noun</i><br><ol><li>(Vallader, religion) angel</li></ol>
angul|anguls	<i>noun</i><br><ol><li>(Rumantsch Grischun, Puter, Vallader) angle</li></ol>
ani|anials|aneals	<i>noun</i><br><ol><li>(Sursilvan, Sutsilvan) ring</li></ol>
animal|animals	<i>noun</i><br><ol><li>(Rumantsch Grischun, Sursilvan, Sutsilvan, Surmiran, Vallader) animal</li></ol>
antschertgear	<i>verb</i><br><ol><li>(Sutsilvan) to look up, look for, search, seek</li></ol>
antschever|antschet	<i>verb</i><br><ol><li>(Sutsilvan, Surmiran) to start</li></ol>
anzatge	<i>noun</i><br><ol><li>(Sutsilvan) something, anything</li></ol>
anè|anels	<i>noun</i><br><ol><li>(Rumantsch Grischun, Puter, Vallader) ring</li></ol>
applicar|applichescha|applichein	<i>verb</i><br><ol><li>(Sursilvan) to use, apply</li></ol>
applichar	<i>verb</i><br><ol><li>(Vallader) to use, apply</li></ol>
applicher	<i>verb</i><br><ol><li>(Puter) to use, apply</li></ol>
applitgar	<i>verb</i><br><ol><li>(Rumantsch Grischun) to use, apply</li></ol>
applitgier	<i>verb</i><br><ol><li>(Surmiran) to use, apply</li></ol>
apricosa|apricosas	<i>noun</i><br><ol><li>apricot</li></ol>
aragnun|aragnuns	<i>noun</i><br><ol><li>(Puter) spider</li></ol>
aram	<i>noun</i><br><ol><li>(Puter) copper</li></ol>
arbagl|arbagls|arbaglia	<i>noun</i><br><ol><li>(Vallader) pea</li></ol>
ardöffel|ardöffels	<i>noun</i><br><ol><li>(Puter) potato</li></ol>
argien	<i>noun</i><br><ol><li>(Sursilvan) silver</li></ol>
argient	<i>noun</i><br><ol><li>(Rumantsch Grischun, Sutsilvan, Surmiran, Puter, Vallader) silver</li></ol>
aria	<i>noun</i><br><ol><li>(Rumantsch Grischun, Sursilvan, Sutsilvan, Surmiran) air</li></ol>
arogn|arogns	<i>noun</i><br><ol><li>(Rumantsch Grischun, Vallader) spider</li></ol>
arom	<i>noun</i><br><ol><li>(Rumantsch Grischun, Sutsilvan, Surmiran, Vallader) copper</li></ol>
artitgel|artitgels	<i>noun</i><br><ol><li>article</li></ol>
arvagl|arvagls|arvaglia	<i>noun</i><br><ol><li>(Puter) pea</li></ol>
arvegl|arvegls|arveglia	<i>noun</i><br><ol><li>(Rumantsch Grischun, Sursilvan, Sutsilvan, Surmiran) pea</li></ol>
arver|arvel|arvavan|arvessien|vegnessen a arver|arvies|arvien|arva|arvi|arvessies|vegnel a arver|arveis|arvessi|vegness a arver|arvein|aviert|arvava|arvevien|vegnies a arver|arvessen|vegnessien a arver|arvavas|aviarts|vegnesses a arver|vegnîen a arver|arveien|vegni a arver|arvas|arvevi|arveies|vegnin a arver|vegnan a arver|arvend|vegnessies a arver|arvesses|arvei|arvess|vegnessi a arver|vegnien a arver|arvan|vegnîes a arver|vegn a arver|vegnis a arver|arvavel|vegns a arver|arvevies	<i>verb</i><br><ol><li>(Sursilvan) to open</li></ol>
as avrir	<i>verb</i><br><ol><li>(Puter) to open (become open)</li></ol>
as drivir	<i>verb</i><br><ol><li>(Vallader) to open (become open)</li></ol>
as rivir	<i>verb</i><br><ol><li>(Vallader) to open (become open)</li></ol>
as-cher|as-chers|ascra|ascras	<i>adj</i><br><ol><li>(Puter) dirty</li></ol>
asan|asans	<i>noun</i><br><ol><li>(Surmiran, Vallader) (male) donkey, ass</li></ol>
aschaid	<i>noun</i><br><ol><li>(Puter, Vallader) vinegar</li></ol>
aschieu	<i>noun</i><br><ol><li>(Rumantsch Grischun) vinegar</li></ol>
asen|asens	<i>noun</i><br><ol><li>(Rumantsch Grischun, Sursilvan, Sutsilvan) (male) donkey, ass</li></ol>
asna|asnas	<i>noun</i><br><ol><li>(Rumantsch Grischun, Sursilvan, Sutsilvan, Surmiran, Vallader) female donkey, ass</li></ol>
aspectatur|aspectatura|aspectaturas|aspectaturs	<i>noun</i><br><ol><li>(male or unspecified) spectator, fan</li></ol>
aspectatura|aspectaturas	<i>noun</i><br><ol><li>(female) spectator, fan</li></ol>
astronomia	<i>noun</i><br><ol><li>astronomy</li></ol>
aton|atons	<i>noun</i><br><ol><li>(Surmiran) autumn, fall</li></ol>
atschal	<i>noun</i><br><ol><li>(Rumantsch Grischun, Sutsilvan, Surmiran, Vallader) steel</li></ol>
atschel	<i>noun</i><br><ol><li>(Puter) steel</li></ol>
atun|atuns	<i>noun</i><br><ol><li>(Rumantsch Grischun, Sursilvan, Sutsilvan) autumn, fall</li></ol>
aua	<i>noun</i><br><ol><li>(Rumantsch Grischun, Sursilvan, Sutsilvan, Puter) water</li></ol>
aua da baiver	<i>noun</i><br><ol><li>(Rumantsch Grischun, Vallader) drinking water, potable water</li></ol>
aua da beiber	<i>noun</i><br><ol><li>(Sursilvan) drinking water, potable water</li></ol>
aua da bever	<i>noun</i><br><ol><li>(Sutsilvan) drinking water, potable water</li></ol>
aua da la spegna	<i>noun</i><br><ol><li>(Sutsilvan) tap water</li></ol>
aua da spina	<i>noun</i><br><ol><li>(Rumantsch Grischun) tap water</li></ol>
aua da tgiern	<i>noun</i><br><ol><li>(Sursilvan, Sutsilvan) tap water</li></ol>
aua dal chüern	<i>noun</i><br><ol><li>(Vallader) tap water</li></ol>
aua minerala	<i>noun</i><br><ol><li>(Rumantsch Grischun, Sursilvan, Sutsilvan, Vallader) mineral water</li></ol>
auca|aucas	<i>noun</i><br><ol><li>(Rumantsch Grischun, Sursilvan) goose</li></ol>
aug|augs	<i>noun</i><br><ol><li>(Rumantsch Grischun, Sursilvan) uncle</li></ol>
ault|aulta|aults|aultas	<i>adj</i><br><ol><li>(Sursilvan) high</li></ol>
aungel|aungels	<i>noun</i><br><ol><li>(Puter, religion) angel</li></ol>
aunghel|aunghels	<i>noun</i><br><ol><li>(Sursilvan, religion) angel</li></ol>
aunz	<i>prep</i><br><ol><li>(Puter) before, beforehand</li></ol>
aur	<i>noun</i><br><ol><li>(Rumantsch Grischun, Sursilvan) gold</li></ol>
aura	<i>noun</i><br><ol><li>(Rumantsch Grischun, Sursilvan) weather</li></ol>
aut|auta|autas|auts	<i>adj</i><br><ol><li>(Rumantsch Grischun) high</li></ol>
auter|auters|autras|autra	<i>adj</i><br><ol><li>(Rumantsch Grischun, Sursilvan) other</li><li>(time, Sursilvan) next, coming</li></ol>
ava	<i>noun</i><br><ol><li>(Surmiran) water</li></ol>
ava da bever	<i>noun</i><br><ol><li>(Surmiran) drinking water, potable water</li></ol>
ava dalla spegna|aua dalla spegna	<i>noun</i><br><ol><li>(Surmiran) tap water</li></ol>
ava minerala	<i>noun</i><br><ol><li>(Surmiran) mineral water</li></ol>
avair|has|vegnies a avair|han|avevan|vegnis a avair|avess|vegnîes a avair|hajan|vegns a avair|avessen|vegnin a avair|gì|avesses|vegnel a avair|aveva|vegness a avair|vegnien a avair|avevas|vegnîen a avair|avais|haja|vegnan a avair|ha|avend|vegnesses a avair|vegni a avair|avain|hai|vegnessen a avair|vegn a avair|hajas	<i>verb</i><br><ol><li>(Rumantsch Grischun) to have</li></ol>
avant	<i>prep</i><br><ol><li>(Rumantsch Grischun, Surmiran, Vallader) before, beforehand</li><li>(Rumantsch Grischun, Surmiran, Vallader) ago</li></ol>
avaunt	<i>prep</i><br><ol><li>(Puter) ago</li></ol>
avert|averts|avertas|averta	<i>adj</i><br><ol><li>(Rumantsch Grischun, Surmiran, Vallader) open</li></ol>
aviert|aviartas|aviertas|aviarta|avierts|avierta	<i>adj</i><br><ol><li>(Sursilvan) open</li><li>(Sutsilvan, Puter) open</li></ol>
avieul|avieuls	<i>noun</i><br><ol><li>(Rumantsch Grischun, Sutsilvan) bee</li></ol>
avioul|aviouls	<i>noun</i><br><ol><li>(Surmiran) bee</li></ol>
aviul|aviuls	<i>noun</i><br><ol><li>(Sursilvan) bee</li></ol>
aviöl|aviöls	<i>noun</i><br><ol><li>(Puter, Vallader) bee</li></ol>
avon	<i>prep</i><br><ol><li>(Sursilvan) before, beforehand</li><li>(Sursilvan) ago</li></ol>
avost	<i>name</i><br><ol><li>(Surmiran) August</li></ol>
avregl	<i>name</i><br><ol><li>(Sutsilvan, Surmiran) April</li></ol>
avrel	<i>name</i><br><ol><li>(Sursilvan) April</li></ol>
avrigl	<i>name</i><br><ol><li>(Rumantsch Grischun, Puter, Vallader) April</li></ol>
avrir	<i>verb</i><br><ol><li>(Rumantsch Grischun, Puter) to open</li></ol>
avuost	<i>name</i><br><ol><li>(Puter, Vallader) August</li></ol>
avust	<i>name</i><br><ol><li>(Rumantsch Grischun, Sutsilvan) August</li></ol>
avànt	<i>prep</i><br><ol><li>(Sutsilvan) before, beforehand</li><li>(Sutsilvan) ago</li></ol>
bab|babs	<i>noun</i><br><ol><li>(Rumantsch Grischun, Sursilvan, Sutsilvan, Surmiran) father</li></ol>
baditschun|baditschuns	<i>noun</i><br><ol><li>(Sursilvan, anatomy) chin</li></ol>
baditschùn|baditschùns	<i>noun</i><br><ol><li>(anatomy, Sutsilvan) chin</li></ol>
bagn|bagns	<i>adv</i><br><ol><li>(Sutsilvan, Surmiran) well</li><li>(Sutsilvan, Surmiran) beautifully</li><li>(Sutsilvan, Surmiran) yes (used to disagree with a negative statement)</li></ol><br><i>noun</i><br><ol><li>(Puter) bath, bathroom</li><li>(Puter) swimming pool</li></ol>
bain|bains	<i>adv</i><br><ol><li>(Rumantsch Grischun, Puter, Vallader) well</li><li>(Rumantsch Grischun, Puter, Vallader) beautifully</li><li>(Rumantsch Grischun, Puter, Vallader) yes (used to disagree with a negative statement)</li></ol><br><i>noun</i><br><ol><li>(Puter, Vallader) farm</li></ol>
bainschi	<i>adv</i><br><ol><li>(Puter, Vallader) yes (used to disagree with a negative statement)</li></ol>
bainschi hai	<i>adv</i><br><ol><li>(Vallader) yes (used to disagree with a negative statement)</li></ol>
bainschi hei	<i>adv</i><br><ol><li>(Puter, Vallader) yes (used to disagree with a negative statement)</li></ol>
baiver	<i>verb</i><br><ol><li>(Rumantsch Grischun, Puter, Vallader) to drink</li></ol>
bal|bals	<i>noun</i><br><ol><li>ball (formal dance)</li></ol>
balezia|balezias	<i>noun</i><br><ol><li>(Sutsilvan) beauty</li></ol>
baleztgia|baleztgias	<i>noun</i><br><ol><li>(Sutsilvan) beauty</li></ol>
balla|ballas	<i>noun</i><br><ol><li>(sports, Rumantsch Grischun, Sursilvan, Surmiran, Puter, Vallader) ball</li></ol>
bambesch	<i>noun</i><br><ol><li>(Puter) cotton</li></ol>
bandiera|bandieras	<i>noun</i><br><ol><li>flag</li></ol>
bap|baps	<i>noun</i><br><ol><li>(Puter, Vallader) father</li></ol>
barba|barbas	<i>noun</i><br><ol><li>beard</li><li>(Rumantsch Grischun, Surmiran, Puter, Vallader) uncle</li></ol>
bartga|bartgas	<i>noun</i><br><ol><li>boat</li></ol>
bas	<i>adj</i><br><ol><li>(Vallader) deep, low</li></ol>
baselgia|baselgias	<i>noun</i><br><ol><li>church</li></ol>
bass	<i>adj</i><br><ol><li>(Rumantsch Grischun, Sursilvan, Sutsilvan, Surmiran, Puter, Vallader) deep, low</li></ol>
battalaura|battalauras	<i>noun</i><br><ol><li>(Vallader) kestrel</li></ol>
battasenda|battasendas	<i>noun</i><br><ol><li>(Rumantsch Grischun) Scout (member of a scouting organisation)</li></ol>
batter	<i>verb</i><br><ol><li>(Rumantsch Grischun) To beat.</li></ol>
baud	<i>adv</i><br><ol><li>(Rumantsch Grischun) early</li></ol>
beber	<i>verb</i><br><ol><li>(Sutsilvan) to drink</li></ol>
begl	<i>noun</i><br><ol><li>(anatomy, Rumantsch Grischun, Sursilvan) intestines, insides, guts</li></ol>
beglia	<i>noun</i><br><ol><li>(anatomy, Rumantsch Grischun, Sursilvan) intestines, insides, guts</li></ol>
beiber|buessies|vegnien a beiber|beibies|beibevies|buessen|buessien|beibien|buessi|beibas|beibavan|vegnesses a beiber|buesses|vegnessi a beiber|beiban|vegnessen a beiber|vegnessien a beiber|bueis|bueies|vegnîen a beiber|vegnies a beiber|vegnis a beiber|vegness a beiber|buiu|beibi|beibevi|buei|vegnîes a beiber|beibavel|beibava|vegnan a beiber|beibel|vegnessies a beiber|vegn a beiber|vegns a beiber|buess|beibend|vegnel a beiber|beibevien|bueien|buein|vegni a beiber|vegnin a beiber|beibavas|beiba	<i>verb</i><br><ol><li>(Sursilvan) to drink</li></ol>
bein|beins	<i>adv</i><br><ol><li>(Sursilvan) well</li><li>(Sursilvan) beautifully</li><li>(Sursilvan) yes (used to disagree with a negative statement)</li></ol><br><i>noun</i><br><ol><li>(Sursilvan) farm</li></ol>
belezza|belezzas	<i>noun</i><br><ol><li>(Surmiran) beauty</li></ol>
bella|bellas	<i>noun</i><br><ol><li>(Sursilvan) butterfly, moth</li></ol>
bellezia|bellezias	<i>noun</i><br><ol><li>(Sursilvan) beauty</li></ol>
bellezza|bellezzas	<i>noun</i><br><ol><li>(Rumantsch Grischun, Puter, Vallader) beauty</li></ol>
bes-cha|bes-chas	<i>noun</i><br><ol><li>(Puter, Vallader) animal</li></ol>
besch|bescha|beschs	<i>noun</i><br><ol><li>(Vallader) sheep</li></ol>
bestga|bestgas	<i>noun</i><br><ol><li>(Rumantsch Grischun, Sursilvan) animal</li></ol>
bestia|bestias	<i>noun</i><br><ol><li>(Sursilvan) animal</li></ol>
betg	<i>adv</i><br><ol><li>(Rumantsch Grischun, Surmiran, na ... betg/n'... betg) not</li><li>(Sutsilvan, nonstandard in Rumantsch Grischun) not</li></ol>
betga	<i>adv</i><br><ol><li>(Sutsilvan) not</li></ol>
bever	<i>verb</i><br><ol><li>(Sutsilvan, Surmiran) to drink</li></ol>
bger|bgera|bgers|bgeras	<i>adj</i><br><ol><li>(Puter) much, a lot of</li></ol>
bia|biara|biars|biaras	<i>adj</i><br><ol><li>(Sursilvan, Sutsilvan) much, a lot of</li></ol>
bienmarcau	<i>adj</i><br><ol><li>(Sursilvan) cheap (low in price)</li></ol>
biera|bieras	<i>noun</i><br><ol><li>(Rumantsch Grischun, Sursilvan, Sutsilvan, Surmiran, Puter, Vallader) beer, ale</li></ol>
biestg|biestgs	<i>noun</i><br><ol><li>(Rumantsch Grischun, Sursilvan, Surmiran) animal</li></ol>
biglia	<i>noun</i><br><ol><li>(anatomy, Sutsilvan, Surmiran) intestines, insides, guts</li></ol>
blau|blauas|blaua|blaus	<i>adj</i><br><ol><li>(Rumantsch Grischun, Sursilvan, Sutsilvan, Vallader) blue</li></ol>
blauaint|blauaintas|blauaints|blauainta	<i>adj</i><br><ol><li>(Vallader) bluish (having a blue tint or hue)</li></ol>
blauent|blauenta|blauentas|blauents	<i>adj</i><br><ol><li>(Rumantsch Grischun) bluish (having a blue tint or hue)</li></ol>
blavaint|blavaints|blavainta|blavaintas	<i>adj</i><br><ol><li>(Surmiran) bluish (having a blue tint or hue)</li></ol>
blear|blears|bleara|blearas	<i>adj</i><br><ol><li>(Sutsilvan) much, a lot of</li></ol>
bler|blera|blers|bleras	<i>adj</i><br><ol><li>(Rumantsch Grischun, Surmiran, Vallader) much, a lot of</li></ol>
bletsch|bletschas|bletschs|bletscha	<i>adj</i><br><ol><li>humid, wet, soaked</li></ol>
blo|blavas|blava|blos	<i>adj</i><br><ol><li>(Sutsilvan, Surmiran) blue</li></ol>
blov|blova|blovas|blovs	<i>adj</i><br><ol><li>(Puter) blue</li></ol>
blovaint|blovaints|blovainta|blovaintas	<i>adj</i><br><ol><li>(Sutsilvan, Puter) bluish (having a blue tint or hue)</li></ol>
boffar	<i>verb</i><br><ol><li>(Vallader) to blow</li></ol>
bogn|bogns	<i>noun</i><br><ol><li>(Rumantsch Grischun, Sursilvan, Sutsilvan, Surmiran, Vallader) bath, bathroom</li><li>(Rumantsch Grischun, Sursilvan, Sutsilvan, Surmiran, Vallader) swimming pool</li></ol>
bora|boras	<i>noun</i><br><ol><li>(sports, Surmiran) ball</li></ol>
bos-ch|bos-cha|bos-chs	<i>noun</i><br><ol><li>(Vallader) tree</li></ol>
bov|bovs	<i>noun</i><br><ol><li>ox</li></ol>
braschlet|braschlets	<i>noun</i><br><ol><li>(Vallader) bracelet, watchstrap</li></ol>
braslet|braslets	<i>noun</i><br><ol><li>(Puter) bracelet, watchstrap</li></ol>
bratsch|bratschs	<i>noun</i><br><ol><li>(anatomy) arm</li></ol>
bratschalet|bratschalets	<i>noun</i><br><ol><li>(Surmiran) bracelet, watchstrap</li></ol>
bratschelet|bratschelets	<i>noun</i><br><ol><li>(Sursilvan, Sutsilvan) bracelet, watchstrap</li></ol>
bratschlet|bratschlets	<i>noun</i><br><ol><li>(Rumantsch Grischun, Surmiran) bracelet, watchstrap</li></ol>
breav|breavs	<i>noun</i><br><ol><li>(Sutsilvan) letter (written note)</li></ol>
bregn|bregns|bregnas|bregna	<i>adj</i><br><ol><li>(Sutsilvan, Surmiran) brown</li></ol>
brev|brevs	<i>noun</i><br><ol><li>letter (written message)</li></ol>
brin|brinas|brina|brins	<i>adj</i><br><ol><li>(Rumantsch Grischun, Sursilvan) brown</li></ol>
brümbla|brümblas	<i>noun</i><br><ol><li>(Vallader) prune</li></ol>
brün|brüna|brünas|brüns	<i>adj</i><br><ol><li>(Puter, Vallader) brown</li></ol>
buc	<i>adv</i><br><ol><li>(Sursilvan) not</li></ol>
buca	<i>adv</i><br><ol><li>(Sursilvan) not</li></ol>
bufar	<i>verb</i><br><ol><li>(Sutsilvan) to blow</li></ol>
buffar	<i>verb</i><br><ol><li>(Rumantsch Grischun, Sursilvan) to blow</li></ol>
buffer	<i>verb</i><br><ol><li>(Puter) to blow</li></ol>
bula|bulas	<i>noun</i><br><ol><li>(Sursilvan, Sutsilvan) butterfly, moth</li></ol>
bunmarcho	<i>adj</i><br><ol><li>(Puter) cheap (low in price)</li></ol>
bunmarchà	<i>adj</i><br><ol><li>(Vallader) cheap (low in price)</li></ol>
bunmartgea|bunmartgedas|bunmartgeda|bunmartgeas	<i>adj</i><br><ol><li>(Surmiran) cheap (low in price)</li></ol>
bunmartgà|bunmartgàs|bunmartgada|bunmartgadas	<i>adj</i><br><ol><li>(Rumantsch Grischun) cheap (low in price)</li></ol>
buob|buobs	<i>noun</i><br><ol><li>boy</li></ol>
buorsa|buorsas	<i>noun</i><br><ol><li>(Sursilvan, Puter, Vallader) purse</li><li>(Sursilvan, Puter, Vallader) exchange</li></ol>
bura|buras	<i>noun</i><br><ol><li>(sports, Sutsilvan) ball</li></ol>
burga	<i>noun</i><br><ol><li>(medicine, Sursilvan) diarrhea</li></ol>
bursa|bursas	<i>noun</i><br><ol><li>(Rumantsch Grischun, Sutsilvan, Surmiran) purse</li><li>(Rumantsch Grischun, Sutsilvan, Surmiran) exchange</li></ol>
bustab|bustabs	<i>noun</i><br><ol><li>(Rumantsch Grischun, Sursilvan, Sutsilvan, Surmiran) letter (of the alphabet)</li></ol>
bês-ch|bês-chs|bês-cha	<i>noun</i><br><ol><li>(Puter) sheep</li></ol>
böglia	<i>noun</i><br><ol><li>(anatomy, Puter) intestines, insides, guts</li></ol>
bös-ch|bös-chs|bös-cha	<i>noun</i><br><ol><li>(Puter, Vallader) tree</li></ol>
bùnmartgieu|bùnmartgeadas|bùnmartgieus|bùnmartgeada	<i>adj</i><br><ol><li>(Sutsilvan) cheap (low in price)</li></ol>
ca	<i>conj</i><br><ol><li>(Sutsilvan) than</li></ol>
cabina da telefon	<i>noun</i><br><ol><li>telephone booth, telephone box</li></ol>
calculader|calculaders	<i>noun</i><br><ol><li>(Rumantsch Grischun, Sursilvan) calculator</li><li>(Rumantsch Grischun, Sursilvan, uncommon) computer</li></ol>
calcular	<i>verb</i><br><ol><li>(Rumantsch Grischun, Sursilvan, Sutsilvan, Surmiran, Vallader) to calculate</li></ol>
calculatour|calculatours	<i>noun</i><br><ol><li>(Surmiran) calculator</li><li>(Surmiran, uncommon) computer</li></ol>
calculatur|calculaturs	<i>noun</i><br><ol><li>(Sutsilvan, Puter, Vallader) calculator</li><li>(Sutsilvan, Puter, Vallader, uncommon) computer</li></ol>
calculer	<i>verb</i><br><ol><li>(Puter) to calculate</li></ol>
camarad|camarads	<i>noun</i><br><ol><li>(Puter, Vallader) friend, companion, comrade</li></ol>
camarada|camaradas	<i>noun</i><br><ol><li>(Puter, Vallader) female friend, companion, comrade</li></ol>
camarat|camarats	<i>noun</i><br><ol><li>(Rumantsch Grischun) friend, companion, comrade</li></ol>
camarata|camaratas	<i>noun</i><br><ol><li>(Rumantsch Grischun) female friend, companion, comrade</li></ol>
camerat|camerats	<i>noun</i><br><ol><li>(Sursilvan) friend, companion, comrade</li></ol>
camerata|cameratas	<i>noun</i><br><ol><li>(Sursilvan) female friend, companion, comrade</li></ol>
cametg	<i>noun</i><br><ol><li>(Sursilvan) lightning</li></ol>
caminar	<i>verb</i><br><ol><li>(Sursilvan) to walk</li></ol>
camutsch|camutschas|camutscha|camutschs	<i>noun</i><br><ol><li>(Sursilvan) chamois</li></ol>
cantar|canteies|vegnessen a cantar|conti|cantavi|cantavies|cantavas|cantau|vegnîes a cantar|vegnis a cantar|vegnan a cantar|vegnessi a cantar|cantei|vegnin a cantar|cantassen|vegnîen a cantar|cantavan|vegni a cantar|vegnel a cantar|conta|cantavel|vegn a cantar|vegness a cantar|cantass|conties|canteis|contas|cantasses|cantavien|vegns a cantar|vegnien a cantar|contel|cantassi|vegnessies a cantar|contien|vegnies a cantar|cantava|vegnessien a cantar|cantein|vegnesses a cantar|cantassies|cantassien|canteien|contan|cantond	<i>verb</i><br><ol><li>(Sursilvan, Sutsilvan, Surmiran) to sing</li></ol>
cantun|cantuns	<i>noun</i><br><ol><li>(Sursilvan) canton</li><li>(Sursilvan) corner</li></ol>
cantung|cantungs	<i>noun</i><br><ol><li>(Surmiran) canton</li><li>(Surmiran) corner</li></ol>
cantùn|cantùns	<i>noun</i><br><ol><li>(Sutsilvan) canton</li><li>(Sutsilvan) corner</li></ol>
canzun|canzuns	<i>noun</i><br><ol><li>(music, Sursilvan) song</li></ol>
canzung|canzungs	<i>noun</i><br><ol><li>(music, Surmiran) song</li></ol>
canzùn|canzùns	<i>noun</i><br><ol><li>(music, Sutsilvan) song</li></ol>
caos	<i>noun</i><br><ol><li>chaos</li></ol>
caotic|caoticas|caotica|caotics	<i>adj</i><br><ol><li>chaotic</li></ol>
capeligna|capelignas	<i>noun</i><br><ol><li>(Surmiran) helmet</li></ol>
capellina|capellinas	<i>noun</i><br><ol><li>(Sursilvan) helmet</li></ol>
capiala|capialas	<i>noun</i><br><ol><li>(Sursilvan) hat</li></ol>
capital|capitals	<i>noun</i><br><ol><li>(Sursilvan, Sutsilvan, Surmiran) capital</li></ol>
capitala|capitalas	<i>noun</i><br><ol><li>(Sursilvan, Surmiran) capital, capital city</li></ol>
carar	<i>verb</i><br><ol><li>(Sutsilvan, Surmiran) to drive</li></ol>
carn|carns	<i>noun</i><br><ol><li>(Sursilvan) meat</li></ol>
carn bov	<i>noun</i><br><ol><li>(Sursilvan) beef</li></ol>
carn piertg	<i>noun</i><br><ol><li>(Sursilvan) pork</li></ol>
carnpiertg	<i>noun</i><br><ol><li>(Sursilvan) bacon</li></ol>
carota|carotas	<i>noun</i><br><ol><li>(Sutsilvan) carrot</li></ol>
carotta|carottas	<i>noun</i><br><ol><li>(Rumantsch Grischun, Sursilvan, Surmiran, Vallader) carrot</li></ol>
carrar|carrescha	<i>verb</i><br><ol><li>(Sursilvan) to drive</li></ol>
carstgang|carstgangs	<i>noun</i><br><ol><li>(Surmiran) male human being</li></ol>
carstganga|carstgangas	<i>noun</i><br><ol><li>(Surmiran) female human being</li></ol>
carstgaun|carstgauns	<i>noun</i><br><ol><li>(Rumantsch Grischun, Sursilvan) male human being</li></ol>
carstgauna|carstgaunas	<i>noun</i><br><ol><li>(Rumantsch Grischun, Sursilvan) female human being</li></ol>
carstgàn|carstgàns	<i>noun</i><br><ol><li>(Sutsilvan) (male) human being</li></ol>
carstgàna|carstgànas	<i>noun</i><br><ol><li>(Sutsilvan) female human being</li></ol>
carvung	<i>noun</i><br><ol><li>(Surmiran) coal</li></ol>
casa|casas	<i>noun</i><br><ol><li>(Sursilvan) house</li></ol>
casc|cascs	<i>noun</i><br><ol><li>(Sutsilvan, Surmiran) helmet</li></ol>
caschiel|caschiels	<i>noun</i><br><ol><li>(Sursilvan, Sutsilvan, Surmiran, often uncountable) cheese</li></ol>
castellan|castellans	<i>noun</i><br><ol><li>(Sursilvan, Surmiran) steward, governor, overseer, sheriff, bailiff, administrator</li></ol>
castelàn|castelàns	<i>noun</i><br><ol><li>(Sutsilvan) steward, governor, overseer, sheriff, bailiff, administrator</li></ol>
castiear	<i>verb</i><br><ol><li>(Sutsilvan) to punish</li></ol>
castigiar	<i>verb</i><br><ol><li>(Sursilvan) to punish</li></ol>
castiier	<i>verb</i><br><ol><li>(Surmiran) to punish</li></ol>
catschar	<i>verb</i><br><ol><li>(Sursilvan, Sutsilvan) to hunt, go hunting</li><li>(Sursilvan, Sutsilvan) to pester, bother</li></ol>
catscher	<i>verb</i><br><ol><li>(Surmiran) to hunt, go hunting</li><li>(Surmiran) to pester, bother</li></ol>
cauliug|cauliugs	<i>noun</i><br><ol><li>(Sursilvan) capital, capital city</li></ol>
caura|cauras	<i>noun</i><br><ol><li>(Sursilvan) goat</li></ol>
cavadi|cavadials	<i>noun</i><br><ol><li>(Sursilvan, anatomy) nipple</li></ol>
cavar	<i>verb</i><br><ol><li>(Sursilvan) to dig</li></ol>
cesta|cestas	<i>noun</i><br><ol><li>(Sutsilvan) chest, trunk</li></ol>
cha	<i>conj</i><br><ol><li>(Puter, Vallader) that</li></ol><br><i>pron</i><br><ol><li>(Puter, Vallader) who, whom</li></ol>
chagna|chagnas	<i>noun</i><br><ol><li>(Puter, Vallader) female dog, bitch</li></ol>
chaista|chaistas	<i>noun</i><br><ol><li>(Puter, Vallader) chest, trunk</li></ol>
chambra|chambras	<i>noun</i><br><ol><li>(Puter) room</li></ol>
chamel|chamels	<i>noun</i><br><ol><li>camel</li></ol>
chametg	<i>noun</i><br><ol><li>(Rumantsch Grischun) lightning</li></ol>
chaminar	<i>verb</i><br><ol><li>(Rumantsch Grischun, Vallader) to walk</li><li>(Vallader) to go walking, hike, go hiking, ramble, go rambling</li></ol>
chaminer	<i>verb</i><br><ol><li>(Puter) to walk</li><li>(Puter) to go walking, hike, go hiking, ramble, go rambling</li></ol>
chamma|chammas	<i>noun</i><br><ol><li>(Puter, anatomy) leg</li></ol>
chamuotsch|chamuotschs|chamuotschas|chamuotscha	<i>noun</i><br><ol><li>(Puter, Vallader) chamois</li></ol>
chamutsch|chamutschs|chamutscha|chamutschas	<i>noun</i><br><ol><li>(Rumantsch Grischun) chamois</li></ol>
chan|chans	<i>noun</i><br><ol><li>(Vallader) (male) dog</li></ol>
chandaila|chandailas	<i>noun</i><br><ol><li>candle</li></ol>
chantar|vegness a chantar|chantass|chantais|chantias|chantava|vegns a chantar|chantia|chantas|chantai|vegnin a chantar|vegnan a chantar|chanta|chantavan|chant|chantain|chantel|vegnîen a chantar|chantavas|chantian|vegnîes a chantar|chantà|vegnesses a chantar|vegni a chantar|chantasses|chantada|vegnessen a chantar|chantan|chantond|vegnis a chantar|vegnies a chantar|chantassen|vegnien a chantar|vegnel a chantar|vegn a chantar	<i>verb</i><br><ol><li>(Rumantsch Grischun, Vallader) to sing</li></ol>
chanter	<i>verb</i><br><ol><li>(Puter) to sing</li></ol>
chantun|chantuns	<i>noun</i><br><ol><li>(Rumantsch Grischun, Puter, Vallader) canton</li><li>(Rumantsch Grischun, Puter, Vallader) corner</li></ol>
chanzun|chanzuns	<i>noun</i><br><ol><li>(music, Rumantsch Grischun, Puter, Vallader) song</li></ol>
chapella|chapellas	<i>noun</i><br><ol><li>(Rumantsch Grischun) hat</li></ol>
chapellina|chapellinas	<i>noun</i><br><ol><li>(Rumantsch Grischun) helmet</li></ol>
chapital|chapitals	<i>noun</i><br><ol><li>(Rumantsch Grischun, Vallader) capital</li></ol>
chapitala|chapitalas	<i>noun</i><br><ol><li>(Rumantsch Grischun, Vallader) capital, capital city</li></ol>
chapitela|chapitelas	<i>noun</i><br><ol><li>(Puter) capital, capital city</li></ol>
chapitêl|chapitêls	<i>noun</i><br><ol><li>(Puter) capital</li></ol>
chaplina|chaplinas	<i>noun</i><br><ol><li>(Puter, Vallader) helmet</li></ol>
chapè|chapels	<i>noun</i><br><ol><li>(Rumantsch Grischun, Puter, Vallader) hat</li></ol>
char|charas|chars|chara	<i>adj</i><br><ol><li>dear</li></ol>
charbun	<i>noun</i><br><ol><li>(Vallader) coal</li></ol>
charezza	<i>noun</i><br><ol><li>love</li></ol>
charn|charns	<i>noun</i><br><ol><li>(Rumantsch Grischun, Puter, Vallader) meat</li></ol>
charn bouv	<i>noun</i><br><ol><li>(Puter, Vallader) beef</li></ol>
charn da bouv	<i>noun</i><br><ol><li>(Puter) beef</li></ol>
charn da püerch	<i>noun</i><br><ol><li>(Puter) pork</li></ol>
charn püerch	<i>noun</i><br><ol><li>(Vallader) pork</li></ol>
charn-bov	<i>noun</i><br><ol><li>(Rumantsch Grischun) beef</li></ol>
charn-portg	<i>noun</i><br><ol><li>(Rumantsch Grischun) pork</li></ol>
charnpiertg	<i>noun</i><br><ol><li>(Rumantsch Grischun) bacon</li></ol>
charnpüerch	<i>noun</i><br><ol><li>(Puter, Vallader) bacon</li></ol>
charrar	<i>verb</i><br><ol><li>(Rumantsch Grischun) to drive</li></ol>
charta|chartas	<i>noun</i><br><ol><li>letter, card</li></ol>
charvun	<i>noun</i><br><ol><li>(Rumantsch Grischun) coal</li></ol>
chasa|chasas	<i>noun</i><br><ol><li>(Rumantsch Grischun, Vallader) house</li></ol>
chascha|chaschas	<i>noun</i><br><ol><li>(Puter) chest, trunk</li></ol>
chaschiel|chaschiels	<i>noun</i><br><ol><li>(Rumantsch Grischun, often uncountable) cheese</li></ol>
chaschöl|chaschöls	<i>noun</i><br><ol><li>(Puter, Vallader, often uncountable) cheese</li></ol>
chastellan|chastellans	<i>noun</i><br><ol><li>(Rumantsch Grischun) steward, governor, overseer, sheriff, bailiff, administrator</li></ol>
chastiar	<i>verb</i><br><ol><li>(Rumantsch Grischun, Vallader) to punish</li></ol>
chastier	<i>verb</i><br><ol><li>(Puter) to punish</li></ol>
chastlan|chastlans	<i>noun</i><br><ol><li>(Vallader) steward, governor, overseer, sheriff, bailiff, administrator</li></ol>
chastlaun|chastlauns	<i>noun</i><br><ol><li>(Puter) steward, governor, overseer, sheriff, bailiff, administrator</li></ol>
chastè|chastels	<i>noun</i><br><ol><li>(Rumantsch Grischun, Puter, Vallader) castle</li></ol>
chatscha	<i>noun</i><br><ol><li>hunting</li></ol>
chatschar	<i>verb</i><br><ol><li>(Rumantsch Grischun, Vallader) to hunt, go hunting</li><li>(Rumantsch Grischun, Vallader) to pester, bother</li></ol>
chatscher	<i>verb</i><br><ol><li>(Puter) to hunt, go hunting</li><li>(Puter) to pester, bother</li></ol>
chau|chaus	<i>noun</i><br><ol><li>(anatomy, Rumantsch Grischun) head</li></ol>
chaun|chauns	<i>noun</i><br><ol><li>(Rumantsch Grischun, Puter) (male) dog</li></ol>
chaura|chauras	<i>noun</i><br><ol><li>(Rumantsch Grischun) goat</li></ol>
chavadè|chavadels	<i>noun</i><br><ol><li>(anatomy, Rumantsch Grischun, Vallader) nipple</li></ol>
chaval|chavals	<i>noun</i><br><ol><li>horse</li><li>(chess) knight</li></ol>
chavar	<i>verb</i><br><ol><li>(Vallader) to dig</li></ol>
chavdè|chavdels	<i>noun</i><br><ol><li>(anatomy, Puter) nipple</li></ol>
chavel|chavels	<i>noun</i><br><ol><li>(single strand of) hair</li></ol>
chavels	<i>noun</i><br><ol><li>hair (mass noun)</li></ol>
chaver	<i>verb</i><br><ol><li>(Puter) to dig</li></ol>
chavra|chavras	<i>noun</i><br><ol><li>(Vallader) goat</li></ol>
che	<i>conj</i><br><ol><li>(Rumantsch Grischun, Sursilvan) that</li><li>(Rumantsch Grischun, Sursilvan) than</li></ol><br><i>pron</i><br><ol><li>(Rumantsch Grischun, Sursilvan) who, whom</li><li>(Puter, Vallader) what</li></ol>
chesa|chesas	<i>noun</i><br><ol><li>(Puter) house</li></ol>
cheu|cheus	<i>noun</i><br><ol><li>(anatomy, Vallader) head</li></ol>
chevra|chevras	<i>noun</i><br><ol><li>(Puter) goat</li></ol>
chintader|chintaders	<i>noun</i><br><ol><li>(Surmiran) calculator</li></ol>
chintar	<i>verb</i><br><ol><li>(Surmiran) to reckon</li></ol>
chista|chistas	<i>noun</i><br><ol><li>(Rumantsch Grischun, Sursilvan, Surmiran) chest, trunk</li></ol>
cho|chos	<i>noun</i><br><ol><li>(anatomy, Puter) head</li></ol>
chogna|chognas	<i>noun</i><br><ol><li>(Rumantsch Grischun) female dog, bitch</li></ol>
chombra|chombras	<i>noun</i><br><ol><li>(Rumantsch Grischun, Vallader) room</li></ol>
chomma|chommas	<i>noun</i><br><ol><li>(Rumantsch Grischun, Vallader, anatomy) leg</li></ol>
chucal|chucals	<i>noun</i><br><ol><li>(Vallader) pig</li></ol>
chüralla|chürallas	<i>noun</i><br><ol><li>(Puter) butterfly, moth</li></ol>
cigaretta|cigarettas	<i>noun</i><br><ol><li>(Rumantsch Grischun, Sursilvan, Surmiran, Puter, Vallader) cigarette</li></ol>
cign|cigns	<i>noun</i><br><ol><li>swan</li></ol>
citad|citads	<i>noun</i><br><ol><li>(Rumantsch Grischun) city</li></ol>
cited|citeds	<i>noun</i><br><ol><li>(Puter) city</li></ol>
citrona|citronas	<i>noun</i><br><ol><li>lemon</li></ol>
cità|citats	<i>noun</i><br><ol><li>(Vallader) city</li></ol>
clamar	<i>verb</i><br><ol><li>(Rumantsch Grischun, Sursilvan, Sutsilvan, Surmiran) to call</li></ol>
clamer	<i>verb</i><br><ol><li>(Puter) to call</li></ol>
clar|claras|clara|clars	<i>adj</i><br><ol><li>(Sursilvan) clear, light</li><li>(Sursilvan) light-coloured, fair</li></ol>
clar d'iev	<i>noun</i><br><ol><li>(Sursilvan) egg white, albumen</li></ol>
clav|clavs	<i>noun</i><br><ol><li>(Rumantsch Grischun, Sursilvan, Sutsilvan, Surmiran, Vallader) key</li></ol>
cler|clera|clers|cleras	<i>adj</i><br><ol><li>(Rumantsch Grischun, Sutsilvan, Surmiran, Puter, Vallader) clear, light</li><li>(Rumantsch Grischun, Sutsilvan, Surmiran, Puter, Vallader) light-coloured, fair</li></ol>
cler d'ov	<i>noun</i><br><ol><li>(Sutsilvan, Surmiran) egg white, albumen</li></ol>
cler d'öv	<i>noun</i><br><ol><li>(Puter, Vallader) egg white, albumen</li></ol>
clev|clevs	<i>noun</i><br><ol><li>(Puter) key</li></ol>
clomar	<i>verb</i><br><ol><li>(Vallader) to call</li></ol>
clucher|cluchers	<i>noun</i><br><ol><li>(architecture, Puter, Vallader) steeple, bell tower, belfry</li></ol>
clutger|clutgers	<i>noun</i><br><ol><li>(architecture, Rumantsch Grischun, Sursilvan, Sutsilvan, Surmiran) steeple, bell tower, belfry</li></ol>
co	<i>conj</i><br><ol><li>(Vallader) than</li></ol>
codesch|codeschs	<i>noun</i><br><ol><li>(Surmiran) book</li></ol>
cogna|cognas	<i>noun</i><br><ol><li>(Sursilvan) female dog, bitch</li></ol>
colavuratur|colavuraturs	<i>noun</i><br><ol><li>(Sutsilvan) male associate, colleague</li></ol>
colavuratura|colavuraturas	<i>noun</i><br><ol><li>(Sutsilvan) female associate, colleague</li></ol>
collaboratour|collaboratours	<i>noun</i><br><ol><li>(Surmiran) (male) associate, colleague</li></ol>
collaboratoura|collaboratouras	<i>noun</i><br><ol><li>(Surmiran) female associate, colleague</li></ol>
collaboratur|collaboraturs	<i>noun</i><br><ol><li>(Sursilvan) (male) associate, colleague</li></ol>
collaboratura|collaboraturas	<i>noun</i><br><ol><li>(Sursilvan) female associate, colleague</li></ol>
collavuratur|collavuraturs	<i>noun</i><br><ol><li>(Rumantsch Grischun, Puter, Vallader) (male) associate, colleague</li></ol>
collavuratura|collavuraturas	<i>noun</i><br><ol><li>(Rumantsch Grischun, Puter, Vallader) female associate, colleague</li></ol>
colluvrer|colluvrers	<i>noun</i><br><ol><li>(Sursilvan) (male) associate, colleague</li></ol>
colluvrera|colluvreras	<i>noun</i><br><ol><li>(Sursilvan) female associate, colleague</li></ol>
columba|columbas	<i>noun</i><br><ol><li>dove, pigeon</li></ol>
comba|combas	<i>noun</i><br><ol><li>(Sursilvan, anatomy) leg</li></ol>
combra|combras	<i>noun</i><br><ol><li>(Sursilvan, Sutsilvan) room</li></ol>
computer|computers	<i>noun</i><br><ol><li>computer</li></ol>
consorta|consortas	<i>noun</i><br><ol><li>(Rumantsch Grischun, Sursilvan, Surmiran) wife, spouse</li></ol>
contemplar|contempleien|contempla|contempleis|contemplada|contempleies|contemplia|vegnel a contemplar|contemplà|contemplies|vegni a contemplar|contemplias|vegnin a contemplar|contemplain|vegnîes a contemplar|contemplavien|vegnessi a contemplar|contemplassen|contemplei|contempl|contemplai|contemplian|contemplais|contemplass|contemplavan|vegnis a contemplar|contemplava|vegness a contemplar|vegnien a contemplar|vegnan a contemplar|vegn a contemplar|vegnîen a contemplar|contemplassi|contemplavies|contemplein|contemplan|vegns a contemplar|vegnesses a contemplar|contemplasses|contempli|contemplau|vegnessien a contemplar|vegnessies a contemplar|contemplas|vegnessen a contemplar|contemplien|vegnies a contemplar|contemplassien|contemplassies|contemplavas|contemplel|contemplond|contemplavel|contemplavi	<i>verb</i><br><ol><li>(Sursilvan, Rumantsch Grischun, Sutsilvan, Surmiran, Puter, Vallader) to contemplate</li><li>(Sursilvan, Rumantsch Grischun, Sutsilvan, Surmiran, Puter, Vallader) to observe</li></ol>
convenziunal|convenziunala|convenziunals|convenziunalas	<i>adj</i><br><ol><li>(Rumantsch Grischun, Sursilvan, Sutsilvan, Surmiran, Vallader) conventional</li></ol>
convenziunel|convenziunelas|convenziunels|convenziunela	<i>adj</i><br><ol><li>(Puter) conventional</li></ol>
cor|cors	<i>noun</i><br><ol><li>(anatomy) heart</li></ol>
cordial	<i>adj</i><br><ol><li>sincere</li><li>cordial</li></ol>
cordialmain	<i>adv</i><br><ol><li>(Rumantsch Grischun, Sursilvan) sincerely, cordially</li></ol>
cordialmaing	<i>adv</i><br><ol><li>(Vallader) sincerely, cordially</li></ol>
cordialmaintg	<i>adv</i><br><ol><li>(Surmiran) sincerely, cordially</li></ol>
cordialmeing	<i>adv</i><br><ol><li>(Sutsilvan) sincerely, cordially</li></ol>
cordielmaing	<i>adv</i><br><ol><li>(Puter) sincerely, cordially</li></ol>
corean|coreanas|coreans|coreana	<i>adj</i><br><ol><li>Korean</li></ol><br><i>name</i><br><ol><li>the Korean language</li></ol>
corp|corps	<i>noun</i><br><ol><li>(anatomy) body</li></ol>
corv|corvs	<i>noun</i><br><ol><li>raven</li></ol>
cot|cots	<i>noun</i><br><ol><li>(Rumantsch Grischun) rooster</li></ol>
cotgel	<i>noun</i><br><ol><li>(Rumantsch Grischun) coal</li></ol>
cotgla	<i>noun</i><br><ol><li>(Sursilvan, Sutsilvan) coal</li></ol>
cotschen|cotschena|cotschens|cotschenas|cotschen otschna	<i>adj</i><br><ol><li>(Rumantsch Grischun, Sutsilvan, Surmiran, Puter, Vallader) red</li></ol>
crap|craps	<i>noun</i><br><ol><li>stone</li></ol>
cravun	<i>noun</i><br><ol><li>(Puter) coal</li></ol>
creivel|creivels	<i>noun</i><br><ol><li>(Surmiran) kestrel</li></ol>
cribel|cribels	<i>noun</i><br><ol><li>(Vallader) kestrel</li></ol>
cridar	<i>verb</i><br><ol><li>(Rumantsch Grischun, Sutsilvan, Vallader) to call</li></ol>
crider	<i>verb</i><br><ol><li>(Puter) to call</li></ol>
crivel|crivels	<i>noun</i><br><ol><li>(Rumantsch Grischun, Sursilvan, Sutsilvan) kestrel</li></ol>
crodar	<i>verb</i><br><ol><li>(Vallader) to fall (over)</li></ol>
crudar	<i>verb</i><br><ol><li>(Rumantsch Grischun, Surmiran) to fall (over)</li></ol>
cruder	<i>verb</i><br><ol><li>(Puter) to fall (over)</li></ol>
cu	<i>conj</i><br><ol><li>(Puter) than</li></ol>
cuc|cucs	<i>noun</i><br><ol><li>(Surmiran) nap</li></ol>
cucumer|cucumers	<i>noun</i><br><ol><li>(Puter, Vallader) cucumber</li></ol>
cucumera|cucumeras	<i>noun</i><br><ol><li>(Rumantsch Grischun, Sursilvan, Sutsilvan, Surmiran) cucumber</li></ol>
cudesch|cudeschs	<i>noun</i><br><ol><li>(Rumantsch Grischun, Sutsilvan, Puter, Vallader) book</li></ol>
cudisch|cudischs	<i>noun</i><br><ol><li>(Sursilvan) book</li></ol>
cumanzamaint|cumanzamaints	<i>noun</i><br><ol><li>(Puter, Vallader) start</li></ol>
cumanzar	<i>verb</i><br><ol><li>(Rumantsch Grischun, Vallader) to start</li></ol>
cumanzer	<i>verb</i><br><ol><li>(Puter) to start</li></ol>
cumarat|cumarats	<i>noun</i><br><ol><li>(Sutsilvan) friend, companion, comrade</li></ol>
cumarata|cumaratas	<i>noun</i><br><ol><li>(Sutsilvan) female friend, companion, comrade</li></ol>
cumbat|cumbats	<i>noun</i><br><ol><li>fight, combat</li></ol>
cumbata|cumbatas	<i>noun</i><br><ol><li>(Sutsilvan) fight, combat</li></ol>
cumenzament|cumenzaments	<i>noun</i><br><ol><li>(Rumantsch Grischun) start</li></ol>
cumin|cumins	<i>noun</i><br><ol><li>(Rumantsch Grischun) village</li></ol>
cumpagn|cumpagns	<i>noun</i><br><ol><li>(Puter) friend, companion, comrade</li></ol>
cumpagna|cumpagnas	<i>noun</i><br><ol><li>(Puter) female friend, companion, comrade</li></ol>
cumpogn|cumpogns	<i>noun</i><br><ol><li>(Rumantsch Grischun, Sursilvan, Surmiran, Vallader) friend, companion, comrade</li></ol>
cumpogna|cumpognas	<i>noun</i><br><ol><li>(Rumantsch Grischun, Sursilvan, Surmiran, Vallader) female friend, companion, comrade</li></ol>
cumprar|vegnien a cumprar|vegni a cumprar|cumprassen|vegnies a cumprar|cumpravien|cumprà|cumpran|cumpreien|vegnessi a cumprar|cumprel|cumpria|cumprada|cumprass|cumpravies|vegns a cumprar|vegnîen a cumprar|cumprais|cumprava|vegness a cumprar|cumprian|vegnis a cumprar|vegnessien a cumprar|cumpravas|cumprien|vegnel a cumprar|vegn a cumprar|cumpravel|cumpras|cumpries|vegnîes a cumprar|cumpreies|cumprain|vegnesses a cumprar|cumprein|cumprasses|cumpravi|cumprassien|cumprai|vegnessen a cumprar|vegnin a cumprar|vegnessies a cumprar|cumpri|cumpravan|cumprond|vegnan a cumprar|cumprau|cumpr|cumprias|cumprassi|cumpra|cumprei|cumprassies|cumpreis	<i>verb</i><br><ol><li>(Sursilvan, Rumantsch Grischun, Sutsilvan, Surmiran, Vallader) to buy, purchase</li></ol>
cumün|cumüns	<i>noun</i><br><ol><li>(Vallader) village</li></ol>
cundiziunal|cundiziunals|cundiziunalas|cundiziunala	<i>adj</i><br><ol><li>conditional</li></ol>
cunfin|cunfins	<i>noun</i><br><ol><li>boundary, limit</li></ol>
cunigl|cunigls	<i>noun</i><br><ol><li>(Rumantsch Grischun) rabbit</li></ol>
cunluvrader|cunluvraders	<i>noun</i><br><ol><li>(Sutsilvan) (male) associate, colleague</li></ol>
cunluvradra|cunluvradras	<i>noun</i><br><ol><li>(Sutsilvan) female associate, colleague</li></ol>
cunsorta|cunsortas	<i>noun</i><br><ol><li>(Sutsilvan) wife, spouse</li></ol>
cuntel|cuntels	<i>noun</i><br><ol><li>(Surmiran) knife</li></ol>
cunti|cunteals|cuntials	<i>noun</i><br><ol><li>(Sursilvan) knife</li><li>(Sutsilvan) knife</li></ol>
cuntè|cuntels	<i>noun</i><br><ol><li>(Rumantsch Grischun) knife</li></ol>
cupid|cupids	<i>noun</i><br><ol><li>(Rumantsch Grischun, Sursilvan, Sutsilvan, Puter, Vallader) nap</li></ol>
cupidada|cupidadas	<i>noun</i><br><ol><li>(Surmiran) nap</li></ol>
curdar|curdassi|curdassen|vegn a curdar|vegni a curdar|curdassien|curdavien|crodan|crodies|curdau|curdass|curdeis|vegnis a curdar|curdavies|vegnîen a curdar|vegns a curdar|curdond|curdavel|vegnessen a curdar|vegnessi a curdar|curdeien|crodel|curdavas|vegnessies a curdar|curdavan|crodien|vegnîes a curdar|crodas|vegnessien a curdar|vegnies a curdar|croda|vegnan a curdar|curdasses|vegnesses a curdar|curdeies|curdein|vegnin a curdar|vegnel a curdar|curdavi|vegnien a curdar|curdassies|curdava|curdei|crodi|vegness a curdar	<i>verb</i><br><ol><li>(Sursilvan, Sutsilvan) to fall (over)</li></ol>
curider|curiders	<i>noun</i><br><ol><li>(Sutsilvan) runner</li><li>(Sutsilvan, chess) bishop</li></ol>
currider|curriders	<i>noun</i><br><ol><li>runner</li><li>(chess) bishop</li></ol>
curridur|curridurs	<i>noun</i><br><ol><li>(Puter, Vallader) runner</li><li>(Puter, Vallader, chess) bishop</li></ol>
currieder|currieders	<i>noun</i><br><ol><li>(Surmiran) runner</li></ol>
currier|curriers	<i>noun</i><br><ol><li>(Surmiran, chess) bishop</li></ol>
curtgegn|curtgegns	<i>noun</i><br><ol><li>(Sutsilvan) garden, orchard</li></ol>
curtgign|curtgigns	<i>noun</i><br><ol><li>(Surmiran) garden, orchard</li></ol>
curtgin|curtgins	<i>noun</i><br><ol><li>(Sursilvan) garden, orchard</li></ol>
curtin|curtins	<i>noun</i><br><ol><li>(Rumantsch Grischun, Puter, Vallader) garden, orchard</li></ol>
curtè|curtels	<i>noun</i><br><ol><li>(Puter, Vallader) knife</li></ol>
cuschina|cuschinas	<i>noun</i><br><ol><li>kitchen</li></ol>
cuser	<i>verb</i><br><ol><li>(Rumantsch Grischun, Sursilvan, Sutsilvan, Surmiran) to sew</li></ol>
cusir	<i>verb</i><br><ol><li>(Puter, Vallader) to sew</li></ol>
custab|custabs	<i>noun</i><br><ol><li>(Puter, Vallader) letter (of the alphabet)</li></ol>
da	<i>prep</i><br><ol><li>of, from</li><li>about</li></ol>
da notg	<i>adv</i><br><ol><li>at night</li></ol>
dadains	<i>noun</i><br><ol><li>(anatomy, Puter) intestines, insides, guts</li></ol>
daint|daints	<i>noun</i><br><ol><li>(anatomy, Sutsilvan, Surmiran, Puter, Vallader) tooth</li></ol>
damanaivel	<i>adv</i><br><ol><li>(Rumantsch Grischun, Sursilvan) near, not far away from</li></ol>
damanevel	<i>adv</i><br><ol><li>(Sutsilvan, Surmiran) near, not far away from</li></ol>
damaun|damauns	<i>adv</i><br><ol><li>tomorrow</li></ol><br><i>noun</i><br><ol><li>tomorrow</li></ol>
damena ca	<i>conj</i><br><ol><li>(Sutsilvan) because, since</li></ol>
daner|daners	<i>noun</i><br><ol><li>(Vallader) money</li></ol>
daners	<i>noun</i><br><ol><li>(Rumantsch Grischun, Sursilvan, Sutsilvan, Surmiran) money</li></ol>
daniev	<i>adv</i><br><ol><li>(Sursilvan) again, once more, once again, anew</li></ol>
danievmeing	<i>adv</i><br><ol><li>(Sutsilvan) again, once more, once again, anew</li></ol>
danovamain	<i>adv</i><br><ol><li>(Rumantsch Grischun, Sursilvan) again, once more, once again, anew</li></ol>
danovamaintg	<i>adv</i><br><ol><li>(Surmiran) again, once more, once again, anew</li></ol>
danovmeing	<i>adv</i><br><ol><li>(Sutsilvan) again, once more, once again, anew</li></ol>
danöv	<i>adv</i><br><ol><li>(Puter, Vallader) again, once more, once again, anew</li></ol>
danövmaing	<i>adv</i><br><ol><li>(Puter, Vallader) again, once more, once again, anew</li></ol>
dar|dat|dettien|deien|vegnîen a dar|vegnessi a dar|dess|vegnien a dar|dend|davas|dai|dei|dass|vegn a dar|dattan|deies|davies|dain|dais|deis|dassien|davan|detti|dessen|dassen|vegnin a dar|vegns a dar|devan|dà|deva|devas|vegnel a dar|dau|davien|vegnis a dar|vegnesses a dar|dun|desses|vegnessies a dar|davi|dein|vegnies a dar|dettian|dassies|vegni a dar|dasses|dassi|dettias|vegnan a dar|vegnîes a dar|vegnessien a dar|davel|vegnessen a dar|dava|dettia|detties|vegness a dar|das	<i>verb</i><br><ol><li>(Rumantsch Grischun, Sursilvan, Surmiran, Puter, Vallader) to give</li></ol>
darcheu	<i>adv</i><br><ol><li>(Vallader) again</li></ol>
darcho	<i>adv</i><br><ol><li>(Puter) again</li></ol>
darveir	<i>verb</i><br><ol><li>(Surmiran) to open</li></ol>
dastrusch|dastruschs|dastruschas|dastruscha	<i>adj</i><br><ol><li>(Vallader) near, not far away from</li></ol>
davos	<i>prep</i><br><ol><li>behind</li></ol>
de|des	<i>noun</i><br><ol><li>(Surmiran) day</li></ol>
december	<i>name</i><br><ol><li>(Rumantsch Grischun, Sursilvan, Surmiran, Puter, Vallader) December</li></ol>
definit|definita|definits|definitas	<i>adj</i><br><ol><li>definite</li></ol>
deir|deira|deirs|deiras	<i>adj</i><br><ol><li>(Surmiran) hard</li></ol><br><i>verb</i><br><ol><li>(Surmiran) to say</li></ol><br><i>noun</i><br><ol><li>(anatomy, Surmiran) liver</li></ol>
deir manzignas	<i>verb</i><br><ol><li>(Surmiran) to lie, tell lies</li></ol>
deisa|deisas	<i>noun</i><br><ol><li>(Surmiran) habit, custom</li></ol>
delfin|delfins	<i>noun</i><br><ol><li>dolphin</li></ol>
dent|dents	<i>noun</i><br><ol><li>(anatomy, Rumantsch Grischun, Sursilvan) tooth</li></ol>
desch	<i>num</i><br><ol><li>(Puter, Vallader) ten</li></ol>
deschdotg	<i>num</i><br><ol><li>(Rumantsch Grischun) eighteen</li></ol>
deschnov	<i>num</i><br><ol><li>(Rumantsch Grischun) nineteen</li></ol>
deschset	<i>num</i><br><ol><li>(Rumantsch Grischun) seventeen</li></ol>
dessert|desserts	<i>noun</i><br><ol><li>(Rumantsch Grischun, Sursilvan, Sutsilvan, Surmiran, Puter, Vallader) dessert</li></ol>
det|dets	<i>noun</i><br><ol><li>(anatomy) finger</li></ol>
dezember	<i>name</i><br><ol><li>(Sutsilvan) December</li></ol>
di|dis	<i>noun</i><br><ol><li>(Rumantsch Grischun, Sursilvan, Puter, Vallader) day</li></ol>
diamant|diamants	<i>noun</i><br><ol><li>(mineralogy, gemstone, Rumantsch Grischun, Sursilvan, Surmiran, Puter, Vallader) diamond</li></ol>
diamànt|diamànts	<i>noun</i><br><ol><li>(mineralogy, Sutsilvan) diamond</li><li>(gemstone, Sutsilvan) diamond</li></ol>
diarea	<i>noun</i><br><ol><li>(medicine, Sutsilvan) diarrhea</li></ol>
diarrea	<i>noun</i><br><ol><li>(medicine, Rumantsch Grischun, Sursilvan, Surmiran, Puter, Vallader) diarrhea</li></ol>
dicziunari|dicziunaris	<i>noun</i><br><ol><li>dictionary</li></ol>
dies	<i>noun</i><br><ol><li>(anatomy) back</li></ol>
diesch	<i>num</i><br><ol><li>(Rumantsch Grischun, Sursilvan, Sutsilvan, Surmiran) ten</li></ol>
dieu|dieus	<i>noun</i><br><ol><li>god</li></ol>
dignitad	<i>noun</i><br><ol><li>(Rumantsch Grischun, Sursilvan, Sutsilvan, Surmiran) dignity</li></ol>
dignited	<i>noun</i><br><ol><li>(Puter) dignity</li></ol>
dignità	<i>noun</i><br><ol><li>(Vallader) dignity</li></ol>
dir|vegnel a dir|ditg|schevas|devi|schessen|vegnien a dir|scheien|dis|vegnesses a dir|dend|vegnies a dir|vegnessien a dir|schai|detg|dia|vegnessi a dir|scheies|diras|schend|devies|deva|di|devan|dias|ditgi|vegnîes a dir|devas|schais|schein|schevan|schesses|vegn a dir|dian|ditgel|scheis|schessi|devel|scheva|schessies|din|schessien|vegnis a dir|schain|schess|vegnessen a dir|vegni a dir|vegnan a dir|dirs|vegnîen a dir|devien|ditgien|vegns a dir|vegnessies a dir|dira|ditgies|schei|vegness a dir|vegnin a dir	<i>adj</i><br><ol><li>(Sursilvan, Sutsilvan, Rumantsch Grischun) hard</li></ol><br><i>verb</i><br><ol><li>to say</li></ol><br><i>noun</i><br><ol><li>(anatomy, Rumantsch Grischun, Sursilvan, Sutsilvan) liver</li></ol>
dir manzegnas	<i>verb</i><br><ol><li>(Rumantsch Grischun, Sursilvan) to lie, tell lies</li></ol>
dir manzögnas	<i>verb</i><br><ol><li>(Puter, Vallader) to lie, tell lies</li></ol>
direcziun|direcziuns	<i>noun</i><br><ol><li>(Rumantsch Grischun, Sursilvan, Surmiran, Puter, Vallader) direction; compass point</li></ol>
direcziùn|direcziùns	<i>noun</i><br><ol><li>(Sutsilvan) direction; compass point</li></ol>
disa|disas	<i>noun</i><br><ol><li>(Rumantsch Grischun, Sursilvan, Sutsilvan) habit, custom</li></ol>
distant|distantas|distants|distanta	<i>adj</i><br><ol><li>(Puter) distant, remote, faraway</li></ol>
doltsch|doltschas|doltscha|doltschs	<i>adj</i><br><ol><li>(Surmiran) sweet</li></ol>
dolur|dolurs	<i>noun</i><br><ol><li>(Rumantsch Grischun, Sursilvan, Vallader) pain, ache</li></ol>
dovrar	<i>verb</i><br><ol><li>(Vallader) to use, need</li></ol>
dret|dretta|drettas|drets	<i>noun</i><br><ol><li>(law, Puter, Vallader) law</li></ol><br><i>adj</i><br><ol><li>(Puter, Vallader) right (direction)</li></ol>
dretg|dretgas|dretga|dretgs	<i>noun</i><br><ol><li>(law, Rumantsch Grischun, Sursilvan, Sutsilvan, Surmiran) law</li></ol><br><i>adj</i><br><ol><li>(Rumantsch Grischun, Sursilvan, Sutsilvan, Surmiran) right (direction)</li><li>(Surmiran) right, proper, correct</li></ol>
drivir	<i>verb</i><br><ol><li>(Vallader) to open</li></ol>
druver	<i>verb</i><br><ol><li>(Puter) to use, need</li></ol>
dschelar	<i>verb</i><br><ol><li>(Vallader) to freeze (intransitive), be cold, feel (very) cold, feel freezing</li><li>(Vallader) to freeze (transitive), chill</li></ol>
dschember	<i>name</i><br><ol><li>(Puter, Vallader) arolla pine, Pinus cembra</li></ol>
dschler	<i>verb</i><br><ol><li>(Puter) to freeze (intransitive), be cold, feel (very) cold, feel freezing</li><li>(Puter) to freeze (transitive), chill</li></ol>
duas|dus	<i>num</i><br><ol><li>(Rumantsch Grischun, Sursilvan, Sutsilvan) two</li></ol>
dudesch	<i>num</i><br><ol><li>(Rumantsch Grischun, Puter) twelve</li></ol>
dudir	<i>verb</i><br><ol><li>(Vallader) to hear</li></ol>
dultsch|dultscha|dultschas|dultschs	<i>adj</i><br><ol><li>(Rumantsch Grischun, Sursilvan, Sutsilvan) sweet</li></ol><br><i>noun</i><br><ol><li>(Sutsilvan) dessert</li></ol>
dultschems	<i>noun</i><br><ol><li>(Sursilvan, Sutsilvan, Surmiran) candy, sweets, confectionery</li></ol>
dultschezias	<i>noun</i><br><ol><li>(Sutsilvan) candy, sweets, confectionery</li></ol>
dultschims	<i>noun</i><br><ol><li>(Rumantsch Grischun) candy, sweets, confectionery</li></ol>
dumeingia|dumeingias	<i>noun</i><br><ol><li>(Sutsilvan) Sunday</li></ol>
dumengia|dumengias	<i>noun</i><br><ol><li>(Rumantsch Grischun, Sursilvan, Surmiran, Puter, Vallader) Sunday</li></ol><br><i>adv</i><br><ol><li>(Rumantsch Grischun, Sursilvan, Surmiran, Puter, Vallader) on Sunday</li></ol>
dumia	<i>noun</i><br><ol><li>(Surmiran) barley</li></ol>
dumonda|dumondas	<i>noun</i><br><ol><li>question</li></ol>
duncrir	<i>verb</i><br><ol><li>(Sutsilvan) to look up, look for, search, seek</li></ol>
dunna|dunnas	<i>noun</i><br><ol><li>(Rumantsch Grischun, Sursilvan) woman</li><li>(Rumantsch Grischun, Sursilvan) wife</li><li>(Rumantsch Grischun, Sursilvan) lady, Mrs.</li></ol>
duos	<i>num</i><br><ol><li>(Puter, Vallader) two</li></ol>
durmeidetta|durmeidettas	<i>noun</i><br><ol><li>(Surmiran) nap</li></ol>
durmeir	<i>verb</i><br><ol><li>(Surmiran) to sleep</li></ol>
durmida|durmidas	<i>noun</i><br><ol><li>(Rumantsch Grischun, Sursilvan) nap</li></ol>
durmir	<i>verb</i><br><ol><li>(Rumantsch Grischun, Sursilvan, Sutsilvan, Puter, Vallader) to sleep</li></ol>
dus|duas	<i>num</i><br><ol><li>(Rumantsch Grischun, Sursilvan, Sutsilvan, Surmiran) two</li></ol>
dutsch|dutschs|dutscha|dutschas	<i>adj</i><br><ol><li>(Puter, Vallader) sweet</li></ol>
dutscharias	<i>noun</i><br><ol><li>(Puter, Vallader) candy, sweets, confectionery</li></ol>
duvrar|drovel	<i>verb</i><br><ol><li>(Rumantsch Grischun, Sursilvan, Sutsilvan, Surmiran) to use, need</li><li>(Sutsilvan) to use, apply</li></ol>
duvrir	<i>verb</i><br><ol><li>(Sutsilvan) to open</li></ol>
dür|düra|düras|dürs	<i>adj</i><br><ol><li>(Puter, Vallader) hard</li></ol>
ea	<i>adv</i><br><ol><li>(Sutsilvan, Surmiran) yes (used to indicate agreement with a positive statement)</li></ol>
eamda|eamdas	<i>noun</i><br><ol><li>(Sutsilvan) week</li></ol>
eanda|eandas	<i>noun</i><br><ol><li>(Sutsilvan) week</li></ol>
earver	<i>verb</i><br><ol><li>(Sutsilvan) to open</li></ol>
easser	<i>verb</i><br><ol><li>(Sutsilvan) to be</li></ol>
eau	<i>pron</i><br><ol><li>(Puter) I</li></ol>
egl|egls	<i>noun</i><br><ol><li>(Rumantsch Grischun, Sursilvan) eye</li></ol>
egn|egna	<i>article</i><br><ol><li>(Sutsilvan, Surmiran) a, an</li></ol><br><i>num</i><br><ol><li>(Sutsilvan, Surmiran) one</li></ol>
egna|egn	<i>article</i><br><ol><li>(Sutsilvan, Surmiran) a, an</li></ol><br><i>num</i><br><ol><li>(Sutsilvan, Surmiran) one</li></ol>
eir	<i>verb</i><br><ol><li>(Surmiran) to go</li></ol>
eivna|eivnas	<i>noun</i><br><ol><li>(Puter, Vallader) week</li></ol>
el	<i>pron</i><br><ol><li>he</li></ol>
ela|elas	<i>noun</i><br><ol><li>(Puter) wing</li></ol>
elefant|elefants	<i>noun</i><br><ol><li>elephant</li></ol>
ellas	<i>pron</i><br><ol><li>they f</li></ol>
els	<i>pron</i><br><ol><li>they (masculine, common, and indeterminate gender)</li></ol>
emblidar	<i>verb</i><br><ol><li>to forget</li></ol>
emda|emdas	<i>noun</i><br><ol><li>(Surmiran) week</li></ol>
emna|emnas	<i>noun</i><br><ol><li>(Rumantsch Grischun) week</li></ol>
emploiada|emploiadas	<i>noun</i><br><ol><li>female employee</li></ol>
emploià|emploiads	<i>noun</i><br><ol><li>male employee</li></ol>
encurir|vegnel a encurir|enquerel|encuresses|encuretg|vegnies a encurir|vegnien a encurir|vegnesses a encurir|vegnessen a encurir|encurîen|enquerien|enqueras|encurevien|vegnin a encurir|encuris|enqueries|encuress|vegness a encurir|vegn a encurir|encuressi|vegnis a encurir|encuressien|vegnessi a encurir|encurin|encurevan|vegns a encurir|encurend|encurevies|encuri|encurevas|encurevi|encuriu|vegnîes a encurir|encurîes|vegni a encurir|enqueran|encuressen|vegnessien a encurir|encurevel|vegnessies a encurir|vegnîen a encurir|vegnan a encurir|enquera|enqueri|encureva|encuressies	<i>verb</i><br><ol><li>(Sursilvan) to look up, look for, search, seek</li></ol>
ensatge	<i>noun</i><br><ol><li>(Surmiran) something, anything</li></ol>
entschaiver	<i>verb</i><br><ol><li>(Rumantsch Grischun) to start</li></ol>
entschatta|entschattas	<i>noun</i><br><ol><li>start</li></ol>
entscheiver|entschiet|entscheivevien|vegnies a entscheiver|entscheivavel|entschevei|vegnîes a entscheiver|vegnîen a entscheiver|entscheveis|vegnessies a entscheiver|vegnis a entscheiver|entscheivas|entschevessen|vegnien a entscheiver|entscheiveien|entscheivien|entschevessies|entscheivevi|entschevein|vegnesses a entscheiver|vegnessi a entscheiver|vegnin a entscheiver|vegnel a entscheiver|entscheivel|entscheivies|entscheivava|vegni a entscheiver|entscheivend|vegness a entscheiver|entscheivevies|entscheiveies|vegnessien a entscheiver|entscheiva|entschevessi|entschevesses|entscheivi|vegn a entscheiver|vegns a entscheiver|entschevess|vegnessen a entscheiver|entscheivavas|entschevessien|entscheivavan|entscheivan|vegnan a entscheiver	<i>verb</i><br><ol><li>(Sursilvan) to start</li></ol>
enviern|envierns	<i>noun</i><br><ol><li>winter</li></ol>
enzatgei	<i>noun</i><br><ol><li>(Sursilvan) something, anything</li></ol>
erizun|erizuns	<i>noun</i><br><ol><li>(Rumantsch Grischun, Sursilvan) hedgehog (Erinaceus europaeus)</li></ol>
erizung|erizungs	<i>noun</i><br><ol><li>(Surmiran) hedgehog (Erinaceus europaeus)</li></ol>
erizùn|erizùns	<i>noun</i><br><ol><li>(Sutsilvan) hedgehog (Erinaceus europaeus)</li></ol>
erva	<i>noun</i><br><ol><li>grass</li></ol>
esan|esans	<i>noun</i><br><ol><li>(Puter) (male) donkey, ass</li></ol>
esna|esnas	<i>noun</i><br><ol><li>(Puter) female donkey, ass</li></ol>
esser|fussies|seigi|eis|es|erel|eries|siond|vegnessi a esser|vegnessien a esser|eri|seigies|essan|èn|fuvan|fuvies|fussi|sun|fussen|fissen|vegness a esser|vegns a esser|eran|essend|fusses|fuvi|sajan|stà|vegn a esser|seigien|stau|vegnis a esser|vegnessies a esser|fuvel|vegnesses a esser|vegnîen a esser|vegnien a esser|era|fussien|fuvien|vegnies a esser|essas|vegnel a esser|è|fuss|erien|vegnin a esser|vegni a esser|fisses|fuvas|ei|vegnessen a esser|vegnîes a esser|ein|vegnan a esser|fiss|sajas|saja|eras|fuva	<i>verb</i><br><ol><li>(Rumantsch Grischun, Sursilvan, Surmiran, Puter, Vallader) to be</li></ol>
eu	<i>pron</i><br><ol><li>(Vallader) I</li></ol>
europeic|europeicas|europeics|europeica	<i>adj</i><br><ol><li>European</li></ol>
europeica|europeic|europeicas|europeics	<i>adj</i><br><ol><li>European</li></ol>
evla|evlas	<i>noun</i><br><ol><li>eagle</li></ol>
exaimpel|exaimpels	<i>noun</i><br><ol><li>(Sutsilvan, Surmiran, Puter, Vallader) example</li></ol>
examen|examens	<i>noun</i><br><ol><li>exam</li></ol>
examen da qualificaziun|examens da qualificaziun	<i>noun</i><br><ol><li>(Rumantsch Grischun, Sursilvan, Surmiran, Puter, Vallader) aptitude test, test of ability, occupational test</li></ol>
examen da qualificaziùn|examens da qualificaziùn	<i>noun</i><br><ol><li>(Sutsilvan) aptitude test, test of ability, occupational test</li></ol>
examen final|examens finals	<i>noun</i><br><ol><li>(education, Rumantsch Grischun, Sursilvan, Sutsilvan, Surmiran, Vallader) final examination</li></ol>
examen finel|examens finels	<i>noun</i><br><ol><li>(education, Puter) final examination</li></ol>
exempel|exempels	<i>noun</i><br><ol><li>(Rumantsch Grischun, Sursilvan) example</li></ol>
fagn	<i>noun</i><br><ol><li>(Sutsilvan, Surmiran) hay</li></ol>
fai|fais	<i>noun</i><br><ol><li>faith</li></ol>
fain	<i>noun</i><br><ol><li>(Rumantsch Grischun, Puter, Vallader) hay</li></ol>
falcun|falcuns	<i>noun</i><br><ol><li>(Rumantsch Grischun, Sursilvan, Puter, Vallader) falcon</li><li>(Sursilvan) kestrel</li></ol>
falcun brün	<i>noun</i><br><ol><li>(Puter, Vallader) kestrel</li></ol>
falcung|falcungs	<i>noun</i><br><ol><li>(Surmiran) falcon</li></ol>
falcùn|falcùns	<i>noun</i><br><ol><li>(Sutsilvan) falcon</li></ol>
falien|faliens	<i>noun</i><br><ol><li>(Sursilvan) spider</li></ol>
falient|falients	<i>noun</i><br><ol><li>(Sutsilvan) spider</li></ol>
fam	<i>noun</i><br><ol><li>(Puter) hunger</li></ol>
famiglia|famiglias	<i>noun</i><br><ol><li>family</li></ol>
fanadour	<i>name</i><br><ol><li>(Surmiran) July</li></ol>
fanadur	<i>name</i><br><ol><li>(Rumantsch Grischun, Sutsilvan) July</li></ol>
fanar	<i>verb</i><br><ol><li>(Rumantsch Grischun, Sutsilvan) to make hay</li></ol>
fanestra|fanestras	<i>noun</i><br><ol><li>window</li></ol>
fantom|fantoms	<i>noun</i><br><ol><li>phantom</li></ol>
far|vegnis a far|fageien|fagessies|faschond|fagei|fagessen|vegnessi a far|faschai|fetschian|fas|fagesses|favas|faschess|fatg|faschesses|vegnessen a far|fevi|fai|vegn a far|fetschien|faschevan|vegnesses a far|vegnin a far|fetschel|fagein|fan|fevies|vegnan a far|fa|fetschi|fascheva|fageies|fevien|favan|fagend|favel|vegness a far|faschain|fageis|fetschia|fetschias|vegnien a far|fagess|vegnessien a far|vegnîes a far|faschais|vegnel a far|fagessi|fava|fagessien|fatsch|vegni a far|faschevas|faschessen|vegnîen a far|vegns a far|fetschies|vegnies a far|vegnessies a far	<i>verb</i><br><ol><li>(Rumantsch Grischun, Sursilvan, Sutsilvan, Surmiran, Vallader) to do, make</li></ol>
far cun fain	<i>verb</i><br><ol><li>(Vallader) to make hay</li></ol>
far fagn	<i>verb</i><br><ol><li>(Sutsilvan, Surmiran) to make hay</li></ol>
far fain	<i>verb</i><br><ol><li>(Rumantsch Grischun) to make hay</li></ol>
far fein	<i>verb</i><br><ol><li>(Sursilvan) to make hay</li></ol>
farbun|farbuns	<i>noun</i><br><ol><li>(Sursilvan) strawberry</li></ol>
farina|farinas	<i>noun</i><br><ol><li>(Rumantsch Grischun, Puter, Vallader) flour</li></ol>
fastedi|fastedis	<i>noun</i><br><ol><li>(Sursilvan) headache, worry, concern</li></ol>
fastidi|fastidis	<i>noun</i><br><ol><li>(Rumantsch Grischun, Sutsilvan, Surmiran, Puter, Vallader) headache, worry, concern</li></ol>
fatscha|fatschas	<i>noun</i><br><ol><li>(anatomy) face</li></ol>
faveala|favealas	<i>noun</i><br><ol><li>(Sutsilvan, poetic) language</li></ol>
favela|favelas	<i>noun</i><br><ol><li>(Surmiran, poetic) language</li></ol>
favella|favellas	<i>noun</i><br><ol><li>(Rumantsch Grischun, Puter, Vallader, poetic) language</li></ol>
faviala|favialas	<i>noun</i><br><ol><li>(Sursilvan, poetic) language</li></ol>
favrer	<i>name</i><br><ol><li>(Rumantsch Grischun, Sutsilvan, Surmiran, Puter, Vallader) February</li></ol>
fazalet|fazalets	<i>noun</i><br><ol><li>(Sursilvan, Sutsilvan) handkerchief</li></ol>
faziel|faziels	<i>noun</i><br><ol><li>(Rumantsch Grischun) handkerchief</li></ol>
faziel da nas	<i>noun</i><br><ol><li>(Surmiran) handkerchief</li></ol>
fazielet|fazielets	<i>noun</i><br><ol><li>(Rumantsch Grischun) handkerchief</li></ol>
fazöl|fazöls	<i>noun</i><br><ol><li>(Puter, Vallader) handkerchief</li></ol>
fegl|fegls	<i>noun</i><br><ol><li>(botany, Rumantsch Grischun, Sursilvan, Sutsilvan) leaf</li><li>(Rumantsch Grischun, Sursilvan) sheet (of paper)</li><li>(Sursilvan, Sutsilvan, Surmiran) son</li></ol>
feglia|feglias	<i>noun</i><br><ol><li>(Sursilvan, Sutsilvan, Surmiran) daughter</li></ol>
fegn|fegna|fegns|fegnas	<i>adj</i><br><ol><li>(Sutsilvan, Surmiran) fine</li><li>(Sutsilvan, Surmiran) end</li></ol>
feila l'ora	<i>noun</i><br><ol><li>(Surmiran) kestrel</li></ol>
fein	<i>noun</i><br><ol><li>(Sursilvan) hay</li></ol>
fem	<i>noun</i><br><ol><li>(Sursilvan, Sutsilvan, Surmiran) smoke</li></ol>
fenadur	<i>name</i><br><ol><li>(Sursilvan) July</li></ol>
fer	<i>verb</i><br><ol><li>(Puter) to do, make</li></ol>
fer cul fain	<i>verb</i><br><ol><li>(Puter) to make hay</li></ol>
ferdar	<i>verb</i><br><ol><li>(Sursilvan, transitive, followed by da) to smell (of)</li></ol>
fevrer	<i>name</i><br><ol><li>(Sursilvan) February</li></ol>
fi	<i>noun</i><br><ol><li>(Surmiran) fire</li></ol>
fia	<i>noun</i><br><ol><li>(Sutsilvan) fire</li></ol>
fiac	<i>noun</i><br><ol><li>(Sutsilvan) fire</li></ol>
fier	<i>noun</i><br><ol><li>iron</li></ol>
fiergna|fiergnas	<i>noun</i><br><ol><li>(Rumantsch Grischun, Sursilvan, Sutsilvan, Surmiran) marten</li><li>(Rumantsch Grischun, Sursilvan, Sutsilvan, Surmiran) pine marten</li></ol>
fiergna nobla|fiergna noblafiergnas noblas	<i>noun</i><br><ol><li>(Rumantsch Grischun) pine marten</li></ol>
fieu	<i>noun</i><br><ol><li>(Rumantsch Grischun) fire</li></ol>
figl|figls	<i>noun</i><br><ol><li>(botany, Sutsilvan, Surmiran) leaf</li><li>(Sutsilvan, Surmiran) sheet (of paper)</li><li>(Rumantsch Grischun, Puter, Vallader) son</li></ol>
figlia|figlias	<i>noun</i><br><ol><li>(Rumantsch Grischun, Puter, Vallader) daughter</li></ol>
filadè	<i>noun</i><br><ol><li>(Puter, Vallader) kestrel</li></ol>
filien|filiens	<i>noun</i><br><ol><li>(Rumantsch Grischun) spider</li></ol>
filunza|filunzas	<i>noun</i><br><ol><li>(Rumantsch Grischun, Surmiran) spider</li></ol>
filùn|filùns	<i>noun</i><br><ol><li>(Sutsilvan) spider</li></ol>
fim	<i>noun</i><br><ol><li>(Rumantsch Grischun) smoke</li></ol>
fimantar	<i>verb</i><br><ol><li>(Surmiran) to smoke (preserve or prepare for consumption by treating with smoke)</li></ol>
fimar|vegnin a fimar|fimassen|feman|fimeies|vegnessies a fimar|fimavien|femies|vegnis a fimar|fimass|vegness a fimar|fimeien|vegnîes a fimar|vegnan a fimar|fimei|femas|fimava|fimassies|fimeis|fema|fimavas|vegnessien a fimar|vegnessen a fimar|vegnien a fimar|fimond|vegns a fimar|fimassien|vegni a fimar|fimavel|vegnîen a fimar|vegnel a fimar|fimavan|vegnies a fimar|fimasses|vegnesses a fimar|fimavi|fimassi|femel|femien|fimein|fimau|vegnessi a fimar|vegn a fimar|femi|fimavies	<i>verb</i><br><ol><li>(Rumantsch Grischun, Sursilvan, Sutsilvan, Surmiran) to smoke (inhale and exhale the smoke from a burning cigarette, cigar, pipe, etc.)</li></ol>
fimentar	<i>verb</i><br><ol><li>(Rumantsch Grischun, Sursilvan, Sutsilvan) to smoke (preserve or prepare for consumption by treating with smoke)</li></ol>
fin|finas|fina|fins	<i>prep</i><br><ol><li>(Rumantsch Grischun, Sursilvan, Puter, Vallader) until, till</li><li>(Rumantsch Grischun, Sursilvan, Puter, Vallader) by</li></ol><br><i>conj</i><br><ol><li>(Rumantsch Grischun) until</li></ol><br><i>adv</i><br><ol><li>(Rumantsch Grischun, Sursilvan, Puter, Vallader) as far as</li></ol><br><i>adj</i><br><ol><li>(Rumantsch Grischun, Sursilvan, Puter, Vallader) fine</li><li>(Rumantsch Grischun, Sursilvan, Puter, Vallader) end</li></ol>
fio|fios	<i>noun</i><br><ol><li>(anatomy, Puter) liver</li></ol>
fistla	<i>noun</i><br><ol><li>fistula</li></ol>
fiug	<i>noun</i><br><ol><li>(Sursilvan) fire</li></ol>
flad|flads	<i>noun</i><br><ol><li>(Rumantsch Grischun, Sursilvan) breath (of air)</li></ol>
fladar	<i>verb</i><br><ol><li>(Rumantsch Grischun, Sursilvan) to breathe</li></ol>
fled|fleds	<i>noun</i><br><ol><li>(Puter) breath (of air)</li></ol>
flem|flems	<i>noun</i><br><ol><li>(Sutsilvan, Surmiran) river</li></ol>
flissiadad|flissiadads	<i>noun</i><br><ol><li>industriousness</li></ol>
flo|flos	<i>noun</i><br><ol><li>(Sutsilvan, Surmiran) breath (of air)</li></ol>
floc da naiv|flocs da naiv	<i>noun</i><br><ol><li>(Romansch Grishun, Vallader, weather) snowflake</li></ol>
floc da nev|flocs da nev	<i>noun</i><br><ol><li>(Sutsilvan, weather) snowflake</li></ol>
flocca da naiv|floccas da naiv	<i>noun</i><br><ol><li>(Romansch Grishun, weather) snowflake</li></ol>
floccar	<i>verb</i><br><ol><li>(Vallader) to snow</li></ol>
flour|flours	<i>noun</i><br><ol><li>(Surmiran) flower</li></ol>
flum|flums	<i>noun</i><br><ol><li>(Rumantsch Grischun, Sursilvan) river</li></ol>
flur|fluors|flurs	<i>noun</i><br><ol><li>(Rumantsch Grischun, Sursilvan, Sutsilvan) flower</li><li>(Puter, Vallader) flower</li></ol>
flura|fluras	<i>noun</i><br><ol><li>(Sursilvan) flower</li></ol>
flureir	<i>verb</i><br><ol><li>(Surmiran) to blossom, flower, bloom</li></ol>
flurir|vegnessien a flurir|flurîen|vegnîes a flurir|fluressien|fluris|vegnien a flurir|flureschi|flureschas|flurevan|vegnessi a flurir|flureschies|flurîes|flureschel|fluressies|vegnel a flurir|fluriu|vegnessies a flurir|vegnin a flurir|flureva|vegness a flurir|vegnesses a flurir|flurevas|vegn a flurir|flurin|vegni a flurir|fluress|vegns a flurir|vegnan a flurir|fluresses|flurevi|vegnies a flurir|flurevel|fluressen|flurevien|flureschien|fluri|flurescha|flurevies|vegnîen a flurir|vegnessen a flurir|flureschan|vegnis a flurir|flurend|fluressi	<i>verb</i><br><ol><li>(Rumantsch Grischun, Sursilvan, Sutsilvan, Puter, Vallader) to blossom, flower, bloom</li></ol>
flà|flàs	<i>noun</i><br><ol><li>(Vallader) breath (of air)</li></ol>
flöch da naiv|flöchs da naiv	<i>noun</i><br><ol><li>(Puter, weather) snowflake</li></ol>
flüm|flüms	<i>noun</i><br><ol><li>(Puter, Vallader) river</li></ol>
foira	<i>noun</i><br><ol><li>(medicine, Surmiran) diarrhea</li></ol>
fom	<i>noun</i><br><ol><li>(Rumantsch Grischun, Sursilvan, Sutsilvan, Surmiran, Vallader) hunger</li></ol>
fonetic|fonetics|fonetica|foneticas	<i>noun</i><br><ol><li>phonetic</li></ol>
fonetica|foneticas	<i>noun</i><br><ol><li>(linguistics) phonetics</li></ol>
fons	<i>noun</i><br><ol><li>(Surmiran) field, land, soil, ground.</li></ol>
forella|forellas	<i>noun</i><br><ol><li>(Puter, Vallader) trout</li></ol>
formar	<i>verb</i><br><ol><li>(Sursilvan) to shape, form</li></ol>
fotta	<i>noun</i><br><ol><li>(Puter, Vallader) anger, rage</li></ol>
fraia|fraias	<i>noun</i><br><ol><li>(Surmiran) strawberry</li></ol>
fraid|fraidas|fraids|fraida	<i>adj</i><br><ol><li>(Rumantsch Grischun, Puter, Vallader) cold</li></ol>
frais-ch|frais-cha|frais-chs|frais-chas	<i>adj</i><br><ol><li>(Vallader) cold, cool</li></ol>
fraja|frajas	<i>noun</i><br><ol><li>(Rumantsch Grischun, Sutsilvan, Vallader) strawberry</li></ol>
frar|frars	<i>noun</i><br><ol><li>(Rumantsch Grischun, Sursilvan, Sutsilvan, Surmiran, Vallader) brother</li></ol>
fras-ch|fras-cha|fras-chs|fras-chas	<i>adj</i><br><ol><li>(Puter) cold, cool</li></ol>
fred|freds|freda|fredas	<i>adj</i><br><ol><li>(Sutsilvan) cold</li></ol>
fregna|fregnas	<i>noun</i><br><ol><li>(Sutsilvan, Surmiran) flour</li></ol>
freid|freids|freida|freidas	<i>adj</i><br><ol><li>(Sursilvan, Surmiran) cold</li></ol>
freja|frejas	<i>noun</i><br><ol><li>(Puter) strawberry</li></ol>
frer|frers	<i>noun</i><br><ol><li>(Puter) brother</li></ol>
frestg|frestgs|frestgas|frestga	<i>adj</i><br><ol><li>(Rumantsch Grischun, Sursilvan, Sutsilvan, Surmiran) cold, cool</li></ol>
fretg|fretga|fretgs	<i>noun</i><br><ol><li>(botany, food, Sursilvan, Sutsilvan, Surmiran) fruit</li></ol>
frezza|frezzas	<i>noun</i><br><ol><li>(Surmiran) arrow</li></ol>
frina|frinas	<i>noun</i><br><ol><li>(Sursilvan) flour</li></ol>
fritg|fritgs|fritga	<i>noun</i><br><ol><li>(botany, food) fruit</li></ol>
frizza|frizzas	<i>noun</i><br><ol><li>(Rumantsch Grischun, Puter, Vallader) arrow</li></ol>
früt|früts|früta	<i>noun</i><br><ol><li>(botany, food, Puter, Vallader) fruit</li></ol>
fuera	<i>noun</i><br><ol><li>(medicine, Sursilvan) diarrhea</li></ol>
fuira	<i>noun</i><br><ol><li>(medicine, Rumantsch Grischun, Sutsilvan) diarrhea</li></ol>
funs	<i>noun</i><br><ol><li>(Rumantsch Grischun, Sursilvan) field, land, soil, ground</li><li>(Sutsilvan) land, soil</li></ol>
fuond|fuonds	<i>noun</i><br><ol><li>(Vallader) field, land, soil, ground</li></ol>
fuonz	<i>noun</i><br><ol><li>(Puter) field, land, soil, ground</li></ol>
fuorcha|fuorchas	<i>noun</i><br><ol><li>(Puter, Vallader) fork</li></ol>
fuorma|fuormas	<i>noun</i><br><ol><li>(Sursilvan, Puter, Vallader) shape, form</li></ol>
fuormar	<i>verb</i><br><ol><li>(Vallader) to shape, form</li></ol>
fuortga|fuortgas	<i>noun</i><br><ol><li>(Sursilvan) fork</li></ol>
furchetta|furchettas	<i>noun</i><br><ol><li>(Puter, Vallader) fork (eating utensil)</li></ol>
furma|furmas	<i>noun</i><br><ol><li>(Rumantsch Grischun, Sutsilvan, Surmiran) shape, form</li></ol>
furmar	<i>verb</i><br><ol><li>(Rumantsch Grischun, Sutsilvan, Surmiran) to shape, form</li></ol>
furmeila|furmeilas	<i>noun</i><br><ol><li>(Surmiran) ant</li></ol>
furment|furments	<i>noun</i><br><ol><li>wheat</li></ol>
furmer	<i>verb</i><br><ol><li>(Puter) to shape, form</li></ol>
furmia|furmias	<i>noun</i><br><ol><li>(Puter, Vallader) ant</li></ol>
furmicla|furmiclas	<i>noun</i><br><ol><li>(Rumantsch Grischun, Sursilvan, Sutsilvan) ant</li></ol>
furtga|furtgas	<i>noun</i><br><ol><li>(Rumantsch Grischun, Sutsilvan, Surmiran) fork</li></ol>
furtgetta|furtgettas	<i>noun</i><br><ol><li>(Rumantsch Grischun, Surmiran) fork (eating utensil)</li></ol>
fö	<i>noun</i><br><ol><li>(Puter, Vallader) fire</li></ol>
fögl|fögls	<i>noun</i><br><ol><li>(Puter, Vallader) sheet (of paper)</li></ol>
föglia|föglias	<i>noun</i><br><ol><li>(botany, Puter, Vallader) leaf</li></ol>
fùns	<i>noun</i><br><ol><li>(Sutsilvan) field, land, soil, ground</li></ol>
füm	<i>noun</i><br><ol><li>(Puter, Vallader) smoke</li></ol>
fümantar	<i>verb</i><br><ol><li>(Vallader) to smoke (preserve or prepare for consumption by treating with smoke)</li></ol>
fümanter	<i>verb</i><br><ol><li>(Puter) to smoke (preserve or prepare for consumption by treating with smoke)</li></ol>
fümar	<i>verb</i><br><ol><li>(Vallader) to smoke (inhale and exhale the smoke from a burning cigarette, cigar, pipe, etc.)</li></ol>
fümer	<i>verb</i><br><ol><li>(Puter) to smoke (inhale and exhale the smoke from a burning cigarette, cigar, pipe, etc.)</li></ol>
gagliegna|gagliegnas	<i>noun</i><br><ol><li>(Sutsilvan) hen</li></ol>
gagligna|gaglignas	<i>noun</i><br><ol><li>(Surmiran) hen</li></ol>
gaglina|gaglinas	<i>noun</i><br><ol><li>(Sursilvan) hen</li></ol>
galdeir	<i>verb</i><br><ol><li>(Surmiran) to enjoy</li></ol>
galdin|galdins	<i>noun</i><br><ol><li>turkey</li></ol>
ganascha|ganaschas	<i>noun</i><br><ol><li>(anatomy, Surmiran) jaw</li></ol>
gat|gats	<i>noun</i><br><ol><li>(Sursilvan, Sutsilvan) cat</li></ol>
gea	<i>adv</i><br><ol><li>(Rumantsch Grischun, Sutsilvan, Surmiran) yes (used to indicate agreement with a positive statement)</li></ol>
gea bagn	<i>adv</i><br><ol><li>(Surmiran) yes (used to disagree with a negative statement)</li></ol>
gelg|gelgs|gelgas|gelga	<i>adj</i><br><ol><li>(Vallader) yellow</li></ol>
gelg d'öv	<i>noun</i><br><ol><li>(Vallader) egg yolk</li></ol>
genevrin|genevrinas|genevrina|genevrins	<i>adj</i><br><ol><li>Genevan</li></ol>
genitur|geniturs	<i>noun</i><br><ol><li>parent</li></ol>
geografeia	<i>noun</i><br><ol><li>(Sutsilvan) geography</li></ol>
geografia	<i>noun</i><br><ol><li>(Rumantsch Grischun, Sursilvan, Surmiran, Puter, Vallader) geography</li></ol>
gervosa|gervosas	<i>noun</i><br><ol><li>(Rumantsch Grischun, Sursilvan, Sutsilvan) beer, ale</li></ol>
ghirschùn|ghirschùns	<i>noun</i><br><ol><li>(Sutsilvan) sparrow (Passer domesticus)</li></ol>
ghitara|ghitaras	<i>noun</i><br><ol><li>(music, Sursilvan, Sutsilvan) guitar</li></ol>
ghitarist|ghitarists	<i>noun</i><br><ol><li>(music, Sursilvan, Sutsilvan) (male) guitarist</li></ol>
ghitarista|ghitaristas	<i>noun</i><br><ol><li>(music, Sursilvan, Sutsilvan) (female) guitarist</li></ol>
ghitarra|ghitarras	<i>noun</i><br><ol><li>(music, Rumantsch Grischun, Surmiran) guitar</li></ol>
ghitarraist|ghitarraists	<i>noun</i><br><ol><li>(music, Surmiran) (male) guitarist</li></ol>
ghitarraista|ghitarraistas	<i>noun</i><br><ol><li>(music, Surmiran) (female) guitarist</li></ol>
ghitarrist|ghitarrists	<i>noun</i><br><ol><li>(music, Rumantsch Grischun) (male) guitarist</li></ol>
ghitarrista|ghitarristas	<i>noun</i><br><ol><li>(music, Rumantsch Grischun) (female) guitarist</li></ol>
gi|gis	<i>noun</i><br><ol><li>(Sursilvan, Sutsilvan) day</li></ol>
giabus	<i>noun</i><br><ol><li>cabbage</li></ol>
giaca|giacas	<i>noun</i><br><ol><li>(Sutsilvan) jacket</li></ol>
giacca|giaccas	<i>noun</i><br><ol><li>(Rumantsch Grischun, Sursilvan, Surmiran, Puter, Vallader) jacket</li></ol>
giachet|giachets	<i>noun</i><br><ol><li>(Rumantsch Grischun) jacket</li></ol>
giaglina|giaglinas	<i>noun</i><br><ol><li>(Rumantsch Grischun) hen</li></ol>
giallina|giallinas	<i>noun</i><br><ol><li>(Vallader) hen</li></ol>
gianoscha|gianoschas	<i>noun</i><br><ol><li>(anatomy, Rumantsch Grischun, Puter, Vallader) jaw</li></ol>
giaschair	<i>verb</i><br><ol><li>(Rumantsch Grischun, Puter, Vallader) to lie</li></ol>
giast|giasts	<i>noun</i><br><ol><li>(Rumantsch Grischun, Sutsilvan, Surmiran, Puter, Vallader) guest</li></ol>
giat|giats	<i>noun</i><br><ol><li>(Rumantsch Grischun, Sutsilvan, Surmiran, Puter, Vallader) cat</li></ol>
giatta|giattas	<i>noun</i><br><ol><li>(Rumantsch Grischun, Sutsilvan, Surmiran, Puter, Vallader) female cat</li></ol>
gie	<i>adv</i><br><ol><li>(Sursilvan) yes (used to indicate agreement with a positive statement)</li></ol>
gievgia|gievgias	<i>noun</i><br><ol><li>(Rumantsch Grischun, Sursilvan, Sutsilvan, Surmiran) Thursday</li></ol><br><i>adv</i><br><ol><li>(Rumantsch Grischun, Sursilvan, Sutsilvan, Surmiran) on Thursday</li></ol>
gillina|gillinas	<i>noun</i><br><ol><li>(Puter) hen</li></ol>
giodair	<i>verb</i><br><ol><li>(Puter, Vallader) to enjoy</li></ol>
giotta	<i>noun</i><br><ol><li>(Surmiran) barley</li></ol>
giovar	<i>verb</i><br><ol><li>(Vallader) to play</li></ol>
gioven|giovens|giovna|giovnas	<i>adj</i><br><ol><li>(Surmiran) young</li></ol><br><i>noun</i><br><ol><li>(Surmiran) boy, youth, young man</li></ol>
giovna|gioven|giovnas|giovens	<i>adj</i><br><ol><li>(Surmiran) young</li></ol><br><i>noun</i><br><ol><li>(Surmiran) girl, youth, young woman</li></ol>
gir	<i>verb</i><br><ol><li>(Sutsilvan) to say</li></ol>
gir manzegnas	<i>verb</i><br><ol><li>(Sutsilvan) to lie, tell lies</li></ol>
gist|gistas|gista|gists	<i>adj</i><br><ol><li>right</li></ol>
giudair|vegnesses a giudair|giudan|giudeva|giudessen|giudend|giudess|vegnel a giudair|vegns a giudair|giudida|giudais|giudai|vegnin a giudair|giudesses|giuda|vegness a giudair|giudevas|giudas|giudel|vegnîen a giudair|giudias|giudì|vegnien a giudair|vegnessen a giudair|giudain|vegnis a giudair|giudian|giudevan|vegnan a giudair|giud|giudia|vegnîes a giudair|vegni a giudair|vegn a giudair|vegnies a giudair	<i>verb</i><br><ol><li>(Rumantsch Grischun) to enjoy</li></ol>
giuder	<i>verb</i><br><ol><li>(Sutsilvan) to enjoy</li></ol>
giugar	<i>verb</i><br><ol><li>(Rumantsch Grischun, Sursilvan, Sutsilvan) to play</li></ol>
giuier	<i>verb</i><br><ol><li>(Surmiran) to play</li></ol>
giujear	<i>verb</i><br><ol><li>(Sutsilvan) to play</li></ol>
giunfra|giunfras	<i>noun</i><br><ol><li>(Surmiran, Puter, Vallader) young lady, Miss</li></ol>
giuotta	<i>noun</i><br><ol><li>(Puter, Vallader) barley</li></ol>
giuta	<i>noun</i><br><ol><li>(Sutsilvan) barley</li></ol>
giutta	<i>noun</i><br><ol><li>(Rumantsch Grischun, Sursilvan) barley</li></ol>
giuven|giuvnas|giuvens|giuvna	<i>adj</i><br><ol><li>(Rumantsch Grischun, Sursilvan, Sutsilvan, Puter, Vallader) young</li></ol><br><i>noun</i><br><ol><li>(Rumantsch Grischun, Sursilvan, Sutsilvan, Puter, Vallader) boy, youth, young man</li></ol>
giuventetgna	<i>noun</i><br><ol><li>(Rumantsch Grischun, Sursilvan, Sutsilvan) youth</li></ol>
giuventetna	<i>noun</i><br><ol><li>(Surmiran) youth</li></ol>
giuventüna	<i>noun</i><br><ol><li>(Puter, Vallader) youth</li></ol>
giuver	<i>verb</i><br><ol><li>(Puter) to play</li></ol>
giuvna|giuvnas|giuven|giuvens	<i>adj</i><br><ol><li>(Rumantsch Grischun, Sursilvan, Sutsilvan, Puter, Vallader) young</li></ol><br><i>noun</i><br><ol><li>(Rumantsch Grischun, Sursilvan, Sutsilvan, Puter, Vallader) girl, youth, young woman</li><li>(Rumantsch Grischun, Sursilvan, Sutsilvan) young lady, Miss</li></ol>
glatsch	<i>noun</i><br><ol><li>ice, ice cream</li></ol>
gleisch	<i>noun</i><br><ol><li>(physics, optics, Surmiran) light</li></ol>
glianga|gliangas	<i>noun</i><br><ol><li>(anatomy, Surmiran) tongue</li></ol>
gliendasgis	<i>noun</i><br><ol><li>(Sutsilvan) Monday</li></ol>
gliendisdis	<i>noun</i><br><ol><li>(Sursilvan) Monday</li></ol>
gliesch|glieschs|gliescha|glieschas	<i>adj</i><br><ol><li>(Sutsilvan) smooth, slippery</li></ol>
gliesta|gliestas	<i>noun</i><br><ol><li>(Sursilvan) list</li></ol>
glina	<i>noun</i><br><ol><li>moon</li></ol>
glindasde|glindasdes	<i>noun</i><br><ol><li>(Surmiran) Monday</li></ol>
glindesdi|glindesdis	<i>noun</i><br><ol><li>(Rumantsch Grischun) Monday</li></ol><br><i>adv</i><br><ol><li>(Rumantsch Grischun) on Monday</li></ol>
glisch|glischs|glischa|glischas	<i>adj</i><br><ol><li>(Rumantsch Grischun, Sursilvan, Surmiran, Puter, Vallader) smooth, slippery</li></ol><br><i>noun</i><br><ol><li>(physics, optics, Rumantsch Grischun, Sursilvan, Sutsilvan) light</li></ol>
glista|glistas	<i>noun</i><br><ol><li>(Rumantsch Grischun, Sutsilvan, Surmiran, Puter, Vallader) list</li></ol>
gluva|gluvas	<i>noun</i><br><ol><li>(Rumantsch Grischun) needle</li></ol>
glüm	<i>noun</i><br><ol><li>(physics, optics, Vallader) light</li></ol>
glüsch	<i>noun</i><br><ol><li>(physics, optics, Puter) light</li></ol>
gnir	<i>verb</i><br><ol><li>(Puter, Vallader) to come</li></ol>
gniram|gnirams	<i>noun</i><br><ol><li>(anatomy, Puter) liver</li></ol>
gnirom|gniroms	<i>noun</i><br><ol><li>(anatomy, Rumantsch Grischun, Vallader) liver</li></ol>
gnirunchel|gnirunchels	<i>noun</i><br><ol><li>(Rumantsch Grischun, Puter, anatomy) kidney</li></ol>
gnoua da naiv|gnouas da naiv	<i>noun</i><br><ol><li>(Surmiran, weather) snowflake</li></ol>
god|gods	<i>noun</i><br><ol><li>(Puter, Vallader) forest</li></ol>
golp|golps	<i>noun</i><br><ol><li>(Surmiran) fox</li></ol>
gotta|gottas	<i>noun</i><br><ol><li>(carpentry, Surmiran) nail</li></ol>
grand|grandas|grands|granda	<i>adj</i><br><ol><li>(Puter) big, large</li><li>(Puter) tall</li></ol>
grass	<i>noun</i><br><ol><li>fat</li></ol>
greav|greavas|greavs|greava	<i>adj</i><br><ol><li>(Sutsilvan) heavy, weighty</li><li>(Sutsilvan) difficult</li></ol>
greisch|grischa|greischs|grischas	<i>adj</i><br><ol><li>(Surmiran) grey</li></ol>
greiv|greivas|greiva|greivs	<i>adj</i><br><ol><li>(Puter, Vallader) heavy, weighty</li><li>(Puter, Vallader) difficult</li></ol>
grepfrut	<i>noun</i><br><ol><li>grapefruit</li></ol>
grev|grevas|grevs|greva	<i>adj</i><br><ol><li>(Rumantsch Grischun, Sursilvan, Surmiran) heavy, weighty</li><li>(Rumantsch Grischun, Sursilvan, Surmiran) difficult</li></ol>
grip|grips	<i>noun</i><br><ol><li>rock</li></ol>
grisch|grischa|grischs|grischas	<i>adj</i><br><ol><li>(Rumantsch Grischun, Sursilvan, Sutsilvan, Puter, Vallader) grey</li></ol>
grischun|grischunas|grischuns|grischuna	<i>adj</i><br><ol><li>(Rumantsch Grischun, Sursilvan, Surmiran, Puter, Vallader) Graubünden (attributive)</li></ol>
grischùn|grischùna|grischùnas|grischùns	<i>adj</i><br><ol><li>(Sutsilvan) Graubünden (attributive)</li></ol>
grogn|grogns	<i>noun</i><br><ol><li>(Surmiran, anatomy) chin</li></ol>
grond|gronds|gronda|grondas	<i>adj</i><br><ol><li>(Rumantsch Grischun, Sursilvan, Surmiran, Vallader) big, large</li><li>(Rumantsch Grischun, Sursilvan, Surmiran, Vallader) tall</li></ol>
grànd|gràndas|grànds|grànda	<i>adj</i><br><ol><li>(Sutsilvan) big, large</li><li>(Sutsilvan) tall</li></ol>
guadagner	<i>verb</i><br><ol><li>(Puter, Vallader) to win</li></ol>
gualp|gualps	<i>noun</i><br><ol><li>(Sutsilvan) fox</li></ol>
guardar	<i>verb</i><br><ol><li>(Rumantsch Grischun, Puter, Vallader) to look, look at, watch</li></ol>
guardar davo	<i>verb</i><br><ol><li>(Vallader) to look up, look for, search, seek</li></ol>
guaud|guauds	<i>noun</i><br><ol><li>(Rumantsch Grischun) forest</li></ol>
gudagnar	<i>verb</i><br><ol><li>(Rumantsch Grischun, Sutsilvan) to win</li></ol>
gudagnear	<i>verb</i><br><ol><li>(Sutsilvan) to win</li></ol>
gudagner	<i>verb</i><br><ol><li>(Surmiran) to win</li></ol>
guder|gaudel	<i>verb</i><br><ol><li>(Sursilvan) to enjoy</li></ol>
gudignar|gudignavas|vegnîen a gudignar|vegn a gudignar|gudognan|vegnessies a gudignar|vegnel a gudignar|gudogna|gudignassies|vegnesses a gudignar|gudognien|gudignassien|gudignein|gudignavan|vegnis a gudignar|gudigneies|gudigneien|vegnan a gudignar|vegnessi a gudignar|gudigneis|gudignass|gudognel|gudignavien|gudignasses|gudignond|gudignava|gudignei|gudognies|vegnîes a gudignar|vegnessien a gudignar|gudogni|vegnien a gudignar|vegnies a gudignar|gudognas|gudignavel|vegnin a gudignar|vegnessen a gudignar|gudignavies|vegness a gudignar|gudignavi|vegni a gudignar|gudignau|gudignassen|gudignassi|vegns a gudignar	<i>verb</i><br><ol><li>(Sursilvan) to win</li></ol>
guerra|guerras	<i>noun</i><br><ol><li>war</li></ol>
guglia|guglias	<i>noun</i><br><ol><li>(Rumantsch Grischun, Surmiran) needle</li></ol>
guila|guilas	<i>noun</i><br><ol><li>(Sursilvan, Sutsilvan) needle</li></ol>
guis	<i>noun</i><br><ol><li>(Puter, Vallader) marten</li></ol>
guitarra|guitarras	<i>noun</i><br><ol><li>(music, Puter, Vallader) guitar</li></ol>
guitarrist|guitarrists	<i>noun</i><br><ol><li>(music, Puter, Vallader) (male) guitarist</li></ol>
guitarrista|guitarristas	<i>noun</i><br><ol><li>(music, Puter, Vallader) (female) guitarist</li></ol>
gula|gulas	<i>noun</i><br><ol><li>(anatomy) throat</li><li>(Surmiran) desire, craving, appetite, lust, pleasure, fancy</li></ol>
gulacotschen	<i>noun</i><br><ol><li>(Puter, Vallader) robin (Erithacus rubecula)</li></ol>
guoglia|guoglias	<i>noun</i><br><ol><li>(Vallader) needle</li></ol>
guota|guotas	<i>noun</i><br><ol><li>(carpentry, Sursilvan) nail</li></ol>
guotta|guottas	<i>noun</i><br><ol><li>(carpentry, Puter, Vallader) nail</li></ol>
gut|guts	<i>noun</i><br><ol><li>drop</li></ol>
guta|gutas	<i>noun</i><br><ol><li>(carpentry, Sutsilvan) nail</li></ol>
gutta|guttas	<i>noun</i><br><ol><li>(carpentry, Rumantsch Grischun) nail</li></ol>
gòld|gòlds	<i>noun</i><br><ol><li>(Sutsilvan) forest</li></ol>
gôt|gôts	<i>noun</i><br><ol><li>(Surmiran) forest</li></ol>
gö|gös	<i>noun</i><br><ol><li>game</li></ol>
gövgia|gövgias	<i>noun</i><br><ol><li>(Puter, Vallader) Thursday</li></ol>
gün	<i>name</i><br><ol><li>(Puter, Vallader) June</li></ol>
hai	<i>intj</i><br><ol><li>(Vallader) yes (used to indicate agreement with the speaker in a conversation)</li></ol>
hardefel|hardefels	<i>noun</i><br><ol><li>(Sutsilvan) potato</li></ol>
haver|havessies|has|han|havevies|vessi|vegni a haver|vegnessies a haver|vessies|vegnîes a haver|vess|vegnel a haver|vegn a haver|haveien|hagien|havava|havessen|vevies|havesses|vegnesses a haver|vegnan a haver|vegnien a haver|vegnin a haver|havessi|vevas|veis|veva|hagi|vevi|vesses|vegnessen a haver|veies|haveis|vevan|havavan|vegnis a haver|vai|vein|havavel|ha|vegnessien a haver|vevien|haveies|havavas|hagies|havevien|vegnies a haver|havend|vegness a haver|hai|havein|havessien|havevi|vessien|vessen|giu|vegnessi a haver|havess|vegns a haver|vevel|vegnîen a haver	<i>verb</i><br><ol><li>(Sursilvan) to have</li></ol>
hei	<i>intj</i><br><ol><li>(Puter, Vallader) yes (used to indicate agreement with the speaker in a conversation)</li></ol>
hosp|hosps	<i>noun</i><br><ol><li>(Sursilvan) guest</li></ol>
human|humana|humanas|humans	<i>adj</i><br><ol><li>(Sursilvan) human</li></ol><br><i>noun</i><br><ol><li>(Sursilvan) (male) human being</li></ol>
humana|humanas	<i>noun</i><br><ol><li>(Sursilvan) female human being</li></ol>
ia	<i>pron</i><br><ol><li>(Surmiran) I</li></ol>
ieli	<i>noun</i><br><ol><li>oil</li></ol>
ier	<i>adv</i><br><ol><li>(Rumantsch Grischun, Surmiran, Sursilvan, Sutsilvan) yesterday</li></ol>
ierdi	<i>noun</i><br><ol><li>(Rumantsch Grischun) barley</li></ol>
iert|ierts	<i>noun</i><br><ol><li>(Rumantsch Grischun, Sursilvan, Sutsilvan, Surmiran) garden, kitchen garden, vegetable garden</li></ol>
ierta|iertas	<i>noun</i><br><ol><li>estate, inheritance</li></ol>
ies	<i>noun</i><br><ol><li>(Sursilvan) bone</li></ol>
ieuva|ieuvas	<i>noun</i><br><ol><li>(Sutsilvan) grape</li></ol>
iev|ovs	<i>noun</i><br><ol><li>(Sursilvan, biology, zoology, foods) egg</li></ol>
iffaunt|iffaunts	<i>noun</i><br><ol><li>(Puter) child</li></ol>
iffaunt sulet|iffaunts sulets	<i>noun</i><br><ol><li>(Puter) only child</li></ol>
iffaunt unic|iffaunts unics	<i>noun</i><br><ol><li>(Puter) only child</li></ol>
in|ina	<i>article</i><br><ol><li>(Rumantsch Grischun, Sursilvan) a, an</li></ol><br><i>num</i><br><ol><li>(Rumantsch Grischun, Sursilvan) one</li></ol>
ina|in	<i>article</i><br><ol><li>(Rumantsch Grischun, Sursilvan) a, an</li></ol><br><i>num</i><br><ol><li>(Rumantsch Grischun, Sursilvan) one</li></ol>
indefinit|indefinits|indefinitas|indefinita	<i>adj</i><br><ol><li>indefinite</li></ol>
indesch	<i>num</i><br><ol><li>(Rumantsch Grischun) eleven</li></ol>
inimi|inimis	<i>noun</i><br><ol><li>enemy</li></ol>
iniziar	<i>verb</i><br><ol><li>(Rumantsch Grischun, Sursilvan, Sutsilvan, Vallader) to start</li></ol>
inizier	<i>verb</i><br><ol><li>(Puter) to start</li></ol>
insatge	<i>noun</i><br><ol><li>(Rumantsch Grischun) something, anything</li></ol>
insla|inslas	<i>noun</i><br><ol><li>island</li></ol>
intestins	<i>noun</i><br><ol><li>(anatomy, Rumantsch Grischun, Vallader) intestines, insides, guts</li></ol>
ir|massen|evien|giajan|vegnien a ir|vegnessen a ir|evas|meis|vegnan a ir|evi|eva|vegnîes a ir|giai|evel|massies|mondies|evan|mein|vegnessies a ir|meien|mondien|gievan|van|vegnessien a ir|giain|va|giais|giesses|giaja|vegni a ir|giajas|vegnies a ir|vegns a ir|gieva|vegn a ir|masses|mondi|gievas|iu|ì|giess|vegness a ir|giessen|mei|massien|vegnessi a ir|evies|vom|vegnin a ir|vas|mass|mond|massi|vegnesses a ir|mon|meies|vegnis a ir|vegnîen a ir|vegnel a ir|giond	<i>verb</i><br><ol><li>(Rumantsch Grischun, Sursilvan, Sutsilvan, Puter, Vallader) to go</li></ol>
irom	<i>noun</i><br><ol><li>(Sursilvan) copper</li></ol>
isch|ischs	<i>noun</i><br><ol><li>(Rumantsch Grischun, Surmiran) door</li></ol>
ischia	<i>noun</i><br><ol><li>(Surmiran) vinegar</li></ol>
ischieu	<i>noun</i><br><ol><li>(Sutsilvan) vinegar</li></ol>
ischiu	<i>noun</i><br><ol><li>(Sursilvan) vinegar</li></ol>
istorgia|istorgias	<i>noun</i><br><ol><li>history</li></ol>
itschal	<i>noun</i><br><ol><li>(Sursilvan, Sutsilvan) steel</li></ol>
iua|iuas	<i>noun</i><br><ol><li>(Sursilvan) grape</li></ol>
iva|ivas	<i>noun</i><br><ol><li>(Rumantsch Grischun, Surmiran) grape</li></ol>
jamna|jamnas	<i>noun</i><br><ol><li>(Sursilvan) week</li></ol>
jau	<i>pron</i><br><ol><li>(Rumantsch Grischun) I</li></ol>
jeu	<i>pron</i><br><ol><li>(Sursilvan) I</li></ol>
jogurt	<i>noun</i><br><ol><li>yoghurt</li></ol>
jou	<i>pron</i><br><ol><li>(Sutsilvan) I</li></ol>
lac	<i>noun</i><br><ol><li>paint</li></ol>
lad|lads|ladas|lada	<i>adj</i><br><ol><li>(Rumantsch Grischun, Sursilvan) wide, broad</li></ol>
lader	<i>noun</i><br><ol><li>thief</li></ol>
lag|lags	<i>noun</i><br><ol><li>(Sursilvan, Sutsilvan) lake</li></ol>
lai|lais	<i>noun</i><br><ol><li>lake</li><li>(Vallader) marriage, matrimony</li></ol>
lain	<i>noun</i><br><ol><li>(Rumantsch Grischun, Puter, Vallader) wood</li></ol>
lainari|lainaris	<i>noun</i><br><ol><li>(Rumantsch Grischun) carpenter</li></ol>
laitg|laitgs	<i>noun</i><br><ol><li>(Sutsilvan) lake</li></ol>
lana	<i>noun</i><br><ol><li>(Vallader) wool</li></ol>
langa	<i>noun</i><br><ol><li>(Surmiran) wool</li></ol>
lantschetta|lantschettas	<i>noun</i><br><ol><li>hand (of a clock or watch)</li></ol>
lard	<i>noun</i><br><ol><li>(Puter) bacon</li></ol>
larg|largs|largia|largias	<i>adj</i><br><ol><li>(Puter, Vallader) wide, broad</li></ol>
larma|larmas	<i>noun</i><br><ol><li>tear, teardrop</li></ol>
lartg|largia|lartgs|largias	<i>adj</i><br><ol><li>(Rumantsch Grischun, Sursilvan, Sutsilvan, Surmiran) wide, broad</li></ol>
latg|latgs	<i>noun</i><br><ol><li>milk</li></ol>
launa	<i>noun</i><br><ol><li>(Rumantsch Grischun, Sursilvan, Puter) wool</li></ol>
laungia|laungias	<i>noun</i><br><ol><li>(anatomy, Puter) tongue</li></ol>
lavour|lavours	<i>noun</i><br><ol><li>(Surmiran) work</li></ol>
lavur|lavuors|lavurs	<i>noun</i><br><ol><li>(Rumantsch Grischun, Sursilvan, Sutsilvan) work</li><li>(Puter, Vallader) work</li></ol>
lavurar	<i>verb</i><br><ol><li>(Rumantsch Grischun, Puter, Vallader) to work</li></ol>
leav|leavs|leavas|leava	<i>adj</i><br><ol><li>(Sutsilvan) light (of weight)</li><li>(Sutsilvan) easy</li></ol>
leavz|leavzs	<i>noun</i><br><ol><li>(Sutsilvan, anatomy) lip</li></ol>
leavza|leavzas	<i>noun</i><br><ol><li>(Sutsilvan, anatomy) lip</li></ol>
leer	<i>noun</i><br><ol><li>(Sutsilvan) air</li></ol>
lef|lefs	<i>noun</i><br><ol><li>(Rumantsch Grischun, Surmiran, Vallader, anatomy) lip</li></ol>
leger|legesses|legras|legavas|vegnan a leger|legessen|legas|legevies|vegn a leger|vegnis a leger|legei|legi|legeva|vegnies a leger|legies|vegnessien a leger|legeien|legais|legend|legien|legavel|vegnel a leger|vegnien a leger|vegni a leger|lega|legava|legì|legevas|vegness a leger|vegnessies a leger|legessi|legain|vegnesses a leger|legias|vegnîes a leger|legel|legevi|legessien|legeies|legevien|legavan|vegnessi a leger|vegnessen a leger|vegns a leger|legiu|legida|vegnîen a leger|legia|legevan|legai|legeis|legein|legra|legian|vegnin a leger|legers|legess|legessies|legan	<i>verb</i><br><ol><li>(Rumantsch Grischun, Sursilvan, Vallader) to read</li></ol><br><i>adj</i><br><ol><li>(Sursilvan) merry, happy</li></ol>
leia|leias	<i>noun</i><br><ol><li>(Sutsilvan, Surmiran) league</li></ol>
leir	<i>verb</i><br><ol><li>(Surmiran) Alternative form of vuleir</li></ol>
leiv|leivas|leivs|leiva	<i>noun</i><br><ol><li>(Puter, anatomy) lip</li></ol><br><i>adj</i><br><ol><li>(Vallader) light (of weight)</li><li>(Vallader) easy</li></ol>
lej|lejs	<i>noun</i><br><ol><li>(Puter) lake</li></ol>
len	<i>noun</i><br><ol><li>(Sutsilvan) wood</li></ol>
lenari|lenaris	<i>noun</i><br><ol><li>(Sutsilvan) carpenter</li></ol>
lengua|lenguas	<i>noun</i><br><ol><li>(Vallader) tongue</li></ol>
lenn	<i>noun</i><br><ol><li>(Sursilvan, Surmiran) wood</li></ol>
lennari|lennaris	<i>noun</i><br><ol><li>(Sursilvan, Surmiran) carpenter</li></ol>
ler	<i>verb</i><br><ol><li>(Puter) to read</li><li>(Sutsilvan) Alternative form of vuler</li></ol>
letg|letgs	<i>noun</i><br><ol><li>(Rumantsch Grischun, Sursilvan, Surmiran) bed</li><li>(Sutsilvan) marriage, matrimony</li></ol>
letra|letras	<i>noun</i><br><ol><li>(Sutsilvan) letter (of the alphabet)</li></ol>
leua|leuas	<i>noun</i><br><ol><li>(anatomy, Vallader) tongue</li></ol>
lev|levas|levs|leva	<i>adj</i><br><ol><li>(Rumantsch Grischun, Sursilvan, Surmiran) light (of weight)</li><li>(Rumantsch Grischun, Sursilvan, Surmiran) easy</li></ol>
levz|levzs	<i>noun</i><br><ol><li>(Sursilvan, anatomy) lip</li></ol>
levza|levzas	<i>noun</i><br><ol><li>(Sursilvan, anatomy) lip</li></ol>
lia|lias	<i>noun</i><br><ol><li>(Rumantsch Grischun, Puter, Vallader) league</li></ol>
lieu	<i>noun</i><br><ol><li>(Rumantsch Grischun) place</li></ol>
lieunga|lieungas	<i>noun</i><br><ol><li>(anatomy, Rumantsch Grischun, Sursilvan, Sutsilvan) tongue</li></ol>
liger|ligera|ligeras|ligers	<i>adj</i><br><ol><li>(Puter, Vallader) light (of weight)</li><li>(Puter, Vallader) easy</li></ol><br><i>verb</i><br><ol><li>(Sutsilvan, Surmiran) to read</li></ol>
ligia|ligias	<i>noun</i><br><ol><li>(Sursilvan) league</li></ol>
lingua|linguas	<i>noun</i><br><ol><li>(Rumantsch Grischun, Puter, Vallader) language</li></ol>
linguach|linguachs	<i>noun</i><br><ol><li>(Puter, Vallader, poetic) language</li></ol>
linguatg|linguatgs	<i>noun</i><br><ol><li>(Rumantsch Grischun) language</li></ol>
listess	<i>adj</i><br><ol><li>(Puter, Vallader) same</li></ol>
litgiva|litgivas	<i>noun</i><br><ol><li>(Rumantsch Grischun, Sursilvan, Sutsilvan, Surmiran) trout</li></ol>
litinent|litinents	<i>noun</i><br><ol><li>(military, Rumantsch Grischun, Sursilvan, Sutsilvan, Surmiran) lieutenant</li></ol>
liun|liuns	<i>noun</i><br><ol><li>(Rumantsch Grischun, Sursilvan, Surmiran, Puter, Vallader) lion</li></ol><br><i>name</i><br><ol><li>(astronomy, astrology, Rumantsch Grischun, Sursilvan, Surmiran, Puter, Vallader) Leo</li></ol>
livel|livels	<i>noun</i><br><ol><li>(Puter) level (in a physical sense; for academic sense, see nivel)</li></ol>
liùn|liùns	<i>noun</i><br><ol><li>(Sutsilvan) lion</li></ol><br><i>name</i><br><ol><li>(astronomy, astrology, Sutsilvan) Leo</li></ol>
lo|los|loa|loas	<i>adj</i><br><ol><li>(Sutsilvan) wide, broad</li></ol>
localitad|localitads	<i>noun</i><br><ol><li>place, locality</li></ol>
lodola|lodolas	<i>noun</i><br><ol><li>lark</li></ol>
lom|loms	<i>noun</i><br><ol><li>(Rumantsch Grischun, Sursilvan, Sutsilvan) lung</li></ol>
lomm|lomms	<i>noun</i><br><ol><li>(Surmiran) lung</li></ol>
lontan|lontanas|lontans|lontana	<i>adj</i><br><ol><li>(Rumantsch Grischun, Sursilvan, Surmiran, Vallader) distant, remote, faraway</li></ol><br><i>noun</i><br><ol><li>(Rumantsch Grischun, Sursilvan, Surmiran, Vallader) distance, faraway places, distant places, remote places</li></ol>
lontàn|lontànas|lontàns|lontàna	<i>adj</i><br><ol><li>(Sutsilvan) distant, remote, faraway</li></ol><br><i>noun</i><br><ol><li>(Sutsilvan) distance, faraway places, distant places, remote places</li></ol>
lotga|lotgas	<i>noun</i><br><ol><li>(Surmiran) fight, struggle, wrestling</li></ol>
lubir	<i>verb</i><br><ol><li>to allow</li></ol>
lucernais|lucernaisas|lucernaisa	<i>adj</i><br><ol><li>(Rumantsch Grischun, Puter, Vallader) Lucerne (attributive)</li></ol>
lucernes|lucernesa|lucernesas	<i>adj</i><br><ol><li>(Sursilvan, Surmiran) Lucerne (attributive)</li></ol>
ludra|ludras	<i>noun</i><br><ol><li>(Rumantsch Grischun, Sursilvan, Sutsilvan, Surmiran) otter</li></ol>
luf|lufs	<i>noun</i><br><ol><li>(Rumantsch Grischun, Puter, Vallader, Sursilvan, Sutsilvan) wolf</li></ol>
lung|lungs|lunga|lungas	<i>adj</i><br><ol><li>long</li></ol>
lungaitg|lungaitgs	<i>noun</i><br><ol><li>(Sutsilvan) language</li></ol>
lungatg|lungatgs	<i>noun</i><br><ol><li>(Sursilvan, Surmiran) language</li></ol>
luntaun|luntauna|luntauns|luntaunas	<i>adj</i><br><ol><li>(Puter) distant, remote, faraway</li></ol><br><i>noun</i><br><ol><li>(Puter) distance, faraway places, distant places, remote places</li></ol>
luotta|luottas	<i>noun</i><br><ol><li>(Puter, Vallader) fight, struggle, wrestling</li></ol>
lur	<i>pron</i><br><ol><li>their</li></ol>
lutga|lutgas	<i>noun</i><br><ol><li>(Rumantsch Grischun, Sursilvan, Sutsilvan) fight, struggle, wrestling</li></ol>
lutra|lutras	<i>noun</i><br><ol><li>(Puter, Vallader) otter</li></ol>
luvrar	<i>verb</i><br><ol><li>(Sursilvan, Sutsilvan, Surmiran) to work</li></ol>
luzernes|luzernesas|luzernesa	<i>adj</i><br><ol><li>(Sutsilvan) Lucerne (attributive)</li></ol>
là	<i>adv</i><br><ol><li>there</li></ol>
làna	<i>noun</i><br><ol><li>(Sutsilvan) wool</li></ol>
lètg|lètgs	<i>noun</i><br><ol><li>(Rumantsch Grischun, Sursilvan, Surmiran) marriage, matrimony</li></ol>
lügl	<i>name</i><br><ol><li>(Puter, Vallader) July</li></ol>
lündeschdi|lündeschdis	<i>noun</i><br><ol><li>(Puter, Vallader) Monday</li></ol>
madem	<i>adj</i><br><ol><li>(Sutsilvan, Surmiran) same</li></ol>
madir	<i>adj</i><br><ol><li>ripe</li></ol>
magister|magisters	<i>noun</i><br><ol><li>(Rumantsch Grischun, Puter, Vallader) male teacher</li></ol>
magistra|magistras	<i>noun</i><br><ol><li>(Rumantsch Grischun, Puter, Vallader) female teacher</li></ol>
magler	<i>verb</i><br><ol><li>(Surmiran) to eat</li></ol>
magliar|na maglai betg|maglain|maglond|maglass|maglavan|maglaran|maglassas|maglan|maglas|maglias|na magla betg|maglà|magl|maglavas|magla|maglava|maglian|maglassan|maglai|maglais|maglar|maglia	<i>verb</i><br><ol><li>(Rumantsch Grischun, Sursilvan, Vallader) to eat</li></ol>
magliear	<i>verb</i><br><ol><li>(Sutsilvan) to eat</li></ol>
maglier	<i>verb</i><br><ol><li>(Puter) to eat</li></ol>
mai	<i>name</i><br><ol><li>(Vallader) May</li></ol>
mail|mails	<i>noun</i><br><ol><li>(Rumantsch Grischun, Vallader) apple</li></ol>
mailinterra|mailinterras	<i>noun</i><br><ol><li>(Vallader) potato</li></ol>
mais	<i>noun</i><br><ol><li>month</li></ol>
maisa|maisas	<i>noun</i><br><ol><li>table</li></ol>
maitg	<i>name</i><br><ol><li>May</li></ol>
maletg|maletgs	<i>noun</i><br><ol><li>(Rumantsch Grischun, Sursilvan, Sutsilvan, Surmiran) picture</li></ol>
malmund	<i>adj</i><br><ol><li>(Sutsilvan) dirty</li></ol>
malnet|malnettas|malnetta|malnets	<i>adj</i><br><ol><li>(Rumantsch Grischun, Vallader) dirty</li></ol>
mamilla|mamillas	<i>noun</i><br><ol><li>(Rumantsch Grischun, anatomy) nipple</li></ol>
mamma|mammas	<i>noun</i><br><ol><li>mother</li></ol>
mandel|mandels	<i>noun</i><br><ol><li>(Rumantsch Grischun, Sursilvan, Sutsilvan, Puter) almond</li><li>(Rumantsch Grischun, Sursilvan, Sutsilvan, anatomy) tonsil</li></ol>
mandla|mandlas	<i>noun</i><br><ol><li>(Surmiran, Vallader) almond</li><li>(Surmiran, Puter, Vallader, anatomy) tonsil</li></ol>
manevel|manevel da	<i>adv</i><br><ol><li>(Sutsilvan) near, not far away from</li></ol>
manger	<i>verb</i><br><ol><li>(Puter) to eat</li></ol>
mangiar|mangiai|mangian|mangia|mangià|mangiaran|mangiia|mangiava|mangiavas|mangiias|mangiian|mangiain|mangi|mangiassas|na mangia betg|mangiassan|mangiais|mangias|mangiavan|mangiass|na mangiai betg|mangiond	<i>verb</i><br><ol><li>(Rumantsch Grischun, Vallader) to eat</li></ol>
mangola	<i>noun</i><br><ol><li>(Rumantsch Grischun, Sursilvan, Sutsilvan, Surmiran) cotton</li></ol>
manizin|manizins	<i>noun</i><br><ol><li>(Puter, Vallader) bracelet, watchstrap</li></ol>
mantun|mantuns	<i>noun</i><br><ol><li>(Rumantsch Grischun, Sursilvan, Puter, Vallader) pile, lot, quantity</li></ol>
mantùn|mantùns	<i>noun</i><br><ol><li>(Sutsilvan) pile, lot, quantity</li><li>(anatomy, Sutsilvan) chin</li></ol>
manzegna|manzegnas	<i>noun</i><br><ol><li>(Rumantsch Grischun, Sursilvan, Sutsilvan) lie</li></ol>
manzigna|manzignas	<i>noun</i><br><ol><li>(Surmiran) lie</li></ol>
manzögna|manzögnas	<i>noun</i><br><ol><li>(Puter, Vallader) lie</li></ol>
mar|mars	<i>noun</i><br><ol><li>(Rumantsch Grischun, Sursilvan, Sutsilvan, Surmiran) sea</li><li>(Vallader) sea</li></ol>
marangun|maranguna|marangunas|maranguns	<i>noun</i><br><ol><li>(Puter, Vallader) carpenter</li></ol>
marcau|marcaus	<i>noun</i><br><ol><li>(Sursilvan) city</li></ol>
marculdi|marculdis	<i>noun</i><br><ol><li>(Puter) Wednesday</li></ol>
marcurdi|marcurdis	<i>noun</i><br><ol><li>(Vallader) Wednesday</li></ol>
marde|mardes	<i>noun</i><br><ol><li>(Surmiran) Tuesday</li></ol>
mardi|mardis	<i>noun</i><br><ol><li>(Rumantsch Grischun, Puter, Vallader) Tuesday</li></ol><br><i>adv</i><br><ol><li>(Rumantsch Grischun, Puter, Vallader) on Tuesday</li></ol>
mardis	<i>noun</i><br><ol><li>(Sursilvan) Tuesday</li></ol>
margis	<i>noun</i><br><ol><li>(Sutsilvan) Tuesday</li></ol>
marlotscha|marlotschas	<i>noun</i><br><ol><li>(Sutsilvan) blackbird</li></ol>
mars	<i>name</i><br><ol><li>(Rumantsch Grischun, Sursilvan, Surmiran) March</li></ol>
martgea|martgeas	<i>noun</i><br><ol><li>(Surmiran) city</li></ol>
martgieu|martgieus	<i>noun</i><br><ol><li>(Sutsilvan) city</li></ol>
martgo|martgos	<i>noun</i><br><ol><li>(Sutsilvan) city</li></ol>
marz	<i>name</i><br><ol><li>(Sutsilvan, Puter, Vallader) March</li></ol>
maset|masets	<i>noun</i><br><ol><li>(Rumantsch Grischun, Sursilvan, Sutsilvan, birds) tit</li></ol>
maset blau	<i>noun</i><br><ol><li>(Rumantsch Grischun, Sursilvan, Sutsilvan) blue tit</li></ol>
maset d'uaul	<i>noun</i><br><ol><li>(Sursilvan) coal tit</li></ol>
maset da guaud	<i>noun</i><br><ol><li>(Rumantsch Grischun) coal tit</li></ol>
maset da pegn	<i>noun</i><br><ol><li>(Sutsilvan) coal tit</li></ol>
massada|massadas	<i>noun</i><br><ol><li>(Surmiran) pile, lot, quantity</li></ol>
massella|massellas	<i>noun</i><br><ol><li>(anatomy, Puter, Vallader) cheek</li></ol>
mat	<i>noun</i><br><ol><li>boy</li></ol>
matg	<i>name</i><br><ol><li>(Rumantsch Grischun, Sursilvan, Sutsilvan, Surmiran) May</li></ol>
matrimoni	<i>noun</i><br><ol><li>(Puter, Vallader) marriage, matrimony</li></ol>
maun|mauns	<i>noun</i><br><ol><li>(anatomy) hand</li></ol>
mazar	<i>verb</i><br><ol><li>(Sutsilvan) to kill</li></ol>
mazzar	<i>verb</i><br><ol><li>(Rumantsch Grischun, Sursilvan, Surmiran, Vallader) to kill</li></ol>
mazzer	<i>verb</i><br><ol><li>(Puter) to kill</li></ol>
meal	<i>noun</i><br><ol><li>(Sutsilvan) honey</li></ol>
medem	<i>adj</i><br><ol><li>(Rumantsch Grischun, Sursilvan) same</li></ol>
meg	<i>name</i><br><ol><li>(Puter) May</li></ol>
meil d'aviöls	<i>noun</i><br><ol><li>(Puter, Vallader) honey</li></ol>
meir|meirs	<i>noun</i><br><ol><li>(Surmiran) exterior wall</li><li>(Surmiran) mouse</li></ol>
mel|mels	<i>noun</i><br><ol><li>(Rumantsch Grischun) honey</li><li>(Rumantsch Grischun) jam</li></ol>
mel d'avieuls	<i>noun</i><br><ol><li>(Rumantsch Grischun) honey</li></ol>
melen|melens|melnas|melna	<i>adj</i><br><ol><li>(Sutsilvan) yellow</li></ol>
melen d'ov	<i>noun</i><br><ol><li>(Sutsilvan) egg yolk</li></ol>
mellan|mellans|melnas|melna	<i>adj</i><br><ol><li>(Puter) yellow</li></ol>
mellan d'öv	<i>noun</i><br><ol><li>(Puter) egg yolk</li></ol>
mellen|melnas|mellens|melna	<i>adj</i><br><ol><li>(Rumantsch Grischun, Sursilvan, Surmiran) yellow</li><li>(Rumantsch Grischun, Sursilvan, Surmiran) egg yolk</li></ol>
mellen d'iev	<i>noun</i><br><ol><li>(Sursilvan) egg yolk</li></ol>
mellen d'ov	<i>noun</i><br><ol><li>(Rumantsch Grischun, Surmiran) egg yolk</li></ol>
melnet|melnettas|melnets|melnetta	<i>adj</i><br><ol><li>(Puter) dirty</li></ol>
mer|mers	<i>noun</i><br><ol><li>(Puter) sea</li></ol>
merl|merls	<i>noun</i><br><ol><li>(Puter, Vallader) blackbird</li></ol>
merlotscha|merlotschas	<i>noun</i><br><ol><li>(Rumantsch Grischun, Sursilvan, Surmiran) blackbird</li></ol>
mes|mia	<i>adj</i><br><ol><li>(possessive) my</li></ol>
mez|mesa|mesas|mezs	<i>adj</i><br><ol><li>(Rumantsch Grischun) half</li></ol><br><i>noun</i><br><ol><li>(Rumantsch Grischun) middle</li></ol>
mia|mes	<i>adj</i><br><ol><li>(possessive) my</li></ol>
midar	<i>verb</i><br><ol><li>to change</li></ol>
miert	<i>adj</i><br><ol><li>(Sursilvan) dead</li></ol>
mieur|mieurs	<i>noun</i><br><ol><li>(Rumantsch Grischun) mouse</li></ol>
miez miur e miez utschi|miez miur e miez utschis	<i>noun</i><br><ol><li>(Sursilvan) bat</li></ol>
miezmir-a-miezutschi|miezmir-a-miezutschis	<i>noun</i><br><ol><li>(Sutsilvan) bat</li></ol>
milliard|milliards	<i>num</i><br><ol><li>(Puter, Vallader) milliard (a short scale billion).</li></ol><br><i>noun</i><br><ol><li>(Puter, Vallader) milliard (a short scale billion).</li></ol>
milliarda|milliardas	<i>num</i><br><ol><li>(Rumantsch Grischun, Sursilvan, Sutsilvan, Surmiran) milliard (a short scale billion).</li></ol><br><i>noun</i><br><ol><li>(Rumantsch Grischun, Sursilvan, Sutsilvan, Surmiran) milliard (a short scale billion).</li></ol>
milliardari|milliardaris	<i>noun</i><br><ol><li>billionaire</li></ol>
mina da naiv|minas da naiv	<i>noun</i><br><ol><li>(Surmiran, weather) snowflake</li></ol>
mintun|mintuns	<i>noun</i><br><ol><li>(Rumantsch Grischun, Puter, Vallader, anatomy) chin</li></ol>
minut|minuts	<i>noun</i><br><ol><li>(Puter, Vallader) minute</li></ol>
minuta|minutas	<i>noun</i><br><ol><li>minute</li></ol>
mir|mirs	<i>noun</i><br><ol><li>(Rumantsch Grischun, Sursilvan, Sutsilvan) exterior wall</li><li>(Sutsilvan) mouse</li></ol>
misseala|missealas	<i>noun</i><br><ol><li>(anatomy, Sutsilvan) jaw</li></ol>
missela|misselas	<i>noun</i><br><ol><li>(anatomy, Surmiran) cheek, jaw</li></ol>
missella|missellas	<i>noun</i><br><ol><li>(anatomy, Rumantsch Grischun) cheek, jaw</li></ol>
missiala|missialas	<i>noun</i><br><ol><li>(anatomy, Sursilvan) jaw</li></ol>
misun|misuns	<i>noun</i><br><ol><li>(Vallader, anatomy) chin</li></ol>
miur|miurs	<i>noun</i><br><ol><li>(Sursilvan) mouse</li></ol>
mond|monds	<i>noun</i><br><ol><li>(Surmiran) world</li></ol>
mordager	<i>verb</i><br><ol><li>(Puter) to kill</li></ol>
mordriar	<i>verb</i><br><ol><li>(Vallader) to kill</li></ol>
mort|morts|morta|mortas	<i>adj</i><br><ol><li>(Rumantsch Grischun, Sutsilvan, Surmiran, Vallader) dead</li></ol>
mostga|mostgas	<i>noun</i><br><ol><li>(Surmiran) fly</li></ol>
munaida	<i>noun</i><br><ol><li>(Rumantsch Grischun, Puter, Vallader) money, small change</li></ol>
mund|munds	<i>noun</i><br><ol><li>(Rumantsch Grischun, Sursilvan, Sutsilvan) world</li></ol>
muneda	<i>noun</i><br><ol><li>(Sutsilvan) money, small change</li></ol>
muneida	<i>noun</i><br><ol><li>(Sursilvan, Surmiran) money, small change</li></ol>
muntagna|muntagnas	<i>noun</i><br><ol><li>(Puter, geography) mountain, peak</li></ol>
muntagnard|muntagnards|muntagnardas|muntagnarda	<i>adj</i><br><ol><li>mountain-dwelling</li><li>(attributive) mountain</li></ol>
muntar	<i>verb</i><br><ol><li>(Rumantsch Grischun, Sursilvan, Sutsilvan, Surmiran) to go up</li></ol>
muntgogna|muntgognas	<i>noun</i><br><ol><li>(Sutsilvan, geography) mountain</li></ol>
muntogna|muntognas	<i>noun</i><br><ol><li>(Rumantsch Grischun, Sursilvan, Surmiran, Vallader, geography) mountain</li></ol>
muond|muonds	<i>noun</i><br><ol><li>(Puter, Vallader) world</li></ol>
muos-cha|muos-chas	<i>noun</i><br><ol><li>(Puter, Vallader) fly</li></ol>
mureir	<i>verb</i><br><ol><li>(Surmiran) to die</li></ol>
murir|mort|murivan|muris|mor|murivas|murissan|murissas|mora|moras|muriss|moran|morias|moria|murind|morian|murin|muriva	<i>verb</i><br><ol><li>(Rumantsch Grischun, Sursilvan, Sutsilvan, Puter, Vallader) to die</li></ol>
musica	<i>noun</i><br><ol><li>music</li></ol>
mustaila|mustailas	<i>noun</i><br><ol><li>weasel</li></ol>
mustga|mustgas	<i>noun</i><br><ol><li>(Rumantsch Grischun, Sursilvan, Sutsilvan) fly</li></ol>
mèl	<i>noun</i><br><ol><li>(Sursilvan) honey</li><li>(Sursilvan) jam</li></ol>
mèl d'aviuls	<i>noun</i><br><ol><li>(Sursilvan) honey</li></ol>
mêl	<i>noun</i><br><ol><li>(Surmiran) honey</li></ol>
mür|or mürs|müers	<i>noun</i><br><ol><li>(Puter, Vallader) exterior wall</li><li>(Puter, Vallader) mouse</li></ol>
nair|nairs|nairas|naira	<i>adj</i><br><ol><li>(Rumantsch Grischun, Puter, Vallader) black</li></ol>
naiv	<i>noun</i><br><ol><li>(Rumantsch Grischun, Puter, Vallader) snow</li></ol>
naiver	<i>verb</i><br><ol><li>(Rumantsch Grischun, Puter, Vallader) to snow</li></ol>
nar|narras|narra|nars	<i>noun</i><br><ol><li>fool</li></ol><br><i>adj</i><br><ol><li>crazy, mad</li></ol>
narr|narrs|narras|narra	<i>adj</i><br><ol><li>(Sursilvan) crazy, mad</li></ol>
narunchel|narunchels	<i>noun</i><br><ol><li>(Sursilvan, anatomy) kidney</li></ol>
nas	<i>noun</i><br><ol><li>(anatomy, Rumantsch Grischun, Sursilvan, Sutsilvan, Surmiran, Vallader) nose</li></ol>
nateira	<i>noun</i><br><ol><li>(Surmiran) nature</li></ol>
natel|natels	<i>noun</i><br><ol><li>mobile phone, cellphone</li></ol>
natira	<i>noun</i><br><ol><li>(Rumantsch Grischun, Sursilvan, Sutsilvan) nature</li></ol>
natüra	<i>noun</i><br><ol><li>(Puter, Vallader) nature</li></ol>
nausch|nauschas|nauscha|nauschs	<i>adj</i><br><ol><li>(Rumantsch Grischun, Sursilvan) bad, rotten, evil</li></ol>
nav|navs	<i>noun</i><br><ol><li>(Rumantsch Grischun, Sursilvan, Sutsilvan, Surmiran, Vallader) ship</li></ol>
neabla|neablas	<i>noun</i><br><ol><li>(Sutsilvan) cloud</li></ol>
nebla|neblas	<i>noun</i><br><ol><li>(Sursilvan) cloud</li></ol>
neir|neira|neiras|neirs	<i>adj</i><br><ol><li>(Surmiran) black</li></ol><br><i>verb</i><br><ol><li>(Surmiran) to come</li></ol>
neiv	<i>noun</i><br><ol><li>(Sursilvan, Surmiran) snow</li></ol>
neivel|neivels	<i>noun</i><br><ol><li>(Surmiran) cloud</li></ol>
neiver	<i>verb</i><br><ol><li>(Sursilvan, Surmiran) to snow</li></ol>
ner|neras|nera|ners	<i>adj</i><br><ol><li>(Sursilvan, Sutsilvan) black</li></ol>
nes	<i>noun</i><br><ol><li>(anatomy, Puter) nose</li></ol>
nev|nevs	<i>noun</i><br><ol><li>(Sutsilvan) snow</li><li>(Puter) ship</li></ol>
never	<i>verb</i><br><ol><li>(Sutsilvan) to snow</li></ol>
nibel|nibels	<i>noun</i><br><ol><li>(Sursilvan) cloud</li></ol>
niev|novas|nievs|nova	<i>num</i><br><ol><li>(Sursilvan) new</li></ol>
nirom|niroms	<i>noun</i><br><ol><li>(anatomy, Surmiran) liver</li></ol>
niruncel|niruncels	<i>noun</i><br><ol><li>(Sutsilvan, anatomy) kidney</li></ol>
nirunchel|nirunchels	<i>noun</i><br><ol><li>(Surmiran, anatomy) kidney</li></ol>
nitschola|nitscholas	<i>noun</i><br><ol><li>(Rumantsch Grischun, Sursilvan, Sutsilvan, Surmiran) hazelnut</li></ol>
nitschoula|nitschoulas	<i>noun</i><br><ol><li>(Puter, Vallader) hazelnut</li></ol>
nivel|nivels	<i>noun</i><br><ol><li>(Rumantsch Grischun, Sutsilvan) cloud</li><li>(Rumantsch Grischun, Sursilvan, Sutsilvan, Surmiran, Vallader) level</li><li>(Puter) level (in an academic sense; for physical sense, see livel)</li></ol>
nivo|nivos	<i>noun</i><br><ol><li>(Sutsilvan, Surmiran) level</li></ol>
niz	<i>noun</i><br><ol><li>use</li></ol>
nodar	<i>verb</i><br><ol><li>(Vallader) to swim</li></ol><br><i>noun</i><br><ol><li>(Vallader) swimming</li></ol>
nola	<i>num</i><br><ol><li>(Sutsilvan) zero</li></ol>
nolla	<i>num</i><br><ol><li>(Surmiran, Puter, Vallader) zero</li></ol>
non|nons	<i>noun</i><br><ol><li>(Puter) grandfather</li></ol>
nord	<i>noun</i><br><ol><li>north</li></ol>
nordost	<i>noun</i><br><ol><li>northeast</li></ol>
nordvest	<i>noun</i><br><ol><li>northwest</li></ol>
nosch|noschs|noscha|noschas	<i>adj</i><br><ol><li>(Sutsilvan, Surmiran, Puter, Vallader) bad, rotten, evil</li></ol>
not|nots	<i>noun</i><br><ol><li>(Puter, Vallader) night</li></ol>
notar|notescha	<i>verb</i><br><ol><li>(Rumantsch Grischun, Sursilvan, Vallader) to note, write up, write down</li></ol>
noter	<i>verb</i><br><ol><li>(Puter) to note, write up, write down</li></ol>
notg|notgs	<i>noun</i><br><ol><li>(Rumantsch Grischun, Sursilvan, Sutsilvan, Surmiran) night</li></ol>
nousch|nouschs	<i>noun</i><br><ol><li>(Surmiran) nut, walnut</li></ol>
nouv|nouvs|nouva|nouvas	<i>num</i><br><ol><li>(Puter, Vallader) nine</li><li>(Puter, Vallader) new</li></ol>
nov|novs|novas|nova	<i>num</i><br><ol><li>(Rumantsch Grischun, Sursilvan, Sutsilvan, Surmiran) nine</li></ol><br><i>adj</i><br><ol><li>(Rumantsch Grischun, Sutsilvan, Surmiran) new</li></ol>
november	<i>name</i><br><ol><li>November</li></ol>
novitad|novitads	<i>noun</i><br><ol><li>(Rumantsch Grischun, Sursilvan, Sutsilvan, Surmiran) news item, item of news</li></ol>
novitads	<i>noun</i><br><ol><li>news</li></ol>
novited|noviteds	<i>noun</i><br><ol><li>(Puter) news item, item of news</li></ol>
novità|novitads	<i>noun</i><br><ol><li>(Vallader) news item, item of news</li></ol>
nudar|noda|nodel	<i>verb</i><br><ol><li>(Rumantsch Grischun, Sursilvan, Sutsilvan, Surmiran) to note, write up, write down</li><li>(Rumantsch Grischun, Sutsilvan, Surmiran) to swim</li></ol><br><i>noun</i><br><ol><li>(Rumantsch Grischun, Sutsilvan, Surmiran) swimming</li></ol>
nuder	<i>verb</i><br><ol><li>(Puter) to swim</li></ol><br><i>noun</i><br><ol><li>(Puter) swimming</li></ol>
nul	<i>num</i><br><ol><li>(Sursilvan) zero</li></ol>
nula	<i>num</i><br><ol><li>(Sutsilvan) zero</li></ol>
nulla	<i>num</i><br><ol><li>(Rumantsch Grischun, Sursilvan) zero</li></ol>
num|nums	<i>noun</i><br><ol><li>(Rumantsch Grischun, Sursilvan, Sutsilvan) name</li></ol>
nuorsa|nuorsas	<i>noun</i><br><ol><li>(Sursilvan) sheep</li><li>(Sursilvan, Puter, Vallader) ewe</li></ol>
nursa|nursas	<i>noun</i><br><ol><li>(Rumantsch Grischun, Sutsilvan, Surmiran) sheep, ewe</li></ol>
nus	<i>pron</i><br><ol><li>we</li></ol>
nusch|nuschs	<i>noun</i><br><ol><li>(Rumantsch Grischun, Sursilvan, Sutsilvan, Puter, Vallader) nut, walnut</li></ol>
nüvla|nüvlas	<i>noun</i><br><ol><li>(Puter, Vallader) cloud</li></ol>
oca|ocas	<i>noun</i><br><ol><li>(Sutsilvan, Surmiran) goose</li></ol>
och	<i>num</i><br><ol><li>(Puter) eight</li></ol>
ocha|ochas	<i>noun</i><br><ol><li>(Puter, Vallader) goose</li></ol>
october	<i>name</i><br><ol><li>October</li></ol>
offrir|offreschias|offreschel|vegnîen a offrir|vegn a offrir|offriu|vegnessien a offrir|vegnîes a offrir|offreschien|offrì|vegnin a offrir|offra|offran|offrissen|offressien|offrivas|offrevas|offrias|offreschas|vegnessen a offrir|offras|vegnan a offrir|offressi|offrevi|vegnessies a offrir|vegnies a offrir|vegnessi a offrir|offria|offrevies|offreschia|offris|offressies|offreschian|offrida|offreschan|offrisses|offrin|offri|offrivan|offress|vegni a offrir|offrevien|vegnel a offrir|vegnis a offrir|offresch|offrian|offrend|vegness a offrir|offr|offrais|offriss|offreva|offreschi|offrevan|offreschies|vegnesses a offrir|offrain|offrîes|vegnien a offrir|offriva|offressen|offrind|offrescha|offresses|offrîen|vegns a offrir|offrevel	<i>verb</i><br><ol><li>(Sursilvan, Rumantsch Grischun, Puter, Vallader) to offer</li></ol>
oliva|olivas	<i>noun</i><br><ol><li>(Sutsilvan, Puter, Vallader) olive (fruit)</li></ol>
olma|olmas	<i>noun</i><br><ol><li>soul</li></ol>
on|ons	<i>noun</i><br><ol><li>(Sutsilvan, Vallader) year</li></ol>
onda|ondas	<i>noun</i><br><ol><li>(Rumantsch Grischun, Sursilvan, Sutsilvan, Surmiran) aunt</li><li>(Surmiran) wave</li></ol>
onn|onns	<i>noun</i><br><ol><li>(Rumantsch Grischun, Sursilvan, Surmiran) year</li></ol>
or	<i>noun</i><br><ol><li>(Sutsilvan, Puter, Vallader) gold</li></ol>
ora	<i>noun</i><br><ol><li>(Sutsilvan, Surmiran, Puter, Vallader) weather</li></ol>
orandscha|orandschas	<i>noun</i><br><ol><li>(Puter, Vallader) orange</li></ol>
oranscha|oranschas	<i>noun</i><br><ol><li>(Rumantsch Grischun, Sursilvan, Sutsilvan, Surmiran) orange</li></ol>
ord	<i>adv</i><br><ol><li>outside</li></ol>
organisaziun|organisaziuns	<i>noun</i><br><ol><li>(Rumantsch Grischun, Sursilvan, Surmiran, Puter, Vallader) organization</li></ol>
organisaziùn|organisaziùns	<i>noun</i><br><ol><li>(Sutsilvan) organization</li></ol>
oriaint	<i>noun</i><br><ol><li>(Sutselvisch) east</li></ol>
ospital|ospitals	<i>noun</i><br><ol><li>hospital</li></ol>
oss|l'ossa|ossa	<i>noun</i><br><ol><li>(Rumantsch Grischun) bone</li><li>(Sutsilvan) bone</li></ol>
ost|osts	<i>noun</i><br><ol><li>east</li></ol>
ot|otas|ota|ots	<i>adj</i><br><ol><li>(Surmiran, Puter, Vallader) high</li></ol><br><i>num</i><br><ol><li>(Vallader) eight</li></ol>
oter|otras|oters|otra	<i>adj</i><br><ol><li>(Sutsilvan, Surmiran, Puter, Vallader) other</li><li>(time, Sutsilvan, Surmiran) next, coming</li></ol>
otg	<i>num</i><br><ol><li>(Rumantsch Grischun, Sursilvan, Sutsilvan, Surmiran) eight</li></ol>
otgover	<i>name</i><br><ol><li>October</li></ol>
our|ours	<i>noun</i><br><ol><li>(Surmiran) edge, margins</li></ol>
oura|ouras	<i>noun</i><br><ol><li>(Surmiran) time, hour</li></ol>
ouvra|ouvras	<i>noun</i><br><ol><li>(Puter, Vallader) work, oeuvre</li></ol>
ov|ovs	<i>noun</i><br><ol><li>(Rumantsch Grischun, Sutsilvan, Surmiran, biology, zoology, foods) egg</li></ol>
ova	<i>noun</i><br><ol><li>(Puter) water</li></ol>
ova da baiver	<i>noun</i><br><ol><li>(Puter) drinking water, potable water</li></ol>
ova da la spina	<i>noun</i><br><ol><li>(Puter) tap water</li></ol>
ova dal chüern	<i>noun</i><br><ol><li>(Puter) tap water</li></ol>
ova minerela	<i>noun</i><br><ol><li>(Puter) mineral water</li></ol>
ovra|ovras	<i>noun</i><br><ol><li>(Rumantsch Grischun, Sursilvan, Sutsilvan, Surmiran) work, oeuvre</li></ol>
oz	<i>adv</i><br><ol><li>today</li></ol>
paeis	<i>noun</i><br><ol><li>(Surmiran) country, land</li></ol>
pair|pairs	<i>noun</i><br><ol><li>(Rumantsch Grischun, Puter, Vallader) pear</li></ol>
pais	<i>noun</i><br><ol><li>(Puter, Vallader) weight</li></ol>
paisa	<i>noun</i><br><ol><li>(Rumantsch Grischun) weight</li></ol>
paiver	<i>noun</i><br><ol><li>(Rumantsch Grischun, Puter, Vallader) pepper</li></ol>
pajais	<i>noun</i><br><ol><li>(Rumantsch Grischun, Puter, Vallader) country, land</li></ol>
pajis	<i>noun</i><br><ol><li>(Sutsilvan) country, land</li></ol>
paliet|paliats	<i>noun</i><br><ol><li>(Rumantsch Grischun, Sursilvan) arrow</li></ol>
paloga|palogas	<i>noun</i><br><ol><li>(Puter) prune</li></ol>
paloja|palojas	<i>noun</i><br><ol><li>(Sutsilvan) prune</li></ol>
palperi|palperis	<i>noun</i><br><ol><li>(Puter, Vallader) paper</li></ol>
palpier|palpiers	<i>noun</i><br><ol><li>(Sutsilvan) paper</li></ol>
palpieri|palpieris	<i>noun</i><br><ol><li>(Surmiran) paper</li></ol>
palpiri|palpiris	<i>noun</i><br><ol><li>(Rumantsch Grischun) paper</li></ol>
pan|pans	<i>noun</i><br><ol><li>(Vallader, uncountable) bread</li><li>(Vallader, countable) loaf of bread</li></ol>
pancetta	<i>noun</i><br><ol><li>(Surmiran) bacon</li></ol>
pandarliez|pandarliezs	<i>noun</i><br><ol><li>(Sutsilvan) earring</li></ol>
pandschè|pandschels	<i>noun</i><br><ol><li>(Puter, weather) snowflake</li></ol>
pang|pangs	<i>noun</i><br><ol><li>(Surmiran) bread</li><li>(Surmiran) loaf of bread</li></ol>
panzetta	<i>noun</i><br><ol><li>(Puter, Vallader) bacon</li></ol>
paraid|paraids	<i>noun</i><br><ol><li>(Rumantsch Grischun, Puter, Vallader) (internal) wall</li><li>(Rumantsch Grischun, Puter, Vallader) rock face</li></ol>
paraplievgia|paraplievgias	<i>noun</i><br><ol><li>(Rumantsch Grischun) umbrella, parasol</li></ol>
paraplövgia|paraplövgias	<i>noun</i><br><ol><li>(Puter) umbrella, parasol</li></ol>
parasul|parasuls	<i>noun</i><br><ol><li>(Vallader) umbrella, parasol</li></ol>
pare|pares	<i>noun</i><br><ol><li>(Sutsilvan, Surmiran) (internal) wall</li><li>(Sutsilvan, Surmiran) rock face</li></ol>
parisol|parisols	<i>noun</i><br><ol><li>(Rumantsch Grischun, Sursilvan, Sutsilvan, Puter) umbrella, parasol</li></ol>
parquegl	<i>conj</i><br><ol><li>(Sutsilvan) therefore, thus, for that reason</li></ol>
parquegl ca	<i>conj</i><br><ol><li>(Sutsilvan) because, since</li></ol>
parsul|parsula|parsuls|parsulas	<i>adj</i><br><ol><li>(Sutsilvan) alone</li></ol>
partenadi	<i>noun</i><br><ol><li>partnership</li></ol>
partenadi registrà	<i>noun</i><br><ol><li>registered partnership, civil partnership</li></ol>
partgirar	<i>verb</i><br><ol><li>(Sutsilvan) to look after, care for</li></ol>
parüschla|parüschlas	<i>noun</i><br><ol><li>(Vallader, birds) tit</li></ol>
parüschla blaua	<i>noun</i><br><ol><li>(Vallader) blue tit</li></ol>
parüschla da god	<i>noun</i><br><ol><li>(Vallader) coal tit</li></ol>
pasant|pasantas|pasanta|pasants	<i>adj</i><br><ol><li>(Surmiran) heavy</li></ol>
pasch	<i>noun</i><br><ol><li>(Rumantsch Grischun, Sursilvan, Sutsilvan, Surmiran, Vallader) peace</li><li>(Sutsilvan) quiet, stillness</li></ol>
paschaivel|paschaivels|paschaivlas|paschaivla	<i>adj</i><br><ol><li>(Rumantsch Grischun, Puter, Vallader) peaceful</li></ol>
pascheivel|pascheivlas|pascheivels|pascheivla	<i>adj</i><br><ol><li>(Sursilvan) peaceful</li></ol>
paschevel|paschevels|paschevla|paschevlas	<i>adj</i><br><ol><li>(Sutsilvan, Surmiran) peaceful</li></ol>
pasler|paslers	<i>noun</i><br><ol><li>sparrow (Passer domesticus)</li></ol>
pasta da daints	<i>noun</i><br><ol><li>(Sutsilvan, Surmiran, Puter, Vallader) toothpaste</li></ol>
pasta da dents	<i>noun</i><br><ol><li>(Rumantsch Grischun, Sursilvan) toothpaste</li></ol>
pasànt|pasànts|pasànta|pasàntas	<i>adj</i><br><ol><li>(Sutsilvan) heavy</li></ol>
paun|pauns	<i>noun</i><br><ol><li>(Rumantsch Grischun, Sursilvan, Puter) bread</li><li>(Rumantsch Grischun, Sursilvan, Puter) loaf of bread</li></ol>
paur|paurs	<i>noun</i><br><ol><li>(Vallader) peasant, farmer</li></ol>
pavun|pavuns	<i>noun</i><br><ol><li>(Rumantsch Grischun, Puter, Vallader) peacock</li></ol>
pavùn|pavùns	<i>noun</i><br><ol><li>(Sutsilvan) peacock</li></ol>
pe|peis|pes	<i>noun</i><br><ol><li>(Rumantsch Grischun, Sutsilvan, Surmiran, anatomy) foot</li></ol>
pegn	<i>noun</i><br><ol><li>(Sutsilvan, Surmiran) spruce, fir</li></ol>
pei|peis	<i>noun</i><br><ol><li>(Sursilvan, anatomy) foot</li></ol>
peir|peirs	<i>noun</i><br><ol><li>(Surmiran) pear</li></ol>
peisa	<i>noun</i><br><ol><li>(Sursilvan, Surmiran) weight</li></ol>
perche cha	<i>conj</i><br><ol><li>(Puter, Vallader) because, since</li></ol>
perchegl	<i>conj</i><br><ol><li>(Surmiran) therefore, thus, for that reason</li></ol><br><i>prep</i><br><ol><li>(Surmiran) on account of, due to, because of</li></ol>
perchegl tgi	<i>conj</i><br><ol><li>(Surmiran) because, since</li></ol>
perchürer	<i>verb</i><br><ol><li>(Puter, Vallader) to look after, care for</li></ol>
perquai	<i>conj</i><br><ol><li>(Rumantsch Grischun, Vallader) therefore, thus, for that reason</li></ol>
perquai cha	<i>conj</i><br><ol><li>(Vallader) because, since</li></ol>
perquai che	<i>conj</i><br><ol><li>(Rumantsch Grischun) because, since</li></ol>
perque	<i>conj</i><br><ol><li>(Puter) therefore, thus, for that reason</li></ol>
perquei	<i>conj</i><br><ol><li>(Sursilvan) therefore, thus, for that reason</li></ol>
perquei che	<i>conj</i><br><ol><li>(Sursilvan) because, since</li></ol>
persic|persics	<i>noun</i><br><ol><li>peach</li></ol>
persul|persula|persulas|persuls	<i>adj</i><br><ol><li>(Sursilvan) alone</li></ol>
persuna	<i>noun</i><br><ol><li>person</li></ol>
pertgirar	<i>verb</i><br><ol><li>(Rumantsch Grischun, Sursilvan, Surmiran) to look after, care for</li></ol>
pesa	<i>noun</i><br><ol><li>(Sutsilvan) weight</li></ol>
pesant|pesanta|pesants|pesantas	<i>adj</i><br><ol><li>(Rumantsch Grischun, Puter, Vallader) heavy</li></ol>
pesch	<i>noun</i><br><ol><li>(Rumantsch Grischun, Sutsilvan, Surmiran, Puter, Vallader) fish</li></ol>
pesont|pesontas|pesonts|pesonta	<i>adj</i><br><ol><li>(Sursilvan) heavy</li></ol>
pestg	<i>noun</i><br><ol><li>(Sutsilvan) fish</li></ol>
pet|pets	<i>noun</i><br><ol><li>(Puter, Vallader, anatomy) chest, thorax</li></ol>
peta|petas	<i>noun</i><br><ol><li>(Sutsilvan) a cake in the shape of a loaf</li></ol>
petsch	<i>noun</i><br><ol><li>(Vallader) spruce</li></ol>
petta|pettas	<i>noun</i><br><ol><li>(Rumantsch Grischun, Sursilvan, Surmiran, Puter, Vallader) a cake in the shape of a loaf</li></ol>
pier|piers	<i>noun</i><br><ol><li>(Sutsilvan) beer, ale</li></ol>
piertg|piertgs	<i>noun</i><br><ol><li>(Sursilvan, Sutsilvan) pig</li></ol>
pievel|pievels	<i>noun</i><br><ol><li>(Rumantsch Grischun, Sursilvan, Sutsilvan, Surmiran) people, nation</li></ol>
pign|pigns|pitschna|pitschnas	<i>noun</i><br><ol><li>(Rumantsch Grischun) spruce, fir</li></ol><br><i>adj</i><br><ol><li>(Sursilvan) small</li></ol>
pignouler|pignoulers	<i>noun</i><br><ol><li>(Surmiran) coal tit</li></ol>
piliet|piliets	<i>noun</i><br><ol><li>(Sutsilvan) arrow</li></ol>
pin	<i>noun</i><br><ol><li>(Puter, Vallader) spruce, fir</li></ol>
pingoula	<i>noun</i><br><ol><li>(Vallader) cotton</li></ol>
pintg|pitschna|pitschnas|pintgs	<i>adj</i><br><ol><li>(Sutsilvan) small</li></ol>
pitschen|pitschna|pitschnas|pitschens	<i>adj</i><br><ol><li>(Rumantsch Grischun, Surmiran, Puter, Vallader) small</li></ol>
pivun|pivuns	<i>noun</i><br><ol><li>(Sutsilvan) peacock</li></ol>
pivung|pivungs	<i>noun</i><br><ol><li>(Surmiran) peacock</li></ol>
pivùn|pivùns	<i>noun</i><br><ol><li>(Sutsilvan) peacock</li></ol>
plagn|plagna|plagns|plagnas	<i>adj</i><br><ol><li>(Sutsilvan, Surmiran) full</li></ol>
plaid|plaids	<i>noun</i><br><ol><li>(Sursilvan) word</li></ol>
plain|plains|plaina|plainas	<i>adj</i><br><ol><li>(Rumantsch Grischun, Puter, Vallader) full</li></ol>
planet|planets	<i>noun</i><br><ol><li>(astronomy, astrology) planet</li></ol>
planta|plantas	<i>noun</i><br><ol><li>(Rumantsch Grischun, Surmiran, Vallader) plant</li><li>(Rumantsch Grischun, Surmiran) tree</li></ol>
plaunta|plauntas	<i>noun</i><br><ol><li>(Puter) plant</li></ol>
plaz	<i>noun</i><br><ol><li>(Rumantsch Grischun, Sursilvan, Sutsilvan, Surmiran) place, square</li></ol>
plaza|plazas	<i>noun</i><br><ol><li>place, position</li><li>job, employment</li></ol>
plazza|plazzas	<i>noun</i><br><ol><li>(Rumantsch Grischun, Sursilvan, Surmiran, Puter, Vallader) place, position</li><li>(Rumantsch Grischun, Sursilvan, Surmiran, Puter, Vallader) job, employment</li><li>(Rumantsch Grischun, Sursilvan, Puter, Vallader) place, square</li></ol>
pled|pleds	<i>noun</i><br><ol><li>(Rumantsch Grischun, Sutsilvan, Surmiran, Puter, Vallader) word</li></ol>
pledar|pledia|pledai|pledavan|pledond|pleda|pledassas|na pleda betg|pledain|pledava|pledas|pledà|pledias|pledian|pledavas|pledaran|pled|pledais|pledan|pledass|pledassan|na pledai betg	<i>verb</i><br><ol><li>(Rumantsch Grischun) to speak</li></ol>
pledari|pledaris	<i>noun</i><br><ol><li>(Rumantsch Grischun, Sursilvan, Sutsilvan, Surmiran) dictionary</li></ol>
plein|pleinas|pleina|pleins	<i>adj</i><br><ol><li>(Sursilvan) full</li></ol>
pli	<i>adv</i><br><ol><li>more</li></ol>
plidar|plaida	<i>verb</i><br><ol><li>(Sursilvan, Sutsilvan) to speak</li></ol>
plievgia	<i>noun</i><br><ol><li>(Rumantsch Grischun, Sursilvan, Sutsilvan, Surmiran) rain, rainfall</li></ol>
plievia	<i>noun</i><br><ol><li>(Sutsilvan) rain, rainfall</li></ol>
ploma|plomas	<i>noun</i><br><ol><li>(Surmiran) pile, lot, quantity</li></ol>
plonta|plontas	<i>noun</i><br><ol><li>(Sursilvan) plant</li><li>(Sursilvan) tree</li></ol>
plum	<i>noun</i><br><ol><li>(Rumantsch Grischun, Sursilvan) lead (metal)</li></ol>
plànta|plàntas	<i>noun</i><br><ol><li>(Sutsilvan) plant</li><li>(Sutsilvan) tree</li></ol>
plövgia	<i>noun</i><br><ol><li>(Puter, Vallader) rain, rainfall</li></ol>
plùna|plùnas	<i>noun</i><br><ol><li>(Sutsilvan) pile, lot, quantity</li></ol>
polvra	<i>noun</i><br><ol><li>(Surmiran) dust, powder</li></ol>
poppen cotschen	<i>noun</i><br><ol><li>(Surmiran) robin (Erithacus rubecula)</li></ol>
portafegl|portafegls	<i>noun</i><br><ol><li>(Rumantsch Grischun, Sursilvan) wallet</li></ol>
portafigl|portafigls	<i>noun</i><br><ol><li>(Sutsilvan, Surmiran) wallet</li></ol>
portafögl|portafögls	<i>noun</i><br><ol><li>(Puter, Vallader) wallet</li></ol>
portg|portgs	<i>noun</i><br><ol><li>(Rumantsch Grischun, Surmiran) pig</li></ol>
pour|pours	<i>noun</i><br><ol><li>(Surmiran) peasant, farmer</li><li>(Surmiran, chess) pawn</li></ol>
preit|preits	<i>noun</i><br><ol><li>(Sursilvan) (internal) wall</li><li>(Sursilvan) rock face</li></ol>
prem|prems	<i>noun</i><br><ol><li>(Sursilvan, Sutsilvan, Surmiran) prune</li></ol>
prema|premas	<i>noun</i><br><ol><li>(Sursilvan) prune</li></ol>
primavaira	<i>noun</i><br><ol><li>spring</li></ol>
primbla|primblas	<i>noun</i><br><ol><li>(Rumantsch Grischun) prune</li></ol>
prisol|prisols	<i>noun</i><br><ol><li>(Sutsilvan) umbrella, parasol</li></ol>
profet|profets	<i>noun</i><br><ol><li>(religion) prophet</li></ol>
prossem|prosma|prosmas|prossems	<i>adj</i><br><ol><li>(Puter, Vallader) next</li></ol>
protocol|protocols	<i>noun</i><br><ol><li>minutes (of meeting)</li></ol>
proxim|proximas|proxims|proxima	<i>adj</i><br><ol><li>(Rumantsch Grischun, Sursilvan, Sutsilvan, Surmiran) next</li></ol>
prüna|prünas	<i>noun</i><br><ol><li>(Puter) prune</li></ol>
psicologia|psicologias	<i>noun</i><br><ol><li>(Rumantsch Grischun, Sursilvan, Surmiran, Puter) psychology</li></ol>
pudair|pudids|pudain|pudessas|poss|pudais|pudessan|pudevas|pudì|pudevan|pon|pudess|possia|pos|pudend|possias|possian|po|pudeva|pudidas	<i>verb</i><br><ol><li>(Rumantsch Grischun, Puter, Vallader) to be able (to)</li></ol>
pudeir	<i>verb</i><br><ol><li>(Surmiran) to be able (to)</li></ol>
puder	<i>verb</i><br><ol><li>(Sursilvan, Sutsilvan) to be able (to)</li></ol>
pugn|pugns	<i>noun</i><br><ol><li>(anatomy, Rumantsch Grischun, Sursilvan, Sutsilvan, Surmiran) fist</li></ol>
pula|pulas	<i>noun</i><br><ol><li>(Surmiran) butterfly, moth</li><li>(Rumantsch Grischun, Sutsilvan, Surmiran) hen</li></ol>
pulpier|pulpiers	<i>noun</i><br><ol><li>(Sutsilvan) paper</li></ol>
pulver	<i>noun</i><br><ol><li>(Sutsilvan) powder</li></ol>
pulvra	<i>noun</i><br><ol><li>(Rumantsch Grischun, Sutsilvan) dust, powder</li></ol>
pumrànza|pumrànzas	<i>noun</i><br><ol><li>(Sutsilvan) orange</li></ol>
punt|punts	<i>noun</i><br><ol><li>(Rumantsch Grischun, Sursilvan, Surmiran, Puter, Vallader) bridge</li></ol>
puogn|puogns	<i>noun</i><br><ol><li>(anatomy, Puter, Vallader) fist</li></ol>
puolvra	<i>noun</i><br><ol><li>(Puter, Vallader) dust, powder</li></ol>
puorla	<i>noun</i><br><ol><li>(Sursilvan) dust, powder</li></ol>
pupencotschen	<i>noun</i><br><ol><li>(Sutsilvan) robin (Erithacus rubecula)</li></ol>
pupi|pupis	<i>noun</i><br><ol><li>(Sursilvan) paper</li></ol>
pupier|pupiers	<i>noun</i><br><ol><li>(Sutsilvan) paper</li></ol>
puppen cotschen	<i>noun</i><br><ol><li>(Rumantsch Grischun) robin (Erithacus rubecula)</li></ol>
puppen tgietschen	<i>noun</i><br><ol><li>(Sursilvan) robin (Erithacus rubecula)</li></ol>
pur|pura|purs|puras	<i>adj</i><br><ol><li>pure</li></ol><br><i>noun</i><br><ol><li>peasant, farmer</li><li>(chess) pawn</li></ol>
purgia	<i>noun</i><br><ol><li>(medicine, Surmiran) diarrhea</li></ol>
purgiativ|purgiativs	<i>noun</i><br><ol><li>laxative</li></ol>
purschel|purschels	<i>noun</i><br><ol><li>(Surmiran) piglet</li></ol>
purschi|purschals	<i>noun</i><br><ol><li>(Sursilvan) piglet</li></ol>
purschlin|purschlins	<i>noun</i><br><ol><li>(Puter, Vallader) piglet</li></ol>
purschè|purschels	<i>noun</i><br><ol><li>(Rumantsch Grischun) piglet</li></ol>
purschè da spargn|purschels da spargn	<i>noun</i><br><ol><li>(Rumantsch Grischun) piggy bank</li></ol>
purtret|purtrets	<i>noun</i><br><ol><li>(Puter, Vallader) picture</li></ol>
purtscheala|purtschealas	<i>noun</i><br><ol><li>(Sutsilvan) piglet</li></ol>
purtschi	<i>noun</i><br><ol><li>(Sutsilvan) piglet</li></ol>
puspe	<i>adv</i><br><ol><li>(Sutsilvan, Surmiran) again</li></ol>
puspei	<i>adv</i><br><ol><li>(Sursilvan) again</li></ol>
puspè	<i>adv</i><br><ol><li>(Rumantsch Grischun) again</li></ol>
pussaivladad|pussaivladads	<i>noun</i><br><ol><li>(Rumantsch Grischun) possibility, chance, opportunity</li></ol>
pussebladad|pussebladads	<i>noun</i><br><ol><li>(Surmiran) possibility, chance, opportunity</li></ol>
pusseivladad|pusseivladads	<i>noun</i><br><ol><li>(Sursilvan) possibility, chance, opportunity</li></ol>
pussevladad|pussevladads	<i>noun</i><br><ol><li>(Sutsilvan) possibility, chance, opportunity</li></ol>
pussibilità|pussibilitats	<i>noun</i><br><ol><li>(Vallader) possibility, chance, opportunity</li></ol>
pussibilted|pussibilteds	<i>noun</i><br><ol><li>(Puter) possibility, chance, opportunity</li></ol>
pàn|pàns	<i>noun</i><br><ol><li>(Sutsilvan, uncountable) bread</li><li>(Sutsilvan, countable) loaf of bread</li></ol>
pè|peis	<i>noun</i><br><ol><li>(anatomy, Puter, Vallader) foot</li></ol>
pèsch	<i>noun</i><br><ol><li>(Sursilvan) fish</li></ol>
pèz|pèzs	<i>noun</i><br><ol><li>(anatomy, Rumantsch Grischun, Sursilvan, Surmiran) chest, thorax</li></ol>
pégn	<i>noun</i><br><ol><li>(Sursilvan) spruce, fir</li></ol>
pér|pérs	<i>noun</i><br><ol><li>(Sursilvan, Sutsilvan) pear</li></ol>
péz|pézs	<i>noun</i><br><ol><li>(anatomy, Sutsilvan) chest, thorax</li></ol>
pêsch	<i>noun</i><br><ol><li>(Puter) peace</li></ol>
pövel|pövels	<i>noun</i><br><ol><li>(Puter, Vallader) people, nation</li></ol>
pùnt|pùnts	<i>noun</i><br><ol><li>(Sutsilvan) bridge</li></ol>
püerch|püerchs	<i>noun</i><br><ol><li>(Puter, Vallader) pig</li></ol>
püerch spinus|püerchs spinus	<i>noun</i><br><ol><li>(Vallader) hedgehog (Erinaceus europaeus)</li></ol>
pür|pürs|püras|püra	<i>adj</i><br><ol><li>(Puter, Vallader) pure</li></ol>
qua	<i>adv</i><br><ol><li>here</li></ol>
quater	<i>num</i><br><ol><li>(Sursilvan, Sutsilvan) four</li></ol>
quatter	<i>num</i><br><ol><li>(Rumantsch Grischun, Surmiran, Puter, Vallader) four</li></ol>
quattordesch	<i>num</i><br><ol><li>(Rumantsch Grischun, Puter, Vallader) fourteen</li></ol>
quel|quella	<i>det</i><br><ol><li>that</li></ol>
quella	<i>det</i><br><ol><li>that</li></ol>
quest	<i>pron</i><br><ol><li>this</li></ol>
questa	<i>det</i><br><ol><li>this</li></ol>
quindesch	<i>num</i><br><ol><li>(Rumantsch Grischun, Puter, Surmiran, Vallader) fifteen</li></ol>
quintader|quintaders	<i>noun</i><br><ol><li>(Sursilvan) calculator</li></ol>
quintar	<i>verb</i><br><ol><li>(Rumantsch Grischun, Sursilvan, Sutsilvan, Puter, Vallader) to reckon</li></ol>
quitar	<i>verb</i><br><ol><li>(Sursilvan) to think, believe, reckon, have an opinion on</li></ol>
rabarber|rabarbers	<i>noun</i><br><ol><li>rhubarb</li></ol>
rabgia	<i>noun</i><br><ol><li>(Sutsilvan, Surmiran, Puter) anger, rage</li></ol>
radond|radondas|radonda|radonds	<i>adj</i><br><ol><li>(Surmiran) round</li></ol><br><i>adv</i><br><ol><li>(Surmiran) about, roughly, approximately</li></ol>
radund|radundas|radunda|radunds	<i>adj</i><br><ol><li>(Rumantsch Grischun, Sutsilvan, Puter, Vallader) round</li></ol><br><i>adv</i><br><ol><li>(Rumantsch Grischun, Sutsilvan, Puter, Vallader) about, roughly, approximately</li></ol>
raginam|raginams	<i>noun</i><br><ol><li>(Sutsilvan) kingdom</li></ol>
ragisch|ragischs	<i>noun</i><br><ol><li>(Rumantsch Grischun, Sursilvan, Sutsilvan, Puter, Vallader) root</li></ol>
ragn|ragns	<i>noun</i><br><ol><li>(Sutsilvan, Surmiran) river</li></ol>
rai|rais	<i>noun</i><br><ol><li>(Vallader) king</li></ol>
raig|raigs	<i>noun</i><br><ol><li>(Puter) king</li></ol>
ram|rams	<i>noun</i><br><ol><li>(Puter) branch (of tree, river, etc.)</li><li>(Puter, education) subject</li><li>(Puter) frame, framework</li><li>(Puter) knot, gnarl</li></ol>
rama|ramas	<i>noun</i><br><ol><li>(Sursilvan) frame, framework</li></ol>
ranuogl|ranuogls	<i>noun</i><br><ol><li>(Vallader, anatomy) kidney</li></ol>
rat|rats	<i>noun</i><br><ol><li>(Surmiran) rat</li></ol>
ratun|ratuns	<i>noun</i><br><ol><li>(Rumantsch Grischun, Sursilvan) rat</li></ol>
ratung|ratungs	<i>noun</i><br><ol><li>(Surmiran) rat</li></ol>
ratùn|ratùns	<i>noun</i><br><ol><li>(Sutsilvan) rat</li></ol>
rauna|raunas	<i>noun</i><br><ol><li>frog</li></ol>
ravgia	<i>noun</i><br><ol><li>(Rumantsch Grischun, Sursilvan, Sutsilvan) anger, rage</li></ol>
reflexiv|reflexivas|reflexivs|reflexiva	<i>adj</i><br><ol><li>(grammar) reflexive</li></ol>
reginam|reginams	<i>noun</i><br><ol><li>(Rumantsch Grischun, Puter) kingdom</li></ol>
reginavel|reginavels	<i>noun</i><br><ol><li>(Rumantsch Grischun, Sursilvan, Surmiran) kingdom</li></ol>
reginom|reginoms	<i>noun</i><br><ol><li>(Vallader) kingdom</li></ol>
religiun|religiuns	<i>noun</i><br><ol><li>(Rumantsch Grischun, Sursilvan, Surmiran, Puter, Vallader) religion</li></ol>
religiùn|religiùns	<i>noun</i><br><ol><li>(Sutsilvan) religion</li></ol>
render	<i>verb</i><br><ol><li>(Rumantsch Grischun, Sutsilvan, Surmiran, Puter, Vallader) to return, give back</li><li>to vomit, throw up, puke, be sick</li></ol>
rentga|rentgas	<i>noun</i><br><ol><li>(Surmiran)</li></ol>
rentga d'ureglia|rentgas d'ureglia	<i>noun</i><br><ol><li>(Sutsilvan) earring</li></ol>
reptil|reptils	<i>noun</i><br><ol><li>reptile</li></ol>
republica|republicas	<i>noun</i><br><ol><li>republic</li></ol>
resgia	<i>noun</i><br><ol><li>saw</li></ol>
resgim	<i>noun</i><br><ol><li>sawdust</li></ol>
respirar	<i>verb</i><br><ol><li>(Rumantsch Grischun, Sursilvan, Sutsilvan, Surmiran, Vallader) to breathe</li></ol>
respirer	<i>verb</i><br><ol><li>(Puter) to breathe</li></ol>
restitueir	<i>verb</i><br><ol><li>(Surmiran) to return, give back</li></ol>
restituir	<i>verb</i><br><ol><li>(Rumantsch Grischun, Sursilvan, Sutsilvan, Puter, Vallader) to return, give back</li></ol>
retg|retgs	<i>noun</i><br><ol><li>king</li><li>(chess) king</li></ol>
retscha	<i>noun</i><br><ol><li>row</li></ol>
retuornar	<i>verb</i><br><ol><li>(Vallader) to return, give back</li></ol>
returnar	<i>verb</i><br><ol><li>(Rumantsch Grischun, Sursilvan, Sutsilvan, Surmiran) to return, go back, come back</li><li>(Rumantsch Grischun, Sursilvan, Sutsilvan, Surmiran) to return, give back</li></ol>
returner	<i>verb</i><br><ol><li>(Puter) to return, give back</li></ol>
rieisch|rieischs	<i>noun</i><br><ol><li>(Surmiran) root</li></ol>
rintga|rintgas	<i>noun</i><br><ol><li>(Rumantsch Grischun, Sursilvan)</li></ol>
rir	<i>verb</i><br><ol><li>(Rumantsch Grischun, Sursilvan, Sutsilvan, Puter) to laugh</li></ol>
risch|rischs	<i>noun</i><br><ol><li>(Sutsilvan, Puter) root</li></ol>
risch melna|rischs melnas	<i>noun</i><br><ol><li>(Rumantsch Grischun) carrot</li></ol>
rischmelna|rischs melnas	<i>noun</i><br><ol><li>(Surmiran, Puter) carrot</li></ol>
rivir	<i>verb</i><br><ol><li>(Vallader) to open</li></ol>
rizza|rizzas	<i>noun</i><br><ol><li>(Surmiran, Puter, Vallader) hedgehog (Erinaceus europaeus)</li></ol>
roda|rodas	<i>noun</i><br><ol><li>(Rumantsch Grischun, Sursilvan, Sutsilvan, Surmiran) wheel</li></ol>
rodund|rodundas|rodunda|rodunds	<i>adj</i><br><ol><li>(Sursilvan) round</li></ol><br><i>adv</i><br><ol><li>(Sursilvan) about, roughly, approximately</li></ol>
rom|roms	<i>noun</i><br><ol><li>(Rumantsch Grischun, Sursilvan, Sutsilvan, Surmiran, Vallader) branch (of tree, river, etc.)</li><li>(Rumantsch Grischun, Sursilvan, Sutsilvan, Surmiran, Vallader, education) subject</li><li>(Rumantsch Grischun, Sursilvan, Sutsilvan, Surmiran, Vallader) frame, framework</li><li>(Rumantsch Grischun, Sursilvan, Sutsilvan, Surmiran, Vallader) knot, gnarl</li></ol>
romontsch|romontschas|romontscha|romontschs	<i>adj</i><br><ol><li>(Sursilvan) Romansch</li></ol><br><i>name</i><br><ol><li>(Sursilvan) Romansch</li></ol>
rosa|rosas	<i>noun</i><br><ol><li>(Rumantsch Grischun, Sursilvan, Sutsilvan, Surmiran) rose</li></ol>
rouda|roudas	<i>noun</i><br><ol><li>(Puter, Vallader) wheel</li></ol>
rugada	<i>noun</i><br><ol><li>dew</li></ol>
rumantsch|rumantschs|rumantschas|rumantscha	<i>adj</i><br><ol><li>(Rumantsch Grischun, Surmiran, Vallader) Romansch</li></ol><br><i>name</i><br><ol><li>(Rumantsch Grischun, Surmiran, Vallader) Romansch</li></ol>
rumauntsch|rumauntscha|rumauntschs|rumauntschas	<i>adj</i><br><ol><li>(Puter) Romansch</li></ol><br><i>name</i><br><ol><li>(Puter) Romansch</li></ol>
rumàntsch|rumàntscha|rumàntschs|rumàntschas	<i>adj</i><br><ol><li>(Sutsilvan) Romansch</li></ol><br><i>name</i><br><ol><li>(Sutsilvan) Romansch</li></ol>
rètg|rètgs	<i>noun</i><br><ol><li>(Surmiran) king</li></ol>
rösa|rösas	<i>noun</i><br><ol><li>(Puter, Vallader) rose</li></ol>
s'avrir	<i>verb</i><br><ol><li>(Rumantsch Grischun) to open (become open)</li></ol>
sa darveir	<i>verb</i><br><ol><li>(Surmiran) to open (become open)</li></ol>
sablun|sabluns	<i>noun</i><br><ol><li>(Rumantsch Grischun, Sursilvan, Puter, Vallader) sand</li></ol>
sablung|sablungs	<i>noun</i><br><ol><li>(Surmiran) sand</li></ol>
sablùn|sablùns	<i>noun</i><br><ol><li>(Sutsilvan) sand</li></ol>
saduvrir	<i>verb</i><br><ol><li>(Sutsilvan) to open (become open)</li></ol>
sagir|sagirs	<i>noun</i><br><ol><li>(Sutsilvan) axe</li></ol>
sagn	<i>noun</i><br><ol><li>(Sutsilvan, Surmiran, anatomy) breast (of a woman)</li></ol>
said	<i>noun</i><br><ol><li>(Rumantsch Grischun, Puter, Vallader) thirst</li></ol>
saida	<i>noun</i><br><ol><li>(Rumantsch Grischun, Puter, Vallader) silk</li></ol>
sain	<i>noun</i><br><ol><li>(Rumantsch Grischun, anatomy) breast (of a woman)</li></ol>
saira|sairas	<i>noun</i><br><ol><li>(Rumantsch Grischun, Puter, Vallader) evening</li></ol>
sajetta	<i>noun</i><br><ol><li>(Puter, Vallader) lightning</li></ol>
sal	<i>noun</i><br><ol><li>(Rumantsch Grischun, Sursilvan, Sutsilvan, Surmiran, Vallader) salt</li></ol>
sanester|sanesters|sanestra|sanestras	<i>noun</i><br><ol><li>(Rumantsch Grischun, Surmiran) left</li></ol><br><i>adj</i><br><ol><li>(Rumantsch Grischun, Surmiran) left</li></ol>
sang	<i>noun</i><br><ol><li>blood</li></ol>
saniester|saniestras|saniesters|saniestra	<i>noun</i><br><ol><li>(Sutsilvan) left</li></ol><br><i>adj</i><br><ol><li>(Sutsilvan) left</li></ol>
sarar	<i>verb</i><br><ol><li>(Sutsilvan, Surmiran) to close</li></ol>
sarver	<i>verb</i><br><ol><li>(Sursilvan) to open (become open)</li></ol>
sategl|sategls|sateglas|sategla	<i>adj</i><br><ol><li>(Sutsilvan) thin</li></ol>
satel|satellas|satels|satella	<i>adj</i><br><ol><li>(Sursilvan) thin</li></ol>
satember	<i>name</i><br><ol><li>(Sutsilvan) September</li></ol>
satigl|satigls|satigla|satiglas	<i>adj</i><br><ol><li>(Rumantsch Grischun) thin</li></ol>
savair|savida|sa|sappia|sappias|savì|savevan|savids|savend|sas|savais|savevas|savess|sappian|saveva|sai|savidas|san|savessan|savessas|savain	<i>verb</i><br><ol><li>(Rumantsch Grischun, Puter, Vallader) to know (how to do something)</li></ol>
savair grà	<i>verb</i><br><ol><li>(Rumantsch Grischun, Vallader) to be grateful, thankful (~ (a))</li></ol>
savair grô	<i>verb</i><br><ol><li>(Puter) to be grateful, thankful</li></ol>
saveir	<i>verb</i><br><ol><li>(Surmiran) to know (how to do something)</li></ol>
saveir gro	<i>verb</i><br><ol><li>(Surmiran) to be grateful, thankful</li></ol>
saver	<i>verb</i><br><ol><li>(Sursilvan, Sutsilvan) to know (how to do something)</li></ol>
saver gra	<i>verb</i><br><ol><li>(Sutsilvan) to be grateful, thankful</li></ol>
saver grau	<i>verb</i><br><ol><li>(Sursilvan) to be grateful, thankful</li></ol>
savetscha|savetschas	<i>noun</i><br><ol><li>(Sursilvan) fork (eating utensil)</li></ol>
savun|savuns	<i>noun</i><br><ol><li>(Rumantsch Grischun, Sursilvan, Puter, Vallader) soap</li></ol>
savung|savungs	<i>noun</i><br><ol><li>(Surmiran) soap</li></ol>
savurar	<i>verb</i><br><ol><li>(Rumantsch Grischun, Sutsilvan, Vallader, followed by da) to smell (of)</li></ol>
savurer	<i>verb</i><br><ol><li>(Puter, followed by da) to smell (of)</li></ol>
savùn|savùns	<i>noun</i><br><ol><li>(Sutsilvan) soap</li></ol>
sbierla	<i>noun</i><br><ol><li>(medicine, Surmiran) diarrhea</li></ol>
sbrensligna|sbrenslignas	<i>noun</i><br><ol><li>(Surmiran, birds) tit</li></ol>
sbrensligna blava	<i>noun</i><br><ol><li>(Surmiran) blue tit</li></ol>
sbrensligna digl gôt	<i>noun</i><br><ol><li>(Surmiran) coal tit</li></ol>
schah	<i>noun</i><br><ol><li>chess</li></ol>
schalantar	<i>verb</i><br><ol><li>(Sutsilvan, Surmiran) to freeze (transitive), chill</li></ol>
schalar	<i>verb</i><br><ol><li>(Sutsilvan, Surmiran) to freeze (intransitive), be cold, feel (very) cold, feel freezing</li></ol>
schalar aint	<i>verb</i><br><ol><li>(Surmiran) to freeze (transitive), chill</li></ol>
schaner	<i>name</i><br><ol><li>(Rumantsch Grischun, Sursilvan, Sutsilvan, Surmiran) January</li></ol>
schanugl|schanugls	<i>noun</i><br><ol><li>(Rumantsch Grischun, Sursilvan, Sutsilvan, Surmiran, anatomy) knee</li></ol>
sche	<i>conj</i><br><ol><li>if</li></ol>
schelar	<i>verb</i><br><ol><li>(Rumantsch Grischun, Sursilvan) to freeze (intransitive), be cold, feel (very) cold, feel freezing</li><li>(Rumantsch Grischun, Sursilvan) to freeze (transitive), chill</li></ol>
schember	<i>name</i><br><ol><li>(Rumantsch Grischun, Sutsilvan, Surmiran) arolla pine, Pinus cembra</li></ol>
schemgia|schemgias	<i>noun</i><br><ol><li>(Sutsilvan, Surmiran) monkey</li></ol>
schemia|schemias	<i>noun</i><br><ol><li>(Sursilvan) monkey</li></ol>
schentsch	<i>noun</i><br><ol><li>ginger</li></ol>
scher	<i>verb</i><br><ol><li>(Sursilvan, Sutsilvan, Surmiran) to lie</li></ol>
schetg|schetgs|schetgas|schetga	<i>adj</i><br><ol><li>(Sursilvan) dry</li></ol>
schi	<i>adv</i><br><ol><li>(Puter, Vallader) yes (used to indicate agreement with a positive statement)</li></ol>
schiember	<i>name</i><br><ol><li>(Sursilvan) arolla pine, Pinus cembra</li></ol>
schiemgia|schiemgias	<i>noun</i><br><ol><li>(Sutsilvan) monkey</li></ol>
schimgia|schimgias	<i>noun</i><br><ol><li>(Rumantsch Grischun, Puter, Vallader) monkey</li></ol>
schmachar	<i>verb</i><br><ol><li>(Vallader) to press, squeeze, squash, crush</li></ol>
schmacher	<i>verb</i><br><ol><li>(Puter) to press, squeeze, squash, crush</li></ol>
schmatgear	<i>verb</i><br><ol><li>(Sutsilvan) to press, squeeze, squash, crush</li></ol>
schner	<i>name</i><br><ol><li>(Surmiran, Puter, Vallader) January</li></ol>
schnester|schnesters|schnestras|schnestra	<i>noun</i><br><ol><li>(Puter, Vallader) left</li></ol><br><i>adj</i><br><ol><li>(Puter, Vallader) left</li></ol>
schnuogl|schnuogls	<i>noun</i><br><ol><li>(Puter, Vallader, anatomy) knee</li></ol>
schuber|schubers|schubera|schuberas	<i>adj</i><br><ol><li>(Rumantsch Grischun, Sursilvan, Sutsilvan) clean</li></ol>
schuldau|schuldaus	<i>noun</i><br><ol><li>(Sursilvan) soldier</li></ol>
schuldo|schuldos	<i>noun</i><br><ol><li>(Sutsilvan) soldier</li></ol>
schuldà|schuldads	<i>noun</i><br><ol><li>(Rumantsch Grischun) soldier</li></ol>
scola|scolas	<i>noun</i><br><ol><li>(Rumantsch Grischun, Sursilvan, Sutsilvan, Surmiran) school</li></ol>
scolast|scolasts	<i>noun</i><br><ol><li>(Rumantsch Grischun, Sursilvan, Sutsilvan, Surmiran) male teacher</li></ol>
scolasta|scolastas	<i>noun</i><br><ol><li>female teacher</li></ol>
scoula|scoulas	<i>noun</i><br><ol><li>(Puter, Vallader) school</li></ol>
scrota da nev|scrotas da nev	<i>noun</i><br><ol><li>(Sutsilvan, weather) snowflake</li></ol>
scrotta da neiv|scrottas da neiv	<i>noun</i><br><ol><li>(Sursilvan, weather) snowflake</li></ol>
scumanzamaint|scumanzamaints	<i>noun</i><br><ol><li>(Surmiran) start</li></ol>
scumanzar	<i>verb</i><br><ol><li>(Surmiran) to start</li></ol>
se	<i>adv</i><br><ol><li>(Sutsilvan, Surmiran) up, upward, upwards</li></ol>
searver	<i>verb</i><br><ol><li>(Sutsilvan) to open (become open)</li></ol>
seat	<i>num</i><br><ol><li>(Sutsilvan) seven</li></ol>
sec|secs|seccas|secca	<i>adj</i><br><ol><li>(Sursilvan) dry</li></ol>
sech|secha|sechs|sechas	<i>adj</i><br><ol><li>(Puter, Vallader) dry</li></ol>
secunda|secundas	<i>noun</i><br><ol><li>second (unit of time)</li></ol>
seda	<i>noun</i><br><ol><li>(Sutsilvan) silk</li></ol>
sedesch	<i>num</i><br><ol><li>(Rumantsch Grischun, Surmiran) sixteen</li></ol>
seid	<i>noun</i><br><ol><li>(Surmiran) thirst</li></ol>
seida	<i>noun</i><br><ol><li>(Sursilvan, Surmiran) silk</li></ol>
sein	<i>noun</i><br><ol><li>(Sursilvan, anatomy) breast (of a woman)</li></ol>
seira|seiras	<i>noun</i><br><ol><li>(Surmiran) evening</li></ol>
seis	<i>num</i><br><ol><li>(Surmiran) six</li></ol>
seit	<i>noun</i><br><ol><li>(Sursilvan) thirst</li></ol>
sel	<i>noun</i><br><ol><li>(Puter) salt</li></ol>
sempel|simplas|simpla|sempels	<i>adj</i><br><ol><li>(Sursilvan, Sutsilvan) simple, easy</li></ol>
sen	<i>adv</i><br><ol><li>(Sutsilvan, Surmiran) up, upward, upwards</li></ol>
senda|sendas	<i>noun</i><br><ol><li>path, footpath</li></ol>
seniester|seniesters|seniastra|seniastras	<i>noun</i><br><ol><li>(Sursilvan) left</li></ol><br><i>adj</i><br><ol><li>(Sursilvan) left</li></ol>
ser	<i>verb</i><br><ol><li>(Sursilvan) Alternative form of seser</li></ol>
sera|seras	<i>noun</i><br><ol><li>(Sursilvan, Sutsilvan) evening</li></ol>
serp|serps	<i>noun</i><br><ol><li>(Rumantsch Grischun, Puter, Vallader) snake</li></ol>
serpaint|serpaints	<i>noun</i><br><ol><li>(Vallader) snake</li></ol>
serpent|serpents	<i>noun</i><br><ol><li>(Surmiran) snake</li></ol>
serrar	<i>verb</i><br><ol><li>(Rumantsch Grischun, Sursilvan, Puter, Vallader) to close</li></ol>
ses	<i>num</i><br><ol><li>(Puter, Vallader) six</li></ol>
seser	<i>verb</i><br><ol><li>(Rumantsch Grischun, Sursilvan, Sutsilvan) to sit, be sitting, be seated</li></ol>
set	<i>num</i><br><ol><li>(Rumantsch Grischun, Surmiran, Puter, Vallader) seven</li></ol><br><i>noun</i><br><ol><li>(Sutsilvan) thirst</li></ol>
setg|setgas|setga|setgs	<i>adj</i><br><ol><li>(Rumantsch Grischun, Surmiran) dry</li></ol>
setger	<i>noun</i><br><ol><li>(Surmiran) sugar</li></ol>
settember	<i>name</i><br><ol><li>(Rumantsch Grischun, Sursilvan, Surmiran, Puter, Vallader) September</li></ol>
sexualitad	<i>noun</i><br><ol><li>sexuality</li></ol>
sezzer	<i>verb</i><br><ol><li>(Vallader) to sit, be sitting, be seated</li></ol>
sfrusch	<i>noun</i><br><ol><li>poaching</li></ol>
sfruschader|sfruschadras|sfruschaders|sfruschadra	<i>noun</i><br><ol><li>(Surmiran) poacher</li></ol>
sfruschar	<i>verb</i><br><ol><li>(Surmiran) to poach</li></ol>
sfuira	<i>noun</i><br><ol><li>(medicine, Rumantsch Grischun, Sutsilvan, Puter) diarrhea</li></ol>
sfuoira	<i>noun</i><br><ol><li>(medicine, Vallader) diarrhea</li></ol>
sfurata	<i>noun</i><br><ol><li>(medicine, Sutsilvan) diarrhea</li></ol>
sgol|sgols	<i>noun</i><br><ol><li>(Rumantsch Grischun) flight</li></ol>
sgolanotg|sgolanotgs	<i>noun</i><br><ol><li>(Sutsilvan, Surmiran) bat</li></ol>
sgraffel|sgraffels	<i>noun</i><br><ol><li>(Puter, Vallader) scratch</li></ol>
sgrefel|sgrefels	<i>noun</i><br><ol><li>(Sutsilvan) scratch</li></ol>
sgreffel|sgreffels	<i>noun</i><br><ol><li>(Sursilvan, Surmiran) scratch</li></ol>
sgriffel|sgriffels	<i>noun</i><br><ol><li>(Rumantsch Grischun) scratch</li></ol>
sgriflada|sgrifladas	<i>noun</i><br><ol><li>(Sutsilvan) scratch</li></ol>
sgular	<i>verb</i><br><ol><li>(Rumantsch Grischun, Sursilvan, Sutsilvan, Surmiran) to fly</li></ol>
sgür|sgürs	<i>noun</i><br><ol><li>(Puter, Vallader) axe</li></ol>
si	<i>adv</i><br><ol><li>(Rumantsch Grischun, Sursilvan) up, upward, upwards</li></ol>
siarp|siarps	<i>noun</i><br><ol><li>(Sursilvan) snake</li></ol>
siat	<i>num</i><br><ol><li>(Sursilvan) seven</li></ol>
sid	<i>noun</i><br><ol><li>(Rumantsch Grischun, Sursilvan, Sutsilvan, Surmiran) south</li></ol>
sidost	<i>noun</i><br><ol><li>southeast</li></ol>
sidvest	<i>noun</i><br><ol><li>southwest</li></ol>
sieir|sieirs	<i>noun</i><br><ol><li>(Surmiran) axe</li></ol>
siemi	<i>noun</i><br><ol><li>dream</li></ol>
sien|siens	<i>noun</i><br><ol><li>(Sutsilvan) nap</li></ol>
siesta|siestas	<i>noun</i><br><ol><li>(Rumantsch Grischun, Sursilvan) nap</li></ol>
sigir|sigirs	<i>noun</i><br><ol><li>(Rumantsch Grischun, Sursilvan, Sutsilvan) axe</li></ol>
signur|signurs	<i>noun</i><br><ol><li>(Rumantsch Grischun, Sursilvan, Sutsilvan, Puter, Vallader) gentleman, Mr.</li></ol>
siir|siirs	<i>noun</i><br><ol><li>(Sutsilvan) axe</li></ol>
simpel|simpels|simplas|simpla	<i>adj</i><br><ol><li>(Rumantsch Grischun, Surmiran, Puter, Vallader) simple, easy</li></ol>
sis	<i>num</i><br><ol><li>(Rumantsch Grischun, Sursilvan, Sutsilvan) six</li></ol>
sitg|sitga|sitgs|sitgas	<i>adj</i><br><ol><li>(Rumantsch Grischun, Surmiran) dry</li></ol>
smaccar	<i>verb</i><br><ol><li>(Sursilvan) to press, squeeze, squash, crush</li></ol>
smatgar	<i>verb</i><br><ol><li>(Rumantsch Grischun) to press, squeeze, squash, crush</li></ol>
smatger	<i>verb</i><br><ol><li>(Surmiran) to press, squeeze, squash, crush</li></ol>
societad|societads	<i>noun</i><br><ol><li>(Rumantsch Grischun, Sursilvan, Surmiran) society</li></ol>
societed|societeds	<i>noun</i><br><ol><li>(Puter) society</li></ol>
società|societàs	<i>noun</i><br><ol><li>(Vallader) society</li></ol>
sofflar	<i>verb</i><br><ol><li>(Vallader) to blow</li></ol>
sonda|sondas	<i>noun</i><br><ol><li>(Rumantsch Grischun, Sursilvan, Sutsilvan, Surmiran, Vallader) Saturday</li></ol><br><i>adv</i><br><ol><li>on Saturday</li></ol>
sora|soras	<i>noun</i><br><ol><li>(Rumantsch Grischun, Sursilvan, Sutsilvan, Surmiran) sister</li></ol>
sorteida|sorteidas	<i>noun</i><br><ol><li>(Surmiran) exit</li></ol>
sorteir	<i>verb</i><br><ol><li>(Surmiran) to exit</li></ol>
sortida|sortidas	<i>noun</i><br><ol><li>(Rumantsch Grischun, Sursilvan, Sutsilvan, Puter, Vallader) exit</li></ol>
sortir	<i>verb</i><br><ol><li>(Rumantsch Grischun, Sursilvan, Sutsilvan, Puter, Vallader) to exit</li></ol>
soua|souas	<i>noun</i><br><ol><li>(Surmiran) rope</li></ol>
sour|sours	<i>noun</i><br><ol><li>(Puter, Vallader) sister</li></ol>
sozietad|sozietads	<i>noun</i><br><ol><li>(Sutsilvan) society</li></ol>
spadla|spadlas	<i>noun</i><br><ol><li>(Vallader, anatomy) shoulder</li></ol>
spagnoleta|spagnoletas	<i>noun</i><br><ol><li>(Sutsilvan) peanut</li></ol>
spagnoletta|spagnolettas	<i>noun</i><br><ol><li>(Rumantsch Grischun, Sursilvan, Surmiran, Puter, Vallader) peanut</li></ol>
spatla|spatlas	<i>noun</i><br><ol><li>(Rumantsch Grischun, Sursilvan, Sutsilvan, Surmiran, anatomy) shoulder</li></ol>
spaventegl|spaventegls	<i>noun</i><br><ol><li>scarecrow</li></ol>
spedla|spedlas	<i>noun</i><br><ol><li>(Puter, anatomy) shoulder</li></ol>
sper|spera|speras|spers	<i>prep</i><br><ol><li>near, next (to)</li><li>in addition (to)</li></ol><br><i>adj</i><br><ol><li>(Puter) near, not far away from</li></ol>
speras	<i>prep</i><br><ol><li>(Sursilvan) in addition (to)</li></ol>
spiert|spierts	<i>noun</i><br><ol><li>(Rumantsch Grischun, Sutsilvan, Surmiran, Puter, Vallader) ghost</li></ol>
spievel|spievels	<i>noun</i><br><ol><li>mirror</li></ol>
spir|spiras|spirs|spira	<i>adj</i><br><ol><li>(Sutsilvan) pure</li></ol>
spler|splers	<i>noun</i><br><ol><li>(Rumantsch Grischun, Puter, Vallader) butterfly, moth</li></ol>
splerin|splerins	<i>noun</i><br><ol><li>(Vallader) butterfly, moth</li></ol>
spért|spérts	<i>noun</i><br><ol><li>(Sursilvan) ghost</li></ol>
squagl|squagls	<i>noun</i><br><ol><li>shark</li></ol>
squitschar	<i>verb</i><br><ol><li>(Rumantsch Grischun, Sursilvan, Vallader) to press, print</li></ol>
squitschear	<i>verb</i><br><ol><li>(Sutsilvan) to press, print</li></ol>
squitscher	<i>verb</i><br><ol><li>(Puter) to press, print</li></ol>
squitschier	<i>verb</i><br><ol><li>(Surmiran) to press, print</li><li>(Surmiran) to press, squeeze, squash, crush</li></ol>
stad|stads	<i>noun</i><br><ol><li>(Rumantsch Grischun, Sursilvan, Sutsilvan, Surmiran) summer</li></ol>
stadi|stadis	<i>noun</i><br><ol><li>(Rumantsch Grischun, Sursilvan, Sutsilvan, Surmiran, Vallader) state</li><li>(Rumantsch Grischun, Sursilvan, Sutsilvan, Surmiran, Vallader) stage</li><li>(Rumantsch Grischun, Sursilvan, Surmiran) status</li></ol>
stagiun|stagiuns	<i>noun</i><br><ol><li>(Rumantsch Grischun, Sursilvan, Puter, Vallader) season</li></ol>
stagiun aulta	<i>noun</i><br><ol><li>(Sursilvan) high season, peak season</li></ol>
stagiun auta	<i>noun</i><br><ol><li>(Rumantsch Grischun) high season, peak season</li></ol>
stagiun bassa	<i>noun</i><br><ol><li>(Rumantsch Grischun, Sursilvan, Puter, Vallader) low season</li></ol>
stagiun morta	<i>noun</i><br><ol><li>(Rumantsch Grischun, Sursilvan, Puter) low season</li></ol>
stagiun ota	<i>noun</i><br><ol><li>(Puter, Vallader) high season, peak season</li></ol>
stagiùn|stagiùns	<i>noun</i><br><ol><li>(Sutsilvan) season</li></ol>
stagiùn morta	<i>noun</i><br><ol><li>(Sutsilvan) low season</li></ol>
stagiùn òlta	<i>noun</i><br><ol><li>(Sutsilvan) high season, peak season</li></ol>
staila|stailas	<i>noun</i><br><ol><li>star</li></ol>
stanglantüm	<i>noun</i><br><ol><li>(Vallader) tiredness, fatigue</li></ol>
stanza|stanzas	<i>noun</i><br><ol><li>(Rumantsch Grischun, Sursilvan, Surmiran, Vallader) room</li></ol>
starnidada|starnidadas	<i>noun</i><br><ol><li>sneeze</li></ol>
starnidar	<i>verb</i><br><ol><li>(intransitive) to sneeze</li></ol>
starnüdöz|starnüdözs	<i>noun</i><br><ol><li>(Puter, Vallader) sneeze</li></ol>
staschung|staschungs	<i>noun</i><br><ol><li>(Surmiran) season</li></ol>
staschung morta	<i>noun</i><br><ol><li>(Surmiran) low season</li></ol>
staschung ota	<i>noun</i><br><ol><li>(Surmiran) high season, peak season</li></ol>
status	<i>noun</i><br><ol><li>status</li></ol>
staunza|staunzas	<i>noun</i><br><ol><li>(Puter) room</li></ol>
sted|steds	<i>noun</i><br><ol><li>(Puter) summer</li></ol>
stedi|stedis	<i>noun</i><br><ol><li>(Puter) state</li><li>(Puter) stage</li></ol>
stemprà|stemprads	<i>noun</i><br><ol><li>(Rumantsch Grischun) storm</li></ol>
stgagna|stgagnas	<i>noun</i><br><ol><li>(Sutsilvan, Surmiran) fork (eating utensil)</li></ol>
stgavar	<i>verb</i><br><ol><li>(Rumantsch Grischun, Sutsilvan, Surmiran) to dig</li></ol>
stgilat|stgilats	<i>noun</i><br><ol><li>red squirrel</li></ol>
stigl|stigla|stigls|stiglas	<i>adj</i><br><ol><li>(Surmiran, Puter, Vallader) thin</li></ol>
stivagl|stivagls	<i>noun</i><br><ol><li>(Surmiran) boot</li></ol>
stival|stivals	<i>noun</i><br><ol><li>(Rumantsch Grischun, Sursilvan, Sutsilvan, Vallader) boot</li></ol>
stivel|stivels	<i>noun</i><br><ol><li>(Puter) boot</li></ol>
stoffa|stoffas	<i>noun</i><br><ol><li>(textiles, Puter, Vallader) material, textile, canvas</li></ol>
strada|stradas	<i>noun</i><br><ol><li>(Rumantsch Grischun, Sutsilvan) street, road</li></ol>
stret|strets|stretta|strettas	<i>adj</i><br><ol><li>(Puter, Vallader) narrow</li></ol>
stretg|stretga|stretgas|stretgs	<i>adj</i><br><ol><li>(Rumantsch Grischun, Sursilvan, Sutsilvan) narrow</li></ol>
struclar	<i>verb</i><br><ol><li>(Sursilvan, Surmiran) to press, squeeze, squash, crush</li></ol>
strètg|strètgs|strètgas|strètga	<i>adj</i><br><ol><li>(Surmiran) narrow</li></ol>
studenta|studentas	<i>noun</i><br><ol><li>(Rumantsch Grischun, Surmiran, Puter, Vallader) female student</li></ol>
studentessa|studentessas	<i>noun</i><br><ol><li>(Rumantsch Grischun, Sursilvan, Sutsilvan) female student</li></ol>
stà|stats	<i>noun</i><br><ol><li>(Vallader) summer</li></ol>
stànza|stànzas	<i>noun</i><br><ol><li>(Sutsilvan) room</li></ol>
sua|suas	<i>noun</i><br><ol><li>(Puter, Vallader) rope</li></ol>
suarar	<i>verb</i><br><ol><li>(Surmiran, followed by da) to smell (of)</li></ol>
sudo|sudos	<i>noun</i><br><ol><li>(Puter) soldier</li></ol>
sudà|sudats	<i>noun</i><br><ol><li>(Vallader) soldier</li></ol>
sufflar	<i>verb</i><br><ol><li>(Rumantsch Grischun, Sursilvan) to blow</li></ol>
suga|sugas	<i>noun</i><br><ol><li>(Rumantsch Grischun, Sursilvan) rope</li></ol>
sughet|sughets	<i>noun</i><br><ol><li>(Rumantsch Grischun, Sursilvan) rope</li></ol>
suglegl	<i>noun</i><br><ol><li>(Surmiran) sun (star)</li></ol>
sugliagleiv|sugliagleiva|sugliagleivs|sugliagleivas	<i>adj</i><br><ol><li>(Surmiran) sunny</li></ol>
suja|sujas	<i>noun</i><br><ol><li>(Sutsilvan) rope</li></ol>
sul|suls|sula|sulas	<i>adj</i><br><ol><li>(Sutsilvan) single</li></ol>
sulagl	<i>noun</i><br><ol><li>(Puter) sun (star)</li></ol>
sulagliv|sulaglivas|sulaglivs|sulagliva	<i>adj</i><br><ol><li>(Sutsilvan, Puter, Vallader) sunny</li></ol>
sulai	<i>noun</i><br><ol><li>(Vallader) sun (star)</li></ol>
suldo|suldos	<i>noun</i><br><ol><li>(Sutsilvan, Surmiran) soldier</li></ol>
sulegl	<i>noun</i><br><ol><li>(Rumantsch Grischun, Sursilvan, Sutsilvan) sun (star)</li></ol>
sulegliv|suleglivas|sulegliva|suleglivs	<i>adj</i><br><ol><li>(Rumantsch Grischun, Sursilvan) sunny</li></ol>
sulet|suletta|sulettas|sulets	<i>adj</i><br><ol><li>(Rumantsch Grischun, Sursilvan, Sutsilvan, Surmiran, Puter, Vallader) alone</li><li>(Rumantsch Grischun, Sursilvan, Sutsilvan, Surmiran, Puter, Vallader) single</li></ol>
sumbriva	<i>noun</i><br><ol><li>shadow</li></ol>
suos-ch	<i>adj</i><br><ol><li>(Vallader) dirty</li></ol>
sur notg	<i>adv</i><br><ol><li>overnight</li></ol>
surmester|surmesters	<i>noun</i><br><ol><li>(Sutsilvan) male teacher</li></ol>
surmestra|surmestras	<i>noun</i><br><ol><li>(Sutsilvan) female teacher</li></ol>
survantscheglia|survantscheglias	<i>noun</i><br><ol><li>eyebrow</li></ol>
surveiver	<i>noun</i><br><ol><li>(Surmiran) to survive</li></ol>
surviver	<i>noun</i><br><ol><li>(Rumantsch Grischun, Sursilvan, Sutsilvan, Puter, Vallader) to survive</li></ol>
sutga|sutgas	<i>noun</i><br><ol><li>chair</li></ol>
svizer|svizers|svizra|svizras	<i>adj</i><br><ol><li>(Sutsilvan) Swiss</li></ol>
svizzer|svizzers|svizra|svizras	<i>adj</i><br><ol><li>(Rumantsch Grischun, Sursilvan, Surmiran, Puter, Vallader) Swiss</li></ol>
svolar	<i>verb</i><br><ol><li>(Vallader) to fly</li></ol>
svuler	<i>verb</i><br><ol><li>(Puter) to fly</li></ol>
sétg|sétga|sétgs|sétgas	<i>adj</i><br><ol><li>(Sutsilvan) dry</li></ol>
sönet|sönets	<i>noun</i><br><ol><li>(Vallader) nap</li></ol>
sönin|sönins	<i>noun</i><br><ol><li>(Puter, Vallader) nap</li></ol>
sü	<i>adv</i><br><ol><li>(Puter, Vallader) up, upward, upwards</li></ol>
süd	<i>noun</i><br><ol><li>(Puter, Vallader) south</li></ol>
taglia|taglias	<i>noun</i><br><ol><li>(anatomy, Rumantsch Grischun, Surmiran, Puter) waist</li></ol>
taila|tailas	<i>noun</i><br><ol><li>(textiles, Rumantsch Grischun, Vallader) material, textile, canvas</li></ol>
taila d'aragnun|tailas d'aragnun	<i>noun</i><br><ol><li>(Puter) spiderweb</li></ol>
taila d'arogn|tailas d'arogn	<i>noun</i><br><ol><li>(Vallader) spiderweb</li></ol>
taila-filien|filiens|taila-filienrm|taila{l f \|pl=tailas-filien}}|filien	<i>noun</i><br><ol><li>(Rumantsch Grischun) spiderweb</li></ol>
taimp|taimps	<i>noun</i><br><ol><li>(Sutsilvan, Surmiran) time</li></ol>
tains	<i>noun</i><br><ol><li>(Sutsilvan) time</li></ol>
tameir	<i>verb</i><br><ol><li>(Surmiran) to fear, be afraid (of), be frightened (of)</li></ol>
tamer	<i>verb</i><br><ol><li>(Sutsilvan) to fear, be afraid (of), be frightened (of)</li></ol>
taner	<i>verb</i><br><ol><li>(Sutsilvan) to hold, keep</li></ol>
taragn|taragns	<i>noun</i><br><ol><li>(Sutsilvan) land, soil</li></ol>
tartuffel|tartuffels	<i>noun</i><br><ol><li>(Rumantsch Grischun) potato</li></ol>
tat|tats	<i>noun</i><br><ol><li>(Rumantsch Grischun, Sursilvan, Sutsilvan, Surmiran) grandfather</li></ol>
taur|taurs	<i>noun</i><br><ol><li>bull</li></ol>
tazza|tazzas	<i>noun</i><br><ol><li>(Puter, Vallader) cup</li></ol>
te	<i>noun</i><br><ol><li>(Sursilvan) tea</li></ol>
tegnair	<i>verb</i><br><ol><li>(Rumantsch Grischun) to hold, keep</li></ol>
teila|teilas	<i>noun</i><br><ol><li>(textiles) material, textile, canvas</li></ol>
teila filien|teilas filien	<i>noun</i><br><ol><li>(Sursilvan) spiderweb</li></ol>
teila-filunza|teila-filunzarm|filunza|teila{l f \|pl=teilas-filunza}}|filunzas	<i>noun</i><br><ol><li>(Surmiran) spiderweb</li></ol>
teissa|teissas	<i>noun</i><br><ol><li>(Surmiran) poison</li></ol>
tela|telas	<i>noun</i><br><ol><li>(textiles, Sutsilvan) material, textile, canvas</li></ol>
tela filient|telas filient	<i>noun</i><br><ol><li>(Sutsilvan) spiderweb</li></ol>
telefon|telefons	<i>noun</i><br><ol><li>telephone</li></ol>
telefon mobil	<i>noun</i><br><ol><li>mobile phone, cell phone, cellular phone</li></ol>
telefonar|telefonescha	<i>noun</i><br><ol><li>(Rumantsch Grischun, Sursilvan, Sutsilvan, Surmiran, Puter, Vallader) to telephone, call</li></ol>
telefoner	<i>noun</i><br><ol><li>(Puter) to telephone, call</li></ol>
tema|temas	<i>noun</i><br><ol><li>(Rumantsch Grischun, Sursilvan, Sutsilvan, Surmiran, Puter, Vallader) subject, topic, theme</li><li>(Rumantsch Grischun, Sursilvan, Sutsilvan, Surmiran) fear</li></ol>
temair|tema|temias|vegnessen a temair|tem|temian|temel|temevas|temevan|vegnin a temair|temida|temend|vegnan a temair|temain|temia|vegnel a temair|vegn a temair|vegns a temair|teman|temess|vegnîes a temair|vegnien a temair|temeva|temais|vegnîen a temair|vegnies a temair|temas|temessen|vegnesses a temair|temai|vegnis a temair|vegni a temair|temì|vegness a temair|temesses	<i>verb</i><br><ol><li>(Rumantsch Grischun) to fear, be afraid (of), be frightened (of)</li></ol>
temer|tema|temeies|temevi|vegnessen a temer|vegnan a temer|temeis|temei|temiu|vegnîen a temer|temessien|temel|temava|vegnessi a temer|vegnies a temer|vegnessien a temer|temien|temend|temi|temein|teman|vegni a temer|vegnessies a temer|vegnis a temer|vegness a temer|temevien|temas|temessies|temevies|temessi|vegnien a temer|temessen|temies|vegnel a temer|vegns a temer|vegnesses a temer|temavel|temavas|vegnîes a temer|temess|vegnin a temer|vegn a temer|temesses|temavan|temeien	<i>verb</i><br><ol><li>(Sursilvan) to fear, be afraid (of), be frightened (of)</li></ol>
temma|temmas	<i>noun</i><br><ol><li>(Puter, Vallader) fear</li></ol>
temp|temps	<i>noun</i><br><ol><li>(Rumantsch Grischun, Puter, Vallader) time</li></ol>
temps	<i>noun</i><br><ol><li>(Sursilvan) time</li></ol>
tenent|tenents	<i>noun</i><br><ol><li>(military, Rumantsch Grischun, Puter, Vallader) lieutenant</li></ol>
tener|tenra|teners|tenras	<i>adj</i><br><ol><li>tender</li></ol><br><i>verb</i><br><ol><li>(Sursilvan) to hold, keep</li></ol>
teragn|teragns	<i>noun</i><br><ol><li>(Surmiran) land, soil</li></ol>
terra|terras	<i>noun</i><br><ol><li>(Rumantsch Grischun, Puter) land, soil</li><li>(Rumantsch Grischun, Puter) country, land</li><li>(capitalized, proper noun, Rumantsch Grischun, Puter, Vallader) the planet Earth</li></ol>
terrain|terrains	<i>noun</i><br><ol><li>(Puter, Vallader) land, soil</li><li>(Puter) country, land</li></ol>
terren|terrens	<i>noun</i><br><ol><li>(Rumantsch Grischun, Sursilvan) land, soil</li></ol>
testa|testas	<i>noun</i><br><ol><li>(Rumantsch Grischun, Sursilvan, Surmiran, Puter, Vallader) head</li></ol>
tet|tets	<i>noun</i><br><ol><li>(Puter, Vallader) roof</li></ol>
tetg|tetgs	<i>noun</i><br><ol><li>(Rumantsch Grischun, Sursilvan, Sutsilvan, Surmiran) roof</li></ol>
tga|tgas	<i>noun</i><br><ol><li>(Surmiran) house</li></ol>
tgametg	<i>noun</i><br><ol><li>(Sutsilvan, Surmiran) lightning</li></ol>
tgaminar	<i>verb</i><br><ol><li>(Surmiran) to walk</li></ol>
tgampiertg	<i>noun</i><br><ol><li>(Surmiran) bacon</li></ol>
tgamutsch|tgamutschs|tgamutscha|tgamutschas	<i>noun</i><br><ol><li>(Sutsilvan, Surmiran) chamois</li></ol>
tgang|tgangs	<i>noun</i><br><ol><li>(Surmiran) (male) dog</li></ol>
tganga|tgangas	<i>noun</i><br><ol><li>(Surmiran) female dog, bitch</li></ol>
tgapeala|tgapealas	<i>noun</i><br><ol><li>(Sutsilvan) hat</li></ol>
tgapela|tgapelas	<i>noun</i><br><ol><li>(Surmiran) hat</li></ol>
tgapitala|tgapitalas	<i>noun</i><br><ol><li>(Sutsilvan) capital, capital city</li></ol>
tgaplegna|tgaplegnas	<i>noun</i><br><ol><li>(Sutsilvan) helmet</li></ol>
tgarn|tgarns	<i>noun</i><br><ol><li>(Sutsilvan) meat</li></ol>
tgarn d'armantiv	<i>noun</i><br><ol><li>(Sutsilvan) beef</li></ol>
tgarn piertg	<i>noun</i><br><ol><li>(Sutsilvan) pork</li></ol>
tgarnpiertg	<i>noun</i><br><ol><li>(Sutsilvan) bacon</li></ol>
tgascha|tgaschas	<i>noun</i><br><ol><li>(Surmiran) chest, trunk</li></ol>
tgau|tgaus	<i>noun</i><br><ol><li>(anatomy, Sursilvan) head</li></ol>
tgaun|tgauns	<i>noun</i><br><ol><li>(Sursilvan) (male) dog</li></ol>
tgavadel|tgavadels	<i>noun</i><br><ol><li>(Surmiran, anatomy) nipple</li></ol>
tgavadi|tgavadeals	<i>noun</i><br><ol><li>(Sutsilvan, anatomy) nipple</li></ol>
tgavar	<i>verb</i><br><ol><li>(Surmiran) to dig</li></ol>
tge	<i>pron</i><br><ol><li>(Rumantsch Grischun, Sutsilvan, Surmiran) what</li><li>(Sutsilvan) who, whom</li></ol>
tgea|tgeas	<i>noun</i><br><ol><li>(Sutsilvan) house</li><li>(anatomy, Surmiran) head</li></ol>
tgeasa|tgeasas	<i>noun</i><br><ol><li>(Sutsilvan) house</li></ol>
tgern|tgerns	<i>noun</i><br><ol><li>(Surmiran) meat</li></ol>
tgern-bov	<i>noun</i><br><ol><li>(Surmiran) beef</li></ol>
tgern-portg	<i>noun</i><br><ol><li>(Surmiran) pork</li></ol>
tgesa|tgesas	<i>noun</i><br><ol><li>(Surmiran) house</li></ol>
tgi	<i>conj</i><br><ol><li>(Surmiran) that</li><li>(Surmiran) than</li></ol><br><i>pron</i><br><ol><li>(Surmiran) who, whom</li></ol>
tgietschen	<i>adj</i><br><ol><li>(Sursilvan) red</li></ol>
tgieu|tgieus	<i>noun</i><br><ol><li>(anatomy, figuratively, Sutsilvan) head</li></ol>
tgiralla|tgirallas	<i>noun</i><br><ol><li>(Rumantsch Grischun) butterfly, moth</li></ol>
tgitar	<i>verb</i><br><ol><li>(Sutsilvan) to look, see</li></ol>
tgittar	<i>verb</i><br><ol><li>(Rumantsch Grischun, Surmiran) to look, see</li></ol>
tgnair	<i>verb</i><br><ol><li>(Puter, Vallader) to hold, keep</li></ol>
tgogna|tgognas	<i>noun</i><br><ol><li>(Sutsilvan) female dog, bitch</li></ol>
tgomba|tgombas	<i>noun</i><br><ol><li>(Sutsilvan, anatomy) leg</li></ol>
tgombra|tgombras	<i>noun</i><br><ol><li>(Sutsilvan, Surmiran) room</li></ol>
tgomma|tgommas	<i>noun</i><br><ol><li>(Surmiran, anatomy) leg</li></ol>
tgora|tgoras	<i>noun</i><br><ol><li>(Sutsilvan, Surmiran) goat</li></ol>
tgàn|tgàns	<i>noun</i><br><ol><li>(Sutsilvan) (male) dog</li></ol>
ti	<i>pron</i><br><ol><li>you (singular familiar)</li></ol>
tiara|tiaras	<i>noun</i><br><ol><li>(Sursilvan) land, soil</li><li>(Sursilvan) country, land</li><li>(capitalized, proper noun, Sursilvan) the planet Earth</li></ol>
tier|tiers	<i>noun</i><br><ol><li>(Sursilvan) animal</li></ol>
tiffel|tiffels	<i>noun</i><br><ol><li>(Surmiran) potato</li></ol>
tigneir	<i>verb</i><br><ol><li>(Surmiran) to hold, keep</li></ol>
tissi|tissis	<i>noun</i><br><ol><li>(Rumantsch Grischun, Sursilvan, Sutsilvan) poison</li></ol>
tmair	<i>verb</i><br><ol><li>(Puter, Vallader) to fear, be afraid (of), be frightened (of)</li></ol>
tomata|tomatas	<i>noun</i><br><ol><li>tomato</li></ol>
tor|tors	<i>noun</i><br><ol><li>(Surmiran) tower</li></ol>
tot	<i>adv</i><br><ol><li>(Surmiran) all</li></ol>
trair	<i>verb</i><br><ol><li>(Rumantsch Grischun) to pull</li></ol>
trair flad	<i>verb</i><br><ol><li>(Rumantsch Grischun) to breathe</li></ol>
trair il flad	<i>verb</i><br><ol><li>(Rumantsch Grischun) to breathe</li></ol>
trais	<i>num</i><br><ol><li>(Rumantsch Grischun, Puter, Vallader) three</li></ol>
trar	<i>verb</i><br><ol><li>(Vallader) to pull</li></ol>
trar il flà	<i>verb</i><br><ol><li>(Vallader) to breathe</li></ol>
tredesch	<i>num</i><br><ol><li>(Rumantsch Grischun, Surmiran) thirteen</li></ol>
treis	<i>num</i><br><ol><li>(Sursilvan, Surmiran) three</li></ol>
trer	<i>verb</i><br><ol><li>(Sursilvan, Sutsilvan, Surmiran, Puter) to pull</li></ol>
trer flad	<i>verb</i><br><ol><li>(Sursilvan) to breathe</li></ol>
trer fled	<i>verb</i><br><ol><li>(Puter) to breathe</li></ol>
trer flo	<i>verb</i><br><ol><li>(Sutsilvan) to breathe</li></ol>
trer igl flo	<i>verb</i><br><ol><li>(Surmiran) to breathe</li></ol>
trer il fled	<i>verb</i><br><ol><li>(Puter) to breathe</li></ol>
tres	<i>num</i><br><ol><li>(Sutsilvan) three</li></ol>
trest|trests|tresta|trestas	<i>adj</i><br><ol><li>(Sursilvan, Sutsilvan, Surmiran) sad</li></ol>
trid	<i>adj</i><br><ol><li>ugly</li></ol>
trist|trista|tristas|trists	<i>adj</i><br><ol><li>(Rumantsch Grischun, Puter, Vallader) sad</li></ol>
trocla|troclas	<i>noun</i><br><ol><li>(Surmiran) chest, trunk</li></ol>
trucca|truccas	<i>noun</i><br><ol><li>(Rumantsch Grischun, Sursilvan) chest, trunk</li></ol>
truffel|truffels	<i>noun</i><br><ol><li>(Sursilvan) potato</li></ol>
tschadun|tschaduns	<i>noun</i><br><ol><li>(Rumantsch Grischun, Sursilvan) spoon</li></ol>
tschaghera|tschagheras	<i>noun</i><br><ol><li>(weather, Sursilvan) fog, mist</li></ol>
tschagula|tschagulas	<i>noun</i><br><ol><li>(Rumantsch Grischun) onion</li></ol>
tschaguola|tschaguolas	<i>noun</i><br><ol><li>(Sursilvan) onion</li></ol>
tschajera|tschajeras	<i>noun</i><br><ol><li>(weather, Rumantsch Grischun) fog, mist</li></ol>
tscharcar	<i>verb</i><br><ol><li>(Sutsilvan) to look up, look for, search, seek</li></ol>
tscharescha|tschareschas	<i>noun</i><br><ol><li>(Rumantsch Grischun) cherry</li></ol>
tschariescha|tscharieschas	<i>noun</i><br><ol><li>(Sutsilvan, Surmiran) cherry</li></ol>
tschartgear	<i>verb</i><br><ol><li>(Sutsilvan) to look up, look for, search, seek</li></ol>
tschartger	<i>verb</i><br><ol><li>(Surmiran) to look up, look for, search, seek</li></ol>
tscharvè|tscharvels	<i>noun</i><br><ol><li>(Rumantsch Grischun, Puter, Vallader) brain</li></ol>
tschavola|tschavolas	<i>noun</i><br><ol><li>(Sutsilvan, Surmiran) onion</li></ol>
tscheia|tscheias	<i>noun</i><br><ol><li>(weather, Surmiran) fog, mist</li></ol>
tschendra	<i>noun</i><br><ol><li>ash</li></ol>
tschentg	<i>num</i><br><ol><li>(Sutsilvan) five</li></ol>
tschercar	<i>verb</i><br><ol><li>(Sursilvan) to look up, look for, search, seek</li></ol>
tscherchar	<i>verb</i><br><ol><li>(Vallader) to look up, look for, search, seek</li></ol>
tschercher	<i>verb</i><br><ol><li>(Puter) to look up, look for, search, seek</li></ol>
tscherescha|tschereschas	<i>noun</i><br><ol><li>(Sursilvan) cherry</li></ol>
tscherner	<i>verb</i><br><ol><li>to pick, to choose</li></ol>
tschertgan	<i>verb</i><br><ol><li>(Surmiran) to look up, look for, search, seek</li></ol>
tschertgar	<i>verb</i><br><ol><li>(Rumantsch Grischun) to look up, look for, search, seek</li></ol>
tschiel|tschiels	<i>noun</i><br><ol><li>(Rumantsch Grischun, Sursilvan, Sutsilvan, Surmiran) heaven, sky</li></ol>
tschiera|tschieras	<i>noun</i><br><ol><li>(weather, Sutsilvan, Puter, Vallader) fog, mist</li></ol>
tschierv|tschiervs	<i>noun</i><br><ol><li>(Rumantsch Grischun) deer</li></ol>
tschiguolla|tschiguollas	<i>noun</i><br><ol><li>(Puter, Vallader) onion</li></ol>
tschinch	<i>num</i><br><ol><li>(Puter, Vallader) five</li></ol>
tschingallegra|tschingallegras	<i>noun</i><br><ol><li>(Puter, birds) tit</li></ol>
tschingallegra blova	<i>noun</i><br><ol><li>(Puter) blue tit</li></ol>
tschingallegra da god	<i>noun</i><br><ol><li>(Puter) coal tit</li></ol>
tschintg	<i>num</i><br><ol><li>(Rumantsch Grischun, Surmiran) five</li></ol>
tschirescha|tschireschas	<i>noun</i><br><ol><li>(Puter, Vallader) cherry</li></ol>
tschitta|tschittas	<i>noun</i><br><ol><li>(Rumantsch Grischun, Sursilvan, Surmiran) butterfly, moth</li></ol>
tschof|tschoffas|tschoffa|tschofs	<i>adj</i><br><ol><li>(Surmiran) dirty</li></ol>
tschueta|tschuetas	<i>noun</i><br><ol><li>(Sutsilvan) owl</li></ol>
tschuetta|tschuettas	<i>noun</i><br><ol><li>(Rumantsch Grischun, Sursilvan, Surmiran, Puter, Vallader) owl</li></ol>
tschuf|tschuffa|tschufs|tschuffas	<i>adj</i><br><ol><li>(Rumantsch Grischun, Sursilvan, Sutsilvan) dirty</li></ol>
tschun	<i>num</i><br><ol><li>(Sursilvan) five</li></ol>
tschut|tschuts	<i>noun</i><br><ol><li>lamb</li></ol>
tschêl|tschêls	<i>noun</i><br><ol><li>(Puter, Vallader) heaven, sky</li></ol>
tschütter	<i>verb</i><br><ol><li>(Puter, Vallader) to look, see</li></ol>
tubac	<i>noun</i><br><ol><li>tobacco</li></ol>
tun	<i>noun</i><br><ol><li>sound</li><li>thunder</li></ol>
tuor|tuors	<i>noun</i><br><ol><li>(Sursilvan, Puter, Vallader) tower</li></ol>
tuornar	<i>verb</i><br><ol><li>(Vallader) to return, go back, come back</li><li>(Vallader) to return, come back (home)</li></ol>
tuorta|tuortas	<i>noun</i><br><ol><li>(Sursilvan, Puter, Vallader) flat, round cake with a fruit filling</li></ol>
tuot	<i>adv</i><br><ol><li>(Puter, Vallader) all</li></ol>
tup|tuppas|tuppa|tups	<i>adj</i><br><ol><li>(Rumantsch Grischun, Sursilvan, Sutsilvan, Surmiran) silly</li></ol>
tur|turs	<i>noun</i><br><ol><li>tower</li><li>(chess) rook</li></ol>
turnar|tuorna	<i>verb</i><br><ol><li>(Rumantsch Grischun, Sursilvan, Sutsilvan, Surmiran) to return, come back (home)</li></ol>
turner	<i>verb</i><br><ol><li>(Puter) to return, go back, come back</li><li>(Puter) to return, come back (home)</li></ol>
turta|turtas	<i>noun</i><br><ol><li>(Rumantsch Grischun, Sutsilvan, Surmiran) flat, round cake with a fruit filling</li></ol>
tut|tuts	<i>adv</i><br><ol><li>(Rumantsch Grischun, Sursilvan, Sutsilvan) all</li></ol><br><i>noun</i><br><ol><li>(Sursilvan) nap</li></ol>
tutgar	<i>verb</i><br><ol><li>(Rumantsch Grischun) to touch</li></ol>
tè	<i>noun</i><br><ol><li>(Puter, Vallader) tea</li></ol>
té	<i>noun</i><br><ol><li>(Rumantsch Grischun, Sutsilvan, Surmiran) tea</li></ol>
tössi|tössis	<i>noun</i><br><ol><li>(Puter, Vallader) poison</li></ol>
u	<i>conj</i><br><ol><li>or</li></ol>
uaul|uauls	<i>noun</i><br><ol><li>(Sursilvan) forest</li></ol>
udida	<i>noun</i><br><ol><li>hearing</li></ol>
udir|vegnessen a udir|udevas|udeva|vegnesses a udir|audies|vegness a udir|vegns a udir|auda|vegnessi a udir|vegnessies a udir|udend|vegnessien a udir|udin|udevel|audan|vegnis a udir|audel|vegn a udir|udevies|udessen|vegni a udir|udess|udesses|vegnin a udir|udevien|udi|vegnîen a udir|vegnien a udir|udevan|vegnan a udir|audas|udiu|vegnîes a udir|udessien|udessies|audi|udis|vegnel a udir|udîes|vegnies a udir|udîen|audien|udevi|udessi	<i>verb</i><br><ol><li>(Rumantsch Grischun, Sursilvan, Sutsilvan, Puter) to hear</li></ol>
uffant|uffants	<i>noun</i><br><ol><li>(Rumantsch Grischun, Vallader) child</li></ol>
uffant sulet|uffants sulets	<i>noun</i><br><ol><li>(Rumantsch Grischun, Vallader) only child</li></ol>
uffizial|uffizials|uffizialas|uffiziala	<i>adj</i><br><ol><li>official</li></ol>
uia|uias	<i>noun</i><br><ol><li>(Vallader) grape</li></ol>
uleiva|uleivas	<i>noun</i><br><ol><li>(Surmiran) olive</li></ol>
uliva|ulivas	<i>noun</i><br><ol><li>(Rumantsch Grischun, Sursilvan) olive</li></ol>
um|umens	<i>noun</i><br><ol><li>man</li><li>husband</li></ol>
uman|umana|umans|umanas	<i>adj</i><br><ol><li>(Rumantsch Grischun, Sutsilvan, Surmiran, Vallader) human</li></ol><br><i>noun</i><br><ol><li>(Rumantsch Grischun, Surmiran, Vallader) (male) human being</li></ol>
umana|umanas	<i>noun</i><br><ol><li>(Rumantsch Grischun, Surmiran, Vallader) female human being</li></ol>
umaun|umauns|umaunas|umauna	<i>adj</i><br><ol><li>(Puter) human</li></ol><br><i>noun</i><br><ol><li>(Puter) human</li></ol>
umauna|umaunas	<i>noun</i><br><ol><li>(Puter) female human being</li></ol>
umbrella|umbrellas	<i>noun</i><br><ol><li>(Surmiran, Vallader) umbrella, parasol</li></ol>
unda|undas	<i>noun</i><br><ol><li>(Rumantsch Grischun, Sursilvan, Sutsilvan) wave</li></ol>
unfant|unfants	<i>noun</i><br><ol><li>(Surmiran) child</li></ol>
unfant sulet|unfants sulets	<i>noun</i><br><ol><li>(Surmiran) only child</li></ol>
unfànt|unfànts	<i>noun</i><br><ol><li>(Sutsilvan) child</li></ol>
unfànt sulet|unfànts sulets	<i>noun</i><br><ol><li>(Sutsilvan) only child</li></ol>
ungla|unglas	<i>noun</i><br><ol><li>(anatomy, Rumantsch Grischun, Sursilvan, Surmiran, Puter, Vallader) nail</li></ol>
unic|unica|unics|unicas	<i>adj</i><br><ol><li>(Rumantsch Grischun, Surmiran, Puter, Vallader) single</li></ol>
unì|unida|unids|unidas	<i>adj</i><br><ol><li>united</li></ol>
uolp|uolps	<i>noun</i><br><ol><li>(Sursilvan) fox</li></ol>
uonda|uondas	<i>noun</i><br><ol><li>(Puter, Vallader) wave</li></ol>
uors	<i>noun</i><br><ol><li>(Sursilvan, Puter, Vallader) bear</li></ol>
uorsa|uorsas	<i>noun</i><br><ol><li>(Sursilvan, Puter, Vallader) bear</li></ol>
uost	<i>name</i><br><ol><li>(Sursilvan) August</li></ol>
ur|urs	<i>noun</i><br><ol><li>(Rumantsch Grischun, Sursilvan, Sutsilvan, Puter, Vallader) edge, margins</li></ol>
ura|uras	<i>noun</i><br><ol><li>(Rumantsch Grischun, Sursilvan, Sutsilvan, Puter, Vallader) time, hour</li></ol>
urachin|urachins	<i>noun</i><br><ol><li>(Puter) earring</li></ol>
uraglia|uraglias	<i>noun</i><br><ol><li>(anatomy, Puter, Vallader) ear</li><li>(Puter, Vallader) cup handle</li></ol>
uraglin|uraglins	<i>noun</i><br><ol><li>(Vallader) earring</li></ol>
ureglia|ureglias	<i>noun</i><br><ol><li>(anatomy, Rumantsch Grischun, Sursilvan, Sutsilvan, Surmiran) ear</li><li>(Rumantsch Grischun, Sursilvan, Sutsilvan, Surmiran) cup handle</li></ol>
ureglin|ureglins	<i>noun</i><br><ol><li>(Rumantsch Grischun, Surmiran) earring</li></ol>
urin	<i>noun</i><br><ol><li>urine</li></ol>
urs	<i>noun</i><br><ol><li>(Rumantsch Grischun, Sutsilvan, Surmiran) bear</li></ol>
ursa|ursas	<i>noun</i><br><ol><li>(Rumantsch Grischun, Sutsilvan, Surmiran) female bear</li></ol>
utschel|utschels	<i>noun</i><br><ol><li>(Surmiran) bird</li></ol>
utschi|utscheals|utschals	<i>noun</i><br><ol><li>(Sursilvan, Sutsilvan) bird</li></ol>
utschè|utschels	<i>noun</i><br><ol><li>(Rumantsch Grischun, Puter, Vallader) bird</li></ol>
utschè mezmieur	<i>noun</i><br><ol><li>(Rumantsch Grischun) bat</li></ol>
utschè mezmür	<i>noun</i><br><ol><li>(Puter, Vallader) bat</li></ol>
utuon|utuons	<i>noun</i><br><ol><li>(Puter, Vallader) autumn, fall</li></ol>
vacca|vaccas	<i>noun</i><br><ol><li>(Sursilvan) cow</li></ol>
vacha|vachas	<i>noun</i><br><ol><li>(Puter, Vallader) cow</li></ol>
vadeala|vadealas	<i>noun</i><br><ol><li>(Sutsilvan) female calf</li></ol>
vadel|vadels	<i>noun</i><br><ol><li>(Surmiran) calf</li></ol>
vadela|vadelas	<i>noun</i><br><ol><li>(Surmiran) female calf</li></ol>
vadella|vadellas	<i>noun</i><br><ol><li>(Rumantsch Grischun) female calf</li></ol>
vadi|vadials	<i>noun</i><br><ol><li>(Sursilvan) calf</li></ol>
vadiala|vadialas	<i>noun</i><br><ol><li>(Sursilvan) female calf</li></ol>
vadè|vadels	<i>noun</i><br><ol><li>(Rumantsch Grischun, Vallader) (male) calf</li></ol>
vagnir	<i>verb</i><br><ol><li>(Sutsilvan) to come</li></ol>
vair	<i>verb</i><br><ol><li>(Puter) to look</li><li>(Puter) to see</li></ol>
val|vals	<i>noun</i><br><ol><li>valley</li></ol>
vardad	<i>noun</i><br><ol><li>(Rumantsch Grischun, Sursilvan, Sutsilvan) truth</li></ol>
vardet	<i>noun</i><br><ol><li>(Puter) truth</li></ol>
vardà	<i>noun</i><br><ol><li>(Vallader) truth</li></ol>
vaschinadi|vaschinadis	<i>noun</i><br><ol><li>(Sutsilvan) village</li></ol>
vaser	<i>verb</i><br><ol><li>(Sutsilvan) to look</li><li>(Sutsilvan) to see</li></ol>
vatga|vatgas	<i>noun</i><br><ol><li>(Rumantsch Grischun, Sutsilvan, Surmiran) cow</li></ol>
vdella|vdellas	<i>noun</i><br><ol><li>(Puter, Vallader) female calf</li></ol>
vdè|vdels	<i>noun</i><br><ol><li>(Puter, Vallader) calf</li></ol>
veard|vearda|veards|veardas	<i>adj</i><br><ol><li>(Sutsilvan) green</li></ol><br><i>noun</i><br><ol><li>(Sutsilvan) green</li></ol>
vearm|vearms	<i>noun</i><br><ol><li>(Sutsilvan) worm</li></ol>
vegl|vegls|veglia|veglias	<i>adj</i><br><ol><li>old</li></ol>
vegn|vegns	<i>noun</i><br><ol><li>(Sutsilvan, Surmiran) wine</li></ol>
vegnir|vegnin|vegnesses|vegnessies|vegnessen a vegnir|vegn a vegnir|vegnessien|vegness a vegnir|vegnessien a vegnir|vegnì|vegnids|vegnind|vegni a vegnir|vegna|vegnîen|vegniva|vegnel a vegnir|vegneva|vegniss|vegnien|ve|vegnessies a vegnir|vegnessi|vegnies|vegnevien|vegnevi|vegnia|vegnissan|vegness|vegn|vegnies a vegnir|vegnessen|vegnivan|vegnissas|vegnias|vegnidas|vegni|vegnis|vegns a vegnir|vegnesses a vegnir|vegnis a vegnir|vegnida|vegniu|vegnevel|vegnan|vegnend|vegnessi a vegnir|vegnevies|vegnîes a vegnir|vegnivas|vegnien a vegnir|vegnîen a vegnir|vegns|vegnan a vegnir|vegnel|vegnevan|vegnîes|vegnevas|vegnin a vegnir|vegnian	<i>verb</i><br><ol><li>(Rumantsch Grischun, Sursilvan) to come</li></ol>
veia|veias	<i>noun</i><br><ol><li>(Sutsilvan, Surmiran) road, street; way</li></ol>
veir	<i>verb</i><br><ol><li>(Surmiran) to look</li><li>(Surmiran) to see</li></ol>
velo|velos	<i>noun</i><br><ol><li>bicycle</li></ol>
vendarde|vendardes	<i>noun</i><br><ol><li>(Surmiran) Friday</li></ol>
venderdi|venderdis	<i>noun</i><br><ol><li>(Rumantsch Grischun, Puter, Vallader) Friday</li></ol><br><i>adv</i><br><ol><li>(Rumantsch Grischun, Puter, Vallader) on Friday</li></ol>
venderdis	<i>noun</i><br><ol><li>(Sursilvan) Friday</li></ol>
vendergis	<i>noun</i><br><ol><li>(Sutsilvan) Friday</li></ol>
ventg	<i>num</i><br><ol><li>(Rumantsch Grischun) twenty</li></ol>
ver|vers	<i>noun</i><br><ol><li>(Rumantsch Grischun, Surmiran) wild boar (Sus scrofa)</li></ol><br><i>verb</i><br><ol><li>(Sutsilvan) Alternative form of vaser</li></ol>
verd|verdas|verda|verds	<i>adj</i><br><ol><li>(Rumantsch Grischun, Sursilvan, Surmiran, Puter, Vallader) green</li></ol><br><i>noun</i><br><ol><li>(Rumantsch Grischun, Sursilvan, Surmiran, Puter, Vallader) green</li></ol>
verdad	<i>noun</i><br><ol><li>(Surmiran) truth</li></ol>
verer	<i>verb</i><br><ol><li>(Vallader) to look</li><li>(Vallader) to see</li></ol>
verm|verms	<i>noun</i><br><ol><li>(Rumantsch Grischun, Surmiran, Puter, Vallader) worm</li></ol>
vesair	<i>verb</i><br><ol><li>(Rumantsch Grischun) to look</li><li>(Rumantsch Grischun) to see</li></ol>
veser|vesend|vesevien|vesies|vesevi|vesesses|vesa|vesiu|vegnîen a veser|vegns a veser|vesavan|vesi|vegni a veser|vesel|vegnies a veser|vesei|veseis|vesan|vesavas|vegnessies a veser|vegnan a veser|vegnessi a veser|vegnessien a veser|vegnien a veser|vesien|vegnessen a veser|vesess|vegnin a veser|veseies|vesevies|vesas|vegness a veser|veseien|vesein|vegn a veser|vegnis a veser|vegnîes a veser|vesavel|vesessien|vesessen|vesava|vesessies|vesessi|vegnel a veser|vegnesses a veser	<i>verb</i><br><ol><li>(Sursilvan) to look</li><li>(Sursilvan) to see</li></ol>
vest	<i>noun</i><br><ol><li>west</li></ol>
vesta|vestas	<i>noun</i><br><ol><li>(Sursilvan, Sutsilvan) view</li><li>(anatomy, Sursilvan, Sutsilvan, Surmiran) cheek</li></ol>
veta|vetas	<i>noun</i><br><ol><li>(Sursilvan, Sutsilvan, Surmiran) life</li><li>(anatomy, Sursilvan, Sutsilvan, Surmiran) waist</li></ol>
via|vias	<i>noun</i><br><ol><li>(Rumantsch Grischun, Sursilvan, Puter, Vallader) road, street; way</li></ol>
vierm|vierms	<i>noun</i><br><ol><li>(Sursilvan) worm</li></ol>
vila|vilas	<i>noun</i><br><ol><li>(Sutsilvan) needle</li></ol>
vin|vins	<i>noun</i><br><ol><li>(Rumantsch Grischun, Sursilvan, Puter, Vallader) wine</li></ol>
violet|violets|violettas|violetta	<i>adj</i><br><ol><li>purple</li></ol>
vischin|vischins|vischina|vischinas	<i>noun</i><br><ol><li>neighbour</li></ol><br><i>adj</i><br><ol><li>neighbouring</li></ol>
vischina|vischins|vischin|vischinas	<i>noun</i><br><ol><li>female neighbour</li></ol><br><i>adj</i><br><ol><li>neighbouring</li></ol>
vischnanca|vischnancas	<i>noun</i><br><ol><li>(Rumantsch Grischun, Surmiran) village</li></ol>
vischnaunca|vischnauncas	<i>noun</i><br><ol><li>(Sursilvan) village</li></ol>
vischnànca|vischnàncas	<i>noun</i><br><ol><li>(Sutsilvan) village</li></ol>
vista|vistas	<i>noun</i><br><ol><li>(Rumantsch Grischun, Surmiran, Puter, Vallader) view</li><li>(Rumantsch Grischun, anatomy) cheek</li><li>(Puter, Vallader, anatomy) face</li></ol>
vita|vitas	<i>noun</i><br><ol><li>(Rumantsch Grischun, Puter, Vallader) life</li><li>(anatomy, Rumantsch Grischun, Vallader) waist</li></ol>
vitg|vitgs	<i>noun</i><br><ol><li>(Rumantsch Grischun, Sursilvan, Sutsilvan) village</li></ol>
vocabulari|vocabularis	<i>noun</i><br><ol><li>dictionary</li><li>vocabulary</li></ol>
vousch|vouschs	<i>noun</i><br><ol><li>(Surmiran) voice</li></ol>
vschinauncha|vschinaunchas	<i>noun</i><br><ol><li>(Puter) village</li></ol>
vualp|vualps	<i>noun</i><br><ol><li>(Sutsilvan) fox</li></ol>
vulair|vuls|vulain|vulend|vulessas|veglian|na veglias betg|vulessan|vulan|vul|vulevas|vulì|veglia|vuless|veglias|vulevan|vuleva|vulais|vi	<i>verb</i><br><ol><li>(Rumantsch Grischun, Puter, Vallader) to want</li></ol>
vuleir	<i>verb</i><br><ol><li>(Surmiran) to want</li></ol>
vuler	<i>verb</i><br><ol><li>(Sursilvan, Sutsilvan) to want</li></ol>
vulp|vulps	<i>noun</i><br><ol><li>(Rumantsch Grischun) fox</li></ol>
vulpa|vulpas	<i>noun</i><br><ol><li>(Rumantsch Grischun, Sursilvan, Sutsilvan, Surmiran) fox</li></ol>
vuolp|vuolps	<i>noun</i><br><ol><li>(Puter, Vallader) fox</li></ol>
vurdar	<i>verb</i><br><ol><li>(Sutsilvan) to contemplate</li><li>(Surmiran) to contemplate, observe</li><li>(Sutsilvan, Surmiran) to look, look at, watch</li><li>(Sutsilvan) to look, see</li></ol>
vus	<i>pron</i><br><ol><li>you (plural familiar)</li></ol>
vusch|vuschs	<i>noun</i><br><ol><li>(Rumantsch Grischun, Sursilvan, Sutsilvan, Puter, Vallader) voice</li></ol>
vzair	<i>verb</i><br><ol><li>(Puter) to look</li><li>(Puter) to see</li></ol>
zarcladour	<i>name</i><br><ol><li>(Surmiran) June</li></ol>
zarcladur	<i>name</i><br><ol><li>(Sutsilvan) June</li></ol>
zarclar	<i>verb</i><br><ol><li>(Sutsilvan, Surmiran) to weed</li></ol>
zarcler	<i>verb</i><br><ol><li>(Puter) to weed</li></ol>
zatge	<i>noun</i><br><ol><li>(Sutsilvan) something, anything</li></ol>
zatgei	<i>noun</i><br><ol><li>(Sursilvan) something, anything</li></ol>
zearp|zearps	<i>noun</i><br><ol><li>(Sutsilvan) snake</li></ol>
zercladur	<i>name</i><br><ol><li>(Rumantsch Grischun, Sursilvan) June</li></ol>
zerclar	<i>verb</i><br><ol><li>(Rumantsch Grischun, Sursilvan, Vallader) to weed</li></ol>
zerp|zerps	<i>noun</i><br><ol><li>(Surmiran) snake</li></ol>
zigareta|zigaretas	<i>noun</i><br><ol><li>(Sutsilvan) cigarette</li></ol>
zucer	<i>noun</i><br><ol><li>(Sutsilvan) sugar</li></ol>
zucher	<i>noun</i><br><ol><li>(Sursilvan) sugar</li></ol>
zuesca|zuescas	<i>noun</i><br><ol><li>(Sursilvan) prune</li></ol>
zuflar	<i>verb</i><br><ol><li>(Sutsilvan, Surmiran) to blow</li></ol>
zufler	<i>verb</i><br><ol><li>(Puter) to blow</li></ol>
zutger	<i>noun</i><br><ol><li>(Rumantsch Grischun) sugar</li></ol>
zvetga|zvetgas	<i>noun</i><br><ol><li>(Sutsilvan) prune</li></ol>
zücher	<i>noun</i><br><ol><li>(Puter, Vallader) sugar</li></ol>
ànghel|ànghels	<i>noun</i><br><ol><li>(Sutsilvan, religion) angel</li><li>(Sutsilvan) angle</li></ol>
îgl|îgls	<i>noun</i><br><ol><li>(Surmiran) eye</li></ol>
îl|îls	<i>noun</i><br><ol><li>(anatomy, Sutsilvan) eye</li></ol>
òlt|òlts|òlta|òltas	<i>adj</i><br><ol><li>(Sutsilvan) high</li></ol>
òss	<i>noun</i><br><ol><li>(anatomy, Surmiran) bone</li></ol>
ôr	<i>noun</i><br><ol><li>(Surmiran) gold</li></ol>
ögl|ögls	<i>noun</i><br><ol><li>(anatomy, Puter, Vallader) eye</li></ol>
öss	<i>noun</i><br><ol><li>(anatomy, Puter, Vallader) bone</li></ol>
öv|övs	<i>noun</i><br><ol><li>(Puter, Vallader, biology, zoology, foods) egg</li></ol>
ùngla|ùnglas	<i>noun</i><br><ol><li>(anatomy, Sutsilvan) nail</li></ol>
üerdi	<i>noun</i><br><ol><li>(Puter) barley</li></ol>
üert|üerts	<i>noun</i><br><ol><li>(Puter, Vallader) garden, kitchen garden, vegetable garden</li></ol>
üja|üjas	<i>noun</i><br><ol><li>(Puter) grape</li></ol>
ün|üna	<i>article</i><br><ol><li>(Puter, Vallader) a, an</li></ol><br><i>num</i><br><ol><li>(Puter, Vallader) one</li></ol>
üna|ün	<i>article</i><br><ol><li>(Puter, Vallader) a, an</li></ol><br><i>num</i><br><ol><li>(Puter, Vallader) one</li></ol>
◌̀	
