ငဝ်းလၢႆး|ngáó lááí	<i>noun</i><br><ol><li>condition, situation, circumstance</li></ol>
ငိင်း|လွင်ႈငိင်း|ngíng	<i>verb</i><br><ol><li>to become calm, quiet, as after a quarrel, (used with ယဵၼ် (yǎěn))</li></ol>
ငိုၼ်း|လွင်ႈငိုၼ်း|ngúén	<i>noun</i><br><ol><li>silver</li><li>money</li></ol><br><i>verb</i><br><ol><li>to stretch forth (as the neck)</li></ol>
ငိူင်ႉဝႄႈ|လွင်ႈငိူင်ႉဝႄႈ|ngô̰ḛ̂ng wāāē	<i>verb</i><br><ol><li>(transitive) avoid, shun</li></ol>
ငူဝ်း|ngó|တူဝ်	<i>noun</i><br><ol><li>ox; cow.</li></ol>
ငူး|ngúú	<i>noun</i><br><ol><li>snake</li></ol>
တင်ႇငူင်း|tàng ngúúng	<i>noun</i><br><ol><li>chair</li></ol>
တတ်း|လွင်ႈတတ်း|tát	<i>verb</i><br><ol><li>to cut</li></ol>
တပ်း|táp	<i>noun</i><br><ol><li>liver</li></ol>
တပ်ႉ|tâ̰p	<i>noun</i><br><ol><li>fort</li></ol>
တပ်ႉသိုၵ်း|tâ̰p súék	<i>noun</i><br><ol><li>the Army, troop</li></ol>
တပႄး|tǎ pááé	<i>noun</i><br><ol><li>scholar, disciple</li></ol>
တမ်းပူႇ|tám pùù	<i>noun</i><br><ol><li>(မႆႉ~) twig frayed at one end to clean the teeth</li></ol>
တမ်ႇငႃႈ|tàm ngāā	<i>noun</i><br><ol><li>fisherman</li></ol>
တမ်ႇတိူင်း|tàm tóéng	<i>noun</i><br><ol><li>wall</li></ol>
တမၢၼ်ႇ|tǎ mààn	<i>noun</i><br><ol><li>courier; messenger.</li></ol>
တယလူဝ်ႇ|tǎ yǎ lò	<i>noun</i><br><ol><li>plaintiff, prosecutor</li></ol>
တလႅင်း|tǎ léng	<i>name</i><br><ol><li>Mon</li></ol>
တဝ်|လွင်ႈတဝ်|tǎǒ	<i>noun</i><br><ol><li>stove; kiln.</li></ol><br><i>verb</i><br><ol><li>to stir.</li><li>to seek.</li></ol>
တဝ်ႉ|လွင်ႈတဝ်ႉ|tâ̰ô̰	<i>verb</i><br><ol><li>to support oneself with something</li><li>to be the same; to be alike</li></ol>
တိူင်း|လွင်ႈတိူင်း|tóéng	<i>noun</i><br><ol><li>country</li></ol><br><i>verb</i><br><ol><li>to compare together, measure together</li></ol>
တိူင်ႇ|tòèng|လွင်ႈတိူင်ႇ	<i>verb</i><br><ol><li>to call on to witness (used in taking an oath)</li><li>to invoke</li></ol>
တိူင်ႇပၢင်ႇ|လွင်ႈတိူင်ႇပၢင်ႇ|tòèng pààng	<i>verb</i><br><ol><li>to consult, hold counsel, deliberate together</li></ol>
တိူၵ်ႇလိူၼ်|tòèk lǒěn	<i>noun</i><br><ol><li>earthworm.</li></ol>
တိူၵ်ႈ|tōēk	<i>noun</i><br><ol><li>brick or stone building</li><li>country, continent</li><li>box, depository</li></ol>
တိၼ်|tǐn	<i>noun</i><br><ol><li>foot</li></ol>
တီႇသႅမ်ႇပႃႇ|tìì sèm pàà	<i>name</i><br><ol><li>December.</li></ol>
တီႈ|tīī	<i>noun</i><br><ol><li>place, situation, area, region</li><li>factual point</li></ol><br><i>prep</i><br><ol><li>in, at, to, on (used before dates)</li></ol><br><i>pron</i><br><ol><li>where (sometimes used with ဢၼ် (ʼǎn, “which”))</li></ol>
တီႈၶႃႈ|tīī khāā	<i>particle</i><br><ol><li>(royal) a sentence ending showing formality and politeness, used when speaking to kings and princes</li></ol>
တုင်|tǔng|လွင်ႈတုင်	<i>verb</i><br><ol><li>coagulate</li></ol>
တူ|tǔǔ	<i>noun</i><br><ol><li>door</li></ol><br><i>pron</i><br><ol><li>I, me</li></ol>
တူင်ႉ|tṵ̂ṵ̂ng|လွင်ႈတူင်ႉ	<i>verb</i><br><ol><li>to stir, move (as a living body)</li><li>to make a movement</li><li>to tremble, shake (as a house)</li></ol>
တူဝ်း|tó|လွင်ႈတူဝ်း	<i>verb</i><br><ol><li>to advance, increase, augment</li></ol>
တူၵ်းလူင်း|túúk lúúng|လွင်ႈတူၵ်းလူင်း	<i>verb</i><br><ol><li>(intransitive) agree (to something)</li></ol>
တူၼ်ႈမႆႉ|tūūn mâ̰ḭ̂	<i>noun</i><br><ol><li>tree</li></ol>
တူၼ်ႈသၼၢပ်ႇၶႃး|tūūn sǎ nààp kháá	<i>noun</i><br><ol><li>a kind of tree, the bark and root of which are used in making a fragrant cosmetic</li></ol>
တူၼ်ႈၵၢဝ်း|tūūn kááó	<i>noun</i><br><ol><li>balsam plant</li></ol>
တူၼ်ႈၵႃႈ|tūūn kāā	<i>noun</i><br><ol><li>seedly</li></ol>
တူႉၺွၼ်ႇၵျႃးယေးမူး|tṵ̂ṵ̂ nyàùn kjáá yéé múú	<i>noun</i><br><ol><li>deputy director, assistant director</li></ol>
တေႃႇတေႃႇ|tàù tàù	<i>adv</i><br><ol><li>medium, middling</li></ol>
တေႃႉသူင်ႇ|လွင်ႈတေႃႉသူင်ႇ|tâ̰ṵ̂ sùùng	<i>verb</i><br><ol><li>transport</li></ol>
တဵမ်ထူၼ်ႈ|tǎěm thūūn	<i>adj</i><br><ol><li>ample, amply sufficient</li></ol>
တြႃး|tráá	<i>noun</i><br><ol><li>law</li><li>right; justice</li></ol>
တွင်|tǎǔng	<i>noun</i><br><ol><li>big leaf, especially banana leaf.</li></ol>
တွင်းလၢၼ်း|táúng láán	<i>noun</i><br><ol><li>daunglan, circular pedestal tray</li></ol>
တွင်ႇသူႇ|tàùng sùù	<i>name</i><br><ol><li>Pa-O</li></ol>
တွင်ႇဢူႇ|tàùng ʼùù	<i>noun</i><br><ol><li>Taungoo (a town north of Pegu)</li></ol>
တွင်ႉမႆႈသႆႈလိူတ်ႇ|လွင်ႈတွင်ႉမႆႈသႆႈလိူတ်ႇ|tâ̰ṵ̂ng māī sāī lòèt	<i>verb</i><br><ol><li>(idiomatic, hyperbolic) to be very hungry</li></ol>
တွၵ်း|táúk|လွင်ႈတွၵ်း	<i>verb</i><br><ol><li>knock, rap with the knuckles</li></ol>
တွၵ်ႉတႄႉ|tâ̰ṵ̂k tâ̰â̰ḛ̂	<i>noun</i><br><ol><li>gecko, large spotted lizard</li></ol>
တၢင်း|tááng	<i>noun</i><br><ol><li>way between two places, road</li></ol>
တၢင်းပဵၼ်|tááng pǎěn	<i>noun</i><br><ol><li>abstract noun of ပဵၼ် (pǎěn); illness, disease.</li></ol>
တၢင်းႁူႉ|tááng hṵ̂ṵ̂	<i>noun</i><br><ol><li>knowledge, perception, intellect</li></ol>
တၢင်းႁၵ်ႉ|tááng hâ̰k	<i>noun</i><br><ol><li>abstract noun of ႁၵ်ႉ (hâ̰k); love.</li></ol>
တၢင်ႇထီး|လွင်ႈတၢင်ႇထီး|tààng thíí	<i>verb</i><br><ol><li>(Buddhism) to crown a pagoda with an ornamental umbrella</li></ol>
တၢင်ႇၵုင်ႇ|tààng kùng|လွင်ႈတၢင်ႇၵုင်ႇ	<i>verb</i><br><ol><li>express, thanks</li></ol>
တၢပ်ႈ|လွင်ႈတၢပ်ႈ|tāāp	<i>verb</i><br><ol><li>to put on, fix on</li></ol>
တၢမ်ႇ|tààm	<i>noun</i><br><ol><li>punishment, penalty; evil, calamity</li></ol>
တၢၼ်း|táán	<i>noun</i><br><ol><li>class</li></ol>
တၢႆ|လွင်ႈတၢႆ|tǎǎǐ	<i>verb</i><br><ol><li>to die.</li></ol>
တၵႃႇ|tǎ kàà	<i>noun</i><br><ol><li>layman; one who contributes to the support of a monk, or does some deed for merit</li></ol>
တၼင်းလႃႇ|tǎ náng làà	<i>noun</i><br><ol><li>(ဝၼ်း~) Monday</li></ol>
တၼင်းၼူၺ်ႇ|tǎ náng nòì	<i>noun</i><br><ol><li>(ဝၼ်း~) Sunday</li></ol>
တၼူႉ|tǎ nṵ̂ṵ̂	<i>name</i><br><ol><li>Danu</li></ol>
တႂၢၵ်ႈ|လွင်ႈတႂၢၵ်ႈ|twāāk	<i>verb</i><br><ol><li>to count, enumerate</li><li>to calculate, reckon</li><li>to cipher</li><li>to shirk duty</li></ol>
တႃ|tǎǎ	<i>noun</i><br><ol><li>eye.</li><li>maternal grandfather.</li></ol>
တႃႇတၢၵ်ႈ|လွင်ႈတႃႇတၢၵ်ႈ|tàà tāāk	<i>verb</i><br><ol><li>to begin a new year</li></ol>
တႃႈရူတ်ႉလဵၼ်း|tāā rṵ̂ṵ̂t láén	<i>noun</i><br><ol><li>railway station.</li></ol>
တႃႈႁိူဝ်း|tāā hóé	<i>noun</i><br><ol><li>river boat jetty.</li></ol>
တႄႇ|လွင်ႈတႄႇ|tààè	<i>verb</i><br><ol><li>to begin, set up, erect, establish, constitute</li></ol>
တႅင်း|téng	<i>noun</i><br><ol><li>country, province</li></ol>
တႅင်းၵႃး|téng káá	<i>noun</i><br><ol><li>coin of silver or gold</li></ol>
တႅင်ၽၢင်|těng phǎǎng	<i>noun</i><br><ol><li>watermelon.</li></ol>
တႅမ်ႈ|လွင်ႈတႅမ်ႈ|tēm	<i>verb</i><br><ol><li>(transitive) write, compose</li><li>(transitive) delineate, paint</li></ol>
တႅၼ်ႇ|လွင်ႈတႅၼ်ႇ|tèn	<i>verb</i><br><ol><li>to strike; to beat</li><li>(colloquial) to eat up; to consume</li></ol>
တႆး|táí	<i>name</i><br><ol><li>Shan or Tai</li></ol>
တႆးလႅင်|táí lěng	<i>name</i><br><ol><li>Tai Laing</li></ol>
ထ|thǎ	
ထမ်ႈ|thām	<i>noun</i><br><ol><li>cave.</li></ol>
ထီး|thíí	<i>noun</i><br><ol><li>umbrella (common or religious/royal used)</li></ol>
ထုင်း|thúng	<i>noun</i><br><ol><li>precedent, way, custom, tradition, manner</li></ol>
ထုင်ႇ|လွင်ႈထုင်ႇ|thùng	<i>verb</i><br><ol><li>to be numb, be benumbed (as a person from long sitting); be stupefied</li></ol>
ထုၼ်း|thún|လွင်ႈထုၼ်း	<i>verb</i><br><ol><li>to shine, be conspicuous</li><li>to be celebrated</li></ol>
ထူ|thǔǔ|လွင်ႈထူ	<i>verb</i><br><ol><li>to rub</li></ol>
ထူဝ်ႇ|thò	<i>noun</i><br><ol><li>a bean.</li></ol>
ထူး|တၢင်းထူး|thúú	<i>noun</i><br><ol><li>fetters.</li></ol><br><i>adj</i><br><ol><li>special; different; unique.</li></ol>
ထူၺ်း|thóí|တၢင်းထူၺ်း	<i>adj</i><br><ol><li>the youngest [sometimes used with လိုၼ်း ]</li></ol>
ထူၺ်ႈၸႂ်|လွင်ႈထူၺ်ႈၸႂ်|thōī tsǎǔě	<i>verb</i><br><ol><li>(intransitive) breathe, respire</li></ol>
ထေး|လွင်ႈထေး|théé	<i>verb</i><br><ol><li>to be rich</li><li>to have in abundance</li></ol>
ထေႃးပၢတ်ႈ|tháú pāāt	<i>noun</i><br><ol><li>butter</li></ol>
ထေႃးပၼႃႇ|လွင်ႈထေႃးပၼႃႇ|tháú pǎ nàà	<i>verb</i><br><ol><li>to laud, praise</li></ol>
ထွင်ႇ|thàùng|လွင်ႈထွင်ႇ	<i>noun</i><br><ol><li>prison; jail.</li></ol><br><i>verb</i><br><ol><li>to strike against (as light or wind); to shine; to shine against.</li><li>to shine upon a surface or spot.</li></ol>
ထွင်ႉ|thâ̰ṵ̂ng	<i>noun</i><br><ol><li>corner</li></ol>
ထွၵ်ႈ|လွင်ႈထွၵ်ႈ|thāūk	<i>verb</i><br><ol><li>to consider</li></ol>
ထၢင်ႇ|လွင်ႈထၢင်ႇ|thààng	<i>verb</i><br><ol><li>to think, opine</li><li>to appear, be visible, conspicuous</li></ol>
ထၢတ်ႈ|thāāt	<i>noun</i><br><ol><li>element (one of the primary or constituent parts of anything whether material or immaterial)</li><li>one of the four principal elements (i.e., ထၢတ်ႈလိၼ် earth; ထၢတ်ႈၼမ်ႉ water; ထၢတ်ႈၽႆး fire; ထၢတ်ႈလူမ်း air)</li><li>essential attribute, quality</li><li>relic of deity</li><li>shrine, pagoda</li></ol>
ထၢမ်|လွင်ႈထၢမ်|thǎǎm	<i>verb</i><br><ol><li>to ask.</li></ol>
ထၢမ်း|tháám|လွင်ႈထၢမ်း	<i>verb</i><br><ol><li>to {do government service, bear official duties)</li><li>to pay tax</li><li>to bear a load</li></ol>
ထၢၼ်|thǎǎn	<i>noun</i><br><ol><li>sugar palm, toddy palm</li></ol>
ထၼူႉ|thǎ nṵ̂ṵ̂	<i>name</i><br><ol><li>Danu</li></ol>
ထႃႇပၼႃႇ|thàà pǎ nàà	<i>noun</i><br><ol><li>(Buddhism) relic (of a pagoda)</li></ol>
ပ|pǎ	
ပတ်ႈတမျႃး|pāt tǎ mjáá	<i>noun</i><br><ol><li>ruby; carbuncle</li></ol>
ပတ်ႈတလႃး|pāt tǎ láá	<i>noun</i><br><ol><li>xylophone</li></ol>
ပတ်ႈတႃး|pāt táá	<i>noun</i><br><ol><li>mercury; quicksilver</li></ol>
ပတ်ႉ|pâ̰t|လွင်ႈပတ်ႉ	
ပယိၼ်း|pǎ yín	<i>noun</i><br><ol><li>amber</li></ol>
ပယိၼ်ႇၶၢမ်ႇ|pǎ yìn khààm	<i>noun</i><br><ol><li>viceroy</li></ol>
ပရုၵ်ႈ|pǎ rūk	<i>noun</i><br><ol><li>camphor</li></ol>
ပလွင်ႈ|pǎ lāūng	<i>name</i><br><ol><li>Palaung</li></ol>
ပဝ်ႇ|pàò|လွင်ႈပဝ်ႇ	<i>verb</i><br><ol><li>to blow</li></ol>
ပဢူဝ်|pǎ ʼǒ	<i>name</i><br><ol><li>Pa-O</li></ol>
ပဢူဝ်း|pǎ ʼó	<i>name</i><br><ol><li>Pa-O</li></ol>
ပိတ်ႈတၵၢတ်ႈ|pīt tǎ kāāt	<i>noun</i><br><ol><li>(Buddhism) Tripitaka</li></ol>
ပိုၼ်ႉတီႈ|pṵ̂ḛ̂n tīī	<i>noun</i><br><ol><li>area</li></ol>
ပိူင်ႇ|pòèng|လွင်ႈပိူင်ႇ	<i>verb</i><br><ol><li>to own, possess, have a right to</li><li>to be over, be chief</li></ol>
ပိၵ်ႈ|pīk	<i>noun</i><br><ol><li>cotton cloth, calico</li></ol>
ပိၵ်ႈမၢၼ်ႇ|pīk mààn	<i>noun</i><br><ol><li>(Buddhism) building for religious worship, temple</li><li>mausoleum</li></ol>
ပီ|pǐǐ	<i>noun</i><br><ol><li>year.</li><li>banana blossom.</li><li>writing brush; small painting brush.</li></ol>
ပီၵွၼ်းၶမ်း|pǐǐ káún khám	<i>noun</i><br><ol><li>golden jubilee.</li></ol>
ပီႉတၵၢတ်ႈ|pḭ̂ḭ̂ tǎ kāāt	<i>noun</i><br><ol><li>(Buddhism) Tripitaka</li></ol>
ပုင်ႇ|pùng	<i>noun</i><br><ol><li>shape; form.</li></ol>
ပုင်ႇၵၢၼ်ႇ|လွင်ႈပုင်ႇၵၢၼ်ႇ|pùng kààn	<i>verb</i><br><ol><li>to rebel; to revolt</li></ol>
ပုၵ်ႈတႁူး|pūk tǎ húú	<i>noun</i><br><ol><li>(ဝၼ်း~) Wednesday</li></ol>
ပုၵ်ႉထဝၢင်ႇ|pṵ̂k thǎ wààng	<i>noun</i><br><ol><li>history of Buddhas</li></ol>
ပုၵ်ႉထႃႉၽႃႇသႃႇ|pṵ̂k thâ̰â̰ phàà sàà	<i>noun</i><br><ol><li>(Buddhism) Buddhism</li></ol>
ပူ|pǔǔ	<i>noun</i><br><ol><li>crab</li></ol>
ပူး|လွင်ႈပူး|púú	<i>verb</i><br><ol><li>to join, unite, place together</li></ol><br><i>noun</i><br><ol><li>guinea pig</li><li>white mouse</li><li>long water weed, kind of watercress</li></ol>
ပူၺ်း|póí	<i>noun</i><br><ol><li>ringworm</li></ol>
ပူၼ်ႉပႅၼ်|pṵ̂ṵ̂n pěn|လွင်ႈပူၼ်ႉပႅၼ်	<i>verb</i><br><ol><li>go beyond, violate, transgress, trespass</li></ol>
ပူႇ|pùù	<i>noun</i><br><ol><li>paternal grandfather.</li></ol>
ပူႇတႃႇ|pùù tàà	<i>noun</i><br><ol><li>station, stopping place</li></ol>
ပူႇၵၢင်ႉ|pùù kâ̰â̰ng	<i>noun</i><br><ol><li>chief of a village</li></ol>
ပူႇၵႄႇ|pùù kààè	<i>noun</i><br><ol><li>headman</li></ol>
ပူႉ|pṵ̂ṵ̂	<i>noun</i><br><ol><li>betel</li></ol>
ပူႉထူဝ်း|pṵ̂ṵ̂ thó	<i>noun</i><br><ol><li>(Buddhism) hollow pagoda</li></ol>
ပေႃး|လွင်ႈပေႃး|páú	<i>verb</i><br><ol><li>to be plentiful, not scarce</li><li>to be cheap, inexpensive</li></ol>
ပေႃႇ|pàù|လွင်ႈပေႃႇ	<i>verb</i><br><ol><li>to appear, come into light</li><li>to become available (as fruits in season)</li></ol>
ပေႃႈ|pāū	<i>noun</i><br><ol><li>father</li></ol>
ပေႇ|pèè	<i>noun</i><br><ol><li>book palm or corypha tree or leaf</li><li>foot, feet, as in a measure of length</li></ol>
ပဵတ်း|páét|တူဝ်	<i>noun</i><br><ol><li>duck</li></ol>
ပဵတ်ႈၸယႃႇ|pāēt tsǎ yàà	<i>noun</i><br><ol><li>(Buddhism, architecture) terrace (of a pagoda)</li></ol>
ပဵၼ်|လွင်ႈပဵၼ်|တၢင်းပဵၼ်|pǎěn	<i>verb</i><br><ol><li>(transitive, copulative) be</li><li>(intransitive) be ill, have a disease</li></ol><br><i>particle</i><br><ol><li>a particle that indicates that it is possible to get something to happen.</li></ol>
ပျေႉ|pjḛ̂ḛ̂|လွင်ႈပျေႉ	<i>verb</i><br><ol><li>to be full</li></ol>
ပျွင်း|pjáúng	<i>noun</i><br><ol><li>tube used for blowing or projecting</li></ol>
ပျၢတ်ႈ|pjāāt|လွင်ႈပျၢတ်ႈ	<i>verb</i><br><ol><li>to be ended, cease, stop (as to be out of supply)</li><li>to ; appraise at a proper price, offer a "bottom line" price</li></ol>
ပျၢတ်ႈသၢတ်ႈ|pjāāt sāāt	<i>noun</i><br><ol><li>(architecture) building or steeple with a graduated roof</li></ol>
ပျၢၵ်ႈ|လွင်ႈပျၢၵ်ႈ|pjāāk	<i>verb</i><br><ol><li>to be witty, comical; trifle with, deride, treat derisively</li></ol>
ပျႃႇတႃႇ|pjàà tàà	<i>noun</i><br><ol><li>messenger; peon</li></ol>
ပြၢင်း|လွင်ႈပြၢင်း|prááng	<i>verb</i><br><ol><li>to be violent (as in action)</li><li>to be pungent (as in smell)</li></ol>
ပွင်း|páúng|လွင်ႈပွင်း	<i>noun</i><br><ol><li>arch roof</li></ol><br><i>verb</i><br><ol><li>to associate with</li><li>to join, be united with</li><li>to add (arithmetic)</li></ol>
ပွင်ႇၸႂ်|pàùng tsǎǔě|လွင်ႈပွင်ႇၸႂ်	<i>verb</i><br><ol><li>to understand</li></ol>
ပွတ်းႁွင်ႇ|တၢင်းပွတ်းႁွင်ႇ|páút hàùng	<i>noun</i><br><ol><li>north, northern part</li></ol><br><i>adj</i><br><ol><li>northern</li></ol>
ပွႆး|páúí	<i>noun</i><br><ol><li>feast, festival, entertainment, celebration</li></ol>
ပွႆးၸႃး|páúí tsáá	<i>noun</i><br><ol><li>broker, agent, go-between</li></ol>
ပၢင်တိုၵ်း|pǎǎng túék	<i>noun</i><br><ol><li>battlefield, battle arena</li><li>battle</li></ol>
ပၢတ်ႈမႃႉ|pāāt mâ̰â̰	<i>noun</i><br><ol><li>large drum</li></ol>
ပၢတ်ႈသႅင်း|pāāt séng	<i>noun</i><br><ol><li>round frame in which several drums are placed (the player standing in the midst of them)</li></ol>
ပၢၼ်းတုင်း|páán túng	<i>noun</i><br><ol><li>goalpost</li><li>pole having a bunch of grass or flowers fastened to the end, set up as an auspicious sign for victory or a symbol of royal prerogative</li></ol>
ပၢၼ်းသေး|páán séé	<i>name</i><br><ol><li>Panthay</li></ol>
ပၢႆးမွၼ်း|pááí máún	<i>noun</i><br><ol><li>art, fine arts</li></ol>
ပၢႆးမၢၵ်ႈမီး|pááí māāk míí	<i>noun</i><br><ol><li>economy, economic affair</li></ol>
ပၼ်ၵတိ|pǎn kǎ tǐ	<i>verb</i><br><ol><li>promise</li></ol>
ပၼ်ႁႅင်း|pǎn héng|လွင်ႈပၼ်ႁႅင်း	<i>verb</i><br><ol><li>encourage, cheer, animate</li></ol>
ပႂၢင်း|လွင်ႈပႂၢင်း|pwááng	<i>verb</i><br><ol><li>to open</li><li>(Buddhism) to manifest as a Buddha or god</li></ol>
ပႃ|pǎǎ	<i>noun</i><br><ol><li>fish</li></ol>
ပႃးၸပူတ်ႉ|páá tsǎ pṵ̂ṵ̂t	<i>noun</i><br><ol><li>passport</li></ol>
ပႃႇတီႇ|pàà tìì	<i>noun</i><br><ol><li>political party</li></ol>
ပႃႈ|pāā	<i>noun</i><br><ol><li>elder sister of one's parent.</li></ol>
ပႄး|pááé	<i>noun</i><br><ol><li>raft.</li><li>viss, weight equal to 8 ticals.</li><li>anna, one sixteenth of a rupee (old currency).</li></ol>
ပႄႇ|လွင်ႈပႄႇ|pààè	<i>verb</i><br><ol><li>to put aside or away, reject</li></ol>
ပႅင်ႇ|လွင်ႈပႅင်ႇ|pèng	<i>verb</i><br><ol><li>to compare</li><li>to engage in rivalry, contest</li><li>to own, have the right to, have authority over (as property)</li></ol>
ပႅတ်ႇ|pèt	<i>num</i><br><ol><li>eight</li></ol>
ပႅတ်ႇသိပ်း|pèt síp	<i>num</i><br><ol><li>eighty</li></ol>
ပႆ|လွင်ႈပႆ|pǎǐ	<i>verb</i><br><ol><li>to go</li></ol>
မလႅင်ႇ|mǎ lèng	<i>noun</i><br><ol><li>cream</li></ol>
မိုၼ်ႇ|mùèn	<i>num</i><br><ol><li>ten thousand</li></ol>
မိူင်း|móéng	<i>noun</i><br><ol><li>country</li><li>city</li></ol>
မိူင်းထႆး|móéng tháí	<i>name</i><br><ol><li>Thailand</li></ol>
မိူင်းမၢၼ်ႈ|móéng māān	<i>name</i><br><ol><li>Myanmar</li></ol>
မိူင်းယူၼ်း|móéng yúún	<i>name</i><br><ol><li>Laos</li></ol>
မိူင်းလၢဝ်း|móéng lááó	<i>name</i><br><ol><li>Laos</li></ol>
မိူင်းဢမေႇရီႉၵႃႉ|móéng ʼǎ mèè rḭ̂ḭ̂ kâ̰â̰	<i>name</i><br><ol><li>United States</li></ol>
မိူင်းဢိင်ႇၵလၼ်ႇ|móéng ʼìng kǎ làn	<i>name</i><br><ol><li>England</li></ol>
မိူင်းဢိၼ်းတီးယႃး|móéng ʼín tíí yáá	<i>name</i><br><ol><li>India</li></ol>
မိူင်းၵလႃး|móéng kǎ láá	<i>name</i><br><ol><li>India</li></ol>
မိူင်းၵျႃႇပၢၼ်ႇ|móéng kjàà pààn	<i>name</i><br><ol><li>Japan</li></ol>
မိူင်းၵွၵ်ႇ|móéng kàùk	<i>name</i><br><ol><li>Bangkok</li></ol>
မိူင်းၶႄႇ|móéng khààè	<i>name</i><br><ol><li>China</li></ol>
မိူင်းၽီးလၢတ်ႈ|móéng phíí lāāt	<i>name</i><br><ol><li>England</li></ol>
မိူင်းႀမတႃႉ|móéng xǎ mǎ tâ̰â̰	<i>noun</i><br><ol><li>republic</li></ol>
မိူဝ်ႈ|တၢင်းမိူဝ်ႈ|mōē	<i>noun</i><br><ol><li>time</li></ol><br><i>conj</i><br><ol><li>when</li></ol><br><i>adv</i><br><ol><li>when</li></ol>
မိူဝ်ႈလႂ်သေဢမ်ႇဝႃႈ|mōē lǎǔě sěě ʼàm wāā	<i>adv</i><br><ol><li>whenever; no matter when, ၶၢဝ်းလႂ်သေဢမ်ႇဝႃႈ၊ ၶိင်ႇလႂ်သေဢမ်ႇဝႃႈ</li></ol>
မိူဝ်ႈၵႆႈ|mōē kāī	<i>adv</i><br><ol><li>just now, a moment ago</li></ol>
မိူဝ်ႈၼႃႈထႃႇလိုၼ်း|mōē nāā thàà lúén	<i>noun</i><br><ol><li>future</li></ol>
မိူၵ်ႈ|mōēk|လွင်ႈမိူၵ်ႈ	<i>verb</i><br><ol><li>to be darkminded, wicked</li><li>to be ignorant, foolish</li></ol>
မိူၼ်|တၢင်းမိူၼ်|mǒěn	<i>adj</i><br><ol><li>similar, same</li></ol>
မီ|mǐǐ|တူဝ်	<i>noun</i><br><ol><li>bear</li></ol>
မီး|တၢင်းမီး|လွင်ႈမီး|míí	<i>verb</i><br><ol><li>(transitive) have</li><li>(intransitive) be, exist</li></ol><br><i>adj</i><br><ol><li>rich, wealthy</li></ol>
မီးပၢၼ်း|míí páán	<i>noun</i><br><ol><li>fireworks</li></ol>
မီးယၢပ်ႈ|míí yāāp	<i>noun</i><br><ol><li>menses</li></ol>
မုၵ်ႈ|mūk	<i>noun</i><br><ol><li>(Buddhism, architecture) ornamental work around an arched gateway into a pagoda</li></ol>
မုၼ်း|mún	<i>noun</i><br><ol><li>bread, cake</li></ol>
မုၼ်ၸဝ်ႈ|mǔn tsāō	<i>noun</i><br><ol><li>monk.</li></ol>
မုၼ်ၸဝ်ႈပူပ်ႉ|mǔn tsāō pṵ̂ṵ̂p	<i>noun</i><br><ol><li>pope.</li></ol>
မူ|mǔǔ|တူဝ်	<i>noun</i><br><ol><li>pig</li></ol>
မူင်ႇလႃႇထုၵ်ႈ|mùùng làà thūk	<i>noun</i><br><ol><li>cabbage</li></ol>
မူင်ႇလႃႇပၢၼ်း|mùùng làà páán	<i>noun</i><br><ol><li>cauliflower</li></ol>
မူဝ်းၵႃႇ|mó kàà	<i>noun</i><br><ol><li>awning, tent</li></ol>
မူးသိူဝ်း|múú sóé	<i>name</i><br><ol><li>Lisu</li></ol><br><i>noun</i><br><ol><li>huntsman</li></ol>
မူၺ်ႉ|mô̰ḭ̂|လွင်ႈမူၺ်ႉ	<i>verb</i><br><ol><li>to twirl, whirl about</li></ol>
မူႇသလိမ်ႇ|mùù sǎ lìm	<i>noun</i><br><ol><li>(Islam) Muslim</li></ol>
မေး|méé	<i>noun</i><br><ol><li>wife.</li></ol>
မေႃယႃ|mǎǔ yǎǎ	<i>noun</i><br><ol><li>physician, doctor</li></ol>
မေႃၵႂၢမ်း|mǎǔ kwáám	<i>noun</i><br><ol><li>singer</li></ol>
မေႃၽီ|mǎǔ phǐǐ	<i>noun</i><br><ol><li>wizard, sorcerer, witch, sorceress</li></ol>
မေႃႇ|màù	<i>noun</i><br><ol><li>supernatural or magical power (which resembles mesmerism in its phenomena), magic, sorcery</li></ol>
မေႇ|mèè	<i>name</i><br><ol><li>May.</li></ol>
မဵဝ်း|máéó	<i>noun</i><br><ol><li>kind; sort; type.</li><li>race.</li></ol>
မဵၼ်ႈ|māēn	<i>noun</i><br><ol><li>porcupine</li></ol>
မျူဝ်ႉဝုၼ်ႇ|mjô̰ wùn	<i>noun</i><br><ol><li>governor of a city or province, mayor</li></ol>
မျူဝ်ႉၸႃး|mjô̰ tsáá	<i>noun</i><br><ol><li>myosa, district chief; duke</li></ol>
မျၢတ်ႈ|လွင်ႈမျၢတ်ႈ|mjāāt	<i>verb</i><br><ol><li>to exceed, gain, make a profit</li></ol>
မျၢၵ်ႈလႄႉ|mjāāk lâ̰â̰ḛ̂	<i>noun</i><br><ol><li>jugglery, trickery, as in magic shows</li></ol>
မျႃႉ|mjâ̰â̰	<i>noun</i><br><ol><li>emerald</li></ol>
မြၢတ်ႈ|mrāāt|လွင်ႈမြၢတ်ႈ	<i>verb</i><br><ol><li>to be noble, excellent, divine</li></ol>
မွင်းၵူၺ်း|máúng kóí	<i>noun</i><br><ol><li>ring (a circular band worn on a finger)</li></ol>
မွၼ်|mǎǔn	<i>noun</i><br><ol><li>pillow.</li></ol>
မွၼ်း|တၢင်းမွၼ်း|máún	<i>name</i><br><ol><li>Mon</li></ol><br><i>noun</i><br><ol><li>(poetic) heart of anything, best part; yolk of an egg; also used in reference to princes, denoting excellence of position.</li><li>mulberry</li></ol><br><i>adj</i><br><ol><li>gentle, delicate, soft; fine, sleek, smooth</li></ol>
မၢတ်ႈ|လွင်ႈမၢတ်ႈ|māāt	<i>noun</i><br><ol><li>amount of money of one quarter of a kyat, (old currency; e.g., a quarter, 25 cents)</li></ol><br><i>verb</i><br><ol><li>to mark, note down</li><li>to observe, remember, regard, know</li></ol>
မၢတ်ႉၶျ်	<i>name</i><br><ol><li>March.</li></ol>
မၢမ်ႇ|လွင်ႈမၢမ်ႇ|mààm	<i>verb</i><br><ol><li>plaster, cover with some soft substance, caulk</li></ol>
မၢဝ်း|mááó	<i>name</i><br><ol><li>(ၼမ်ႉ~) Shweli river</li></ol>
မၢၵ်ႇ|mààk	<i>noun</i><br><ol><li>fruit</li></ol>
မၢၵ်ႇမူင်ႈ|mààk mūūng	<i>noun</i><br><ol><li>a mango.</li></ol>
မၢၵ်ႇယၢၼ်းတီး|mààk yáán tíí	<i>noun</i><br><ol><li>marian plum</li></ol>
မၢၵ်ႇလၼ်း|mààk lán|ႁူၺ်ႇ	<i>noun</i><br><ol><li>(anatomy) kidney</li></ol>
မၢၵ်ႇၵၢဝ်ႈ|mààk kāāō	<i>noun</i><br><ol><li>calf</li></ol>
မၢၵ်ႇၼင်|mààk nǎng	<i>noun</i><br><ol><li>soccer ball</li></ol>
မၢၼ်ႇ|mààn	<i>noun</i><br><ol><li>glass</li></ol>
မၢၼ်ႇတႅင်ႇ|mààn tèng	<i>noun</i><br><ol><li>upright pivot in the center of a circle; goal</li><li>(Buddhism, figuratively) bodhi tree under which the Buddha gained enlightenment</li></ol>
မၢၼ်ႈ|māān	<i>noun</i><br><ol><li>village.</li></ol><br><i>name</i><br><ol><li>Burma; Burmese.</li></ol>
မၢၼ်ႈထၼူႉ|māān thǎ nṵ̂ṵ̂	<i>name</i><br><ol><li>Danu</li></ol>
မၢၼ်ႈမႅင်း|māān méng	<i>name</i><br><ol><li>Burman or Burmese</li></ol>
မၢၼ်ႈဢၢင်းလေး|māān ʼááng léé	<i>name</i><br><ol><li>Intha</li></ol>
မၢၼ်ႈၵသေး|māān kǎ séé	<i>name</i><br><ol><li>Khasi</li></ol>
မၢၼ်ႈၼွင်|māān nǎǔng	<i>name</i><br><ol><li>Intha</li></ol>
မၢၼ်ႈႁၢႆးယႃႈ|māān hááí yāā	<i>name</i><br><ol><li>Intha</li></ol>
မႁႃႇမိၵ်ႈ|mǎ hàà mīk	<i>noun</i><br><ol><li>alliance, allies, group of nations on friendly terms,</li></ol>
မႁႃႇသႃႇဝၵႃႉ|mǎ hàà sàà wǎ kâ̰â̰	<i>noun</i><br><ol><li>(Buddhism) main disciple of the Buddha</li></ol>
မႂ်း|máúé	<i>pron</i><br><ol><li>you (singular).</li></ol>
မႂ်ႇသုင်|màùè sǔng	<i>intj</i><br><ol><li>hello, used as a greeting</li></ol><br><i>verb</i><br><ol><li>to be progressive, advanced (as in status, well-being)</li></ol>
မႃ|mǎǎ|တူဝ်	<i>noun</i><br><ol><li>dog</li></ol>
မႃး|máá|လွင်ႈမႃး	<i>verb</i><br><ol><li>to come.</li></ol>
မႃႇၼၢတ်ႈ|màà nāāt	<i>noun</i><br><ol><li>(Buddhism) Mara, powerful evil spirit, who has power over all the lower parts of the universe</li></ol>
မႃႉ|လွင်ႈမႃႉ|mâ̰â̰|တူဝ်	<i>noun</i><br><ol><li>horse</li><li>wen</li><li>frame with legs used to support something</li></ol><br><i>verb</i><br><ol><li>to assist, help</li></ol>
မႃႉၼမ်ႉ|mâ̰â̰ nâ̰m|တူဝ်	<i>noun</i><br><ol><li>hippopotamus</li></ol>
မႅင်ႇ|လွင်ႈမႅင်ႇ|mèng	<i>noun</i><br><ol><li>mile.</li></ol><br><i>verb</i><br><ol><li>to share, to divide (into parts).</li></ol>
မႅဝ်း|méáó|တူဝ်	<i>noun</i><br><ol><li>cat.</li></ol>
မႅၵ်ႈၵၸိၼ်း|mēk kǎ tsín	<i>noun</i><br><ol><li>magazine</li></ol>
မႆႉၵၢၼ်းႁၢပ်ႇ|mâ̰ḭ̂ káán hààp	<i>noun</i><br><ol><li>yoke</li></ol>
မႆႉၸလီႇ|mâ̰ḭ̂ tsǎ lìì	<i>noun</i><br><ol><li>flowery cassia (Senna siamea, syn. Cassia siamea)</li></ol>
ယမ်း|yám|တၢင်းယမ်း|လွင်ႈယမ်း	<i>verb</i><br><ol><li>to be wet.</li></ol><br><i>adj</i><br><ol><li>wet.</li></ol>
ယဝ်ႉ|yâ̰ô̰|လွင်ႈယဝ်ႉ	<i>verb</i><br><ol><li>(intransitive) be finished, be done</li><li>(transitive) finish</li><li>(transitive) tease playfully, joke, banter</li></ol><br><i>adv</i><br><ol><li>used as a general marker to indicate that an action or state has completed, ended, happened, done, etc.</li></ol>
ယိင်း|yíng	<i>noun</i><br><ol><li>female, girl.</li></ol>
ယိပ်း|yíp|လွင်ႈယိပ်း	<i>verb</i><br><ol><li>take hold of.</li></ol>
ယုင်း|yúng	<i>noun</i><br><ol><li>mosquito.</li></ol>
ယုတ်ႈ|လွင်ႈယုတ်ႈ|yūt	<i>verb</i><br><ol><li>to be inferior, mean</li><li>to be vile, wicked</li></ol>
ယုမ်ႉ|လွင်ႈယုမ်ႉ|yṵ̂m	<i>verb</i><br><ol><li>to smile.</li><li>to wilt.</li><li>to believe, trust, have confidence in</li></ol>
ယူဝ်ႇ|yò	<i>noun</i><br><ol><li>jam; preserve</li></ol>
ယူၼ်း|yúún	<i>name</i><br><ol><li>Northern Thai</li></ol>
ယေးငိုၼ်း|yéé ngúén	<i>noun</i><br><ol><li>bank (financial institution)</li></ol>
ယေႃး|yáú	<i>name</i><br><ol><li>Yaw (an ethnic group living west of the Irrawaddy river)</li></ol>
ယေႇသူႉ|yèè sṵ̂ṵ̂	<i>name</i><br><ol><li>Jesus</li></ol>
ယဵပ်ႉ|yâ̰ḛ̂p|လွင်ႈယဵပ်ႉ	<i>verb</i><br><ol><li>to sew.</li></ol>
ယဵၼ်ႇ|yàèn|တၢင်းယဵၼ်ႇ	<i>noun</i><br><ol><li>carriage; vehicle.</li><li>(ပႃ~) eel.</li></ol><br><i>adj</i><br><ol><li>civilized; polite.</li><li>tame; docile.</li></ol>
ယွမ်းၵၢၼ်ႉ|လွင်ႈယွမ်းၵၢၼ်ႉ|yáúm kâ̰â̰n	<i>verb</i><br><ol><li>surrender</li></ol>
ယွၵ်ႈလိၼ်ႉပိၼ်ႈတႃ|လွင်ႈယွၵ်ႈလိၼ်ႉပိၼ်ႈတႃ|yāūk lḭ̂n pīn tǎǎ	<i>verb</i><br><ol><li>protrude the tongue in banter or to cause another to be angry</li></ol>
ယၢပ်ႇၽိုတ်ႇ|yààp phùèt|တၢင်းယၢပ်ႇၽိုတ်ႇ	<i>adj</i><br><ol><li>difficult, arduous</li></ol>
ယၢမ်း|yáám	<i>noun</i><br><ol><li>time</li><li>gunpowder</li><li>scaffold</li><li>(poetic) gong</li></ol>
ယၢၼ်ႇသူႇ|yààn sùù	<i>noun</i><br><ol><li>enemy.</li></ol>
ယၶႅင်ႇ|yǎ khèng	<i>name</i><br><ol><li>Rakhine</li></ol>
ယၼ်ႇၵုင်ႇ|yàn kùng	<i>name</i><br><ol><li>Yangon (a city in Myanmar)</li></ol>
ယႃ|yǎǎ|လွင်ႈယႃ	<i>noun</i><br><ol><li>medicine</li></ol><br><i>verb</i><br><ol><li>to cure; to heal</li><li>to repair</li></ol>
ယႅၵ်ႉ|yḛ̂k|လွင်ႈယႅၵ်ႉ	<i>verb</i><br><ol><li>(transitive) to look at attentively; to gaze at</li></ol>
ရ|rǎ	<i>character</i><br><ol><li>Ra, the 15th letter of the Shan alphabet.</li></ol>
ရေႃးၵႃႇ|ráú kàà	<i>noun</i><br><ol><li>disease; sickness; disorder.</li></ol>
ရၢၼ်ႇသူႇ|rààn sùù	<i>noun</i><br><ol><li>enemy.</li></ol>
ရၶႅင်ႇ|rǎ khèng	<i>name</i><br><ol><li>Rakhine</li></ol>
ရႁၢၼ်း|rǎ háán	<i>noun</i><br><ol><li>(Buddhism) monk; bhikkhu</li></ol>
ရႃႇဝၢင်ႇ|ràà wààng	<i>noun</i><br><ol><li>(history) history</li></ol>
လ|lǎ	
လင်|lǎng	<i>noun</i><br><ol><li>back (of the body).</li></ol><br><i>classifier</i><br><ol><li>a classifier for houses</li></ol>
လင်ႇၵႃႇ|làng kàà	<i>noun</i><br><ol><li>poetry</li></ol>
လပ်း|တၢင်းလပ်း|láp|လွင်ႈလပ်း	<i>verb</i><br><ol><li>to extinguish</li><li>to shut (eyes); to sleep</li></ol><br><i>adj</i><br><ol><li>dark</li></ol>
လမ်|lǎm|တၢင်းလမ်|လွင်ႈလမ်	<i>verb</i><br><ol><li>to dive.</li></ol><br><i>adj</i><br><ol><li>black.</li></ol>
လမ်းၽႅင်ႇ|lám phèng	<i>noun</i><br><ol><li>porpoise</li></ol>
လမ်ႇလွင်ႈ|làm lāūng	<i>adj</i><br><ol><li>important, significant</li></ol>
လိင်း|líng	<i>noun</i><br><ol><li>monkey.</li></ol>
လိုမ်း|lúém|လွင်ႈလိုမ်း	<i>verb</i><br><ol><li>to forget.</li></ol>
လိုၵ်ႉ|တၢင်းလိုၵ်ႉ|lṵ̂ḛ̂k	<i>adj</i><br><ol><li>deep.</li></ol>
လိူင်|တၢင်းလိူင်|lǒěng	<i>adj</i><br><ol><li>yellow.</li></ol>
လိူၵ်ႈ|လွင်ႈလိူၵ်ႈ|lōēk	<i>verb</i><br><ol><li>to choose.</li></ol>
လိူၼ်|lǒěn	<i>noun</i><br><ol><li>month.</li><li>moon.</li></ol>
လိၵ်ႈတႆး|līk táí	<i>name</i><br><ol><li>the Shan language (especially written)</li></ol>
လိၼ်|lǐn	<i>noun</i><br><ol><li>earth; soil.</li><li>great-grandchild.</li></ol>
လီ|lǐǐ|တၢင်းလီ	<i>adj</i><br><ol><li>good</li></ol><br><i>noun</i><br><ol><li>gallbladder; bile.</li></ol>
လုင်ႇ|လွင်ႈလုင်ႇ|lùng	<i>verb</i><br><ol><li>to be safe, secure</li></ol>
လုတ်ႈတေႃႇ|lūt tàù	<i>noun</i><br><ol><li>parliament; national assembly; legislature</li></ol>
လုမ်ႈၽႃႉ|lūm phâ̰â̰	<i>noun</i><br><ol><li>realm of the sky, universe.</li></ol>
လုၵ်ႈႁဵၼ်း|lūk háén	<i>noun</i><br><ol><li>student</li></ol>
လုၼ်ႇ|လွင်ႈလုၼ်ႇ|lùn	<i>verb</i><br><ol><li>to pass beyond, exceed</li><li>to pass beyond, away from (as danger)</li></ol>
လူ|lǔǔ|လွင်ႈလူ	<i>verb</i><br><ol><li>to see</li><li>to donate; give as a religious act; make an offering</li></ol>
လူင်း|တၢင်းလူင်း|lúúng	<i>adv</i><br><ol><li>down; downward.</li></ol>
လူမ်း|lúúm	<i>noun</i><br><ol><li>wind.</li></ol>
လူဝ်ႇ|လွင်ႈလူဝ်ႇ|lò	<i>verb</i><br><ol><li>to need, desire, wish for, have a wish</li></ol>
လူႉလႅဝ်|လွင်ႈလူႉလႅဝ်|lṵ̂ṵ̂ lěǎǒ	<i>verb</i><br><ol><li>break down, fall to pieces</li></ol>
လူႉၵိူၼ်ႇ|lṵ̂ṵ̂ kòèn|လွင်ႈလူႉၵိူၼ်ႇ	<i>verb</i><br><ol><li>break down, fall to pieces</li></ol>
လေး|léé|လွင်ႈလေး	<i>verb</i><br><ol><li>to lick.</li></ol><br><i>noun</i><br><ol><li>certain amount or weight of alloy added to silver</li><li>profit, increase on rice in trade or interest on money, when the original doubles or trebles</li></ol>
လေႃႉၵူၼ်းပဵၼ်|lâ̰ṵ̂ kúún pǎěn	<i>noun</i><br><ol><li>stretcher, ၶဵင်ႇႁၢမ်ၵူၼ်းပဵၼ်</li></ol>
လေႇယိၼ်ႇပျၢၼ်ႇ|lèè yìn pjààn	<i>noun</i><br><ol><li>airplane</li></ol>
လဵၵ်း|láék	<i>noun</i><br><ol><li>iron</li></ol>
လွင်း|လွင်ႈလွင်း|láúng	<i>verb</i><br><ol><li>to stake in a wager or in gambling, bet, gamble</li></ol>
လွင်ႈလုၵ်ႉၽိုၼ်ႉ|lāūng lṵ̂k phṵ̂ḛ̂n	<i>noun</i><br><ol><li>revolution</li></ol>
လွႆ|lǎǔǐ	<i>noun</i><br><ol><li>mountain</li></ol>
လၢင်းတႃႉ|lááng tâ̰â̰	<i>noun</i><br><ol><li>vulture.</li></ol>
လၢတ်ႈၵႂၢမ်းၵၵ်း|lāāt kwáám kák|လွင်ႈလၢတ်ႈၵႂၢမ်းၵၵ်း	<i>verb</i><br><ol><li>stutter</li></ol>
လၢပ်ႈ|လွင်ႈလၢပ်ႈ|lāāp	<i>noun</i><br><ol><li>gift, present, anything obtained by gift, acquired fortune</li></ol><br><i>verb</i><br><ol><li>to be empty, vacant, disengaged</li></ol>
လၢမ်ႇ|lààm	<i>noun</i><br><ol><li>flag, ensign</li></ol>
လၢဝ်|lǎǎǒ	<i>noun</i><br><ol><li>star.</li></ol>
လၢၵ်ႈထၢပ်ႈ|လွင်ႈလၢၵ်ႈထၢပ်ႈ|lāāk thāāp	<i>verb</i><br><ol><li>to wed; to marry</li></ol>
လၢၵ်ႈမၢတ်ႈ|lāāk māāt	<i>noun</i><br><ol><li>signature</li><li>ticket, certificate</li></ol>
လၢၵ်ႈသမႃး|lāāk sǎ máá	<i>noun</i><br><ol><li>carpenter</li></ol>
လၢၵ်ႈသဵတ်ႈ|lāāk sāēt	<i>noun</i><br><ol><li>new hand, new-fashioned</li></ol>
လၢၵ်ႈသွင်ႇ|lāāk sàùng	<i>noun</i><br><ol><li>present; gift</li></ol>
လၢၵ်ႈၸွပ်ႈ|lāāk tsāūp	<i>noun</i><br><ol><li>ring (worn on the finger)</li></ol>
လၢၵ်ႈၼၢၵ်ႈ|lāāk nāāk	<i>noun</i><br><ol><li>weapon</li></ol>
လၢၵ်ႈၽွႆး|lāāk pháúí	<i>noun</i><br><ol><li>amulet</li></ol>
လၢၵ်ႈၽွႆႉ|lāāk phâ̰ṵ̂ḭ̂	<i>noun</i><br><ol><li>amulet</li></ol>
လၢၼ်ႉၸဝ်ႈ|lâ̰â̰n tsāō	<i>name</i><br><ol><li>Nanzhao</li></ol>
လၵ်းထၢၼ်|lák thǎǎn	<i>noun</i><br><ol><li>evidence.</li></ol>
လႄႈ|lāāē	<i>conj</i><br><ol><li>and, and so</li></ol><br><i>particle</i><br><ol><li>a particle as an imperative particle used after a verb phrase</li></ol>
လႅင်|တၢင်းလႅင်|lěng	<i>adj</i><br><ol><li>red.</li></ol>
လႅင်း|léng	<i>noun</i><br><ol><li>wave, billow</li></ol>
လႅၵ်ႈလၢႆႈ|လွင်ႈလႅၵ်ႈလၢႆႈ|lēk lāāī	<i>verb</i><br><ol><li>change, exchange</li></ol>
လႅၼ်|lěn	<i>noun</i><br><ol><li>border, boundary.</li></ol>
လႆ|လွင်ႈလႆ|lǎǐ	<i>verb</i><br><ol><li>to flow</li></ol>
လႆႈ|lāī|လွင်ႈလႆႈ	<i>verb</i><br><ol><li>to get; to obtain; to receive</li><li>(auxiliary) Used before a verb to indicate that one has done or has an opportunity to do the action.</li><li>(auxiliary) Used before a verb to express that the action must be done.</li><li>(auxiliary) Used after a verb to express that the action can be done.</li></ol>
ဝ|wǎ	
ဝင်ႇၵပႃႇ|wàng kǎ pàà	<i>noun</i><br><ol><li>maze; labyrinth</li><li>name of a labyrinthine range of mountains which figures in Buddhist history</li></ol>
ဝီ|wǐǐ|လွင်ႈဝီ	<i>noun</i><br><ol><li>comb.</li><li>hand (of bananas).</li></ol><br><i>verb</i><br><ol><li>to comb.</li></ol>
ဝီႇၶီႇၽီးတီးယႃး|wìikhìiphíitíiyáa	<i>name</i><br><ol><li>(current spelling) Wikipedia</li></ol>
ဝီႉၺဵၼ်ႇ|wḭ̂ḭ̂ nyàèn	<i>noun</i><br><ol><li>(Buddhism) soul; spirit</li></ol>
ဝီႉၼႄး|wḭ̂ḭ̂ nááé	<i>noun</i><br><ol><li>(Buddhism) Vinaya, one of three canons of the Tripitaka</li></ol>
ဝုတ်ႉထူႉ|wṵ̂t thṵ̂ṵ̂	<i>noun</i><br><ol><li>narrative, novel, tale</li><li>(Buddhism) offering of money, gold or silver</li></ol>
ဝုၼ်ႇၵျီးၶျုၵ်ႈ|wùn kjíí khjūk	<i>noun</i><br><ol><li>prime minister</li></ol>
ဝူတ်ႈသမ်ႇ|wūūt sàm	<i>noun</i><br><ol><li>stamen, anther and pollen of a flower</li></ol>
ဝူၺ်ႇ|wòì|လွင်ႈဝူၺ်ႇ	<i>verb</i><br><ol><li>to distribute, dispense</li></ol>
ဝဵင်း|wáéng	<i>noun</i><br><ol><li>town or city</li><li>prefix of the name of a town or city</li></ol>
ဝၢင်း|wááng	<i>noun</i><br><ol><li>enclosure</li><li>place enclosed or fenced in</li><li>court, yard (as of a house)</li></ol>
ဝၢၵ်ႈဢူႇ|wāāk ʼùù	<i>noun</i><br><ol><li>screw</li></ol>
ဝၢၼ်|wǎǎn|တၢင်းဝၢၼ်	<i>adj</i><br><ol><li>sweet.</li><li>delicious.</li><li>pleasant (of speech).</li><li>joyful; cheerful.</li></ol>
ဝၢၼ်ႈ|wāān	<i>noun</i><br><ol><li>(dialectal) village, hamlet</li></ol>
ဝၢႆ|wǎǎǐ	<i>noun</i><br><ol><li>rattan vine</li></ol>
ဝၢႆး|လွင်ႈဝၢႆး|တၢင်းဝၢႆး|wááí	<i>verb</i><br><ol><li>to be over, past the time or season of (as the season of any kind of fruit, occasion, festival)</li></ol><br><i>adv</i><br><ol><li>after</li></ol>
ဝၢႆႇ|wààì|လွင်ႈဝၢႆႇ	<i>verb</i><br><ol><li>to turn around, to turn away, as the head</li></ol>
ဝၢႆႉ|လွင်ႈဝၢႆႉ|တၢင်းဝၢႆႉ|wâ̰â̰ḭ̂	<i>verb</i><br><ol><li>to do anything sideways</li></ol><br><i>adv</i><br><ol><li>obliquely, sideways</li></ol>
ဝၼ်း|wán	<i>noun</i><br><ol><li>day.</li><li>sun.</li></ol>
ဝႂ်ၶၢမ်ႈမိူင်း|wǎǔě khāām móéng	<i>noun</i><br><ol><li>passport</li></ol>
ဝႃႈ|တၢင်းဝႃႈ|လွင်ႈဝႃႈ|wāā	<i>verb</i><br><ol><li>(intransitive) say, speak, tell</li><li>(transitive) scold</li></ol><br><i>conj</i><br><ol><li>(complementizer) that</li></ol><br><i>particle</i><br><ol><li>used after a statement as an emphasis.</li></ol><br><i>adj</i><br><ol><li>insane, crazy.</li></ol>
ဝႃႈၼႆ|wāā nǎǐ|လွင်ႈဝႃႈၼႆ	<i>verb</i><br><ol><li>(intransitive) say so, say thus; have said thus</li></ol>
ဝႃႉ|wâ̰â̰	<i>name</i><br><ol><li>Wa</li></ol>
ဝႆ|wǎǐ	<i>verb</i><br><ol><li>to stir, to move, to wave</li></ol>
သတၢင်း|sǎ tááng	<i>noun</i><br><ol><li>religious duty</li><li>time between worship days</li><li>week</li></ol>
သပ်ႉပျႃႇ|sâ̰p pjàà	<i>noun</i><br><ol><li>soap</li></ol>
သပျေႇ|sǎ pjèè	<i>noun</i><br><ol><li>eugenia tree, whose leaves are used as a religious offering</li></ol>
သပႃႇပတီႉ|sǎ pàà pǎ tḭ̂ḭ̂	<i>noun</i><br><ol><li>speaker, spokesman, spokesperson</li></ol>
သမ်း|sám|လွင်ႈသမ်း	<i>verb</i><br><ol><li>to thrust in (as a needle); to inject.</li><li>to tattoo.</li></ol>
သမ်ႇမၺႃႉ|တၢင်းသမ်ႇမၺႃႉ|sàm mǎ nyâ̰â̰	<i>adj</i><br><ol><li>ordinary, middling</li></ol>
သမ်ႇမၼီႉ|sàm mǎ nḭ̂ḭ̂	<i>noun</i><br><ol><li>(လဵၵ်း~) steel.</li></ol>
သမႅင်း|sǎ méng	<i>noun</i><br><ol><li>(Buddhism) history of a pagoda, gods, or ancient kings</li></ol>
သရၽူႇ|sǎ rǎ phùù	<i>noun</i><br><ol><li>crown (worn on the head)</li></ol>
သလေႇ|sǎ lèè	<i>noun</i><br><ol><li>character, reputation</li></ol>
သဝ်ပၢၼ်းလႄး|sǎǒ páán lááé	<i>noun</i><br><ol><li>rod of an umbrella; rod of the umbrella of a pagoda</li></ol>
သဝၢၵ်ႈသႃႇ|sǎ wāāk sàà	<i>noun</i><br><ol><li>muriate of ammonia, salammoniac</li></ol>
သိင်းၶူဝ်ႇ|síng khò	<i>noun</i><br><ol><li>asafoetida</li></ol>
သိင်ႇ|sìng	<i>noun</i><br><ol><li>Leo, the fifth sign of the Zodiac</li></ol>
သိင်ႇဝႅတ်ႉလွမ်ႉ|sìng wḛ̂t lâ̰ṵ̂m	<i>noun</i><br><ol><li>environment (nature).</li></ol>
သိပ်း|síp	<i>num</i><br><ol><li>ten</li></ol>
သိပ်းပႅတ်ႇ|síp pèt	<i>num</i><br><ol><li>eighteen</li></ol>
သိပ်းသီႇ|síp sìì	<i>num</i><br><ol><li>fourteen</li></ol>
သိပ်းသွင်|síp sǎǔng	<i>num</i><br><ol><li>twelve</li></ol>
သိပ်းသၢမ်|síp sǎǎm	<i>num</i><br><ol><li>thirteen</li></ol>
သိပ်းဢဵတ်း|síp ʼáét	<i>num</i><br><ol><li>eleven</li></ol>
သိပ်းၵဝ်ႈ|síp kāō	<i>num</i><br><ol><li>nineteen</li></ol>
သိပ်းၸဵတ်း|síp tsáét	<i>num</i><br><ol><li>seventeen</li></ol>
သိပ်းႁူၵ်း|síp húúk	<i>num</i><br><ol><li>sixteen</li></ol>
သိပ်းႁႃႈ|síp hāā	<i>num</i><br><ol><li>fifteen</li></ol>
သိမ်း|sím|လွင်ႈသိမ်း	<i>verb</i><br><ol><li>gather in</li><li>to put up, lay up, store up, treasure up</li><li>to deprive of the insignia of office</li></ol>
သိမ်ႇ|sìm	<i>noun</i><br><ol><li>(Buddhism) ordination hall, building set apart for the performance of certain rites pertaining to the Buddhist monkhood</li><li>a sanctuary</li></ol>
သိူဝ်|တူဝ်|sǒě	<i>noun</i><br><ol><li>tiger</li></ol>
သီ|sǐǐ|လွင်ႈသီ	<i>verb</i><br><ol><li>to rub; to scrape.</li></ol><br><i>noun</i><br><ol><li>color.</li></ol>
သီမူၼ်ႇ|sǐǐ mùùn	<i>noun</i><br><ol><li>gray.</li><li>grey.</li></ol>
သီလမ်|sǐǐ lǎm	<i>noun</i><br><ol><li>black.</li></ol>
သီလိူင်သဝ်ႈ|sǐǐ lǒěng sāō	<i>noun</i><br><ol><li>dusty yellow.</li></ol>
သီလိူင်ၼုမ်ႇ|sǐǐ lǒěng nùm	<i>noun</i><br><ol><li>mustard yellow.</li></ol>
သီလႅင်|sǐǐ lěng	<i>noun</i><br><ol><li>red.</li></ol>
သီၵမ်ႇ|sǐǐ kàm	<i>noun</i><br><ol><li>brown.</li></ol>
သီၶဵဝ်|sǐǐ khǎěǒ	<i>noun</i><br><ol><li>green.</li></ol>
သီၽိူၵ်ႇ|sǐǐ phòèk	<i>noun</i><br><ol><li>white.</li></ol>
သီႇ|sìì	<i>num</i><br><ol><li>four</li></ol>
သီႇရီႉလင်ႇၵႃႇ|sìì rḭ̂ḭ̂ làng kàà	<i>name</i><br><ol><li>Sri Lanka</li></ol>
သီႇသိပ်း|sìì síp	<i>num</i><br><ol><li>forty</li></ol>
သီႇႁူဝ်ႇ|sìì hò	<i>name</i><br><ol><li>Sri Lanka, Ceylon</li></ol>
သီႇႁႃႉ|sìì hâ̰â̰	<i>noun</i><br><ol><li>lion</li></ol>
သုင်|တၢင်းသုင်|sǔng	<i>adj</i><br><ol><li>tall.</li><li>high.</li></ol>
သုင်းမႃႉ|súng mâ̰â̰|လွင်ႈသုင်းမႃႉ	<i>verb</i><br><ol><li>to instruct, discipline</li></ol>
သုမ်းၶၢဝ်းယၢမ်း|လွင်ႈသုမ်းၶၢဝ်းယၢမ်း|súm khááó yáám	<i>verb</i><br><ol><li>(intransitive) waste time</li></ol>
သုၵ်ႈ|sūk	<i>noun</i><br><ol><li>(Buddhism) sutra; Buddhist scriptures</li><li>(grammar) grammatical rule</li></ol>
သုၵ်ႉၶႃႉ|sṵ̂k khâ̰â̰	<i>noun</i><br><ol><li>happiness, freedom from trouble</li></ol>
သူ|sǔǔ	<i>pron</i><br><ol><li>you (plural).</li></ol>
သူင်ႇ|လွင်ႈသူင်ႇ|sùùng	<i>verb</i><br><ol><li>to send.</li><li>to hide.</li></ol>
သူင်ႇဢွၵ်ႇ|လွင်ႈသူင်ႇဢွၵ်ႇ|sùùng ʼàùk	<i>verb</i><br><ol><li>export</li></ol>
သူဝ်း|só	<i>noun</i><br><ol><li>sheep</li></ol>
သူး|súú|လွင်ႈသူး	<i>noun</i><br><ol><li>reward, prize</li><li>blessing</li></ol><br><i>verb</i><br><ol><li>push up, boost</li></ol>
သူးၵွၵ်း|súú káúk	<i>noun</i><br><ol><li>trophy, Cup</li></ol>
သူၺ်ႇတၵုင်ႇ|sòì tǎ kùng	<i>name</i><br><ol><li>Shwedagon Pagoda</li></ol>
သူၼ်|sǔǔn	<i>noun</i><br><ol><li>garden</li></ol><br><i>num</i><br><ol><li>zero</li></ol>
သူၼ်သတ်း|sǔǔn sát	<i>noun</i><br><ol><li>zoo</li></ol>
သူႇ|sùù|လွင်ႈသူႇ	<i>verb</i><br><ol><li>to smoke opium</li></ol>
သူႇတေႃႇၵွင်း|sùù tàù káúng	<i>noun</i><br><ol><li>religious person, good, righteous person</li></ol>
သေးပူးလႄး|séé púú lááé	<i>noun</i><br><ol><li>gentian</li></ol>
သေးယူင်ႇ|séé yùùng	<i>noun</i><br><ol><li>hospital</li></ol>
သေးလိၵ်ႉ|séé lḭ̂k	<i>noun</i><br><ol><li>cheroot, native cigar milder than the Havana cigar, made of a mixture of chopped tobacco leaves and stems, certain kinds of wood sprinkled with jaggery, and tamarind syrup, and covered with the leaves of certain trees, such as တွင်ပေႃမၼ်</li></ol>
သဵင်|sǎěng	<i>noun</i><br><ol><li>sound, noise, voice, tone</li></ol>
သဵၼ်ႈ|sāēn	<i>noun</i><br><ol><li>line; thread</li><li>splinter</li></ol>
သဵၼ်ႈတၢင်း|sāēn tááng	<i>noun</i><br><ol><li>road, route</li></ol>
သြႃႇတေႃႇ|sràà tàù	<i>noun</i><br><ol><li>(Buddhism) abbot (of a Buddhist monastery)</li></ol>
သြႃႇဝုၼ်ႇ|sràà wùn	<i>noun</i><br><ol><li>physician; doctor</li></ol>
သြႃႇသမႃး|sràà sǎ máá	<i>noun</i><br><ol><li>teacher</li></ol>
သွင်|sǎǔng	<i>num</i><br><ol><li>two</li></ol>
သွမ်း|sáúm|တၢင်းသွမ်း|လွင်ႈသွမ်း	<i>noun</i><br><ol><li>(Buddhism) cooked rice or food for a monk</li></ol><br><i>adj</i><br><ol><li>inferior, mean, vile, wicked</li></ol><br><i>verb</i><br><ol><li>to censure; to scold</li></ol>
သွၵ်ႉၵျႃႇ|sâ̰ṵ̂k kjàà	<i>noun</i><br><ol><li>(ဝၼ်း~) Friday</li></ol>
သွၼ်|လွင်ႈသွၼ်|sǎǔn	<i>verb</i><br><ol><li>to teach.</li></ol>
သၢင်း|sááng|လွင်ႈသၢင်း	<i>verb</i><br><ol><li>to be clear, free from</li></ol>
သၢင်းၵျၢၼ်ႇ|sááng kjààn	<i>name</i><br><ol><li>Thingyan, the traditional New Year celebrated in mid-April</li></ol><br><i>noun</i><br><ol><li>walk, place for walking to and fro</li></ol>
သၢင်ႇပုတ်ႈ|sààng pūt	<i>noun</i><br><ol><li>frame used for the displaying of offerings at the close of Buddhist Lent</li></ol>
သၢင်ႇလွင်း|sààng láúng	<i>noun</i><br><ol><li>boy or young man before becoming a novice monk</li></ol>
သၢင်ႇဝၢင်ႇ|sààng wààng	<i>noun</i><br><ol><li>(architecture, Buddhism) portico or porch (of a monastery)</li></ol>
သၢင်ႇသီႈ|တူဝ်|sààng sīī	<i>noun</i><br><ol><li>lion</li></ol>
သၢင်ႇၵၢၼ်း|sààng káán	<i>noun</i><br><ol><li>monastic robes</li></ol>
သၢမ်|sǎǎm	<i>num</i><br><ol><li>three</li></ol>
သၢမ်လႅမ်ထွင်းၶမ်း|sǎǎm lěm tháúng khám	<i>name</i><br><ol><li>the Golden Triangle</li></ol>
သၢမ်သိပ်း|sǎǎm síp	<i>num</i><br><ol><li>thirty</li></ol>
သၢမ်ၸဵင်ႇ|sǎǎm tsàèng	<i>noun</i><br><ol><li>triangle.</li></ol>
သၢဝ်း|sááó	<i>num</i><br><ol><li>twenty</li></ol>
သၢဝ်းသွင်|sááó sǎǔng	<i>num</i><br><ol><li>twenty-two</li></ol>
သၢဝ်းသၢမ်|sááó sǎǎm	<i>num</i><br><ol><li>twenty-three</li></ol>
သၢဝ်းဢဵတ်း|sááó ʼáét	<i>num</i><br><ol><li>twenty-one</li></ol>
သၢၵ်ႇသေ|sààk sěě	<i>noun</i><br><ol><li>witness.</li><li>evidence.</li></ol>
သၢၵ်ႈ|sāāk|လွင်ႈသၢၵ်ႈ	<i>verb</i><br><ol><li>to offer, present, as to a priest or a king</li></ol>
သၢၵ်ႈသႃႇ|လွင်ႈသၢၵ်ႈသႃႇ|sāāk sàà	<i>verb</i><br><ol><li>to be at ease</li></ol>
သၢၼ်ႇလႅၵ်ႉ|sààn lḛ̂k	<i>noun</i><br><ol><li>magnet</li></ol>
သၵျႃး|sǎ kjáá	<i>noun</i><br><ol><li>sugar</li></ol>
သၼၢပ်ႈၶႃး|sǎ nāāp kháá	<i>noun</i><br><ol><li>thanakha.</li></ol>
သၽေႃး|sǎ pháú	<i>noun</i><br><ol><li>nature, character</li><li>disposition, bent or tendency of mind, mental state</li><li>tenor, meaning</li></ol>
သၽၢင်ႇ|sǎ phààng	<i>noun</i><br><ol><li>festival of any kind</li><li>a public entertainment</li></ol>
သႃးၸေး|sáá tséé	<i>noun</i><br><ol><li>cutch</li></ol>
သႃႇ|sàà|လွင်ႈသႃႇ	<i>verb</i><br><ol><li>to be clear, pleasant</li><li>to be comfortable</li><li>to be better</li></ol>
သႃႇထူႉ|sàà thṵ̂ṵ̂	<i>intj</i><br><ol><li>term of approbation, right, well done (as hallelujah, amen)</li></ol>
သႃႇဝၵႃႉ|sàà wǎ kâ̰â̰	<i>noun</i><br><ol><li>(Buddhism) disciple (of the Buddha)</li></ol>
သႃႇၵီႇဝၢင်ႇ|sàà kìì wààng	<i>noun</i><br><ol><li>royal race from which Gaudama descended</li></ol>
သႄးၵၢပ်ႈ|လွင်ႈသႄးၵၢပ်ႈ|sááé kāāp	<i>verb</i><br><ol><li>to adhereto, be under the guidance of</li></ol>
သႅင်|sěng	<i>noun</i><br><ol><li>gem; gemstone; precious stone.</li></ol>
သႅင်း|séng	<i>noun</i><br><ol><li>circular frame in which several drums are fixed</li></ol>
သႅင်ႇ|sèng|လွင်ႈသႅင်ႇ	<i>noun</i><br><ol><li>shop, stall</li></ol><br><i>verb</i><br><ol><li>to have a right to; appertain to, concern</li></ol>
သႅပ်ႇထႅမ်ႇပႃႇ|sèp thèm pàà	<i>name</i><br><ol><li>September.</li></ol>
သႅၼ်|sěn	<i>num</i><br><ol><li>hundred thousand</li></ol>
ဢ|ʼǎ	<i>character</i><br><ol><li>the 33rd alphabet of Shan alphabet, named ဢ ဢၢင်ႇ.</li></ol>
ဢင်းၵိတ်ႉ|တၢင်းဢင်းၵိတ်ႉ|ʼáng kḭ̂t	<i>name</i><br><ol><li>England; English.</li></ol><br><i>adj</i><br><ol><li>English.</li></ol>
ဢင်ႇၵႃႇ|ʼàng kàà	<i>noun</i><br><ol><li>(ဝၼ်း~) Tuesday</li></ol>
ဢတူဝ်း|ʼǎ tó	<i>noun</i><br><ol><li>(finance) interest (of money).</li></ol>
ဢတၢတ်ႈ|ʼǎ tāāt	<i>noun</i><br><ol><li>science, skill</li><li>charm, spell</li></ol>
ဢတႂၢင်းဝုၼ်ႇ|ʼǎ twááng wùn	<i>noun</i><br><ol><li>private minister of a prince</li></ol>
ဢတႂၢၵ်ႈ|ʼǎ twāāk	<i>noun</i><br><ol><li>account, concern, matter</li></ol>
ဢပုမ်ႇ|ʼǎ pùm	<i>noun</i><br><ol><li>story, tale</li></ol>
ဢမိင်ႉ|ʼǎ mḭ̂ng	<i>noun</i><br><ol><li>order; command</li></ol>
ဢမူး|ʼǎ múú	<i>noun</i><br><ol><li>civil service or duty of any kind (as paying taxes)</li></ol>
ဢမူၺ်ႇ|ʼǎ mòì	<i>noun</i><br><ol><li>inheritance; legacy; heritage.</li></ol>
ဢမူႉ|ʼǎ mṵ̂ṵ̂	<i>noun</i><br><ol><li>business, case</li><li>legal process, law suit</li></ol>
ဢမျွၵ်ႈ|ʼǎ mjāūk	<i>noun</i><br><ol><li>cannon</li></ol>
ဢမျၢၵ်ႈ|ʼǎ mjāāk	<i>noun</i><br><ol><li>anger, resentment</li></ol>
ဢမၢတ်ႈ|ʼǎ māāt	<i>noun</i><br><ol><li>person of rank, minister in a king's court</li><li>cabinet minister, member of parliament</li></ol>
ဢယိၵ်ႈ|ʼǎ yīk	<i>noun</i><br><ol><li>shadow, shade</li><li>hint, intimation</li></ol>
ဢယူႇ|ʼǎ yùù	<i>noun</i><br><ol><li>opinion, sentiment, ideology, belief</li></ol>
ဢယေး|ʼǎ yéé	<i>noun</i><br><ol><li>matter, case</li></ol>
ဢယႃႇ|ʼǎ yàà	<i>noun</i><br><ol><li>rank, position, designation</li></ol>
ဢရွႆႇ|ʼǎ ràùì	<i>noun</i><br><ol><li>age of maturity</li><li>age</li></ol>
ဢရၢပ်ႈ|ʼǎ rāāp	<i>noun</i><br><ol><li>height, stature</li><li>place, location</li></ol>
ဢရႃႇ|ʼǎ ràà	<i>noun</i><br><ol><li>thing, matter</li><li>office, rank</li></ol>
ဢလူဝ်ႇ|ʼǎ lò	<i>noun</i><br><ol><li>desire, will</li><li>need, want</li></ol>
ဢလေႉ|ʼǎ lḛ̂ḛ̂	<i>noun</i><br><ol><li>habit, way acquired</li></ol>
ဢလွင်း|ʼǎ láúng	<i>noun</i><br><ol><li>(Buddhism) one who is progressing towards a state of enlightenment</li></ol>
ဢသိမ်ႇ|ʼǎ sìm	<i>noun</i><br><ol><li>velocity, power, imposing appearance</li></ol>
ဢသုင်း|ʼǎ súng	<i>noun</i><br><ol><li>use, usefulness</li></ol>
ဢသွင်ႇ|ʼǎ sàùng	<i>noun</i><br><ol><li>what one usually carries, mascot</li></ol>
ဢသၢၵ်ႈ|ʼǎ sāāk	<i>noun</i><br><ol><li>life, age</li></ol>
ဢိင်းၵလဵတ်ႈ|ʼíng kǎ lāēt|တၢင်းဢိင်းၵလဵတ်ႈ	<i>adj</i><br><ol><li>English</li></ol>
ဢိင်ႇမျွင်ႇ|ʼìng mjàùng	<i>noun</i><br><ol><li>mariner's compass</li></ol>
ဢိုဝ်ႈ|တၢင်းဢိုဝ်ႈ|ʼūē	<i>adj</i><br><ol><li>improvident; inefficient; unstable</li></ol>
ဢုပ်ႇဢူဝ်း|ʼùp ʼó|လွင်ႈဢုပ်ႇဢူဝ်း	<i>verb</i><br><ol><li>(intransitive, transitive) discuss, converse</li></ol>
ဢုပ်ႉ|လွင်ႈဢုပ်ႉ|ʼṵ̂p	<i>verb</i><br><ol><li>to cover</li><li>to preside over, have the charge of rule</li></ol>
ဢုပ်ႉပိူင်ႇ|ʼṵ̂p pòèng|လွင်ႈဢုပ်ႉပိူင်ႇ	<i>verb</i><br><ol><li>(transitive) rule, have authority over, preside over, have dominion</li></ol>
ဢုမ်ႇ|လွင်ႈဢုမ်ႇ|ʼùm	<i>verb</i><br><ol><li>cover up, plaster, plate</li></ol>
ဢုၵ်ႉၸူႉ|ʼṵ̂k tsṵ̂ṵ̂	<i>noun</i><br><ol><li>district, jurisdiction</li><li>group of people</li></ol>
ဢုၼ်|ʼǔn	<i>noun</i><br><ol><li>coconut</li></ol>
ဢူး|ʼúú	<i>noun</i><br><ol><li>beginning, fore part, head</li></ol>
ဢူးတၢၼ်း|ʼúú táán	<i>noun</i><br><ol><li>joyful utterance, speaking with joy, exultation (commonly applied to deity, or inspired persons)</li><li>accounts handed down from antiquity, traditional records</li></ol>
ဢူၺ်းလီ|ʼóí lǐǐ	<i>noun</i><br><ol><li>ally</li></ol>
ဢူၺ်းၵေႃႉ|ʼóí kâ̰ṵ̂	<i>noun</i><br><ol><li>friend, companion</li></ol>
ဢေႃးၵၢတ်ႉ|ʼáú kâ̰â̰t	<i>name</i><br><ol><li>August.</li></ol>
ဢေႃႇၸတြေးလီးယိူဝ်း|ʼàù tsǎ tréé líí yóé	<i>name</i><br><ol><li>Australia (a continent and country in Oceania)</li></ol>
ဢေႇ|ʼèè	<i>adj</i><br><ol><li>few, not many</li></ol>
ဢေႇပရႄႇ|ʼèè pǎ rààè	<i>name</i><br><ol><li>April.</li></ol>
ဢဵတ်ႇ|ʼàèt	<i>noun</i><br><ol><li>AIDS.</li></ol>
ဢွင်ႇ|လွင်ႈဢွင်ႇ|ʼàùng	<i>verb</i><br><ol><li>to beat, conquer, win, overcome, gain one's objective</li><li>to pass an examination or test</li></ol>
ဢွၵ်းဢေႃ|ʼáúk ʼǎǔ	<i>noun</i><br><ol><li>brain</li></ol>
ဢွၵ်ႇထူဝ်ႇပႃႇ|ʼàùk thò pàà	<i>name</i><br><ol><li>October.</li></ol>
ဢၢင်း|ʼááng	<i>noun</i><br><ol><li>table divided into squares for entering figures and accounts; such a table used as a charm</li></ol>
ဢၢင်းၵတေႇ|ʼááng kǎ tèè	<i>noun</i><br><ol><li>plaster compounds of lime and sand for coating walls, cement</li></ol>
ဢၢင်ႇ|ʼààng	<i>noun</i><br><ol><li>basin; sink (utensil).</li></ol>
ဢၢမ်း|ʼáám|လွင်ႈဢၢမ်း	<i>verb</i><br><ol><li>(intransitive) to wonder, to be amazed; to be in awe</li></ol>
ဢၢၼ်ႇ|ʼààn|လွင်ႈဢၢၼ်ႇ	<i>verb</i><br><ol><li>(transitive) read</li><li>(transitive) count</li></ol>
ဢၵျူဝ်း|ʼǎ kjó	<i>noun</i><br><ol><li>consequence, result, effect</li><li>good result, advantage, benefit, profit</li></ol>
ဢၵျွတ်ႈ|ʼǎ kjāūt	<i>noun</i><br><ol><li>release</li></ol>
ဢၵွၵ်ႈ|ʼǎ kāūk	<i>noun</i><br><ol><li>tax; duty; toll.</li></ol>
ဢၶျၢၵ်ႈ|ʼǎ khjāāk	<i>noun</i><br><ol><li>subject, fact of the matter, topic, signal</li></ol>
ဢၶွၼ်ႇ|ʼǎ khàùn	<i>noun</i><br><ol><li>taxes, tribute</li></ol>
ဢၸူဝ်းယႃႉ|ʼǎ tsó yâ̰â̰	<i>noun</i><br><ol><li>government; administrative body</li></ol>
ဢၺေႃႇ|ʼǎ nyàù	<i>noun</i><br><ol><li>offensive smell, especially of anything frying</li></ol>
ဢၼူႉပိင်ႇၺႃႇ|ʼǎ nṵ̂ṵ̂ pìng nyàà	<i>noun</i><br><ol><li>fine arts, artistic entertainment</li></ol>
ဢၼၢၵ်ႈ|ʼǎ nāāk	<i>noun</i><br><ol><li>explanation, translation, interpretation (usually a translation from Pali)</li></ol>
ဢႁုင်ႇ|ʼǎ hùng	<i>noun</i><br><ol><li>force, energy, vehemence</li></ol>
ဢႃးၶႃး|ʼáá kháá	<i>name</i><br><ol><li>Akha</li></ol>
ဢႃးၼႃႇ|လွင်ႈဢႃးၼႃႇ|ʼáá nàà	<i>verb</i><br><ol><li>to be deterred by feelings of respect or fear of offending</li></ol>
ဢႃႇပေႃႇ|ʼàà pàù	<i>noun</i><br><ol><li>water</li></ol>
ဢႃႇၵႃႇသႃႉ|ʼàà kàà sâ̰â̰	<i>noun</i><br><ol><li>space, expanse of heaven, sky.</li></ol>
ဢႃႇႁႃႇရႃႉ|ʼàà hàà râ̰â̰	<i>noun</i><br><ol><li>nourishment, food</li></ol>
ဢႅဝ်|ʼěǎǒ	<i>noun</i><br><ol><li>waist</li></ol>
ဢႅၵ်ႇ|ʼèk	<i>noun</i><br><ol><li>yoke</li></ol>
ဢႅၵ်ႉၶရႃႇ|ʼḛ̂k khǎ ràà	<i>noun</i><br><ol><li>letter.</li></ol>
ၢ	<i>character</i><br><ol><li>it's instead of ႃ when it has a. final consonant</li></ol>
ၵတိ|kǎ tǐ	<i>noun</i><br><ol><li>promise</li></ol>
ၵတိမၼ်ႈ|kǎ tǐ mān	<i>adj</i><br><ol><li>faithful</li></ol>
ၵတိသဵတ်ႉၸႃႇ|kǎ tǐ sâ̰ḛ̂t tsàà	<i>noun</i><br><ol><li>promise</li></ol>
ၵတ်း|kát	<i>adj</i><br><ol><li>cool, cold</li></ol>
ၵတ်းယဵၼ်|kát yǎěn	<i>adv</i><br><ol><li>calmly, peacefully</li></ol>
ၵတ်းလၢင်ႈ|kát lāāng|လွင်ႈၵတ်းလၢင်ႈ	<i>verb</i><br><ol><li>freezing cold, be very cold</li></ol>
ၵတ်းသၼ်ႇၵတ်းၼၢဝ်|kát sàn kát nǎǎǒ|လွင်ႈၵတ်းသၼ်ႇၵတ်းၼၢဝ်	<i>verb</i><br><ol><li>have chills</li></ol>
ၵတ်းၵႃႈ|kát kāā	<i>adv</i><br><ol><li>fortunately, luckily</li></ol>
ၵတ်းၶဵဝ်ႈၵတ်းၽၼ်း|လွင်ႈၵတ်းၶဵဝ်ႈၵတ်းၽၼ်း|kát khāēō kát phán	<i>verb</i><br><ol><li>grind, gnash</li></ol>
ၵတ်းၸႂ်ယဵၼ်ၸႂ်|လွင်ႈၵတ်းၸႂ်ယဵၼ်ၸႂ်|kát tsǎǔě yǎěn tsǎǔě	<i>verb</i><br><ol><li>be quiet, be happy, be cool</li></ol>
ၵတ်ႈတရႃႇသီႇ|kāt tǎ ràà sìì	<i>noun</i><br><ol><li>tar</li></ol>
ၵတ်ႈတီႇပႃႇ|kāt tìì pàà	<i>noun</i><br><ol><li>velvet</li></ol>
ၵတ်ႉၶႅၼ်ႇ|kâ̰t khèn|တၢင်းၵတ်ႉၶႅၼ်ႇ	<i>adj</i><br><ol><li>clever, skillful (usually implies both cleverness and skillfulness)</li><li>brilliant, outstanding</li></ol>
ၵတၢၵ်း|kǎ táák	<i>verb</i><br><ol><li>cackle</li></ol>
ၵပ်း|လွင်ႈၵပ်း|káp	<i>verb</i><br><ol><li>join, unite, stick thing together.</li></ol>
ၵပ်းမိတ်ႈ|káp mīt	<i>noun</i><br><ol><li>sheath of a knife</li></ol>
ၵပ်းသိုပ်ႇ|လွင်ႈၵပ်းသိုပ်ႇ|káp sùèp	<i>verb</i><br><ol><li>contact with, introduce</li></ol>
ၵပ်းၵၢႆႇ|káp kààì|လွင်ႈၵပ်းၵၢႆႇ	<i>verb</i><br><ol><li>relate</li></ol>
ၵပ်းၼိူင်း|လွင်ႈၵပ်းၼိူင်း|káp nóéng	<i>verb</i><br><ol><li>put together, compare</li></ol>
ၵပ်ႉ|kâ̰p	<i>adj</i><br><ol><li>tight</li></ol><br><i>adv</i><br><ol><li>tight</li></ol>
ၵပ်ႉၸႂ်|kâ̰p tsǎǔě|လွင်ႈၵပ်ႉၸႂ်	<i>verb</i><br><ol><li>be harassed, trouble in mind</li></ol>
ၵမ်တူဝ်ၵမ်ၸႂ်|လွင်ႈၵမ်တူဝ်ၵမ်ၸႂ်|kǎm tǒ kǎm tsǎǔě	<i>verb</i><br><ol><li>restrain</li></ol>
ၵမ်တၢင်းၵိၼ်|kǎm tááng kǐn|လွင်ႈၵမ်တၢင်းၵိၼ်	<i>verb</i><br><ol><li>refrain from food.</li></ol>
ၵမ်တႃမိုဝ်း|kǎm tǎǎ múé|လွင်ႈၵမ်တႃမိုဝ်း	<i>verb</i><br><ol><li>clinch the fist.</li></ol>
ၵမ်ဝႄႈ|လွင်ႈၵမ်ဝႄႈ|kǎm wāāē	<i>verb</i><br><ol><li>abstain</li></ol>
ၵမ်သိၼ်|လွင်ႈၵမ်သိၼ်|kǎm sǐn	<i>verb</i><br><ol><li>keep or observe a worship day, fast as a religions obligation</li><li>to observe religious precepts</li></ol>
ၵမ်း|လွင်ႈၵမ်း|kám	<i>noun</i><br><ol><li>time, instant, moment</li></ol><br><i>verb</i><br><ol><li>feel, touch</li></ol>
ၵမ်းတူၺ်း|kám tóí|လွင်ႈၵမ်းတူၺ်း	<i>verb</i><br><ol><li>examine the body or texture by feeling</li></ol>
ၵမ်းလင်|kám lǎng	<i>adv</i><br><ol><li>afterward</li></ol>
ၵမ်းလိုၼ်း|kám lúén	<i>adv</i><br><ol><li>afterwards</li></ol><br><i>noun</i><br><ol><li>last time, final time</li></ol>
ၵမ်းလိုၼ်းသုတ်း|kám lúén sút	<i>noun</i><br><ol><li>very, last time, final time</li></ol><br><i>adv</i><br><ol><li>finally</li></ol>
ၵမ်းလဵဝ်|kám lǎěǒ	<i>adv</i><br><ol><li>at once, immediately, instantly</li></ol><br><i>noun</i><br><ol><li>single instant</li></ol>
ၵမ်းသိုဝ်ႈ|kám sūē	<i>adv</i><br><ol><li>directly, firsthand</li></ol>
ၵမ်းဢွၼ်တၢင်း|kám ʼǎǔn tááng	<i>noun</i><br><ol><li>the first time</li></ol><br><i>adv</i><br><ol><li>at first, previously, formerly</li></ol>
ၵမ်းဢွၼ်ႇ|kám ʼàùn	<i>adv</i><br><ol><li>for a moment, in a moment</li></ol>
ၵမ်းၵမ်း|kám kám	<i>adv</i><br><ol><li>repeatedly, at intervals, frequently</li></ol>
ၵမ်းၶဝ်ႈ|kám khāō	<i>noun</i><br><ol><li>mouthful of rice</li></ol>
ၵမ်းၶဝ်ႈၵမ်းၽၵ်း|kám khāō kám phák	<i>noun</i><br><ol><li>mouthful of rice and curry</li></ol>
ၵမ်းၺၢပ်ႈၽႆး|kám nyāāp pháí	<i>noun</i><br><ol><li>fire tongs</li></ol>
ၵမ်းၼိုင်ႈ|kám nūēng	<i>noun</i><br><ol><li>a moment, an instant</li></ol><br><i>adv</i><br><ol><li>soon</li></ol>
ၵမ်းၼႃႈၵမ်းလိုၼ်း|kám nāā kám lúén	<i>adv</i><br><ol><li>afterwards</li></ol>
ၵမ်ၸိုမ်း|kǎm tsúém	<i>noun</i><br><ol><li>pen, fountain pen</li></ol>
ၵမ်ၼူတ်ႈ|လွင်ႈၵမ်ၼူတ်ႈ|kǎm nūūt	<i>verb</i><br><ol><li>knead, squeeze</li></ol>
ၵမ်ႇ|kàm	<i>adj</i><br><ol><li>purple</li></ol>
ၵမ်ႇမ	<i>noun</i><br><ol><li>deed</li></ol>
ၵမ်ႇမထၢၼ်း|kàm mǎ tháán	<i>noun</i><br><ol><li>meditation center, prayer</li></ol>
ၵမ်ႇမသၵႃႇ|kàm mǎ sǎ kàà	<i>noun</i><br><ol><li>one's own destiny</li></ol>
ၵမ်ႇၵႄႇ|kàm kààè	<i>adj</i><br><ol><li>dark purple</li></ol>
ၵမ်ႇၼုမ်ႇ|kàm nùm	<i>adj</i><br><ol><li>light purple</li></ol>
ၵမ်ႇၽႃႇ|kàm phàà	<i>noun</i><br><ol><li>world</li></ol>
ၵမ်ႇၽႃႇလုမ်ႈၾႃႉ|kàm phàà lūm fâ̰â̰	<i>noun</i><br><ol><li>the universe</li></ol>
ၵမ်ႇၽႃႇသုတ်း|kàm phàà sút	<i>noun</i><br><ol><li>end of the world</li></ol>
ၵမ်ႈဝႆးလႆႈ|kām wáí lāī	<i>adv</i><br><ol><li>as soon as possible</li></ol>
ၵမ်ႈဢဝ်ဝႃႈ|kām ʼǎǒ wāā	<i>prep</i><br><ol><li>according to, according as</li></ol>
ၵမ်ႈဢေႇ|kām ʼèè	<i>adv</i><br><ol><li>very few, not very much</li></ol>
ၵမ်ႈၸႂ်|kām tsǎǔě	<i>noun</i><br><ol><li>pleasure, wish, desire</li></ol>
ၵမ်ႈၼမ်|kām nǎm	<i>adv</i><br><ol><li>mostly, on the majority</li></ol>
ၵမ်ႈၽွင်ႈ|kām phāūng	<i>adj</i><br><ol><li>some, certain</li></ol>
ၵမ်ႉထွၵ်ႈ|kâ̰m thāūk|လွင်ႈၵမ်ႉထွၵ်ႈ	<i>verb</i><br><ol><li>help, assist, support, give aid</li></ol>
ၵမ်ႉထႅမ်|လွင်ႈၵမ်ႉထႅမ်|kâ̰m thěm	<i>verb</i><br><ol><li>help, assist, support, give aid</li></ol>
ၵမ်ႉယမ်|kâ̰m yǎm|လွင်ႈၵမ်ႉယမ်	<i>verb</i><br><ol><li>confirm, affirm</li></ol>
ၵမ်ႉလေႃႉ|kâ̰m lâ̰ṵ̂	<i>noun</i><br><ol><li>cart supporter</li></ol>
ၵမ်ႉၵေႃႇ|kâ̰m kàù	<i>noun</i><br><ol><li>Indian rose chestnut, Ceylon ironwood (Mesua ferrea), tree that yields sweet smelling flowers</li></ol>
ၵမ်ႉၸွႆႈ|လွင်ႈၵမ်ႉၸွႆႈ|kâ̰m tsāūī	<i>verb</i><br><ol><li>help, assist, support, give aid</li></ol>
ၵမ်ႉၽူႈၵမ်ႉၵၢၼ်|kâ̰m phūū kâ̰m kǎǎn	<i>noun</i><br><ol><li>Deputy secretary</li></ol>
ၵရမ်ႇ|kǎ ràm	<i>noun</i><br><ol><li>gram</li></ol>
ၵရဝေႇ|kǎ rǎ wèè	<i>noun</i><br><ol><li>wizard, sorcerer, witch, sorceress</li></ol>
ၵရိယႃႇ|kǎ rǐ yàà	<i>noun</i><br><ol><li>tool</li></ol>
ၵရုၼႃႇ|kǎ rǔ nàà	<i>noun</i><br><ol><li>pity</li></ol>
ၵလပ်ႉ|kǎ lâ̰p	<i>noun</i><br><ol><li>club</li></ol>
ၵလွင်ႇ|kǎ làùng	<i>noun</i><br><ol><li>pen, fountain pen</li></ol>
ၵလၢင်ႇ|kǎ lààng	<i>noun</i><br><ol><li>syphilis</li></ol>
ၵလၢတ်ႈ|kǎ lāāt	<i>verb</i><br><ol><li>slip, ပလၢတ်ႈ</li></ol>
ၵလႃး|kǎ láá	<i>name</i><br><ol><li>foreigner, usually of South Asian descent</li><li>Indian</li></ol>
ၵလႃးဢုၵ်ႉ|kǎ láá ʼṵ̂k	<i>noun</i><br><ol><li>camel</li></ol>
ၵလႃးဢူၵ်ႉ|kǎ láá ʼṵ̂ṵ̂k|တူဝ်	<i>noun</i><br><ol><li>camel</li></ol>
ၵဝိ|kǎ wǐ	<i>noun</i><br><ol><li>wise man</li></ol>
ၵဝ်|kǎǒ	<i>pron</i><br><ol><li>I, me, my.</li></ol>
ၵဝ်းမႄႈယိင်း|လွင်ႈၵဝ်းမႄႈယိင်း|káó māāē yíng	<i>verb</i><br><ol><li>persuade a woman, court</li></ol>
ၵဝ်းၵၼ်|လွင်ႈၵဝ်းၵၼ်|káó kǎn	<i>verb</i><br><ol><li>persuade, tempt, disrupt court as lover.</li></ol>
ၵဝ်ႇ|kàò	<i>adj</i><br><ol><li>old, not new, used.</li></ol>
ၵဝ်ႇမွင်|kàò mǎǔng	<i>adj</i><br><ol><li>old, dull, faded.</li></ol>
ၵဝ်ႈ|kāō	<i>num</i><br><ol><li>nine</li></ol>
ၵဝ်ႈပၢၵ်ႇ|kāō pààk	<i>num</i><br><ol><li>nine hundred</li></ol>
ၵဝ်ႈမိုၼ်ႇၵဝ်ႈႁဵင်|kāō mùèn kāō hǎěng	<i>num</i><br><ol><li>ninety nine thousand.</li></ol>
ၵဝ်ႈသိပ်း|kāō síp	<i>num</i><br><ol><li>ninety</li></ol>
ၵဝ်ႈသိပ်းၵဝ်ႈ|kāō síp kāō	<i>num</i><br><ol><li>ninety nine</li></ol>
ၵဝ်ႈၶူၼ်ႁူဝ်|kāō khǔǔn hǒ|လွင်ႈၵဝ်ႈၶူၼ်ႁူဝ်	<i>verb</i><br><ol><li>tie a knot in the hair.</li></ol>
ၵဝ်ႉ|kâ̰ô̰	<i>noun</i><br><ol><li>owl</li></ol>
ၵဝ်ႉငဝ်ႈ|kâ̰ô̰ ngāō	<i>noun</i><br><ol><li>bottom, foundation, beginning, base</li></ol>
ၵသေး|kǎ séé	<i>name</i><br><ol><li>Khasi</li></ol>
ၵိင်း|kíng|လွင်ႈၵိင်း	<i>verb</i><br><ol><li>(Buddhism) to sleep (of a monk)</li></ol><br><i>noun</i><br><ol><li>period of time: a turn</li><li>arithmetical number used in astrological calculation</li></ol>
ၵိင်ႇ|kìng	<i>noun</i><br><ol><li>branch</li></ol>
ၵိင်ႇမႆႉ|kìng mâ̰ḭ̂	<i>noun</i><br><ol><li>branch of a tree</li></ol>
ၵိင်ႇလူင်|kìng lǔǔng	<i>noun</i><br><ol><li>main branch of a tree</li></ol>
ၵိင်ႇၵွႆႈ|kìng kāūī	<i>noun</i><br><ol><li>little finger</li></ol>
ၵိင်ႇႁႄႉ|kìng hâ̰â̰ḛ̂	<i>noun</i><br><ol><li>armpit</li></ol>
ၵိင်ႈ|kīng|လွင်ႈၵိင်ႈ	<i>verb</i><br><ol><li>roll</li></ol>
ၵိင်ႈတူၵ်း|kīng túúk|လွင်ႈၵိင်ႈတူၵ်း	<i>verb</i><br><ol><li>roll over and fall</li></ol>
ၵိင်ႈၵိူၵ်ႇ|kīng kòèk|လွင်ႈၵိင်ႈၵိူၵ်ႇ	<i>verb</i><br><ol><li>roll from side to side</li></ol>
ၵိတ်ႇ|kìt	<i>adj</i><br><ol><li>crowded</li></ol>
ၵိတ်ႇၵႅပ်ႈ|လွင်ႈၵိတ်ႇၵႅပ်ႈ|kìt kēp	<i>verb</i><br><ol><li>narrow, be close</li></ol>
ၵိတ်ႇၸႂ်|kìt tsǎǔě	<i>adj</i><br><ol><li>distressed</li></ol>
ၵိပ်ႇ|kìp	<i>noun</i><br><ol><li>hoof</li></ol>
ၵိပ်ႈ|kīp|လွင်ႈၵိပ်ႈ	<i>verb</i><br><ol><li>pinch, squeeze; perch(as a bird).</li></ol>
ၵိပ်ႈၽၵ်း|လွင်ႈၵိပ်ႈၽၵ်း|kīp phák	<i>verb</i><br><ol><li>pinch the food.</li></ol>
ၵိမ်း|လွင်ႈၵိမ်း|kím	<i>noun</i><br><ol><li>scissors; pincers, any instrument which picks up things by pressing its two parts together</li><li>vessel for heating water</li></ol><br><i>verb</i><br><ol><li>to be curved equally inward and toward one another (as the horns of an ox)</li></ol>
ၵိမ်းၺၢပ်ႈလဵၵ်း|kím nyāāp láék	<i>noun</i><br><ol><li>blacksmith's tongs</li></ol>
ၵိမ်းႁႆး|kím háí	<i>noun</i><br><ol><li>scissors</li></ol>
ၵိရိယႃႇ|kǐ rǐ yàà	<i>noun</i><br><ol><li>materials, utensils, tools, implement</li></ol>
ၵိလေႇသႃႇ|kǐ lèè sàà	<i>noun</i><br><ol><li>passion, desire of the sexes, lust, vice</li></ol>
ၵိဝ်|kǐǒ	<i>noun</i><br><ol><li>strand</li></ol>
ၵိဝ်ႇ|kìò	<i>noun</i><br><ol><li>passageway, open path between houses</li></ol>
ၵိဝ်ႇတၢင်း|kìò tááng	<i>noun</i><br><ol><li>way, passageway</li></ol>
ၵိဝ်ႇလွႆ|kìò lǎǔǐ	<i>noun</i><br><ol><li>defile in the mountain</li></ol>
ၵိဝ်ႇဝဵင်း|kìò wáéng	<i>noun</i><br><ol><li>street in a city</li></ol>
ၵိုင်ႇ|kùèng|လွင်ႈၵိုင်ႇ	<i>verb</i><br><ol><li>be suitable, fit, proper, suit</li></ol>
ၵိုင်ႇတၢၼ်ႇ|kùèng tààn	<i>adj</i><br><ol><li>suitable</li></ol>
ၵိုင်ႇဢၢပ်ႈ|လွင်ႈၵိုင်ႇဢၢပ်ႈ|kùèng ʼāāp	<i>verb</i><br><ol><li>fit, match well</li></ol>
ၵိုင်ႇၵႃႈ|kùèng kāā	<i>adj</i><br><ol><li>worth</li></ol>
ၵိုင်ႉၵၢင်ႉ|လွင်ႈၵိုင်ႉၵၢင်ႉ|kṵ̂ḛ̂ng kâ̰â̰ng	<i>verb</i><br><ol><li>do suddenly, expectedly</li></ol>
ၵိုတ်း|kúét|လွင်ႈၵိုတ်း	<i>verb</i><br><ol><li>cease, stop, remain, wait, be left</li></ol>
ၵိုတ်းတၢင်းလင်|လွင်ႈၵိုတ်းတၢင်းလင်|kúét tááng lǎng	<i>verb</i><br><ol><li>stop behind, stay behind</li></ol>
ၵိုတ်းမိူၼ်ႇ|လွင်ႈၵိုတ်းမိူၼ်ႇ|kúét mòèn	<i>verb</i><br><ol><li>fear or sorrow</li></ol>
ၵိုတ်းသဝ်း|လွင်ႈၵိုတ်းသဝ်း|kúét sáó	<i>verb</i><br><ol><li>stop, stop and stay</li></ol>
ၵိုတ်ႉလႆႈ|kṵ̂ḛ̂t lāī|လွင်ႈၵိုတ်ႉလႆႈ	<i>verb</i><br><ol><li>remember</li></ol>
ၵိုတ်ႉၽိူဝ်ႇပိူၼ်ႈ|လွင်ႈၵိုတ်ႉၽိူဝ်ႇပိူၼ်ႈ|kṵ̂ḛ̂t phòè pōēn	<i>verb</i><br><ol><li>consider</li></ol>
ၵိုမ်း|kúém	<i>adj</i><br><ol><li>firm, immovable.</li></ol>
ၵိုမ်ႉၸႂ်|kṵ̂ḛ̂m tsǎǔě	<i>adj</i><br><ol><li>dim. ဢမ်ႇၸႅင်ႈလႅင်းၸႂ်။</li></ol>
ၵိုဝ်|kǔě	<i>noun</i><br><ol><li>bridle for tethering an animal</li></ol>
ၵိုဝ်တႃ|kǔě tǎǎ|လွင်ႈၵိုဝ်တႃ	<i>verb</i><br><ol><li>stare</li></ol>
ၵိုဝ်မႃႉ|kǔě mâ̰â̰	<i>noun</i><br><ol><li>bridle</li></ol>
ၵိုၵ်း|လွင်ႈၵိုၵ်း|kúék	<i>verb</i><br><ol><li>match</li></ol>
ၵိုၵ်းပႃး|kúék páá	<i>noun</i><br><ol><li>be beside, along side of, associate, match</li></ol><br><i>prep</i><br><ol><li>with</li></ol>
ၵိုၵ်းဝၢၼ်ႈၵိုၵ်းမိူင်း|kúék wāān kúék móéng	<i>adj</i><br><ol><li>heritage</li></ol>
ၵိုၼ်း|kúén	<i>adj</i><br><ol><li>many, abundant, thriving, crowded</li></ol>
ၵိူင်း|kóéng	<i>noun</i><br><ol><li>(Buddhism) sect; assemblage</li></ol>
ၵိူင်းထွၵ်ႈ|kóéng thāūk	<i>noun</i><br><ol><li>(Buddhism) assistant to a bishop</li></ol>
ၵိူင်းဢုပ်ႉ|kóéng ʼṵ̂p	<i>noun</i><br><ol><li>(Buddhism) Buddhist bishop</li></ol>
ၵိူင်းၵႂႃႇၵိူင်းၶိုၼ်း|kóéng kwàà kóéng khúén|လွင်ႈၵိူင်းၵႂႃႇၵိူင်းၶိုၼ်း	<i>verb</i><br><ol><li>reel, lean to one side and then to the other</li></ol>
ၵိူင်းၶျုၵ်ႈ|kóéng khjūk	<i>noun</i><br><ol><li>(Buddhism) head of monastic association belonging to a religious sect</li></ol>
ၵိူတ်ႇ|kòèt|လွင်ႈၵိူတ်ႇ	<i>verb</i><br><ol><li>be born, give birthd to, bring forth</li></ol>
ၵိူတ်ႇၽႃၽႄ|လွင်ႈၵိူတ်ႇၽႃၽႄ|kòèt phǎǎ phǎǎě	<i>verb</i><br><ol><li>be twins</li></ol>
ၵိူပ်ႇတိၼ်|kòèp tǐn	<i>noun</i><br><ol><li>sandal</li></ol>
ၵိူပ်ႇတေႃႇၵိူပ်ႇတႅၼ်|kòèp tàù kòèp těn|လွင်ႈၵိူပ်ႇတေႃႇၵိူပ်ႇတႅၼ်	<i>verb</i><br><ol><li>be numerous in populations.</li></ol>
ၵိူမ်ႈ|kōēm	<i>noun</i><br><ol><li>flesh။ ၵိူမ်ႈၼိူဝ်ႉ-မၢၵ်ႇမႆႉ-ၼိူဝ်ႉ။</li></ol><br><i>verb</i><br><ol><li>have a smooth, flattering manner.</li></ol>
ၵိူဝ်|kǒě	<i>noun</i><br><ol><li>salt.</li></ol>
ၵိူဝ်ဝၢၼ်|kǒě wǎǎn	<i>noun</i><br><ol><li>sugar.</li></ol>
ၵိူဝ်သိင်း|kǒě síng	<i>noun</i><br><ol><li>very fine salt, slightly bitter</li></ol>
ၵိူဝ်သိင်းထေႃး|kǒě síng tháú	<i>noun</i><br><ol><li>rock salt</li></ol>
ၵိူဝ်သၢႆး|kǒě sááí	<i>noun</i><br><ol><li>salt in large crystal</li></ol>
ၵိူဝ်ဢုတ်ႇ|kǒě ʼùt	<i>noun</i><br><ol><li>salt in brick form</li></ol>
ၵိူဝ်း|လွင်ႈၵိူဝ်း|kóé	<i>verb</i><br><ol><li>look, hope, expect.</li></ol>
ၵိူဝ်းယမ်|kóé yǎm|လွင်ႈၵိူဝ်းယမ်	<i>verb</i><br><ol><li>worship</li></ol>
ၵိူဝ်းလီတူဝ်|kóé lǐǐ tǒ|လွင်ႈၵိူဝ်းလီတူဝ်	<i>verb</i><br><ol><li>self-benefit, look for advantage.</li></ol>
ၵိူဝ်းလႆႈၵိၼ်|kóé lāī kǐn|လွင်ႈၵိူဝ်းလႆႈၵိၼ်	<i>verb</i><br><ol><li>trust in, rely on for one's own profit.</li></ol>
ၵိူဝ်းၽီ|လွင်ႈၵိူဝ်းၽီ|kóé phǐǐ	<i>verb</i><br><ol><li>offer to a spirit.</li></ol>
ၵိူဝ်ၸဵမ်း|kǒě tsáém	<i>noun</i><br><ol><li>common salt</li></ol>
ၵိူဝ်ႉတူၺ်း|kô̰ḛ̂ tóí|လွင်ႈၵိူဝ်ႉတူၺ်း	<i>verb</i><br><ol><li>stare at foolishly.</li></ol>
ၵိူၺ်း|kóéí	<i>adj</i><br><ol><li>friendly</li></ol>
ၵိူၼ်ႇ|kòèn|လွင်ႈၵိူၼ်ႇ	<i>noun</i><br><ol><li>gate, fence</li></ol><br><i>verb</i><br><ol><li>break down, fall to pieces</li></ol>
ၵိၵ်ႈ|kīk	<i>adj</i><br><ol><li>odd</li></ol>
ၵိၼ်|kǐn	<i>verb</i><br><ol><li>To eat</li><li>To drink</li></ol>
ၵိၼ်ငိုၼ်းမွၼ်|kǐn ngúén mǎǔn|လွင်ႈၵိၼ်ငိုၼ်းမွၼ်	<i>verb</i><br><ol><li>take bribe</li></ol>
ၵိၼ်တူၼ်ႉ|kǐn tṵ̂ṵ̂n|လွင်ႈၵိၼ်တူၼ်ႉ	<i>verb</i><br><ol><li>be surfeited, over satiated, sick from overeating</li></ol>
ၵိၼ်ထၢတ်ႈ|လွင်ႈၵိၼ်ထၢတ်ႈ|kǐn thāāt	<i>verb</i><br><ol><li>diet</li></ol>
ၵိၼ်ပိုၼ်ႉၵိၼ်ပႅတ်ႈ|လွင်ႈၵိၼ်ပိုၼ်ႉၵိၼ်ပႅတ်ႈ|kǐn pṵ̂ḛ̂n kǐn pēt	<i>verb</i><br><ol><li>waste food through carelessness</li></ol>
ၵိၼ်ပူၼ်ႉ|kǐn pṵ̂ṵ̂n|လွင်ႈၵိၼ်ပူၼ်ႉ	<i>verb</i><br><ol><li>be surfeited, over satiated, sick from overeating</li></ol>
ၵိၼ်ပူၼ်ႉၵိၼ်လိူဝ်|လွင်ႈၵိၼ်ပူၼ်ႉၵိၼ်လိူဝ်|kǐn pṵ̂ṵ̂n kǐn lǒě	<i>verb</i><br><ol><li>eat more than sufficient</li></ol>
ၵိၼ်ပႅတ်ႈ|လွင်ႈၵိၼ်ပႅတ်ႈ|kǐn pēt	<i>verb</i><br><ol><li>consume entirely, eat up</li></ol>
ၵိၼ်ယိူဝ်ႈ|kǐn yōē|လွင်ႈၵိၼ်ယိူဝ်ႈ	<i>verb</i><br><ol><li>graze</li></ol>
ၵိၼ်ယႂ်ႇၵိၼ်လူင်|kǐn yàùè kǐn lǔǔng|လွင်ႈၵိၼ်ယႂ်ႇၵိၼ်လူင်	<i>verb</i><br><ol><li>eat voraciously, be a big eater</li></ol><br><i>adj</i><br><ol><li>voracious</li></ol>
ၵိၼ်ယႃ|kǐn yǎǎ|လွင်ႈၵိၼ်ယႃ	<i>verb</i><br><ol><li>take medicine</li></ol>
ၵိၼ်ယႃႈယႃ|လွင်ႈၵိၼ်ယႃႈယႃ|kǐn yāā yǎǎ	<i>verb</i><br><ol><li>take medicine</li></ol>
ၵိၼ်လဝ်ႈ|kǐn lāō|လွင်ႈၵိၼ်လဝ်ႈ	<i>verb</i><br><ol><li>drink intoxicating liquor</li></ol>
ၵိၼ်လိပ်း|kǐn líp|လွင်ႈၵိၼ်လိပ်း	<i>verb</i><br><ol><li>eat raw, eat without cooking</li></ol>
ၵိၼ်လူင်ၸၢႆႇလူင်|kǐn lǔǔng tsààì lǔǔng|လွင်ႈၵိၼ်လူင်ၸၢႆႇလူင်	<i>verb</i><br><ol><li>profuse in buying, be a big spender</li></ol>
ၵိၼ်ဝူၺ်ႇ|kǐn wòì|လွင်ႈၵိၼ်ဝူၺ်ႇ	<i>verb</i><br><ol><li>eat messily, eat carelessly</li></ol>
ၵိၼ်ဝၢၼ်|kǐn wǎǎn|လွင်ႈၵိၼ်ဝၢၼ်	<i>verb</i><br><ol><li>relish, eat with good appetite</li></ol>
ၵိၼ်ဢိမ်ႇ|kǐn ʼìm|လွင်ႈၵိၼ်ဢိမ်ႇ	<i>verb</i><br><ol><li>have satisfied the appetite</li><li>have eaten sufficiently</li></ol>
ၵိၼ်ဢိမ်ႇၵိၼ်ဝၢၼ်|လွင်ႈၵိၼ်ဢိမ်ႇၵိၼ်ဝၢၼ်|kǐn ʼìm kǐn wǎǎn	<i>verb</i><br><ol><li>have eaten a tasty meal, have eaten a hearty meal</li></ol>
ၵိၼ်း|kín	<i>adj</i><br><ol><li>constricted , poor, desperate, helpless</li></ol>
ၵိၼ်းၸႂ်|kín tsǎǔě	<i>adj</i><br><ol><li>constricted , poor, desperate, helpless</li></ol>
ၵိၼ်ၵၼ်|kǐn kǎn	<i>adj</i><br><ol><li>crowded</li></ol>
ၵိၼ်ၵၼ်ၵိုင်ႇၵၼ်|kǐn kǎn kùèng kǎn	<i>adj</i><br><ol><li>fitted, fit</li></ol>
ၵိၼ်ၵႃႈ|kǐn kāā|လွင်ႈၵိၼ်ၵႃႈ	<i>verb</i><br><ol><li>live on wages</li></ol>
ၵိၼ်ၵႄႈ|လွင်ႈၵိၼ်ၵႄႈ|kǐn kāāē	<i>verb</i><br><ol><li>gain profit, as a broker</li></ol>
ၵိၼ်ၵႅၼ်း|လွင်ႈၵိၼ်ၵႅၼ်း|kǐn kén	<i>verb</i><br><ol><li>eat poor</li></ol>
ၵိၼ်ၵႅၼ်ႇၵၼ်|kǐn kèn kǎn|လွင်ႈၵိၼ်ၵႅၼ်ႇၵၼ်	<i>verb</i><br><ol><li>promise, contract</li></ol>
ၵိၼ်ၶဝ်ႈၵိၼ်ၼမ်ႉ|လွင်ႈၵိၼ်ၶဝ်ႈၵိၼ်ၼမ်ႉ|kǐn khāō kǐn nâ̰m	<i>verb</i><br><ol><li>eat rice and curry</li><li>eat food</li></ol>
ၵိၼ်ၶီႈငိုၼ်း|လွင်ႈၵိၼ်ၶီႈငိုၼ်း|kǐn khīī ngúén	<i>verb</i><br><ol><li>live on interest</li></ol>
ၵိၼ်ၶႅၵ်ႇ|လွင်ႈၵိၼ်ၶႅၵ်ႇ|kǐn khèk	<i>verb</i><br><ol><li>celebrate a marriage</li></ol>
ၵိၼ်ၸိၵ်း|လွင်ႈၵိၼ်ၸိၵ်း|kǐn tsík	<i>verb</i><br><ol><li>eat the top part</li><li>skim the profit</li></ol>
ၵိၼ်ၸၢင်|လွင်ႈၵိၼ်ၸၢင်|kǐn tsǎǎng	<i>verb</i><br><ol><li>taste insipid, eat insipid food</li></ol>
ၵိၼ်ၸၢင်ႈ|kǐn tsāāng|လွင်ႈၵိၼ်ၸၢင်ႈ	<i>verb</i><br><ol><li>work for wages</li></ol>
ၵိၼ်ၸၢႆ|kǐn tsǎǎǐ	<i>noun</i><br><ol><li>vegetarian</li></ol>
ၵိၼ်ၼမ်ႉၼူမ်း|kǐn nâ̰m núúm|လွင်ႈၵိၼ်ၼမ်ႉၼူမ်း	<i>verb</i><br><ol><li>drink milk</li></ol>
ၵိၼ်ၽိတ်း|kǐn phít|လွင်ႈၵိၼ်ၽိတ်း	<i>verb</i><br><ol><li>get an allergy, get an allergic reaction</li></ol>
ၵိၼ်ႁႅင်း|လွင်ႈၵိၼ်ႁႅင်း|kǐn héng	<i>verb</i><br><ol><li>make use of one's strength</li><li>get profit out of labor</li></ol>
ၵိၼ်ႇ|လွင်ႈၵိၼ်ႇ|kìn	<i>verb</i><br><ol><li>take an oath, swear, curse, invoke evil</li></ol>
ၵိၼ်ႇလႃႇ|လွင်ႈၵိၼ်ႇလႃႇ|kìn làà	<i>verb</i><br><ol><li>curse in anger, invoke evil an another, revile</li></ol>
ၵီႇ|kìì	<i>noun</i><br><ol><li>loom</li></ol>
ၵီႇယႃႇ|kìì yàà	<i>noun</i><br><ol><li>gear</li></ol>
ၵီႇလူဝ်ႇ|kìì lò	<i>noun</i><br><ol><li>kilo</li></ol>
ၵီႇလူဝ်ႇမီႇတႃႇ|kìì lò mìì tàà	<i>noun</i><br><ol><li>kilometer</li></ol>
ၵီႇလူဝ်ႇၵရမ်ႇ|kìì lò kǎ ràm	<i>noun</i><br><ol><li>kilogram</li></ol>
ၵီႈ|kīī	<i>verb</i><br><ol><li>open, expand, unloose, unroll, blossom, smell</li></ol>
ၵီႈပွႆႇ|kīī pàùì	<i>verb</i><br><ol><li>free, set at liberty</li></ol>
ၵီႈမွၵ်ႇၵီႈၼႄ|kīī màùk kīī nǎǎě	<i>verb</i><br><ol><li>explain</li></ol>
ၵီႈသူၺ်းသူၺ်း|kīī sóí sóí	<i>noun</i><br><ol><li>blossom</li></ol>
ၵုင်း|kúng	<i>noun</i><br><ol><li>mound, hillrock, dry land</li></ol>
ၵုင်းလွႆ|kúng lǎǔǐ	<i>noun</i><br><ol><li>hill</li></ol>
ၵုင်ႇ|kùng	<i>noun</i><br><ol><li>Aquarius, the eleventh sign of the Zodiac</li><li>good or bad quality, an attribute; honor, prestige</li></ol>
ၵုင်ႇတၢင်ႇ|လွင်ႈၵုင်ႇတၢင်ႇ|kùng tààng	<i>verb</i><br><ol><li>express, thanks</li></ol>
ၵုင်ႇသရေႇ|kùng sǎ rèè	<i>noun</i><br><ol><li>dignity</li></ol>
ၵုင်ႇၵုၼ်း|kùng kún	<i>noun</i><br><ol><li>dignity</li></ol>
ၵုင်ႇၶိုၼ်ႈ|လွင်ႈၵုင်ႇၶိုၼ်ႈ|kùng khūēn	<i>verb</i><br><ol><li>advance in honor and reputation</li></ol>
ၵုင်ႈ|kūng	<i>noun</i><br><ol><li>shrimp.</li></ol>
ၵုင်ႈသူမ်ႈ|kūng sūūm	<i>noun</i><br><ol><li>pickled shrimp</li></ol>
ၵုင်ႈႁႅင်ႈ|kūng hēng	<i>noun</i><br><ol><li>dried shrimp</li></ol>
ၵုတ်ႇ|kùt	<i>noun</i><br><ol><li>moss, fern</li></ol>
ၵုပ်း|kúp|လွင်ႈၵုပ်း	<i>noun</i><br><ol><li>woven bamboo.</li></ol><br><i>verb</i><br><ol><li>patch, mend a hole, darn.</li></ol>
ၵုပ်းၽုင်|kúp phǔng|လွင်ႈၵုပ်းၽုင်	<i>verb</i><br><ol><li>woven</li></ol>
ၵုမ်|လွင်ႈၵုမ်|kǔm	<i>verb</i><br><ol><li>gather together and tale, assemble and consult.</li></ol>
ၵုမ်း|kúm|လွင်ႈၵုမ်း	<i>verb</i><br><ol><li>repair.</li></ol>
ၵုမ်ႇ|kùm	<i>noun</i><br><ol><li>the hip.</li></ol><br><i>adj</i><br><ol><li>enough, ample, sufficient, adequate.</li></ol>
ၵုမ်ႇတင်းသဵင်ႈ|kùm táng sāēng	<i>verb</i><br><ol><li>have a sufficiency, be plenty, abundance.</li></ol>
ၵုမ်ႇလုမ်ႇ|kùm lùm	<i>adj</i><br><ol><li>ample, amply sufficient</li></ol>
ၵုမ်ႇၵူၼ်ႈ|kùm kūūn	<i>noun</i><br><ol><li>the posteriors,buttocks.</li></ol>
ၵုမ်ႇၶဵတ်ႇ|kùm khàèt	<i>noun</i><br><ol><li>pelvis.</li></ol>
ၵုမ်ႈ|kūm	<i>adj</i><br><ol><li>overcast, cloudy.</li></ol>
ၵုမ်ႈၾူၼ်|kūm fǔǔn	<i>noun</i><br><ol><li>rain clouds.</li></ol>
ၵုသူဝ်ႇ|kǔ sò	<i>noun</i><br><ol><li>merit, good deed</li></ol>
ၵုၵ်ႈ|kūk	<i>pron</i><br><ol><li>mane</li></ol>
ၵုၵ်ႈမႃႉ|kūk mâ̰â̰	<i>pron</i><br><ol><li>pony's mane</li></ol>
ၵုၵ်ႉတေႇ|kṵ̂k tèè	<i>noun</i><br><ol><li>ten millions</li></ol>
ၵုၵ်ႉၵီႈၵုၵ်ႉၵၵ်ႉ|kṵ̂k kīī kṵ̂k kâ̰k	<i>adv</i><br><ol><li>with grate exertion to overcome a difficulty</li></ol>
ၵုၺ်|kǔǐ	<i>noun</i><br><ol><li>cotton plant, unprocessed cotton</li></ol>
ၵုၺ်သႆ|kǔǐ sǎǐ	<i>noun</i><br><ol><li>jute</li></ol>
ၵုၺ်ၶွၼ်ႇ|kǔǐ khàùn	<i>noun</i><br><ol><li>cotton of a brownish color</li></ol>
ၵုၺ်ႉ|လွင်ႈၵုၺ်ႉ|kṵ̂ḭ̂	<i>verb</i><br><ol><li>pry, lift up with a lever</li></ol>
ၵုၺ်ႉၽုၺ်ႇ|kṵ̂ḭ̂ phùì|လွင်ႈၵုၺ်ႉၽုၺ်ႇ	<i>verb</i><br><ol><li>pry, lift up with a lever</li></ol>
ၵုၼ်|kǔn	<i>noun</i><br><ol><li>island, shoal, sand bank, continent</li></ol>
ၵုၼ်ယွၼ်ႇ|kǔn yàùn	<i>noun</i><br><ol><li>peninsula</li></ol>
ၵုၼ်သၢႆး|kǔn sááí	<i>noun</i><br><ol><li>desert</li></ol>
ၵုၼ်ဢေးသျႃး|kǔn ʼéé sjáá	<i>noun</i><br><ol><li>continent of Asia</li></ol>
ၵုၼ်း|kún|လွင်ႈၵုၼ်း	<i>verb</i><br><ol><li>(arithmetic) to multiply</li></ol>
ၵုၼ်ၽင်ႇၼမ်ႉ|kǔn phàng nâ̰m	<i>noun</i><br><ol><li>bank</li></ol>
ၵုၼ်ႁၢတ်ႇသၢႆး|kǔn hààt sááí	<i>noun</i><br><ol><li>desert</li></ol>
ၵုၼ်ႇ|kùn	<i>noun</i><br><ol><li>merchandise, goods for sale</li></ol>
ၵုၼ်ႇသိၼ်|kùn sǐn	<i>noun</i><br><ol><li>merchandise, goods</li></ol>
ၵူင်|kǔǔng	<i>noun</i><br><ol><li>a bow with one string</li></ol>
ၵူင်တွင်ႉ|kǔǔng tâ̰ṵ̂ng	<i>noun</i><br><ol><li>cavity of the belly</li></ol>
ၵူင်မႆႉ|kǔǔng mâ̰ḭ̂	<i>noun</i><br><ol><li>hollow of a tree or of a bamboo</li></ol>
ၵူင်လွႆ|kǔǔng lǎǔǐ	<i>noun</i><br><ol><li>cave</li></ol>
ၵူင်သူပ်း|kǔǔng súúp	<i>noun</i><br><ol><li>palate, cavity of the mouth</li></ol>
ၵူင်း|kúúng	<i>noun</i><br><ol><li>vein or seam</li></ol>
ၵူင်းငိုၼ်း|kúúng ngúén	<i>noun</i><br><ol><li>vein of silver</li></ol>
ၵူင်းၵႂၵ်း|kúúng kwák	<i>noun</i><br><ol><li>spool, instrument to wind thread on</li></ol>
ၵူင်းၼမ်ႉ|kúúng nâ̰m	<i>noun</i><br><ol><li>water wheel, spinning wheel, water mill</li></ol>
ၵူင်းႁူတ်း|kúúng húút	<i>noun</i><br><ol><li>water sprinkler</li></ol>
ၵူင်ၵူင်|kǔǔng kǔǔng	<i>adj</i><br><ol><li>hollow</li></ol><br><i>noun</i><br><ol><li>cavity</li></ol>
ၵူင်ၵွၼ်|kǔǔng kǎǔn	<i>noun</i><br><ol><li>sling-shot</li></ol>
ၵူင်ၵႂၼ်းၾႆး|kǔǔng kwán fáí	<i>noun</i><br><ol><li>chimney</li></ol>
ၵူင်ၶေႃး|kǔǔng kháú	<i>noun</i><br><ol><li>gullet or windpipe</li></ol>
ၵူင်ႁူၺ်ႈ|kǔǔng hōī	<i>noun</i><br><ol><li>valley</li></ol>
ၵူင်ႇ|kùùng|လွင်ႈၵူင်ႇ	<i>verb</i><br><ol><li>bends around, be crooked, warp</li></ol>
ၵူင်ႇၵၢဝ်|kùùng kǎǎǒ	<i>noun</i><br><ol><li>spider</li></ol>
ၵူင်ႇၵၢဝ်မီ|kùùng kǎǎǒ mǐǐ	<i>noun</i><br><ol><li>bear spider</li></ol>
ၵူင်ႇၵၢဝ်ၵၢင်ယႂ်း|kùùng kǎǎǒ kǎǎng yáúé|လွင်ႈၵူင်ႇၵၢဝ်ၵၢင်ယႂ်း	<i>verb</i><br><ol><li>spin a spider's web</li></ol>
ၵူင်ႉ|kṵ̂ṵ̂ng	<i>adj</i><br><ol><li>circuitous</li></ol>
ၵူတ်ႉ|kṵ̂ṵ̂t	<i>noun</i><br><ol><li>curve, bend, gulf, bay</li></ol>
ၵူတ်ႉမေးပိူၼ်ႈ|kṵ̂ṵ̂t méé pōēn|လွင်ႈၵူတ်ႉမေးပိူၼ်ႈ	<i>verb</i><br><ol><li>commit adultery</li></ol>
ၵူတ်ႉမႄႈယိင်း|လွင်ႈၵူတ်ႉမႄႈယိင်း|kṵ̂ṵ̂t māāē yíng	<i>verb</i><br><ol><li>have illicit sexual intercourse with woman</li></ol>
ၵူတ်ႉလႅၼ်|kṵ̂ṵ̂t lěn|လွင်ႈၵူတ်ႉလႅၼ်	<i>verb</i><br><ol><li>deceive, cheat</li></ol>
ၵူပ်း|kúúp	<i>noun</i><br><ol><li>frog</li></ol>
ၵူပ်းၵိၼ်လိူၼ်|kúúp kǐn lǒěn	<i>noun</i><br><ol><li>lunar eclipse.</li></ol>
ၵူပ်းၵိၼ်ဝၼ်း|kúúp kǐn wán	<i>noun</i><br><ol><li>solar eclipse.</li></ol>
ၵူပ်ႉၵူႈ|kṵ̂ṵ̂p kūū|လွင်ႈၵူပ်ႉၵူႈ	<i>verb</i><br><ol><li>be married, become a pair.</li></ol>
ၵူမ်|kǔǔm	<i>adj</i><br><ol><li>round, cylindrical.</li></ol><br><i>verb</i><br><ol><li>cover, cover up.</li></ol>
ၵူမ်း|kúúm	<i>noun</i><br><ol><li>two viss.</li></ol>
ၵူမ်ႇ|kùùm	<i>noun</i><br><ol><li>mud.</li></ol><br><i>adj</i><br><ol><li>muddy.</li></ol>
ၵူမ်ႇၼဝ်ႈ|kùùm nāō	<i>noun</i><br><ol><li>filth, rotten mud.</li></ol>
ၵူမ်ႈ|kūūm|လွင်ႈၵူမ်ႈ	<i>verb</i><br><ol><li>stoop, bow.</li></ol>
ၵူမ်ႈၵွမ်း|kūūm káúm|လွင်ႈၵူမ်ႈၵွမ်း	<i>verb</i><br><ol><li>stoop, bow.</li></ol>
ၵူမ်ႈၶဝ်ႈ|kūūm khāō|လွင်ႈၵူမ်ႈၶဝ်ႈ	<i>verb</i><br><ol><li>stoop and enter.</li></ol>
ၵူမ်ႈႁူဝ်|kūūm hǒ|လွင်ႈၵူမ်ႈႁူဝ်	<i>verb</i><br><ol><li>bow.</li></ol>
ၵူဝ်|kǒ	<i>adj</i><br><ol><li>afraid</li></ol>
ၵူဝ်ယမ်|kǒ yǎm|လွင်ႈၵူဝ်ယမ်	<i>verb</i><br><ol><li>respect, reverence</li></ol>
ၵူဝ်း|kó|လွင်ႈၵူဝ်း	<i>verb</i><br><ol><li>to depend on</li></ol>
ၵူဝ်ႁႄ|လွင်ႈၵူဝ်ႁႄ|kǒ hǎǎě	<i>verb</i><br><ol><li>fear</li></ol>
ၵူဝ်ႇၵဵၼ်း|kò káén	<i>noun</i><br><ol><li>cocaine</li></ol>
ၵူဝ်ႈ|kō|လွင်ႈၵူဝ်ႈ	<i>verb</i><br><ol><li>mix, stir</li></ol><br><i>adj</i><br><ol><li>dirty</li></ol>
ၵူဝ်ႈပဵၼ်ၵႂၢၵ်ႈ|kō pǎěn kwāāk	<i>adj</i><br><ol><li>spotted</li></ol><br><i>noun</i><br><ol><li>spot</li></ol>
ၵူး|kúú|လွင်ႈၵူး	<i>verb</i><br><ol><li>copy, transcribe</li></ol>
ၵူးလိၵ်ႈ|kúú līk	<i>verb</i><br><ol><li>copy, transcribe</li></ol>
ၵူးၶႅပ်းႁၢင်ႈ|kúú khép hāāng|လွင်ႈၵူးၶႅပ်းႁၢင်ႈ	<i>verb</i><br><ol><li>print a photography</li></ol>
ၵူၺ်|kǒǐ	<i>noun</i><br><ol><li>large basket</li></ol>
ၵူၺ်တၢင်ႇ|kǒǐ tààng	<i>noun</i><br><ol><li>pannier</li></ol>
ၵူၺ်း|kóí	<i>adv</i><br><ol><li>only, alone</li></ol>
ၵူၺ်းၵႃႈ|kóí kāā	<i>conj</i><br><ol><li>although, nevertheless, but, however</li></ol>
ၵူၺ်ႁၢပ်ႇ|kǒǐ hààp	<i>noun</i><br><ol><li>porter basket</li></ol>
ၵူၺ်ႇ|kòì	<i>adj</i><br><ol><li>gray</li></ol>
ၵူၺ်ႇလဵၵ်း|kòì láék	<i>adj</i><br><ol><li>iron-gray</li></ol>
ၵူၺ်ႈ|kōī	<i>noun</i><br><ol><li>banana.</li></ol>
ၵူၺ်ႈထိူၼ်ႇ|kōī thòèn	<i>noun</i><br><ol><li>wild banana or plantain</li></ol>
ၵူၺ်ႈသူမ်ႈ|kōī sūūm	<i>noun</i><br><ol><li>slightly sour banana</li></ol>
ၵူၺ်ႈႁႅင်ႈ|kōī hēng	<i>noun</i><br><ol><li>dried banana</li></ol>
ၵူၼ်|kǔǔn	<i>noun</i><br><ol><li>trousers, pants</li></ol>
ၵူၼ်တၢင်းၼႂ်း|kǔǔn tááng náúé	<i>noun</i><br><ol><li>underwear, shorts</li></ol>
ၵူၼ်တႆး|kǔǔn táí	<i>noun</i><br><ol><li>Shan trousers</li></ol>
ၵူၼ်ပိတ်း|kǔǔn pít	<i>noun</i><br><ol><li>short pants, briefs</li></ol>
ၵူၼ်ပွတ်း|kǔǔn páút	<i>noun</i><br><ol><li>short trousers, shorts</li></ol>
ၵူၼ်ယူင်ႉ|kǔǔn yṵ̂ṵ̂ng	<i>noun</i><br><ol><li>baggy pants, pantaloons</li></ol>
ၵူၼ်ယၢဝ်း|kǔǔn yááó	<i>noun</i><br><ol><li>long pants</li></ol>
ၵူၼ်း|kúún|kâ̰ṵ̂|ၵေႃႉ	<i>noun</i><br><ol><li>human, human being, person, people</li></ol>
ၵူၼ်းငိူဝ်ႈ|kúún ngōē	<i>noun</i><br><ol><li>incapable person, stupid person</li></ol>
ၵူၼ်းငႃႉ|kúún ngâ̰â̰	<i>noun</i><br><ol><li>incapable person, stupid person</li></ol>
ၵူၼ်းတင်းလၢႆ|kúún táng lǎǎǐ	<i>noun</i><br><ol><li>people, the populace</li></ol>
ၵူၼ်းတပ်ႉ|kúún tâ̰p	<i>noun</i><br><ol><li>soldier, serviceman, private</li></ol>
ၵူၼ်းတပ်ႉၵၢင်ႁၢဝ်|kúún tâ̰p kǎǎng hǎǎǒ	<i>noun</i><br><ol><li>airman, member of the air force</li></ol>
ၵူၼ်းတပ်ႉၼမ်ႉ|kúún tâ̰p nâ̰m	<i>noun</i><br><ol><li>sailor, navy man, marine</li></ol>
ၵူၼ်းတမ်ၶဝ်ႈ|kúún tǎm khāō	<i>noun</i><br><ol><li>miller, person who pounds rice</li></ol>
ၵူၼ်းတုတ်ႈ|kúún tūt	<i>noun</i><br><ol><li>leper</li></ol>
ၵူၼ်းတူၵ်းထွင်ႇ|kúún túúk thàùng	<i>noun</i><br><ol><li>prisoner</li></ol>
ၵူၼ်းတူၵ်းၶွၵ်ႈ|kúún túúk khāūk	<i>noun</i><br><ol><li>prisoner, person who was caught</li></ol>
ၵူၼ်းတူၺ်းပွႆး|kúún tóí páúí	<i>noun</i><br><ol><li>audience</li></ol>
ၵူၼ်းတူၺ်းလုၵ်ႈဢွၼ်ႇ|kúún tóí lūk ʼàùn	<i>noun</i><br><ol><li>babysitter</li></ol>
ၵူၼ်းတေႃးႁုၵ်ႇ|kúún táú hùk	<i>noun</i><br><ol><li>weaver</li></ol>
ၵူၼ်းတေႃႇ|kúún tàù	<i>noun</i><br><ol><li>player, one who plays</li></ol>
ၵူၼ်းတေႃႇတူဝ်|kúún tàù tǒ	<i>noun</i><br><ol><li>childless person</li></ol>
ၵူၼ်းတေႃႇၵူၼ်းလွင်း|kúún tàù kúún láúng	<i>noun</i><br><ol><li>gamble</li></ol>
ၵူၼ်းတေႃႉၶူဝ်း|kúún tâ̰ṵ̂ khó	<i>noun</i><br><ol><li>porter, person who carries things</li></ol>
ၵူၼ်းတၢင်ႇမိူင်း|kúún tààng móéng	<i>noun</i><br><ol><li>foreigner alien, person form another land</li></ol>
ၵူၼ်းတၢင်ႇၸုမ်း|kúún tààng tsúm	<i>noun</i><br><ol><li>outsider, person from another group</li></ol>
ၵူၼ်းတၢႆၽၢၵ်ႇ|kúún tǎǎǐ phààk	<i>noun</i><br><ol><li>paralyzed person, person who has the palsy</li></ol>
ၵူၼ်းတႅမ်ႈလိၵ်ႈ|kúún tēm līk	<i>noun</i><br><ol><li>writer, author</li></ol>
ၵူၼ်းတႅမ်ႈၸၢတ်ႈ|kúún tēm tsāāt	<i>noun</i><br><ol><li>painter, limner</li></ol>
ၵူၼ်းတႅမ်ႈႁၢင်ႈ|kúún tēm hāāng	<i>noun</i><br><ol><li>artist, person who draw figures</li></ol>
ၵူၼ်းတႆႇၸိူၵ်ႈ|kúún tàì tsōēk	<i>noun</i><br><ol><li>tight-rope walker</li></ol>
ၵူၼ်းထဝ်ႈ|kúún thāō	<i>noun</i><br><ol><li>old person, aged person</li></ol>
ၵူၼ်းထိင်း|kúún thíng	<i>noun</i><br><ol><li>one who keep watch, look after, keeper, herder</li></ol>
ၵူၼ်းထိင်းမႃႉ|kúún thíng mâ̰â̰	<i>noun</i><br><ol><li>horse keeper, groom</li></ol>
ၵူၼ်းထိင်းလုၵ်ႈဢွၼ်ႇ|kúún thíng lūk ʼàùn	<i>noun</i><br><ol><li>a nanny</li></ol>
ၵူၼ်းထိင်းၼၢင်း|kúún thíng nááng	<i>noun</i><br><ol><li>eunuch, person who has charge of a harem</li></ol>
ၵူၼ်းထိူၼ်ႇ|kúún thòèn	<i>noun</i><br><ol><li>expatriate, guerilla</li></ol>
ၵူၼ်းထုၵ်ႇၼီႈ|kúún thùk nīī	<i>noun</i><br><ol><li>debtor</li></ol>
ၵူၼ်းထၢၵ်ႇမၢၵ်ႇႁိၼ်|kúún thààk mààk hǐn	<i>noun</i><br><ol><li>stone cutter</li></ol>
ၵူၼ်းထႆႇႁၢင်ႈ|kúún thàì hāāng	<i>noun</i><br><ol><li>photographer</li></ol>
ၵူၼ်းပိုၵ်ႉမႃႉ|kúún pṵ̂ḛ̂k mâ̰â̰	<i>noun</i><br><ol><li>horse breaker</li></ol>
ၵူၼ်းပေႃးမူၺ်း|kúún páú móí	<i>noun</i><br><ol><li>boxer</li></ol>
ၵူၼ်းပေႃႉၶႅပ်းႁၢင်ႈ|kúún pâ̰ṵ̂ khép hāāng	<i>noun</i><br><ol><li>photographer</li></ol>
ၵူၼ်းပဵၼ်|kúún pǎěn	<i>noun</i><br><ol><li>sick person, invalid, patient</li></ol>
ၵူၼ်းပျၢၵ်ႈ|kúún pjāāk	<i>noun</i><br><ol><li>buffoon, joker, comedian</li></ol>
ၵူၼ်းပွၵ်း|kúún páúk	<i>noun</i><br><ol><li>short person</li></ol>
ၵူၼ်းပၢႆႈၽေး|kúún pāāī phéé	<i>noun</i><br><ol><li>refugee, one who flees from danger</li></ol>
ၵူၼ်းပႂ်ႉ|kúún pâ̰ṵ̂ḛ̂	<i>noun</i><br><ol><li>watcher, guard, keeper</li></ol>
ၵူၼ်းပႂ်ႉထွင်ႇ|kúún pâ̰ṵ̂ḛ̂ thàùng	<i>noun</i><br><ol><li>jailer, prison guard</li></ol>
ၵူၼ်းပႂ်ႉဝူဝ်း|kúún pâ̰ṵ̂ḛ̂ wó	<i>noun</i><br><ol><li>shepherd</li></ol>
ၵူၼ်းပႂ်ႉသူဝ်း|kúún pâ̰ṵ̂ḛ̂ só	<i>noun</i><br><ol><li>shepherd</li></ol>
ၵူၼ်းပႂ်ႉၵၢင်|kúún pâ̰ṵ̂ḛ̂ kǎǎng	<i>noun</i><br><ol><li>sentinel, guard</li></ol>
ၵူၼ်းပႅတ်ႈလၢႆ|kúún pēt lǎǎǐ	<i>noun</i><br><ol><li>useless person, person who is good for nothing</li></ol>
ၵူၼ်းပႅတ်ႉၵူၼ်းလႅၼ်|kúún pḛ̂t kúún lěn	<i>noun</i><br><ol><li>dishonest person, cheat</li></ol>
ၵူၼ်းမဝ်းလဝ်ႈ|kúún máó lāō	<i>noun</i><br><ol><li>drunkard</li></ol>
ၵူၼ်းမိူင်း|kúún móéng	<i>noun</i><br><ol><li>citizen</li></ol>
ၵူၼ်းမိူင်းၼွၵ်ႈ|kúún móéng nāūk	<i>noun</i><br><ol><li>foreigner, person from abroad</li></ol>
ၵူၼ်းမီးႁႅင်း|kúún míí héng	<i>noun</i><br><ol><li>strong person</li></ol>
ၵူၼ်းမူၼ်ႈ|kúún mūūn	<i>noun</i><br><ol><li>entertainer, performer</li></ol>
ၵူၼ်းမေႃ|kúún mǎǔ	<i>noun</i><br><ol><li>expert</li></ol>
ၵူၼ်းမေႃလႅၼ်|kúún mǎǔ lěn	<i>noun</i><br><ol><li>liar</li></ol>
ၵူၼ်းမေႃသေႃႇမေႃသူၼ်း|kúún mǎǔ sàù mǎǔ súún	<i>noun</i><br><ol><li>troublemaker</li></ol>
ၵူၼ်းမေႃၵႂၢမ်း|kúún mǎǔ kwáám	<i>noun</i><br><ol><li>skillful man</li></ol>
ၵူၼ်းမွၵ်ႇလၢတ်ႈၵႂၢမ်း|kúún màùk lāāt kwáám	<i>noun</i><br><ol><li>speaker, orator, person who gives a speech</li></ol>
ၵူၼ်းမၢၵ်ႈမီး|kúún māāk míí	<i>noun</i><br><ol><li>rich man, wealthy person</li></ol>
ၵူၼ်းမႃးၸၢင်ႈ|kúún máá tsāāng	<i>noun</i><br><ol><li>client</li></ol>
ၵူၼ်းမႄးလွတ်ႇၼမ်ႉ|kúún mááé làùt nâ̰m	<i>noun</i><br><ol><li>plumber</li></ol>
ၵူၼ်းမႄးၵႃး|kúún mááé káá	<i>noun</i><br><ol><li>car mechanic</li></ol>
ၵူၼ်းမႄးၸၢၵ်ႈ|kúún mááé tsāāk	<i>noun</i><br><ol><li>mechanic, technician</li></ol>
ၵူၼ်းမႄးႁၢင်ႁိူဝ်း|kúún mááé hǎǎng hóé	<i>noun</i><br><ol><li>helmsman of a boat</li></ol>
ၵူၼ်းယိင်း|kúún yíng	<i>noun</i><br><ol><li>woman, female</li></ol>
ၵူၼ်းယိင်းဢွၼ်ႇ|kúún yíng ʼàùn	<i>noun</i><br><ol><li>girl</li></ol>
ၵူၼ်းယိင်းၸၢႆး|kúún yíng tsááí	<i>noun</i><br><ol><li>tomboy, mannish woman</li></ol>
ၵူၼ်းယူႇလီ|kúún yùù lǐǐ	<i>noun</i><br><ol><li>healthy person</li></ol>
ၵူၼ်းယေး|kúún yéé	<i>noun</i><br><ol><li>layman, person of a household</li></ol>
ၵူၼ်းယဵပ်ႉလၢႆးမွၵ်ႇ|kúún yâ̰ḛ̂p lááí màùk	<i>noun</i><br><ol><li>embroiderer</li></ol>
ၵူၼ်းယဵပ်ႉသွၵ်းတိၼ်|kúún yâ̰ḛ̂p sáúk tǐn	<i>noun</i><br><ol><li>shoemaker, cobber</li></ol>
ၵူၼ်းယဵပ်ႉၶူဝ်း|kúún yâ̰ḛ̂p khó	<i>noun</i><br><ol><li>tailor</li></ol>
ၵူၼ်းယဵပ်ႉၶႅပ်းတိၼ်|kúún yâ̰ḛ̂p khép tǐn	<i>noun</i><br><ol><li>sandal maker, shoe maker</li></ol>
ၵူၼ်းယဵပ်ႉၸၢၵ်ႈ|kúún yâ̰ḛ̂p tsāāk	<i>noun</i><br><ol><li>person who sews in a machine</li></ol>
ၵူၼ်းယွင်ႇ|kúún yàùng	<i>noun</i><br><ol><li>insane person</li></ol>
ၵူၼ်းယွၼ်း|kúún yáún	<i>noun</i><br><ol><li>beggar, panhandler</li></ol>
ၵူၼ်းယႃႉၵဝ်း|kúún yâ̰â̰ káó	<i>noun</i><br><ol><li>trouble-maker</li></ol>
ၵူၼ်းလမ်|kúún lǎm	<i>noun</i><br><ol><li>layman</li></ol>
ၵူၼ်းလိပ်း|kúún líp	<i>noun</i><br><ol><li>uneducated person, inexperienced person</li></ol>
ၵူၼ်းလိူင်း|kúún lóéng	<i>noun</i><br><ol><li>wild, uncultivated, ignorant person, rude person</li></ol>
ၵူၼ်းလိူဝ်ႈပႅၼ်ႈ|kúún lōē pēn	<i>noun</i><br><ol><li>lumberman</li></ol>
ၵူၼ်းလိူဝ်ႈမႆႉ|kúún lōē mâ̰ḭ̂	<i>noun</i><br><ol><li>logger</li></ol>
ၵူၼ်းလုမ်းလႃးသူၼ်|kúún lúm láá sǔǔn	<i>noun</i><br><ol><li>gardener</li></ol>
ၵူၼ်းလုမ်းလႃးၵူၼ်းပဵၼ်|kúún lúm láá kúún pǎěn	<i>noun</i><br><ol><li>nurse</li></ol>
ၵူၼ်းလူင်|kúún lǔǔng	<i>noun</i><br><ol><li>adult, great man, chief, boss, elder</li></ol>
ၵူၼ်းလူမ်းလူင်|kúún lúúm lǔǔng	<i>noun</i><br><ol><li>boaster, braggart</li></ol>
ၵူၼ်းလူလိၵ်ႈ|kúún lǔǔ līk	<i>noun</i><br><ol><li>reader, person who reads</li></ol>
ၵူၼ်းလူႉၵူၼ်းသုမ်း|kúún lṵ̂ṵ̂ kúún súm	<i>noun</i><br><ol><li>totally ruined person</li></ol>
ၵူၼ်းလေႃ|kúún lǎǔ	<i>noun</i><br><ol><li>thief</li></ol>
ၵူၼ်းလေႃလႄ|kúún lǎǔ lǎǎě	<i>noun</i><br><ol><li>careless, worthless person</li></ol>
ၵူၼ်းလေႃးၽ	<i>noun</i><br><ol><li>greedy person</li></ol>
ၵူၼ်းလဵင်ႉမႃႉ|kúún lâ̰ḛ̂ng mâ̰â̰	<i>noun</i><br><ol><li>horse keeper, groom</li></ol>
ၵူၼ်းလဵင်ႉဝူဝ်း|kúún lâ̰ḛ̂ng wó	<i>noun</i><br><ol><li>cowherd, cattle herdsman</li></ol>
ၵူၼ်းလဵၼ်ႈ|kúún lāēn	<i>noun</i><br><ol><li>player, one who plays</li></ol>
ၵူၼ်းလဵၼ်ႈငူး|kúún lāēn ngúú	<i>noun</i><br><ol><li>juggler, snake charmer</li></ol>
ၵူၼ်းလဵၼ်ႈၸိူင်းလႅဝ်း|kúún lāēn tsóéng léáó	<i>noun</i><br><ol><li>fencer, swordsman</li></ol>
ၵူၼ်းလဵၼ်ႈႁႅင်း|kúún lāēn héng	<i>noun</i><br><ol><li>athlete, sportsman</li></ol>
ၵူၼ်းလၢတ်ႈငၢႆႈ|kúún lāāt ngāāī	<i>noun</i><br><ol><li>tractable person, obedient person, docile person</li></ol>
ၵူၼ်းလၢတ်ႈယၢပ်ႇ|kúún lāāt yààp	<i>noun</i><br><ol><li>disobedient person</li></ol>
ၵူၼ်းလၢၵ်ႇလၢႆး|kúún lààk lááí	<i>noun</i><br><ol><li>stranger, alien, stronger person</li></ol>
ၵူၼ်းလႅၵ်ႈငိုၼ်း|kúún lēk ngúén	<i>noun</i><br><ol><li>money changer</li></ol>
ၵူၼ်းလႅၼ်|kúún lěn	<i>noun</i><br><ol><li>dishonest man, cheat, liar</li></ol>
ၵူၼ်းဝူင်ႈၵၢင်|kúún wūūng kǎǎng	<i>noun</i><br><ol><li>mediator, go between middleman</li></ol>
ၵူၼ်းဝၢၼ်ႈ|kúún wāān	<i>noun</i><br><ol><li>village people, villager</li></ol>
ၵူၼ်းဝၢၼ်ႈၵူၼ်းမိူင်း|kúún wāān kúún móéng	<i>noun</i><br><ol><li>citizens, population</li></ol>
ၵူၼ်းဝၢၼ်ႈၵူၼ်းသူၼ်|kúún wāān kúún sǔǔn	<i>noun</i><br><ol><li>farmer, gardener, peasant</li></ol>
ၵူၼ်းဝၢၼ်ႈၼွၵ်ႈ|kúún wāān nāūk	<i>noun</i><br><ol><li>peasant, rustic</li></ol>
ၵူၼ်းသိုပ်ႇၶၢႆ|kúún sùèp khǎǎǐ	<i>noun</i><br><ol><li>distributor</li></ol>
ၵူၼ်းသိုဝ်ႈၵူၼ်းယူဝ်း|kúún sūē kúún yó	<i>noun</i><br><ol><li>righteous man, honest person</li></ol>
ၵူၼ်းသိုဝ်ႉ|kúún sṵ̂ḛ̂	<i>noun</i><br><ol><li>buyer, customer</li></ol>
ၵူၼ်းသိုၵ်း|kúún súék	<i>noun</i><br><ol><li>soldier, warrior, service man</li></ol>
ၵူၼ်းသိုၵ်းၵဝ်ႇ|kúún súék kàò	<i>noun</i><br><ol><li>former soldier, ex-soldier, veteran</li></ol>
ၵူၼ်းသုၵ်ႉယုင်ႈ|kúún sṵ̂k yūng	<i>noun</i><br><ol><li>trouble-maker terrorist</li></ol>
ၵူၼ်းသူၺ်းသႅင်|kúún sóí sěng	<i>noun</i><br><ol><li>polisher of precious stone</li></ol>
ၵူၼ်းသေႃႇ|kúún sàù	<i>noun</i><br><ol><li>public crier, herald</li></ol>
ၵူၼ်းသွၼ်ၵၢၼ်|kúún sǎǔn kǎǎn	<i>noun</i><br><ol><li>apprentice</li></ol>
ၵူၼ်းသၵ်ႉၶူဝ်း|kúún sâ̰k khó	<i>noun</i><br><ol><li>washer man, washer woman</li></ol>
ၵူၼ်းဢမ်ႇမီးၽႃႇသႃႇ|kúún ʼàm míí phàà sàà	<i>noun</i><br><ol><li>atheist</li></ol>
ၵူၼ်းဢမ်ႇၶွပ်ႇဢမ်ႇၵၢင်|kúún ʼàm khàùp ʼàm kǎǎng	<i>noun</i><br><ol><li>person either good nor bad</li></ol>
ၵူၼ်းဢိုပ်း|kúún ʼúép	<i>noun</i><br><ol><li>starving person</li></ol>
ၵူၼ်းဢုပ်ႇလူင်|kúún ʼùp lǔǔng	<i>noun</i><br><ol><li>boaster, braggart</li></ol>
ၵူၼ်းဢၢၼ်ႇငိုၼ်း|kúún ʼààn ngúén	<i>noun</i><br><ol><li>teller</li></ol>
ၵူၼ်းဢႃႉ|kúún ʼâ̰â̰	<i>noun</i><br><ol><li>dumb person</li></ol>
ၵူၼ်းၵတ်ႉ|kúún kâ̰t	<i>noun</i><br><ol><li>clever, skillful person, charmed person</li></ol>
ၵူၼ်းၵတ်ႉၶႅၼ်ႇ|kúún kâ̰t khèn	<i>noun</i><br><ol><li>person who is extremely clever, skillful, person with outstanding skills</li></ol>
ၵူၼ်းၵဝ်ႇ|kúún kàò	<i>noun</i><br><ol><li>old resident, old hand, veteran</li></ol>
ၵူၼ်းၵုမ်း|kúún kúm	<i>noun</i><br><ol><li>guard</li></ol>
ၵူၼ်းၵူတ်ႉ|kúún kṵ̂ṵ̂t	<i>noun</i><br><ol><li>dishonest man, cheat</li></ol>
ၵူၼ်းၵူႈငိုၼ်း|kúún kūū ngúén	<i>noun</i><br><ol><li>money lender</li></ol>
ၵူၼ်းၵေႃႇဢုတ်ႇ|kúún kàù ʼùt	<i>noun</i><br><ol><li>bricklayer, mason</li></ol>
ၵူၼ်းၵျၢမ်း|kúún kjáám	<i>noun</i><br><ol><li>violent person, cruel man</li></ol>
ၵူၼ်းၵၢၼ်မိူင်း|kúún kǎǎn móéng	<i>noun</i><br><ol><li>government administration, legislator</li></ol>
ၵူၼ်းၵၵ်း|kúún kák	<i>noun</i><br><ol><li>person who stammers</li></ol>
ၵူၼ်းၵႃႈ|kúún kāā	<i>noun</i><br><ol><li>dancer</li></ol>
ၵူၼ်းၵႃႈၸၢတ်ႈ|kúún kāā tsāāt	<i>noun</i><br><ol><li>actor, actress</li></ol>
ၵူၼ်းၵႃႉ|kúún kâ̰â̰	<i>noun</i><br><ol><li>merchant, trader</li></ol>
ၵူၼ်းၵႃႉၵူၼ်းၶၢႆ|kúún kâ̰â̰ kúún khǎǎǐ	<i>noun</i><br><ol><li>merchant, trader</li></ol>
ၵူၼ်းၵႄႇ|kúún kààè	<i>noun</i><br><ol><li>elderly person</li></ol>
ၵူၼ်းၵႄႇၶႅၼ်ႉ|kúún kààè khḛ̂n	<i>noun</i><br><ol><li>person of stunted growth</li></ol>
ၵူၼ်းၵႅတ်းၶူၼ်ႁူဝ်|kúún két khǔǔn hǒ	<i>noun</i><br><ol><li>barber, hair cutter</li></ol>
ၵူၼ်းၵႅၵ်း|kúún kék	<i>noun</i><br><ol><li>inefficient, cowardly person, deceitful person</li></ol>
ၵူၼ်းၵႅၼ်း|kúún kén	<i>noun</i><br><ol><li>poor person, destitute person</li></ol>
ၵူၼ်းၵႅၼ်ႇၶႅင်|kúún kèn khěng	<i>noun</i><br><ol><li>strong man</li></ol>
ၵူၼ်းၵႆႉ|kúún kâ̰ḭ̂	<i>noun</i><br><ol><li>persevering, person who is energetic</li></ol>
ၵူၼ်းၵႆႉၼႃႈၶဝ်ႈ|kúún kâ̰ḭ̂ nāā khāō	<i>noun</i><br><ol><li>eye-servant</li></ol>
ၵူၼ်းၶတ်းႁၢင်ႁိူဝ်း|kúún khát hǎǎng hóé	<i>noun</i><br><ol><li>helmsman of a boat</li></ol>
ၵူၼ်းၶိုင်မႃႇသႃႇ|kúún khǔěng màà sàà	<i>noun</i><br><ol><li>undertaker</li></ol>
ၵူၼ်းၶီႇ|kúún khìì	<i>noun</i><br><ol><li>passenger, person who rides</li></ol>
ၵူၼ်းၶီႈယၢၼ်ႈ|kúún khīī yāān	<i>noun</i><br><ol><li>coward</li></ol>
ၵူၼ်းၶုတ်းတတ်ႉထူႉ|kúún khút tâ̰t thṵ̂ṵ̂	<i>noun</i><br><ol><li>miner</li></ol>
ၵူၼ်းၶုတ်းမေႃႇ|kúún khút màù	<i>noun</i><br><ol><li>well driller</li></ol>
ၵူၼ်းၶူးၵူၼ်းဝဵင်း|kúún khúú kúún wáéng	<i>noun</i><br><ol><li>citizen</li></ol>
ၵူၼ်းၶေႃႉ|kúún khâ̰ṵ̂	<i>noun</i><br><ol><li>person emaciated by disease</li></ol>
ၵူၼ်းၶၢဝ်ႇႁူင်|kúún khààò hǔǔng	<i>noun</i><br><ol><li>famous person</li></ol>
ၵူၼ်းၶၢဝ်ႉ|kúún khâ̰â̰ô̰	<i>noun</i><br><ol><li>middle-aged person</li></ol>
ၵူၼ်းၶၢၼ်ႉ|kúún khâ̰â̰n	<i>noun</i><br><ol><li>lazy person</li></ol>
ၵူၼ်းၶၢႆၶူဝ်း|kúún khǎǎǐ khó	<i>noun</i><br><ol><li>vender, seller of goods</li></ol>
ၵူၼ်းၶၢႆၶူဝ်းၸွမ်းတၢင်း|kúún khǎǎǐ khó tsáúm tááng	<i>noun</i><br><ol><li>street seller, hawker</li></ol>
ၵူၼ်းၶႃလမ်|kúún khǎǎ lǎm	<i>noun</i><br><ol><li>tattooed person</li></ol>
ၵူၼ်းၶႃလၢႆး|kúún khǎǎ lááí	<i>noun</i><br><ol><li>tattooed person</li></ol>
ၵူၼ်းၶႄထဵင်|kúún khǎǎě thǎěng	<i>noun</i><br><ol><li>defendant</li></ol>
ၵူၼ်းၶႆႈဢပုမ်ႇ|kúún khāī ʼǎ pùm	<i>noun</i><br><ol><li>story teller, person who tells stories</li></ol>
ၵူၼ်းၸပ်းလဝ်ႈ|kúún tsáp lāō	<i>noun</i><br><ol><li>alcoholic</li></ol>
ၵူၼ်းၸူၼ်|kúún tsǔǔn	<i>noun</i><br><ol><li>robber, bandit</li></ol>
ၵူၼ်းၸွပ်ႇႁႃ|kúún tsàùp hǎǎ	<i>noun</i><br><ol><li>investigator, researcher</li></ol>
ၵူၼ်းၸွမ်းလင်|kúún tsáúm lǎng	<i>noun</i><br><ol><li>follower</li></ol>
ၵူၼ်းၸွႆႈႁေႃႈႁိူဝ်းမိၼ်|kúún tsāūī hāū hóé mǐn	<i>noun</i><br><ol><li>co-pilot</li></ol>
ၵူၼ်းၸၢင်ႈ|kúún tsāāng	<i>noun</i><br><ol><li>hired hand, laborer</li></ol>
ၵူၼ်းၸၢႆး|kúún tsááí	<i>noun</i><br><ol><li>man, male</li></ol>
ၵူၼ်းၸၢႆးယိင်း|kúún tsááí yíng	<i>noun</i><br><ol><li>effeminate man, womanish man, male transvestite</li></ol>
ၵူၼ်းၸၢႆးဢွၼ်ႇ|kúún tsááí ʼàùn	<i>noun</i><br><ol><li>boy</li></ol>
ၵူၼ်းၸႂ်လမ်သႆႈၵမ်ႇ|kúún tsǎǔě lǎm sāī kàm	<i>noun</i><br><ol><li>short-tempered person</li></ol>
ၵူၼ်းၸႂ်ႉ|kúún tsâ̰ṵ̂ḛ̂	<i>noun</i><br><ol><li>waiter, messenger, servant</li></ol>
ၵူၼ်းၺွပ်းလႆႈ|kúún nyáúp lāī	<i>noun</i><br><ol><li>prisoner, person who was caught</li></ol>
ၵူၼ်းၼပ်ႉမၢႆငိုၼ်း|kúún nâ̰p mǎǎǐ ngúén	<i>noun</i><br><ol><li>accountant, bookkeeper</li></ol>
ၵူၼ်းၼုမ်ႇ|kúún nùm	<i>noun</i><br><ol><li>young person, youth</li></ol>
ၵူၼ်းၼူၵ်ႇၵူၼ်းၼႃ|kúún nùùk kúún nǎǎ	<i>noun</i><br><ol><li>slow person, dull person, stupid person</li></ol>
ၵူၼ်းၼႃႈလိူမ်ႈ|kúún nāā lōēm	<i>noun</i><br><ol><li>comedian, joker</li></ol>
ၵူၼ်းၽိုၵ်း|kúún phúék	<i>noun</i><br><ol><li>beginner</li></ol>
ၵူၼ်းၽဵဝ်ႈၵူၼ်းသိမ်း|kúún phāēō kúún sím	<i>noun</i><br><ol><li>cleaning person</li></ol>
ၵူၼ်းၽၢၵ်ႇပိူၼ်ႈ|kúún phààk pōēn	<i>noun</i><br><ol><li>agent</li></ol>
ၵူၼ်းၽၢၼ်|kúún phǎǎn	<i>noun</i><br><ol><li>poor person, destitute person</li></ol>
ၵူၼ်းၽၢၼ်ပေႃႈမႄႈ|kúún phǎǎn pāū māāē	<i>noun</i><br><ol><li>orphan</li></ol>
ၵူၼ်းၽၢႆႇၼႂ်း|kúún phààì náúé	<i>noun</i><br><ol><li>spy</li></ol>
ၵူၼ်းၽၢႆႇၽႆးၾႃႉ|kúún phààì pháí fâ̰â̰	<i>noun</i><br><ol><li>electrician</li></ol>
ၵူၼ်းၽၼ်းမႆႉ|kúún phán mâ̰ḭ̂	<i>noun</i><br><ol><li>wood cutter, logger, lumberjack</li></ol>
ၵူၼ်းႁတ်း|kúún hát	<i>noun</i><br><ol><li>brave person</li></ol>
ၵူၼ်းႁပ်ႉ|kúún hâ̰p	<i>noun</i><br><ol><li>person who receive, welcomes, receiver, welcomer</li></ol>
ၵူၼ်းႁိတ်ႉ|kúún hḭ̂t	<i>noun</i><br><ol><li>glutton</li></ol>
ၵူၼ်းႁိူဝ်း|kúún hóé	<i>noun</i><br><ol><li>crew, sailor</li></ol>
ၵူၼ်းႁိူၼ်းၸမ်ၵၼ်|kúún hóén tsǎm kǎn	<i>noun</i><br><ol><li>neighbor</li></ol>
ၵူၼ်းႁုင်ၶဝ်ႈ|kúún hǔng khāō	<i>noun</i><br><ol><li>cook, chef</li></ol>
ၵူၼ်းႁူင်းၵၢၼ်|kúún húúng kǎǎn	<i>noun</i><br><ol><li>staff</li></ol>
ၵူၼ်းႁူမ်ႈၵၼ်ၵႃႉ|kúún hūūm kǎn kâ̰â̰	<i>noun</i><br><ol><li>partner, shareholder</li></ol>
ၵူၼ်းႁူႉယႂ်ႇႁၼ်ၼမ်|kúún hṵ̂ṵ̂ yàùè hǎn nǎm	<i>noun</i><br><ol><li>well informed person, experienced person</li></ol>
ၵူၼ်းႁူႉၸၵ်း|kúún hṵ̂ṵ̂ tsák	<i>noun</i><br><ol><li>recognizes, acquaintance</li></ol>
ၵူၼ်းႁေႃးတြႃး|kúún háú tráá	<i>noun</i><br><ol><li>preacher, person who preaches sermon</li></ol>
ၵူၼ်းႁေႃႈ|kúún hāū	<i>noun</i><br><ol><li>driver</li></ol>
ၵူၼ်းႁေႃႈရထႃး|kúún hāū rǎ tháá	<i>noun</i><br><ol><li>train engineer</li></ol>
ၵူၼ်းႁေႃႈၵႃး|kúún hāū káá	<i>noun</i><br><ol><li>driver, motorist</li></ol>
ၵူၼ်းႁေႃႈႁိူဝ်းမိၼ်|kúún hāū hóé mǐn	<i>noun</i><br><ol><li>pilot</li></ol>
ၵူၼ်းႁဵတ်းမၢၵ်ႇလေႃႉ|kúún háét mààk lâ̰ṵ̂	<i>noun</i><br><ol><li>wheelwright</li></ol>
ၵူၼ်းႁဵတ်းလေႃႉ|kúún háét lâ̰ṵ̂	<i>noun</i><br><ol><li>cartwright</li></ol>
ၵူၼ်းႁဵတ်းသူၼ်|kúún háét sǔǔn	<i>noun</i><br><ol><li>gardener</li></ol>
ၵူၼ်းႁဵတ်းဢမူႉ|kúún háét ʼǎ mṵ̂ṵ̂	<i>noun</i><br><ol><li>plaintiff, prosecutor</li></ol>
ၵူၼ်းႁဵတ်းဢွၵ်ႇၶူဝ်း|kúún háét ʼàùk khó	<i>noun</i><br><ol><li>manufacturer</li></ol>
ၵူၼ်းႁဵတ်းၵူၼ်းသၢင်ႈ|kúún háét kúún sāāng	<i>noun</i><br><ol><li>workman, operator</li></ol>
ၵူၼ်းႁဵတ်းၵၢၼ်|kúún háét kǎǎn	<i>noun</i><br><ol><li>worker, employee</li></ol>
ၵူၼ်းႁဵတ်းၵၢၼ်ငၢၼ်း|kúún háét kǎǎn ngáán	<i>noun</i><br><ol><li>businessman</li></ol>
ၵူၼ်းႁဵတ်းၵႂၢမ်း|kúún háét kwáám	<i>noun</i><br><ol><li>singer</li></ol>
ၵူၼ်းႁဵတ်းၼင်|kúún háét nǎng	<i>noun</i><br><ol><li>potter</li></ol>
ၵူၼ်းႁဵတ်းႁိူၼ်း|kúún háét hóén	<i>noun</i><br><ol><li>builder</li></ol>
ၵူၼ်းႁဵတ်းႁူဝ်ပၵ်းၶိတ်း|kúún háét hǒ pák khít	<i>noun</i><br><ol><li>tumbler</li></ol>
ၵူၼ်းႁၢပ်ႇ|kúún hààp	<i>noun</i><br><ol><li>person who carries, porter, coolie</li></ol>
ၵူၼ်းႁၢပ်ႇၶျေႃး|kúún hààp khjáú	<i>noun</i><br><ol><li>porter, force laborer</li></ol>
ၵူၼ်းႁၼ်ႁူႉ|kúún hǎn hṵ̂ṵ̂	<i>noun</i><br><ol><li>witness</li></ol>
ၵူၼ်းႁႃပႃ|kúún hǎǎ pǎǎ	<i>noun</i><br><ol><li>fisherman, angler</li></ol>
ၵူၼ်းႁႅင်း|kúún héng	<i>noun</i><br><ol><li>strong person, hale and hearty person</li></ol>
ၵူၼ်းႁႅၼ်းၶဝ်ႈၽၵ်း|kúún hén khāō phák	<i>noun</i><br><ol><li>steward, butler</li></ol>
ၵူၼ်းႁႆႇၵႂၢမ်း|kúún hàì kwáám	<i>noun</i><br><ol><li>musician, musicians</li></ol>
ၵူၼ်ၶႃမႃႉ|kǔǔn khǎǎ mâ̰â̰	<i>noun</i><br><ol><li>flares</li></ol>
ၵူၼ်ၶႃလဵၵ်ႉ|kǔǔn khǎǎ lâ̰ḛ̂k	<i>noun</i><br><ol><li>drainpipes, trousers with narrow leg</li></ol>
ၵူၼ်ၶႃၵီႈ|kǔǔn khǎǎ kīī	<i>noun</i><br><ol><li>flares</li></ol>
ၵူၼ်ႇ|လွင်ႈၵူၼ်ႇ|kùùn	<i>verb</i><br><ol><li>break down, fall down, demolish, destroy</li></ol>
ၵူၼ်ႇတူၵ်း|လွင်ႈၵူၼ်ႇတူၵ်း|kùùn túúk	<i>verb</i><br><ol><li>fall down, crumble and fall</li></ol>
ၵူၼ်ႈ|kūūn	<i>noun</i><br><ol><li>anus, buttock</li></ol>
ၵူၼ်ႈမေႃႈ|kūūn māū	<i>noun</i><br><ol><li>bottom of a pot</li></ol>
ၵူၼ်ႈၵူၺ်|kūūn kǒǐ	<i>noun</i><br><ol><li>bottom of a basket</li></ol>
ၵူၼ်ႈၶဵတ်ႇ|kūūn khàèt	<i>noun</i><br><ol><li>coccyx</li></ol>
ၵူၼ်ႈၼမ်ႉမေႃႇ|kūūn nâ̰m màù	<i>noun</i><br><ol><li>bottom of a well</li></ol>
ၵူၼ်ႈႁူၺ်ႈ|kūūn hōī	<i>noun</i><br><ol><li>bottom of a ravine</li></ol>
ၵူၼ်ႉ|kṵ̂ṵ̂n|လွင်ႈၵူၼ်ႉ	<i>verb</i><br><ol><li>ache</li></ol>
ၵူႇ|kùù	<i>noun</i><br><ol><li>bud, bud of leaf or flower</li><li>block, bench, couch, bed</li></ol>
ၵူႇတူပ်ႉ|kùù tṵ̂ṵ̂p	<i>noun</i><br><ol><li>collapsible bed, cot</li></ol>
ၵူႇလိၵ်ႈ|kùù līk	<i>noun</i><br><ol><li>stand for books</li></ol>
ၵူႇလုၵ်ႈဢွၼ်ႇ|kùù lūk ʼàùn	<i>noun</i><br><ol><li>crib, cot</li></ol>
ၵူႇၼွၼ်း|kùù náún	<i>noun</i><br><ol><li>bedstead, bed</li></ol>
ၵူႇၼွၼ်းသွင်ၵေႃႉ|kùù náún sǎǔng kâ̰ṵ̂	<i>noun</i><br><ol><li>double bed</li></ol>
ၵူႈ|kūū|လွင်ႈၵူႈ	<i>noun</i><br><ol><li>pair.</li></ol><br><i>verb</i><br><ol><li>to retrieve.</li><li>borrow</li></ol><br><i>adj</i><br><ol><li>every</li></ol>
ၵူႈတီႈၵူႈတၢင်း|kūū tīī kūū tááng	<i>adv</i><br><ol><li>everywhere, all-over</li></ol>
ၵူႈပွၵ်ႈ|kūū pāūk	<i>adv</i><br><ol><li>every time</li></ol>
ၵူႈမိုဝ်ႉၵူႈဝၼ်း|kūū mṵ̂ḛ̂ kūū wán	<i>adv</i><br><ol><li>everyday, daily</li></ol>
ၵူႈမိူင်းမိူင်း|kūū móéng móéng	<i>adv</i><br><ol><li>every nation, international</li></ol>
ၵူႈယိမ်|kūū yǐm|လွင်ႈၵူႈယိမ်	<i>verb</i><br><ol><li>to borrow</li><li>to lend</li></ol>
ၵူႈဢၼ်|kūū ʼǎn	<i>adv</i><br><ol><li>every item, everything</li></ol>
ၵူႈၵေႃႉ|kūū kâ̰ṵ̂	<i>pron</i><br><ol><li>everybody, everyone</li></ol>
ၵူႈၶမ်ႈ|kūū khām	<i>adv</i><br><ol><li>every evening</li></ol>
ၵူႈၶိုၼ်း|kūū khúén	<i>adv</i><br><ol><li>every night</li></ol>
ၵူႈၶူဝ်း|kūū khó|လွင်ႈၵူႈၶူဝ်း	<i>verb</i><br><ol><li>take in, withdraw</li></ol>
ၵူႈၸဝ်ႉၼႂ်ဝၼ်းၶမ်ႈ|kūū tsâ̰ô̰ nǎǔě wán khām	<i>adv</i><br><ol><li>every day, every morning, noon and night; daily</li></ol>
ၵူႈၸိူဝ်ႉၵူႈပိူင်|kūū tsô̰ḛ̂ kūū pǒěng	<i>pron</i><br><ol><li>every kind, everything</li></ol>
ၵူႈၸူဝ်ႈၵူႈပၢၼ်|kūū tsō kūū pǎǎn	<i>adv</i><br><ol><li>everytime, all the time</li></ol>
ၵူႈၼႂ်|kūū nǎǔě	<i>adv</i><br><ol><li>every morning</li></ol>
ၵူႈၽၢႆႇၵူႈတၢင်း|kūū phààì kūū tááng	<i>adv</i><br><ol><li>every side, every direction</li></ol>
ၵူႉလႃႉႀႃႉမႅၵ်ႉၵႃႉ|kṵ̂ṵ̂ lâ̰â̰ xâ̰â̰ mḛ̂k kâ̰â̰	<i>name</i><br><ol><li>United Nations</li></ol>
ၵေသႃ|kěě sǎǎ	<i>noun</i><br><ol><li>hair</li></ol>
ၵေးလၢင်း|kéé lááng	<i>noun</i><br><ol><li>capital</li></ol>
ၵေးၸူး|kéé tsúú	<i>noun</i><br><ol><li>gratitude, grace, favor, kindness</li></ol>
ၵေႃ|kǎǔ	<i>noun</i><br><ol><li>cluster</li><li>committee, association</li></ol><br><i>verb</i><br><ol><li>meet, gather together</li></ol>
ၵေႃပူၵ်းပွင်ၶိုၼ်း|kǎǔ púúk pǎǔng khúén	<i>noun</i><br><ol><li>restoration committee</li></ol>
ၵေႃပွင်ၵၢၼ်|kǎǔ pǎǔng kǎǎn	<i>noun</i><br><ol><li>committee, executive committee</li></ol>
ၵေႃမႆႉ|kǎǔ mâ̰ḭ̂	<i>noun</i><br><ol><li>cluster or clump of trees</li></ol>
ၵေႃယိူဝ်ႈ|kǎǔ yōē	<i>noun</i><br><ol><li>clump of grass</li></ol>
ၵေႃယုၵ်ႉယွင်ႈ|kǎǔ yṵ̂k yāūng	<i>noun</i><br><ol><li>development committee</li></ol>
ၵေႃးၸႃႇ|káú tsàà	<i>noun</i><br><ol><li>epoch, era</li></ol>
ၵေႃၵူၺ်ႈ|kǎǔ kōī	<i>noun</i><br><ol><li>cluster of plantain or banana tree</li></ol>
ၵေႃၶဝ်ႈ|kǎǔ khāō	<i>noun</i><br><ol><li>cluster of rice plants</li></ol>
ၵေႃၽူႈတၢင်တူဝ်|kǎǔ phūū tǎǎng tǒ	<i>noun</i><br><ol><li>representative committee</li></ol>
ၵေႃႇ|kàù	<i>noun</i><br><ol><li>glue</li><li>beginning</li></ol><br><i>verb</i><br><ol><li>begin, be first</li><li>pile</li></ol>
ၵေႃႇငဝ်ႈ|kàù ngāō	<i>adv</i><br><ol><li>first, at the beginning</li></ol>
ၵေႃႇတမႃႉ|kàù tǎ mâ̰â̰	<i>noun</i><br><ol><li>(Buddhism) Gotama Buddha</li></ol>
ၵေႃႇမတီႇ|kàù mǎ tìì	<i>noun</i><br><ol><li>committee</li></ol>
ၵေႃႇသၢင်ႈ|လွင်ႈၵေႃႇသၢင်ႈ|kàù sāāng	<i>verb</i><br><ol><li>build, pile, heap up</li></ol>
ၵေႃႇၵွင်|kàù kǎǔng	<i>noun</i><br><ol><li>heap</li></ol>
ၵေႃႈ|kāū	<i>adv</i><br><ol><li>although, then, as well as</li></ol>
ၵေႃႈယႃႇ|kāū yàà	<i>conj</i><br><ol><li>although, even though, even if</li></ol>
ၵေႃႈယႃႇမၼ်း|kāū yàà mán	<i>adv</i><br><ol><li>so let it be, never mind</li></ol>
ၵေႃႉ|kâ̰ṵ̂	<i>noun</i><br><ol><li>person, friend, companion, associate</li></ol>
ၵေႃႉတမႃႉ|kâ̰ṵ̂ tǎ mâ̰â̰	<i>noun</i><br><ol><li>(Buddhism) Gotama Buddha</li></ol>
ၵေႃႉထုၵ်ႈပၼ်ငိုၼ်း|kâ̰ṵ̂ thūk pǎn ngúén	<i>noun</i><br><ol><li>banker</li></ol>
ၵေႃႉထုၵ်ႈလိၵ်ႈ|kâ̰ṵ̂ thūk līk	<i>noun</i><br><ol><li>publisher</li></ol>
ၵေႃႉမိုတ်ႈၵေႃႉၵိုဝ်း|kâ̰ṵ̂ mūēt kâ̰ṵ̂ kúé	<i>noun</i><br><ol><li>familiar friend</li></ol>
ၵေႃႉမိုဝ်ႉ|kâ̰ṵ̂ mṵ̂ḛ̂	<i>noun</i><br><ol><li>cook, chef</li></ol>
ၵေႃႉမၢႆ|kâ̰ṵ̂ mǎǎǐ	<i>noun</i><br><ol><li>fiance , fiancee</li></ol>
ၵေႃႉမၼ်ႈမၢႆ|kâ̰ṵ̂ mān mǎǎǐ	<i>noun</i><br><ol><li>fiance , fiancee</li></ol>
ၵေႃႉလဵဝ်|kâ̰ṵ̂ lǎěǒ	<i>noun</i><br><ol><li>one person, single person, alone</li></ol>
ၵေႃႉလႂ်|kâ̰ṵ̂ lǎǔě	<i>noun</i><br><ol><li>which one?, who?</li></ol>
ၵေႃႉလႂ်ၵေႃႉၼၼ်ႉ|kâ̰ṵ̂ lǎǔě kâ̰ṵ̂ nâ̰n	<i>pron</i><br><ol><li>each person</li></ol>
ၵေႃႉဢၼ်ၶၢမ်ႇတြႃး|kâ̰ṵ̂ ʼǎn khààm tráá	<i>noun</i><br><ol><li>accused person, defendant</li></ol>
ၵေႃႉဢၼ်ႁဵတ်းတြႃး|kâ̰ṵ̂ ʼǎn háét tráá	<i>noun</i><br><ol><li>complainant, plaintiff</li></ol>
ၵေႃႉၵၼ်|kâ̰ṵ̂ kǎn	<i>noun</i><br><ol><li>friend, companion, matching pair</li></ol>
ၵေႃႉၶၢမ်ႇဢမူၺ်ႇ|kâ̰ṵ̂ khààm ʼǎ mòì	<i>noun</i><br><ol><li>heir</li></ol>
ၵေႃႉၼၼ်ႉ|kâ̰ṵ̂ nâ̰n	<i>noun</i><br><ol><li>that person</li></ol>
ၵေႃႉၼႆႉ|kâ̰ṵ̂ nâ̰ḭ̂	<i>noun</i><br><ol><li>this person</li></ol>
ၵေႃႉႁပ်ႉ|kâ̰ṵ̂ hâ̰p	<i>pron</i><br><ol><li>welcomer, receiver</li></ol>
ၵေႃႉႁူႉၵေႃႉမိုတ်ႈ|kâ̰ṵ̂ hṵ̂ṵ̂ kâ̰ṵ̂ mūēt	<i>noun</i><br><ol><li>acquaintance</li></ol>
ၵေႃႉႁူႉၵေႃႉႁၼ်|kâ̰ṵ̂ hṵ̂ṵ̂ kâ̰ṵ̂ hǎn	<i>noun</i><br><ol><li>witness</li></ol>
ၵေႃႉႁူႉၸၵ်း|kâ̰ṵ̂ hṵ̂ṵ̂ tsák	<i>noun</i><br><ol><li>acquaintance</li></ol>
ၵေႃႉႁၵ်ႉ|kâ̰ṵ̂ hâ̰k	<i>pron</i><br><ol><li>lover, loved one</li></ol>
ၵေႇ|kèè	<i>adj</i><br><ol><li>few, not many</li></ol>
ၵဵင်း|káéng	<i>noun</i><br><ol><li>city</li><li>tripod</li></ol>
ၵဵင်းသၢမ်ၶႃ|káéng sǎǎm khǎǎ	<i>noun</i><br><ol><li>tripod</li></ol>
ၵဵင်ႈ|kāēng	<i>adj</i><br><ol><li>clear, clean</li></ol>
ၵဵင်ႈၵဵင်ႈ|kāēng kāēng	<i>adv</i><br><ol><li>completely clean</li></ol>
ၵဵင်ႈႁဵတ်း|လွင်ႈၵဵင်ႈႁဵတ်း|kāēng háét	<i>verb</i><br><ol><li>pretend, feign, sham</li></ol>
ၵဵပ်း|လွင်ႈၵဵပ်း|တၢင်းၵဵပ်း|káép	<i>verb</i><br><ol><li>to pick up</li><li>to gather; to collect</li><li>to adopt; to choose</li></ol><br><i>adj</i><br><ol><li>adopted</li></ol>
ၵဵပ်းလဵင်ႉ|လွင်ႈၵဵပ်းလဵင်ႉ|káép lâ̰ḛ̂ng	<i>verb</i><br><ol><li>adopt, take and feed.</li></ol>
ၵဵပ်းဢဝ်|လွင်ႈၵဵပ်းဢဝ်|káép ʼǎǒ	<i>verb</i><br><ol><li>pick up, take up or out, collect, gather, adopt, choose.</li></ol>
ၵဵပ်းၵွၵ်ႈၵဵပ်းၵၢင်|káép kāūk káép kǎǎng|လွင်ႈၵဵပ်းၵွၵ်ႈၵဵပ်းၵၢင်	<i>verb</i><br><ol><li>collect tax.</li></ol>
ၵဵဝ်|kǎěǒ	<i>noun</i><br><ol><li>column of light, column of smoke</li><li>jungle, wilderness</li></ol>
ၵဵဝ်ႇ|kàèò|လွင်ႈၵဵဝ်ႇ	<i>verb</i><br><ol><li>pertain to, be related to</li></ol>
ၵဵဝ်ႇၶွင်ႈ|kàèò khāūng|လွင်ႈၵဵဝ်ႇၶွင်ႈ	<i>verb</i><br><ol><li>have connection, relation with</li></ol>
ၵဵဝ်ႈ|လွင်ႈၵဵဝ်ႈ|kāēō	<i>verb</i><br><ol><li>wind around, encircle (as a creeper); repeat alternately</li></ol>
ၵဵဝ်ႈၵၢဝ်ႈ|kāēō kāāō|လွင်ႈၵဵဝ်ႈၵၢဝ်ႈ	<i>verb</i><br><ol><li>wind around, encircle (as a creeper); repeat alternately</li></ol>
ၵဵဝ်ႈၶိုၼ်ႈ|kāēō khūēn|လွင်ႈၵဵဝ်ႈၶိုၼ်ႈ	<i>verb</i><br><ol><li>climb</li></ol>
ၵဵဝ်ႈႁတ်ႉ|kāēō hâ̰t|လွင်ႈၵဵဝ်ႈႁတ်ႉ	<i>verb</i><br><ol><li>fasten by winding about</li></ol>
ၵဵဝ်ႉ|kâ̰ḛ̂ô̰|လွင်ႈၵဵဝ်ႉ	<i>verb</i><br><ol><li>chew, masticate</li></ol>
ၵဵဝ်ႉယိုၵ်းယၵ်း|လွင်ႈၵဵဝ်ႉယိုၵ်းယၵ်း|kâ̰ḛ̂ô̰ yúék yák	<i>verb</i><br><ol><li>masticate slightly, masticate insufficiently</li></ol>
ၵဵဝ်ႉဢိူင်ႈ|kâ̰ḛ̂ô̰ ʼōēng|လွင်ႈၵဵဝ်ႉဢိူင်ႈ	<i>verb</i><br><ol><li>ruminate, chew the cud</li></ol>
ၵဵၼ်|လွင်ႈၵဵၼ်|kǎěn	<i>verb</i><br><ol><li>roll up, twist together</li></ol>
ၵဵၼ်လိၵ်ႈ|kǎěn līk	<i>noun</i><br><ol><li>scroll, roll</li></ol>
ၵဵၼ်ၶူဝ်း|kǎěn khó	<i>noun</i><br><ol><li>luggage</li></ol>
ၵျုၼ်ႇ|kjùn	<i>name</i><br><ol><li>June.</li></ol>
ၵျူဝ်ႇ|kjò	<i>noun</i><br><ol><li>(astronomy) planet</li><li>(religion) one's guardian spirit</li></ol>
ၵျူႇလၢႆႇ|kjùù lààì	<i>name</i><br><ol><li>July.</li></ol>
ၵျေးၸူး|kjéé tsúú	<i>noun</i><br><ol><li>gratitude, grace, favor, kindness</li></ol>
ၵျေႃင်း|kjáúng	<i>noun</i><br><ol><li>school</li><li>(Buddhism) monastery</li></ol>
ၵျွင်း|kjáúng	<i>noun</i><br><ol><li>school</li><li>(Buddhism) monastery</li></ol>
ၵျွၵ်ႈတၢၼ်ႇ|kjāūk tààn	<i>noun</i><br><ol><li>slate pencil</li></ol>
ၵျွႃး	<i>verb</i><br><ol><li>to boast, brag</li></ol>
ၵျၢမ်ႇမႃႇ|kjààm màà	<i>noun</i><br><ol><li>karma.</li></ol>
ၵျႃႇပသၢၼ်ႇ|kjàà pǎ sààn	<i>noun</i><br><ol><li>front locks of hair often worn for adornment by young women</li></ol>
ၵျႃႇသပ်ႈပတေး|kjàà sāp pǎ téé	<i>noun</i><br><ol><li>(ဝၼ်း~) Thursday</li></ol>
ၵျႃႇသၢၼ်ႇ|kjàà sààn	<i>noun</i><br><ol><li>vermicelli</li></ol>
ၵျႃႇၺူဝ်ႉ|kjàà nyô̰	<i>noun</i><br><ol><li>thick soy sauce</li></ol>
ၵွင်|လွင်ႈၵွင်|kǎǔng	<i>noun</i><br><ol><li>(music) drum</li><li>heap</li></ol><br><i>verb</i><br><ol><li>collect, gather together, heap up, pile</li></ol>
ၵွင်လင်|kǎǔng lǎng|လွင်ႈၵွင်လင်	<i>verb</i><br><ol><li>turn one's back on, turn the back</li></ol>
ၵွင်လေႃး|kǎǔng láú|လွင်ႈၵွင်လေႃး	<i>verb</i><br><ol><li>pile up, heap up together</li></ol>
ၵွင်း|káúng	<i>noun</i><br><ol><li>back, ridge</li></ol>
ၵွင်းမူး|káúng múú	<i>noun</i><br><ol><li>pagoda.</li></ol>
ၵွင်းလင်|káúng lǎng	<i>noun</i><br><ol><li>back</li></ol>
ၵွင်းသၼ်လွႆ|káúng sǎn lǎǔǐ	<i>noun</i><br><ol><li>ridge of a mountain</li></ol>
ၵွင်းၵႅင်းပႃ|káúng kéng pǎǎ	<i>noun</i><br><ol><li>ridge of a fish's back</li></ol>
ၵွင်းၶုမ်|káúng khǔm	<i>noun</i><br><ol><li>burial mound</li></ol>
ၵွင်းၶူႈလင်|káúng khūū lǎng	<i>noun</i><br><ol><li>ridge of the nose</li></ol>
ၵွင်ၶိုၼ်ႈ|kǎǔng khūēn|လွင်ႈၵွင်ၶိုၼ်ႈ	<i>verb</i><br><ol><li>pile up, heap up</li></ol>
ၵွင်ႇ|kàùng|လွင်ႈၵွင်ႇ	<i>verb</i><br><ol><li>be convex, curve, bulge up, warp</li></ol>
ၵွင်ႇတၢင်း|kàùng tááng|လွင်ႈၵွင်ႇတၢင်း	<i>verb</i><br><ol><li>reconnoiter</li></ol>
ၵွင်ႇယွင်ႇ|kàùng yàùng	<i>noun</i><br><ol><li>squat</li></ol><br><i>adv</i><br><ol><li>in a squatting position</li></ol>
ၵွင်ႇၵေႃႈ|kàùng kāū	<i>noun</i><br><ol><li>back of the neck, nape of the neck, cords of the neck</li></ol>
ၵွင်ႇၸီႇ|kàùng tsìì	<i>noun</i><br><ol><li>council</li></ol>
ၵွင်ႈ|kāūng|လွင်ႈၵွင်ႈ	<i>noun</i><br><ol><li>tube, pipe, gun</li></ol><br><i>verb</i><br><ol><li>echo</li></ol>
ၵွင်ႈတွပ်း|kāūng táúp	<i>noun</i><br><ol><li>popgun</li></ol>
ၵွင်ႈပွတ်း|kāūng páút	<i>noun</i><br><ol><li>pistol</li></ol>
ၵွင်ႈယိုဝ်းၶိူင်ႈမိၼ်|kāūng yúé khōēng mǐn	<i>noun</i><br><ol><li>anti aircraft gun</li></ol>
ၵွင်ႈသုပ်းႁွၵ်ႇ|kāūng súp hàùk	<i>noun</i><br><ol><li>rifle with a bayonet</li></ol>
ၵွင်ႈၵၢင်ႇ|kāūng kààng	<i>noun</i><br><ol><li>weapon</li></ol>
ၵွင်ႈၸၢၵ်ႈ|kāūng tsāāk	<i>noun</i><br><ol><li>machine gun</li></ol>
ၵွင်ႈၾႆး|kāūng fáí	<i>noun</i><br><ol><li>flintlock</li></ol>
ၵွင်ႈၾႆးမႃႉ|kāūng fáí mâ̰â̰	<i>noun</i><br><ol><li>pistol</li></ol>
ၵွင်ႈၾႆးယၢဝ်း|kāūng fáí yááó	<i>noun</i><br><ol><li>refle</li></ol>
ၵွင်ႈၾႆးယႃႈ|kāūng fáí yāā	<i>noun</i><br><ol><li>pipe or tube for smoking</li></ol>
ၵွင်ႉ|kâ̰ṵ̂ng|လွင်ႈၵွင်ႉ	<i>noun</i><br><ol><li>poison, venom</li></ol><br><i>verb</i><br><ol><li>hook, catch with a hook, suspend by a hook</li></ol>
ၵွင်ႉငဝ်း|kâ̰ṵ̂ng ngáó	<i>noun</i><br><ol><li>shadow</li></ol>
ၵွင်ႉငူး|kâ̰ṵ̂ng ngúú	<i>noun</i><br><ol><li>venom from snake</li></ol>
ၵွင်ႉမိူဝ်ႇ|kâ̰ṵ̂ng mòè	<i>noun</i><br><ol><li>poison</li></ol>
ၵွင်ႉမႃႇၵွင်ႉၶေႃး|kâ̰ṵ̂ng màà kâ̰ṵ̂ng kháú|လွင်ႈၵွင်ႉမႃႇၵွင်ႉၶေႃး	<i>verb</i><br><ol><li>wrap around the neck and shoulder</li></ol>
ၵွင်ႉဝိူဝ်ႇ|kâ̰ṵ̂ng wòè	<i>noun</i><br><ol><li>poison</li></ol>
ၵွင်ႉဝႃႇၵွင်ႉၶေႃး|လွင်ႈၵွင်ႉဝႃႇၵွင်ႉၶေႃး|kâ̰ṵ̂ng wàà kâ̰ṵ̂ng kháú	<i>verb</i><br><ol><li>wrap around the neck and shoulder</li></ol>
ၵွတ်း|káút	<i>adj</i><br><ol><li>broke, lose money, goods, penniless, bankrupt</li></ol>
ၵွတ်းၽၢၼ်|káút phǎǎn	<i>adj</i><br><ol><li>broke, poor</li></ol>
ၵွတ်ႇ|kàùt|လွင်ႈၵွတ်ႇ	<i>verb</i><br><ol><li>hug</li></ol>
ၵွတ်ႇမိုဝ်း|kàùt múé|လွင်ႈၵွတ်ႇမိုဝ်း	<i>verb</i><br><ol><li>fold the arms</li></ol>
ၵွတ်ႇၵႆႇ|kàùt kàì|လွင်ႈၵွတ်ႇၵႆႇ	<i>verb</i><br><ol><li>fold the arms</li></ol>
ၵွတ်ႇၶေႃး|လွင်ႈၵွတ်ႇၶေႃး|kàùt kháú	<i>verb</i><br><ol><li>embrace</li></ol>
ၵွတ်ႇႁတ်ႉ|လွင်ႈၵွတ်ႇႁတ်ႉ|kàùt hâ̰t	<i>verb</i><br><ol><li>fold in the arms tightly</li></ol>
ၵွတ်ႇႁွမ်ႈ|kàùt hāūm|လွင်ႈၵွတ်ႇႁွမ်ႈ	<i>verb</i><br><ol><li>embrace, enfold, surround</li></ol>
ၵွပ်း|káúp	<i>noun</i><br><ol><li>bunch of bananas or plantains.</li></ol>
ၵွပ်းမႃႉ|káúp mâ̰â̰	<i>noun</i><br><ol><li>saddle.</li></ol>
ၵွပ်းလွင်လင်မႃႉ|káúp lǎǔng lǎng mâ̰â̰	<i>noun</i><br><ol><li>saddle cloth.</li></ol>
ၵွပ်းၵူၺ်ႈ|káúp kōī	<i>noun</i><br><ol><li>single comb of bananas.</li></ol>
ၵွပ်းၼင်ႈ|káúp nāng	<i>noun</i><br><ol><li>cushion, mattress.</li></ol>
ၵွပ်းၽႃႈၵွပ်း|káúp phāā káúp	<i>noun</i><br><ol><li>mattress.</li></ol>
ၵွပ်ႈ|လွင်ႈၵွပ်ႈ|kāūp	<i>verb</i><br><ol><li>attach, cling to.</li></ol>
ၵွပ်ႈပိူဝ်ႈ|kāūp pōē	<i>prep</i><br><ol><li>because.</li></ol>
ၵွပ်ႈသင်|kāūp sǎng	<i>adv</i><br><ol><li>why?, for what reason?</li></ol>
ၵွပ်ႈဢၼ်ၼၼ်ႉ|kāūp ʼǎn nâ̰n	<i>adv</i><br><ol><li>for that reason, because of that.</li></ol>
ၵွပ်ႈဢၼ်ၼႆႉ|kāūp ʼǎn nâ̰ḭ̂	<i>adv</i><br><ol><li>for this reason, because of this.</li></ol>
ၵွပ်ႈၸပ်း|kāūp tsáp|လွင်ႈၵွပ်ႈၸပ်း	<i>verb</i><br><ol><li>attach to, cling to or hang on closely.</li></ol>
ၵွပ်ႈၸေး|လွင်ႈၵွပ်ႈၸေး|kāūp tséé	<i>verb</i><br><ol><li>take along on one's back.</li></ol>
ၵွပ်ႈၼၼ်|kāūp nǎn	<i>conj</i><br><ol><li>therefore.</li></ol>
ၵွပ်ႈၼၼ်ႉ|kāūp nâ̰n	<i>conj</i><br><ol><li>on account of that.</li></ol>
ၵွပ်ႈၼႆ|kāūp nǎǐ	<i>conj</i><br><ol><li>therefore.</li></ol>
ၵွမ်း|လွင်ႈၵွမ်း|káúm	<i>verb</i><br><ol><li>stoop, bow, bow respectfully.</li></ol>
ၵွမ်းဝၢင်ႇ|káúm wààng|လွင်ႈၵွမ်းဝၢင်ႇ	<i>verb</i><br><ol><li>surrender</li></ol>
ၵွမ်းၽိတ်ႈ|káúm phīt|လွင်ႈၵွမ်းၽိတ်ႈ	<i>verb</i><br><ol><li>call, invite.</li></ol>
ၵွမ်ႇ|kàùm	<i>noun</i><br><ol><li>coffin</li></ol><br><i>verb</i><br><ol><li>recline and hold to the bosom</li></ol>
ၵွမ်ႇပျူႇတိူဝ်ႇ|kàùm pjùù tòè	<i>noun</i><br><ol><li>computer.</li></ol>
ၵွမ်ႇၵူၼ်းတၢႆ|kàùm kúún tǎǎǐ	<i>noun</i><br><ol><li>coffin</li></ol>
ၵွမ်ႈ|လွင်ႈၵွမ်ႈ|kāūm	<i>verb</i><br><ol><li>convert.</li></ol>
ၵွမ်ႉ|လွင်ႈၵွမ်ႉ|kâ̰ṵ̂m	<i>verb</i><br><ol><li>hang down the head.</li></ol>
ၵွမ်ႉၵႃႈ|kâ̰ṵ̂m kāā	<i>adv</i><br><ol><li>if only for, just for.</li></ol>
ၵွၵ်း|လွင်ႈၵွၵ်း|káúk	<i>noun</i><br><ol><li>cup, bowl, small vessel, concavity</li></ol><br><i>verb</i><br><ol><li>strip off, peel, skin, shell</li></ol>
ၵွၵ်းငိုၼ်း|káúk ngúén	<i>noun</i><br><ol><li>silver cup</li></ol>
ၵွၵ်းတွင်းလိူင်|káúk táúng lǒěng	<i>noun</i><br><ol><li>brass cup or vessel</li></ol>
ၵွၵ်းတွင်းလႅင်|káúk táúng lěng	<i>noun</i><br><ol><li>copper cup or vessel</li></ol>
ၵွၵ်းထူမ်ႇ|káúk thùùm	<i>noun</i><br><ol><li>spittoon</li></ol>
ၵွၵ်းပိူၵ်ႇ|káúk pòèk|လွင်ႈၵွၵ်းပိူၵ်ႇ	<i>verb</i><br><ol><li>peel, strip off</li></ol>
ၵွၵ်းမၢၵ်ႇပဝ်ႉ|káúk mààk pâ̰ô̰	<i>noun</i><br><ol><li>coconut cup</li></ol>
ၵွၵ်းမၢၵ်ႇဢုၼ်|káúk mààk ʼǔn	<i>noun</i><br><ol><li>coconut cup</li></ol>
ၵွၵ်းလိၼ်|káúk lǐn	<i>noun</i><br><ol><li>earthen cup</li></ol>
ၵွၵ်းလဵၵ်း|káúk láék	<i>noun</i><br><ol><li>iron cup</li></ol>
ၵွၵ်းလဵၵ်းၽိူၵ်ႇ|káúk láék phòèk	<i>noun</i><br><ol><li>tin cup</li></ol>
ၵွၵ်းလွၵ်ႉ|káúk lâ̰ṵ̂k	<i>noun</i><br><ol><li>lacquered cup</li></ol>
ၵွၵ်းသုၵ်ႈမိုဝ်း|káúk sūk múé	<i>noun</i><br><ol><li>basin for washing hands</li></ol>
ၵွၵ်းသႅင်|káúk sěng	<i>noun</i><br><ol><li>glass cup or tumbler</li></ol>
ၵွၵ်းဢၢင်ႇ|káúk ʼààng	<i>noun</i><br><ol><li>basin</li></ol>
ၵွၵ်းၵိၼ်ၼမ်ႉ|káúk kǐn nâ̰m	<i>noun</i><br><ol><li>drinking cup</li></ol>
ၵွၵ်းၵႅဝ်ႈ|káúk kēāō	<i>noun</i><br><ol><li>glass cup or tumble</li></ol>
ၵွၵ်းၶမ်း|káúk khám	<i>noun</i><br><ol><li>gold cup</li></ol>
ၵွၵ်းၼမ်ႉ|káúk nâ̰m	<i>noun</i><br><ol><li>water dipper, water cup</li></ol>
ၵွၵ်းၼမ်ႉမိုၵ်ႉ|káúk nâ̰m mṵ̂ḛ̂k	<i>noun</i><br><ol><li>inkstand, ink well</li></ol>
ၵွၵ်းၽၢၼ်ႇ|káúk phààn	<i>noun</i><br><ol><li>glass cup or tumble</li></ol>
ၵွၵ်းၾႆး|káúk fáí	<i>noun</i><br><ol><li>lamp</li></ol>
ၵွၵ်းႁူဝ်|káúk hǒ	<i>noun</i><br><ol><li>head</li></ol>
ၵွၵ်းႁၢတ်ႇ|káúk hààt	<i>noun</i><br><ol><li>scoop</li></ol>
ၵွၵ်ႇလိူတ်ႈ|လွင်ႈၵွၵ်ႇလိူတ်ႈ|kàùk lōēt	<i>verb</i><br><ol><li>scarify</li></ol>
ၵွၵ်ႇလၢင်း|kàùk lááng|လွင်ႈၵွၵ်ႇလၢင်း	<i>verb</i><br><ol><li>clean refuse from a dish or trench</li></ol>
ၵွၵ်ႇၵႅၵ်ႇ|လွင်ႈၵွၵ်ႇၵႅၵ်ႇ|kàùk kèk	<i>verb</i><br><ol><li>rinse</li></ol>
ၵွၵ်ႇၸဵၵ်ႇ|kàùk tsàèk	<i>noun</i><br><ol><li>goblet</li></ol>
ၵွၵ်ႇႁွင်ႈ|လွင်ႈၵွၵ်ႇႁွင်ႈ|kàùk hāūng	<i>verb</i><br><ol><li>dig a ditch or trench</li></ol>
ၵွၵ်ႈ|kāūk	<i>noun</i><br><ol><li>tax; duty; toll.</li></ol>
ၵွၼ်း|káún	<i>noun</i><br><ol><li>exhalation, smoke</li><li>leader, head</li></ol>
ၵွၼ်းတပ်ႉ|káún tâ̰p	<i>noun</i><br><ol><li>captain of troops</li></ol>
ၵွၼ်းမိူင်း|káún móéng	<i>noun</i><br><ol><li>ruler of a country</li></ol>
ၵွၼ်းဝဵင်း|káún wáéng	<i>noun</i><br><ol><li>mayor</li></ol>
ၵွၼ်းသိုၵ်း|káún súék	<i>noun</i><br><ol><li>leader of troops, commander</li></ol>
ၵွၼ်းၵႆႇ|káún kàì	<i>noun</i><br><ol><li>hen roost</li></ol>
ၵွၼ်းၶေႃ|káún khǎǔ	<i>adj</i><br><ol><li>autonomous, independent</li></ol><br><i>noun</i><br><ol><li>freedom</li></ol>
ၵွၼ်းၸႄႈမိူင်း|káún tsāāē móéng	<i>noun</i><br><ol><li>head of a province, province chief, governor</li></ol>
ၵွၼ်းၽူႈႁၢၼ်|káún phūū hǎǎn	<i>noun</i><br><ol><li>chief of police</li></ol>
ၵွၼ်းႁိူဝ်း|káún hóé	<i>noun</i><br><ol><li>captain of a ship</li></ol>
ၵွၼ်းႁူင်းႁဵၼ်း|káún húúng háén	<i>noun</i><br><ol><li>school principal</li></ol>
ၵွၼ်ၸွင်ႈ|kǎǔn tsāūng	<i>noun</i><br><ol><li>umbrella stay</li></ol>
ၵွၼ်ႁိူၼ်း|kǎǔn hóén	<i>noun</i><br><ol><li>rafter</li></ol>
ၵွၼ်ႇ|kàùn	<i>noun</i><br><ol><li>crane, stork</li></ol><br><i>prep</i><br><ol><li>before</li></ol>
ၵွၼ်ႈ|လွင်ႈၵွၼ်ႈ|kāūn	<i>noun</i><br><ol><li>lump, hard mass</li></ol><br><i>verb</i><br><ol><li>be in full, large, round cluster</li></ol>
ၵွၼ်ႈမၼ်း|kāūn mán	<i>noun</i><br><ol><li>animal grease, tallow, lard</li></ol>
ၵွၼ်ႈလိူတ်ႈ|kāūn lōēt	<i>noun</i><br><ol><li>cotted blood</li></ol>
ၵွၼ်ႈလိၼ်|kāūn lǐn	<i>noun</i><br><ol><li>lump of earth</li></ol>
ၵွၼ်ႈသီ|kāūn sǐǐ	<i>noun</i><br><ol><li>bar of soap</li></ol>
ၵွၼ်ႈၵိူဝ်ဝၢၼ်|kāūn kǒě wǎǎn	<i>noun</i><br><ol><li>lump of sugar, sugar candy</li></ol>
ၵွၼ်ႈၶဝ်ႈ|kāūn khāō	<i>noun</i><br><ol><li>lump of boiled rice</li></ol>
ၵွၼ်ႈၶႆ|kāūn khǎǐ	<i>noun</i><br><ol><li>internal fat of animals, tallow</li></ol>
ၵွၼ်ႈၼမ်ႉဢွႆႈ|kāūn nâ̰m ʼāūī	<i>noun</i><br><ol><li>lump of jaggery, hardened sugar, cane molasses</li></ol>
ၵွၼ်ႉ|kâ̰ṵ̂n|လွင်ႈၵွၼ်ႉ	<i>noun</i><br><ol><li>peg, tenon</li></ol><br><i>verb</i><br><ol><li>dip up</li></ol>
ၵွၼ်ႉၵိၼ်|လွင်ႈၵွၼ်ႉၵိၼ်|kâ̰ṵ̂n kǐn	<i>verb</i><br><ol><li>dip food and eat</li></ol>
ၵွၼ်ႉၽၵ်း|လွင်ႈၵွၼ်ႉၽၵ်း|kâ̰ṵ̂n phák	<i>verb</i><br><ol><li>dip up, take out of transfer food from one dish to another by dipping</li></ol>
ၵွႆး|káúí	<i>adv</i><br><ol><li>only, alone</li></ol>
ၵွႆးမၼ်း|káúí mán	<i>adv</i><br><ol><li>he alone, she alone</li></ol>
ၵွႆးၵဝ်ၶႃႈ|káúí kǎǒ khāā	<i>adv</i><br><ol><li>myself alone, I only</li></ol>
ၵွႆးၵႃႈ|káúí kāā	<i>conj</i><br><ol><li>although, nevertheless, but, however</li></ol>
ၵွႆႉ|kâ̰ṵ̂ḭ̂	<i>adv</i><br><ol><li>bend, curve</li></ol>
ၵၢင်ပဝ်ႇ|kǎǎng pàò	<i>adv</i><br><ol><li>bare, naked</li></ol>
ၵၢင်လၢႆ|kǎǎng lǎǎǐ	<i>adv</i><br><ol><li>bare, naked</li></ol>
ၵၢင်ဝၼ်းဢွၵ်ႇ|kǎǎng wán ʼàùk|လွင်ႈၵၢင်ဝၼ်းဢွၵ်ႇ	<i>noun</i><br><ol><li>sunrise</li></ol><br><i>verb</i><br><ol><li>rise</li></ol>
ၵၢင်း|kááng|လွင်ႈၵၢင်း	<i>noun</i><br><ol><li>lower jaw, chin</li></ol><br><i>verb</i><br><ol><li>to be free from; to be exempt from</li></ol>
ၵၢင်းလွတ်ႈ|လွင်ႈၵၢင်းလွတ်ႈ|kááng lāūt	<i>verb</i><br><ol><li>free, deliver</li></ol>
ၵၢင်းသၼ်ႇ|လွင်ႈၵၢင်းသၼ်ႇ|kááng sàn	<i>verb</i><br><ol><li>chatter</li></ol>
ၵၢင်းၵႆ|လွင်ႈၵၢင်းၵႆ|kááng kǎǐ	<i>verb</i><br><ol><li>be free from, be exempt from</li></ol>
ၵၢင်ၶိုမ်း|လွင်ႈၵၢင်ၶိုမ်း|kǎǎng khúém	<i>noun</i><br><ol><li>trap</li></ol><br><i>verb</i><br><ol><li>set a trap</li></ol>
ၵၢင်ႁႅဝ်ႉ|လွင်ႈၵၢင်ႁႅဝ်ႉ|kǎǎng hḛ̂â̰ô̰	<i>verb</i><br><ol><li>set a trap</li></ol>
ၵၢင်ႇ|kààng	<i>noun</i><br><ol><li>bow.</li><li>crossbow.</li></ol>
ၵၢင်ႈပႃ|kāāng pǎǎ	<i>noun</i><br><ol><li>bone of fish</li></ol>
ၵၢင်ႉ|kâ̰â̰ng	<i>noun</i><br><ol><li>chief of a village</li><li>stage</li></ol>
ၵၢင်ႉပပ်ႉ|kâ̰â̰ng pâ̰p	<i>noun</i><br><ol><li>book shelf</li></ol>
ၵၢင်ႉၵွင်ႈ|kâ̰â̰ng kāūng	<i>noun</i><br><ol><li>gun rack</li></ol>
ၵၢင်ႉၽိူင်း|kâ̰â̰ng phóéng	<i>noun</i><br><ol><li>hay stack</li></ol>
ၵၢတ်ႇ|kààt	<i>noun</i><br><ol><li>market.</li></ol>
ၵၢပ်ႇမိူဝ်ႈ|kààp mōē	<i>noun</i><br><ol><li>butterfly</li></ol>
ၵၢပ်ႇၼဵပ်ႉမိုဝ်း|kààp nâ̰ḛ̂p múé	<i>noun</i><br><ol><li>fingernail</li></ol>
ၵၢပ်ႇႁႄႉ|kààp hâ̰â̰ḛ̂	<i>noun</i><br><ol><li>armpit</li></ol>
ၵၢပ်ႈ|kāāp|လွင်ႈၵၢပ်ႈ	<i>verb</i><br><ol><li>(Buddhism) to offer (to a monk)</li><li>to join; to adhere</li></ol><br><i>noun</i><br><ol><li>period of time, age</li></ol>
ၵၢပ်ႈပၢၼ်|kāāp pǎǎn	<i>noun</i><br><ol><li>age, time</li></ol>
ၵၢပ်ႈမႂ်ႇ|kāāp màùè	<i>noun</i><br><ol><li>new period</li></ol>
ၵၢပ်ႈသွမ်း|လွင်ႈၵၢပ်ႈသွမ်း|kāāp sáúm	<i>verb</i><br><ol><li>offer something to the monk</li></ol>
ၵၢပ်ႈၵိၼ်|လွင်ႈၵၢပ်ႈၵိၼ်|kāāp kǐn	<i>verb</i><br><ol><li>hold</li></ol>
ၵၢမ်ႇ|kààm	<i>noun</i><br><ol><li>karma.</li></ol>
ၵၢမ်ႇလီ|kààm lǐǐ	<i>noun</i><br><ol><li>good luck, good fortune</li></ol><br><i>adj</i><br><ol><li>lucky, fortunate</li></ol>
ၵၢမ်ႇလီလႄႈ|kààm lǐǐ lāāē	<i>adv</i><br><ol><li>fortunately, luckily</li></ol>
ၵၢမ်ႇဢမ်ႇလီသေလႄႈ|kààm ʼàm lǐǐ sěě lāāē	<i>adv</i><br><ol><li>unfortunately, unluckily</li></ol>
ၵၢမ်ႇႁၢႆႉ|kààm hâ̰â̰ḭ̂	<i>adj</i><br><ol><li>unlucky</li></ol>
ၵၢမ်ႈ|kāām|လွင်ႈၵၢမ်ႈ	<i>verb</i><br><ol><li>coagulate</li></ol>
ၵၢဝ်း|kááó	<i>noun</i><br><ol><li>balsam plant</li></ol>
ၵၢဝ်ႇႁႃ|kààò hǎǎ|လွင်ႈၵၢဝ်ႇႁႃ	<i>verb</i><br><ol><li>speak nostalgically of (a friend)</li></ol>
ၵၢဝ်ႈ|kāāō	<i>noun</i><br><ol><li>calf</li></ol>
ၵၢဝ်ႉ|လွင်ႈၵၢဝ်ႉ|kâ̰â̰ô̰	<i>noun</i><br><ol><li>mill for crushing, sugar cane, cotton gin</li></ol><br><i>verb</i><br><ol><li>pull and bend down</li></ol>
ၵၢဝ်ႉၶိုတ်ႈဢွႆႈ|kâ̰â̰ô̰ khūēt ʼāūī	<i>noun</i><br><ol><li>mill for grinding sugar cane</li></ol>
ၵၢဝ်ႉၶိုတ်ႈၵုၺ်|kâ̰â̰ô̰ khūēt kǔǐ	<i>noun</i><br><ol><li>machine for cleaning cotton</li></ol>
ၵၢၵ်ႇငႅမ်ႈ|kààk ngēm	<i>noun</i><br><ol><li>fork</li></ol>
ၵၢၵ်ႇမွၵ်း|kààk máúk	<i>noun</i><br><ol><li>ladle</li></ol>
ၵၢၵ်ႇလၢင်း|kààk lááng	<i>noun</i><br><ol><li>fork</li></ol>
ၵၢၵ်ႇဝွၵ်း|kààk wáúk	<i>noun</i><br><ol><li>ladle</li></ol>
ၵၢၵ်ႇသေႃး|kààk sáú	<i>noun</i><br><ol><li>key</li></ol>
ၵၢၵ်ႇၶွၵ်းၶီႈႁူ|kààk kháúk khīī hǔǔ	<i>noun</i><br><ol><li>earpick</li></ol>
ၵၢၼ်|kǎǎn	<i>noun</i><br><ol><li>work; labor; business; job.</li></ol><br><i>prefix</i><br><ol><li>Used to precede verbs to form abstract nouns.</li></ol>
ၵၢၼ်ငၢၼ်း|kǎǎn ngáán	<i>noun</i><br><ol><li>work, business, project, assignment</li></ol>
ၵၢၼ်ပိူင်ၵူၼ်း|kǎǎn pǒěng kúún	<i>noun</i><br><ol><li>social service</li></ol>
ၵၢၼ်ပူင်ႁဵတ်း|kǎǎn pǔǔng háét	<i>noun</i><br><ol><li>assignment</li></ol>
ၵၢၼ်ပၢႆးမိူင်း|kǎǎn pááí móéng	<i>noun</i><br><ol><li>politics, political affairs</li></ol>
ၵၢၼ်ပၢႆးသိုၵ်း|kǎǎn pááí súék	<i>noun</i><br><ol><li>military affairs</li></ol>
ၵၢၼ်မၢၵ်ႈမီး|kǎǎn māāk míí	<i>noun</i><br><ol><li>business enterprise</li></ol>
ၵၢၼ်လိၵ်ႈႁိူၼ်း|kǎǎn līk hóén	<i>noun</i><br><ol><li>homework</li></ol>
ၵၢၼ်လုၵ်ႉၽိုၼ်ႉ|kǎǎn lṵ̂k phṵ̂ḛ̂n	<i>noun</i><br><ol><li>revolution, rebellion</li></ol>
ၵၢၼ်လဵင်ႉတွင်ႉ|kǎǎn lâ̰ḛ̂ng tâ̰ṵ̂ng	<i>noun</i><br><ol><li>livelihood</li></ol>
ၵၢၼ်သုၼ်ႇတူဝ်|kǎǎn sùn tǒ	<i>noun</i><br><ol><li>self enterprise, entrepreneur</li></ol>
ၵၢၼ်သဵၼ်ႈသၢႆတိတ်းတေႃႇ|kǎǎn sāēn sǎǎǐ tít tàù	<i>noun</i><br><ol><li>communications, telecommunications, network</li></ol>
ၵၢၼ်ဢုပ်ႉပိူင်ႇၽွင်းငမ်း|kǎǎn ʼṵ̂p pòèng pháúng ngám	<i>noun</i><br><ol><li>administrative work, administration, constitution</li></ol>
ၵၢၼ်း|káán|လွင်ႈၵၢၼ်း	<i>verb</i><br><ol><li>crawl</li></ol>
ၵၢၼ်းႁၢပ်ႇ|káán hààp	<i>noun</i><br><ol><li>yoke</li></ol>
ၵၢၼ်ၵႃႉၶၢႆ|kǎǎn kâ̰â̰ khǎǎǐ	<i>noun</i><br><ol><li>trading business, mercantile business</li></ol>
ၵၢၼ်ၸိူဝ်ႉၸၢတ်ႈ|kǎǎn tsô̰ḛ̂ tsāāt	<i>noun</i><br><ol><li>national movement</li></ol>
ၵၢၼ်ၼႃႈႁိူၼ်း|kǎǎn nāā hóén	<i>noun</i><br><ol><li>housework</li></ol>
ၵၢၼ်ၽူႈၸွပ်ႇ|kǎǎn phūū tsàùp	<i>noun</i><br><ol><li>detective work</li></ol>
ၵၢၼ်ၽၢႆႇၼႂ်း|kǎǎn phààì náúé	<i>noun</i><br><ol><li>spying work</li></ol>
ၵၢၼ်ႁဵတ်းလဵၼ်ႈ|kǎǎn háét lāēn	<i>noun</i><br><ol><li>hobby</li></ol>
ၵၢၼ်ႈၶေႃး|kāān kháú	<i>noun</i><br><ol><li>neck</li></ol>
ၵၢၼ်ႉပိူၼ်ႈ|လွင်ႈၵၢၼ်ႉပိူၼ်ႈ|kâ̰â̰n pōēn	<i>verb</i><br><ol><li>lose</li></ol>
ၵၢၼ်ႉပိူၼ်ႈဢဝ်|လွင်ႈၵၢၼ်ႉပိူၼ်ႈဢဝ်|kâ̰â̰n pōēn ʼǎǒ	<i>verb</i><br><ol><li>break off</li></ol>
ၵၢႆးၶူမ်း|လွင်ႈၵၢႆးၶူမ်း|kááí khúúm	<i>verb</i><br><ol><li>itch</li></ol>
ၵၢႆၵႂႃႇ|လွင်ႈၵၢႆၵႂႃႇ|kǎǎǐ kwàà	<i>verb</i><br><ol><li>go by or near</li></ol>
ၵၢႆႇ|လွင်ႈၵၢႆႇ|kààì	<i>verb</i><br><ol><li>erect</li></ol>
ၵၢႆႇၵွၼ်|လွင်ႈၵၢႆႇၵွၼ်|kààì kǎǔn	<i>verb</i><br><ol><li>erect rafters</li></ol>
ၵၢႆႇၵႂၢမ်း|kààì kwáám|လွင်ႈၵၢႆႇၵႂၢမ်း	<i>verb</i><br><ol><li>couple words together</li></ol>
ၵၢႆႇၶူဝ်|လွင်ႈၵၢႆႇၶူဝ်|kààì khǒ	<i>verb</i><br><ol><li>bridge, make a bridge over</li></ol>
ၵၢႆႇၶႃပႄ|kààì khǎǎ pǎǎě	<i>noun</i><br><ol><li>cross</li></ol>
ၵၵ်း|လွင်ႈၵၵ်း|kák	<i>verb</i><br><ol><li>stutter, stammer</li></ol>
ၵၵ်းမိုဝ်းႁွင်ႉ|လွင်ႈၵၵ်းမိုဝ်းႁွင်ႉ|kák múé hâ̰ṵ̂ng	<i>verb</i><br><ol><li>wave</li></ol>
ၵၼ်|kǎn	<i>noun</i><br><ol><li>part, chapter</li></ol>
ၵၼ်း|kán	<i>noun</i><br><ol><li>handle</li></ol>
ၵၼ်းမိတ်ႈ|kán mīt	<i>noun</i><br><ol><li>knife handle</li></ol>
ၵၼ်းၸွင်ႈ|kán tsāūng	<i>noun</i><br><ol><li>umbrella handle</li></ol>
ၵၼ်ႁူဝ်|kǎn hǒ	<i>noun</i><br><ol><li>soul</li></ol>
ၵၼ်ႇ|kàn	<i>noun</i><br><ol><li>Virgo, the sixth sign of the Zodiac</li></ol>
ၵၼ်ႇတရ	<i>noun</i><br><ol><li>desert</li></ol>
ၵၼ်ႇတရထိူၼ်ႇ|kàn tǎ rǎ thòèn	<i>noun</i><br><ol><li>jungle</li></ol>
ၵၼ်ႇတေႃး|လွင်ႈၵၼ်ႇတေႃး|kàn táú	<i>verb</i><br><ol><li>pay homage</li></ol>
ၵၼ်ႇၺႃႇ|kàn nyàà	<i>noun</i><br><ol><li>unmarried maiden, virgin</li></ol>
ၵၼ်ႈၶဝ်ႈၵၼ်ႈၼမ်ႉ|kān khāō kān nâ̰m	<i>adj</i><br><ol><li>destitute</li></ol>
ၵၼ်ႈၶၢမ်ႇ|kān khààm|လွင်ႈၵၼ်ႈၶၢမ်ႇ	<i>verb</i><br><ol><li>bear patiently, bear</li></ol>
ၵၼ်ႈႁႄႉ|လွင်ႈၵၼ်ႈႁႄႉ|kān hâ̰â̰ḛ̂	<i>verb</i><br><ol><li>prevent</li></ol>
ၵၼ်ႉ|လွင်ႈၵၼ်ႉ|kâ̰n	<i>verb</i><br><ol><li>rape</li></ol>
ၵၼ်ႉၶတ်းၸႂ်|လွင်ႈၵၼ်ႉၶတ်းၸႂ်|kâ̰n khát tsǎǔě	<i>verb</i><br><ol><li>struggle</li></ol>
ၵၼ်ႉၼၢင်းယိင်း|လွင်ႈၵၼ်ႉၼၢင်းယိင်း|kâ̰n nááng yíng	<i>verb</i><br><ol><li>rape</li></ol>
ၵၼၢၼ်း|kǎ náán	<i>noun</i><br><ol><li>numeral</li></ol>
ၵႂ်ႈ|kāūē|လွင်ႈၵႂ်ႈ	<i>verb</i><br><ol><li>swelling , swell.</li></ol>
ၵႂ်ႈပွင်း|kāūē páúng|လွင်ႈၵႂ်ႈပွင်း	<i>verb</i><br><ol><li>swelling swell.</li></ol>
ၵႂၢင်|kwǎǎng|တူဝ်	<i>noun</i><br><ol><li>deer</li></ol>
ၵႂၢမ်းတႆး|kwáám táí	<i>name</i><br><ol><li>the Shan language (especially spoken)</li></ol>
ၵႂၢႆး|kwááí|တူဝ်	<i>noun</i><br><ol><li>water buffalo.</li></ol>
ၵႂႃႇ|လွင်ႈၵႂႃႇ|kwàà	<i>verb</i><br><ol><li>to go</li></ol>
ၵႃ|kǎǎ	<i>noun</i><br><ol><li>crow</li></ol>
ၵႃလမ်|kǎǎ lǎm	<i>noun</i><br><ol><li>crow</li></ol>
ၵႃလူၼ်ႇ|kǎǎ lùùn	<i>noun</i><br><ol><li>garuda</li></ol>
ၵႃဝၢဝ်ႇ|kǎǎ wààò	<i>noun</i><br><ol><li>kite</li></ol>
ၵႃသႅဝ်း|kǎǎ séáó	<i>noun</i><br><ol><li>long-tailed Edolius.</li></ol>
ၵႃဢိုဝ်ႈ|kǎǎ ʼūē|တူဝ်	<i>noun</i><br><ol><li>dove, pigeon</li></ol>
ၵႃး|káá|လွင်ႈၵႃး	<i>noun</i><br><ol><li>motor car, car, automobile</li></ol><br><i>verb</i><br><ol><li>to be apart, to be distant</li></ol>
ၵႃးတိုၵ်းလဵၵ်း|káá túék láék	<i>noun</i><br><ol><li>tank</li></ol>
ၵႃးတူဝ်ယၢဝ်း|káá tǒ yááó	<i>noun</i><br><ol><li>van, truck</li></ol>
ၵႃးတူႈ|káá tūū	<i>noun</i><br><ol><li>van, truck</li></ol>
ၵႃးတၢင်ႇယုၵ်းယၵ်း|káá tààng yúk yák	<i>noun</i><br><ol><li>dustcart, dustbins, garbage truck</li></ol>
ၵႃးတၢင်ႇၵုၼ်ႇ|káá tààng kùn	<i>noun</i><br><ol><li>truck</li></ol>
ၵႃးတၢင်ႇၵူၼ်း|káá tààng kúún	<i>noun</i><br><ol><li>bus, passenger car</li></ol>
ၵႃးတၢင်ႇၵႃး|káá tààng káá	<i>noun</i><br><ol><li>tow truck, breakdown truck</li></ol>
ၵႃးတၢင်ႇၶီႈယိူဝ်ႈ|káá tààng khīī yōē	<i>noun</i><br><ol><li>dustcart, dustbins, garbage truck</li></ol>
ၵႃးတၢင်ႇၼမ်ႉမၼ်း|káá tààng nâ̰m mán	<i>noun</i><br><ol><li>tanker</li></ol>
ၵႃးတႅင်ႉ|káá tḛ̂ng	<i>noun</i><br><ol><li>tank</li></ol>
ၵႃးထုၺ်လိၼ်|káá thǔǐ lǐn	<i>noun</i><br><ol><li>bulldozer</li></ol>
ၵႃးထႆ|káá thǎǐ	<i>noun</i><br><ol><li>tractor, tractor trailer</li></ol>
ၵႃးယုၵ်ႉၶူဝ်း|káá yṵ̂k khó	<i>noun</i><br><ol><li>forklift, truck, crane</li></ol>
ၵႃးလၢၵ်ႈ|káá lāāk	<i>noun</i><br><ol><li>armored car</li></ol>
ၵႃးသလုၼ်း|káá sǎ lún	<i>noun</i><br><ol><li>covered, luxury car, saloon, sedan</li></ol>
ၵႃးၶေၽႆး|káá khěě pháí	<i>noun</i><br><ol><li>fire engine</li></ol>
ၵႃးၶႄႉၶဵင်ႇ|káá khâ̰â̰ḛ̂ khàèng	<i>noun</i><br><ol><li>racer, racing car, racecar</li></ol>
ၵႃးၸိပ်ႉ|káá tsḭ̂p	<i>noun</i><br><ol><li>jeep</li></ol>
ၵႃးၸၢင်ႈ|káá tsāāng	<i>noun</i><br><ol><li>hired car, taxi, cab</li></ol>
ၵႃးႁူင်းႁဵၼ်း|káá húúng háén	<i>noun</i><br><ol><li>school bus</li></ol>
ၵႃၵႄ|kǎǎ kǎǎě	<i>noun</i><br><ol><li>pigeon</li></ol>
ၵႃၶူဝ်ႇ|kǎǎ khò	<i>noun</i><br><ol><li>dove, pigeon</li></ol>
ၵႃၶၢပ်ႇ|kǎǎ khààp	<i>noun</i><br><ol><li>jay</li></ol>
ၵႃၸႆး|kǎǎ tsáí	<i>noun</i><br><ol><li>snakebird, cormorant</li></ol>
ၵႃႇထႃႇ|kàà thàà	<i>noun</i><br><ol><li>(Buddhism) gatha; mantra or verse or charm</li></ol>
ၵႃႇမ	<i>noun</i><br><ol><li>sensual desire, passion, lust</li></ol>
ၵႃႇမတၼ်ႇၼႃႇ|kàà mǎ tàn nàà	<i>noun</i><br><ol><li>sensual desire, passion, lust</li></ol>
ၵႃႇမၵုၼ်ႇ|kàà mǎ kùn	<i>noun</i><br><ol><li>sensual enjoyment, sexual intercourse.</li></ol>
ၵႃႇယ	<i>noun</i><br><ol><li>body, physique</li></ol>
ၵႃႇယၵမ်ႇ|kàà yǎ kàm	<i>noun</i><br><ol><li>act</li></ol>
ၵႃႇရဝ	<i>verb</i><br><ol><li>respect</li></ol>
ၵႃႇလ	<i>noun</i><br><ol><li>time</li><li>epidemic, disease</li></ol>
ၵႃႇလၶေႃးၵႂ်ႈ|kàà lǎ kháú kāūē	<i>noun</i><br><ol><li>anthrax</li></ol>
ၵႃႇလၼ်ႇ|kàà làn	<i>noun</i><br><ol><li>gallon</li></ol>
ၵႃႇလႃႉသႃး|kàà lâ̰â̰ sáá	<i>noun</i><br><ol><li>person in his youthful prime</li><li>wild, reckless man</li><li>person obedient to his passion</li><li>fast man (with women)</li></ol>
ၵႃႇၽီႇ|kàà phìì	<i>noun</i><br><ol><li>coffee</li></ol>
ၵႃႈ|kāā|လွင်ႈၵႃႈ	<i>noun</i><br><ol><li>price, cost, fee</li><li>seedling</li></ol><br><i>verb</i><br><ol><li>dance</li></ol>
ၵႃႈတီႈ|kāā tīī	<i>prep</i><br><ol><li>at, to</li></ol>
ၵႃႈတီႈတႂ်ႈ|kāā tīī tāūē	<i>adv</i><br><ol><li>under, beneath, below</li></ol><br><i>adj</i><br><ol><li>under, beneath</li></ol>
ၵႃႈတီႈၼၼ်ႈ|kāā tīī nān	<i>adv</i><br><ol><li>there</li></ol>
ၵႃႈတီႈၼႆႈ|kāā tīī nāī	<i>adv</i><br><ol><li>here</li></ol>
ၵႃႈတူၵ်းၶၼ်ယွမ်း|kāā túúk khǎn yáúm	<i>noun</i><br><ol><li>decrease in price, decrease in value, deflation</li></ol>
ၵႃႈတႂ်ႈ|kāā tāūē	<i>adv</i><br><ol><li>under, beneath, below</li></ol><br><i>adj</i><br><ol><li>under, beneath</li></ol>
ၵႃႈတႃႈ|kāā tāā	<i>noun</i><br><ol><li>ferriage, cost to ride a ferry, docking fee, landing fee</li></ol>
ၵႃႈထုၵ်ႇ|kāā thùk	<i>adj</i><br><ol><li>cheap, low price</li></ol>
ၵႃႈပုၼ်ႉ|kāā pṵ̂n	<i>adv</i><br><ol><li>over there, yonder</li></ol><br><i>prep</i><br><ol><li>beyond</li></ol>
ၵႃႈပေႃး|kāā páú	<i>adj</i><br><ol><li>cheap</li></ol>
ၵႃႈပႅင်း|kāā péng	<i>adj</i><br><ol><li>expensive, costly</li></ol>
ၵႃႈမၼ်း|kāā mán	<i>noun</i><br><ol><li>price</li></ol>
ၵႃႈယွမ်း|kāā yáúm	<i>noun</i><br><ol><li>decreased price</li></ol>
ၵႃႈယႂ်ႇ|kāā yàùè|တၢင်းၵႃႈယႂ်ႇ	<i>noun</i><br><ol><li>high price</li></ol><br><i>adj</i><br><ol><li>expensive, costly</li></ol>
ၵႃႈလႂ်|kāā lǎǔě	<i>adv</i><br><ol><li>where?</li></ol>
ၵႃႈဢူၼ်ႈ|kāā ʼūūn	<i>verb</i><br><ol><li>dance gracefully</li></ol>
ၵႃႈဢေႇ|kāā ʼèè	<i>adj</i><br><ol><li>cheap, low price</li></ol>
ၵႃႈၵေႇ|kāā kèè	<i>adj</i><br><ol><li>cheap, low price</li></ol>
ၵႃႈၵၼ်|kāā kǎn	<i>verb</i><br><ol><li>be equal to, as much as</li></ol>
ၵႃႈၶိုၼ်ႈၶၼ်ၶိုၼ်ႈ|kāā khūēn khǎn khūēn	<i>verb</i><br><ol><li>advance in price, increase in price, inflation</li></ol>
ၵႃႈၶီႇ|kāā khìì	<i>noun</i><br><ol><li>cost of transportation, fare</li></ol>
ၵႃႈၶီႈငိုၼ်း|kāā khīī ngúén	<i>noun</i><br><ol><li>interest rate</li></ol>
ၵႃႈၶၢတ်ႈ|kāā khāāt	<i>noun</i><br><ol><li>wages, rent</li></ol>
ၵႃႈၶၢႆ|kāā khǎǎǐ	<i>noun</i><br><ol><li>sale price</li></ol>
ၵႃႈၶၼ်|kāā khǎn	<i>noun</i><br><ol><li>price, worth, value</li></ol>
ၵႃႈၶၼ်မၼ်း|kāā khǎn mán	<i>noun</i><br><ol><li>price, worth, value</li></ol>
ၵႃႈၸၢင်ႈ|kāā tsāāng	<i>noun</i><br><ol><li>wages, rent, rental fee</li></ol>
ၵႃႈၸၢတ်ႈ|kāā tsāāt	<i>verb</i><br><ol><li>act, dance</li></ol>
ၵႃႈၼင်ႇဢၼ်|kāā nàng ʼǎn	<i>adv</i><br><ol><li>according as, according to</li></ol>
ၵႃႈၼိူဝ်|kāā nǒě	<i>adv</i><br><ol><li>above, over</li></ol><br><i>prep</i><br><ol><li>above, over</li></ol>
ၵႃႈၼွၵ်ႈ|kāā nāūk	<i>noun</i><br><ol><li>outside space</li></ol><br><i>adv</i><br><ol><li>outside</li></ol>
ၵႃႈၼၼ်ႈ|kāā nān	<i>adv</i><br><ol><li>there</li></ol>
ၵႃႈၼႂ်း|kāā náúé	<i>noun</i><br><ol><li>inside space</li></ol><br><i>adj</i><br><ol><li>within, inside of</li></ol>
ၵႃႈၼႃႈ|kāā nāā	<i>prep</i><br><ol><li>before, to the front</li></ol>
ၵႃႈၼႆႈ|kāā nāī	<i>adv</i><br><ol><li>here</li></ol>
ၵႃႈၼႆႉ|kāā nâ̰ḭ̂	<i>adv</i><br><ol><li>thus, as this, as much as this, as large as this</li></ol>
ၵႃႈႁိုဝ်|kāā hǔě	<i>adv</i><br><ol><li>how much?</li></ol>
ၵႃႈႁႅင်း|kāā héng	<i>noun</i><br><ol><li>cost of strength, wage</li></ol>
ၵႃႉ|kâ̰â̰	<i>verb</i><br><ol><li>trade, buy and sell</li></ol>
ၵႃႉယွႆႈၵႃႉယႅမ်း|kâ̰â̰ yāūī kâ̰â̰ yém	<i>verb</i><br><ol><li>retail</li></ol>
ၵႃႉၶၢႆ|kâ̰â̰ khǎǎǐ|လွင်ႈၵႃႉၶၢႆ	<i>verb</i><br><ol><li>trade, sell, exchange goods, barter</li></ol>
ၵႄးၼမ်ႉ|kááé nâ̰m	<i>noun</i><br><ol><li>river</li></ol>
ၵႄႇ|kààè|လွင်ႈၵႄႇ	<i>noun</i><br><ol><li>headman</li></ol><br><i>verb</i><br><ol><li>to deliver from evil or danger</li><li>to save</li></ol>
ၵႄႇထွင်ႇ|kààè thàùng	<i>noun</i><br><ol><li>jail keeper, bailiff</li></ol>
ၵႄႇယဝ်ႉ|kààè yâ̰ô̰	<i>verb</i><br><ol><li>mature age, middle age</li></ol>
ၵႄႇလူင်|kààè lǔǔng	<i>noun</i><br><ol><li>leader, chief</li></ol>
ၵႄႇဝၢၼ်ႈ|kààè wāān	<i>noun</i><br><ol><li>headman, chief of a village</li></ol>
ၵႄႇသၢင်းၽေႃး|kààè sááng pháú	<i>noun</i><br><ol><li>captain of a ship</li></ol>
ၵႄႇသႄႇ|kààè sààè	<i>verb</i><br><ol><li>free, deliver, release</li></ol>
ၵႄႇဢွၼ်ႇၸၢႆး|kààè ʼàùn tsááí	<i>noun</i><br><ol><li>valets, butlers</li></ol>
ၵႄႇၵၢင်ႉ|kààè kâ̰â̰ng	<i>noun</i><br><ol><li>headman, chief of a village</li></ol>
ၵႄႇၶျွတ်ႈ|kààè khjāūt	<i>verb</i><br><ol><li>deliver, save from evil</li></ol>
ၵႄႇၶႅၼ်ႉ|kààè khḛ̂n	<i>adj</i><br><ol><li>small, old age</li></ol>
ၵႄႇၸူၼ်|kààè tsǔǔn	<i>noun</i><br><ol><li>gang leader</li></ol>
ၵႄႇႁူဝ်ႁၢၼ်|kààè hǒ hǎǎn	<i>noun</i><br><ol><li>military officer</li></ol>
ၵႄႈ|လွင်ႈၵႄႈ|kāāē	<i>verb</i><br><ol><li>to undo.</li></ol><br><i>noun</i><br><ol><li>space, crack</li></ol><br><i>prep</i><br><ol><li>between, in the middle of</li></ol>
ၵႄႈပွႆႇထၢမ်လိၵ်ႈ|kāāē pàùì thǎǎm līk	<i>verb</i><br><ol><li>take an examination</li><li>take a school test</li></ol>
ၵႄႈလိတ်ႈ|kāāē līt	<i>noun</i><br><ol><li>unite, unloose, unroll, find a solution</li></ol>
ၵႄႈဢူၵ်း|kāāē ʼúúk	<i>noun</i><br><ol><li>center of the chest</li></ol>
ၵႄႈၵူၼ်းတင်းၼမ်|kāāē kúún táng nǎm	<i>prep</i><br><ol><li>among</li></ol>
ၵႄႈၸဵင်ႇ|kāāē tsàèng	<i>noun</i><br><ol><li>corner</li></ol>
ၵႄႈႁူၺ်ႈၵႄႈလွႆ|kāāē hōī kāāē lǎǔǐ	<i>noun</i><br><ol><li>valley</li></ol>
ၵႄႉ|kâ̰â̰ḛ̂	<i>noun</i><br><ol><li>tasteless, be lacking in flavor</li></ol>
ၵႅင်|kěng	<i>noun</i><br><ol><li>to make or make as or into a curry, soup, or stew.</li></ol>
ၵႅင်း|kéng	<i>noun</i><br><ol><li>religious sect</li></ol>
ၵႅင်းဢုပ်ႉ|kéng ʼṵ̂p	<i>noun</i><br><ol><li>(Buddhism) Buddhist bishop</li></ol>
ၵႅင်းႁွမ်|kéng hǎǔm	<i>noun</i><br><ol><li>cinnamon</li></ol>
ၵႅင်ႈယဝ်ႉၵႅင်ႈယွၵ်ႇ|kēng yâ̰ô̰ kēng yàùk|လွင်ႈၵႅင်ႈယဝ်ႉၵႅင်ႈယွၵ်ႇ	<i>verb</i><br><ol><li>pretend in jest; tease playfully</li></ol>
ၵႅတ်း|လွင်ႈၵႅတ်း|két	<i>verb</i><br><ol><li>cut</li></ol>
ၵႅတ်းၶူၼ်ႁူဝ်|két khǔǔn hǒ|လွင်ႈၵႅတ်းၶူၼ်ႁူဝ်	<i>verb</i><br><ol><li>cut the hair</li></ol>
ၵႅတ်းၶၢတ်ႇ|လွင်ႈၵႅတ်းၶၢတ်ႇ|két khààt	<i>verb</i><br><ol><li>cut off, bite off</li></ol>
ၵႅတ်းၼဵပ်ႉမိုဝ်း|két nâ̰ḛ̂p múé|လွင်ႈၵႅတ်းၼဵပ်ႉမိုဝ်း	<i>verb</i><br><ol><li>cut the nail, clip the nail</li></ol>
ၵႅတ်ႇ|kèt|လွင်ႈၵႅတ်ႇ	<i>verb</i><br><ol><li>head off, thwart, hinder, obstruct</li></ol>
ၵႅတ်ႇၶႄ|kèt khǎǎě|လွင်ႈၵႅတ်ႇၶႄ	<i>verb</i><br><ol><li>hinder, protect from, defend from</li></ol>
ၵႅပ်ႇ|kèp	<i>noun</i><br><ol><li>rice husk; rice hull; rice chaff</li></ol>
ၵႅပ်ႈ|kēp	<i>adj</i><br><ol><li>narrow, contracted.</li></ol>
ၵႅပ်ႉၼိုင်ႈ|kḛ̂p nūēng	<i>noun</i><br><ol><li>a moment, a short time, in a short time, soon, temporarily.</li></ol>
ၵႅမ်|လွင်ႈၵႅမ်|kěm	<i>noun</i><br><ol><li>deputy</li></ol><br><i>verb</i><br><ol><li>to put, place or fasten on lengthwise</li><li>to keep close to the side of</li><li>to support; to help</li></ol>
ၵႅမ်တမတႃႉ|kěm tǎ mǎ tâ̰â̰	<i>noun</i><br><ol><li>Vice President.</li></ol>
ၵႅမ်း|kém|လွင်ႈၵႅမ်း	<i>verb</i><br><ol><li>take hold of.</li></ol>
ၵႅမ်ၶုၼ်ပွင်ၸိုင်ႈ|kěm khǔn pǎǔng tsūēng	<i>noun</i><br><ol><li>deputy minister of a cabinet ministry</li></ol>
ၵႅမ်ၶုၼ်သိုၵ်း|kěm khǔn súék	<i>noun</i><br><ol><li>warrant office of a military unit</li></ol>
ၵႅမ်ၶုၼ်ၸီႉသင်ႇ|kěm khǔn tsḭ̂ḭ̂ sàng	<i>noun</i><br><ol><li>deputy director</li></ol>
ၵႅမ်ၶုၼ်ႁၢၼ်|kěm khǔn hǎǎn	<i>noun</i><br><ol><li>sergeant major of a military unit</li></ol>
ၵႅမ်ႁူဝ်ပဝ်ႈ|kěm hǒ pāō	<i>noun</i><br><ol><li>Vice-chairman.</li></ol>
ၵႅမ်ႈ|kēm	<i>noun</i><br><ol><li>cheek.</li></ol>
ၵႅမ်ႈလွၵ်း|kēm láúk	<i>noun</i><br><ol><li>dimple.</li></ol>
ၵႅမ်ႈၶွင်ႇ|kēm khàùng	<i>noun</i><br><ol><li>pink cheeked, rosy cheek.</li></ol>
ၵႅဝ်ႈသႅင်|kēāō sěng	<i>noun</i><br><ol><li>precious stone, glass</li></ol>
ၵႅၵ်း|kék	<i>adj</i><br><ol><li>fake, not real</li></ol>
ၵႅၼ်|လွင်ႈၵႅၼ်|kěn	<i>verb</i><br><ol><li>hang, suspend</li></ol><br><i>noun</i><br><ol><li>jinx</li></ol><br><i>adj</i><br><ol><li>jinxed</li></ol>
ၵႅၼ်တပ်း|kěn táp	<i>noun</i><br><ol><li>liver</li></ol>
ၵႅၼ်ထီး|kěn thíí	<i>noun</i><br><ol><li>rod of an umbrella; rod of the umbrella of a pagoda</li></ol>
ၵႅၼ်မႆႉ|kěn mâ̰ḭ̂	<i>noun</i><br><ol><li>heart of a tree</li></ol>
ၵႅၼ်ယူၵ်ႇ|kěn yùùk	<i>noun</i><br><ol><li>heart of the wild plantain tree</li></ol>
ၵႅၼ်သႆႈ|kěn sāī	<i>noun</i><br><ol><li>core of certain vegetable</li></ol>
ၵႅၼ်း|kén	<i>adj</i><br><ol><li>sore, ache</li></ol>
ၵႅၼ်းၸႂ်|kén tsǎǔě	<i>adj</i><br><ol><li>distressed</li></ol>
ၵႅၼ်ၵူၺ်ႈ|kěn kōī	<i>noun</i><br><ol><li>heart of the plantain tree</li></ol>
ၵႅၼ်ၸၢၵ်ႈ|kěn tsāāk	<i>noun</i><br><ol><li>wheel of a block or pulley</li></ol>
ၵႅၼ်ႁူၺ်ႇတႃ|kěn hòì tǎǎ	<i>noun</i><br><ol><li>pupil</li></ol>
ၵႅၼ်ႇ|kèn	<i>noun</i><br><ol><li>hard</li></ol><br><i>adj</i><br><ol><li>prosperous in life</li></ol>
ၵႅၼ်ႇလၵ်း|kèn lák	<i>adv</i><br><ol><li>truly, certainly</li></ol>
ၵႅၼ်ႇဝၢၼ်|kèn wǎǎn|လွင်ႈၵႅၼ်ႇဝၢၼ်	<i>verb</i><br><ol><li>be ignorant, unable to understand</li></ol>
ၵႅၼ်ႇၶႅင်|kèn khěng|လွင်ႈၵႅၼ်ႇၶႅင်	<i>verb</i><br><ol><li>be rigid, tough, strong</li></ol>
ၵႅၼ်ႇၸဝ်ႈ|kèn tsāō	<i>noun</i><br><ol><li>lord</li></ol>
ၵႅၼ်ႇၸႂ်ႈ|လွင်ႈၵႅၼ်ႇၸႂ်ႈ|kèn tsāūē	<i>verb</i><br><ol><li>be very true</li></ol>
ၵႅၼ်ႈ|kēn	<i>noun</i><br><ol><li>stem, petiole, leaf stalk</li></ol>
ၵႆ|kǎǐ|လွင်ႈၵႆ	<i>verb</i><br><ol><li>be distant, far not far</li></ol>
ၵႆး|káí	<i>noun</i><br><ol><li>penis</li></ol>
ၵႆးၵွင်ႈ|káí kāūng	<i>noun</i><br><ol><li>trigger of a gun</li></ol>
ၵႆၸမ်|kǎǐ tsǎm	<i>adj</i><br><ol><li>far and near</li></ol>
ၵႆၸႂ်|kǎǐ tsǎǔě	<i>adj</i><br><ol><li>far from one's heart</li></ol>
ၵႆၽေး|kǎǐ phéé	<i>adj</i><br><ol><li>safe, far from danger</li></ol>
ၵႆႇ|kàì	<i>noun</i><br><ol><li>chicken</li></ol>
ၵႆႇတင်ႈ|kàì tāng	<i>noun</i><br><ol><li>fowl used to decoy wild fowls</li></ol>
ၵႆႇတေႃႇ|kàì tàù	<i>noun</i><br><ol><li>fighting cock, gamecock</li></ol>
ၵႆႇထိူၼ်ႇ|kàì thòèn	<i>noun</i><br><ol><li>jungle fowl</li></ol>
ၵႆႇပေႃႈ|kàì pāū	<i>noun</i><br><ol><li>cock, rooster</li></ol>
ၵႆႇမႄႈ|kàì māāē	<i>noun</i><br><ol><li>hen</li></ol>
ၵႆႇဢွၼ်ႇ|kàì ʼàùn	<i>noun</i><br><ol><li>chicken</li></ol>
ၵႆႇၵတိူၵ်း|လွင်ႈၵႆႇၵတိူၵ်း|kàì kǎ tóék	<i>verb</i><br><ol><li>cackle</li></ol>
ၵႆႇၶီႈတိူၵ်း|လွင်ႈၵႆႇၶီႈတိူၵ်း|kàì khīī tóék	<i>verb</i><br><ol><li>cackle</li></ol>
ၵႆႇၶၼ်|လွင်ႈၵႆႇၶၼ်|kàì khǎn	<i>verb</i><br><ol><li>crow</li></ol>
ၵႆႇၶႃ|kàì khǎǎ	<i>noun</i><br><ol><li>pheasant</li></ol>
ၵႆႇၸၢင်ႉ|kàì tsâ̰â̰ng	<i>noun</i><br><ol><li>turkey</li></ol>
ၵႆႇၼမ်ႉ|kàì nâ̰m	<i>noun</i><br><ol><li>water fowl</li></ol>
ၵႆႇၽူႈ|kàì phūū	<i>noun</i><br><ol><li>cock, rooster</li></ol>
ၵႆႈ|kāī	<i>adv</i><br><ol><li>just now, a moment ago</li></ol>
ၵႆႉ|kâ̰ḭ̂|လွင်ႈၵႆႉ	<i>verb</i><br><ol><li>hardworking</li></ol><br><i>adv</i><br><ol><li>often, normally, commonly, regularly, frequently</li></ol>
ၵႆႉၵိၼ်|kâ̰ḭ̂ kǐn|လွင်ႈၵႆႉၵိၼ်	<i>verb</i><br><ol><li>eat frequently</li></ol>
ၶင်|khǎng|လွင်ႈၶင်	<i>verb</i><br><ol><li>pen, put into and shut up</li></ol>
ၶင်ႇ|လွင်ႈၶင်ႇ|khàng	<i>verb</i><br><ol><li>let out</li></ol>
ၶင်ႈ|khāng	<i>noun</i><br><ol><li>lac, stick-lac</li></ol>
ၶင်ႉ|khâ̰ng	<i>noun</i><br><ol><li>barrier or obstruction in a river; waterfall</li></ol>
ၶမ်း|khám	<i>noun</i><br><ol><li>gold.</li></ol>
ၶယိၼ်း|khǎ yín	<i>noun</i><br><ol><li>fork.</li></ol>
ၶယိၼ်းရိတ်ႉ|khǎ yín rḭ̂t	<i>noun</i><br><ol><li>Christ.</li></ol>
ၶယိၼ်းရိတ်ႉယၢၼ်ႇ|khǎ yín rḭ̂t yààn	<i>noun</i><br><ol><li>Christian.</li></ol>
ၶယိၼ်းရႃႇ|khǎ yín ràà	<i>noun</i><br><ol><li>trumpet or bugle.</li></ol>
ၶယိၼ်းရႃႇၵႄႇ|khǎ yín ràà kààè	<i>adj</i><br><ol><li>pert, saucy, quarrelsome.</li></ol>
ၶလွၵ်ႈ|khǎ lāūk	<i>noun</i><br><ol><li>wooden bell</li></ol>
ၶဝ်ႈ|လွင်ႈၶဝ်ႈ|khāō	<i>verb</i><br><ol><li>to enter</li></ol><br><i>noun</i><br><ol><li>rice</li></ol>
ၶဝ်ႈမိၼ်ႉ|khāō mḭ̂n	<i>noun</i><br><ol><li>turmeric plant</li></ol>
ၶဝ်ႈသဵၼ်ႈ|khāō sāēn	<i>noun</i><br><ol><li>rice noodles.</li></ol>
ၶဝ်ႈသွႆး|khāō sáúí	<i>noun</i><br><ol><li>noodles</li><li>khao soi</li></ol>
ၶဝ်ႈၵၢပ်ႇ|khāō kààp	<i>noun</i><br><ol><li>corn, maize</li></ol>
ၶဝ်ႈၼမ်ႉတၢင်းၵိၼ်|khāō nâ̰m tááng kǐn	<i>noun</i><br><ol><li>food; provisions; ration.</li></ol>
ၶိင်|khǐng	<i>noun</i><br><ol><li>ginger</li></ol>
ၶိင်း|khíng	<i>noun</i><br><ol><li>ancestor</li><li>body, တူဝ်</li></ol>
ၶိင်းၵၢင်ႉ|khíng kâ̰â̰ng	<i>noun</i><br><ol><li>headman of a hamlet</li></ol>
ၶိင်းၶႅင်|khíng khěng	<i>adj</i><br><ol><li>strong, hale in body</li></ol>
ၶိင်ၶႅၵ်ႉ|လွင်ႈၶိင်ၶႅၵ်ႉ|khǐng khḛ̂k	<i>verb</i><br><ol><li>rest on the elbow</li></ol>
ၶိင်ႁႅင်ႈ|khǐng hēng	<i>noun</i><br><ol><li>dried ginger</li></ol>
ၶိင်ႇ|khìng	<i>noun</i><br><ol><li>time, မိူဝ်ႈ၊ ယၢမ်း၊ ၶၢဝ်း၊ ၵႃႇလ</li></ol>
ၶိင်ႇမႆႈ|khìng māī	<i>noun</i><br><ol><li>hot part of the dry season, summer, ၶၢဝ်းမႆႈ</li></ol>
ၶိင်ႇလႂ်သေဢမ်ႇဝႃႈ|khìng lǎǔě sěě ʼàm wāā	<i>adv</i><br><ol><li>whenever; no matter when, ၶၢဝ်းလႂ်သေဢမ်ႇဝႃႈ၊ မိူဝ်ႈလႂ်သေဢမ်ႇဝႃႈ</li></ol>
ၶိင်ႇၵတ်း|khìng kát	<i>noun</i><br><ol><li>cold season, winter</li></ol>
ၶိင်ႇၸွမ်းတူဝ်မႄႈ|khìng tsáúm tǒ māāē	<i>noun</i><br><ol><li>rutting season periods of desire for mating (of animal)</li></ol>
ၶိင်ႇၽူၼ်|khìng phǔǔn	<i>noun</i><br><ol><li>rainy season, ၶၢဝ်းၽူၼ်</li></ol>
ၶိင်ႇႁိုဝ်ႉ|khìng hṵ̂ḛ̂	<i>noun</i><br><ol><li>rainy season, ၶၢဝ်းႁိုဝ်ႉ</li></ol>
ၶိင်ႇႁႅင်ႈ|khìng hēng	<i>noun</i><br><ol><li>dry season, ၶၢဝ်းႁႅင်ႈ</li></ol>
ၶိုင်|လွင်ႈၶိုင်|khǔěng	<i>verb</i><br><ol><li>prepare, make ready for</li><li>sift</li></ol><br><i>noun</i><br><ol><li>sieve</li></ol>
ၶိုင်မိူင်း|khǔěng móéng|လွင်ႈၶိုင်မိူင်း	<i>verb</i><br><ol><li>look after the affairs of a country in order that improvements may be made</li></ol>
ၶိုင်မႆႉ|khǔěng mâ̰ḭ̂	<i>noun</i><br><ol><li>wooden sieve</li></ol>
ၶိုင်လဵၵ်း|khǔěng láék	<i>noun</i><br><ol><li>iron sieve</li></ol>
ၶိုင်ဝႆႉ|khǔěng wâ̰ḭ̂|လွင်ႈၶိုင်ဝႆႉ	<i>verb</i><br><ol><li>prepare, make ready for; be made ready for, prepared</li></ol>
ၶိုင်ၵႂၢမ်း|လွင်ႈၶိုင်ၵႂၢမ်း|khǔěng kwáám	<i>verb</i><br><ol><li>consult together, make ready by consulting</li></ol>
ၶိုင်ႁၢင်မႃႉ|khǔěng hǎǎng mâ̰â̰	<i>noun</i><br><ol><li>horsehair sieve</li></ol>
ၶိုင်ႁႃၵၢၼ်|လွင်ႈၶိုင်ႁႃၵၢၼ်|khǔěng hǎǎ kǎǎn	<i>verb</i><br><ol><li>make an effort to come to an agreement</li></ol>
ၶိုင်ႈ|khūēng|လွင်ႈၶိုင်ႈ	<i>verb</i><br><ol><li>divide into two equal portions or weights</li></ol><br><i>noun</i><br><ol><li>a half</li></ol>
ၶိုင်ႈပီ|khūēng pǐǐ	<i>noun</i><br><ol><li>half a year</li></ol>
ၶိုင်ႈၵၢင်|khūēng kǎǎng	<i>noun</i><br><ol><li>intervening space, middle, midst, center,</li></ol><br><i>prep</i><br><ol><li>in the midst of, half way between</li></ol>
ၶိုင်ႈၵၼ်|khūēng kǎn	<i>adj</i><br><ol><li>in equal halves</li></ol>
ၶိုင်ႈၶိုင်ႈ|khūēng khūēng	<i>adv</i><br><ol><li>in halves; ၶိုၼ်းၶိုင်ႈၶိုင်ႈ make into equal halves</li></ol>
ၶိုင်ႈၼိုင်ႈ|khūēng nūēng	<i>noun</i><br><ol><li>one half</li></ol>
ၶိုၵ်ႇ|khùèk	<i>noun</i><br><ol><li>openwork basket used to catch fish</li></ol>
ၶိုၵ်ႇၵၢင်ပႃ|khùèk kǎǎng pǎǎ	<i>noun</i><br><ol><li>openwork basket used to catch fish</li></ol>
ၶိုၵ်ႉ|လွင်ႈၶိုၵ်ႉ|khṵ̂ḛ̂k	<i>adj</i><br><ol><li>better or handsomer, extraordinary</li></ol><br><i>verb</i><br><ol><li>suffer ill effects from hard labor, privation</li></ol>
ၶိုၵ်ႉလိုၵ်ႉ|khṵ̂ḛ̂k lṵ̂ḛ̂k	<i>adj</i><br><ol><li>important, significant</li></ol>
ၶိုၵ်ႉၶိုၵ်ႉၶမ်ႇၶမ်ႇ|khṵ̂ḛ̂k khṵ̂ḛ̂k khàm khàm	<i>adv</i><br><ol><li>excessively; in a handsome manner; with suitable furniture, equipage</li></ol>
ၶိုၵ်ႉၶိုၵ်ႉၶမ်ႈၶမ်ႈ|khṵ̂ḛ̂k khṵ̂ḛ̂k khām khām	<i>adv</i><br><ol><li>excessively; in a handsome manner; with suitable furniture, equipage</li></ol>
ၶိုၵ်ႉၶၵ်ႉ|khṵ̂ḛ̂k khâ̰k	<i>adj</i><br><ol><li>urgent</li></ol><br><i>noun</i><br><ol><li>emergency</li></ol>
ၶိုၵ်ႉၸႂ်|khṵ̂ḛ̂k tsǎǔě	<i>adj</i><br><ol><li>distressed, harassed in mind</li></ol>
ၶိုၵ်ႉၸႂ်ၵႅၼ်းၸႂ်|khṵ̂ḛ̂k tsǎǔě kén tsǎǔě	<i>adj</i><br><ol><li>distressed, harassed in mind</li></ol>
ၶိူင်|khǒěng	<i>noun</i><br><ol><li>knee or waist ornaments of coils of cord or wire</li></ol>
ၶိူင်တွင်း|khǒěng táúng	<i>noun</i><br><ol><li>knee or waist ornaments made of brass wire</li></ol>
ၶိူင်လမ်|khǒěng lǎm	<i>noun</i><br><ol><li>knee or waist ornaments made of blackened rattan</li></ol>
ၶိူင်ၼၢင်းပုမ်ႈ|khǒěng nááng pūm	<i>noun</i><br><ol><li>maidenhair</li></ol>
ၶိူင်ႇ|လွင်ႈၶိူင်ႇ|khòèng	<i>verb</i><br><ol><li>be firm, strong, durable ꧦမၼ်ႈ/ၶိူင်ႇၶမ်ႉꧦ</li></ol>
ၶိူင်ႈ|khōēng	<i>noun</i><br><ol><li>things, property, what pertains too person; materials, articles, ornaments, accessories, implement, device, gadget</li></ol>
ၶိူင်ႈၵႅတ်ႇၶႄ|khōēng kèt khǎǎě	<i>noun</i><br><ol><li>defensive weapon, arms</li></ol>
ၶိူင်ႈၶတ်းႁၢင်ႁိူဝ်း|khōēng khát hǎǎng hóé	<i>noun</i><br><ol><li>rudder.</li></ol>
ၶိူင်ႈၶီႇ|khōēng khìì	<i>noun</i><br><ol><li>passenger vehicle, vehicle</li></ol>
ၶိူင်ႈၶီႇၶိူင်ႈတေႃႉ|khōēng khìì khōēng tâ̰ṵ̂	<i>noun</i><br><ol><li>transportation vehicle</li></ol>
ၶိူင်ႈႁႄႉ|khōēng hâ̰â̰ḛ̂	<i>noun</i><br><ol><li>protective armor, shield</li></ol>
ၶိူၵ်ႈ|khōēk|လွင်ႈၶိူၵ်ႈ	<i>verb</i><br><ol><li>hit, come into contact, strike against</li></ol>
ၶိၵ်းၶိၵ်း|khík khík	<i>adv</i><br><ol><li>in a loud manner, with repeated reports of the voice; applied to laughter</li></ol>
ၶိၵ်ႈ|khīk	<i>adj</i><br><ol><li>striped, with straight or wavy lines</li></ol>
ၶီ|khǐǐ	<i>adj</i><br><ol><li>concerned, troubled, anxious, worry.</li></ol>
ၶီးၵုင်ႇ|လွင်ႈၶီးၵုင်ႇ|khíí kùng	<i>verb</i><br><ol><li>exalt, praise</li></ol>
ၶီႈငိုၼ်း|khīī ngúén	<i>noun</i><br><ol><li>(finance) interest (of money).</li></ol>
ၶီႈငႅပ်ႉ|khīī ngḛ̂p|လွင်ႈၶီႈငႅပ်ႉ	<i>noun</i><br><ol><li>temple, of the head</li></ol><br><i>verb</i><br><ol><li>sneeze</li></ol>
ၶီႈတိူတ်း|လွင်ႈၶီႈတိူတ်း|khīī tóét	<i>verb</i><br><ol><li>utter a noise, as a tiger</li></ol>
ၶီႈတုၵ်ႉ|khīī tṵ̂k|လွင်ႈၶီႈတုၵ်ႉ	<i>verb</i><br><ol><li>jerk</li></ol>
ၶီႈတူၵ်ႉ|လွင်ႈၶီႈတူၵ်ႉ|khīī tṵ̂ṵ̂k	<i>verb</i><br><ol><li>jerk</li></ol>
ၶီႈတွၼ်း|လွင်ႈၶီႈတွၼ်း|khīī táún	<i>verb</i><br><ol><li>sob</li></ol>
ၶီႈတွၼ်ႉ|khīī tâ̰ṵ̂n|လွင်ႈၶီႈတွၼ်ႉ	<i>verb</i><br><ol><li>sob</li></ol>
ၶီႈတၢၵ်ႇ|khīī tààk|လွင်ႈၶီႈတၢၵ်ႇ	<i>verb</i><br><ol><li>cackle as a hen</li></ol>
ၶီႈထီႇ|khīī thìì	<i>adj</i><br><ol><li>niggardly, stingy</li></ol>
ၶီႈပိုတ်း|khīī púét|လွင်ႈၶီႈပိုတ်း	<i>verb</i><br><ol><li>stumble</li></ol>
ၶီႈမိၼ်ႉ|khīī mḭ̂n	<i>noun</i><br><ol><li>turmeric plant</li></ol>
ၶီႈယၢၼ်|လွင်ႈၶီႈယၢၼ်|khīī yǎǎn	<i>verb</i><br><ol><li>quail, fear; be easily frightened, cowardly</li></ol>
ၶီႈယႃႈ|khīī yāā	<i>noun</i><br><ol><li>opium addict, drug addict</li></ol>
ၶီႈလဝ်ႈ|khīī lāō	<i>noun</i><br><ol><li>drunkard, alcoholic</li></ol>
ၶီႈလိုတ်း|လွင်ႈၶီႈလိုတ်း|khīī lúét	<i>verb</i><br><ol><li>stumble</li></ol>
ၶီႈလဵၵ်း|khīī láék	<i>noun</i><br><ol><li>refuse of iron at a blacksmith's forge</li></ol>
ၶီႈလၢဝ်ယွတ်ႇ|khīī lǎǎǒ yàùt	<i>noun</i><br><ol><li>meteor, falling star, shooting star</li></ol>
ၶီႈဢိုၵ်ႉ|khīī ʼṵ̂ḛ̂k	<i>noun</i><br><ol><li>hiccough</li></ol>
ၶီႈဢိူဝ်ႉ|khīī ʼô̰ḛ̂|လွင်ႈၶီႈဢိူဝ်ႉ	<i>verb</i><br><ol><li>sob</li></ol>
ၶီႈဢႄႇ|လွင်ႈၶီႈဢႄႇ|khīī ʼààè	<i>verb</i><br><ol><li>cry easily, be a cry baby</li></ol>
ၶီႈၶင်ႈ|khīī khāng	<i>noun</i><br><ol><li>lac, stick-lac</li></ol>
ၶီႈၶၢပ်ႇ|khīī khààp	<i>noun</i><br><ol><li>clappers of bamboo</li></ol>
ၶီႈၶၢၼ်ႉ|khīī khâ̰â̰n	<i>adj</i><br><ol><li>idle, lazy, bored</li></ol>
ၶီႈၶၢၼ်ႉၶီႈဢိူၼ်|khīī khâ̰â̰n khīī ʼǒěn	<i>adj</i><br><ol><li>idle, lazy, bored</li></ol>
ၶီႈၼဵဝ်|khīī nǎěǒ	<i>adj</i><br><ol><li>niggardly, stingy</li></ol>
ၶီႈႁူ|khīī hǔǔ	<i>noun</i><br><ol><li>earwax</li></ol>
ၶီႈႁေႈ|khīī hēē|လွင်ႈၶီႈႁေႈ	<i>verb</i><br><ol><li>have diarrhea</li></ol>
ၶီႈႁၢၵ်ႈသွင်ႁူၼ်|khīī hāāk sǎǔng hǔǔn	<i>verb</i><br><ol><li>violent dysentery</li></ol>
ၶီႈႁႆႈ|လွင်ႈၶီႈႁႆႈ|khīī hāī	<i>verb</i><br><ol><li>cry unreasonably</li></ol>
ၶီႉၶႃႉ|လွင်ႈၶီႉၶႃႉ|khḭ̂ḭ̂ khâ̰â̰	<i>verb</i><br><ol><li>do suddenly, abruptly, precipitately, not used alone</li></ol>
ၶုင်|khǔng	<i>noun</i><br><ol><li>species of monkey</li></ol>
ၶုင်ႇ|khùng	<i>noun</i><br><ol><li>small support of any kind</li></ol>
ၶုင်ႇတဵၼ်း|khùng táén	<i>noun</i><br><ol><li>candle stand</li></ol>
ၶုင်ႇတႅမ်ႈလိၵ်ႈ|khùng tēm līk	<i>noun</i><br><ol><li>writing stand or table</li></ol>
ၶုင်ႇလိၵ်ႈ|khùng līk	<i>noun</i><br><ol><li>study table</li></ol>
ၶုင်ႇၵိၼ်ၶဝ်ႈ|khùng kǐn khāō	<i>noun</i><br><ol><li>table, dining table</li></ol>
ၶုင်ႇၸဵၼ်ႇ|khùng tsàèn	<i>noun</i><br><ol><li>lathe</li></ol>
ၶုင်ႇၼင်ႈ|khùng nāng	<i>noun</i><br><ol><li>bench, stool</li></ol>
ၶုမ်ႇ|khùm	<i>noun</i><br><ol><li>plain surrounded by mountain</li></ol>
ၶုၵ်း|လွင်ႈၶုၵ်း|khúk	<i>verb</i><br><ol><li>bring to mind, reminisce</li></ol><br><i>adj</i><br><ol><li>concave</li></ol>
ၶုၵ်းထူပ်း|လွင်ႈၶုၵ်းထူပ်း|khúk thúúp	<i>verb</i><br><ol><li>bring to mind, remember</li></ol>
ၶုၵ်းယၢၼ်း|khúk yáán	<i>noun</i><br><ol><li>low ground; a spreading valley</li></ol>
ၶုၵ်းၶုမ်ႇ|khúk khùm	<i>noun</i><br><ol><li>plain surrounded by mountain</li></ol>
ၶုၵ်းၶၵ်း|khúk khák	<i>adv</i><br><ol><li>of a rough character, like a rocky road, uneven; also suddenly, immediately</li></ol>
ၶုၵ်းၸႂ်|လွင်ႈၶုၵ်းၸႂ်|khúk tsǎǔě	<i>verb</i><br><ol><li>bring to mind, reminisce</li></ol>
ၶုၵ်းၸႂ်လႆႈ|khúk tsǎǔě lāī|လွင်ႈၶုၵ်းၸႂ်လႆႈ	<i>verb</i><br><ol><li>remember, reminisce, be nostalgic for</li></ol>
ၶုၵ်းၸႂ်လႆႈမႆႈၸႂ်|khúk tsǎǔě lāī māī tsǎǔě	<i>adj</i><br><ol><li>sorry,</li></ol><br><i>verb</i><br><ol><li>repent</li></ol>
ၶုၵ်းၸႂ်လႆႈၶႆႈၸႂ်ထိုင်|လွင်ႈၶုၵ်းၸႂ်လႆႈၶႆႈၸႂ်ထိုင်|khúk tsǎǔě lāī khāī tsǎǔě thǔěng	<i>verb</i><br><ol><li>remember, reminisce, be nostalgic for, miss and long [[for]</li></ol>
ၶုၵ်ႉ|လွင်ႈၶုၵ်ႉ|khṵ̂k	<i>verb</i><br><ol><li>bring to mind - ၶုၵ်း</li></ol>
ၶုၵ်ႉၸႂ်|လွင်ႈၶုၵ်ႉၸႂ်|khṵ̂k tsǎǔě	<i>verb</i><br><ol><li>bring to mind, reminisce; be sorry for, repent</li></ol>
ၶုၵ်ႉၸႂ်လႆႈ|လွင်ႈၶုၵ်ႉၸႂ်လႆႈ|khṵ̂k tsǎǔě lāī	<i>verb</i><br><ol><li>remember, reminisce, be nostalgic for</li></ol>
ၶုၵ်ႉၸႂ်လႆႈၶႆႈၸႂ်ထူပ်း|လွင်ႈၶုၵ်ႉၸႂ်လႆႈၶႆႈၸႂ်ထူပ်း|khṵ̂k tsǎǔě lāī khāī tsǎǔě thúúp	<i>verb</i><br><ol><li>remember, reminisce, be nostalgic for, miss and long for</li></ol>
ၶုၼ်|khǔn	<i>noun</i><br><ol><li>prince; ruler; nobleman</li><li>officer; official</li><li>Your Excellency</li></ol>
ၶုၼ်မိူၵ်ႈ|khǔn mōēk	<i>noun</i><br><ol><li>tyrant</li></ol>
ၶုၼ်ႁေႃၶမ်း|khǔn hǎǔ khám	<i>noun</i><br><ol><li>king.</li></ol>
ၶူင်|khǔǔng	<i>adj</i><br><ol><li>perforated, have a hole in it (as a dam); come out as a small jet of water from a hole in a dam; form (as an abscess); do little be little</li></ol>
ၶူင်ငူင်|လွင်ႈၶူင်ငူင်|khǔǔng ngǔǔng	<i>verb</i><br><ol><li>obstruct, hinder (as by a thicket of thorns); be in a confused state (as an unfinished house)</li></ol>
ၶူင်ပွင်ႇ|khǔǔng pàùng	<i>adj</i><br><ol><li>perforated, have a hole in it</li></ol>
ၶူင်း|khúúng	<i>noun</i><br><ol><li>Salween River</li><li>one step in a series, abode, country တီႈယူႇ</li></ol>
ၶူင်းတွင်ႉ|khúúng tâ̰ṵ̂ng	<i>noun</i><br><ol><li>viscera, internal organs</li></ol>
ၶူင်းၵၢင်|khúúng kǎǎng	<i>noun</i><br><ol><li>middle abode, world we inhabit</li></ol>
ၶူင်းၼိူဝ်|khúúng nǒě	<i>noun</i><br><ol><li>upper spiritual world, celestial abode</li></ol>
ၶူင်းၼႂ်း|khúúng náúé	<i>noun</i><br><ol><li>viscera, internal organs</li></ol>
ၶူင်းၽီ|khúúng phǐǐ	<i>noun</i><br><ol><li>country of spirits or supernatural beings</li></ol>
ၶူင်ၼႂ်း|လွင်ႈၶူင်ၼႂ်း|khǔǔng náúé	<i>verb</i><br><ol><li>from a hole</li></ol>
ၶူင်ႇ|khùùng	<i>noun</i><br><ol><li>table</li></ol>
ၶူင်ႇမႃႉ|khùùng mâ̰â̰	<i>noun</i><br><ol><li>workbench</li></ol>
ၶူင်ႈ|khūūng	<i>adj</i><br><ol><li>concave, hollow, like a dent in a board</li></ol>
ၶူင်ႈၶၢင်းပဵၼ်ၵိင်ႇပဵၼ်ၶႃႈ|လွင်ႈၶူင်ႈၶၢင်းပဵၼ်ၵိင်ႇပဵၼ်ၶႃႈ|khūūng khááng pǎěn kìng pǎěn khāā	<i>verb</i><br><ol><li>have branches reaching out in all directions</li></ol>
ၶူင်ႉ|khṵ̂ṵ̂ng	<i>noun</i><br><ol><li>bend, bend around, be circuitous</li></ol>
ၶူင်ႉဝႆႉလူင်ႉၵူင်ႉ|လွင်ႈၶူင်ႉဝႆႉလူင်ႉၵူင်ႉ|khṵ̂ṵ̂ng wâ̰ḭ̂ lṵ̂ṵ̂ng kṵ̂ṵ̂ng	<i>verb</i><br><ol><li>bend, bend around, be circuitous</li></ol>
ၶူဝ်လႆ|khǒ lǎǐ	<i>noun</i><br><ol><li>stairs, ladder</li></ol>
ၶူဝ်ၶိၵ်းၶိၵ်း|လွင်ႈၶူဝ်ၶိၵ်းၶိၵ်း|khǒ khík khík	<i>verb</i><br><ol><li>giggle, laugh in a silly manner</li></ol>
ၶူးသွၼ်|khúú sǎǔn	<i>noun</i><br><ol><li>teacher, instructor.</li></ol>
ၶူၵ်ႉ|khṵ̂ṵ̂k	<i>noun</i><br><ol><li>mortar, mill</li></ol>
ၶူၵ်ႉမိုဝ်း|khṵ̂ṵ̂k múé	<i>noun</i><br><ol><li>mortar for hand use</li></ol>
ၶူၵ်ႉမွင်း|khṵ̂ṵ̂k máúng	<i>noun</i><br><ol><li>cup of a mortar used for pounding rice with the feet</li></ol>
ၶူၵ်ႉလဵၵ်း|khṵ̂ṵ̂k láék	<i>noun</i><br><ol><li>iron mortar</li></ol>
ၶူၵ်ႉၼမ်ႉ|khṵ̂ṵ̂k nâ̰m	<i>noun</i><br><ol><li>watermill</li></ol>
ၶူၵ်ႉၼမ်ႉၽိတ်ႉ|khṵ̂ṵ̂k nâ̰m phḭ̂t	<i>noun</i><br><ol><li>mortar</li></ol>
ၶူၼ်|လွင်ႈၶူၼ်|khǔǔn	<i>noun</i><br><ol><li>hair.</li></ol><br><i>verb</i><br><ol><li>to snore.</li></ol>
ၶေးၶေး|khéé khéé	<i>adv</i><br><ol><li>agreeable in sound</li></ol>
ၶေႃး|kháú	<i>noun</i><br><ol><li>neck, throat</li></ol>
ၶေႃးပုမ်း|kháú púm	<i>noun</i><br><ol><li>goiter</li></ol>
ၶေႃးမေႃႈ|kháú māū	<i>noun</i><br><ol><li>neck of a pot</li></ol>
ၶေႃးသိူဝ်ႈ|kháú sōē	<i>noun</i><br><ol><li>collar</li></ol>
ၶေႃးသၢၵ်ႇ|kháú sààk	<i>noun</i><br><ol><li>handle of a pestle of any kind, place which the hand grasps the pestle</li></ol>
ၶေႃးၵပ်း|kháú káp	<i>noun</i><br><ol><li>joint of the neck</li></ol>
ၶေႃးၵိဝ်ႇ|လွင်ႈၶေႃးၵိဝ်ႇ|kháú kìò	<i>verb</i><br><ol><li>have a very slender neck</li></ol>
ၶေႃးၵိဝ်ႇလိၼ်|kháú kìò lǐn	<i>noun</i><br><ol><li>isthmus</li></ol>
ၶေႃးၵၢပ်ႇ|kháú kààp	<i>noun</i><br><ol><li>swelling on both sides of the neck, mumps</li></ol>
ၶေႃးၶတ်း|kháú khát|လွင်ႈၶေႃးၶတ်း	<i>verb</i><br><ol><li>have a stiffness of the neck</li></ol>
ၶေႃးၶတ်းၶေႃးၶႅင်|kháú khát kháú khěng|လွင်ႈၶေႃးၶတ်းၶေႃးၶႅင်	<i>adj</i><br><ol><li>headstrong</li></ol><br><i>verb</i><br><ol><li>have a stiffness of the neck</li></ol>
ၶေႃးၶူမ်|kháú khǔǔm	<i>adj</i><br><ol><li>ironic</li></ol>
ၶေႃးၸဵပ်း|kháú tsáép|လွင်ႈၶေႃးၸဵပ်း	<i>verb</i><br><ol><li>be sore in the throat</li></ol><br><i>noun</i><br><ol><li>sore throat</li></ol>
ၶေႃးၼဵင်|kháú nǎěng	<i>noun</i><br><ol><li>goiter</li></ol>
ၶေႃးၼွၵ်ႇ|kháú nàùk	<i>noun</i><br><ol><li>protuberance on the back of the neck</li></ol>
ၶေႃးႁွႆ|kháú hǎǔǐ	<i>noun</i><br><ol><li>adam's apple</li></ol>
ၶေႃႈပူင်|khāū pǔǔng	<i>noun</i><br><ol><li>order, instruction</li></ol>
ၶေႃႈပွင်ႁွင်ႉ|khāū pǎǔng hâ̰ṵ̂ng	<i>noun</i><br><ol><li>summons</li></ol>
ၶေႃႈမၢႆ|khāū mǎǎǐ	<i>noun</i><br><ol><li>note, memorandum; mark, point, number, label (as a mark of reference)</li></ol>
ၶေႃႈယုမ်ႇယမ်|khāū yùm yǎm	<i>noun</i><br><ol><li>creed, belief, ideology</li></ol>
ၶေႃႈလူပ်းလိုၼ်း|khāū lúúp lúén	<i>noun</i><br><ol><li>final summing up, conclusion (as in speeches, books)</li></ol>
ၶေႃႈဢိူမ်း|khāū ʼóém	<i>noun</i><br><ol><li>swelling on both side of the neck, mumps</li></ol>
ၶေႃႈဢၢင်ႈ|khāū ʼāāng	<i>noun</i><br><ol><li>suggestion, intention</li></ol>
ၶေႃႈၼမ်း|khāū nám	<i>noun</i><br><ol><li>preface, foreword</li></ol>
ၶေႃႈႁူမ်ႈမၢႆ|khāū hūūm mǎǎǐ	<i>noun</i><br><ol><li>agreement, treaty, pact</li></ol>
ၶေႃႈႁွင်ႉသႅၼ်ႇ|khāū hâ̰ṵ̂ng sèn	<i>noun</i><br><ol><li>slogan</li></ol>
ၶေႃႉ|လွင်ႈၶေႃႉ|khâ̰ṵ̂	<i>verb</i><br><ol><li>have an emaciating disease</li></ol>
ၶေႃႉၵျူဝ်ႇ|လွင်ႈၶေႃႉၵျူဝ်ႇ|khâ̰ṵ̂ kjò	<i>verb</i><br><ol><li>be sick repeatedly</li></ol>
ၶေႃႉၶႄႉ|khâ̰ṵ̂ khâ̰â̰ḛ̂	<i>noun</i><br><ol><li>blight, pest</li></ol>
ၶေႇ|khèè|လွင်ႈၶေႇ	<i>verb</i><br><ol><li>to rub out; be rubbed out, cancelled</li><li>brush away, lift out of its place, move away</li></ol>
ၶေႇမမ်ႇ|khèè màm	<i>noun</i><br><ol><li>freedom from evil</li></ol>
ၶေႇမွတ်ႇ|khèè màùt|လွင်ႈၶေႇမွတ်ႇ	<i>verb</i><br><ol><li>to rub out, be rubbed out, cancelled</li></ol>
ၶေႇမႃႇ|khèè màà	<i>noun</i><br><ol><li>freedom from evil</li></ol>
ၶေႇၵႃႈ|လွင်ႈၶေႇၵႃႈ|khèè kāā	<i>verb</i><br><ol><li>pay the cost of an article</li></ol>
ၶေႇၽၼၢပ်ႈ|khèè phǎ nāāp	<i>noun</i><br><ol><li>masonry base of a building</li></ol>
ၶေႉ|khḛ̂ḛ̂|လွင်ႈၶေႉ	<i>verb</i><br><ol><li>put side by side, compare with the purpose of competition; contend in rivalry, compete</li></ol>
ၶေႉမႃႉ|khḛ̂ḛ̂ mâ̰â̰|လွင်ႈၶေႉမႃႉ	<i>verb</i><br><ol><li>race horses</li></ol>
ၶေႉၶဵင်ႇ|khḛ̂ḛ̂ khàèng|လွင်ႈၶေႉၶဵင်ႇ	<i>verb</i><br><ol><li>contend in rivalry, compete</li></ol>
ၶေႉႁိူဝ်း|khḛ̂ḛ̂ hóé|လွင်ႈၶေႉႁိူဝ်း	<i>verb</i><br><ol><li>race boats</li></ol>
ၶေႉႁႅင်းၵၼ်|khḛ̂ḛ̂ héng kǎn|လွင်ႈၶေႉႁႅင်းၵၼ်	<i>verb</i><br><ol><li>contest each other's strength</li></ol>
ၶဵင်|khǎěng	<i>noun</i><br><ol><li>chopping board, chopping block</li></ol>
ၶဵင်ႇ|khàèng|လွင်ႈၶဵင်ႇ	<i>noun</i><br><ol><li>frame or stage for any purpose, shelf</li></ol><br><i>verb</i><br><ol><li>engage in a contest or rivalry, one resisting another, compete; resist another (as a child resisting a parent who is punishing him)</li></ol>
ၶဵင်ႇတီႉသဵင်|khàèng tḭ̂ḭ̂ sǎěng	<i>noun</i><br><ol><li>antenna tower</li></ol>
ၶဵင်ႇတၢင်ႇ|khàèng tààng	<i>noun</i><br><ol><li>shelf to put things on, counter</li></ol>
ၶဵင်ႇတႅမ်ႈလိၵ်ႈ|khàèng tēm līk	<i>noun</i><br><ol><li>writing table</li></ol>
ၶဵင်ႇပပ်ႉ|khàèng pâ̰p	<i>noun</i><br><ol><li>book shelf</li></ol>
ၶဵင်ႇမုင်ႈ|khàèng mūng	<i>noun</i><br><ol><li>watch tower</li></ol>
ၶဵင်ႇမုင်ႈႁိူဝ်း|khàèng mūng hóé	<i>noun</i><br><ol><li>crow's nest, as on a ship</li></ol>
ၶဵင်ႇမေႃႈၼမ်ႉ|khàèng māū nâ̰m	<i>noun</i><br><ol><li>water stand</li></ol>
ၶဵင်ႇမႃႉၵၼ်|khàèng mâ̰â̰ kǎn|လွင်ႈၶဵင်ႇမႃႉၵၼ်	<i>verb</i><br><ol><li>race houses</li></ol>
ၶဵင်ႇလိုဝ်ႈ|khàèng lūē	<i>noun</i><br><ol><li>bench for travelers to rest upon, frequent under trees by the roadside</li></ol>
ၶဵင်ႇသိုၵ်း|လွင်ႈၶဵင်ႇသိုၵ်း|khàèng súék	<i>verb</i><br><ol><li>engage in battle</li></ol>
ၶဵင်ႇသူပ်းၶဵင်ႇၵႂၢမ်း|khàèng súúp khàèng kwáám|လွင်ႈၶဵင်ႇသူပ်းၶဵင်ႇၵႂၢမ်း	<i>verb</i><br><ol><li>have a wordy quarrel</li></ol>
ၶဵင်ႇသွမ်းတေႃႇ|khàèng sáúm tàù	<i>noun</i><br><ol><li>frame or shelf in a house, devoted to sacred offerings</li></ol>
ၶဵင်ႇၵုၵ်ႈသေး|khàèng kūk séé	<i>noun</i><br><ol><li>stage on which a puppet is exhibited</li></ol>
ၶဵင်ႇၽီ|khàèng phǐǐ	<i>noun</i><br><ol><li>small building erected to spirits</li></ol>
ၶဵင်ႇၽြႃး|khàèng phráá	<i>noun</i><br><ol><li>alter</li></ol>
ၶဵင်ႇႁပ်ႇ|khàèng hàp	<i>noun</i><br><ol><li>litter</li></ol>
ၶဵင်ႇႁိူဝ်းၵၼ်|လွင်ႈၶဵင်ႇႁိူဝ်းၵၼ်|khàèng hóé kǎn	<i>verb</i><br><ol><li>race boats</li></ol>
ၶဵင်ႇႁၢမ်|khàèng hǎǎm	<i>noun</i><br><ol><li>litter</li></ol>
ၶဵင်ႇႁၢမ်ၵူၼ်းပဵၼ်|khàèng hǎǎm kúún pǎěn	<i>noun</i><br><ol><li>stretcher, လေႃႉၵူၼ်းပဵၼ်</li></ol>
ၶဵင်ႈ|လွင်ႈၶဵင်ႈ|khāēng	<i>verb</i><br><ol><li>stretch out, make tense, tighten as a rope; extend a line and make it fast</li></ol><br><i>adj</i><br><ol><li>taut, tense</li></ol>
ၶဵင်ႈၶဵင်ႈ|khāēng khāēng	<i>adv</i><br><ol><li>tautly, tensely</li></ol>
ၶဵင်ႈၸိူၵ်ႈ|khāēng tsōēk|လွင်ႈၶဵင်ႈၸိူၵ်ႈ	<i>verb</i><br><ol><li>stretch a rope or cord</li></ol>
ၶဵင်ႈၼင်|လွင်ႈၶဵင်ႈၼင်|khāēng nǎng	<i>verb</i><br><ol><li>stretch a hide</li></ol>
ၶဵင်ႈၼႃႈၶဵင်ႈတႃ|လွင်ႈၶဵင်ႈၼႃႈၶဵင်ႈတႃ|khāēng nāā khāēng tǎǎ	<i>verb</i><br><ol><li>look at intently, sternly</li></ol>
ၶဵမ်|khǎěm	<i>noun</i><br><ol><li>needle</li></ol>
ၶဵဝ်|တၢင်းၶဵဝ်|khǎěǒ	<i>adj</i><br><ol><li>green.</li><li>having an unfavourable smell like that of a fresh leaf of a tree.</li></ol>
ၶဵဝ်ႈ|khāēō|လွင်ႈၶဵဝ်ႈ	<i>noun</i><br><ol><li>tooth.</li></ol><br><i>verb</i><br><ol><li>to boil down; to concentrate.</li></ol>
ၶျုၵ်ႈ|လွင်ႈၶျုၵ်ႈ|khjūk	<i>verb</i><br><ol><li>to confine, imprison; control</li></ol>
ၶျေႃး|khjáú	<i>noun</i><br><ol><li>forced labor (usually as porters)</li></ol>
ၶျွတ်ႈ|လွင်ႈၶျွတ်ႈ|khjāūt	<i>verb</i><br><ol><li>to take out of, free from, deliver, release</li></ol>
ၶျၢင်း|khjááng	<i>name</i><br><ol><li>Chin</li></ol>
ၶျၢမ်းသႃႇ|လွင်ႈၶျၢမ်းသႃႇ|khjáám sàà	<i>noun</i><br><ol><li>ease, happiness, rest</li></ol><br><i>verb</i><br><ol><li>to be at ease</li><li>to be content, happy</li></ol>
ၶျႃး|လွင်ႈၶျႃး|khjáá	<i>verb</i><br><ol><li>to put down</li></ol>
ၶွင်|khǎǔng	<i>noun</i><br><ol><li>things, property, goods, what belongs to a person; the private parts</li></ol><br><i>pron</i><br><ol><li>dual form, both, two person</li></ol><br><i>prep</i><br><ol><li>on account of, because of, since</li></ol>
ၶွင်တႄႉၶွင်ဝႃႈ|khǎǔng tâ̰â̰ḛ̂ khǎǔng wāā	<i>noun</i><br><ol><li>really excellent goods</li></ol>
ၶွင်ထွတ်ႈၶွင်မျၢတ်ႈ|khǎǔng thāūt khǎǔng mjāāt	<i>noun</i><br><ol><li>sacred objects</li></ol>
ၶွင်မၼ်း|khǎǔng mán	<i>pron</i><br><ol><li>his, hers, his property, her property</li></ol>
ၶွင်လၢႆ|khǎǔng lǎǎǐ	<i>noun</i><br><ol><li>thing received without payment or exchange in kind</li></ol>
ၶွင်ဝၢၼ်|khǎǔng wǎǎn	<i>noun</i><br><ol><li>desserts, sweets</li></ol>
ၶွင်သူ|khǎǔng sǔǔ	<i>pron</i><br><ol><li>yours, your property</li></ol>
ၶွင်း|kháúng	<i>noun</i><br><ol><li>head (as a person in charge)</li></ol>
ၶွင်းလွင်း|kháúng láúng	<i>noun</i><br><ol><li>bell</li></ol>
ၶွင်းၵၢတ်ႇ|kháúng kààt	<i>noun</i><br><ol><li>market tax collector</li></ol>
ၶွင်ၵဝ်|khǎǔng kǎǒ	<i>pron</i><br><ol><li>mine, my property ၶွင်ၶႃႈ</li></ol>
ၶွင်ၶိူဝ်|khǎǔng khǒě	<i>pron</i><br><ol><li>both, yours</li></ol>
ၶွင်ၶႃ|khǎǔng khǎǎ	<i>pron</i><br><ol><li>both, theirs, used only in speaking of two persons</li></ol>
ၶွင်ၽၢၵ်ႇ|khǎǔng phààk	<i>noun</i><br><ol><li>present sent by the hand of some person</li></ol>
ၶွင်ႁဝ်း|khǎǔng háó	<i>pron</i><br><ol><li>ours, our property</li></ol>
ၶွင်ႁႃး|khǎǔng háá	<i>pron</i><br><ol><li>ours, our property</li></ol>
ၶွင်ႇ|khàùng	<i>noun</i><br><ol><li>pink</li></ol>
ၶွင်ႇၵႄႇ|khàùng kààè	<i>noun</i><br><ol><li>deep pink</li></ol>
ၶွင်ႇၶႅမ်ႈ|khàùng khēm	<i>noun</i><br><ol><li>dark pink</li></ol>
ၶွင်ႇၼုမ်ႇ|khàùng nùm	<i>noun</i><br><ol><li>light pink</li></ol>
ၶွင်ႈ|လွင်ႈၶွင်ႈ|khāūng	<i>noun</i><br><ol><li>large-mouthed basket</li></ol><br><i>verb</i><br><ol><li>hit or touch accidentally, with bad results ၶွင်ႈလူမ်ႉ</li><li>borrow mutually of each other, have equal debts with one another ၶွင်ႈၵၼ်/ၵိတ်ႇၵၼ်</li></ol>
ၶွင်ႈတူင်|khāūng tǔǔng	<i>noun</i><br><ol><li>measuring basket</li></ol>
ၶွင်ႈၶူၼ်ႇ|khāūng khùùn	<i>noun</i><br><ol><li>basket of small size</li></ol>
ၶွင်ႈၶႆႇ|khāūng khàì	<i>noun</i><br><ol><li>basket and its content</li></ol>
ၶွင်ႈၼမ်ႉ|khāūng nâ̰m	<i>noun</i><br><ol><li>bucket</li></ol>
ၶွင်ႉ|လွင်ႈၶွင်ႉ|khâ̰ṵ̂ng	<i>verb</i><br><ol><li>catch, draw back; catch and hold; be caught and held;</li></ol>
ၶွင်ႉၶၢတ်ႇ|khâ̰ṵ̂ng khààt|လွင်ႈၶွင်ႉၶၢတ်ႇ	<i>verb</i><br><ol><li>catch and tear</li></ol>
ၶွင်ႉၸႂ်|khâ̰ṵ̂ng tsǎǔě|လွင်ႈၶွင်ႉၸႂ်	<i>verb</i><br><ol><li>be anxious မႆႈၸႂ်</li></ol>
ၶွင်ႉၼွၼ်း|khâ̰ṵ̂ng náún	<i>noun</i><br><ol><li>bedroom</li></ol>
ၶွၵ်း|လွင်ႈၶွၵ်း|kháúk	<i>verb</i><br><ol><li>knock, rap with the knuckles</li></ol>
ၶွၵ်းၶွၵ်းၶႅၵ်းၶႅၵ်း|kháúk kháúk khék khék	<i>adv</i><br><ol><li>with a ratting or jingling sound</li></ol>
ၶွၵ်ႇ|khàùk	<i>noun</i><br><ol><li>inner shell, which encloses the kernel; cocoon</li><li>boundary, frontier border</li></ol>
ၶွၵ်ႇမူ|khàùk mǔǔ	<i>noun</i><br><ol><li>rind of a hog with the fatty substance beneath it</li></ol>
ၶွၵ်ႇမူင်ႈလၢႆႈ|khàùk mūūng lāāī	<i>noun</i><br><ol><li>silk worm's cocoon</li></ol>
ၶွၵ်ႇလိပ်ႈ|khàùk līp	<i>noun</i><br><ol><li>empty shell</li></ol>
ၶွၵ်ႇလၢႆႈ|khàùk lāāī	<i>noun</i><br><ol><li>silk worm's cocoon</li></ol>
ၶွၵ်ႇလႅၼ်မိူင်း|khàùk lěn móéng	<i>noun</i><br><ol><li>boundary, frontier border</li></ol>
ၶွၵ်ႈ|khāūk	<i>noun</i><br><ol><li>enclosure for keeping animals, cage, jail cell</li></ol>
ၶွၵ်ႈထွင်ႇ|khāūk thàùng	<i>noun</i><br><ol><li>enclosure used for confinement, prison yard</li></ol>
ၶွၵ်ႈထၢင်ႇ|khāūk thààng	<i>noun</i><br><ol><li>stocks</li></ol>
ၶွၵ်ႈမူ|khāūk mǔǔ	<i>noun</i><br><ol><li>pigsty</li></ol>
ၶွၵ်ႈမႃ|khāūk mǎǎ	<i>noun</i><br><ol><li>doghouse</li></ol>
ၶွၵ်ႈမႃႉ|khāūk mâ̰â̰	<i>noun</i><br><ol><li>stable</li></ol>
ၶွၵ်ႈလဵၵ်းၶွၵ်ႈထၢင်ႇ|khāūk láék khāūk thààng	<i>noun</i><br><ol><li>stocks</li></ol>
ၶွၵ်ႈလွၵ်ႈ|khāūk lāūk	<i>noun</i><br><ol><li>wooden bell</li></ol>
ၶွၵ်ႈဝူဝ်း|khāūk wó	<i>noun</i><br><ol><li>enclosure for cows, cowshed</li></ol>
ၶွၵ်ႈၵႆႇ|khāūk kàì	<i>noun</i><br><ol><li>hencoop</li></ol>
ၶွၼ်ႇ|khàùn	<i>noun</i><br><ol><li>tax, revenue received by assessing property</li></ol>
ၶွၼ်ႉတဝ်ႉ|khâ̰ṵ̂n tâ̰ô̰	<i>noun</i><br><ol><li>cane; walking stick.</li></ol>
ၶၢင်|khǎǎng	<i>name</i><br><ol><li>Kachin</li></ol><br><i>noun</i><br><ol><li>metallic substance, composed of zinc and iron</li></ol><br><i>verb</i><br><ol><li>live apart without being divorced</li></ol>
ၶၢင်း|လွင်ႈၶၢင်း|khááng	<i>verb</i><br><ol><li>put together side by side (not used alone)</li><li>sigh, moan, groan, growl; complain, grumble</li></ol>
ၶၢင်းထႃႈ|လွင်ႈၶၢင်းထႃႈ|khááng thāā	<i>verb</i><br><ol><li>borrow trouble, complain in advance</li></ol>
ၶၢင်းယွႆႈၶၢင်းယႅမ်း|khááng yāūī khááng yém|လွင်ႈၶၢင်းယွႆႈၶၢင်းယႅမ်း	<i>verb</i><br><ol><li>complain without much cause; grumble because of small annoyances</li></ol>
ၶၢင်းဢိူမ်ႈ|khááng ʼōēm|လွင်ႈၶၢင်းဢိူမ်ႈ	<i>verb</i><br><ol><li>put together side by side (not used alone)</li></ol>
ၶၢင်းၵၼ်|khááng kǎn|လွင်ႈၶၢင်းၵၼ်	<i>verb</i><br><ol><li>put together side by side (not used alone)</li></ol>
ၶၢင်းၶီၶၢင်းၽၢၼ်|khááng khǐǐ khááng phǎǎn|လွင်ႈၶၢင်းၶီၶၢင်းၽၢၼ်	<i>verb</i><br><ol><li>complain, bemoan one's condition</li></ol>
ၶၢင်ႇ|khààng|လွင်ႈၶၢင်ႇ	<i>verb</i><br><ol><li>let out</li></ol>
ၶၢင်ႇပွင်း|khààng páúng	<i>noun</i><br><ol><li>fried cake, containing vegetable, fish, etc; fritters</li></ol>
ၶၢင်ႇလေႃး|khààng láú	<i>noun</i><br><ol><li>eagle, often kite</li></ol>
ၶၢင်ႈ|khāāng	<i>noun</i><br><ol><li>side of an object, animate or inanimate</li></ol>
ၶၢင်ႈလၢႆး|khāāng lááí	<i>noun</i><br><ol><li>tattooed side (as of the body)</li></ol>
ၶၢင်ႉ|khâ̰â̰ng|လွင်ႈၶၢင်ႉ	<i>noun</i><br><ol><li>barrier or obstruction in a river; waterfall, ၶင်ႉ</li></ol><br><i>verb</i><br><ol><li>stop over, sojourn (as on a journey)</li></ol>
ၶၢင်ႉၶၢၵ်ႈ|khâ̰â̰ng khāāk|လွင်ႈၶၢင်ႉၶၢၵ်ႈ	<i>verb</i><br><ol><li>toad</li></ol>
ၶၢဝ်|khǎǎǒ|တၢင်းၶၢဝ်	<i>adj</i><br><ol><li>white.</li></ol>
ၶၢဝ်းတၢင်း|khááó tááng	<i>noun</i><br><ol><li>distance, way, journey, duration of traveling</li></ol>
ၶၢဝ်းမႆႈ|khááó māī	<i>noun</i><br><ol><li>hot part of the dry season, summer, ၶိင်ႇမႆႈ</li></ol>
ၶၢဝ်းလႂ်သေဢမ်ႇဝႃႈ|khááó lǎǔě sěě ʼàm wāā	<i>adv</i><br><ol><li>whenever; no matter when, ၶိင်ႇလႂ်သေဢမ်ႇဝႃႈ၊ မိူဝ်ႈလႂ်သေဢမ်ႇဝႃႈ</li></ol>
ၶၢဝ်းၵတ်း|khááó kát	<i>noun</i><br><ol><li>cold season, winter</li></ol>
ၶၢဝ်းၽူၼ်|khááó phǔǔn	<i>noun</i><br><ol><li>rainy season, ၶိင်ႇၽူၼ်</li></ol>
ၶၢဝ်းႁိုဝ်ႉ|khááó hṵ̂ḛ̂	<i>noun</i><br><ol><li>rainy season, ၶိင်ႇႁိုဝ်ႉ</li></ol>
ၶၢဝ်းႁႅင်ႈ|khááó hēng	<i>noun</i><br><ol><li>dry season, ၶိင်ႇႁႅင်ႈ</li></ol>
ၶၢၵ်းၶၢၵ်းၶိၵ်းၶိၵ်း|kháák kháák khík khík	<i>adv</i><br><ol><li>with a ratting or jingling sound</li></ol>
ၶၢၵ်ႇ|khààk|လွင်ႈၶၢၵ်ႇ	<i>noun</i><br><ol><li>sharp spike</li></ol><br><i>verb</i><br><ol><li>shake out</li><li>hawk, raise phlegm</li></ol>
ၶၢၵ်ႇလၢင်း|khààk lááng	<i>noun</i><br><ol><li>fork</li></ol>
ၶၢၵ်ႇၶီႈတိူဝ်ႇ|khààk khīī tòè|လွင်ႈၶၢၵ်ႇၶီႈတိူဝ်ႇ	<i>verb</i><br><ol><li>hawk, raise phlegm</li></ol>
ၶၢၵ်ႇၶီႈယႃႈ|khààk khīī yāā|လွင်ႈၶၢၵ်ႇၶီႈယႃႈ	<i>verb</i><br><ol><li>shake out</li></ol>
ၶၢၵ်ႈ|khāāk|လွင်ႈၶၢၵ်ႈ	<i>verb</i><br><ol><li>make large</li></ol>
ၶၢၼ်း|လွင်ႈၶၢၼ်း|kháán	<i>noun</i><br><ol><li>section, division of a writing</li><li>room</li></ol><br><i>verb</i><br><ol><li>to appoint, commission to some work or office</li></ol>
ၶၵ်း|လွင်ႈၶၵ်း|khák	<i>verb</i><br><ol><li>carve, engrave</li></ol>
ၶၵ်းတွင်ႈ|လွင်ႈၶၵ်းတွင်ႈ|khák tāūng	<i>verb</i><br><ol><li>carve, grave</li></ol>
ၶၵ်းၶႅၵ်း|khák khék|လွင်ႈၶၵ်းၶႅၵ်း	<i>verb</i><br><ol><li>carve, engrave</li></ol>
ၶၵ်ႉ|khâ̰k	<i>noun</i><br><ol><li>step</li></ol>
ၶၵ်ႉတိင်ႇ|khâ̰k tìng	<i>noun</i><br><ol><li>fingerboard of a violin</li></ol>
ၶၵ်ႉလွႆ|khâ̰k lǎǔǐ	<i>noun</i><br><ol><li>terrace or small plateau on the side of a mountain, the depressions in a range of mountains</li></ol>
ၶၵ်ႉၶၼ်ႈလႆ|khâ̰k khān lǎǐ	<i>noun</i><br><ol><li>steps of a staircase, ladder, stairway</li></ol>
ၶႂၢၵ်ႇ|khwààk	<i>noun</i><br><ol><li>sharp spike</li></ol>
ၶႂၢၵ်ႈ|khwāāk|လွင်ႈၶႂၢၵ်ႈ	<i>verb</i><br><ol><li>make large</li></ol>
ၶႃ|khǎǎ	<i>noun</i><br><ol><li>(anatomy) legs.</li></ol>
ၶႃတူင်ႇ|khǎǎ tùùng	<i>noun</i><br><ol><li>bow legs.</li></ol>
ၶႃး|kháá	<i>noun</i><br><ol><li>thatch.</li></ol>
ၶႃးႁွမ်|kháá hǎǔm	<i>noun</i><br><ol><li>lemon grass.</li></ol>
ၶႃၵဵင်း|khǎǎ káéng	<i>noun</i><br><ol><li>leg of a tripod.</li></ol>
ၶႃၶႄႉ|khǎǎ khâ̰â̰ḛ̂	<i>noun</i><br><ol><li>crippled leg.</li></ol>
ၶႃႇ|khàà	<i>noun</i><br><ol><li>frame.</li></ol>
ၶႃႇၵႄႇ|khàà kààè	<i>adv</i><br><ol><li>pert, saucy, quarrelsome.</li></ol>
ၶႃႈ|လွင်ႈၶႃႈ|khāā	<i>noun</i><br><ol><li>servant, slave.</li></ol><br><i>verb</i><br><ol><li>to kill.</li></ol><br><i>pron</i><br><ol><li>I, me, my</li></ol>
ၶႃႈလၵ်ႉယႃႉ|khāā lâ̰k yâ̰â̰	<i>noun</i><br><ol><li>captive ၽူႈၺႃးတၢမ်ႇ။</li></ol>
ၶႃႈသိုဝ်ႉ|khāā sṵ̂ḛ̂	<i>noun</i><br><ol><li>bought slave.</li></ol>
ၶႃႈၸဝ်ႈၽြႃး|khāā tsāō phráá	<i>noun</i><br><ol><li>pagoda slave.</li></ol>
ၶႃႈၸႂ်ဢသၢၵ်ႈ|khāā tsǎǔě ʼǎ sāāk|လွင်ႈၶႃႈၸႂ်ဢသၢၵ်ႈ	<i>verb</i><br><ol><li>kill.</li></ol>
ၶႃႈၽိုၼ်ႉမိူင်း|khāā phṵ̂ḛ̂n móéng	<i>noun</i><br><ol><li>rebel.</li></ol>
ၶႃႈႁဝ်း|khāā háó	<i>pron</i><br><ol><li>I, me.</li></ol>
ၶႃႉ|khâ̰â̰|လွင်ႈၶႃႉ	<i>verb</i><br><ol><li>defame, slander.</li></ol>
ၶႃႉၸိုဝ်ႈၶၢႆသဵင်|လွင်ႈၶႃႉၸိုဝ်ႈၶၢႆသဵင်|khâ̰â̰ tsūē khǎǎǐ sǎěng	<i>verb</i><br><ol><li>betray</li></ol>
ၶႄ|khǎǎě|လွင်ႈၶႄ	<i>noun</i><br><ol><li>casting net</li></ol><br><i>verb</i><br><ol><li>hinder, thwart, deliver from or remove a prevent evil, same from harm or danger</li></ol>
ၶႄတူဝ်|လွင်ႈၶႄတူဝ်|khǎǎě tǒ	<i>verb</i><br><ol><li>deliver oneself, save oneself</li></ol>
ၶႄထဵင်|khǎǎě thǎěng|လွင်ႈၶႄထဵင်	<i>verb</i><br><ol><li>defend by denial</li></ol>
ၶႄထဵင်ဢမူႉ|khǎǎě thǎěng ʼǎ mṵ̂ṵ̂|လွင်ႈၶႄထဵင်ဢမူႉ	<i>verb</i><br><ol><li>defend in court</li></ol>
ၶႄပႃ|khǎǎě pǎǎ	<i>noun</i><br><ol><li>fishing net</li></ol>
ၶႄး|khááé	<i>noun</i><br><ol><li>probability</li></ol><br><i>adv</i><br><ol><li>perhaps, may be, probably</li></ol>
ၶႄၽေး|khǎǎě phéé|လွင်ႈၶႄၽေး	<i>verb</i><br><ol><li>save from harm or danger</li></ol>
ၶႄၾႆး|လွင်ႈၶႄၾႆး|khǎǎě fáí	<i>verb</i><br><ol><li>put out fire</li></ol>
ၶႄႇ|khààè	<i>name</i><br><ol><li>Chinese</li></ol>
ၶႄႈ|khāāē	<i>noun</i><br><ol><li>dried sticks or twigs, kindling twigs</li></ol>
ၶႅင်|khěng	<i>adj</i><br><ol><li>hard, stiff, firm, not pliant, tough</li></ol>
ၶႅင်း|khéng	<i>noun</i><br><ol><li>grill</li></ol>
ၶႅင်ၵႂၢမ်း|khěng kwáám	<i>adj</i><br><ol><li>unwilling to obey; maintain one's word</li></ol>
ၶႅင်ၸႂ်|khěng tsǎǔě	<i>adj</i><br><ol><li>undaunted, firm in mind.</li></ol>
ၶႅင်ႇ|khèng	<i>noun</i><br><ol><li>tax or duty levied; broker's commission.</li></ol>
ၶႅင်ႈၶႄး|khēng khááé	<i>noun</i><br><ol><li>small dry pieces of kindling of bamboo or bushes</li></ol>
ၶႅပ်းတိၼ်|khép tǐn	<i>noun</i><br><ol><li>sandal</li></ol>
ၶႅပ်းၶမ်း|khép khám	<i>noun</i><br><ol><li>gold leaf</li></ol>
ၶႅၵ်း|khék|လွင်ႈၶႅၵ်း	<i>verb</i><br><ol><li>make a hole into, perforate for any purpose; engrave, carve</li><li>speak or sing alternately or responsively</li></ol>
ၶႅၵ်းလၢႆး|လွင်ႈၶႅၵ်းလၢႆး|khék lááí	<i>verb</i><br><ol><li>carve figures</li></ol>
ၶႅၵ်ႇ|khèk	<i>noun</i><br><ol><li>traveler, sojourner, stranger; guest, visitor</li></ol>
ၶႅၵ်ႇဢႃႇၵၼ်ႇတူႉ|khèk ʼàà kàn tṵ̂ṵ̂	<i>noun</i><br><ol><li>traveler, sojourner, stranger; a guest, visitor</li></ol>
ၶႅၵ်ႇၶမ်ႁိူၼ်း|khèk khǎm hóén	<i>noun</i><br><ol><li>hanger on</li></ol>
ၶႅၵ်ႉ|khḛ̂k	<i>noun</i><br><ol><li>drift, matter drifting on the water or stranded</li></ol><br><i>adv</i><br><ol><li>on the elbow</li></ol>
ၸပြိင်ႇ|tsǎ prìng	<i>noun</i><br><ol><li>spring (device)</li></ol>
ၸမုင်ႇၼၢၵ်ႈ|tsǎ mùng nāāk	<i>noun</i><br><ol><li>black anise, Nigella sativa</li></ol>
ၸမုတ်ႈ|tsǎ mūt	<i>noun</i><br><ol><li>dill, caraway plant</li></ol>
ၸမ်ႈ|tsām	<i>noun</i><br><ol><li>glass</li><li>mirror</li></ol>
ၸရိပ်ႈ|tsǎ rīp	<i>noun</i><br><ol><li>provisions for a journey; expenses of a journey</li></ol>
ၸလုင်ႇ|tsǎ lùng	<i>noun</i><br><ol><li>deep bowl, basin, deep plate</li></ol>
ၸလၢင်း|tsǎ lááng	<i>noun</i><br><ol><li>register, account, list</li></ol>
ၸဝ်ႈမုၼ်|tsāō mǔn	<i>noun</i><br><ol><li>monk.</li></ol>
ၸဝ်ႈမုၼ်ပူပ်ႉ|tsāō mǔn pṵ̂ṵ̂p	<i>noun</i><br><ol><li>pope.</li></ol>
ၸဝ်ႈၽြႃး|tsāō phráá	<i>noun</i><br><ol><li>god, object of worship, pagoda.</li></ol>
ၸဝ်ႈႁဝ်း|tsāō háó	<i>pron</i><br><ol><li>(polite) respectful pronoun used when addressing someone of a higher rank</li></ol>
ၸိင်ႇ|tsìng	<i>noun</i><br><ol><li>diamond</li></ol>
ၸိမ်း|လွင်ႈၸိမ်း|tsím	<i>verb</i><br><ol><li>to taste; to sample (food).</li></ol>
ၸိုင်ႈၶမ်းသၢမ်ၸဵင်ႇ|tsūēng khám sǎǎm tsàèng	<i>name</i><br><ol><li>the Golden Triangle</li></ol>
ၸီးပႂႃး|tsíí pwáá	<i>noun</i><br><ol><li>increase, profit, advantage, as money, material things</li></ol>
ၸီးဝူၺ်း|လွင်ႈၸီးဝူၺ်း|tsíí wóí	<i>verb</i><br><ol><li>to assemble (used of people)</li></ol>
ၸီးၼႃႉ|tsíí nâ̰â̰	<i>noun</i><br><ol><li>(Buddhism) Buddha</li></ol>
ၸီႇပႅင်း|tsìì péng	<i>noun</i><br><ol><li>tub, barrel</li></ol>
ၸီႇယႃႇ|tsìì yàà	<i>noun</i><br><ol><li>cumin</li></ol>
ၸီႉၸႅတ်ႈ|လွင်ႈၸီႉၸႅတ်ႈ|tsḭ̂ḭ̂ tsēt	<i>verb</i><br><ol><li>to examine critically</li></ol>
ၸီႉၼႃႉ|tsḭ̂ḭ̂ nâ̰â̰	<i>noun</i><br><ol><li>(Buddhism) Buddha</li></ol>
ၸုင်ႇထွၵ်ႈ|tsùng thāūk	<i>noun</i><br><ol><li>detective</li></ol>
ၸုမ်းၵူၼ်း|tsúm kúún	<i>noun</i><br><ol><li>a group of people</li><li>mob</li></ol>
ၸုၼ်ႉ|tsṵ̂n|လွင်ႈၸုၼ်ႉ	<i>verb</i><br><ol><li>to put away</li><li>to abandon; to give up</li><li>to risk</li></ol>
ၸူႇၵႃႇ|tsùù kàà	<i>noun</i><br><ol><li>passion flower, a creeping plant</li></ol>
ၸေႃႉငႅမ်ႈ|tsâ̰ṵ̂ ngēm	<i>noun</i><br><ol><li>fork</li></ol>
ၸေႇတီႇ|tsèè tìì	<i>noun</i><br><ol><li>pagoda.</li></ol>
ၸေႈ|tsēē	<i>noun</i><br><ol><li>paper</li></ol>
ၸေႉၸၢပ်ႈ|tsḛ̂ḛ̂ tsāāp|လွင်ႈၸေႉၸၢပ်ႈ	<i>verb</i><br><ol><li>to join by the close union of parts, affiance; be well-finished, well-proportioned, done with perfection</li></ol>
ၸဵင်ႇလႅမ်|tsàèng lěm	<i>noun</i><br><ol><li>acute angle.</li></ol>
ၸဵင်ႇဝၢတ်ႈ|tsàèng wāāt	<i>noun</i><br><ol><li>obtuse angle.</li></ol>
ၸဵင်ႇၶိုင်ႈ|tsàèng khūēng	<i>noun</i><br><ol><li>right angle.</li></ol>
ၸဵတ်း|tsáét	<i>num</i><br><ol><li>seven</li></ol>
ၸဵတ်းသိပ်း|tsáét síp	<i>num</i><br><ol><li>seventy</li></ol>
ၸဵတ်ႈပူဝ်ႇ|tsāēt pò	<i>noun</i><br><ol><li>military officer</li></ol>
ၸွမ်ၸိုင်ႈ|tsǎǔm tsūēng	<i>noun</i><br><ol><li>president (of a country)</li></ol>
ၸွႆႈထႅမ်|လွင်ႈၸွႆႈထႅမ်|tsāūī thěm	<i>verb</i><br><ol><li>help, assist</li></ol>
ၸၢင်|tsǎǎng	<i>noun</i><br><ol><li>tasteless, be lacking in flavor</li></ol>
ၸၢင်ႉ|tsâ̰â̰ng|တူဝ်	<i>noun</i><br><ol><li>elephant</li></ol>
ၸၢတ်ႈ|tsāāt	<i>noun</i><br><ol><li>state of existence of which there are three, present, past and future</li><li>race, caste</li><li>jataka, account of one of the 550 existences of Buddha</li></ol>
ၸၢပ်ႈ|လွင်ႈၸၢပ်ႈ|tsāāp	<i>verb</i><br><ol><li>to connect, join</li><li>to be connected with, pertain to</li><li>to be related in race, ancestry</li></ol>
ၸၢမ်း|tsáám|လွင်ႈၸၢမ်း	<i>verb</i><br><ol><li>to test, make a trial of; feel of in order to discern the quality (used of persons or things)</li></ol>
ၸၢဝ်းၶိူဝ်း|tsááó khóé	<i>noun</i><br><ol><li>ethnic group, race, nationality, native (of a place)</li></ol>
ၸၢၵ်ႈ|tsāāk	<i>noun</i><br><ol><li>wheel.</li><li>machine; engine.</li><li>thunderbolt.</li></ol>
ၸၢႆး|tsááí	<i>noun</i><br><ol><li>male; man.</li></ol>
ၸၼေႇ|tsǎ nèè	<i>noun</i><br><ol><li>(ဝၼ်း~) Saturday</li></ol>
ၸၼ်းတယႃး|tsán tǎ yáá	<i>noun</i><br><ol><li>piano</li></ol>
ၸၼ်ႁၢင်ႈ|လွင်ႈၸၼ်ႁၢင်ႈ|tsǎn hāāng	<i>verb</i><br><ol><li>(transitive) design</li></ol>
ၸၼ်ႇတႃႇ|tsàn tàà	<i>noun</i><br><ol><li>coral (gemstone)</li></ol>
ၸၼ်ႇဝႃႇရီႇ|tsàn wàà rìì	<i>name</i><br><ol><li>January.</li></ol>
ၸႂ်|tsǎǔě	<i>noun</i><br><ol><li>heart</li><li>mind; feeling</li></ol>
ၸႃႇ|tsàà	<i>noun</i><br><ol><li>lace, knitting, embroidery</li></ol>
ၺိတ်ႈ|nyīt|လွင်ႈၺိတ်ႈ	<i>verb</i><br><ol><li>to be uneasy, unhappy</li><li>to do a thing beyond what is reasonable [used only in compositions]</li></ol>
ၺူဝ်ႇ|nyò|တၢင်းၺူဝ်ႇ	<i>adj</i><br><ol><li>brown</li></ol>
ၺွင်ႇ|nyàùng	<i>noun</i><br><ol><li>banyan</li></ol>
ၺွင်ႇပေႃးထီႉ|nyàùng páú thḭ̂ḭ̂	<i>noun</i><br><ol><li>(Buddhism) bodhi tree</li></ol>
ၺၢမ်း|လွင်ႈၺၢမ်း|nyáám	<i>verb</i><br><ol><li>to be fine, soft, delicate</li></ol>
ၺၢမ်ႉ|nyâ̰â̰m|လွင်ႈၺၢမ်ႉ	<i>verb</i><br><ol><li>to be poor, mean, inferior</li></ol>
ၼင်|nǎng	<i>noun</i><br><ol><li>skin.</li></ol>
ၼင်ႈ|လွင်ႈၼင်ႈ|nāng	<i>verb</i><br><ol><li>to sit</li></ol>
ၼမ်ႉ|nâ̰m	<i>noun</i><br><ol><li>water</li><li>liquid</li><li>river</li></ol>
ၼမ်ႉမၼ်း|nâ̰m mán	<i>noun</i><br><ol><li>oil (petroleum or comestible).</li><li>gasoline.</li></ol>
ၼမ်ႉၶူင်း|nâ̰m khúúng	<i>noun</i><br><ol><li>Salween River</li></ol>
ၼမ်ႉၶေႃႉ|လွင်ႈၼမ်ႉၶေႃႉ|nâ̰m khâ̰ṵ̂	<i>verb</i><br><ol><li>have a scarcity of anything</li></ol>
ၼိဝ်ႉ|nḭ̂ô̰	<i>noun</i><br><ol><li>finger; toe</li></ol>
ၼိုင်ႈ|လွင်ႈၼိုင်ႈ|nūēng	<i>num</i><br><ol><li>one</li></ol><br><i>verb</i><br><ol><li>to steam</li></ol>
ၼိူင်း|nóéng|လွင်ႈၼိူင်း	<i>verb</i><br><ol><li>to compare</li><li>to make equal</li><li>to make weights equal</li></ol>
ၼိူင်ႇ|nòèng|လွင်ႈၼိူင်ႇ	<i>verb</i><br><ol><li>to conquer, prevail forcibly</li><li>to compel against one's will</li></ol>
ၼီႉမိၵ်ႈ|nḭ̂ḭ̂ mīk	<i>noun</i><br><ol><li>mark, sign, token, omen</li></ol>
ၼုင်း|núng|လွင်ႈၼုင်း	<i>verb</i><br><ol><li>to be weak, exhausted</li><li>to have the stiffening taken out (as of starched cloth)</li></ol>
ၼုၵ်ႈ|nūk|လွင်ႈၼုၵ်ႈ	<i>verb</i><br><ol><li>to take away, take out, subtract</li></ol>
ၼူ|တူဝ်|nǔǔ	<i>noun</i><br><ol><li>murid, mouse, rat</li></ol>
ၼူဝ်း|nó|လွင်ႈၼူဝ်း	<i>verb</i><br><ol><li>to exhort, urge, stir up to action</li></ol>
ၼူဝ်ႇဝႅမ်ႇပႃႇ|nò wèm pàà	<i>name</i><br><ol><li>November.</li></ol>
ၼူၵ်ႉ|nṵ̂ṵ̂k|တူဝ်	<i>noun</i><br><ol><li>bird.</li></ol>
ၼၢင်း|náang	<i>noun</i><br><ol><li>she, he.</li></ol>
ၼၢင်းတႃႉ|nááng tâ̰â̰	<i>noun</i><br><ol><li>vulture.</li></ol>
ၼၢင်းယိင်း|nááng yíng	<i>noun</i><br><ol><li>Woman.</li></ol>
ၼၢင်းႁေႃၶမ်း|ပႃး|nááng hǎǔ khám	<i>noun</i><br><ol><li>queen</li></ol>
ၼၢမ်ႇသႃႇ|nààm sàà	<i>noun</i><br><ol><li>odiferous substance (most frequently applied to sandalwood, of which there are a number of varieties)</li></ol>
ၼၢႆး|nááí	<i>noun</i><br><ol><li>dew.</li><li>mist.</li><li>grandmother.</li><li>respectful appellation for any aged female.</li></ol>
ၼၵူဝ်ႇ|nǎ kò	<i>noun</i><br><ol><li>nature, constitution, inherent character, original condition</li></ol>
ၼၵႃး|nǎ káá	<i>noun</i><br><ol><li>type of sea dragon</li></ol>
ၼၼ်ႉ|nâ̰n	<i>det</i><br><ol><li>that, those</li></ol>
ၼႂ်း|náúé	<i>noun</i><br><ol><li>inside, interior</li></ol><br><i>prep</i><br><ol><li>(ၵႃႈ~) in, into</li></ol>
ၼႃး|náá	<i>noun</i><br><ol><li>paddy field</li></ol>
ၼႃႈ|တၢင်းၼႃႈ|nāā	<i>noun</i><br><ol><li>(anatomy) face</li></ol><br><i>adv</i><br><ol><li>before; about to</li></ol>
ၼႄၼမ်ႉၼႄတူဝ်|လွင်ႈၼႄၼမ်ႉၼႄတူဝ်|nǎǎě nâ̰m nǎǎě tǒ	<i>verb</i><br><ol><li>(intransitive) carry through, fulfill, realize; implement, carry out</li></ol>
ၼႄႇ|nààè	<i>noun</i><br><ol><li>part of a kingdom, province, state</li></ol>
ၼႅင်ႇ|တၢင်းၼႅင်ႇ|nèng	<i>adv</i><br><ol><li>forcibly, contrary to another's will</li></ol>
ၼႆ|nǎǐ	<i>det</i><br><ol><li>this</li></ol><br><i>adv</i><br><ol><li>thus, as</li></ol><br><i>conj</i><br><ol><li>then, hence</li></ol><br><i>particle</i><br><ol><li>reassure oneself about given information, when used interrogatively, reassure or repeat to an interlocutor of a message just said.</li></ol>
ၼႆယဝ်ႉ|nǎǐ yâ̰ô̰|တၢင်းၼႆယဝ်ႉ	<i>conj</i><br><ol><li>and then, and after that</li></ol><br><i>adv</i><br><ol><li>thus said</li></ol>
ၼႆႉ|nâ̰ḭ̂	<i>det</i><br><ol><li>this</li><li>used to denote strong emphasis.</li><li>used for topicalization.</li><li>used to mark a general topic.</li></ol>
ၽင်း|လွင်ႈၽင်း|pháng	<i>verb</i><br><ol><li>to listen</li></ol>
ၽတ်း|phát|လွင်ႈၽတ်း	<i>verb</i><br><ol><li>to read</li></ol>
ၽဝႃႇ|phǎ wàà	<i>noun</i><br><ol><li>blanket of any kind, scarf, stole</li></ol>
ၽိင်း|phíng	<i>noun</i><br><ol><li>opium</li></ol>
ၽိဝ်ၼင်|phǐǒ nǎng	<i>noun</i><br><ol><li>(anatomy) skin</li></ol>
ၽိုင်ႈ|phūēng	<i>noun</i><br><ol><li>bee (insect)</li></ol>
ၽိူဝ်ႉ|phô̰ḛ̂	<i>noun</i><br><ol><li>wizard, sorcerer, witch, sorceress</li></ol>
ၽိၵ်ႈၶူႇ|phīk khùù	<i>noun</i><br><ol><li>(Buddhism) bhikkhu</li></ol>
ၽိၼ်ႇ|phìn	<i>noun</i><br><ol><li>opium</li></ol>
ၽီလူး|phǐǐ lúú	<i>noun</i><br><ol><li>(mythology) ogre</li></ol>
ၽုင်ႇ|phùng	<i>noun</i><br><ol><li>superadded roof, gradation of a turreted roof</li></ol>
ၽုၵ်ႇ|လွင်ႈၽုၵ်ႇ|phùk	<i>verb</i><br><ol><li>to tie; to bind.</li><li>to plant.</li></ol>
ၽုၺ်ႇ|phùì|လွင်ႈၽုၺ်ႇ	<i>verb</i><br><ol><li>(transitive) open.</li></ol>
ၽူၼ်|phǔǔn	<i>noun</i><br><ol><li>rain</li></ol>
ၽူႈတၢင်တူဝ်|phūū tǎǎng tǒ	<i>noun</i><br><ol><li>agent, representative</li></ol>
ၽူႈလူင်ႉလႅၼ်ႇ|phūū lṵ̂ṵ̂ng lèn	<i>noun</i><br><ol><li>expert</li></ol>
ၽူႈလၵ်ႉ|phūū lâ̰k	<i>noun</i><br><ol><li>thief</li></ol>
ၽေး|phéé	<i>noun</i><br><ol><li>evil, calamity, danger, harm</li></ol>
ၽေႇ|phèè|လွင်ႈၽေႇ	<i>verb</i><br><ol><li>to loose, unfold</li><li>to cancel, release (as a person from sin, debt, or grudge)</li></ol>
ၽျၢင်း|လွင်ႈၽျၢင်း|phjááng	<i>verb</i><br><ol><li>to be useless, good for nothing</li></ol>
ၽျၢၼ်း|phjáán	<i>noun</i><br><ol><li>witness.</li></ol>
ၽြႃး|phráá	<i>noun</i><br><ol><li>god, object of worship</li></ol>
ၽြႃးလွင်း|phráá láúng	<i>noun</i><br><ol><li>future Buddha, one who is to become a Buddha</li></ol>
ၽြႃးဢလွင်း|phráá ʼǎ láúng	<i>noun</i><br><ol><li>(Buddhism) future Buddha; one who is destined for Buddhahood</li></ol>
ၽွင်ၶမ်း|phǎǔng khám	<i>noun</i><br><ol><li>The gold dust.</li></ol>
ၽွႆႉ|phâ̰ṵ̂ḭ̂	<i>noun</i><br><ol><li>honorary title or name</li></ol>
ၽၢၼ်ႇ|phààn|လွင်ႈၽၢၼ်ႇ	<i>verb</i><br><ol><li>to create</li></ol>
ၽၢၼ်ႇသၢင်း|လွင်ႈၽၢၼ်ႇသၢင်း|phààn sááng	<i>verb</i><br><ol><li>make, create, give form and appearance, transform</li></ol>
ၽၵ်းတူ|phák tǔǔ	<i>noun</i><br><ol><li>door</li></ol>
ၽၵ်းၵုတ်ႇ|phák kùt	<i>noun</i><br><ol><li>moss, fern</li></ol>
ၽၵ်းၵူဝ်ႈ|phák kō	<i>noun</i><br><ol><li>salad</li></ol>
ၽၵ်းၵၢတ်ႇမွၵ်ႇ|phák kààt màùk	<i>noun</i><br><ol><li>cauliflower.</li></ol>
ၽၼ်ႇတႃႇၸူဝ်း|phàn tàà tsó	<i>noun</i><br><ol><li>treasurer</li></ol>
ၽႃႇသႃႇ|phàà sàà	<i>noun</i><br><ol><li>any system of religion or language; customary way</li></ol>
ၽႃႇသႃႇမၢၼ်ႈ|phàà sàà māān	<i>noun</i><br><ol><li>Burmese language.</li></ol>
ၽႃႈၶိၵ်ႈၽႃႈၵွင်ႉ|phāā khīk phāā kâ̰ṵ̂ng	<i>noun</i><br><ol><li>cloth with stripes and wavy designs</li></ol>
ၽႃႉ|phâ̰â̰|မၢၵ်ႈ	<i>noun</i><br><ol><li>sky</li><li>large knife with a blunted end; hatchet of the Shans</li></ol><br><i>verb</i><br><ol><li>(dialectal) to novitiate for the priesthood</li></ol>
ၽႆး|pháí	<i>noun</i><br><ol><li>fire</li><li>additional silver put into alloyed silver to raise its value</li></ol>
ၽႆးၽႃႉ|pháí phâ̰â̰	<i>noun</i><br><ol><li>electricity</li></ol>
ၾိၼ်ႇ|fìn	<i>noun</i><br><ol><li>opium</li></ol>
ၾူၼ်|fǔǔn	<i>noun</i><br><ol><li>rain</li></ol>
ၾႅပ်ႇဝႃႇရီႇ|fèp wàà rìì	<i>name</i><br><ol><li>February.</li></ol>
ၾႆး|fáí	<i>noun</i><br><ol><li>fire</li></ol>
ၾႆးၾႃႉ|fáí fâ̰â̰	<i>noun</i><br><ol><li>electricity</li></ol>
ႀမတႃႉ|xǎ mǎ tâ̰â̰|သမတႃႉ|sǎ mǎ tâ̰â̰	<i>noun</i><br><ol><li>president (of a country)</li></ol>
ႀမႃႉဝႃႇယမႃႉ|xǎ mâ̰â̰ wàà yǎ mâ̰â̰	<i>noun</i><br><ol><li>cooperative</li></ol>
ႀရၽူႇ|xǎ rǎ phùù	<i>noun</i><br><ol><li>crown (worn on the head)</li></ol>
ႀီႇႁူဝ်ႇ|xìì hò	<i>name</i><br><ol><li>Sri Lanka, Ceylon</li></ol>
ႀူဝ်း|xó	<i>noun</i><br><ol><li>sheep</li></ol>
ႀၼၢပ်ႈၶႃး|xǎ nāāp kháá	<i>noun</i><br><ol><li>thanakha.</li></ol>
ႁင်းသႃႇ|háng sàà	<i>noun</i><br><ol><li>Brahminy duck; ruddy shelduck.</li><li>swan.</li></ol>
ႁတရႃႉ|hǎ tǎ râ̰â̰	<i>noun</i><br><ol><li>heart</li></ol>
ႁမ်းလိၵ်ႈ|hám līk	<i>noun</i><br><ol><li>scroll, roll</li></ol>
ႁဝ်းၶႃႈ|háó khāā	<i>pron</i><br><ol><li>(formal) we, us, our</li></ol>
ႁိင်ႇႁွႆႈ|hìng hāūī|တူဝ်	<i>noun</i><br><ol><li>firefly</li></ol>
ႁိူဝ်း|hóé	<i>noun</i><br><ol><li>boat.</li></ol>
ႁိူဝ်းမိၼ်|hóé mǐn	<i>noun</i><br><ol><li>airplane</li></ol>
ႁိၼ်|hǐn	<i>noun</i><br><ol><li>rock; stone.</li></ol>
ႁိၼ်သူမ်ႈ|hǐn sūūm	<i>noun</i><br><ol><li>alum</li></ol>
ႁုၼ်ႇ|hùn	<i>noun</i><br><ol><li>puppet; doll.</li></ol>
ႁူင်|hǔǔng|လွင်ႈႁူင်	<i>verb</i><br><ol><li>to toss; to toss up.</li><li>to be famous; to be celebrated.</li><li>to be spread abroad.</li></ol><br><i>noun</i><br><ol><li>swan.</li></ol>
ႁူင်းယႃ|húúng yǎǎ	<i>noun</i><br><ol><li>hospital</li></ol>
ႁူင်းဝႆႉၶူဝ်း|húúng wâ̰ḭ̂ khó	<i>noun</i><br><ol><li>storage building, warehouse</li></ol>
ႁူင်းၼႄ|húúng nǎǎě	<i>noun</i><br><ol><li>exhibition hall; museum.</li></ol>
ႁူင်းႁဵၼ်း|húúng háén	<i>noun</i><br><ol><li>school.</li></ol>
ႁူပ်ႉထူပ်း|hṵ̂ṵ̂p thúúp|လွင်ႈႁူပ်ႉထူပ်း	<i>verb</i><br><ol><li>(transitive) encounter, meet</li></ol>
ႁူမ်ႇလူမ်ႈ|လွင်ႈႁူမ်ႇလူမ်ႈ|hùùm lūūm	<i>verb</i><br><ol><li>cover completely, cover and hide</li></ol>
ႁူဝ်ပဝ်ႈ|hǒ pāō	<i>noun</i><br><ol><li>president (of a company), chairman (of a committee), head</li></ol>
ႁူဝ်ၽၵ်းပိုၵ်ႉ|hǒ phák pṵ̂ḛ̂k	<i>noun</i><br><ol><li>carrot .</li></ol>
ႁူဝ်ႉၵိူၼ်ႇ|hô̰ kòèn	<i>noun</i><br><ol><li>gate, fence</li></ol>
ႁူၵ်း|húúk	<i>num</i><br><ol><li>six</li></ol>
ႁူၵ်းသိပ်း|húúk síp	<i>num</i><br><ol><li>sixty</li></ol>
ႁူၵ်ႈ|hūūk	<i>noun</i><br><ol><li>tadpole</li></ol>
ႁူႉ|လွင်ႈႁူႉ|hṵ̂ṵ̂	<i>verb</i><br><ol><li>to know</li></ol>
ႁေႃး|háú|လွင်ႈႁေႃး	<i>verb</i><br><ol><li>to preach, recite, read</li></ol>
ႁေႃၶမ်း|hǎǔ khám	<i>noun</i><br><ol><li>royal palace</li></ol>
ႁဵင်း|háéng|တၢင်းႁဵင်း	<i>noun</i><br><ol><li>place.</li><li>subject; topic.</li></ol><br><i>adj</i><br><ol><li>small.</li></ol>
ႁွၵ်ႇ|hàùk|တၢင်းႁွၵ်ႇ	<i>noun</i><br><ol><li>spear</li></ol><br><i>adj</i><br><ol><li>grey (hair)</li></ol>
ႁၢင်|hǎǎng	<i>noun</i><br><ol><li>tail.</li></ol>
ႁၢင်းလေး|hááng léé	<i>noun</i><br><ol><li>hotchpotch curry</li></ol>
ႁၢင်ႈလီ|hāāng lǐǐ|တၢင်းႁၢင်ႈလီ	<i>adj</i><br><ol><li>beautiful, handsome, good-looking</li></ol>
ႁၢင်ႈႁႅၼ်း|hāāng hén|လွင်ႈႁၢင်ႈႁႅၼ်း	<i>verb</i><br><ol><li>prepare, organize, make ready</li></ol>
ႁၢၼ်ႇ|hààn|လွင်ႈႁၢၼ်ႇ	<i>noun</i><br><ol><li>goose</li></ol><br><i>verb</i><br><ol><li>to have an appearance, appear; be assuming, put on airs</li></ol>
ႁၵ်းလွႆ|hák lǎǔǐ	<i>noun</i><br><ol><li>terrace or small plateau on the side of a mountain, the depressions in a range of mountains</li></ol>
ႁၵ်ႉ|hâ̰k|တၢင်းႁၵ်ႉ|လွင်ႈႁၵ်ႉ	<i>verb</i><br><ol><li>(transitive) love, have affection for</li></ol><br><i>noun</i><br><ol><li>(botany) gum of the black varnish tree, Burmese lacquer</li></ol>
ႁၼ်|hǎn|လွင်ႈႁၼ်	<i>verb</i><br><ol><li>to see</li></ol>
ႁႃႈ|hāā	<i>num</i><br><ol><li>five</li></ol><br><i>noun</i><br><ol><li>epidemic disease, disease prevailing without any apparent cause, particularly cholera</li></ol>
ႁႃႈသိပ်း|hāā síp	<i>num</i><br><ol><li>fifty</li></ol>
ႁႄႉၵင်ႈ|လွင်ႈႁႄႉၵင်ႈ|hâ̰â̰ḛ̂ kāng	<i>verb</i><br><ol><li>hinder, protect from, defend from</li></ol>
ႁႅမ်|hěm	<i>verb</i><br><ol><li>hit</li></ol>
ႉ	<i>character</i><br><ol><li>Creaky tone, it's called ၸမ်ႈတႂ်ႈ (tsām tāūē).</li></ol>
႐	<i>num</i><br><ol><li>0 (zero)</li></ol>
႑	<i>num</i><br><ol><li>1 (one)</li></ol>
႒	<i>num</i><br><ol><li>2 (two)</li></ol>
႓	<i>num</i><br><ol><li>3 (three)</li></ol>
႔	<i>num</i><br><ol><li>4 (four)</li></ol>
႕	<i>num</i><br><ol><li>5 (five)</li></ol>
႖	<i>num</i><br><ol><li>6 (six)</li></ol>
႗	<i>num</i><br><ol><li>7 (seven)</li></ol>
႘	<i>num</i><br><ol><li>8 (eight)</li></ol>
႙	<i>num</i><br><ol><li>9 (nine)</li></ol>
႞	<i>symbol</i><br><ol><li>A counter placed after the counted noun in Shan language writing.</li></ol>
႟	<i>symbol</i><br><ol><li>The symbol used to represent exclamations such as "Oh!" when writing the Shan language</li></ol>
