Алтай|Altay	<i>name</i><br><ol><li>Altay, Altai (a mountain range in Central Asia); see Altai Mountains</li><li>Altai Republic (a republic of Russia)</li><li>Altai Krai (a krai of Russia)</li><li>A prefecture of Xinjiang, China</li><li>A city in Altay prefecture, Xinjiang, China</li><li>A town in the East Kazakhstan Region, Kazakhstan</li><li>The capital city of Govi-Altai Province, Mongolia</li></ol>
Кадын|Kadïn	<i>name</i><br><ol><li>Katun (tributary of the Ob)</li></ol>
Кыдат|Kïdat	<i>name</i><br><ol><li>China</li><li>a unisex given name from Oirat, meaning "Chinese"</li></ol>
Моол|Mool	<i>name</i><br><ol><li>Mongolia (a country in inner Asia)</li></ol>
Тӱҥӱр|Tüŋür	<i>noun</i><br><ol><li>a village in the Altai Republic.</li></ol>
Эдил|Edil	<i>noun</i><br><ol><li>Volga</li></ol>
Энесей|Enesey	<i>name</i><br><ol><li>Yenisei (a major river in Russia)</li></ol>
Эртиш|Ertiš	<i>noun</i><br><ol><li>Irtish</li></ol>
аару|aaru	<i>noun</i><br><ol><li>bee</li></ol>
абра|abra	<i>noun</i><br><ol><li>cart, araba</li></ol>
агалу-ийиндӱ|agalu-iyindü	<i>noun</i><br><ol><li>younger brother and elder brother</li></ol>
агар|agar	<i>verb</i><br><ol><li>to flow</li></ol>
агас|aɣas	<i>noun</i><br><ol><li>ermine</li></ol>
агаш|agaš	<i>noun</i><br><ol><li>tree</li></ol>
агын|agïn	<i>noun</i><br><ol><li>flow</li></ol>
ада|ada	<i>noun</i><br><ol><li>father</li></ol>
ада-эне|ada-ene	<i>noun</i><br><ol><li>parent</li></ol>
адалгы|adalgı	<i>noun</i><br><ol><li>oar</li></ol>
адалгыш|adalgış	<i>noun</i><br><ol><li>(linguistics) noun</li></ol>
адар|adar	<i>verb</i><br><ol><li>to shoot</li></ol>
адару|adaru	<i>noun</i><br><ol><li>bee</li></ol>
азык-тӱлӱк|azïk-tülük	<i>noun</i><br><ol><li>food</li></ol>
ай|айларга|айды|айда|айларда|айга|айдаҥ|айдыҥ|айларды|айлардаҥ|айлардыҥ|айлар|ay	<i>noun</i><br><ol><li>moon</li></ol>
айак|айактарды|айактардыҥ|айактар|айакта|айактардаҥ|айактарда|айак|ayak|айакка|айакты|айактаҥ|айактарга|айактыҥ	<i>noun</i><br><ol><li>leg</li><li>foot</li><li>cup</li></ol>
айас|ayas	<i>adj</i><br><ol><li>clear</li></ol>
айгыр|aygïr	<i>noun</i><br><ol><li>stallion</li></ol>
айдар|aydar	<i>verb</i><br><ol><li>to tell, to say</li></ol>
айланар|aylanar	<i>verb</i><br><ol><li>to rotate</li></ol>
айран|ayran	<i>noun</i><br><ol><li>airan</li></ol>
айрыыр|ayrïïr	<i>verb</i><br><ol><li>to separate</li></ol>
айу|ayu	<i>noun</i><br><ol><li>bear</li></ol>
айыл|ayïl	<i>noun</i><br><ol><li>yurt, village</li></ol>
ак|ak	<i>adj</i><br><ol><li>white</li></ol>
ака|aka	<i>noun</i><br><ol><li>elder brother</li></ol>
аксагал|aksagal	<i>noun</i><br><ol><li>old man</li></ol>
аксак|aksak	<i>adj</i><br><ol><li>lame</li></ol>
акча|akča	<i>noun</i><br><ol><li>money</li></ol>
акырын|akïrïn	<i>adv</i><br><ol><li>slowly</li></ol>
алабуга|alabuga	<i>noun</i><br><ol><li>perch</li></ol>
алакан|alakan	<i>noun</i><br><ol><li>palm</li></ol>
алар|alar	<i>verb</i><br><ol><li>to take</li></ol>
албаты|albatï	<i>noun</i><br><ol><li>(historical) subject</li><li>people</li></ol>
алд|ald	<i>noun</i><br><ol><li>front</li></ol>
алдында|aldïnda	<i>postp</i><br><ol><li>in front of, before</li></ol>
алкыш|alkïš	<i>noun</i><br><ol><li>blessing</li></ol>
алкыш-быйан|alkïš-bïyan	<i>noun</i><br><ol><li>gratitude</li></ol>
алту|altu	<i>num</i><br><ol><li>six in group together</li></ol>
алты|altı	<i>num</i><br><ol><li>six</li></ol>
алтын|altïn	<i>noun</i><br><ol><li>gold</li></ol>
алтынчы|altïnčï	<i>num</i><br><ol><li>sixth</li></ol>
алып|alïp	<i>noun</i><br><ol><li>hero</li></ol>
амаду|amadu	<i>noun</i><br><ol><li>goal</li></ol>
ар|ar	<i>adj</i><br><ol><li>every</li></ol>
ара|ara	<i>noun</i><br><ol><li>space</li></ol>
аразында|arazïnda	<i>adv</i><br><ol><li>between, among</li></ol>
аракы|arakı	<i>noun</i><br><ol><li>vodka</li></ol>
аракызак|arakızak	<i>noun</i><br><ol><li>drunkard</li></ol>
арба|arba	<i>noun</i><br><ol><li>barley</li></ol>
арка|arka	<i>noun</i><br><ol><li>back</li></ol>
аркан|arkan	<i>noun</i><br><ol><li>rope</li></ol>
аркар|arkar	<i>noun</i><br><ol><li>argali</li></ol>
арслан|arslan	<i>noun</i><br><ol><li>lion</li></ol>
арт	<i>noun</i><br><ol><li>back, rear</li></ol>
артык|artïk	<i>adj</i><br><ol><li>excessive</li></ol>
ару|aru	<i>adj</i><br><ol><li>clear</li></ol>
ас|as	<i>adj</i><br><ol><li>a little</li><li>a few</li></ol>
ат|атка|аттардаҥ|атта|аттарда|аттаҥ|at|атты|аттыҥ|аттар|аттарга|аттарды|ат|аттардыҥ	<i>noun</i><br><ol><li>name</li><li>horse</li></ol>
атар|atar	<i>verb</i><br><ol><li>to shoot</li></ol>
ач|ač	<i>adj</i><br><ol><li>hungry</li></ol>
ачар|ačar	<i>verb</i><br><ol><li>to open</li></ol>
ачкыч|açkíç	<i>noun</i><br><ol><li>key</li></ol>
ачу|aču	<i>noun</i><br><ol><li>anger, wrath</li></ol><br><i>adj</i><br><ol><li>bitter</li></ol>
ачык|ačïk	<i>adj</i><br><ol><li>open</li></ol>
аш|aš	<i>noun</i><br><ol><li>food, meal</li></ol>
ашкана|aškana	<i>noun</i><br><ol><li>canteen, cafeteria, restaurant</li></ol>
аҥ|aŋ	<i>noun</i><br><ol><li>beast, wild animal</li></ol>
аҥчы|aŋčï	<i>noun</i><br><ol><li>hunter</li></ol>
баа|baa	<i>noun</i><br><ol><li>price</li></ol>
баатыр|baatïr	<i>noun</i><br><ol><li>hero</li></ol>
бадар|badar	<i>verb</i><br><ol><li>to come in</li></ol>
базар|bazar	<i>noun</i><br><ol><li>market</li></ol><br><i>verb</i><br><ol><li>to press</li></ol>
бай|bay	<i>adj</i><br><ol><li>rich</li></ol>
байа|baya	<i>adv</i><br><ol><li>recently</li></ol>
байлу|baylu	<i>noun</i><br><ol><li>tying</li></ol>
байлык|baylïk	<i>noun</i><br><ol><li>wealth</li></ol>
байрам|bayram	<i>noun</i><br><ol><li>holiday</li></ol>
байтал|baytal	<i>noun</i><br><ol><li>mare that has not yet produced young</li></ol>
байыыр|bayïïr	<i>verb</i><br><ol><li>(intransitive) to grow rich</li></ol>
бака|baka	<i>noun</i><br><ol><li>frog</li></ol>
бакана|bakana	<i>noun</i><br><ol><li>pillar, column</li></ol>
бакыр|bakïr	<i>adj</i><br><ol><li>poor</li></ol>
бал|bal	<i>noun</i><br><ol><li>honey</li></ol>
бала|bala	<i>noun</i><br><ol><li>child</li></ol>
балтыр|baltïr	<i>noun</i><br><ol><li>roe</li></ol>
балык|balïk	<i>noun</i><br><ol><li>fish</li></ol>
балыкчы|balïkčï	<i>noun</i><br><ol><li>fisherman</li></ol>
бар|bar	<i>adj</i><br><ol><li>there is / there are, there exist; I/you have, he/she has, etc.</li></ol>
барар|barar	<i>verb</i><br><ol><li>to go</li></ol>
бармак|barmak	<i>noun</i><br><ol><li>finger</li></ol>
барс|bars	<i>noun</i><br><ol><li>tiger</li></ol>
баскыш|baskïš	<i>noun</i><br><ol><li>stair, staircase</li></ol>
бассы|bassï	<i>noun</i><br><ol><li>sister-in-law</li></ol>
баткак|batkak	<i>noun</i><br><ol><li>swamp, marsh</li></ol>
батша|batša	<i>noun</i><br><ol><li>king, tsar</li></ol>
баш|baš	<i>noun</i><br><ol><li>head</li></ol>
башка|baška	<i>adj</i><br><ol><li>other</li></ol>
башкарар|baškarar	<i>verb</i><br><ol><li>to rule, govern</li></ol>
башмак|bašmak	<i>noun</i><br><ol><li>shoe, boot</li></ol>
баштапкы|baštapkï	<i>adj</i><br><ol><li>first</li></ol>
баштык|baštïk	<i>noun</i><br><ol><li>sack, handbag</li></ol>
башчы|baščï	<i>noun</i><br><ol><li>leader</li></ol>
баја|baǰa	<i>noun</i><br><ol><li>one's wife's sister's husband; brother-in-law</li></ol>
бее|bee	<i>noun</i><br><ol><li>mare</li></ol>
бежен|bežen	<i>num</i><br><ol><li>fifty</li></ol>
бежинчи|bejinçi	<i>num</i><br><ol><li>fifth</li></ol>
бежӱ|bežü	<i>num</i><br><ol><li>five (in a group together)</li></ol>
бек|bek	<i>adv</i><br><ol><li>firm</li></ol><br><i>adj</i><br><ol><li>firm</li></ol>
бел|bel	<i>noun</i><br><ol><li>waist</li></ol>
белги|belgi	<i>noun</i><br><ol><li>sign,</li><li>mark</li><li>token</li></ol>
беле|bele	<i>noun</i><br><ol><li>rowan</li></ol>
белен|belen	<i>adj</i><br><ol><li>ready</li></ol>
берер|berer	<i>verb</i><br><ol><li>to give</li></ol>
берт|bert	<i>adj</i><br><ol><li>practicable</li></ol>
бес|bes	<i>noun</i><br><ol><li>gland</li></ol>
бет|bet	<i>noun</i><br><ol><li>face</li></ol>
беш|beş	<i>num</i><br><ol><li>five</li></ol>
бий|biy	<i>noun</i><br><ol><li>gentleman, master, lord</li></ol>
бийе|biye	<i>noun</i><br><ol><li>dance</li></ol>
бийеер|biyeer	<i>verb</i><br><ol><li>to dance</li></ol>
бийелеер|biyeleer	<i>verb</i><br><ol><li>to dance</li></ol>
бийечи|biyeči	<i>noun</i><br><ol><li>dancer</li></ol>
бийик|biyik	<i>adj</i><br><ol><li>tall</li><li>high</li></ol>
бийт|biyt	<i>noun</i><br><ol><li>louse</li></ol>
биле|bile	<i>noun</i><br><ol><li>family</li></ol>
билер|biler	<i>verb</i><br><ol><li>to know</li></ol>
билерик|bilerik	<i>noun</i><br><ol><li>bracelet</li></ol>
билим|bilim	<i>noun</i><br><ol><li>knowledge</li></ol>
бир|bir	<i>num</i><br><ol><li>one</li></ol>
бирге|birge	<i>adv</i><br><ol><li>together</li></ol>
биригер|biriger	<i>verb</i><br><ol><li>to unite</li></ol>
бириккен|birikken	<i>adj</i><br><ol><li>connected, united</li></ol>
биринчи|birinči	<i>num</i><br><ol><li>first</li></ol>
бирсӱӱн|birsüün	<i>noun</i><br><ol><li>day after tomorrow</li></ol>
бирӱ|birü	<i>num</i><br><ol><li>one (of several), one</li></ol>
бистиҥ|bistiŋ	<i>pron</i><br><ol><li>thee (second-person plural familiar personal pronoun)</li></ol>
бичен|bičen	<i>noun</i><br><ol><li>hay</li></ol>
бичиир|bičiir	<i>verb</i><br><ol><li>to write</li></ol>
бичик|biçik|biçikter	<i>noun</i><br><ol><li>book</li></ol>
богок|bogok	<i>noun</i><br><ol><li>crop</li></ol>
бозого|bozogo	<i>noun</i><br><ol><li>threshold</li></ol>
бозорор|bozoror	<i>verb</i><br><ol><li>to be gray</li></ol>
бозу|bozu	<i>noun</i><br><ol><li>calf</li></ol>
бой|boy	<i>noun</i><br><ol><li>growth</li></ol>
бойор|boyor	<i>verb</i><br><ol><li>to paint, dye, color</li></ol>
бойу|boyu	<i>noun</i><br><ol><li>dye, color</li></ol>
болзо|bolzo	<i>verb</i><br><ol><li>third-person conditional-concessive of бол- (bol-, affirmative stem)</li></ol>
болор|bolor	<i>verb</i><br><ol><li>to be; to become</li></ol>
болот|bolot	<i>noun</i><br><ol><li>steel</li></ol>
боос|boos	<i>noun</i><br><ol><li>pregnant</li><li>throat</li></ol><br><i>adj</i><br><ol><li>pregnant</li></ol>
бор|bor	<i>noun</i><br><ol><li>skin forming milk</li></ol>
бороон|boroon	<i>noun</i><br><ol><li>blizzard, snowstorm</li><li>storm</li></ol>
борсок|borsok	<i>noun</i><br><ol><li>pieces of deep-fried dough</li></ol>
борсык|borsïk	<i>noun</i><br><ol><li>badger</li></ol>
бос|bos	<i>adj</i><br><ol><li>gray</li></ol>
бос торкой|bos torkoy	<i>noun</i><br><ol><li>skylark</li></ol>
боскос|boskos	<i>noun</i><br><ol><li>gudgeon</li></ol>
ботко|botko	<i>noun</i><br><ol><li>porridge</li></ol>
бош|boš	<i>adj</i><br><ol><li>empty</li></ol>
бојо|boǰo	<i>noun</i><br><ol><li>home brew</li></ol>
бу|bu	<i>pron</i><br><ol><li>this</li></ol>
бука|buka	<i>noun</i><br><ol><li>ox, bull</li></ol>
булак|bulak	<i>noun</i><br><ol><li>stream, source</li></ol>
булут|bulut	<i>noun</i><br><ol><li>cloud</li></ol>
бурыыр|бурып ийер|burïïr	<i>verb</i><br><ol><li>to turn</li></ol>
бут|but	<i>noun</i><br><ol><li>foot</li></ol>
буу|buu	<i>noun</i><br><ol><li>steam</li><li>cord, rope</li></ol>
буудай|buuday	<i>noun</i><br><ol><li>wheat</li></ol>
буур|buur	<i>noun</i><br><ol><li>liver</li></ol><br><i>verb</i><br><ol><li>to strangle</li></ol>
бујыл|buǰïl	<i>adv</i><br><ol><li>this year</li></ol>
быжар|bïžar	<i>verb</i><br><ol><li>to ripen</li></ol>
былтыр|bïltïr	<i>adv</i><br><ol><li>last year</li></ol>
бычак|bïčak	<i>noun</i><br><ol><li>knife</li></ol>
бычыыр|bïčïïr	<i>verb</i><br><ol><li>to cut</li></ol>
быштак|bïštak	<i>noun</i><br><ol><li>cheese</li></ol>
бӧкӧ|bökö	<i>noun</i><br><ol><li>strong man</li></ol>
бӧлјирген|bölǰirgen	<i>noun</i><br><ol><li>berry</li></ol>
бӧрӱ|börü	<i>noun</i><br><ol><li>wolf</li></ol>
бӧрӱк|börük	<i>noun</i><br><ol><li>hat</li></ol>
бӧс|bös	<i>noun</i><br><ol><li>fabric, cloth</li></ol>
бӧӧрӧк|böörök	<i>noun</i><br><ol><li>kidney</li></ol>
бӱгӱн|bügün	<i>adv</i><br><ol><li>today</li></ol>
бӱдер|büder	<i>verb</i><br><ol><li>to end</li></ol>
бӱдӱн|büdün	<i>adj</i><br><ol><li>whole, entire</li></ol>
деген|degen	<i>adj</i><br><ol><li>called, named</li></ol>
деер|deer	<i>verb</i><br><ol><li>to say</li><li>to tell</li></ol>
иженер|ižener	<i>verb</i><br><ol><li>to believe</li></ol>
ижениш|iženiš	<i>noun</i><br><ol><li>hope, reliance, trust</li></ol>
изӱ|izü	<i>adj</i><br><ol><li>hot</li></ol>
ийер|iyer	<i>verb</i><br><ol><li>to send</li></ol>
ийик|iyik	<i>noun</i><br><ol><li>spindle</li></ol>
ийин|iyin	<i>noun</i><br><ol><li>shoulder</li></ol>
ийирер|iyirer	<i>verb</i><br><ol><li>to spin</li></ol>
ийменер|iymener	<i>verb</i><br><ol><li>to be afraid</li></ol>
ийне|iyne	<i>noun</i><br><ol><li>needle</li></ol>
ийт|iyt	<i>noun</i><br><ol><li>dog</li></ol>
ийт балык|iyt balïk	<i>noun</i><br><ol><li>turbot</li></ol>
илер|iler	<i>verb</i><br><ol><li>to hang</li></ol>
илмек|ilmek	<i>noun</i><br><ol><li>hook</li></ol>
инек|inek	<i>noun</i><br><ol><li>cow</li></ol>
инји|inǰi	<i>noun</i><br><ol><li>pearl</li></ol>
ириҥ|iriŋ	<i>noun</i><br><ol><li>pus</li></ol>
ис|is	<i>noun</i><br><ol><li>trace</li></ol>
истеер|isteer	<i>verb</i><br><ol><li>to search</li></ol>
ич|ič	<i>noun</i><br><ol><li>inside, stomach</li></ol>
ичер|ičer	<i>verb</i><br><ol><li>to drink</li></ol>
ичинде|ičinde	<i>adv</i><br><ol><li>inside</li></ol>
ичкери|ičkeri	<i>adv</i><br><ol><li>inside</li></ol>
иш|iš	<i>noun</i><br><ol><li>work</li></ol>
ишчи|išči	<i>noun</i><br><ol><li>worker</li></ol>
кабар|kabar	<i>noun</i><br><ol><li>news</li></ol>
кабык|kabïk	<i>noun</i><br><ol><li>bark</li><li>shell</li></ol>
кабырга|kabïrga	<i>noun</i><br><ol><li>rib</li></ol>
кабырчак|kabïrčak	<i>noun</i><br><ol><li>shell</li></ol>
кагас|kagas	<i>noun</i><br><ol><li>paper</li></ol>
каду|kadu	<i>noun</i><br><ol><li>nail</li></ol>
кадын|kadïn	<i>noun</i><br><ol><li>women, wife</li></ol>
кадыт|kadït	<i>noun</i><br><ol><li>wife</li></ol>
казан|kazan	<i>noun</i><br><ol><li>cauldron</li></ol>
казар|kazar	<i>verb</i><br><ol><li>to dig</li></ol>
казна|kazna	<i>noun</i><br><ol><li>treasure</li></ol>
казы|kazï	<i>noun</i><br><ol><li>fat (of animals)</li></ol>
казык|kazïk	<i>noun</i><br><ol><li>stake</li></ol>
кай|kay	<i>noun</i><br><ol><li>overtone singing</li></ol>
кайа|kaya	<i>noun</i><br><ol><li>rock, cliff</li></ol>
кайгы|kaygï	<i>noun</i><br><ol><li>sorrow</li></ol>
кайда|kayda	<i>adv</i><br><ol><li>(interrogative) where?</li></ol>
кайдаҥ|kaydañ	<i>adv</i><br><ol><li>whence, from where</li></ol>
кайык|kayïk	<i>noun</i><br><ol><li>oar</li></ol>
кайын|kayïn	<i>noun</i><br><ol><li>relative in-law</li></ol>
кайын ада|kayïn ada	<i>noun</i><br><ol><li>father-in-law</li></ol>
кайын ака|kayïn aka	<i>noun</i><br><ol><li>brother-in-law</li></ol>
кайын эне|kayïn ene	<i>noun</i><br><ol><li>mother-in-law</li></ol>
кайыш|kayïš	<i>noun</i><br><ol><li>belt</li></ol>
кайыҥ|kayïŋ	<i>noun</i><br><ol><li>birch</li></ol>
кала|kala	<i>noun</i><br><ol><li>city</li></ol>
калай|kalay	<i>noun</i><br><ol><li>tin</li></ol>
калык|калыктардыҥ|калыкка|калыктыҥ|калыктарга|калыкты|kalïk|калыктаҥ|калыктардаҥ|калыктар|калыктарда|калыкта|калыктарды	<i>noun</i><br><ol><li>people</li></ol>
калып|kalïp	<i>noun</i><br><ol><li>form (for shape), mold</li></ol>
камчы|kamčï	<i>noun</i><br><ol><li>whip</li></ol>
камыш|kamïš	<i>noun</i><br><ol><li>reed</li></ol>
кан|кандыҥ|канды|кандаҥ|канга|kan|кан|канда	<i>noun</i><br><ol><li>blood</li><li>khan</li><li>khanate, country</li></ol>
канат|kanat	<i>noun</i><br><ol><li>wing</li></ol>
канча|kanča	<i>adv</i><br><ol><li>how many</li></ol>
канјыл|kanǰïl	<i>noun</i><br><ol><li>dagger</li></ol>
кап|kap	<i>noun</i><br><ol><li>sack</li></ol>
капчык|kapčïk	<i>noun</i><br><ol><li>sack</li></ol>
кар|kar	<i>noun</i><br><ol><li>snow</li></ol>
кара|kara	<i>noun</i><br><ol><li>black</li></ol>
кара чай|kara čay	<i>noun</i><br><ol><li>black tea</li></ol>
кара-агаш|kara-agaš	<i>noun</i><br><ol><li>elm</li></ol>
кара-куш|kara-kuš	<i>noun</i><br><ol><li>golden eagle</li></ol>
карагай|karagay	<i>noun</i><br><ol><li>pine</li></ol>
карандаш|karandaš	<i>noun</i><br><ol><li>pencil</li></ol>
караҥуй|karaŋu|караҥу|karaŋuy	<i>adj</i><br><ol><li>dark</li></ol>
карга|karga	<i>noun</i><br><ol><li>crow</li></ol>
карлагаш|karlagaš	<i>noun</i><br><ol><li>swallow</li></ol>
кармаар|karmaar	<i>verb</i><br><ol><li>to grasp</li></ol>
кармак|karmak	<i>noun</i><br><ol><li>fishing rod</li></ol>
карын|karïn	<i>noun</i><br><ol><li>belly, stomach</li></ol>
карындаш|karïndaš	<i>noun</i><br><ol><li>relative</li><li>brother</li></ol>
карыыр|karïïr	<i>verb</i><br><ol><li>(unaccusative) to grow old</li></ol>
кас|kas	<i>noun</i><br><ol><li>goose</li></ol>
кат|kat	<i>noun</i><br><ol><li>layer</li><li>letter</li><li>berry</li></ol>
кату|katu	<i>adj</i><br><ol><li>solid, hard</li></ol>
качан|kačan	<i>adv</i><br><ol><li>when</li></ol>
качкын|kačkïn	<i>noun</i><br><ol><li>fugitive</li></ol>
каш|kaš	<i>noun</i><br><ol><li>eyebrow</li></ol>
каҥмыл|kaŋmïl	<i>noun</i><br><ol><li>tumbleweed</li></ol>
кебедел|kebedel	<i>noun</i><br><ol><li>coat of arms</li></ol>
кебис|kebis	<i>noun</i><br><ol><li>carpet</li></ol>
кегирер|kegirer	<i>verb</i><br><ol><li>to belch</li></ol>
кедер|keder	<i>verb</i><br><ol><li>to go (by foot)</li></ol>
кезер|kezer	<i>verb</i><br><ol><li>to cut</li></ol>
келер|keler	<i>verb</i><br><ol><li>to come</li></ol>
келин|kelin	<i>noun</i><br><ol><li>daughter-in-law</li></ol>
кем|kem	<i>pron</i><br><ol><li>who</li></ol>
кеме|keme	<i>noun</i><br><ol><li>boat</li></ol>
кемеге|kemege	<i>noun</i><br><ol><li>hearth</li></ol>
кемирер|kemirer	<i>verb</i><br><ol><li>to gnaw</li></ol>
кемирӱ|kemirü	<i>noun</i><br><ol><li>(small) Bridge, footbridge</li><li>Captain's bridge</li></ol>
кенје|kenǰe	<i>adj</i><br><ol><li>the youngest</li></ol>
кеп|kep	<i>noun</i><br><ol><li>form, shape, cloth</li></ol>
керек|kerek	<i>noun</i><br><ol><li>need</li></ol><br><i>adj</i><br><ol><li>it is necessary</li></ol>
кери|keri	<i>adj</i><br><ol><li>back</li></ol>
кертме|kertme	<i>noun</i><br><ol><li>hoe</li></ol>
кеч|keč	<i>noun</i><br><ol><li>evening</li></ol>
кече|keče	<i>noun</i><br><ol><li>yesterday</li></ol>
кеҥ|keŋ	<i>adj</i><br><ol><li>wide</li><li>broad</li></ol>
кижи|kiži|кижилер	<i>noun</i><br><ol><li>person, human</li></ol>
кижилик|kižilik	<i>noun</i><br><ol><li>humanity, humankind</li></ol>
кийер|kiyer	<i>verb</i><br><ol><li>to put on</li></ol>
кийим|kiyim	<i>noun</i><br><ol><li>clothes</li></ol>
кийин|kiyin	<i>noun</i><br><ol><li>later</li></ol>
кийинер|kiyiner	<i>verb</i><br><ol><li>to dress</li></ol>
кийининде|kiyininde	<i>adv</i><br><ol><li>behind</li></ol>
кийис|kiyis	<i>noun</i><br><ol><li>felt</li></ol>
киндик|kindik	<i>noun</i><br><ol><li>umbilical cord, navel</li></ol>
кир|kir	<i>noun</i><br><ol><li>dirt</li></ol>
кирбик|kirbik	<i>noun</i><br><ol><li>eyelash</li></ol>
кирер|kirer	<i>verb</i><br><ol><li>to enter</li></ol>
кириш|kiriš	<i>noun</i><br><ol><li>entry, entrance</li><li>bowstring</li></ol>
кирпич|kirpič	<i>noun</i><br><ol><li>brick</li></ol>
кирӱ|kirü	<i>noun</i><br><ol><li>entrance, entry</li></ol>
киске|kiske	<i>noun</i><br><ol><li>cat</li></ol>
кичӱ|kičü	<i>adj</i><br><ol><li>small</li></ol>
киш|kiš	<i>noun</i><br><ol><li>sable</li></ol>
кожо|kožo	<i>adv</i><br><ol><li>together</li></ol>
кожоҥ|kožoŋ	<i>noun</i><br><ol><li>song</li></ol>
кожык|kožïk	<i>noun</i><br><ol><li>spoon</li></ol>
козы|kozï	<i>noun</i><br><ol><li>lamb (Teleut)</li></ol>
кой|koy	<i>noun</i><br><ol><li>sheep</li></ol>
койон|койонныҥ|койонды|qoyon	<i>noun</i><br><ol><li>hare</li></ol>
койор|koyor	<i>verb</i><br><ol><li>to put</li></ol>
койу|koyu	<i>adj</i><br><ol><li>thick</li></ol>
кол|kol	<i>noun</i><br><ol><li>hand, arm</li></ol>
коло|kolo	<i>noun</i><br><ol><li>bronze, tin</li></ol>
колтук|koltuk	<i>noun</i><br><ol><li>armpit</li></ol>
комус|komus	<i>noun</i><br><ol><li>kobyz, Jew's harp</li></ol>
конок|konok	<i>noun</i><br><ol><li>guest</li></ol>
конор|konor	<i>verb</i><br><ol><li>to spend a night</li><li>to stay; to live</li><li>to perch (of birds)</li><li>(auxiliary) Used after an imperfective converb, expressing the rapidness of an action.</li></ol>
коргожын|korgožïn	<i>noun</i><br><ol><li>(chemistry) lead</li></ol>
корку|korku	<i>noun</i><br><ol><li>fear</li></ol>
коркыыр|korkïïr	<i>verb</i><br><ol><li>to fear</li></ol>
корон|koron	<i>noun</i><br><ol><li>poison</li><li>misfortune, calamity</li></ol>
коскоор|koskoor	<i>verb</i><br><ol><li>to move</li></ol>
кочкор|kočkor	<i>noun</i><br><ol><li>ram</li></ol>
кош|koš	<i>noun</i><br><ol><li>pair, couple</li></ol>
коҥору|koŋoru	<i>noun</i><br><ol><li>bell</li></ol>
коҥус|koŋus	<i>noun</i><br><ol><li>beetle</li></ol>
кудай|кудайда|кудайды|кудайдаҥ|кудайларда|кудайлар|кудайларга|кудайларды|кудайлардаҥ|кудайлардыҥ|кудайга|кудайдыҥ|kuday	<i>noun</i><br><ol><li>God</li></ol>
кудук|kuduk	<i>noun</i><br><ol><li>well</li></ol>
куйар|kuyar	<i>verb</i><br><ol><li>to pour (from cast)</li></ol>
куйрук|kuyruk	<i>noun</i><br><ol><li>tail</li></ol>
куйу|kuyu	<i>noun</i><br><ol><li>border</li></ol>
кул|kul	<i>noun</i><br><ol><li>slave</li></ol>
кулак|kulak	<i>noun</i><br><ol><li>ear</li></ol>
кулдук|kulduk	<i>noun</i><br><ol><li>slavery</li></ol>
кулун|kulun	<i>noun</i><br><ol><li>foal</li></ol>
кум|kum	<i>noun</i><br><ol><li>sand</li></ol>
кумак|qumaq	<i>noun</i><br><ol><li>sand</li></ol>
кумдус|qumdus	<i>noun</i><br><ol><li>beaver</li></ol>
кумурска|komurska|комурска|kumurska	<i>noun</i><br><ol><li>ant</li></ol>
кур|kur	<i>noun</i><br><ol><li>belt</li></ol>
кургаар|kurgaar	<i>verb</i><br><ol><li>to dry, to wither</li></ol>
кургак|kurgak	<i>adj</i><br><ol><li>dry</li></ol>
курсак|kursak	<i>noun</i><br><ol><li>food</li><li>stomach</li></ol>
курт|kurt	<i>noun</i><br><ol><li>worm</li></ol>
куру|kuru	<i>adj</i><br><ol><li>dry</li></ol>
курут|kurut	<i>noun</i><br><ol><li>cheese</li></ol>
кут|kut	<i>noun</i><br><ol><li>(religion) soul</li></ol>
куу|kuu	<i>noun</i><br><ol><li>swan</li><li>white</li><li>tinder</li></ol>
куун|kuun	<i>noun</i><br><ol><li>luck</li><li>happiness</li></ol>
куш|kuš	<i>noun</i><br><ol><li>bird</li></ol>
кызыл|kïzïl	<i>adj</i><br><ol><li>red</li></ol>
кызыл тӧш|kïzïl töš	<i>noun</i><br><ol><li>bullfinch</li></ol>
кыйгак|kïygak	<i>noun</i><br><ol><li>sedge</li></ol>
кыймат|kïymat	<i>adj</i><br><ol><li>expensive</li></ol>
кыймык|kıymık	<i>noun</i><br><ol><li>movement</li></ol>
кылыш|kïlïš	<i>noun</i><br><ol><li>sword, saber</li></ol>
кымыс|kïmïs	<i>noun</i><br><ol><li>koumiss</li></ol>
кын|kïn	<i>noun</i><br><ol><li>sheath, scabbard</li></ol>
кыркар|kïrkar	<i>verb</i><br><ol><li>to cut</li></ol>
кыру|kïru	<i>noun</i><br><ol><li>frost</li></ol>
кырык|kïrïk	<i>num</i><br><ol><li>forty</li></ol>
кыс|kïs	<i>noun</i><br><ol><li>girl</li></ol>
кыска|kïska	<i>adj</i><br><ol><li>short</li></ol>
кыш|kış	<i>noun</i><br><ol><li>winter</li></ol>
кӧбӧлӧк|кӧбӧлӧкти|köbölök|кӧбӧлӧктиҥ	<i>noun</i><br><ol><li>butterfly</li></ol>
кӧбӱк|köbük	<i>noun</i><br><ol><li>foam</li></ol>
кӧгӧн|kögön	<i>noun</i><br><ol><li>gadfly</li></ol>
кӧгӧрчин|kögörčin	<i>noun</i><br><ol><li>pigeon</li></ol>
кӧзнӧк|köznök	<i>noun</i><br><ol><li>window</li></ol>
кӧзӱлӱк|közülük	<i>noun</i><br><ol><li>glasses</li></ol>
кӧк|kök	<i>adj</i><br><ol><li>blue</li></ol>
кӧк буур|kök buur	<i>noun</i><br><ol><li>spleen</li></ol>
кӧк чай|kök čay	<i>noun</i><br><ol><li>green tea</li></ol>
кӧл|köl	<i>noun</i><br><ol><li>lake</li></ol>
кӧлӧтки|kölötki	<i>noun</i><br><ol><li>shadow</li><li>shade</li></ol>
кӧмӱр|kömür	<i>noun</i><br><ol><li>coal</li><li>bridge</li></ol>
кӧп|köp	<i>adj</i><br><ol><li>many</li></ol>
кӧрӧр|körör	<i>verb</i><br><ol><li>to see</li></ol>
кӧрӱнбес|körünbes	<i>adj</i><br><ol><li>invisible</li></ol>
кӧс|kös	<i>noun</i><br><ol><li>eye</li></ol>
кӱзен|küzen	<i>noun</i><br><ol><li>polecat</li></ol>
кӱйе|küye	<i>noun</i><br><ol><li>moth</li></ol>
кӱйӱ|küyü	<i>noun</i><br><ol><li>son-in-law</li></ol>
кӱл|kül	<i>noun</i><br><ol><li>ash</li></ol>
кӱлер|küler	<i>noun</i><br><ol><li>bronze</li></ol><br><i>adj</i><br><ol><li>bronze (nature or colour)</li></ol><br><i>verb</i><br><ol><li>to smile</li></ol>
кӱлӱм|külüm	<i>noun</i><br><ol><li>smile</li></ol>
кӱлӱч|külüč	<i>noun</i><br><ol><li>key</li></ol>
кӱмӱш|kümüš	<i>noun</i><br><ol><li>silver</li></ol>
кӱн|kün	<i>noun</i><br><ol><li>sun, day</li></ol>
кӱнбадыш|künbadïš	<i>noun</i><br><ol><li>west</li></ol>
кӱнек|künek	<i>noun</i><br><ol><li>shirt</li></ol>
кӱнчыгыш|künçığış	<i>noun</i><br><ol><li>east</li></ol>
кӱреер|küreer	<i>verb</i><br><ol><li>to rake</li></ol>
кӱрек|kürek	<i>noun</i><br><ol><li>spade, shovel</li></ol>
кӱреш|küreš	<i>noun</i><br><ol><li>fight</li></ol>
кӱреҥ|küreŋ	<i>adj</i><br><ol><li>brown</li></ol>
кӱркӱреер|kürküreer	<i>verb</i><br><ol><li>to thunder</li></ol>
кӱс|küs	<i>noun</i><br><ol><li>autumn, fall (season)</li></ol>
кӱскӱ|küskü	<i>noun</i><br><ol><li>mirror</li></ol>
кӱч|küč	<i>noun</i><br><ol><li>power</li></ol>
кӱчӱк|küçük	<i>noun</i><br><ol><li>puppy</li></ol>
кӱӱ|küü	<i>noun</i><br><ol><li>melody</li><li>tune</li></ol>
кӱӱн|küün	<i>noun</i><br><ol><li>wish</li></ol>
кӱӱрт|küürt	<i>noun</i><br><ol><li>sulfur</li></ol>
мааны|maanı	<i>noun</i><br><ol><li>wild cat, manul</li></ol>
мажак|mažak	<i>noun</i><br><ol><li>ear</li></ol>
май|may	<i>noun</i><br><ol><li>May</li><li>butter</li><li>fat</li></ol>
мал|mal	<i>noun</i><br><ol><li>livestock, cattle</li><li>property</li></ol>
малта|malta	<i>noun</i><br><ol><li>axe</li></ol>
маҥ|maŋ	<i>noun</i><br><ol><li>bey, bek</li></ol>
мее|mee	<i>noun</i><br><ol><li>brain</li></ol>
меелей|meeley	<i>noun</i><br><ol><li>mitten</li></ol>
меес|mees	<i>noun</i><br><ol><li>treeless slipping side</li><li>southern side of mountain</li></ol>
межик|mežik	<i>noun</i><br><ol><li>coffin</li><li>cradle</li></ol>
мелтиреер|meltireer	<i>verb</i><br><ol><li>to shine, to twinkle</li></ol>
мен|men	<i>pron</i><br><ol><li>I</li></ol>
мечет|meçet	<i>noun</i><br><ol><li>mosque</li></ol>
мечин|mečin	<i>noun</i><br><ol><li>monkey</li></ol>
мешке|meşke	<i>noun</i><br><ol><li>mushroom</li></ol>
меҥ|meŋ	<i>noun</i><br><ol><li>mole</li></ol>
минер|miner	<i>verb</i><br><ol><li>to ride</li></ol>
мис|mis	<i>noun</i><br><ol><li>blade</li></ol>
мойын|moyïn	<i>noun</i><br><ol><li>neck</li></ol>
мойынчык|moyïnčïk	<i>noun</i><br><ol><li>collar which encircles the neck.</li></ol>
момон|momon	<i>noun</i><br><ol><li>mole</li></ol>
моркоп|morqop	<i>noun</i><br><ol><li>carrot</li></ol>
мурун|murun	<i>noun</i><br><ol><li>nose</li></ol>
мус|mus	<i>noun</i><br><ol><li>ice</li></ol>
мустаар|mustaar	<i>verb</i><br><ol><li>to ice, freeze</li></ol>
муҥ|muŋ	<i>num</i><br><ol><li>thousand</li></ol><br><i>noun</i><br><ol><li>grief</li></ol>
мыжык|mïžïk	<i>noun</i><br><ol><li>cat</li></ol>
мыйык|мыйыктарды|мыйыктыҥ|мыйыктарда|мыйыктаҥ|mïyïk|мыйыктарга|мыйыкты|мыйыктардаҥ|мыйыкка|мыйыкта|мыйыктардыҥ|мыйыктар	<i>noun</i><br><ol><li>moustache</li></ol>
мыкын|mïkïn	<i>noun</i><br><ol><li>waist</li><li>side</li></ol>
мылтык|мылтыкты|мылтыктардыҥ|мылтыктыҥ|мылтыктарда|мылтыкка|мылтыкта|мылтыктаҥ|мылтыктарга|мылтыктардаҥ|mïltïk|мылтыктарды|мылтыктар	<i>noun</i><br><ol><li>rifle</li></ol>
мына|mïna	<i>pron</i><br><ol><li>this (is)</li></ol>
мынаҥ|mïnaŋ	<i>postp</i><br><ol><li>with</li></ol>
мында|mïnda	<i>adv</i><br><ol><li>here</li></ol>
мындый|mïndïy	<i>adj</i><br><ol><li>like this</li></ol>
мынта|mïnta	<i>noun</i><br><ol><li>pound</li></ol>
мырч|mïrč	<i>noun</i><br><ol><li>pepper</li></ol>
мырчак|mïrčak	<i>noun</i><br><ol><li>pea</li></ol>
мӧндӱр|möndür	<i>noun</i><br><ol><li>hail</li></ol>
мӧндӱрлеер|möndürleer	<i>verb</i><br><ol><li>to hail</li></ol>
мӧрӧй|möröy	<i>noun</i><br><ol><li>result of victory</li></ol>
мӧҥкӱ|möŋkü	<i>adj</i><br><ol><li>eternity, eternal</li></ol>
мӧҥӱн|möŋün	<i>noun</i><br><ol><li>silver</li></ol>
мӧӧн|möön	<i>noun</i><br><ol><li>duodenum</li></ol>
мӱркӱт|mürküt	<i>noun</i><br><ol><li>golden eagle</li></ol>
мӱӱс|müüs	<i>noun</i><br><ol><li>horn</li></ol>
не|ne	<i>pron</i><br><ol><li>what</li></ol>
неме|neme	<i>noun</i><br><ol><li>thing</li></ol><br><i>pron</i><br><ol><li>what</li></ol>
оду|odu	<i>noun</i><br><ol><li>tent</li></ol>
одус|odus	<i>num</i><br><ol><li>thirty</li></ol>
одын|odïn	<i>noun</i><br><ol><li>firewood</li></ol>
ой|oy	<i>noun</i><br><ol><li>mind, idea</li><li>lowland</li></ol>
ойгонор|oygonor	<i>verb</i><br><ol><li>to wake up</li></ol>
оймок|oymok	<i>noun</i><br><ol><li>thimble</li></ol>
ойноор|oynoor	<i>verb</i><br><ol><li>to play</li></ol>
ойык|oyïk	<i>adj</i><br><ol><li>knocked</li></ol><br><i>noun</i><br><ol><li>hollow</li></ol>
ойын|oyïn	<i>noun</i><br><ol><li>game</li></ol>
ойынчык|oyïnčïk	<i>noun</i><br><ol><li>toy</li></ol>
ок|ok	<i>noun</i><br><ol><li>arrow</li></ol>
окур|okur	<i>verb</i><br><ol><li>to vomit (from mouth)</li></ol>
ол|ol	<i>pron</i><br><ol><li>he, she, it (third-person singular subject pronoun)</li></ol>
олор|olor	<i>pron</i><br><ol><li>they (third-person plural personal pronoun)</li></ol>
омуртка|omurtka	<i>noun</i><br><ol><li>spine</li></ol>
он|on	<i>num</i><br><ol><li>ten</li></ol>
онно|onno	<i>pron</i><br><ol><li>there (is)</li></ol>
ону|onu	<i>num</i><br><ol><li>ten (in a group together)</li></ol>
онынчы|onïnčï	<i>num</i><br><ol><li>tenth</li></ol>
оо|oo	<i>noun</i><br><ol><li>poison</li></ol>
оок|ook	<i>adj</i><br><ol><li>small</li></ol>
оок-теек|ook-teek	<i>adj</i><br><ol><li>small</li></ol>
оору|ooru	<i>noun</i><br><ol><li>pain, sick ,ill</li><li>illness, sickness</li></ol>
оорулу|oorulu	<i>adj</i><br><ol><li>sick, ill, painful</li></ol>
оорыыр|oorïïr	<i>verb</i><br><ol><li>to be sick, to be ill</li></ol>
оос|oos	<i>noun</i><br><ol><li>mouth</li></ol>
орозо|orozo	<i>noun</i><br><ol><li>fasting</li></ol>
ором|orom	<i>noun</i><br><ol><li>street</li></ol>
ороор|oroor	<i>verb</i><br><ol><li>to roll</li></ol>
орто|orto	<i>noun</i><br><ol><li>middle</li></ol>
ортозында|ortozïnda	<i>adv</i><br><ol><li>in the middle of</li></ol>
орток|ortok	<i>adj</i><br><ol><li>common</li></ol>
ортон|orton	<i>adj</i><br><ol><li>middle</li></ol>
орын|orïn	<i>noun</i><br><ol><li>place</li></ol>
от|ot	<i>noun</i><br><ol><li>fire</li><li>grass</li></ol>
оток|otok	<i>noun</i><br><ol><li>a tribal subdivision</li></ol>
отту|ottu	<i>adj</i><br><ol><li>fire</li></ol>
отурар|отуру|oturar|oturu	<i>verb</i><br><ol><li>to sit</li></ol>
отуру|oturu	<i>noun</i><br><ol><li>sitting</li></ol>
отык|otïk	<i>noun</i><br><ol><li>tinderbox</li></ol>
очок|očok	<i>noun</i><br><ol><li>fireplace, hearth</li></ol>
ошкоор|oškoor	<i>verb</i><br><ol><li>to resemble</li></ol>
оҥ|oŋ	<i>adj</i><br><ol><li>right (opposite of left)</li></ol>
оҥдоор|oŋdoor	<i>verb</i><br><ol><li>to correct</li></ol>
пахта|pahta	<i>noun</i><br><ol><li>cotton</li></ol>
саадак|saadak	<i>noun</i><br><ol><li>quiver (for arrows)</li></ol>
саам|saam	<i>noun</i><br><ol><li>fishing rod</li></ol>
саамай|saamay	<i>noun</i><br><ol><li>temple (anatomy)</li></ol>
саанчы|saančï	<i>noun</i><br><ol><li>milkmaid</li></ol>
саар|saar	<i>verb</i><br><ol><li>to milk</li></ol>
саат|saat	<i>noun</i><br><ol><li>hour</li><li>clock</li></ol>
сабар|sabar	<i>noun</i><br><ol><li>finger</li></ol>
сагал|sagal	<i>noun</i><br><ol><li>beard</li></ol>
садар|sadar	<i>verb</i><br><ol><li>to sell</li></ol>
садучы|sadučï	<i>noun</i><br><ol><li>seller</li></ol>
сазан|sazan	<i>noun</i><br><ol><li>sazan, wild carp</li></ol>
сай|say	<i>adj</i><br><ol><li>shallow</li></ol><br><i>noun</i><br><ol><li>shoal</li></ol>
сайын|sayïn	<i>adv</i><br><ol><li>every</li></ol>
сака|saka	<i>noun</i><br><ol><li>knucklebone</li></ol>
сакчы|sakčï	<i>noun</i><br><ol><li>guard, guardian</li></ol>
сал|sal	<i>noun</i><br><ol><li>raft</li></ol>
салкын|salkïn	<i>noun</i><br><ol><li>wind</li></ol>
саман|saman	<i>noun</i><br><ol><li>time</li></ol>
самын|samın	<i>noun</i><br><ol><li>soap</li></ol>
сан|san	<i>noun</i><br><ol><li>thigh</li></ol>
санаар|sanaar	<i>verb</i><br><ol><li>to think</li></ol>
сап|sap	<i>noun</i><br><ol><li>handle</li></ol>
сарай|saray	<i>noun</i><br><ol><li>palace</li></ol>
сарлык|sarlık	<i>noun</i><br><ol><li>yak</li></ol>
сары|sarï	<i>adj</i><br><ol><li>yellow</li></ol>
сарын|sarïn	<i>noun</i><br><ol><li>song</li></ol>
сас|sas	<i>noun</i><br><ol><li>swamp</li></ol>
саҥыс|saŋïs	<i>noun</i><br><ol><li>resin</li></ol>
саҥыскан|saŋïskan	<i>noun</i><br><ol><li>magpie</li></ol>
сегизен|segizen	<i>num</i><br><ol><li>eighty</li></ol>
сегизинчи|segizinči	<i>num</i><br><ol><li>eighth</li></ol>
сегизӱ|segizü	<i>num</i><br><ol><li>eight (in a group together)</li></ol>
сегис|segis	<i>num</i><br><ol><li>eight</li></ol>
сезер|sezer	<i>verb</i><br><ol><li>to feel</li></ol>
сезим|sezim	<i>noun</i><br><ol><li>feeling</li></ol>
секирер|sekirer	<i>verb</i><br><ol><li>to jump</li></ol>
селем|selem	<i>noun</i><br><ol><li>hello</li></ol>
семирер|semirer	<i>verb</i><br><ol><li>to become fat</li></ol>
семис|semis	<i>adj</i><br><ol><li>fat</li></ol>
сен|sen	<i>pron</i><br><ol><li>you, thou</li></ol>
сеп|sep	<i>noun</i><br><ol><li>dowry</li></ol>
сепкил|sepkil	<i>noun</i><br><ol><li>freckle</li></ol>
сибирги|sibirgi	<i>noun</i><br><ol><li>broom</li></ol>
сибирер|sibirer	<i>verb</i><br><ol><li>to sweep</li></ol>
сийдик|siydik	<i>noun</i><br><ol><li>urine</li></ol>
сийер|siyer	<i>verb</i><br><ol><li>to urinate</li></ol>
силкиир|silkiir	<i>verb</i><br><ol><li>to shake</li></ol>
сирке|sirke	<i>noun</i><br><ol><li>nit</li></ol>
сиҥир|siŋir	<i>noun</i><br><ol><li>thread, tendon</li></ol>
согоно|sogono	<i>noun</i><br><ol><li>onion</li></ol>
согор|sogor	<i>verb</i><br><ol><li>to beat</li></ol>
согыр|sogïr	<i>adj</i><br><ol><li>blind</li></ol>
согыш|sogïš	<i>noun</i><br><ol><li>war</li></ol>
сол|sol	<i>adj</i><br><ol><li>left</li></ol>
сологой|sologoy	<i>noun</i><br><ol><li>left-handed, left-hander</li></ol>
солтон|solton	<i>noun</i><br><ol><li>Sultan</li></ol>
солун|solundar|solun	<i>noun</i><br><ol><li>news</li></ol>
соок|sook	<i>adj</i><br><ol><li>cold</li></ol>
соолыыр|soolïïr	<i>verb</i><br><ol><li>to breathe (heavily) , to be breathe</li></ol>
соҥ|soŋ	<i>noun</i><br><ol><li>end</li><li>after, later</li></ol><br><i>adv</i><br><ol><li>late</li></ol>
соҥы|soŋï	<i>adj</i><br><ol><li>back</li></ol>
соҥында|соондо|soondo|soŋïnda	<i>adv</i><br><ol><li>after</li></ol>
су|su	<i>adj</i><br><ol><li>healthy</li></ol>
суйук|suyuk	<i>adj</i><br><ol><li>liquid</li></ol>
сула|sula	<i>noun</i><br><ol><li>oats</li></ol>
сулук|suluk	<i>noun</i><br><ol><li>bit (a piece of metal placed in a horse's mouth)</li></ol>
сунар|sunar	<i>verb</i><br><ol><li>to strech</li></ol>
сундук|sunduk	<i>noun</i><br><ol><li>chest</li></ol>
сур|sur	<i>adj</i><br><ol><li>light brown</li></ol>
суру	<i>noun</i><br><ol><li>question</li></ol>
суу|suu	<i>noun</i><br><ol><li>water</li></ol>
суузаар|suuzaar	<i>verb</i><br><ol><li>to thirst</li></ol>
суузар|suuzar	<i>noun</i><br><ol><li>marten</li></ol>
суузу|suuzu	<i>noun</i><br><ol><li>thirst</li></ol>
сууры|suurï	<i>noun</i><br><ol><li>marmot</li></ol>
сыбыскы|sïbïskï	<i>noun</i><br><ol><li>trumpet</li></ol>
сыдырар|sïdïrar	<i>verb</i><br><ol><li>to whip</li></ol>
сызар|sïzar	<i>verb</i><br><ol><li>to ooze</li></ol>
сый|sïy	<i>noun</i><br><ol><li>gift</li></ol>
сыйлаар|sïylaar	<i>verb</i><br><ol><li>to show honour</li></ol>
сыймаар|sïymaar	<i>verb</i><br><ol><li>to iron, to press (cloth)</li></ol>
сыйыр|sïyïr	<i>noun</i><br><ol><li>cow</li></ol>
сыйырар|sïyïrar	<i>verb</i><br><ol><li>to strip</li></ol>
сылу|sïlu	<i>adj</i><br><ol><li>beautiful</li></ol>
сыр|sïr	<i>noun</i><br><ol><li>cheese</li><li>dye, paint</li></ol>
сыра|sïra	<i>noun</i><br><ol><li>beer</li></ol>
сырт|sïrt	<i>noun</i><br><ol><li>back</li></ol>
сыҥар|sïŋar	<i>num</i><br><ol><li>one of a pair</li></ol>
сӧзлик|sözlik	<i>noun</i><br><ol><li>dictionary</li></ol>
сӧйлӧӧр|söylöör	<i>verb</i><br><ol><li>to speak, to say, to talk.</li></ol>
сӧс|sös	<i>noun</i><br><ol><li>word</li></ol>
сӧӧк|söök	<i>noun</i><br><ol><li>bone</li><li>clan</li></ol>
сӧӧл|sööl	<i>noun</i><br><ol><li>corn</li><li>callus</li></ol>
сӧӧм|sööm	<i>noun</i><br><ol><li>span, quarter</li></ol>
сӱт|süt	<i>noun</i><br><ol><li>milk</li></ol>
сӱттӱ|süttü	<i>adj</i><br><ol><li>milky</li></ol>
таа|taa	<i>adv</i><br><ol><li>even</li></ol>
таары|taarï	<i>noun</i><br><ol><li>gunpowder</li></ol>
табак|tabak	<i>noun</i><br><ol><li>plate</li></ol>
табар|tabar	<i>verb</i><br><ol><li>to find</li></ol>
табыш|tabïš	<i>noun</i><br><ol><li>sound</li></ol>
тажыыр|tažïïr	<i>verb</i><br><ol><li>to carry</li></ol>
тайак|tayak	<i>noun</i><br><ol><li>stick</li></ol>
тайар|tayar	<i>verb</i><br><ol><li>to slip, slide</li></ol>
тайгак|taygak	<i>adj</i><br><ol><li>slippery</li></ol>
тал|tal	<i>noun</i><br><ol><li>willow</li></ol>
талай|talay	<i>noun</i><br><ol><li>sea</li></ol>
там|tam	<i>noun</i><br><ol><li>taste</li></ol>
тамак|tamak	<i>noun</i><br><ol><li>throat</li></ol>
таман|taman	<i>noun</i><br><ol><li>foot, sole</li></ol>
тамчы|tamçı	<i>noun</i><br><ol><li>drop</li></ol>
тамыр|tamïr	<i>noun</i><br><ol><li>root</li></ol>
тану|tanu	<i>noun</i><br><ol><li>nostril</li></ol>
тар|tar	<i>adj</i><br><ol><li>narrow</li></ol>
тарак|tarak	<i>noun</i><br><ol><li>comb</li></ol>
тарам|taram	<i>noun</i><br><ol><li>tendon</li></ol>
тартар|tartar	<i>verb</i><br><ol><li>to pull</li></ol>
тару|taru	<i>noun</i><br><ol><li>millet</li></ol>
тарых|tarïh	<i>noun</i><br><ol><li>(Qanas, dialectal) history</li></ol>
тат|tat	<i>noun</i><br><ol><li>taste</li></ol>
тату|tatu	<i>adj</i><br><ol><li>sweet</li></ol>
таш|taš	<i>noun</i><br><ol><li>stone</li></ol>
ташкын|taškïn	<i>noun</i><br><ol><li>flood</li></ol>
таҥ|taŋ	<i>noun</i><br><ol><li>dawn</li></ol>
тебетей|tebetey	<i>noun</i><br><ol><li>tubeteika, tyubeteika</li></ol>
тегенек|tegenek	<i>noun</i><br><ol><li>thorn</li></ol>
тегерик|tegerik	<i>noun</i><br><ol><li>round</li><li>circle</li></ol>
теермен|teermen	<i>noun</i><br><ol><li>mill</li></ol>
тежик|težik	<i>noun</i><br><ol><li>hole</li></ol>
тек|tek	<i>adv</i><br><ol><li>in vain</li></ol>
теке|teke	<i>noun</i><br><ol><li>goat</li></ol>
темене|temene	<i>noun</i><br><ol><li>big needle</li></ol>
темир|temir	<i>noun</i><br><ol><li>iron</li></ol>
темир јол|temir ǰol	<i>noun</i><br><ol><li>railway , railroad</li></ol>
темирчи|temirči	<i>noun</i><br><ol><li>blacksmith, smith</li></ol>
тенке|tenke	<i>noun</i><br><ol><li>coin</li><li>ruble</li></ol>
тер|ter	<i>noun</i><br><ol><li>sweat</li></ol>
тере|tere	<i>noun</i><br><ol><li>skin</li></ol>
терезе|tereze	<i>noun</i><br><ol><li>scales</li></ol>
терек|terek	<i>noun</i><br><ol><li>poplar</li></ol>
тереҥ|tereŋ	<i>adj</i><br><ol><li>deep</li></ol>
терс|ters	<i>noun</i><br><ol><li>opposite</li></ol>
тескери|teskeri	<i>adv</i><br><ol><li>back to front</li></ol>
теҥ|teŋ	<i>adj</i><br><ol><li>equal</li></ol>
теҥери|teŋeri|теҥерилер	<i>noun</i><br><ol><li>sky, heaven</li></ol>
теҥис|teŋis	<i>noun</i><br><ol><li>ocean</li><li>sea</li></ol>
тигер|tiger	<i>verb</i><br><ol><li>to sew</li></ol>
тиги|tigi	<i>pron</i><br><ol><li>that</li></ol>
тижи|tiži	<i>noun</i><br><ol><li>(zoology) female</li></ol>
тизе|tize	<i>noun</i><br><ol><li>knee</li></ol>
тийер|tiyer	<i>verb</i><br><ol><li>to touch</li><li>to disturb</li></ol>
тийиҥ|tiyiñ	<i>noun</i><br><ol><li>squirrel</li></ol>
тил|til	<i>noun</i><br><ol><li>tongue</li><li>language</li></ol>
тилмеш|tilmeš	<i>noun</i><br><ol><li>translator</li></ol>
тиреер|tireer	<i>verb</i><br><ol><li>to prop up</li></ol>
тирсек|tirsek	<i>noun</i><br><ol><li>stye</li></ol>
тирӱ|tirü	<i>adj</i><br><ol><li>living, live</li></ol>
тиш|tiš	<i>noun</i><br><ol><li>tooth</li></ol>
тобрак|tobrak	<i>noun</i><br><ol><li>land, earth</li></ol>
тогузон|toguzon	<i>num</i><br><ol><li>ninety</li></ol>
тогузу|toguzu	<i>num</i><br><ol><li>nine (in a group together)</li></ol>
тогузынчы|toguzïnčï	<i>num</i><br><ol><li>ninth</li></ol>
тогус	<i>num</i><br><ol><li>nine</li></ol>
той|toy	<i>noun</i><br><ol><li>feast, wedding</li></ol>
токой|tokoy	<i>noun</i><br><ol><li>shore of river, peninsula</li></ol>
токулдаар|tokuldaar	<i>verb</i><br><ol><li>to knock</li></ol>
толку|tolku	<i>noun</i><br><ol><li>wave</li></ol>
толо|tolo	<i>adj</i><br><ol><li>full</li></ol>
толоно|tolono	<i>noun</i><br><ol><li>hawthorn</li></ol>
толор|tolor	<i>verb</i><br><ol><li>to be full, to fill</li></ol>
толтырар|toltïrar	<i>verb</i><br><ol><li>to fill</li></ol>
томра|tomra	<i>noun</i><br><ol><li>balalaika, dombra</li></ol>
томук|tomuk	<i>noun</i><br><ol><li>kneecap</li></ol>
тон|ton	<i>noun</i><br><ol><li>fur coat</li></ol>
тоомјы|toomjı	<i>noun</i><br><ol><li>prestige</li></ol>
тос|tos	<i>noun</i><br><ol><li>birchbark</li></ol>
тоҥ|toŋ	<i>adj</i><br><ol><li>frozen</li></ol>
тоҥдырма|toŋdïrma	<i>noun</i><br><ol><li>ice cream</li></ol>
тоҥор|toŋor	<i>verb</i><br><ol><li>to freeze</li></ol>
тоҥус|toŋus	<i>noun</i><br><ol><li>pig</li></ol>
ту|tu	<i>pron</i><br><ol><li>that</li></ol><br><i>noun</i><br><ol><li>flag</li></ol>
тудар|tudar	<i>verb</i><br><ol><li>to hold</li></ol>
тузак|tuzak	<i>noun</i><br><ol><li>snare</li></ol>
туйгак|tuygak	<i>noun</i><br><ol><li>hoof</li></ol>
тул|tul	<i>noun</i><br><ol><li>widow</li></ol>
тулбар|tulbar	<i>noun</i><br><ol><li>winged horse, thin wing horse</li></ol>
туман|tuman	<i>noun</i><br><ol><li>mist, foggy</li></ol>
тура|turadaŋ|tura|турадаҥ	<i>noun</i><br><ol><li>house</li><li>city, town</li></ol>
турар|turar	<i>verb</i><br><ol><li>to stand</li></ol>
турна|turna	<i>noun</i><br><ol><li>crane</li></ol>
тус|tus	<i>noun</i><br><ol><li>salt</li></ol>
тусту|tustu	<i>adj</i><br><ol><li>salty</li></ol>
тутка|tutka	<i>noun</i><br><ol><li>handle</li></ol>
туу|tuu	<i>noun</i><br><ol><li>(geography) mountain</li></ol>
тууган кӱни|tuugan küni	<i>noun</i><br><ol><li>birthday</li></ol>
тууган јери|tuugan ǰeri	<i>noun</i><br><ol><li>field</li></ol>
туул|tuul	<i>noun</i><br><ol><li>unweather, storm</li></ol>
туулу|ornative|tuulu	<i>adj</i><br><ol><li>mountainous</li></ol>
туус|tuus	<i>adj</i><br><ol><li>dense, thick</li></ol>
тушман|tušman	<i>noun</i><br><ol><li>enemy</li></ol>
тын|tïn	<i>noun</i><br><ol><li>soul, spirit</li></ol>
тыныш|tïnïš	<i>noun</i><br><ol><li>breath</li></ol><br><i>adj</i><br><ol><li>calm, quiet, rest, peace</li></ol>
тырмак|tïrmak	<i>noun</i><br><ol><li>nail (finger or toe)</li></ol>
тышкары|tïškarï	<i>adv</i><br><ol><li>outside</li></ol>
тыҥ|tïŋ	<i>adj</i><br><ol><li>strong</li></ol>
тӧбӧ|töbö	<i>noun</i><br><ol><li>hill</li></ol>
тӧжи|töži	<i>noun</i><br><ol><li>anvil</li></ol>
тӧрт|tört	<i>num</i><br><ol><li>four</li></ol>
тӧртинчи|törtinči	<i>num</i><br><ol><li>fourth</li></ol>
тӧртӱ|törtü	<i>num</i><br><ol><li>four (in a group together)</li></ol>
тӧӧ|töö	<i>noun</i><br><ol><li>camel</li></ol>
тӱдӱн|tüdün	<i>noun</i><br><ol><li>smoke</li></ol>
тӱжер|tüžer	<i>verb</i><br><ol><li>to fall</li></ol>
тӱжӱм|tüžüm	<i>noun</i><br><ol><li>harvest</li></ol>
тӱк|tük	<i>noun</i><br><ol><li>hair</li><li>wool</li></ol>
тӱлкӱ|tülkü	<i>noun</i><br><ol><li>fox</li></ol>
тӱн|tün	<i>noun</i><br><ol><li>night</li></ol>
тӱндӱк|tündük	<i>noun</i><br><ol><li>north</li></ol>
тӱп|tüp	<i>noun</i><br><ol><li>bottom</li></ol>
тӱрме|türme	<i>noun</i><br><ol><li>prison</li></ol>
тӱс|tüs	<i>adj</i><br><ol><li>straight</li></ol>
тӱш|tüš	<i>noun</i><br><ol><li>dream</li><li>noon</li></ol>
тӱштӱк|tüştük	<i>noun</i><br><ol><li>south</li></ol>
тӱҥӱр|tüŋür	<i>noun</i><br><ol><li>a tüŋür, an Altaian instrument similar to buben for Shamanistic usage.</li></ol>
тӱӱки|tüüki	<i>noun</i><br><ol><li>history (aggregate of past events)</li></ol>
тӱӱме|tüüme	<i>noun</i><br><ol><li>tying, knitting, tie</li></ol>
угар|ugar	<i>verb</i><br><ol><li>to hear</li></ol>
узак|uzak	<i>adv</i><br><ol><li>far</li></ol>
узун|uzun	<i>adj</i><br><ol><li>long</li></ol>
уй|uy	<i>noun</i><br><ol><li>cow</li></ol>
уйа|uya	<i>noun</i><br><ol><li>nest</li></ol>
уйалар|uyalar	<i>verb</i><br><ol><li>to be ashamed of/to</li></ol>
уйку|uyku	<i>noun</i><br><ol><li>sleep</li></ol>
уйуктаар|uyuktaar	<i>verb</i><br><ol><li>to sleep</li></ol>
ук|uk	<i>noun</i><br><ol><li>stocking</li></ol>
улак|ulak	<i>noun</i><br><ol><li>young goat</li></ol>
улам|ulam	<i>adv</i><br><ol><li>always</li></ol>
улу|ulu	<i>adj</i><br><ol><li>great</li><li>big, large</li></ol>
ум|um	<i>noun</i><br><ol><li>secret sign</li></ol>
ун|un	<i>noun</i><br><ol><li>flour</li></ol>
ундыыр|undïïr	<i>verb</i><br><ol><li>to forget</li></ol>
унчугар|unčugar	<i>verb</i><br><ol><li>to speak with voice</li></ol>
ур|ur	<i>noun</i><br><ol><li>growth</li></ol>
урук|uruk	<i>noun</i><br><ol><li>loop</li></ol>
уруш|uruš	<i>noun</i><br><ol><li>war</li></ol>
ус|us	<i>noun</i><br><ol><li>master</li></ol>
уу|uu	<i>noun</i><br><ol><li>net</li></ol>
уул|uul	<i>noun</i><br><ol><li>son</li></ol>
уулаар|uulaar	<i>verb</i><br><ol><li>to hunt (with net)</li></ol>
уулан|uulan	<i>noun</i><br><ol><li>young man</li></ol>
уур|uur	<i>adj</i><br><ol><li>heavy</li></ol><br><i>noun</i><br><ol><li>thief</li></ol>
уурдаар|uurdaar	<i>verb</i><br><ol><li>to steal</li></ol>
уучы|uučï	<i>noun</i><br><ol><li>hunter</li></ol>
ууш|uuš	<i>noun</i><br><ol><li>handful</li></ol>
уч|uč	<i>noun</i><br><ol><li>end, edge</li></ol>
учар|učar	<i>verb</i><br><ol><li>to fly</li></ol>
учмак|učmak	<i>noun</i><br><ol><li>paradise</li></ol>
учун|učun	<i>postp</i><br><ol><li>for</li></ol>
чабар|čabar	<i>verb</i><br><ol><li>to mow, cut, chop</li></ol>
чабу|čabu	<i>noun</i><br><ol><li>gusset</li></ol>
чаганак|čaganak	<i>noun</i><br><ol><li>elbow</li></ol>
чагар|čagar	<i>verb</i><br><ol><li>to bite</li></ol>
чай|čay|çay	<i>noun</i><br><ol><li>river</li><li>tea</li></ol>
чайнаар|čaynaar	<i>verb</i><br><ol><li>to chew</li></ol>
чак|čak	<i>noun</i><br><ol><li>time</li></ol>
чал|čal	<i>adj</i><br><ol><li>grey</li></ol>
чалгы|čalgï	
чалкан|ćálqan	<i>noun</i><br><ol><li>turnip</li><li>nettle</li></ol>
чана|čana	<i>noun</i><br><ol><li>sledge, ski</li></ol>
чапчак|čapčak	<i>noun</i><br><ol><li>tub, vat</li></ol>
чар|čar	<i>noun</i><br><ol><li>whetstone</li></ol>
чатыр|çatír	<i>noun</i><br><ol><li>tent</li></ol>
чач|čač	<i>noun</i><br><ol><li>hair</li></ol>
чачак|čačak	<i>noun</i><br><ol><li>brush</li></ol>
чегертки|čegertki	<i>noun</i><br><ol><li>locust</li></ol>
чекпен|čekpen	<i>noun</i><br><ol><li>chekmen</li></ol>
черт|čert	<i>noun</i><br><ol><li>oath</li></ol>
чечек|čeček	<i>noun</i><br><ol><li>flower</li></ol>
чибирек|čibirek	<i>noun</i><br><ol><li>rag</li></ol>
чибишке|čibiške	<i>noun</i><br><ol><li>pimple</li></ol>
чииш|čiiš	<i>noun</i><br><ol><li>wedge</li></ol>
чий|čiy	<i>adj</i><br><ol><li>damp, moist</li><li>raw</li></ol>
чийиш|čiyiš	<i>noun</i><br><ol><li>peg</li></ol>
чикир|çikir	<i>noun</i><br><ol><li>sugar</li></ol>
чирик|čirik	<i>adj</i><br><ol><li>rotten</li></ol>
чой|čoy	<i>noun</i><br><ol><li>cast iron</li></ol>
чокур|čokur	<i>verb</i><br><ol><li>to peck, pick</li></ol>
чолмон|čolmon	<i>noun</i><br><ol><li>(astronomy) star (luminous celestial body)</li><li>(semiotics) star (symbol)</li></ol>
чортон|čorton	<i>noun</i><br><ol><li>pike</li></ol>
чочко|čočko	<i>noun</i><br><ol><li>pig, swine</li></ol>
чыбык|čïbïk	<i>noun</i><br><ol><li>twig, switch, branch</li></ol>
чыгар|čïgar	<i>verb</i><br><ol><li>to go out</li></ol>
чык|čïk	<i>noun</i><br><ol><li>moisture</li></ol>
чыкту|čïktu	<i>adj</i><br><ol><li>moist, dew</li></ol>
чымалы|čïmalï	<i>noun</i><br><ol><li>ant</li></ol>
чымчым|čïmčïm	<i>noun</i><br><ol><li>pinch</li></ol>
чымчыыр|čïmčïïr	<i>verb</i><br><ol><li>to pinch</li></ol>
чымын|čïmïn	<i>noun</i><br><ol><li>a fly (insect)</li></ol>
чын|čïn	<i>noun</i><br><ol><li>truth</li></ol><br><i>adj</i><br><ol><li>true</li></ol>
чындык|čïndïk	<i>noun</i><br><ol><li>truth</li></ol>
чырай|čïray	<i>noun</i><br><ol><li>line of face, face</li></ol>
чырайлу|čïraylu	<i>adj</i><br><ol><li>beautiful</li></ol>
чычкан|čïčkan	<i>noun</i><br><ol><li>mouse</li></ol>
чӧҥӧр|čöŋör	<i>verb</i><br><ol><li>to dive</li></ol>
шайтан|šaytan	<i>noun</i><br><ol><li>shaitan, Satan; the devil</li></ol>
шајын|şacın	<i>noun</i><br><ol><li>religion</li></ol>
шикир|şikir	<i>noun</i><br><ol><li>(Teleut) sugar</li></ol>
шылту|šïltu	<i>noun</i><br><ol><li>cause, pretext</li></ol>
ыйлаар|ïylaar	<i>verb</i><br><ol><li>to cry</li></ol>
ыйык|ïyïk	<i>adj</i><br><ol><li>holy, sacred</li></ol>
ылаачын|ïlaačïn	<i>noun</i><br><ol><li>falcon, peregrine falcon</li></ol>
ылгаар|ïlgaar	<i>verb</i><br><ol><li>to choose</li></ol>
ылтам|ïltam	<i>adv</i><br><ol><li>fast</li></ol><br><i>adj</i><br><ol><li>fast</li></ol>
ылјыраар|ïlǰïraar	<i>verb</i><br><ol><li>to suppurate</li></ol>
ымдаар|ïmdaar	<i>verb</i><br><ol><li>to wink</li></ol>
ыр|ïr	<i>noun</i><br><ol><li>song</li></ol>
ыра|ïra	<i>noun</i><br><ol><li>character</li></ol>
ыраак|ïraak	<i>adj</i><br><ol><li>far</li></ol>
ыргак|ïrgak	<i>noun</i><br><ol><li>hook</li></ol>
ыркыраар|ïrkïraar	<i>verb</i><br><ol><li>to grumble</li></ol>
ырыс|ïrïs	<i>noun</i><br><ol><li>luck, happiness</li></ol>
ыш|ış	<i>noun</i><br><ol><li>smoke</li></ol>
ыҥырчак|ïŋïrčak	<i>noun</i><br><ol><li>packsaddle</li></ol>
эбирер|ebirer	<i>verb</i><br><ol><li>to turn , to go around</li></ol>
эгис|egis	<i>noun</i><br><ol><li>twin</li></ol>
эгӱ|egü	<i>noun</i><br><ol><li>file</li></ol>
эдек|edek	<i>noun</i><br><ol><li>lap</li></ol>
эдер|eder	<i>verb</i><br><ol><li>to do</li></ol>
эжик|ežik	<i>noun</i><br><ol><li>door</li></ol>
эзен|ezen	<i>adj</i><br><ol><li>healthy, sound</li></ol>
эйе|eye	<i>particle</i><br><ol><li>yes</li></ol>
эки|eki	<i>num</i><br><ol><li>two</li></ol>
экинчи|ekinči	<i>num</i><br><ol><li>second</li></ol>
экӱ|ekü	<i>num</i><br><ol><li>two (in a group together)</li></ol>
эл|el	<i>noun</i><br><ol><li>land</li><li>people</li></ol>
элгек|elgek	<i>noun</i><br><ol><li>sieve</li></ol>
элик|elik	<i>noun</i><br><ol><li>roe deer</li></ol>
эм|em	<i>noun</i><br><ol><li>medicine</li></ol>
эмди|emdi	<i>adv</i><br><ol><li>now</li></ol>
эмес|emes	<i>adj</i><br><ol><li>not</li></ol>
эмчек|emček	<i>noun</i><br><ol><li>breast</li></ol>
эне|ene	<i>noun</i><br><ol><li>mother</li></ol>
эп|ep	<i>adv</i><br><ol><li>wisely, cleverly</li></ol>
эр|er	<i>noun</i><br><ol><li>men, husband</li></ol>
эриир|eriir	<i>verb</i><br><ol><li>to melt</li></ol>
эрик|erik	<i>noun</i><br><ol><li>freedom</li></ol>
эрин|erin	<i>noun</i><br><ol><li>lip</li></ol>
эрке|erke	<i>noun</i><br><ol><li>darling, favorite</li></ol>
эркек|erkek	<i>noun</i><br><ol><li>male</li></ol>
эркин|erkin	<i>noun</i><br><ol><li>freedom, liberty</li></ol><br><i>adj</i><br><ol><li>free</li></ol>
эрмен агаш|ermen agaš	<i>noun</i><br><ol><li>oak</li></ol>
эрте|erte	<i>adv</i><br><ol><li>early</li></ol>
эртен|erten	<i>noun</i><br><ol><li>morning</li><li>tomorrow</li></ol><br><i>adv</i><br><ol><li>in the morning</li></ol>
эрчим|erçim	<i>noun</i><br><ol><li>activity</li></ol>
эс|es	<i>noun</i><br><ol><li>memory</li></ol>
эски|eski	<i>adj</i><br><ol><li>old</li></ol>
эскирер|eskirer	<i>verb</i><br><ol><li>(unaccusative) to become obsolete</li></ol>
эт|et	<i>noun</i><br><ol><li>meat</li></ol>
эчки|ečki	<i>noun</i><br><ol><li>goat</li></ol>
эш|eš	<i>pron</i><br><ol><li>nothing</li></ol><br><i>noun</i><br><ol><li>friend</li></ol>
эштек|eštek	<i>noun</i><br><ol><li>donkey</li></ol>
ээ|ee	<i>noun</i><br><ol><li>owner</li></ol>
ээк|eek	<i>noun</i><br><ol><li>chin</li></ol>
ээн|een	<i>noun</i><br><ol><li>width</li></ol><br><i>adj</i><br><ol><li>deserted</li></ol>
ээр|eer	<i>noun</i><br><ol><li>saddle</li></ol>
эје|eǰe	<i>noun</i><br><ol><li>elder sister</li></ol>
эҥ|eŋ	<i>adj</i><br><ol><li>most</li></ol>
эҥзе|eŋze	<i>noun</i><br><ol><li>back of the head</li></ol>
эҥир|eŋir	<i>noun</i><br><ol><li>evening</li></ol>
јаа|ǰaa	<i>noun</i><br><ol><li>bow</li></ol>
јаак|ǰaak	<i>noun</i><br><ol><li>jaw, cheek</li><li>shoal</li></ol>
јаар|ǰaar	<i>verb</i><br><ol><li>to rain; to snow</li></ol>
јааш|ǰaaš	<i>noun</i><br><ol><li>rain</li></ol>
јабык|ǰabïk	<i>adj</i><br><ol><li>closed</li></ol>
јадар|ǰadar	<i>verb</i><br><ol><li>to lie</li></ol>
јажаар|ǰažaar	<i>verb</i><br><ol><li>to live</li></ol>
јажыл|ǰažïl	<i>adj</i><br><ol><li>green</li></ol>
јазаар|ǰazaar	<i>verb</i><br><ol><li>to beautify</li></ol>
јай|cay	<i>noun</i><br><ol><li>summer</li></ol>
јайар|ǰayar	<i>verb</i><br><ol><li>to spread</li></ol>
јайдак|ǰaydak	<i>adj</i><br><ol><li>(of a horse) without a saddle</li></ol>
јака|ǰaka	<i>noun</i><br><ol><li>collar</li></ol>
јакшы|ǰakšï	<i>adj</i><br><ol><li>good</li></ol>
јал|ǰal	<i>noun</i><br><ol><li>mane</li></ol>
јалбырак|ǰalbïrak	<i>noun</i><br><ol><li>leaf</li></ol>
јалганчак|ǰalgančak	<i>noun</i><br><ol><li>liar</li></ol>
јалку|ǰalku	<i>adj</i><br><ol><li>lazy</li></ol>
јалын|ǰalïn	<i>noun</i><br><ol><li>flame</li></ol>
јаман|ǰaman	<i>adj</i><br><ol><li>bad</li></ol>
јан|ǰan	<i>noun</i><br><ol><li>side</li></ol>
јанында|ǰanïnda	<i>adv</i><br><ol><li>near, next to</li></ol>
јапшынар|ǰapšïnar	<i>verb</i><br><ol><li>to stick</li></ol>
јар|ǰar	<i>noun</i><br><ol><li>bank, shore, coast, beach</li><li>order</li></ol>
јара|ǰara	<i>noun</i><br><ol><li>wound</li></ol>
јараар|ǰaraar	<i>verb</i><br><ol><li>to be benefit</li></ol>
јарар|ǰarar	<i>verb</i><br><ol><li>to split</li></ol>
јарык|ǰarïk	<i>noun</i><br><ol><li>light</li></ol>
јарым|carım	<i>noun</i><br><ol><li>half</li></ol>
јас|ǰas	<i>noun</i><br><ol><li>spring</li></ol>
јастык|ǰastïk	<i>noun</i><br><ol><li>pillow</li></ol>
јат|ǰat	<i>adj</i><br><ol><li>foreign</li></ol>
јаш|ǰaš|јаштаҥ|јаштардаҥ|јаштарда|јашка|јаштар|јаштарга|јашта|јаштардыҥ|јаштарды|јаш|јаштыҥ|јашты	<i>adj</i><br><ol><li>young</li></ol><br><i>noun</i><br><ol><li>age, year</li><li>tear</li></ol>
јаҥмыр|ǰaŋmïr	<i>noun</i><br><ol><li>rain</li></ol>
јаҥы|ǰaŋï	<i>adj</i><br><ol><li>new</li></ol>
јаҥыдаҥ|ǰaŋïdaŋ	<i>adv</i><br><ol><li>anew</li></ol>
јаҥыс|ǰaŋïs	<i>adj</i><br><ol><li>lone, lonely</li><li>only</li></ol>
јебе|ǰebe	<i>noun</i><br><ol><li>arrow</li></ol>
једер|ǰeder	<i>adv</i><br><ol><li>efficient, enough, It's enough</li></ol><br><i>verb</i><br><ol><li>to reach</li></ol>
јеен|ǰeen	<i>noun</i><br><ol><li>nephew</li></ol>
јеерен|ǰeeren	<i>noun</i><br><ol><li>red</li></ol>
јел|јелдер|јелде|јелди|јелдиҥ|јелден|ǰel|јелдердиҥ|јелге|јелдерди|јелдердеҥ|јелдерде|јелдерге	<i>noun</i><br><ol><li>wind</li></ol>
јелим|ǰelim	<i>noun</i><br><ol><li>glue</li></ol>
јелин|ǰelin	<i>noun</i><br><ol><li>udder</li></ol>
јем|ǰem	<i>noun</i><br><ol><li>prey</li><li>fodder</li><li>bait</li></ol>
јемиш|ǰemiš	<i>noun</i><br><ol><li>fodder</li></ol>
јер|ǰer	<i>noun</i><br><ol><li>land, earth</li></ol>
јес|ǰes	<i>noun</i><br><ol><li>copper</li></ol>
јесте|ǰeste	<i>noun</i><br><ol><li>son-in-law</li></ol>
јетеген|ǰetegen	<i>noun</i><br><ol><li>Ursa Major</li></ol>
јетен|ǰeden	<i>num</i><br><ol><li>seventy</li></ol>
јети|ǰeti	<i>num</i><br><ol><li>seven</li></ol>
јетинчи|ǰetinči	<i>num</i><br><ol><li>seventh</li></ol>
јетӱ|ǰetü	<i>num</i><br><ol><li>seven (in a group together)</li></ol>
јеҥ|ǰeŋ	<i>noun</i><br><ol><li>sleeve</li></ol>
јеҥе|ǰeŋe	<i>noun</i><br><ol><li>the wife of one's elder brother, cousin or other male blood relative (who is older than the speaker but younger than the speaker's parents)</li></ol>
јеҥер|ǰeŋer	<i>verb</i><br><ol><li>to win</li></ol>
јеҥил|ǰeŋil	<i>adj</i><br><ol><li>light</li></ol>
јеҥӱ|ǰeŋü	<i>noun</i><br><ol><li>victory</li></ol>
јеҥӱчи|ǰeŋüči	<i>noun</i><br><ol><li>winner</li></ol>
јибек|ǰibek	<i>noun</i><br><ol><li>thread</li><li>silk</li></ol>
јиир|ǰiir	<i>verb</i><br><ol><li>to eat</li></ol>
јиит|ǰiit	<i>noun</i><br><ol><li>young man</li></ol>
јилек|ǰilek	<i>noun</i><br><ol><li>berry</li></ol>
јилик|ǰilik	<i>noun</i><br><ol><li>marrow, bone marrow</li></ol>
јинји|ǰinǰi	<i>noun</i><br><ol><li>pearl</li></ol>
јип|ǰip	<i>noun</i><br><ol><li>wool thread, thread</li></ol>
јирме|ǰirme	<i>num</i><br><ol><li>twenty</li></ol>
јобо|ǰobo	<i>noun</i><br><ol><li>wild garlic</li></ol>
јоголор|ǰogolor	<i>verb</i><br><ol><li>to disappear</li></ol>
јодо|ǰodo	<i>noun</i><br><ol><li>shin, shank</li></ol>
јодро|ǰodro	<i>noun</i><br><ol><li>bird cherry (Prunus padus) (tree and fruit)</li></ol>
јожо|ǰožo	<i>noun</i><br><ol><li>ochre</li></ol>
јойу|ǰoyu	<i>adv</i><br><ol><li>on foot</li></ol>
јок|ǰok	<i>adv</i><br><ol><li>not</li></ol>
јол|ǰol	<i>noun</i><br><ol><li>way, road.</li></ol>
јолдош|ǰoldoš	<i>noun</i><br><ol><li>friend</li><li>fellow traveller</li><li>comrade</li></ol>
јолчы|ǰolčï	<i>noun</i><br><ol><li>traveler</li></ol>
јон|ǰon	<i>noun</i><br><ol><li>people, ethnic group</li></ol>
јоон|ǰoon	<i>adj</i><br><ol><li>thick</li></ol>
јудар|ǰudar	<i>verb</i><br><ol><li>to swallow</li></ol>
јука|ǰuka	<i>adj</i><br><ol><li>thin</li></ol>
јулар|ǰular	<i>noun</i><br><ol><li>halter</li></ol>
јум|ǰum	<i>noun</i><br><ol><li>wool</li></ol>
јумгак|ǰumgak	<i>noun</i><br><ol><li>limp</li></ol>
јурт|ǰurt	<i>noun</i><br><ol><li>village</li></ol>
јуу|ǰuu	<i>noun</i><br><ol><li>war, enemy</li><li>fat</li></ol>
јуук|ǰuuk	<i>adj</i><br><ol><li>close, near</li></ol>
јууркан|ǰuurkan	<i>noun</i><br><ol><li>blanket</li></ol>
јуучы|ǰuučï	<i>noun</i><br><ol><li>matchmaker</li><li>collector</li></ol>
јуҥ|ǰuŋ	<i>noun</i><br><ol><li>feather</li></ol>
јыбар|ǰïbar	<i>noun</i><br><ol><li>light wind</li></ol>
јыл|cıl	<i>noun</i><br><ol><li>year</li></ol>
јылан|cılan|јыланга|јыланнаҥ|јыландардың (ǰïlandardïң)|јыландарга|јыланда|јыландарда|јыланныҥ|јыланды|јыландар|јыландардан|јыландарды	<i>noun</i><br><ol><li>snake</li></ol>
јылаҥайак|ǰïlaŋayak	<i>noun</i><br><ol><li>barefoot</li></ol>
јылаҥаш|ǰïlaŋaš	<i>adj</i><br><ol><li>nuked, bare</li></ol>
јылаҥбаш|ǰïlaŋbaš	<i>adj</i><br><ol><li>bareheaded</li></ol>
јылдык|ǰïldïk	<i>noun</i><br><ol><li>anniversary</li></ol>
јылдыс|ǰïldïs	<i>noun</i><br><ol><li>(astronomy) star</li></ol>
јылкы|ǰïlkï	<i>noun</i><br><ol><li>horse</li></ol>
јылу|ǰïlu	<i>adj</i><br><ol><li>warm</li></ol>
јымжак|ǰïmžak	<i>adj</i><br><ol><li>soft</li></ol>
јымран|ǰïmran	<i>noun</i><br><ol><li>spermophilus, gopher</li></ol>
јымыртка|cımırtqa	<i>noun</i><br><ol><li>egg</li></ol>
јымырыт|ǰïmïrït	<i>noun</i><br><ol><li>bird cherry</li></ol>
јыт|ǰït	<i>noun</i><br><ol><li>smell</li></ol>
јӧргӧмӧш|ǰörgömöš	<i>noun</i><br><ol><li>spider</li></ol>
јӱгӱрер|ǰügürer	<i>verb</i><br><ol><li>to run</li></ol>
јӱгӱрӱк|ǰügürük	<i>adj</i><br><ol><li>fast, quick</li></ol>
јӱйер|ǰüyer	<i>verb</i><br><ol><li>to go to the end</li></ol>
јӱрек|ǰürek	<i>noun</i><br><ol><li>heart</li></ol>
јӱс|ǰüs	<i>num</i><br><ol><li>hundred</li></ol>
јӱс јыл|ǰüs ǰïl	<i>noun</i><br><ol><li>century</li></ol>
ӧгӱс|ögüs	<i>noun</i><br><ol><li>male bear</li></ol>
ӧдӱк|ödük	<i>noun</i><br><ol><li>boot, footwear</li></ol>
ӧзӧк|özök	<i>noun</i><br><ol><li>pivot</li></ol>
ӧзӧн|özön	<i>noun</i><br><ol><li>river (duct, stream)</li></ol>
ӧзӧр|özör	<i>verb</i><br><ol><li>to grow</li></ol>
ӧй|öy	<i>noun</i><br><ol><li>time</li></ol><br><i>adj</i><br><ol><li>step-</li></ol>
ӧкпӧ|ökpö	<i>noun</i><br><ol><li>lung</li></ol>
ӧксӱс|öksüs	<i>noun</i><br><ol><li>orphan</li></ol>
ӧлӱ|ölü	<i>num</i><br><ol><li>fifty</li></ol><br><i>adj</i><br><ol><li>dead</li></ol>
ӧлӱм|ölüm	<i>noun</i><br><ol><li>death</li></ol>
ӧмӱт|ömüt	<i>noun</i><br><ol><li>excitement spirit</li></ol>
ӧргӧӧ|örgöö	<i>noun</i><br><ol><li>palace</li></ol>
ӧркӧш|örköš	<i>noun</i><br><ol><li>hump (camel)</li></ol>
ӧрт|ört	<i>noun</i><br><ol><li>fire</li></ol>
ӧртӧк|örtök	<i>noun</i><br><ol><li>duck</li></ol>
ӧрӧр|örör	<i>verb</i><br><ol><li>to twist</li></ol>
ӧрӱм|örüm	<i>noun</i><br><ol><li>braid</li><li>drill</li></ol>
ӧс|ös	<i>pron</i><br><ol><li>self</li></ol>
ӧскӧ|öskö	<i>adj</i><br><ol><li>other</li></ol>
ӧт|öt	<i>noun</i><br><ol><li>bile</li></ol>
ӧтпӧк|ötpök	<i>noun</i><br><ol><li>roll of bread, bread</li></ol>
ӧч|öč	<i>noun</i><br><ol><li>spite, revenge</li></ol>
ӧчтӱ|öčtü	<i>adj</i><br><ol><li>bitter</li></ol>
ӧчӧр|öčör	<i>verb</i><br><ol><li>to go out</li></ol>
ӧчӱргиш|öčürgiš	<i>noun</i><br><ol><li>eraser</li></ol>
ӧштӱ|öştü	<i>noun</i><br><ol><li>enemy, opponent</li></ol>
ӧҥ|öŋ	<i>noun</i><br><ol><li>colour</li></ol>
ӱжӱк|üžük	<i>noun</i><br><ol><li>freezing water</li></ol>
ӱжӱӱр|üžüür	<i>verb</i><br><ol><li>to freeze</li></ol>
ӱзер|üzer	<i>verb</i><br><ol><li>to tear</li></ol>
ӱзеҥи|üzeŋi	<i>noun</i><br><ol><li>stirrup</li></ol>
ӱзӱк|üzük	<i>adj</i><br><ol><li>ragged</li></ol>
ӱзӱм|üzüm	<i>noun</i><br><ol><li>raisin grape</li></ol>
ӱй|üy	<i>noun</i><br><ol><li>home</li></ol>
ӱйген|üygen	<i>noun</i><br><ol><li>bridle</li></ol>
ӱкӱ|ükü	<i>noun</i><br><ol><li>owl</li></ol>
ӱлгер|ülger	<i>name</i><br><ol><li>Pleiades</li></ol>
ӱлгӱ|ülgü	<i>noun</i><br><ol><li>example</li></ol>
ӱлеер|üleer	<i>verb</i><br><ol><li>to separate</li></ol>
ӱлеш|üleš	<i>noun</i><br><ol><li>part, share</li></ol>
ӱн|ün	<i>noun</i><br><ol><li>voice, sound</li></ol>
ӱндӱ|ündü	<i>adj</i><br><ol><li>vowel</li></ol>
ӱренер|ürener	<i>verb</i><br><ol><li>to learn</li></ol>
ӱрер|ürer	<i>verb</i><br><ol><li>to bark</li></ol>
ӱркӱӱр|ürküür	<i>verb</i><br><ol><li>to frighten</li></ol>
ӱст|üst	<i>noun</i><br><ol><li>top</li></ol>
ӱстӱнде|üstünde	<i>adv</i><br><ol><li>on</li></ol>
ӱч	<i>num</i><br><ol><li>three</li></ol>
ӱчинчи|üčinči	<i>num</i><br><ol><li>third</li></ol>
ӱчӱ|üčü	<i>num</i><br><ol><li>three (in a group together)</li></ol>
