Hyang	<i>noun</i><br><ol><li>God</li><li>goddess</li><li>divinity</li><li>deified being</li></ol>
Jepang	<i>name</i><br><ol><li>Japan</li></ol>
Jumaah	<i>romanization</i><br><ol><li>Romanization of ᮏᮥᮙᮃᮂ</li></ol>
Kandang	<i>noun</i><br><ol><li>kennel</li><li>stable</li><li>corral</li><li>pen</li><li>chickenrun</li></ol>
Ki balanak	<i>noun</i><br><ol><li>Avicennia officinalis L.</li></ol>
Lapang	<i>noun</i><br><ol><li>unbuilt terrain</li><li>flat block of land</li><li>(sports, playing) field</li><li>square</li></ol>
Nini Darugi	<i>noun</i><br><ol><li>kind of evil spirit</li></ol>
Nusantara	<i>name</i><br><ol><li>the archipelagic region known as 'Indonesian Archipelago' in modern-day.</li></ol>
Pangbanyu	<i>noun</i><br><ol><li>(Jhon) the Baptist</li></ol>
Rebo	<i>noun</i><br><ol><li>Wednesday</li></ol>
Salasa	<i>noun</i><br><ol><li>Tuesday</li></ol>
Saptu	<i>noun</i><br><ol><li>Saturday</li></ol>
Senén	<i>noun</i><br><ol><li>Monday</li></ol>
Sieng	<i>noun</i><br><ol><li>description of a whistling or zooming sound through the air, e.g. of a flying arrow, bullet, stone, etc.</li></ol>
aa	<i>noun</i><br><ol><li>older brother</li></ol>
abah	<i>romanization</i><br><ol><li>Romanization of ᮃᮘᮂ; father (male parent)</li></ol>
abah-abah	<i>romanization</i><br><ol><li>Romanization of ᮃᮘᮂ-ᮃᮘᮂ</li></ol>
abdi	<i>pron</i><br><ol><li>(polite) I</li></ol><br><i>noun</i><br><ol><li>servant</li><li>dependant</li><li>subordinate</li></ol>
abot	<i>romanization</i><br><ol><li>Romanization of ᮃᮘᮧᮒ᮪</li></ol>
abring	<i>verb</i><br><ol><li>(vi) troop out in a group somewhere; (vt.) accompany/walk behind so./st. in group</li></ol>
abrul	<i>verb</i><br><ol><li>go/move out/ come (out) in a crowd/throng</li></ol>
absés	<i>noun</i><br><ol><li>abscess</li></ol>
acreug	<i>verb</i><br><ol><li>jump</li><li>hop</li></ol>
acrig	<i>verb</i><br><ol><li>hop</li></ol>
adat	<i>romanization</i><br><ol><li>Romanization of ᮃᮓᮒ᮪.</li></ol>
adeg	<i>romanization</i><br><ol><li>Romanization of ᮃᮓᮨᮌ᮪</li></ol>
adi beuteung	<i>noun</i><br><ol><li>youger brother/sister-in-law</li></ol>
aduh	<i>romanization</i><br><ol><li>Romanization of ᮃᮓᮥᮂ</li></ol>
ageung	<i>romanization</i><br><ol><li>Romanization of ᮃᮌᮩᮀ</li></ol>
agrikultur	<i>romanization</i><br><ol><li>Romanization of ᮃᮌᮢᮤᮊᮥᮜ᮪ᮒᮥᮁ</li></ol>
ajag	<i>noun</i><br><ol><li>dhole</li><li>wolf</li></ol>
ajak	<i>romanization</i><br><ol><li>Romanization of ᮃᮏᮊ᮪</li></ol>
ajeg	<i>romanization</i><br><ol><li>Romanization of ᮃᮏᮨᮌ᮪</li></ol>
ajleng	<i>verb</i><br><ol><li>jump (up)</li><li>hop</li><li>skip</li></ol>
ajlok	<i>verb</i><br><ol><li>jump</li></ol>
ajrut	<i>verb</i><br><ol><li>jump down</li></ol>
ajul	<i>verb</i><br><ol><li>to knock off with a pole</li></ol>
akang	<i>romanization</i><br><ol><li>Romanization of ᮃᮊᮀ</li></ol>
aki	<i>noun</i><br><ol><li>grandfather</li></ol>
aksara	<i>romanization</i><br><ol><li>Romanization of ᮃᮊ᮪ᮞᮛ</li></ol>
alas	<i>noun</i><br><ol><li>forest</li></ol>
alih	<i>romanization</i><br><ol><li>Romanization of ᮃᮜᮤᮂ</li></ol>
alim	<i>romanization</i><br><ol><li>Romanization of ᮃᮜᮤᮙ᮪</li></ol>
alit	<i>adj</i><br><ol><li>small</li><li>young</li></ol>
alung	<i>romanization</i><br><ol><li>Romanization of ᮃᮜᮥᮀ</li></ol>
amang	<i>noun</i><br><ol><li>uncle (brother (or brother-in-law) of someone’s parent)</li></ol>
ambekan	<i>romanization</i><br><ol><li>Romanization of ᮃᮙ᮪ᮘᮨᮊᮔ᮪</li></ol>
ambleng	<i>verb</i><br><ol><li>keep/stay under water (fig.), (disappear and) not let oneself be heard, not turn (show) up</li></ol>
ambung	<i>romanization</i><br><ol><li>Romanization of ᮃᮙ᮪ᮘᮥᮀ</li></ol>
ameng	<i>romanization</i><br><ol><li>Romanization of ᮃᮙᮨᮀ</li></ol>
amparan	<i>romanization</i><br><ol><li>Romanization of ᮃᮙ᮪ᮕᮛᮔ᮪</li></ol>
ampih	<i>verb</i><br><ol><li>neatly put away</li><li>(of person) retreat (to one's room etc.)</li></ol>
amyang	<i>verb</i><br><ol><li>have a bright yellow tinge (of/like the ripening riceplant, also the skin of a young woman)</li></ol>
ancal-ancalan	<i>verb</i><br><ol><li>(only/already/still) to be here and there; to appear scattered (of e.g. ripening rice in the field, tree growth on the plains, villages in a thinly populated area, fruit that is not ready for harvest, work in conjunction with cultivation, in an old tradition)</li><li>come up here and there (of plants)</li></ol>
ancrub	<i>verb</i><br><ol><li>step/jump in the water; (fig.) throw oneself into (kana) st. (eg. politics, pursuit of knowledge)</li></ol>
ancul	<i>verb</i><br><ol><li>(with the head etc.) make an upward movement (while walking, of/as deer, horses), bounce up (of a ball)</li></ol>
andéwi	<i>romanization</i><br><ol><li>Romanization of ᮃᮔ᮪ᮓᮦᮝᮤ</li></ol>
angen	<i>romanization</i><br><ol><li>Romanization of ᮃᮍᮨᮔ᮪</li></ol>
anggel	<i>noun</i><br><ol><li>pillow</li></ol>
anggrék	<i>noun</i><br><ol><li>orchid</li></ol>
angin	<i>romanization</i><br><ol><li>Romanization of ᮃᮍᮤᮔ᮪</li></ol>
anging	<i>romanization</i><br><ol><li>Romanization of ᮃᮍᮤᮀ</li></ol>
angkat	<i>romanization</i><br><ol><li>Romanization of ᮃᮀᮊᮒ᮪</li></ol>
angkeub	<i>romanization</i><br><ol><li>Romanization of ᮃᮀᮊᮩᮘ᮪</li></ol>
angkik	<i>noun</i><br><ol><li>agate</li></ol>
angklung	<i>romanization</i><br><ol><li>Romanization of ᮃᮀᮊᮣᮥᮀ</li></ol>
angkutan	<i>romanization</i><br><ol><li>Romanization of ᮃᮀᮊᮥᮒᮔ᮪</li></ol>
anglo	<i>romanization</i><br><ol><li>Romanization of ᮃᮍᮣᮧ</li></ol>
anjeun	<i>romanization</i><br><ol><li>Romanization of ᮃᮔ᮪ᮏᮩᮔ᮪</li></ol>
anjeunna	<i>romanization</i><br><ol><li>Romanization of ᮃᮔ᮪ᮏᮩᮔ᮪ᮔ</li></ol>
anjing	<i>romanization</i><br><ol><li>Romanization of ᮃᮔ᮪ᮏᮤᮀ</li></ol>
anom	<i>romanization</i><br><ol><li>Romanization of ᮃᮔᮧᮙ᮪</li></ol>
anteb	<i>adj</i><br><ol><li>serious</li><li>profound</li><li>tender</li><li>earnest</li><li>intense (with ref. to reflect upon, concentrate on something, feelings, beauty,etc.)</li><li>well-grounded (of someone's judgement etc.)</li></ol>
antér	<i>verb</i><br><ol><li>linger</li><li>delay</li><li>procrastinate</li><li>dawdle</li><li>loiterer</li><li>slacker</li><li>lag behind</li></ol>
apiun	<i>noun</i><br><ol><li>opium</li></ol>
apoték	<i>romanization</i><br><ol><li>Romanization of ᮃᮕᮧᮒᮦᮊ᮪</li></ol>
araing	<i>romanization</i><br><ol><li>Romanization of ᮃᮛᮄᮀ</li></ol>
aranjeun	<i>romanization</i><br><ol><li>Romanization of ᮃᮛᮔ᮪ᮏᮩᮔ᮪</li></ol>
aranjeunna	<i>romanization</i><br><ol><li>Romanization of ᮃᮛᮔ᮪ᮏᮩᮔ᮪ᮔ</li></ol>
arbén	<i>noun</i><br><ol><li>strawberry</li></ol>
arek	<i>romanization</i><br><ol><li>Romanization of ᮃᮛᮨᮊ᮪</li></ol>
arerut	<i>noun</i><br><ol><li>arrowroot</li></ol>
areuy	<i>noun</i><br><ol><li>climber/creeper/trailer plant</li></ol>
areuy babalingbingan	<i>noun</i><br><ol><li>A plant, Adenia cordifolia</li></ol>
areuy beurit	<i>noun</i><br><ol><li>A plant, Hiptage benghalensis</li></ol>
arot	<i>romanization</i><br><ol><li>Romanization of ᮃᮛᮧᮒ᮪</li></ol>
artos	<i>noun</i><br><ol><li>money (in polite form)</li></ol>
arurang	<i>romanization</i><br><ol><li>Romanization of ᮃᮛᮥᮛᮀ</li></ol>
asalna	<i>adv</i><br><ol><li>originally</li><li>initially</li></ol>
asih	<i>noun</i><br><ol><li>love</li></ol>
asrog	<i>verb</i><br><ol><li>come forward</li><li>turn up somewhere/at someone's place</li><li>come up to someone</li></ol>
ati	<i>romanization</i><br><ol><li>Romanization of ᮃᮒᮤ</li></ol>
atuh	<i>intj</i><br><ol><li>well...!, (well) then ....! , ....hear!, ....then!</li></ol>
atur	<i>romanization</i><br><ol><li>Romanization of ᮃᮒᮥᮁ</li></ol>
august	<i>noun</i><br><ol><li>August</li></ol>
awang	<i>romanization</i><br><ol><li>Romanization of ᮃᮝᮀ</li></ol>
aweuhan	<i>noun</i><br><ol><li>echo</li><li>resonance</li><li>reverberation</li></ol>
awis	<i>romanization</i><br><ol><li>Romanization of ᮃᮝᮤᮞ᮪</li></ol>
awon	<i>romanization</i><br><ol><li>Romanization of ᮃᮝᮧᮔ᮪</li></ol>
awut-awut	<i>adj</i><br><ol><li>disorderly</li><li>chaotic</li></ol>
ayakan	<i>noun</i><br><ol><li>sieve</li></ol>
ayeuna	<i>noun</i><br><ol><li>now</li><li>today</li><li>at present</li><li>nowadays</li></ol>
baca	<i>romanization</i><br><ol><li>Romanization of ᮘᮎ.</li></ol>
badarat	<i>verb</i><br><ol><li>go on foot</li></ol>
badéga	<i>noun</i><br><ol><li>servant</li></ol>
bagedur	<i>romanization</i><br><ol><li>Romanization of ᮘᮌᮨᮓᮥᮁ</li></ol>
bagong	<i>noun</i><br><ol><li>wild boar</li><li>(vulgar) a swear word</li><li>hog</li><li>pig</li></ol>
baham	<i>romanization</i><br><ol><li>Romanization of ᮘᮠᮙ᮪</li></ol>
bajing	<i>romanization</i><br><ol><li>Romanization of ᮘᮏᮤᮀ</li></ol>
baku	<i>romanization</i><br><ol><li>Romanization of ᮘᮊᮥ.</li></ol>
balakaciut	<i>noun</i><br><ol><li>A plant, Hyptis suaveolens (L.) Poit.</li></ol>
baluas	<i>noun</i><br><ol><li>phobia</li></ol>
bangsa	<i>romanization</i><br><ol><li>Romanization of ᮘᮀᮞ.</li></ol>
bangsat	<i>noun</i><br><ol><li>burglar</li><li>thief</li><li>rogue</li><li>scoundrel</li></ol>
baralak	<i>noun</i><br><ol><li>dried leaf of the cocos palm</li></ol>
bareubeuy	<i>noun</i><br><ol><li>Helicia serrata Bl. Member of the proteaceae</li></ol>
bareuh	<i>romanization</i><br><ol><li>Romanization of ᮘᮛᮩᮂ</li></ol>
baru	<i>romanization</i><br><ol><li>Romanization of ᮘᮛᮥ</li></ol>
baréa-réa	<i>adv</i><br><ol><li>in great numbers</li></ol>
basa	<i>romanization</i><br><ol><li>Romanization of ᮘᮞ</li></ol>
basa lulugu	<i>noun</i><br><ol><li>standard language</li></ol>
baseuh	<i>romanization</i><br><ol><li>Romanization of ᮘᮞᮩᮂ</li></ol>
batang	<i>romanization</i><br><ol><li>Romanization of ᮘᮒᮀ.</li></ol>
batu	<i>romanization</i><br><ol><li>Romanization of ᮘᮒᮥ</li></ol>
bayah	<i>romanization</i><br><ol><li>Romanization of ᮘᮚᮂ</li></ol>
bayu	<i>romanization</i><br><ol><li>Romanization of ᮘᮚᮥ</li></ol>
bebegig	<i>noun</i><br><ol><li>puppet with an ugly face</li><li>scarecrow</li></ol>
bedol	<i>romanization</i><br><ol><li>Romanization of ᮘᮨᮓᮧᮜ᮪</li></ol>
bekok	<i>noun</i><br><ol><li>fart</li><li>wind</li></ol>
beledag	<i>noun</i><br><ol><li>description of loud banging sound (like a sharp thunderclap, firearm, whip,etc)</li></ol>
belewuk	<i>romanization</i><br><ol><li>Romanization of ᮘᮨᮜᮨᮝᮥᮊ᮪</li></ol>
bener	<i>romanization</i><br><ol><li>Romanization of ᮘᮨᮔᮨᮁ</li></ol>
berengbeng	<i>noun</i><br><ol><li>anticipator for : run, run away</li></ol>
beréndi	<i>noun</i><br><ol><li>brandy</li></ol>
beubeunteuran	<i>noun</i><br><ol><li>Isachne miliacea Roth.</li><li>Maoutia diversifolia Wedd.</li></ol>
beubeuritan	<i>romanization</i><br><ol><li>Romanization of ᮘᮩᮘᮩᮛᮤᮒᮔ᮪</li></ol>
beulah	<i>romanization</i><br><ol><li>Romanization of ᮘᮩᮜᮂ</li></ol>
beuleum	<i>romanization</i><br><ol><li>Romanization of ᮘᮩᮜᮩᮙ᮪</li></ol>
beunghar	<i>romanization</i><br><ol><li>Romanization of ᮘᮩᮀᮠᮁ</li></ol>
beungkeut	<i>romanization</i><br><ol><li>Romanization of ᮘᮩᮀᮊᮩᮒ᮪</li></ol>
beunta	<i>verb</i><br><ol><li>have one's eyes (well) open</li><li>open one's eyes</li><li>(fig.) see things sharply, have a clear insight</li><li>have done well (with ref. To one's living condition etc.)</li></ol>
beunying	<i>noun</i><br><ol><li>Ficus fistulosa Reinw.</li></ol>
beureum	<i>romanization</i><br><ol><li>Romanization of ᮘᮩᮛᮩᮙ᮪</li></ol>
beurit	<i>noun</i><br><ol><li>mouse</li><li>rat</li></ol>
beusi	<i>romanization</i><br><ol><li>Romanization of ᮘᮩᮞᮤ</li></ol>
beuteung	<i>noun</i><br><ol><li>belly</li><li>stomach</li></ol>
biang	<i>romanization</i><br><ol><li>Romanization of ᮘᮤᮃᮀ</li></ol>
bijil	<i>verb</i><br><ol><li>come out</li><li>come forth</li><li>appear</li><li>turn up</li><li>make one's appearance</li><li>rise</li><li>come up (of the sun, stars)</li></ol>
binatang	<i>noun</i><br><ol><li>animal (organism)</li><li>animal (organism other than man)</li></ol>
bingkeng	<i>romanization</i><br><ol><li>Romanization of ᮘᮤᮀᮊᮨᮀ</li></ol>
binih	<i>noun</i><br><ol><li>seed</li></ol><br><i>romanization</i><br><ol><li>Romanization of ᮘᮤᮔᮤᮂ</li></ol>
bisoro	<i>noun</i><br><ol><li>tree</li><li>Ficus hispida</li></ol>
bobongkong	<i>noun</i><br><ol><li>apparition</li><li>phantom</li></ol>
bodas	<i>noun</i><br><ol><li>white</li></ol>
bojo	<i>romanization</i><br><ol><li>Romanization of ᮆᮒ</li></ol>
bolokot	<i>romanization</i><br><ol><li>Romanization of ᮘᮧᮜᮧᮊᮧᮒ᮪</li></ol>
bolérang	<i>noun</i><br><ol><li>whirlpool</li></ol>
boncérét	<i>verb</i><br><ol><li>a. have the eyes wide open, (of the eyes) wide open (eg. with ref.to a child that lies awake)</li><li>b. (with ref. to rice kernels) have beutiful round kernels, (with ref. to podbearing fruit) have big seeds</li><li>c. (C.) glitter, sparkle</li></ol>
bortol	<i>noun</i><br><ol><li>carrot</li><li>parsnip</li></ol>
borérang	<i>noun</i><br><ol><li>whirlpool</li></ol>
buah	<i>romanization</i><br><ol><li>Romanization of ᮘᮥᮃᮂ</li></ol>
buana	<i>romanization</i><br><ol><li>Romanization of ᮘᮥᮃᮔ</li></ol>
bubudén	<i>noun</i><br><ol><li>nature</li><li>disposition</li><li>tendency</li><li>manner</li></ol>
budah	<i>noun</i><br><ol><li>foam</li></ol>
buhaya	<i>noun</i><br><ol><li>crocodile</li></ol><br><i>romanization</i><br><ol><li>Romanization of ᮘᮥᮠᮚ</li></ol>
bujeng	<i>romanization</i><br><ol><li>Romanization of ᮘᮥᮏᮨᮀ</li></ol>
bulan	<i>noun</i><br><ol><li>moon (largest natural satellite of planet Earth)</li><li>moon (any substantially sized natural satellite of a planet)</li><li>month (period into which a year is divided)</li></ol>
bulao	<i>romanization</i><br><ol><li>Romanization of ᮘᮥᮜᮇ</li></ol>
buleud	<i>romanization</i><br><ol><li>Romanization of ᮘᮥᮜᮩᮓ᮪</li></ol>
bunder	<i>romanization</i><br><ol><li>Romanization of ᮘᮥᮔ᮪ᮓᮨᮁ</li></ol>
bungaok	<i>noun</i><br><ol><li>kind of night spirit</li></ol>
buntut	<i>romanization</i><br><ol><li>Romanization of ᮘᮥᮔ᮪ᮒᮥᮒ᮪</li></ol>
burangrang	<i>noun</i><br><ol><li>leafless branch</li></ol>
burih	<i>noun</i><br><ol><li>gizard of a bird</li></ol>
burintik	<i>noun</i><br><ol><li>cloth baby cap</li></ol>
buru	<i>romanization</i><br><ol><li>Romanization of ᮘᮥᮛᮥ</li></ol>
buruk	<i>romanization</i><br><ol><li>Romanization of ᮘᮥᮛᮥᮊ᮪</li></ol>
butak	<i>romanization</i><br><ol><li>Romanization of ᮘᮥᮒᮊ᮪</li></ol>
butuh	<i>romanization</i><br><ol><li>Romanization of ᮘᮥᮒᮥᮂ</li></ol>
buuk	<i>romanization</i><br><ol><li>Romanization of ᮊᮨᮊᮨᮘᮥᮜ᮪</li></ol>
béntang	<i>romanization</i><br><ol><li>Romanization of ᮘᮦᮔ᮪ᮒᮀ</li></ol>
béntang ranggeuyan	<i>noun</i><br><ol><li>constellation</li></ol>
cacai	<i>romanization</i><br><ol><li>Romanization of ᮎᮎᮄ</li></ol>
cacar	<i>romanization</i><br><ol><li>Romanization of ᮎᮎᮁ</li></ol>
cacing	<i>romanization</i><br><ol><li>Romanization of ᮎᮎᮤᮀ</li></ol>
cahaya	<i>romanization</i><br><ol><li>Romanization of ᮎᮠᮚ</li></ol>
cai	<i>romanization</i><br><ol><li>Romanization of ᮎᮄ</li></ol>
caket	<i>romanization</i><br><ol><li>Romanization of ᮎᮊᮨᮒ᮪</li></ol>
cakueum	<i>adj</i><br><ol><li>dark, gloomy (of a house or garden surrounded by overgrow trees etc.)</li></ol>
calangap	<i>verb</i><br><ol><li>wide open (of the mouth/snout), agape; open the mouth wide (esp. to snap st. up, to bite st.)</li></ol>
calik	<i>romanization</i><br><ol><li>Romanization of ᮝᮜᮥᮍᮔ᮪</li></ol>
camaplang	<i>adj</i><br><ol><li>stretch wide (of an expanse of water etc.)</li></ol>
campleng	<i>adj</i><br><ol><li>exact</li><li>precise (of size, weight,time)</li></ol>
cangkang	<i>noun</i><br><ol><li>(thick or hard) peel (eg.of a banana, citrus fruit, leguminous plants)</li><li>husk</li><li>shell</li><li>coconut bark</li><li>leaf-sheath around the corncob</li><li>shell ( of an egg, crab, prawn, snail, turtle,etc.)</li><li>empty box or packet (of matches, ciggarettes, etc.)</li></ol><br><i>romanization</i><br><ol><li>Romanization of ᮎᮀᮊᮀ</li></ol>
carakan	<i>noun</i><br><ol><li>the traditional arrangement of the letters of the Sundanese alphabet.</li></ol>
carios	<i>romanization</i><br><ol><li>Romanization of ᮎᮛᮤᮇᮞ᮪</li></ol>
carogé	<i>romanization</i><br><ol><li>Romanization of ᮎᮛᮧᮌᮦ</li></ol>
catang bobo	<i>noun</i><br><ol><li>Milky Way</li></ol>
catih	<i>noun</i><br><ol><li>unirrigated rice-field</li></ol>
cawokah	<i>romanization</i><br><ol><li>Romanization of ᮎᮝᮧᮊᮂ</li></ol>
cawudwud	<i>adj</i><br><ol><li>wolly ( as a fleece of sheep)</li><li>shaggy</li><li>hairy</li></ol>
cepeng	<i>romanization</i><br><ol><li>Romanization of ᮎᮨᮕᮨᮀ</li></ol>
cepil	<i>romanization</i><br><ol><li>Romanization of ᮎᮨᮕᮤᮜ᮪</li></ol>
cibéas	<i>noun</i><br><ol><li>rice water</li></ol>
cihujan	<i>noun</i><br><ol><li>rainwater</li></ol>
cikama	<i>noun</i><br><ol><li>sperm</li></ol>
cikiih	<i>noun</i><br><ol><li>urine</li></ol>
cikokocrot	<i>noun</i><br><ol><li>sperm</li></ol>
cikénéh	<i>adv</i><br><ol><li>just now</li><li>just then</li></ol>
cinggir	<i>noun</i><br><ol><li>little finger</li></ol>
cipanas	<i>noun</i><br><ol><li>hot water</li><li>hot spring</li></ol>
cokoh	<i>adj</i><br><ol><li>handsome</li></ol>
colong	<i>verb</i><br><ol><li>to steal</li></ol>
congcorang	<i>noun</i><br><ol><li>praying mantis</li></ol>
cucuk	<i>romanization</i><br><ol><li>Romanization of ᮎᮥᮎᮥᮊ᮪</li></ol>
cucunguk	<i>romanization</i><br><ol><li>Romanization of ᮎᮥᮎᮥᮍᮥᮊ᮪</li></ol>
cucut	<i>noun</i><br><ol><li>shark</li></ol>
cungcurungan	<i>noun</i><br><ol><li>coccyx</li><li>tail bone</li></ol>
cungunguk	<i>romanization</i><br><ol><li>Romanization of ᮎᮥᮍᮥᮍᮥᮊ᮪</li></ol>
curug	<i>noun</i><br><ol><li>waterfall</li></ol>
curuk	<i>noun</i><br><ol><li>index finger</li></ol>
cécél	<i>verb</i><br><ol><li>damaged ( of something when one or more pieces or parts are missing, e.g. a table-top, car)</li><li>stripped of the skin, grazed, skinned</li></ol>
dadawuhan	<i>romanization</i><br><ol><li>Romanization of ᮓᮓᮝᮥᮠᮔ᮪</li></ol>
dahar	<i>verb</i><br><ol><li>to eat</li></ol>
dahu	<i>romanization</i><br><ol><li>Romanization of ᮓᮠᮥ</li></ol>
dalingding	<i>romanization</i><br><ol><li>Romanization of ᮓᮜᮤᮀᮓᮤᮀ</li></ol>
dalurung	<i>romanization</i><br><ol><li>Romanization of ᮓᮜᮥᮛᮥᮀ</li></ol>
dangdeur	<i>romanization</i><br><ol><li>Romanization of ᮓᮀᮓᮩᮁ</li></ol>
dangu	<i>romanization</i><br><ol><li>Romanization of ᮓᮍᮥ</li></ol>
darat	<i>romanization</i><br><ol><li>Romanization of ᮓᮛᮒ᮪</li></ol>
dat areng	<i>noun</i><br><ol><li>carbon</li></ol>
dat haseum	<i>noun</i><br><ol><li>oxygen</li></ol>
daun	<i>romanization</i><br><ol><li>Romanization of ᮓᮅᮔ᮪</li></ol>
dawa	<i>noun</i><br><ol><li>lawsuit; a dispute carried before a court or authority.</li></ol>
dawuh	<i>romanization</i><br><ol><li>Romanization of ᮓᮝᮥᮂ</li></ol>
dawuh kiwari	<i>romanization</i><br><ol><li>Romanization of ᮓᮝᮥᮂ ᮊᮤᮝᮛᮤ</li></ol>
dawĕuh	<i>noun</i><br><ol><li>a small variety of rattan, used for cords or whips.</li></ol>
daya	<i>verb</i><br><ol><li>to deceive, to persuade to anything under false pretenses. artifice. trick.</li></ol>
dayang	<i>romanization</i><br><ol><li>Romanization of ᮓᮚᮀ</li></ol>
dayeuh	<i>romanization</i><br><ol><li>Romanization of ᮓᮚᮩᮂ</li></ol>
dedeg	<i>adj</i><br><ol><li>well-built</li><li>strongly-built</li></ol>
dedegan	<i>noun</i><br><ol><li>build</li><li>stature</li><li>physique</li><li>size</li></ol>
detik	<i>romanization</i><br><ol><li>Romanization of ᮓᮨᮒᮤᮊ᮪</li></ol>
deui	<i>adv</i><br><ol><li>again</li><li>once again</li><li>once more</li><li>still (some, severeal, etc.) more</li><li>(who, what, where) else, further</li><li>(no, never) more</li><li>still , over (three days, etc.)</li><li>(i, this,etc) too</li><li>of all (people, things, etc.)</li></ol>
deukeut	<i>adj</i><br><ol><li>close, near</li><li>close by, near by</li><li>neighbouring</li><li>in the vicinity</li></ol>
di dieu	<i>adv</i><br><ol><li>here</li><li>I (here)</li><li>we (here)</li><li>(in letters) with you</li></ol>
di dinya	<i>adv</i><br><ol><li>there ( at some distance from the speaker)</li><li>you (there)</li></ol>
di dinya kénéh	<i>adv</i><br><ol><li>in the same place</li></ol>
di ditu	<i>adv</i><br><ol><li>over there</li><li>out there</li><li>yonder</li></ol>
di ditu di dieu	<i>adv</i><br><ol><li>everywhere</li></ol>
di mana-mana	<i>adv</i><br><ol><li>everywhere</li><li>in all respect</li></ol>
dicareuhkeun	<i>verb</i><br><ol><li>accused of being 'queer' or 'gay'</li></ol>
dieu	<i>adv</i><br><ol><li>here</li></ol>
dikadieukeun	<i>verb</i><br><ol><li>be brought here</li></ol>
dina	<i>romanization</i><br><ol><li>Romanization of ᮓᮤᮔ</li></ol>
dinten	<i>romanization</i><br><ol><li>Romanization of ᮓᮤᮔ᮪ᮒᮨᮔ᮪</li></ol>
dinya	<i>romanization</i><br><ol><li>Romanization of ᮓᮤᮑ</li></ol>
ditu	<i>romanization</i><br><ol><li>Romanization of ᮓᮤᮒᮥ</li></ol>
dom	<i>noun</i><br><ol><li>needle</li></ol>
dompét	<i>romanization</i><br><ol><li>Romanization of ᮓᮧᮙ᮪ᮕᮦᮒ᮪</li></ol>
dongké	<i>noun</i><br><ol><li>hedgehog</li></ol>
dorhos	<i>verb</i><br><ol><li>dead/killed outright (by a firearm shot)</li></ol>
duka	<i>verb</i><br><ol><li>in the state of ignorance</li><li>not knowing</li></ol>
dumduman	<i>noun</i><br><ol><li>part</li><li>portion</li></ol>
durén	<i>romanization</i><br><ol><li>Romanization of ᮓᮥᮛᮦᮔ᮪</li></ol>
duum	<i>verb</i><br><ol><li>to divide</li><li>to split</li><li>to be lazy</li></ol>
démplon	<i>adj</i><br><ol><li>buxom</li></ol>
elol	<i>verb</i><br><ol><li>to stick one's head (eg. out of a window, doorway, also of a turtle )</li><li>to show up</li><li>let oneself be seen</li></ol>
emas	<i>romanization</i><br><ol><li>Romanization of ᮈᮙᮞ᮪</li></ol>
embung	<i>romanization</i><br><ol><li>Romanization of ᮈᮙ᮪ᮘᮥᮀ</li></ol>
endag	<i>verb</i><br><ol><li>to sway</li><li>shake lightly (of leaves moving lightly blown by the wind)</li></ol>
endog	<i>romanization</i><br><ol><li>Romanization of ᮈᮔ᮪ᮓᮧᮌ᮪</li></ol>
endung	<i>romanization</i><br><ol><li>Romanization of ᮈᮔ᮪ᮓᮥᮀ</li></ol>
engki	<i>noun</i><br><ol><li>grandpa</li></ol>
enteu	<i>romanization</i><br><ol><li>Romanization of ᮈᮔ᮪ᮒᮩ</li></ol>
entéh	<i>romanization</i><br><ol><li>Romanization of ᮈᮔ᮪ᮒᮦᮂ</li></ol>
enyay	<i>noun</i><br><ol><li>sparkle</li></ol>
erob	<i>noun</i><br><ol><li>high tide</li><li>rising flood</li></ol>
erongan	<i>noun</i><br><ol><li>outlook</li><li>expectation</li></ol>
eujeun	<i>noun</i><br><ol><li>dysentery</li></ol>
eujeung	<i>conj</i><br><ol><li>and</li><li>with</li></ol>
eumbreuk	<i>noun</i><br><ol><li>flowers of the bamboo</li></ol>
eundeur	<i>noun</i><br><ol><li>drone</li><li>rumble</li><li>shaking violently (through explosion, or heavy traffic, etc.)</li></ol>
eunteung	<i>noun</i><br><ol><li>mirror</li></ol>
eunyeuh	<i>verb</i><br><ol><li>to collapse, fall down, trumble down (of houses by flooding), overturned (of trees), sink away,give away (eg. the wall of a precipice)</li></ol>
eupan	<i>noun</i><br><ol><li>bait</li></ol>
eurih	<i>noun</i><br><ol><li>sword grass</li></ol>
eusi	<i>romanization</i><br><ol><li>Romanization of ᮉᮞᮤ</li></ol>
euti-euti	<i>noun</i><br><ol><li>kind of small beetle</li></ol>
euyeub	<i>verb</i><br><ol><li>abundant, plentiful (merchandise in the shops or department stores,etc),complete (furniture in the house, etc.);(of eyebrows) heavy, thick</li></ol>
gadag	<i>noun</i><br><ol><li>work</li></ol>
gahrab	<i>noun</i><br><ol><li>amber</li></ol>
gahung	<i>noun</i><br><ol><li>kind of mythical animal in the form of an ape</li></ol>
gajih	<i>romanization</i><br><ol><li>Romanization of ᮌᮏᮤᮂ</li></ol>
gakang	<i>adj</i><br><ol><li>aggressive</li></ol>
galabag	<i>noun</i><br><ol><li>dried tobacco leaf</li></ol>
galaksi	<i>romanization</i><br><ol><li>Romanization of ᮌᮜᮊ᮪ᮞᮤ</li></ol>
galur	<i>romanization</i><br><ol><li>Romanization of ᮌᮜᮥᮁ</li></ol>
gambus	<i>noun</i><br><ol><li>lute</li></ol>
gandola	<i>noun</i><br><ol><li>Basella alba</li><li>purple</li></ol>
ganjen	<i>adj</i><br><ol><li>coquettish</li></ol>
gaok	<i>noun</i><br><ol><li>kind of big crow</li></ol>
garing	<i>romanization</i><br><ol><li>Romanization of ᮌᮛᮤᮀ</li></ol>
garo	<i>romanization</i><br><ol><li>Romanization of ᮌᮛᮧ</li></ol>
garungsang	<i>adj</i><br><ol><li>steep</li></ol>
garwa	<i>romanization</i><br><ol><li>Romanization of ᮌᮁᮝ</li></ol>
gateuw	<i>noun</i><br><ol><li>queen of the termites (white ants)</li></ol>
geblas	<i>adj</i><br><ol><li>continuous</li><li>(meet) no obstacles</li><li>straight on</li></ol>
gedang	<i>romanization</i><br><ol><li>papaya</li><li>Romanization of ᮌᮨᮓᮀ</li></ol>
gedong	<i>noun</i><br><ol><li>building, skyscraper</li></ol>
gegendir	<i>noun</i><br><ol><li>club</li><li>cudgel</li></ol>
gegeremetan	<i>noun</i><br><ol><li>insect</li></ol>
gelekgek	<i>noun</i><br><ol><li>description (also as ant.) of a clucking sound ( like when drinking greedily)</li></ol>
gelombang	<i>romanization</i><br><ol><li>Romanization of ᮌᮨᮜᮧᮙ᮪ᮘᮀ</li></ol>
gelut	<i>romanization</i><br><ol><li>Romanization of ᮌᮨᮜᮥᮒ᮪</li></ol>
gentak	<i>adj</i><br><ol><li>hasty</li><li>quick</li><li>swift</li><li>fast</li><li>rapid</li><li>speedy</li></ol>
gerembo	<i>noun</i><br><ol><li>matchmaker</li></ol>
getih	<i>noun</i><br><ol><li>blood</li></ol><br><i>romanization</i><br><ol><li>Romanization of ᮌᮨᮒᮤᮂ</li></ol>
geulis	<i>romanization</i><br><ol><li>Romanization of ᮌᮩᮜᮤᮞ᮪</li></ol>
geuneuk	<i>adj</i><br><ol><li>looking bluish (of a spot on the body or part of the body as a result of bruising)</li><li>having a bluish spot on the body</li><li>(of someone's face) having turned purple</li></ol>
geuning	<i>intj</i><br><ol><li>(of surprise, astonishment, amazement,etc) look! apparently, indeed</li></ol>
geureuha	<i>noun</i><br><ol><li>wife</li></ol>
geureung	<i>noun</i><br><ol><li>earthworm</li></ol>
gewok	<i>verb</i><br><ol><li>to snarl</li></ol>
gilidig	<i>adj</i><br><ol><li>beaten (eg. of a path through the jungle)</li></ol>
gimbreung	<i>adj</i><br><ol><li>annoying</li><li>disturbing</li><li>inconvenient</li><li>troublesome</li></ol>
ginjal	<i>romanization</i><br><ol><li>Romanization of ᮌᮤᮔ᮪ᮏᮜ᮪</li></ol>
girimis	<i>noun</i><br><ol><li>drizzle</li></ol>
gogot	<i>verb</i><br><ol><li>to bite</li></ol><br><i>romanization</i><br><ol><li>Romanization of ᮌᮧᮌᮧᮒ᮪</li></ol>
golowong	<i>noun</i><br><ol><li>opening</li><li>cavity</li><li>gap</li></ol>
goong	<i>noun</i><br><ol><li>gong</li></ol>
goroh	<i>verb</i><br><ol><li>lied</li><li>something that is lied</li><li>lie</li><li>tell lie</li><li>to lie</li></ol>
gorombolan	<i>noun</i><br><ol><li>group</li><li>troop</li><li>gang</li></ol>
gowok	<i>noun</i><br><ol><li>cavity (esp. in a tree or a wall etc., e.g. nesting-cavity)</li><li>hut</li><li>hovel</li><li>dog-hole</li></ol>
guguk	<i>romanization</i><br><ol><li>Romanization of ᮌᮥᮌᮥᮊ᮪</li></ol>
gula	<i>romanization</i><br><ol><li>Romanization of ᮌᮥᮜ</li></ol>
guludug	<i>noun</i><br><ol><li>thunder</li></ol>
gumbeng	<i>noun</i><br><ol><li>opium pipe</li></ol>
gumujeng	<i>romanization</i><br><ol><li>Romanization of ᮌᮥᮙᮥᮏᮨᮀ</li></ol>
gundam	<i>verb</i><br><ol><li>dream aloud</li><li>talk in one's sleep</li></ol>
gunting	<i>romanization</i><br><ol><li>Romanization of ᮌᮥᮔ᮪ᮒᮤᮀ</li></ol>
gunung	<i>romanization</i><br><ol><li>Romanization of ᮌᮥᮔᮥᮀ</li></ol>
gurat	<i>noun</i><br><ol><li>line</li><li>stroke</li><li>dash (with a pen etc.)</li><li>stripe</li><li>(astronomic) degree</li></ol>
gurat jungjang	<i>noun</i><br><ol><li>diagonal</li></ol>
géléwér	<i>noun</i><br><ol><li>steep bank</li></ol>
géséh	<i>romanization</i><br><ol><li>Romanization of ᮌᮦᮞᮦᮂ</li></ol>
hadé	<i>romanization</i><br><ol><li>Romanization of ᮠᮓᮦ</li></ol>
hagaru	<i>noun</i><br><ol><li>aloe</li></ol>
hahauan	<i>noun</i><br><ol><li>A tree, Elaeocarpus floribundus.</li></ol>
hakan	<i>romanization</i><br><ol><li>Romanization of ᮠᮊᮔ᮪</li></ol>
haleungheum	<i>romanization</i><br><ol><li>Romanization of ᮠᮜᮩᮀᮠᮩᮙ᮪</li></ol>
halimun	<i>romanization</i><br><ol><li>Romanization of ᮠᮜᮤᮙᮥᮔ᮪</li></ol>
halu	<i>noun</i><br><ol><li>pestle</li></ol><br><i>romanization</i><br><ol><li>Romanization of ᮠᮜᮥ (pestle)</li></ol>
handaru	<i>noun</i><br><ol><li>echo</li><li>reverberation</li></ol>
haneut	<i>romanization</i><br><ol><li>Romanization of ᮠᮔᮩᮒ᮪</li></ol>
harigu-manukeun	<i>verb</i><br><ol><li>be pigeon breasted</li></ol>
harita	<i>adv</i><br><ol><li>at that moment</li><li>then</li></ol>
harita kénéh	<i>adv</i><br><ol><li>immediately</li><li>instantly</li><li>directly</li><li>at once</li><li>right away (leave for etc.)</li></ol>
haréwos	<i>verb</i><br><ol><li>whisper</li></ol>
haseup	<i>romanization</i><br><ol><li>Romanization of ᮠᮞᮩᮕ᮪</li></ol>
hateup|ᮠᮒᮩᮕ᮪|spelling ᮠᮒᮩᮕ᮪	<i>noun</i><br><ol><li>roof; thatch</li></ol>
haur cina	<i>noun</i><br><ol><li>A shrubby type of bamboo, Bambusa multiplex.</li></ol>
hawu	<i>romanization</i><br><ol><li>Romanization of ᮠᮝᮥ</li></ol>
hejo	<i>romanization</i><br><ol><li>Misromanization of ᮠᮦᮏᮧ (héjo).</li></ol>
heubeul	<i>romanization</i><br><ol><li>Romanization of ᮠᮩᮘᮩᮜ᮪</li></ol>
heulang	<i>noun</i><br><ol><li>bird of prey</li></ol>
heunceut	<i>romanization</i><br><ol><li>Romanization of ᮠᮩᮔ᮪ᮎᮩᮒ᮪</li></ol>
heureut	<i>romanization</i><br><ol><li>Romanization of ᮠᮩᮛᮩᮒ᮪</li></ol>
hiber	<i>romanization</i><br><ol><li>Romanization of ᮠᮤᮘᮨᮁ</li></ol>
hideung	<i>romanization</i><br><ol><li>Romanization of ᮠᮤᮓᮩᮀ</li></ol>
hieum	<i>adj</i><br><ol><li>shaded</li></ol>
hiji	<i>romanization</i><br><ol><li>Romanization of ᮠᮤᮏᮤ</li></ol>
hileud	<i>noun</i><br><ol><li>caterpillar</li></ol>
hirup	<i>romanization</i><br><ol><li>Romanization of ᮠᮤᮛᮥᮕ᮪ (“life”)</li></ol>
hiu	<i>romanization</i><br><ol><li>Romanization of ᮠᮤᮅ</li></ol>
hojah	<i>noun</i><br><ol><li>initiative</li><li>proposal</li><li>suggestion</li><li>plan</li><li>objection</li><li>argument</li></ol>
hujan	<i>romanization</i><br><ol><li>Romanization of ᮠᮥᮏᮔ᮪</li></ol>
hujan poyan	<i>noun</i><br><ol><li>rain in the sun</li></ol>
huma	<i>noun</i><br><ol><li>unirrigated rice field</li></ol>
hunyudan	<i>noun</i><br><ol><li>pile</li><li>heap</li></ol>
hunyur	<i>noun</i><br><ol><li>hillock</li><li>knoll</li><li>mound</li><li>heap of earth</li><li>termitarium</li></ol>
hurang catang	<i>noun</i><br><ol><li>lobster</li></ol>
huru	<i>romanization</i><br><ol><li>Romanization of ᮠᮥᮛᮥ</li></ol>
hurung	<i>verb</i><br><ol><li>alight</li><li>burn with bright flames(of a torch, lamp,etc.)</li><li>aglow (of iron that is being forged etc.,also fig. Someone because of indignation etc.)</li><li>gleaming (of polished gold etc.)</li></ol>
héjo	<i>romanization</i><br><ol><li>Romanization of ᮠᮦᮏᮧ</li></ol>
ihil	<i>noun</i><br><ol><li>wild boar</li></ol>
iimbangan	<i>noun</i><br><ol><li>balance</li><li>relations</li></ol>
iklim	<i>romanization</i><br><ol><li>Romanization of ᮄᮊᮣᮤᮙ᮪</li></ol>
ilat	<i>romanization</i><br><ol><li>Romanization of ᮄᮜᮒ᮪</li></ol>
imah	<i>romanization</i><br><ol><li>Romanization of ᮄᮙᮂ</li></ol>
imahkacana	<i>romanization</i><br><ol><li>Romanization of ᮄᮙᮂᮊᮎᮔ</li></ol>
imbruh	<i>adj</i><br><ol><li>corpulent</li></ol>
inggeung	<i>verb</i><br><ol><li>shaking</li><li>shuddering</li><li>swaying (because of a storm or earthquake)</li></ol>
inyana	<i>pron</i><br><ol><li>he/him etc.</li></ol>
ipis	<i>romanization</i><br><ol><li>Romanization of ᮄᮕᮤᮞ᮪</li></ol>
iraha	<i>romanization</i><br><ol><li>Romanization of ᮄᮛᮠ</li></ol>
irung	<i>romanization</i><br><ol><li>Romanization of ᮄᮛᮥᮀ</li></ol>
istri	<i>noun</i><br><ol><li>woman</li></ol>
iyeu	<i>romanization</i><br><ol><li>Romanization of ᮄᮚᮩ</li></ol>
jablog	<i>romanization</i><br><ol><li>Romanization of ᮏᮘᮣᮧᮌ᮪</li></ol>
jagong	<i>romanization</i><br><ol><li>Romanization of ᮏᮌᮧᮀ</li></ol>
jahat	<i>romanization</i><br><ol><li>Romanization of ᮏᮠᮒ᮪</li></ol>
jajangkung	<i>noun</i><br><ol><li>middle finger</li></ol>
jajantung	<i>romanization</i><br><ol><li>Romanization of ᮏᮏᮔ᮪ᮒᮥᮀ</li></ol>
jalan	<i>noun</i><br><ol><li>path (a course taken)</li><li>road</li><li>street</li></ol>
jalaran	<i>romanization</i><br><ol><li>Romanization of ᮏᮜᮛᮔ᮪</li></ol>
jalastrang	<i>noun</i><br><ol><li>tree</li><li>Talauma elegans</li></ol>
jamarak	<i>noun</i><br><ol><li>Setaria barbata</li></ol>
janggilus	<i>noun</i><br><ol><li>swordfish</li></ol>
jangjang	<i>romanization</i><br><ol><li>Romanization of ᮏᮀᮏᮀ</li></ol>
jantung	<i>romanization</i><br><ol><li>Romanization of ᮏᮔ᮪ᮒᮥᮀ</li></ol>
jariji	<i>noun</i><br><ol><li>ring finger</li></ol>
jempol	<i>noun</i><br><ol><li>thumb</li></ol>
jenengan	<i>romanization</i><br><ol><li>Romanization of ᮏᮨᮔᮨᮍᮔ᮪</li></ol>
jeruk	<i>romanization</i><br><ol><li>Romanization of ᮏᮨᮛᮥᮊ᮪.</li></ol>
joget	<i>noun</i><br><ol><li>dance; initially refers to the traditional Sundanese cultural performance (group dance, along with the songs and gamelan instrument rhythm) influenced by Javanese culture.</li></ol>
jukut	<i>noun</i><br><ol><li>grass</li></ol><br><i>romanization</i><br><ol><li>Romanization of ᮏᮥᮊᮥᮒ᮪</li></ol>
jukut kotor	<i>noun</i><br><ol><li>weed</li></ol>
jukut leuleus	<i>noun</i><br><ol><li>Dimeria ornithopoda</li></ol>
jumeneng	<i>romanization</i><br><ol><li>Romanization of ᮏᮥᮙᮨᮔᮨᮀ</li></ol>
jèndral	<i>noun</i><br><ol><li>general</li></ol>
ka dieu	<i>adv</i><br><ol><li>(to) here</li><li>hereabouts</li></ol>
ka dinya	<i>adv</i><br><ol><li>there</li><li>thither</li><li>(to) him/her/them</li></ol>
kaantékan	<i>noun</i><br><ol><li>perfection</li><li>completion</li></ol>
kaawuntahan	<i>noun</i><br><ol><li>frivolity</li><li>flippancy</li></ol>
kaayaan	<i>noun</i><br><ol><li>situation</li><li>condition</li><li>circumastances</li></ol>
kabedasan	<i>noun</i><br><ol><li>strenght</li><li>power</li></ol>
kabobongkong	<i>noun</i><br><ol><li>skeleton</li></ol>
kadaharan	<i>romanization</i><br><ol><li>Romanization of ᮊᮓᮠᮛᮔ᮪</li></ol>
kadengkian	<i>noun</i><br><ol><li>envy</li></ol>
kadieunakeun	<i>adv</i><br><ol><li>later</li><li>eventually</li></ol>
kadu	<i>romanization</i><br><ol><li>Romanization of ᮊᮓᮥ</li></ol>
kagegel	<i>noun</i><br><ol><li>attachment</li><li>devotion</li></ol>
kageulis	<i>noun</i><br><ol><li>beauty</li></ol>
kagiridig	<i>verb</i><br><ol><li>(of a place) passed/entered by many</li><li>much frequented</li></ol>
kagéloan	<i>noun</i><br><ol><li>foolishness</li><li>madness</li></ol>
kai	<i>romanization</i><br><ol><li>Romanization of ᮊᮄ</li></ol>
kajauhan	<i>noun</i><br><ol><li>distance</li></ol>
kakeuheul	<i>noun</i><br><ol><li>annoyance</li><li>displeasure</li></ol>
kakeungkang	<i>noun</i><br><ol><li>diffidence</li><li>fear of failure</li></ol>
kakuruan	<i>noun</i><br><ol><li>thinness</li></ol>
kalacuran	<i>noun</i><br><ol><li>debauchery</li><li>licentiousness</li></ol>
kalakay	<i>noun</i><br><ol><li>dried leaves</li></ol>
kalapa	<i>romanization</i><br><ol><li>Romanization of ᮊᮜᮕ</li></ol>
kalawan	<i>romanization</i><br><ol><li>Romanization of ᮊᮜᮝᮔ᮪</li></ol>
kalayan	<i>romanization</i><br><ol><li>Romanization of ᮊᮜᮚᮔ᮪</li></ol>
kali	<i>verb</i><br><ol><li>to dig</li></ol>
kalilahan	<i>noun</i><br><ol><li>readiness</li><li>willingness</li><li>agreement</li></ol>
kalomaan	<i>noun</i><br><ol><li>familiar association</li><li>intimacy</li></ol>
kalonggaran	<i>noun</i><br><ol><li>scope</li><li>margin</li><li>latitude</li><li>have give</li><li>allow possibility</li><li>opportunity to something</li><li>facility</li></ol>
kaludeungan	<i>noun</i><br><ol><li>boldness</li><li>intrepidness</li><li>undauntedness</li></ol>
kaluginaan	<i>noun</i><br><ol><li>state of order</li><li>security</li><li>tranquility</li><li>calm</li></ol>
kaluhungan	<i>noun</i><br><ol><li>elevation</li><li>sublimity</li><li>loftiness</li><li>greatness</li><li>magnitude</li></ol>
kalulusan	<i>noun</i><br><ol><li>durability</li><li>constancy</li><li>prosperity</li><li>good understanding</li></ol>
kalumrahan	<i>noun</i><br><ol><li>custom</li></ol>
kaluén	<i>noun</i><br><ol><li>hunger</li></ol>
kamalaratan	<i>noun</i><br><ol><li>poverty</li></ol>
kamampuhan	<i>noun</i><br><ol><li>ability</li><li>power</li><li>influence</li></ol>
kamarang	<i>noun</i><br><ol><li>kind of small wasp</li></ol>
kamashuran	<i>noun</i><br><ol><li>fame</li></ol>
kamatihan	<i>noun</i><br><ol><li>efficiency</li><li>effectiveness</li><li>potency</li><li>exceptional ability</li></ol>
kambang	<i>romanization</i><br><ol><li>Romanization of ᮊᮙ᮪ᮘᮀ</li></ol>
kameditan	<i>noun</i><br><ol><li>avarice</li><li>miserliness</li></ol>
kamekaran	<i>noun</i><br><ol><li>development</li></ol>
kamelang	<i>noun</i><br><ol><li>anxiety</li><li>apprehension</li><li>concern</li></ol>
kamelidan	<i>noun</i><br><ol><li>lazyness</li></ol>
kamerdikaan	<i>noun</i><br><ol><li>freedom</li><li>independence</li></ol>
kameumeut	<i>noun</i><br><ol><li>sweetheart</li><li>favourite</li></ol>
kamicikan	<i>noun</i><br><ol><li>stinginess</li><li>miserliness</li></ol>
kamonésan	<i>noun</i><br><ol><li>curiosity</li><li>interesting sight</li><li>special or unusual exhibition</li><li>performance or spectacle</li><li>niceness</li></ol>
kancana	<i>romanization</i><br><ol><li>Romanization of ᮊᮔ᮪ᮎᮔ</li></ol>
kandaraan	<i>noun</i><br><ol><li>vehicle</li></ol>
kandel	<i>adj</i><br><ol><li>thick (of objects, stripe, hair, etc.)</li><li>solid</li><li>sound</li><li>having a high carrying-capacity</li><li>strong (in belief, confidence, etc.)</li></ol>
kandul	<i>adj</i><br><ol><li>lazy</li></ol>
kantor	<i>romanization</i><br><ol><li>Romanization of ᮊᮔ᮪ᮒᮧᮁ.</li></ol>
kanyaahan	<i>noun</i><br><ol><li>love</li></ol>
kapanujuan	<i>noun</i><br><ol><li>agreement</li></ol>
kapilah	<i>noun</i><br><ol><li>caravan</li></ol>
kapuloan	<i>noun</i><br><ol><li>archipelago</li></ol>
kaput	<i>verb</i><br><ol><li>to sew</li></ol>
kararas	<i>noun</i><br><ol><li>dried banana leaves</li></ol>
karari	<i>noun</i><br><ol><li>dried palm leaves</li></ol>
karawang	<i>adj</i><br><ol><li>full of holes</li></ol>
karniem	<i>noun</i><br><ol><li>geranium</li></ol>
karosaan	<i>noun</i><br><ol><li>power</li><li>strenght</li><li>violence</li></ol>
karoyalan	<i>noun</i><br><ol><li>extravagance</li></ol>
karudetan	<i>noun</i><br><ol><li>dejection</li><li>depression</li><li>discouragement</li><li>distress</li></ol>
karugi	<i>noun</i><br><ol><li>difficulty</li></ol>
karuhun	<i>noun</i><br><ol><li>ancestors</li></ol>
karwat	<i>noun</i><br><ol><li>riding-whip</li><li>hunting-crop</li></ol>
karét	<i>romanization</i><br><ol><li>Romanization of ᮊᮛᮦᮒ᮪</li></ol>
kasang tukang	<i>noun</i><br><ol><li>background</li></ol>
kastroli	<i>noun</i><br><ol><li>castor oil</li></ol>
kasumpegan	<i>noun</i><br><ol><li>oppression</li></ol>
kasur	<i>romanization</i><br><ol><li>Romanization of ᮊᮞᮥᮁ</li></ol>
katalingeuhan	<i>noun</i><br><ol><li>carelessness</li><li>stupidity</li></ol>
kateululusan	<i>noun</i><br><ol><li>adversity</li><li>ill-luck</li><li>tribulation</li></ol>
kateusaluyuan	<i>noun</i><br><ol><li>disharmony</li><li>discord</li><li>disagreement</li><li>dissent</li><li>disunity</li></ol>
katumbiri	<i>noun</i><br><ol><li>rainbow</li></ol>
kawih	<i>romanization</i><br><ol><li>Romanization of ᮊᮝᮤᮂ</li></ol>
kawoyang	<i>noun</i><br><ol><li>the plant Prunus grisea</li></ol>
kaéstuan	<i>noun</i><br><ol><li>truth</li><li>veracity</li></ol>
kebat	<i>verb</i><br><ol><li>go on (uninterrupted)</li><li>continue</li><li>go on (walk etc.) for a stretch</li></ol><br><i>conj</i><br><ol><li>then</li><li>further</li><li>thereupon</li></ol>
kecap	<i>romanization</i><br><ol><li>Romanization of ᮊᮨᮎᮕ᮪</li></ol>
kecap panganteb	<i>noun</i><br><ol><li>emphatic particle</li></ol>
kecap panganteur	<i>noun</i><br><ol><li>anticipator word</li></ol>
kecebek	<i>noun</i><br><ol><li>splashing or lapping sound</li></ol>
keceber	<i>noun</i><br><ol><li>splashing sound</li></ol>
kecebur	<i>noun</i><br><ol><li>plop!</li><li>flop!</li></ol>
kecemplung	<i>verb</i><br><ol><li>splash!</li></ol>
keceplus	<i>noun</i><br><ol><li>the sound of plunging in the water</li></ol>
kecepruk	<i>noun</i><br><ol><li>the sound of stepping on water or mud</li></ol>
kecit	<i>noun</i><br><ol><li>squeaking sound</li></ol>
keclak	<i>noun</i><br><ol><li>drip!</li><li>drop of water</li></ol>
kecrék	<i>noun</i><br><ol><li>jingling sound</li></ol>
kecét	<i>noun</i><br><ol><li>small sound</li></ol>
kedekes	<i>noun</i><br><ol><li>sound of biting on something hard</li></ol>
kedeng	<i>romanization</i><br><ol><li>Romanization of ᮊᮨᮓᮨᮀ</li></ol>
kekebul	<i>romanization</i><br><ol><li>Romanization of ᮊᮨᮊᮨᮘᮥᮜ᮪</li></ol>
kembang	<i>romanization</i><br><ol><li>Romanization of ᮊᮨᮙ᮪ᮘᮀ</li></ol>
kencling	<i>noun</i><br><ol><li>anticipator for : go away</li></ol>
kendang	<i>romanization</i><br><ol><li>Romanization of ᮊᮨᮔ᮪ᮓᮀ</li></ol>
keray	<i>noun</i><br><ol><li>(R.) kind of fish (found in waterholes)</li></ol>
keris	<i>noun</i><br><ol><li>sheathed sharp blade weapon (blades are generally wavy-edged, but there is also straight-edged). This weapon could be both dagger and sword.</li></ol>
kersa	<i>romanization</i><br><ol><li>Romanization of ᮊᮨᮁᮞ</li></ol>
kerud	<i>noun</i><br><ol><li>kind of panther</li></ol>
keueum	<i>verb</i><br><ol><li>stand, sit, or lie in the water</li></ol>
keuheul	<i>adj</i><br><ol><li>annoyed</li><li>displeased</li><li>ruffled</li><li>vexed</li><li>be fed up</li></ol>
keumpleung	<i>adj</i><br><ol><li>silly</li><li>foolish</li><li>cracked</li><li>crazy</li></ol>
keungkang	<i>adj</i><br><ol><li>timid</li><li>diffident</li><li>shy</li><li>timorous</li><li>have fear of failure</li></ol>
keupeul	<i>noun</i><br><ol><li>handful</li></ol>
keusik	<i>romanization</i><br><ol><li>Romanization of ᮊᮩᮞᮤᮊ᮪</li></ol>
keusrak	<i>romanization</i><br><ol><li>Romanization of ᮊᮩᮞᮢᮊ᮪</li></ol>
keyeng	<i>romanization</i><br><ol><li>Romanization of ᮊᮨᮚᮨᮀ</li></ol>
ki ajag	<i>noun</i><br><ol><li>A plant, Ardisia fuliginosa</li></ol>
ki badak	<i>noun</i><br><ol><li>Acer laurinum</li><li>Cyrtophyllum fragrans</li></ol>
ki bako	<i>noun</i><br><ol><li>Tournefortia argentea L.</li></ol>
ki balanak	<i>noun</i><br><ol><li>A type of mangrove, Avicennia officinalis.</li></ol>
ki bangbara	<i>noun</i><br><ol><li>A type of tree, either Vitex quinata or Vitex pinnata</li></ol>
ki banén	<i>noun</i><br><ol><li>A type of tree, Crypteronia paniculata.</li></ol>
ki beusi	<i>noun</i><br><ol><li>Pternandra azurea</li><li>A species of Rhodamnia</li></ol>
ki bodas	<i>noun</i><br><ol><li>Homalium tomentosum</li></ol>
ki buruy	<i>noun</i><br><ol><li>A tree, Pternandra azurea</li></ol>
ki hileud	<i>noun</i><br><ol><li>A type of herb, Anisomeles indica.</li></ol>
ki hitir	<i>noun</i><br><ol><li>kind of herb</li><li>Amomum Hochreutineri Valeton</li></ol>
ki kuya	<i>noun</i><br><ol><li>Aporosa arborea</li><li>Kibara coriacea</li></ol>
ki langit	<i>noun</i><br><ol><li>Polyscias nodosa</li></ol>
ki malaka	<i>noun</i><br><ol><li>Phyllantus Emblica L.</li></ol>
ki manuk	<i>noun</i><br><ol><li>Trietia javanica Bl.</li></ol>
ki oray	<i>noun</i><br><ol><li>Commersonia bartramia (brown kurrajong)</li><li>Andrographis paniculata (green chireta)</li><li>Hibiscus grewiifolius</li><li>Schizolobium excelsum (Brazilian firetree)</li></ol>
ki taleus badak	<i>noun</i><br><ol><li>A type of shrub or tree in the genus Phoebe.</li></ol>
ki tambleg	<i>noun</i><br><ol><li>Sambucus javanica</li><li>name of baobab tree</li></ol>
kiliningan	<i>noun</i><br><ol><li>triangle</li></ol>
kimpel	<i>romanization</i><br><ol><li>Romanization of ᮊᮤᮙ᮪ᮕᮨᮜ᮪</li></ol>
kitu jeung kitu baé	<i>adv</i><br><ol><li>always in the same manner</li><li>it went on just like that</li></ol>
kiwa	<i>romanization</i><br><ol><li>Romanization of ᮊᮤᮝ</li></ol>
koléab	<i>verb</i><br><ol><li>just come up and then disappear again (underwater) (of st. carried away by the current, a drowning person, fish)</li></ol>
koneng	<i>romanization</i><br><ol><li>Misromanization of ᮊᮧᮔᮦᮀ (konéng).</li></ol>
konéng	<i>romanization</i><br><ol><li>Romanization of ᮊᮧᮔᮦᮀ</li></ol>
kopi	<i>romanization</i><br><ol><li>Romanization of ᮊᮧᮕᮤ</li></ol>
kosok	<i>romanization</i><br><ol><li>Romanization of ᮊᮧᮞᮧᮊ᮪</li></ol>
kotok	<i>noun</i><br><ol><li>chook</li></ol>
kucel	<i>romanization</i><br><ol><li>Romanization of ᮊᮥᮎᮨᮜ᮪</li></ol>
kucur	<i>romanization</i><br><ol><li>Romanization of ᮊᮥᮎᮥᮁ</li></ol>
kuda	<i>noun</i><br><ol><li>horse</li></ol>
kujang	<i>noun</i><br><ol><li>A sword-like weapon with the traditional Sundanese characteristic arts.</li></ol><br><i>romanization</i><br><ol><li>Romanization of ᮊᮥᮏᮀ</li></ol>
kuku	<i>romanization</i><br><ol><li>Romanization of ᮊᮥᮊᮥ</li></ol>
kulawu	<i>romanization</i><br><ol><li>Romanization of ᮊᮥᮜᮝᮥ</li></ol>
kulem	<i>romanization</i><br><ol><li>Romanization of ᮊᮥᮜᮨᮙ᮪</li></ol>
kulit	<i>romanization</i><br><ol><li>Romanization of ᮊᮥᮜᮤᮒ᮪</li></ol>
kulkas	<i>romanization</i><br><ol><li>Romanization of ᮊᮥᮜ᮪ᮊᮞ᮪</li></ol>
kumaha	<i>romanization</i><br><ol><li>Romanization of ᮊᮥᮙᮠ</li></ol>
kumbah	<i>romanization</i><br><ol><li>Romanization of ᮊᮥᮙ᮪ᮘᮂ</li></ol>
kumelendang	<i>verb</i><br><ol><li>slowly walk here and there (like grazing cattle)</li><li>saunter</li><li>walk around (on earth)</li><li>(still) live in this (earthly) life</li></ol>
kuyuk	<i>noun</i><br><ol><li>bamboo shoots or young tip of coconut (humbut) which are soaked until soft</li></ol>
kécap	<i>romanization</i><br><ol><li>Romanization of ᮊᮦᮎᮕ᮪</li></ol>
kécu	<i>noun</i><br><ol><li>bandit</li></ol>
kécépék	<i>noun</i><br><ol><li>splashing or spatter sound in water</li></ol>
kéhéd	<i>noun</i><br><ol><li>prick</li><li>penis</li></ol>
kékényos	<i>noun</i><br><ol><li>phiz</li><li>face</li></ol>
kénéh	<i>adv</i><br><ol><li>still</li><li>yet</li></ol>
kérésék	<i>noun</i><br><ol><li>rustling sound</li></ol>
kéréwéd	<i>noun</i><br><ol><li>offal</li></ol>
kéréwéng	<i>noun</i><br><ol><li>a kind of earthen teapot</li></ol>
labuh	<i>romanization</i><br><ol><li>Romanization of ᮜᮘᮥᮂ</li></ol>
ladog	<i>noun</i><br><ol><li>(name for the description the) rhinoceros</li></ol>
laju	<i>romanization</i><br><ol><li>Romanization of ᮜᮏᮥ</li></ol>
laju cahaya	<i>romanization</i><br><ol><li>Romanization of ᮜᮏᮥ ᮎᮠᮚ</li></ol>
lakbok	<i>noun</i><br><ol><li>a kind of evil spirit</li><li>(C.) tiger of an unusual size</li></ol>
lalaki	<i>romanization</i><br><ol><li>Romanization of ᮜᮜᮊᮤ</li></ol>
lalawora	<i>adj</i><br><ol><li>careless</li><li>casual</li><li>heedless</li><li>indifferent</li><li>off-hand</li></ol>
lamur	<i>adj</i><br><ol><li>weak in vision</li><li>cannot see clearly</li></ol>
lanceuk	<i>noun</i><br><ol><li>older brother/sister</li></ol>
landak	<i>romanization</i><br><ol><li>Romanization of ᮜᮔ᮪ᮓᮊ᮪</li></ol>
langit	<i>romanization</i><br><ol><li>Romanization of ᮜᮍᮤᮒ᮪</li></ol>
langlayangan	<i>romanization</i><br><ol><li>Romanization of ᮜᮍᮣᮚᮍᮔ᮪</li></ol>
lasut	<i>verb</i><br><ol><li>miss</li><li>wrong</li><li>not hit</li></ol>
lauk	<i>romanization</i><br><ol><li>Romanization of ᮜᮅᮊ᮪</li></ol>
laut	<i>romanization</i><br><ol><li>Romanization of ᮜᮅᮒ᮪</li></ol>
layangan	<i>romanization</i><br><ol><li>Romanization of ᮜᮚᮍᮔ᮪</li></ol>
layeus	<i>noun</i><br><ol><li>rafter</li></ol>
layur	<i>noun</i><br><ol><li>a long flat marine fish (with pointy head)</li></ol>
lebet	<i>romanization</i><br><ol><li>Romanization of ᮜᮨᮘᮨᮒ᮪</li></ol>
lebu	<i>romanization</i><br><ol><li>Romanization of ᮜᮨᮘᮥ</li></ol>
lecek	<i>romanization</i><br><ol><li>Romanization of ᮜᮨᮎᮨᮊ᮪</li></ol>
ledrek	<i>romanization</i><br><ol><li>Romanization of ᮜᮨᮓᮢᮨᮊ᮪</li></ol>
leleb	<i>adj</i><br><ol><li>intense (of smell, colours); close, fervent, profound (of love, affection); significant, meaningful (of a smile, look); impressive, serious (of disease, of so.'s speech)</li></ol>
lelembut	<i>noun</i><br><ol><li>spirit</li><li>ghost</li></ol>
lelenged	<i>noun</i><br><ol><li>dirt</li><li>scum</li></ol>
lemah	<i>romanization</i><br><ol><li>Romanization of ᮜᮨᮙᮂ</li></ol>
lembut	<i>romanization</i><br><ol><li>Romanization of ᮜᮨᮙ᮪ᮘᮥᮒ᮪</li></ol>
lemes	<i>romanization</i><br><ol><li>Romanization of ᮜᮨᮙᮨᮞ᮪</li></ol>
lempeng	<i>romanization</i><br><ol><li>Romanization of ᮜᮨᮙ᮪ᮕᮨᮀ</li></ol>
lengser	<i>noun</i><br><ol><li>prime minister.</li></ol>
leres	<i>romanization</i><br><ol><li>Romanization of ᮜᮨᮛᮨᮞ᮪</li></ol>
leueut	<i>romanization</i><br><ol><li>Romanization of ᮜᮩᮉᮒ᮪</li></ol>
leuit	<i>noun</i><br><ol><li>rice-barn</li></ol>
leumpang	<i>verb</i><br><ol><li>walk</li><li>go</li><li>go on one's way</li><li>leave</li><li>gone/be out</li></ol>
leungeun	<i>romanization</i><br><ol><li>Romanization of ᮜᮩᮍᮩᮔ᮪</li></ol>
leungkeub	<i>adj</i><br><ol><li>dark, dense (of a forest)</li></ol>
leungsing	<i>noun</i><br><ol><li>leech</li></ol>
leutak	<i>noun</i><br><ol><li>mud</li><li>slime</li><li>mire</li><li>bitumen</li></ol>
leutak panas	<i>noun</i><br><ol><li>lava</li></ol>
leuweung	<i>noun</i><br><ol><li>forest</li><li>jungle</li><li>wilderness</li></ol>
likur	<i>romanization</i><br><ol><li>Romanization of ᮜᮤᮊᮥᮁ</li></ol>
liliwatan	<i>noun</i><br><ol><li>passage</li></ol>
linggirik	<i>noun</i><br><ol><li>high rising physique</li><li>bulky posture</li></ol>
linggis	<i>noun</i><br><ol><li>crowbar</li><li>crow or jemmy</li></ol>
lini	<i>romanization</i><br><ol><li>Romanization of ᮜᮤᮔᮤ</li></ol>
lisah	<i>romanization</i><br><ol><li>Romanization of ᮜᮤᮞᮂ</li></ol>
logam	<i>romanization</i><br><ol><li>Romanization of ᮜᮧᮌᮙ᮪</li></ol>
lolo	<i>romanization</i><br><ol><li>Romanization of ᮜᮧᮜᮧ</li></ol>
lolowong	<i>noun</i><br><ol><li>empty/open space</li><li>airspace</li></ol>
loma	<i>romanization</i><br><ol><li>Romanization of ᮜᮧᮙ</li></ol>
londok	<i>noun</i><br><ol><li>chameleon</li></ol>
luas	<i>romanization</i><br><ol><li>Romanization of ᮜᮥᮃᮞ᮪</li></ol>
ludah	<i>romanization</i><br><ol><li>Romanization of ᮜᮥᮓᮂ</li></ol>
luga	<i>romanization</i><br><ol><li>Romanization of ᮜᮥᮌ</li></ol>
luhur	<i>adj</i><br><ol><li>high</li></ol>
lulun|spelling ᮜᮥᮜᮥᮔ᮪|ᮜᮥᮜᮥᮔ᮪	<i>verb</i><br><ol><li>to be rolled up</li></ol>
lulun samak	<i>noun</i><br><ol><li>a kind of eel</li><li>a kind of evil water spirit</li></ol>
lumut laut	<i>noun</i><br><ol><li>plankton</li></ol>
léat	<i>noun</i><br><ol><li>a kind of freshwater fish</li></ol>
légé	<i>noun</i><br><ol><li>cockchafer</li></ol>
lénggotan	<i>adj</i><br><ol><li>forgetful</li></ol>
léngkob	<i>noun</i><br><ol><li>valley</li></ol>
létah	<i>romanization</i><br><ol><li>Romanization of ᮜᮦᮒᮂ</li></ol>
mabur	<i>verb</i><br><ol><li>to run away, to skulk off; to make off without leave.</li></ol>
madu	<i>romanization</i><br><ol><li>Romanization of ᮙᮓᮥ</li></ol>
magaé	<i>noun</i><br><ol><li>Solonum torvum</li></ol>
maksimeum	<i>noun</i><br><ol><li>maximum</li></ol>
maling	<i>noun</i><br><ol><li>thief</li></ol>
mambang	<i>noun</i><br><ol><li>kind of divine being, fairy</li></ol>
manah	<i>romanization</i><br><ol><li>Romanization of ᮙᮔᮂ</li></ol>
mang	<i>noun</i><br><ol><li>uncle (form of address to a man by young people or children)</li></ol>
manggu	<i>romanization</i><br><ol><li>Romanization of ᮙᮀᮌᮥ</li></ol>
mangplang	<i>adj</i><br><ol><li>stretching far and wide (e.g. of water, the sea)</li></ol>
mangréa-réa	<i>adv</i><br><ol><li>in great numbers</li></ol>
mangsa harita	<i>adv</i><br><ol><li>at the time</li></ol>
mangsar-mingsir	<i>adj</i><br><ol><li>afraid, scared</li></ol>
mantéga	<i>romanization</i><br><ol><li>Romanization of ᮙᮔ᮪ᮒᮦᮌ</li></ol>
manuk	<i>noun</i><br><ol><li>bird</li></ol>
manusa|manusa|ᮙᮔᮥᮞ	<i>adj</i><br><ol><li>having human qualities</li></ol><br><i>noun</i><br><ol><li>human</li><li>man</li></ol>
manèh	<i>pron</i><br><ol><li>you</li></ol>
maranehna	<i>romanization</i><br><ol><li>Romanization of ᮙᮛᮔᮨᮂᮔ</li></ol>
maranèh	<i>pron</i><br><ol><li>you (plural)</li></ol>
maranèhna	<i>pron</i><br><ol><li>they, them</li></ol>
marcapada	<i>romanization</i><br><ol><li>Romanization of ᮙᮁᮎᮕᮓ</li></ol>
mareuman	<i>romanization</i><br><ol><li>Romanization of ᮙᮛᮩᮙᮔ᮪</li></ol>
margi	<i>romanization</i><br><ol><li>Romanization of ᮙᮁᮌᮤ</li></ol>
marhaén	<i>noun</i><br><ol><li>proletariat</li></ol>
maruta	<i>romanization</i><br><ol><li>Romanization of ᮙᮛᮥᮒ</li></ol>
masigit	<i>noun</i><br><ol><li>mosque</li></ol>
mastaka	<i>noun</i><br><ol><li>head</li></ol>
matak keuheul	<i>noun</i><br><ol><li>annoying</li><li>exasperating</li><li>irksome</li><li>tiresome</li><li>fed up to the back teeth</li></ol>
mayakpak	<i>verb</i><br><ol><li>stretched over a great distance (of a like, water on a rice-field, a city that is spread out down below, an army spread out over a flat terrain, etc.)</li></ol>
mayor	<i>noun</i><br><ol><li>picnic</li></ol>
mega	<i>romanization</i><br><ol><li>Romanization of ᮙᮦᮌ (cloud)</li></ol>
meleg-meleg	<i>adj</i><br><ol><li>extraordinarily big amount</li><li>in plentitude</li></ol>
mentrung	<i>noun</i><br><ol><li>hilltop</li><li>mountain top</li></ol>
mentud	<i>romanization</i><br><ol><li>Romanization of ᮙᮨᮔ᮪ᮒᮥᮓ᮪</li></ol>
meri	<i>noun</i><br><ol><li>duck</li><li>teal</li></ol>
mesin	<i>romanization</i><br><ol><li>Romanization of ᮙᮨᮞᮤᮔ᮪</li></ol>
mesin teang	<i>romanization</i><br><ol><li>Romanization of ᮙᮨᮞᮤᮔ᮪ ᮒᮨᮃᮀ</li></ol>
mesin tik	<i>romanization</i><br><ol><li>Romanization of ᮙᮨᮞᮤᮔ᮪ ᮒᮤᮊ᮪</li></ol>
meuleuneu	<i>adj</i><br><ol><li>neat, well-kept, tidy, clean (of a house)</li></ol>
meurit	<i>noun</i><br><ol><li>bacillus</li><li>bacteria</li><li>maggot</li><li>grub</li><li>the larvae where maggots come from</li></ol>
mikaceuceub	<i>verb</i><br><ol><li>to hate</li><li>to abhor</li><li>to loathe</li></ol>
mikageuleuh	<i>verb</i><br><ol><li>to abhor</li><li>to hate</li></ol>
mikagiruk	<i>verb</i><br><ol><li>to abhor</li><li>to detest</li><li>to loathe</li></ol>
mincrak	<i>adj</i><br><ol><li>move excitedly (during playing, etc.)</li></ol>
minyak	<i>romanization</i><br><ol><li>Romanization of ᮙᮤᮑᮊ᮪</li></ol>
miriksil	<i>adj</i><br><ol><li>frequent, continuous</li></ol>
mites	<i>romanization</i><br><ol><li>Romanization of ᮙᮤᮒᮨᮞ᮪</li></ol>
mokia	<i>romanization</i><br><ol><li>Romanization of ᮙᮧᮊᮤᮃ</li></ol>
momok	<i>noun</i><br><ol><li>Romanization of ᮙᮧᮙᮧᮊ᮪</li></ol>
momotan	<i>noun</i><br><ol><li>freight</li><li>cargo</li><li>load</li></ol>
munding	<i>romanization</i><br><ol><li>Romanization of ᮙᮥᮔ᮪ᮓᮤᮀ</li></ol>
mupus	<i>romanization</i><br><ol><li>Romanization of ᮙᮥᮕᮥᮞ᮪</li></ol>
murangkalih	<i>romanization</i><br><ol><li>Romanization of ᮙᮥᮛᮀᮊᮜᮤᮂ</li></ol>
muruy	<i>verb</i><br><ol><li>to be reflected in the water</li></ol>
méga	<i>romanization</i><br><ol><li>Romanization of ᮙᮦᮌ</li></ol>
méong	<i>noun</i><br><ol><li>tiger</li><li>panther</li><li>domestic cat</li></ol>
mérékététét	<i>adj</i><br><ol><li>stunted, not growing, remain small (of plants)</li></ol>
nalian	<i>romanization</i><br><ol><li>Romanization of ᮔᮜᮤᮃᮔ᮪</li></ol>
nami	<i>noun</i><br><ol><li>name</li></ol>
nanging	<i>conj</i><br><ol><li>but</li><li>however</li></ol>
nangkarak	<i>verb</i><br><ol><li>to lie on one's back</li></ol>
naon	<i>romanization</i><br><ol><li>Romanization of ᮔᮇᮔ᮪</li></ol>
nataku	<i>adv</i><br><ol><li>extremely</li><li>peculiarly</li><li>terribly</li></ol>
nerengteng	<i>verb</i><br><ol><li>walk with quick steps</li><li>proceed quickly ( also fig. with ref. to handling a subject etc.)</li></ol>
ngabagug	<i>verb</i><br><ol><li>sit or stand unmoving (e.g. of a dog, of a people, somewhat course)</li><li>stand still unmoving (e.g. of a broken down vehicle)</li><li>stand ready (of dishes on the table etc. )</li></ol>
ngaberengbeng	<i>verb</i><br><ol><li>to run (away)</li><li>to take to one's heel</li></ol>
ngabiur	<i>verb</i><br><ol><li>to fly away</li><li>to jump away</li><li>to run away fast</li><li>to sail away fast</li></ol>
ngaburisat	<i>verb</i><br><ol><li>fly away</li><li>flee in all directions</li></ol>
ngadon	<i>verb</i><br><ol><li>come to do something somewhere (outside one's house/ home town or country)</li><li>set out to do something</li></ol>
ngafungsikeun	<i>romanization</i><br><ol><li>Romanization of ᮍᮖᮥᮀᮞᮤᮊᮩᮔ᮪</li></ol>
ngagayuh	<i>verb</i><br><ol><li>call up ( spirits,animals,natural phenomena like wind and rain etc. with wich to gain something or work on something for oneself: using wild boars to destroy the competitor's crops, a tiger that one wants to catch in a set trap,etc) through magic means ( by incantation)</li></ol>
ngagiggig	<i>verb</i><br><ol><li>to giggle</li></ol>
ngagiridig	<i>verb</i><br><ol><li>walk with a quick pace</li><li>walk (on) in haste</li></ol>
ngagonyok	<i>verb</i><br><ol><li>close together ( of people animals, e.g. ants on sugar, also of flowers, stars )</li><li>gather close together with/around someone/something</li></ol>
ngahibas	<i>verb</i><br><ol><li>reach</li></ol>
ngahurungkeun	<i>romanization</i><br><ol><li>Romanization of ᮍᮠᮥᮛᮥᮀᮊᮩᮔ᮪</li></ol>
ngajojo	<i>verb</i><br><ol><li>choose something as target</li><li>go (straight) at someone/something</li><li>see someone/something with certain intention</li></ol>
ngajolopong	<i>verb</i><br><ol><li>lie stretched out lenghtwise (of people, big animals, or objects)</li></ol>
ngajungkiring	<i>verb</i><br><ol><li>have a clearly visible shape or form (esp. because of its huge size, e.g. a huge mountain)</li><li>conspicuous through external shape (big size etc.; e.g. of big buildings, huge animals)</li></ol>
ngaktipkeun	<i>romanization</i><br><ol><li>Romanization of ᮍᮊ᮪ᮒᮤᮕ᮪ᮊᮩᮔ᮪</li></ol>
ngalawan	<i>verb</i><br><ol><li>to offer resistance</li><li>to go against</li><li>to resist</li></ol>
ngaleketey	<i>verb</i><br><ol><li>slowly sink ( like the ground in an earthquake)</li><li>slide slowly from his place</li><li>bend</li><li>give away ( like a small tree when climbed on )</li><li>yield</li></ol>
ngalénghoy	<i>verb</i><br><ol><li>move slowly ( of someone who walks, a swimming fish, a slithering snake)</li></ol>
ngaléong	<i>verb</i><br><ol><li>float along with the current</li><li>soar along</li><li>move with light gait/pace (of people, vehicles)</li><li>go on his way with light tread</li></ol>
ngaléos	<i>verb</i><br><ol><li>go away (esp. quietly, without notice,etc.)</li><li>run away</li><li>clear off</li><li>shoot through</li><li>disappear</li></ol>
ngamanah	<i>romanization</i><br><ol><li>Romanization of ᮍᮙᮔᮂ</li></ol>
ngampih	<i>verb</i><br><ol><li>retreat (in one's house,bedroom, in the campus,etc.)</li><li>(when it gets dark) go in (esp. children who are playing outdoors etc., also of animal that go in the pen or corral at nights)</li><li>(of hens) go to roost</li></ol>
ngampihan	<i>verb</i><br><ol><li>to put away</li><li>to store</li><li>to save</li></ol>
ngangkleung	<i>verb</i><br><ol><li>floating along bobbing up and down ( of a boat on the waves, a drowning person,etc.)</li><li>pitch (of a ship)</li></ol>
nganjor	<i>verb</i><br><ol><li>come to do something somewhere</li></ol>
nganonaktipkeun	<i>romanization</i><br><ol><li>Romanization of ᮍᮔᮧᮔᮊ᮪ᮒᮤᮕ᮪ᮊᮩᮔ᮪</li></ol>
ngantebkeun	<i>verb</i><br><ol><li>to intensify</li><li>to deepen (feelings etc.)</li><li>to put emphasis on</li><li>to bring to the front (a word etc.)</li></ol>
ngaplak	<i>verb</i><br><ol><li>stretch wide ( of a stretch of water, rice-field complex, open field, etc.)</li></ol>
ngapung	<i>romanization</i><br><ol><li>Romanization of ᮍᮕᮥᮀ</li></ol>
ngaran	<i>romanization</i><br><ol><li>Romanization of ᮍᮛᮔ᮪</li></ol>
ngarenggenek	<i>verb</i><br><ol><li>loom up in the distance</li><li>stand out against the surroundings (of tall trees, mountains, village,etc.)</li></ol>
ngareureuh	<i>verb</i><br><ol><li>to take a rest</li><li>to have rest</li></ol>
ngaringkang	<i>verb</i><br><ol><li>to walk somewhere</li><li>go by</li></ol>
ngawaskeun	<i>verb</i><br><ol><li>to look at closely</li><li>to watch closely</li></ol>
ngelemeng	<i>verb</i><br><ol><li>be faintly or vaguely visible ( like the light of the moon through the clouds, a fish under the water's surface)</li><li>loom (up) (also fig. of something where prospects are possible)</li></ol>
ngelesed	<i>verb</i><br><ol><li>slowly move (somewhat) (esp. of someone who is sitting on the ground)</li><li>quietly or stealthily go away (so that no one sees or is troubled by it)</li><li>take French leave</li></ol>
ngeungah	<i>adv</i><br><ol><li>very</li><li>extremely</li><li>excessively</li></ol>
ngeureuyeuh	<i>verb</i><br><ol><li>(just) proceed slowly (inrelation to weakness, bad condition of the road, etc.)</li><li>continue something step by step</li><li>do something little by little</li><li>work on something steadily and safely (ie. slowly but surely)</li><li>push on (even if it is slow)</li></ol>
ngojai	<i>romanization</i><br><ol><li>Romanization of ᮍᮧᮏᮄ</li></ol>
ngoloyong	<i>verb</i><br><ol><li>walk staggering or tottering (of so. who is dizzy or drunk)</li><li>stroll</li></ol>
ngoléang	<i>verb</i><br><ol><li>float (of clouds, a kite , birds, dry leaves)</li><li>move buoyantly (also of persons who walk with a light springy tread)</li></ol>
ngumbah	<i>verb</i><br><ol><li>to wash (clothes)</li></ol>
nini antéh	<i>noun</i><br><ol><li>similar to man in the moon</li></ol>
norolong	<i>verb</i><br><ol><li>walk quickly (without standing still, stumbling,etc.)</li><li>(of a horse etc.) at an amble</li><li>speak (read aloud, recite, etc.) fluently (without hesitation or interruption)</li></ol>
nu tatabeuhan	<i>noun</i><br><ol><li>musicians</li></ol>
nusa	<i>noun</i><br><ol><li>island (area of land completely surrounded by water)</li></ol>
nyana	<i>romanization</i><br><ol><li>Romanization of ᮑᮔ</li></ol>
nyangheuy	<i>verb</i><br><ol><li>sit or lie face down (with the chin supported on the table or pillow)</li></ol>
nyaracalan	<i>verb</i><br><ol><li>(come to) lie scattered (eg. of objects on the table, of isolated houses, grains of rice dropping out of a sack during transportation)</li></ol>
nyorang	<i>verb</i><br><ol><li>go over (a road, bridge, sea)</li><li>go through (forest, land)</li><li>commit (mistake, crime)</li><li>transgress (prohibition)</li><li>pass through (misery, grief, disaster, calamity, a period of drought)</li><li>experience</li><li>live to see</li></ol>
nyoréang	<i>verb</i><br><ol><li>look over your shoulder</li><li>turn to look (back)</li><li>turn the head (and look) at someone or something</li></ol>
ongkék	<i>verb</i><br><ol><li>vomit</li></ol>
ontohod	<i>noun</i><br><ol><li>bear</li></ol>
opat	<i>num</i><br><ol><li>four</li></ol>
oray	<i>romanization</i><br><ol><li>Romanization of ᮇᮛᮚ᮪</li></ol>
oray matih	<i>noun</i><br><ol><li>poison snake</li></ol>
orok	<i>romanization</i><br><ol><li>Romanization of ᮇᮛᮧᮊ᮪</li></ol>
orowodol	<i>adj</i><br><ol><li>careless</li><li>frivolous</li><li>shoddy</li><li>loosely tied;</li><li>(dialect) a kind of spirit</li></ol>
otot	<i>romanization</i><br><ol><li>Romanization of ᮇᮒᮧᮒ᮪</li></ol>
otét	<i>romanization</i><br><ol><li>Romanization of ᮇᮒᮦᮒ᮪</li></ol>
oyag	<i>verb</i><br><ol><li>shake</li><li>stagger</li><li>swaying</li><li>totter</li><li>create a sensation</li><li>cause a stir</li></ol>
paburisat	<i>verb</i><br><ol><li>disintegrate</li><li>fall apart</li><li>fly apart</li><li>scatter ( of people, also of a pile firewood etc.)</li><li>flee in all directions</li></ol>
padaharan	<i>noun</i><br><ol><li>stomach</li></ol>
padayangan	<i>noun</i><br><ol><li>brothel</li></ol>
padoman	<i>noun</i><br><ol><li>compass</li></ol>
pagarayu	<i>romanization</i><br><ol><li>Romanization of ᮕᮌᮛᮚᮥ</li></ol>
paguyuban	<i>noun</i><br><ol><li>association</li><li>union</li><li>partnership</li><li>company</li></ol>
pahoman	<i>noun</i><br><ol><li>gathering place for spirits</li></ol>
pakarang	<i>romanization</i><br><ol><li>Romanization of ᮕᮊᮛᮀ</li></ol>
pakasaban	<i>noun</i><br><ol><li>trade</li><li>business</li><li>occupation</li></ol>
pakuan	<i>noun</i><br><ol><li>lair of tiger in the wilderness</li></ol>
pakuburan	<i>noun</i><br><ol><li>cemetery</li></ol>
pakéan	<i>noun</i><br><ol><li>article of dress</li><li>clothes</li><li>costume</li><li>uniform</li></ol>
pala gumantung	<i>noun</i><br><ol><li>hanging fruit, ie. tree fruit</li></ol>
palalangon	<i>noun</i><br><ol><li>a small watch-tower (on the field or at the edge of the forest as an observation post in hunting)</li></ol>
palintangan	<i>noun</i><br><ol><li>astronomy</li><li>astrological (divination)</li></ol>
pamanggul	<i>noun</i><br><ol><li>leader</li><li>commander</li></ol>
pamangkring	<i>noun</i><br><ol><li>control</li></ol>
pamangloh	<i>noun</i><br><ol><li>remarks</li><li>reproach</li><li>blame</li></ol>
pameget	<i>romanization</i><br><ol><li>Romanization of ᮕᮙᮨᮌᮨᮒ᮪</li></ol>
pamelidan	<i>noun</i><br><ol><li>lazybone</li></ol>
pameuleuman	<i>noun</i><br><ol><li>oven</li><li>grill</li></ol>
pamilih	<i>noun</i><br><ol><li>discrimination</li><li>discernment</li><li>judicious choice</li><li>(good) taste</li></ol>
pamohalan	<i>noun</i><br><ol><li>an imposibble matter</li><li>absurdity</li><li>nonsense</li></ol>
pamoroan	<i>noun</i><br><ol><li>hunting ground</li><li>hunting place</li></ol>
pamulu	<i>noun</i><br><ol><li>facial features</li><li>facial expression</li></ol>
pamupus	<i>romanization</i><br><ol><li>Romanization of ᮕᮙᮥᮕᮥᮞ᮪</li></ol>
paméré	<i>noun</i><br><ol><li>gift</li><li>present</li></ol>
panandasa	<i>noun</i><br><ol><li>mistreatment</li><li>oppression</li></ol>
panangan	<i>romanization</i><br><ol><li>Romanization of ᮕᮔᮍᮔ᮪</li></ol>
panarajang	<i>noun</i><br><ol><li>attack</li></ol>
panas	<i>romanization</i><br><ol><li>Romanization of ᮕᮔᮞ᮪</li></ol>
pancalongok	<i>noun</i><br><ol><li>peeping Tom (nickname for thieves, burglas)</li></ol>
panepak	<i>noun</i><br><ol><li>(flat) object to hit with</li><li>bat ( in cricket, baseball)</li><li>racket</li><li>swatter (to kill flies)</li></ol>
pangambung	<i>romanization</i><br><ol><li>Romanization of ᮕᮍᮙ᮪ᮘᮥᮀ</li></ol>
pangan	<i>romanization</i><br><ol><li>Romanization of ᮕᮍᮔ᮪</li></ol>
panganjangan	<i>noun</i><br><ol><li>meeting place</li><li>rendezvous</li></ol>
panganteb	<i>noun</i><br><ol><li>intensification</li></ol>
pangapungan	<i>noun</i><br><ol><li>airfield</li></ol>
pangarang	<i>noun</i><br><ol><li>writer</li><li>author</li></ol>
pangarep-ngarep	<i>noun</i><br><ol><li>expectation</li><li>hope</li></ol>
pangaturan	<i>noun</i><br><ol><li>regulation</li><li>arrangement</li><li>planning</li></ol>
pangauban	<i>noun</i><br><ol><li>refuge</li><li>shelter</li><li>protector</li></ol>
pangawakan	<i>noun</i><br><ol><li>figure</li><li>stature</li><li>size</li><li>build</li></ol>
pangbedo	<i>noun</i><br><ol><li>annulment</li><li>nullification</li><li>break off</li></ol>
pangdorong	<i>noun</i><br><ol><li>stimulation</li></ol>
pangduum	<i>noun</i><br><ol><li>distribution</li></ol>
pangeusi	<i>noun</i><br><ol><li>filler</li><li>contents</li><li>population</li><li>inhabitants</li></ol>
panggelendeng	<i>noun</i><br><ol><li>grumbling</li></ol>
panghulu agung	<i>noun</i><br><ol><li>(Israelite) high priest</li></ol>
pangicuk-icuk	<i>noun</i><br><ol><li>incitement</li><li>instigation</li></ol>
panglabrak	<i>noun</i><br><ol><li>rage</li><li>grumble</li></ol>
panglacuran	<i>noun</i><br><ol><li>fornicator</li></ol>
panglajer	<i>noun</i><br><ol><li>support</li><li>defender</li><li>protector</li><li>preserver</li></ol>
panglelekan	<i>noun</i><br><ol><li>interrogation</li></ol>
pangleumpangan	<i>noun</i><br><ol><li>journey</li><li>trip</li></ol>
pangliaran	<i>noun</i><br><ol><li>place where wild animals/evil spirit roam</li></ol>
panglicinan	<i>noun</i><br><ol><li>ironer</li></ol>
panglipur	<i>noun</i><br><ol><li>comfort</li><li>consolation</li><li>solace</li><li>diversion</li><li>comforter</li></ol>
pangperangan	<i>noun</i><br><ol><li>battlefield</li></ol>
pangsét	<i>adj</i><br><ol><li>very salty</li><li>briny</li></ol>
pangwowoy	<i>noun</i><br><ol><li>indulgence</li></ol>
pangwuruk	<i>noun</i><br><ol><li>instruction</li></ol>
pangélingan	<i>noun</i><br><ol><li>admontion</li></ol>
pangémbohan	<i>noun</i><br><ol><li>appendix</li><li>supplement</li></ol>
pangéstu	<i>romanization</i><br><ol><li>Romanization of ᮕᮍᮦᮞ᮪ᮒᮥ</li></ol>
panilik	<i>noun</i><br><ol><li>inspector</li><li>supervisor</li></ol>
panimbang	<i>noun</i><br><ol><li>consideration</li></ol>
panon	<i>noun</i><br><ol><li>eye</li></ol>
panonpoé	<i>romanization</i><br><ol><li>Romanization of ᮕᮔᮧᮔ᮪ᮕᮧᮆ</li></ol>
paos	<i>romanization</i><br><ol><li>Romanization of ᮕᮇᮞ᮪</li></ol>
papagan	<i>romanization</i><br><ol><li>Romanization of ᮕᮕᮌᮔ᮪</li></ol>
papah	<i>romanization</i><br><ol><li>Romanization of ᮕᮕᮂ</li></ol>
papanter	<i>noun</i><br><ol><li>kind of small worm that eats up the core of a young rice plant</li></ol>
papayungan	<i>noun</i><br><ol><li>parachute</li></ol>
parancah	<i>noun</i><br><ol><li>kind of magic formula or charm ( to ward off evil power or harmful influence)</li></ol>
pariuk	<i>noun</i><br><ol><li>pan</li><li>earthen pot</li></ol>
parunggu	<i>romanization</i><br><ol><li>Romanization of ᮕᮛᮥᮀᮌᮥ</li></ol>
parungu	<i>noun</i><br><ol><li>bronze</li></ol>
pasagi	<i>noun</i><br><ol><li>square</li></ol>
pasagi burung	<i>noun</i><br><ol><li>rectangle</li><li>rectangular</li></ol>
pasihan	<i>romanization</i><br><ol><li>Romanization of ᮕᮞᮤᮠᮔ᮪</li></ol>
pasir	<i>romanization</i><br><ol><li>Romanization of ᮕᮞᮤᮁ</li></ol>
pasuratan	<i>noun</i><br><ol><li>postman</li></ol>
patitirahan	<i>noun</i><br><ol><li>sanatorium</li><li>health-resort</li></ol>
patlot	<i>romanization</i><br><ol><li>Romanization of ᮕᮒᮣᮧᮒ᮪</li></ol>
patuangan	<i>romanization</i><br><ol><li>Romanization of ᮕᮒᮥᮃᮍᮔ᮪</li></ol>
patunggon	<i>noun</i><br><ol><li>watchman</li><li>guard</li></ol>
payung	<i>romanization</i><br><ol><li>Romanization of ᮕᮚᮥᮀ</li></ol>
paéh	<i>romanization</i><br><ol><li>Romanization of ᮕᮆᮂ</li></ol>
pepedut	<i>romanization</i><br><ol><li>Romanization of ᮕᮨᮕᮨᮓᮥᮒ᮪</li></ol>
pepelakan	<i>romanization</i><br><ol><li>Romanization of ᮕᮨᮕᮨᮜᮊᮔ᮪</li></ol>
perpustakaan	<i>romanization</i><br><ol><li>Romanization of ᮕᮨᮁᮕᮥᮞ᮪ᮒᮊᮃᮔ᮪</li></ol>
pertokol	<i>noun</i><br><ol><li>protocol</li></ol>
petétan	<i>noun</i><br><ol><li>young plant</li><li>seedling</li></ol>
peucang	<i>noun</i><br><ol><li>chevrotain</li><li>mouse deer</li></ol>
peujit	<i>romanization</i><br><ol><li>Romanization of ᮕᮩᮏᮤᮒ᮪</li></ol>
peupeus	<i>verb</i><br><ol><li>broken</li></ol>
peureum	<i>verb</i><br><ol><li>closed (eyes)</li><li>have the eyes closed</li></ol>
peureup	<i>noun</i><br><ol><li>fist</li></ol>
peuting	<i>noun</i><br><ol><li>the time from sunset to sunrise, dusk, night</li></ol>
pikakeuheuleun	<i>noun</i><br><ol><li>annoying</li><li>exasperating</li><li>irksome</li></ol>
pikalewangeun	<i>noun</i><br><ol><li>horrifying</li><li>terrifying</li></ol>
pinarep	<i>romanization</i><br><ol><li>Romanization of ᮕᮤᮔᮛᮨᮕ᮪</li></ol>
pinuh	<i>romanization</i><br><ol><li>Romanization of ᮕᮤᮔᮥᮂ</li></ol>
piraku	<i>adv</i><br><ol><li>word used to express disbelief, compare Indonesian masa</li></ol>
pites	<i>adj</i><br><ol><li>cracked</li><li>snapped</li><li>crack</li><li>snap</li></ol>
piwelas	<i>noun</i><br><ol><li>compassion</li><li>pity</li></ol>
pohoan	<i>adj</i><br><ol><li>forgetful</li></ol>
pohprol	<i>noun</i><br><ol><li>butt of a rifle</li></ol>
pondok	<i>romanization</i><br><ol><li>Romanization of ᮕᮧᮔ᮪ᮓᮧᮊ᮪</li></ol>
profesor	<i>noun</i><br><ol><li>professor</li></ol>
puhun	<i>noun</i><br><ol><li>tree</li></ol>
pulekan	<i>noun</i><br><ol><li>whirlpool</li></ol>
pulo	<i>noun</i><br><ol><li>island (area of land completely surrounded by water)</li></ol>
pungkur	<i>romanization</i><br><ol><li>Romanization of ᮕᮥᮀᮊᮥᮁ</li></ol>
pupus	<i>verb</i><br><ol><li>to die</li></ol>
purungkul	<i>noun</i><br><ol><li>lump</li><li>clod</li></ol>
puseur	<i>noun</i><br><ol><li>navel</li><li>centre</li></ol>
puseuran	<i>noun</i><br><ol><li>whirlpool</li></ol>
puspa	<i>romanization</i><br><ol><li>Romanization of ᮕᮥᮞ᮪ᮕ</li></ol>
pèlor	<i>noun</i><br><ol><li>bullet</li></ol>
péso	<i>romanization</i><br><ol><li>Romanization of ᮕᮦᮞᮧ</li></ol>
péso cukur	<i>noun</i><br><ol><li>razor</li></ol>
racun	<i>romanization</i><br><ol><li>Romanization of ᮛᮎᮥᮔ᮪</li></ol>
rajeun	<i>adv</i><br><ol><li>every now and then</li><li>time and time again</li></ol>
rakit	<i>romanization</i><br><ol><li>Romanization of ᮛᮊᮤᮒ᮪</li></ol>
rama	<i>romanization</i><br><ol><li>Romanization of ᮛᮙ</li></ol>
ramatkaca	<i>romanization</i><br><ol><li>Romanization of ᮛᮙᮒ᮪ᮊᮎ</li></ol>
ramatloka	<i>romanization</i><br><ol><li>Romanization of ᮛᮙᮒᮣᮧᮊ</li></ol>
rambut	<i>romanization</i><br><ol><li>Romanization of ᮛᮙ᮪ᮘᮥᮒ᮪</li></ol>
rames	<i>romanization</i><br><ol><li>Romanization of ᮛᮙᮨᮞ᮪</li></ol>
rampag	<i>adj</i><br><ol><li>all (almost) equal, as big as long( with ref. to children, plants, acreage); everything all at once, (advance) in close ranks; be public (somewhere), be everywhere</li></ol>
ranggikgik	<i>verb</i><br><ol><li>branching</li><li>spread in all directions (of a lineage)</li></ol>
ranjang	<i>romanization</i><br><ol><li>Romanization of ᮛᮔ᮪ᮏᮀ</li></ol>
rantab	<i>adj</i><br><ol><li>spread in great numbers</li><li>be seen everywhere (e.g. houses in an area)</li></ol>
rarong	<i>noun</i><br><ol><li>young prawn</li></ol>
rateng	<i>adj</i><br><ol><li>(visible somewhere) in big numbers (esp. of lights, also kites)</li></ol>
rentag	<i>adj</i><br><ol><li>anxious</li><li>startled</li><li>shocked</li></ol>
rentang-rentang	<i>adv</i><br><ol><li>(in the distance) vaguely visible ( esp. of someone who is seen approaching in the distance)</li></ol>
rentul	<i>verb</i><br><ol><li>seen in great numbers somewhere (of people congregating together, stones in the backyard, huts in the field during harvest time)</li></ol>
reuay	<i>adj</i><br><ol><li>numerous (of so.'s brood, als of animals</li></ol>
reueuk	<i>romanization</i><br><ol><li>Romanization of ᮛᮩᮉᮊ᮪</li></ol>
reugeujeug	<i>adj</i><br><ol><li>healthy and strong</li><li>fit</li></ol>
reugreug	<i>adj</i><br><ol><li>sturdy</li><li>firm</li><li>tight</li></ol>
reujeung	<i>conj</i><br><ol><li>together with</li><li>as well as</li><li>and</li></ol>
reunceum	<i>adj</i><br><ol><li>fine</li><li>pretty</li><li>decked out</li><li>showy</li></ol>
reureuh	<i>verb</i><br><ol><li>to rest</li><li>to have a rest</li></ol>
reureujeungan	<i>adv</i><br><ol><li>jointly</li><li>collectively</li><li>together</li></ol>
reyem-reyem	<i>adj</i><br><ol><li>between light and darkness</li><li>dim</li><li>dusky</li><li>twilight</li></ol>
riceuw	<i>adj</i><br><ol><li>in disarray</li><li>chaotic</li></ol>
rincang	<i>adj</i><br><ol><li>quick</li></ol>
ringkang-ringkang	<i>noun</i><br><ol><li>a passing figure</li></ol>
rinyuh	<i>romanization</i><br><ol><li>Romanization of ᮛᮤᮑᮥᮂ</li></ol>
ririg	<i>noun</i><br><ol><li>direction</li><li>persuasion</li><li>tendency</li></ol>
ririkipan	<i>adv</i><br><ol><li>stealthily</li><li>secretively</li></ol>
risbang	<i>romanization</i><br><ol><li>Romanization of ᮛᮤᮞ᮪ᮘᮀ</li></ol>
robah	<i>romanization</i><br><ol><li>Romanization of ᮛᮧᮘᮂ</li></ol>
rohangan hapa	<i>romanization</i><br><ol><li>Romanization of ᮛᮧᮠᮍᮔ᮪ ᮠᮕ</li></ol>
rorompok	
rorongkong	<i>noun</i><br><ol><li>skeleton</li></ol>
rubak	<i>romanization</i><br><ol><li>Romanization of ᮛᮥᮘᮊ᮪</li></ol>
rucatan	<i>noun</i><br><ol><li>analysis</li></ol>
ruhay	<i>adj</i><br><ol><li>glowing (of coal, wood,etc.)</li></ol>
rumpil	<i>adj</i><br><ol><li>bad going (of a road), hardly accessible (terrain etc.), difficult (communication between two places); difficult to understand, complicated, obscure (of a theory etc.)</li></ol>
rungkad	<i>verb</i><br><ol><li>uprooted, fall down (of a tree)</li></ol>
rungkang	<i>adj</i><br><ol><li>big</li></ol>
rurusuhan	<i>adv</i><br><ol><li>hastily</li><li>in haste</li></ol>
ruyuk	<i>noun</i><br><ol><li>underwood</li><li>dense thicket</li><li>bush</li></ol>
régang	<i>romanization</i><br><ol><li>Romanization of ᮛᮦᮌᮀ</li></ol>
rékayasa	<i>romanization</i><br><ol><li>Romanization of ᮛᮦᮊᮚᮞ</li></ol>
saab	<i>romanization</i><br><ol><li>Romanization of ᮞᮃᮘ᮪</li></ol>
saat	<i>adj</i><br><ol><li>dry (of something where there was water before)</li><li>dried up (eg. of a riverbed, ditch, pond, rice-field, well, kettle, where the water has evaporated)</li><li>run dry</li><li>dried out (of a cow)</li><li>give no milk (of the breast)</li></ol>
sababaraha	<i>romanization</i><br><ol><li>Romanization of ᮞᮘᮘᮛᮠ</li></ol>
sadaya	<i>romanization</i><br><ol><li>Romanization of ᮞᮓᮚ</li></ol>
saga	<i>noun</i><br><ol><li>jequirity (Abrus precatorius)</li></ol>
sagara	<i>romanization</i><br><ol><li>Romanization of ᮞᮌᮛ</li></ol>
saha	<i>romanization</i><br><ol><li>Romanization of ᮞᮠ</li></ol>
sakali	<i>adv</i><br><ol><li>once</li><li>one time</li><li>for the first time</li><li>(all) at once</li><li>at the same time</li></ol>
sakali ieu	<i>adv</i><br><ol><li>for this once</li><li>this time</li></ol>
sakedik	<i>romanization</i><br><ol><li>Romanization of ᮞᮊᮨᮓᮤᮊ᮪</li></ol>
sakubeng	<i>noun</i><br><ol><li>around (something)</li></ol>
salaki	<i>romanization</i><br><ol><li>Romanization of ᮞᮜᮊᮤ</li></ol>
salju	<i>romanization</i><br><ol><li>Romanization of ᮞᮜ᮪ᮏᮥ</li></ol>
sampeu	<i>romanization</i><br><ol><li>Romanization of ᮞᮙ᮪ᮕᮩ</li></ol>
sampéan	<i>romanization</i><br><ol><li>Romanization of ᮞᮙ᮪ᮕᮦᮃᮔ᮪</li></ol>
sanapang	<i>noun</i><br><ol><li>rifle</li></ol>
sandi asma	<i>noun</i><br><ol><li>pseudonym</li></ol>
sanggama	<i>romanization</i><br><ol><li>Romanization of ᮞᮀᮌᮙ</li></ol>
sangku	<i>noun</i><br><ol><li>bayonet</li></ol>
sangu	<i>romanization</i><br><ol><li>Romanization of ᮞᮍᮥ</li></ol>
sanés	<i>romanization</i><br><ol><li>Romanization of ᮞᮔᮦᮞ᮪</li></ol>
sapi kabiri	<i>noun</i><br><ol><li>ox</li><li>bullock</li></ol>
sareng	<i>romanization</i><br><ol><li>Romanization of ᮞᮛᮨᮀ</li></ol>
sarta	<i>romanization</i><br><ol><li>Romanization of ᮞᮁᮒ</li></ol>
sarung	<i>noun</i><br><ol><li>sarong (garment made of batik or ikat cloth wrapped about the waist)</li><li>sheath (sheath for traditional Sundanese weapon (usually kujang, kris, etc.))</li></ol>
sasak	<i>romanization</i><br><ol><li>Romanization of ᮞᮞᮊ᮪</li></ol>
sasak angkat	<i>romanization</i><br><ol><li>Romanization of ᮞᮞᮊ᮪ ᮃᮀᮊᮒ᮪</li></ol>
sasak gantung	<i>romanization</i><br><ol><li>Romanization of ᮞᮞᮊ᮪ ᮌᮔ᮪ᮒᮥᮀ</li></ol>
sasak gerak	<i>romanization</i><br><ol><li>Romanization of ᮞᮞᮊ᮪ ᮌᮨᮛᮊ᮪</li></ol>
sasak kabel	<i>romanization</i><br><ol><li>Romanization of ᮞᮞᮊ᮪ ᮊᮘᮨᮜ᮪</li></ol>
sasak lengkung	<i>romanization</i><br><ol><li>Romanization of ᮞᮞᮊ᮪ ᮜᮨᮀᮊᮥᮀ</li></ol>
sasak malang	<i>romanization</i><br><ol><li>Romanization of ᮞᮞᮊ᮪ ᮙᮜᮀ</li></ol>
sasak pananggeuy	<i>romanization</i><br><ol><li>Romanization of ᮞᮞᮊ᮪ ᮕᮔᮀᮌᮩᮚ᮪</li></ol>
sasak rorongkong	<i>romanization</i><br><ol><li>Romanization of ᮞᮞᮊ᮪ ᮛᮧᮛᮧᮀᮊᮧᮀ</li></ol>
sasak tangkal kai	<i>romanization</i><br><ol><li>Romanization of ᮞᮞᮊ᮪ ᮒᮀᮊᮜ᮪ ᮊᮄ</li></ol>
sasih	<i>romanization</i><br><ol><li>Romanization of ᮞᮞᮤᮂ</li></ol>
sato	<i>romanization</i><br><ol><li>Romanization of ᮞᮒᮧ</li></ol>
satru	<i>noun</i><br><ol><li>enemy</li><li>foe</li><li>rival</li></ol>
saung	<i>noun</i><br><ol><li>shelter</li></ol>
sawah	<i>noun</i><br><ol><li>irrigated rice field</li></ol><br><i>romanization</i><br><ol><li>Romanization of ᮞᮝᮂ</li></ol>
saé	<i>romanization</i><br><ol><li>Romanization of ᮞᮆ</li></ol>
sebér	<i>romanization</i><br><ol><li>Romanization of ᮞᮨᮘᮦᮁ</li></ol>
semu biru	<i>adj</i><br><ol><li>bluish</li></ol>
sepuh	<i>romanization</i><br><ol><li>Romanization of ᮞᮨᮕᮥᮂ</li></ol>
serangga	<i>romanization</i><br><ol><li>Romanization of ᮞᮨᮛᮀᮌ</li></ol>
seueur	<i>romanization</i><br><ol><li>Romanization of ᮞᮩᮉᮁ</li></ol>
seukeut	<i>romanization</i><br><ol><li>Romanization of ᮞᮩᮊᮩᮒ᮪</li></ol>
seuneu	<i>romanization</i><br><ol><li>Romanization of ᮞᮩᮔᮩ</li></ol>
seuseup	<i>romanization</i><br><ol><li>Romanization of ᮞᮩᮞᮩᮕ᮪</li></ol>
sidéngklak	<i>verb</i><br><ol><li>straddle</li></ol>
siki	<i>romanization</i><br><ol><li>Romanization of ᮞᮤᮊᮤ</li></ol>
simbut	<i>romanization</i><br><ol><li>Romanization of ᮞᮤᮙ᮪ᮘᮥᮒ᮪</li></ol>
sinapang	<i>noun</i><br><ol><li>rifle</li></ol>
sindir	<i>romanization</i><br><ol><li>Romanization of ᮞᮤᮔ᮪ᮓᮤᮁ</li></ol>
sirah	<i>romanization</i><br><ol><li>romanization of Swahili ᮞᮤᮛᮂ (“head”)</li></ol>
sireum	<i>noun</i><br><ol><li>ant</li></ol>
sisindiran	<i>romanization</i><br><ol><li>Romanization of ᮞᮤᮞᮤᮔ᮪ᮓᮤᮛᮔ᮪</li></ol>
sisir	<i>romanization</i><br><ol><li>Romanization of ᮞᮤᮞᮤᮁ</li></ol>
situ	<i>romanization</i><br><ol><li>Romanization of ᮞᮤᮒᮥ</li></ol>
soang	<i>noun</i><br><ol><li>swan, goose</li></ol>
soca	<i>noun</i><br><ol><li>eye</li></ol>
sorong	<i>romanization</i><br><ol><li>Romanization of ᮞᮧᮛᮧᮀ</li></ol>
spésiés	<i>romanization</i><br><ol><li>Romanization of ᮞ᮪ᮕᮦᮞᮤᮆᮞ᮪</li></ol>
suhu	<i>romanization</i><br><ol><li>Romanization of ᮞᮥᮠᮥ</li></ol>
suhun	<i>romanization</i><br><ol><li>Romanization of ᮞᮥᮠᮥᮔ᮪</li></ol>
suku	<i>romanization</i><br><ol><li>Romanization of ᮞᮥᮊᮥ</li></ol>
suluh	<i>romanization</i><br><ol><li>Romanization of ᮞᮥᮜᮥᮂ</li></ol>
sumindal	<i>noun</i><br><ol><li>cockroach</li></ol>
sumping	<i>romanization</i><br><ol><li>Romanization of ᮞᮥᮙ᮪ᮕᮤᮀ</li></ol>
supa limar	<i>noun</i><br><ol><li>phosphorescent forest mushroom</li></ol>
surélék	<i>romanization</i><br><ol><li>Romanization of ᮞᮥᮛᮦᮜᮦᮊ᮪</li></ol>
suster baseuh	<i>romanization</i><br><ol><li>Romanization of ᮞᮥᮞ᮪ᮒᮨᮁ ᮘᮞᮩᮂ</li></ol>
susuduk	<i>verb</i><br><ol><li>to inflict a stab with a weapon</li></ol><br><i>noun</i><br><ol><li>stabbing weapon</li></ol>
susukan	<i>romanization</i><br><ol><li>Romanization of ᮞᮥᮞᮥᮊᮔ᮪</li></ol>
suwita	<i>noun</i><br><ol><li>servant</li><li>serve</li></ol>
suyuk	<i>verb</i><br><ol><li>run aslant (of a roof)</li><li>(walk) with the head bowed to the ground</li></ol>
séjén	<i>romanization</i><br><ol><li>Romanization of ᮞᮦᮏᮦᮔ᮪</li></ol>
séndok	<i>romanization</i><br><ol><li>Romanization of ᮞᮦᮔ᮪ᮓᮧᮊ᮪</li></ol>
sénti	<i>noun</i><br><ol><li>centimetre</li></ol>
taak	<i>romanization</i><br><ol><li>Romanization of ᮒᮃᮊ᮪</li></ol>
talaga	<i>romanization</i><br><ol><li>Romanization of ᮒᮜᮌ</li></ol>
talawa	<i>noun</i><br><ol><li>tub</li><li>through</li></ol>
taleus	<i>noun</i><br><ol><li>yam</li></ol>
talingkup	<i>noun</i><br><ol><li>Claoxylon indicum</li></ol>
tambela	<i>noun</i><br><ol><li>coffin</li></ol>
tamblegan	<i>noun</i><br><ol><li>dike</li></ol>
tamiang	<i>noun</i><br><ol><li>Bambusa Wrayi Stapf</li></ol>
tampolong	<i>romanization</i><br><ol><li>Romanization of ᮒᮙ᮪ᮕᮧᮜᮧᮀ</li></ol>
taméng	<i>noun</i><br><ol><li>shield</li></ol>
tanah	<i>romanization</i><br><ol><li>Romanization of ᮒᮔᮂ</li></ol>
tanduk	<i>romanization</i><br><ol><li>Romanization of ᮒᮔ᮪ᮓᮥᮊ᮪</li></ol>
taneuh	<i>romanization</i><br><ol><li>Romanization of ᮒᮔᮩᮂ (“earth, soil”)</li></ol>
tanggai	<i>romanization</i><br><ol><li>Romanization of ᮒᮀᮌᮄ</li></ol>
tanggiri	<i>noun</i><br><ol><li>mackerel</li></ol>
tangkal	<i>romanization</i><br><ol><li>Romanization of ᮒᮀᮊᮜ᮪</li></ol><br><i>noun</i><br><ol><li>tree</li><li>tree-shrub</li><li>trunk (of a tree)</li><li>stem (of a plant)</li><li>(rice, tea, tobacco, etc.) plant</li><li>hassock (of grasses)</li></ol>
tangkorék	<i>noun</i><br><ol><li>skull</li><li>death's-head</li></ol>
tarum	<i>noun</i><br><ol><li>true indigo, Indigofera tinctoria</li></ol>
tarung	<i>romanization</i><br><ol><li>Romanization of ᮒᮛᮥᮀ</li></ol>
tasma	<i>noun</i><br><ol><li>glasses</li></ol>
tatabeuhan	<i>noun</i><br><ol><li>musical instruments</li></ol>
taun	<i>romanization</i><br><ol><li>Romanization of ᮒᮅᮔ᮪</li></ol>
tebih	<i>romanization</i><br><ol><li>Romanization of ᮒᮨᮘᮤᮂ</li></ol>
teku	<i>noun</i><br><ol><li>knee</li></ol><br><i>romanization</i><br><ol><li>Romanization of ᮒᮨᮊᮥ</li></ol>
telas	<i>romanization</i><br><ol><li>Romanization of ᮒᮨᮜᮞ᮪</li></ol>
tembang	<i>romanization</i><br><ol><li>Romanization of ᮒᮨᮙ᮪ᮘᮀ</li></ol>
tengek	<i>romanization</i><br><ol><li>Romanization of ᮒᮨᮍᮨᮊ᮪</li></ol>
tengen	<i>romanization</i><br><ol><li>Romanization of ᮒᮨᮍᮨᮔ᮪</li></ol>
teukteuk	<i>romanization</i><br><ol><li>Romanization of ᮒᮩᮊ᮪ᮒᮩᮊ᮪</li></ol>
tewek	<i>romanization</i><br><ol><li>Romanization of ᮒᮨᮝᮨᮊ᮪</li></ol>
ti dituna	<i>adv</i><br><ol><li>long ago</li><li>from the beginning</li></ol>
tidinya	<i>conj</i><br><ol><li>after that</li><li>thereupon</li><li>then</li><li>further</li></ol>
tiis	<i>romanization</i><br><ol><li>Romanization of ᮒᮤᮄᮞ᮪</li></ol>
tilu	<i>romanization</i><br><ol><li>Romanization of ᮒᮤᮜᮥ</li></ol>
timah	<i>romanization</i><br><ol><li>Romanization of ᮒᮤᮙᮂ</li></ol>
timanten	<i>romanization</i><br><ol><li>Romanization of ᮒᮤᮙᮔ᮪ᮒᮨᮔ᮪</li></ol>
tingali	<i>romanization</i><br><ol><li>Romanization of ᮒᮤᮍᮜᮤ</li></ol>
tingarunyay	<i>verb</i><br><ol><li>phosphorescence (of the sea)</li></ol>
tinggang	<i>romanization</i><br><ol><li>Romanization of ᮒᮤᮀᮌᮀ</li></ol>
tinun	<i>verb</i><br><ol><li>to weave</li></ol>
tiris	<i>romanization</i><br><ol><li>Romanization of ᮒᮤᮛᮤᮞ᮪</li></ol>
tiséntad	<i>verb</i><br><ol><li>slipped</li></ol>
titit	<i>noun</i><br><ol><li>(childish) penis</li></ol>
tiup	<i>romanization</i><br><ol><li>Romanization of ᮒᮤᮅᮕ᮪</li></ol>
tiwuan	<i>noun</i><br><ol><li>bumblebee</li></ol>
tuang	<i>verb</i><br><ol><li>to eat</li></ol>
tuhur	<i>romanization</i><br><ol><li>Romanization of ᮒᮥᮠᮥᮁ</li></ol>
tukang kuda	<i>noun</i><br><ol><li>stablehand</li><li>groom</li></ol>
tulang	<i>romanization</i><br><ol><li>Romanization of ᮒᮥᮜᮀ</li></ol>
tungi	<i>romanization</i><br><ol><li>Romanization of ᮒᮥᮍᮤ</li></ol>
tungkai	<i>romanization</i><br><ol><li>Romanization of ᮒᮥᮀᮊᮄ</li></ol>
tur	<i>conj</i><br><ol><li>and</li><li>as well as</li><li>furthermore</li><li>while in fact</li></ol>
turug-turug	<i>conj</i><br><ol><li>furthermore</li><li>besides</li><li>in addition</li></ol>
tutuwuhan	<i>noun</i><br><ol><li>plant</li><li>vegetation</li></ol>
tuur	<i>noun</i><br><ol><li>knee</li></ol>
tuus	<i>romanization</i><br><ol><li>Romanization of ᮒᮥᮅᮞ᮪</li></ol>
tèrèh	<i>adj</i><br><ol><li>quick</li><li>soon</li></ol>
téspong	<i>noun</i><br><ol><li>The aster Myriactis wightii</li></ol>
téwok	<i>noun</i><br><ol><li>young taro</li></ol>
uap	<i>romanization</i><br><ol><li>Romanization of ᮅᮃᮕ᮪</li></ol>
ubar	<i>romanization</i><br><ol><li>Romanization of ᮅᮘᮁ</li></ol>
uduh	<i>adj</i><br><ol><li>soft, tender</li></ol>
ulam paeut	<i>noun</i><br><ol><li>a kind of worm</li></ol>
uninga	<i>romanization</i><br><ol><li>Romanization of ᮅᮔᮤᮍ</li></ol>
upami	<i>romanization</i><br><ol><li>Romanization of ᮅᮕᮙᮤ</li></ol>
urang	<i>romanization</i><br><ol><li>Romanization of ᮅᮛᮀ</li></ol>
uteuk	<i>romanization</i><br><ol><li>Romanization of ᮅᮒᮩᮊ᮪</li></ol>
uyah	<i>romanization</i><br><ol><li>Romanization of ᮅᮚᮂ</li></ol>
uyun	<i>adj</i><br><ol><li>funny</li><li>amusing</li></ol>
wahangan	<i>romanization</i><br><ol><li>Romanization of ᮝᮠᮍᮔ᮪</li></ol>
walirang	<i>romanization</i><br><ol><li>Romanization of ᮝᮜᮤᮛᮀ</li></ol>
walungan	<i>romanization</i><br><ol><li>Romanization of ᮝᮜᮥᮍᮔ᮪</li></ol>
wana	<i>romanization</i><br><ol><li>Romanization of ᮝᮔ</li></ol>
wancahan	<i>noun</i><br><ol><li>abbreviation</li><li>abridgement</li><li>shortening</li><li>diminutive</li></ol>
wanoja	<i>romanization</i><br><ol><li>Romanization of ᮝᮔᮧᮏ</li></ol>
waos	<i>romanization</i><br><ol><li>Romanization of ᮝᮇᮞ᮪</li></ol>
warsih	<i>romanization</i><br><ol><li>Romanization of ᮝᮁᮞᮤᮂ</li></ol>
warta	<i>romanization</i><br><ol><li>Romanization of ᮝᮁᮒ</li></ol>
wawayang	<i>noun</i><br><ol><li>trigger of a gun</li></ol>
welas	<i>romanization</i><br><ol><li>Romanization of ᮝᮨᮜᮞ᮪</li></ol>
wengi	<i>romanization</i><br><ol><li>Romanization of ᮝᮨᮍᮤ</li></ol>
weuteuh	<i>romanization</i><br><ol><li>Romanization of ᮝᮩᮒᮩᮂ</li></ol>
wilangan	<i>noun</i><br><ol><li>number</li></ol><br><i>romanization</i><br><ol><li>Romanization of ᮝᮤᮜᮍᮔ᮪</li></ol>
wilangan buleud	<i>romanization</i><br><ol><li>Romanization of ᮝᮤᮜᮍᮔ᮪ ᮘᮥᮜᮩᮓ᮪</li></ol>
wongwongan	<i>noun</i><br><ol><li>image (of a man)</li><li>doll</li></ol>
wuwuluh	<i>noun</i><br><ol><li>barrel (of a rifle, revolver,etc.)</li></ol>
élmu	<i>romanization</i><br><ol><li>Romanization of ᮆᮜ᮪ᮙᮥ</li></ol>
élmu kudrat	<i>noun</i><br><ol><li>physics</li></ol>
émbak	<i>noun</i><br><ol><li>little wave</li></ol>
émbaran	<i>noun</i><br><ol><li>announcement</li></ol>
érang-érang	<i>noun</i><br><ol><li>lintel</li></ol>
és	<i>romanization</i><br><ol><li>Romanization of ᮆᮞ᮪</li></ol>
éta	<i>romanization</i><br><ol><li>Romanization of ᮆᮒ</li></ol>
étang	<i>romanization</i><br><ol><li>Romanization of ᮆᮒᮀ</li></ol>
ᮃᮀᮊᮒ᮪|angkat	<i>verb</i><br><ol><li>to depart</li><li>to leave</li></ol>
ᮃᮀᮊᮣᮥᮀ|angklung	<i>noun</i><br><ol><li>angklung</li></ol>
ᮃᮀᮊᮥᮒᮔ᮪|angkutan	<i>noun</i><br><ol><li>transport, transportation</li></ol>
ᮃᮀᮊᮩᮘ᮪|angkeub	<i>adj</i><br><ol><li>clouded</li></ol>
ᮃᮄᮀ|aing	<i>pron</i><br><ol><li>(Banten) I, me</li></ol>
ᮃᮊᮀ|akang	<i>noun</i><br><ol><li>older brother</li></ol>
ᮃᮊ᮪ᮞᮛ|aksara	<i>noun</i><br><ol><li>letter (of the alphabet)</li><li>alphabet</li></ol>
ᮃᮌᮢᮤᮊᮥᮜ᮪ᮒᮥᮁ|agrikultur	<i>noun</i><br><ol><li>agriculture</li></ol>
ᮃᮌᮩᮀ|ageung	<i>adj</i><br><ol><li>big</li></ol>
ᮃᮍᮣᮧ|anglo	<i>noun</i><br><ol><li>fireplace</li></ol>
ᮃᮍᮤᮀ|anging	<i>adv</i><br><ol><li>except</li></ol><br><i>conj</i><br><ol><li>only</li></ol>
ᮃᮍᮤᮔ᮪|angin	<i>noun</i><br><ol><li>wind (movement of air)</li><li>draft</li></ol>
ᮃᮍᮨᮔ᮪|angen	<i>noun</i><br><ol><li>liver</li></ol>
ᮃᮏᮊ᮪|ajak	<i>verb</i><br><ol><li>to invite (ask for the presence or participation of someone)</li></ol>
ᮃᮏᮨᮌ᮪|ajeg	<i>adj</i><br><ol><li>standing upright</li></ol>
ᮃᮒᮤ|ati	<i>noun</i><br><ol><li>liver</li></ol>
ᮃᮒᮥᮁ|atur	<i>verb</i><br><ol><li>to arrange (to set up, organise)</li></ol>
ᮃᮓᮒ᮪|adat	<i>noun</i><br><ol><li>custom, habit</li></ol>
ᮃᮓᮥᮂ|aduh	<i>intj</i><br><ol><li>ouch (expression of one's own physical pain)</li></ol>
ᮃᮓᮨᮌ᮪|adeg	<i>verb</i><br><ol><li>to stand</li></ol>
ᮃᮔᮧᮙ᮪|anom	<i>adj</i><br><ol><li>young</li></ol>
ᮃᮔ᮪ᮏᮤᮀ|anjing	<i>noun</i><br><ol><li>dog (animal)</li></ol>
ᮃᮔ᮪ᮏᮩᮔ᮪|anjeun	<i>pron</i><br><ol><li>you (singular)</li></ol>
ᮃᮔ᮪ᮏᮩᮔ᮪ᮔ|anjeunna	<i>pron</i><br><ol><li>third person singular pronoun, he, she, it</li></ol>
ᮃᮔ᮪ᮓᮦᮝᮤ|andéwi	<i>noun</i><br><ol><li>endive</li></ol>
ᮃᮕᮧᮒᮦᮊ᮪|apoték	<i>noun</i><br><ol><li>drugstore, pharmacy</li></ol>
ᮃᮘᮂ|abah	<i>noun</i><br><ol><li>dad</li><li>father (male parent)</li></ol>
ᮃᮘᮂ-ᮃᮘᮂ|abah-abah	<i>noun</i><br><ol><li>goods, chattels, effects; gear, tackle</li></ol>
ᮃᮘᮧᮒ᮪|abot	<i>adj</i><br><ol><li>heavy (having great weight)</li></ol>
ᮃᮘ᮪ᮓᮤ|abdi	<i>pron</i><br><ol><li>I, me</li></ol>
ᮃᮙᮨᮀ|ameng	<i>verb</i><br><ol><li>to play</li></ol>
ᮃᮙ᮪ᮕᮛᮔ᮪|amparan	<i>noun</i><br><ol><li>mat</li></ol>
ᮃᮙ᮪ᮘᮥᮀ|ambung	<i>verb</i><br><ol><li>to smell</li></ol>
ᮃᮙ᮪ᮘᮨᮊᮔ᮪|ambekan	<i>verb</i><br><ol><li>to breathe</li></ol>
ᮃᮛᮄᮀ|araing	<i>pron</i><br><ol><li>(Banten) we</li></ol>
ᮃᮛᮔ᮪ᮏᮩᮔ᮪|aranjeun	<i>pron</i><br><ol><li>you (plural)</li></ol>
ᮃᮛᮔ᮪ᮏᮩᮔ᮪ᮔ|aranjeunna	<i>pron</i><br><ol><li>they</li></ol>
ᮃᮛᮥᮛᮀ|arurang	<i>pron</i><br><ol><li>we</li></ol>
ᮃᮛᮧᮒ᮪|arot	<i>verb</i><br><ol><li>to drink</li></ol>
ᮃᮛᮨᮊ᮪|arek	<i>verb</i><br><ol><li>to want</li></ol>
ᮃᮜᮤᮂ|alih	<i>verb</i><br><ol><li>(intransitive) to move (to change place or posture; to go)</li></ol>
ᮃᮜᮤᮒ᮪|alit	<i>adj</i><br><ol><li>small</li><li>young</li></ol>
ᮃᮜᮤᮙ᮪|alim	<i>adj</i><br><ol><li>highly educated in religion</li><li>pious</li></ol><br><i>verb</i><br><ol><li>to not want to</li></ol>
ᮃᮜᮥᮀ|alung	<i>verb</i><br><ol><li>to throw</li></ol>
ᮃᮜᮥᮔᮺᮌᮥᮀ|alun-agung	<i>noun</i><br><ol><li>tidal wave</li></ol>
ᮃᮝᮀ|awang	<i>noun</i><br><ol><li>sky</li></ol>
ᮃᮝᮤᮞ᮪|awis	<i>adj</i><br><ol><li>expensive</li></ol>
ᮃᮝᮧᮔ᮪|awon	<i>adj</i><br><ol><li>bad</li></ol>
ᮄᮊᮣᮤᮙ᮪|iklim	<i>noun</i><br><ol><li>climate</li></ol>
ᮄᮕᮤᮞ᮪|ipis	<i>adj</i><br><ol><li>thin</li></ol>
ᮄᮙᮂ|imah	<i>noun</i><br><ol><li>house</li></ol>
ᮄᮙᮂᮊᮎᮔ|imahkacana	<i>noun</i><br><ol><li>homepage</li></ol>
ᮄᮚᮩ|iyeu	<i>det</i><br><ol><li>this</li></ol><br><i>pron</i><br><ol><li>this</li></ol>
ᮄᮛᮠ|iraha	<i>adv</i><br><ol><li>when</li></ol>
ᮄᮛᮥᮀ|irung	<i>noun</i><br><ol><li>nose</li></ol>
ᮄᮜᮒ᮪|ilat	<i>noun</i><br><ol><li>tongue</li></ol>
ᮅᮃᮕ᮪|uap	<i>noun</i><br><ol><li>vapor, steam</li></ol>
ᮅᮒᮩᮊ᮪|uteuk	<i>noun</i><br><ol><li>brain</li></ol>
ᮅᮔᮤᮍ|uninga	<i>verb</i><br><ol><li>to know</li></ol>
ᮅᮕᮙᮤ|upami	<i>conj</i><br><ol><li>if</li></ol>
ᮅᮘᮁ|ubar	<i>noun</i><br><ol><li>drug, medicine, remedy</li></ol>
ᮅᮚᮂ|uyah	<i>noun</i><br><ol><li>salt</li></ol>
ᮅᮛᮀ|urang	<i>noun</i><br><ol><li>human being</li></ol>
ᮆᮒ|éta	<i>det</i><br><ol><li>that</li></ol><br><i>pron</i><br><ol><li>that</li></ol>
ᮆᮒᮀ|étang	<i>verb</i><br><ol><li>to count</li></ol>
ᮆᮜ᮪ᮙᮥ|élmu	<i>noun</i><br><ol><li>science</li></ol>
ᮆᮞ᮪|és	<i>noun</i><br><ol><li>ice</li></ol>
ᮇᮒᮦᮒ᮪|otét	<i>noun</i><br><ol><li>louse</li></ol>
ᮇᮒᮧᮒ᮪|otot	<i>noun</i><br><ol><li>muscle</li></ol>
ᮇᮛᮚ᮪|oray	<i>noun</i><br><ol><li>snake</li></ol>
ᮇᮛᮧᮊ᮪|orok	<i>noun</i><br><ol><li>baby, infant</li></ol>
ᮈᮔ᮪ᮒᮦᮂ|entéh	<i>noun</i><br><ol><li>tea</li></ol>
ᮈᮔ᮪ᮒᮩ|enteu	<i>adv</i><br><ol><li>not</li></ol>
ᮈᮔ᮪ᮓᮥᮀ|endung	<i>verb</i><br><ol><li>(Banten) to not want to</li></ol>
ᮈᮔ᮪ᮓᮧᮌ᮪|endog	<i>noun</i><br><ol><li>egg</li><li>(of a fish) roe</li><li>spawn</li></ol>
ᮈᮙᮞ᮪|emas	<i>noun</i><br><ol><li>gold</li></ol>
ᮈᮙ᮪ᮘᮥᮀ|embung	<i>verb</i><br><ol><li>(Banten) to not want to</li></ol>
ᮈᮝᮒᮩᮔ᮪|ewateun	<i>noun</i><br><ol><li>acne</li></ol>
ᮉᮞᮤ|eusi	<i>noun</i><br><ol><li>content</li><li>essence</li></ol>
ᮊᮄ|kai	<i>noun</i><br><ol><li>wood, timber</li></ol>
ᮊᮓᮠᮛᮔ᮪|kadaharan	<i>noun</i><br><ol><li>food</li></ol>
ᮊᮓᮥ|kadu	<i>noun</i><br><ol><li>durian</li></ol>
ᮊᮔ᮪ᮎᮔ|kancana	<i>noun</i><br><ol><li>gold</li></ol>
ᮊᮔ᮪ᮏᮥᮒ᮪|kanjut	<i>noun</i><br><ol><li>(anatomy) scrotum</li></ol>
ᮊᮔ᮪ᮒᮧᮁ|kantor	<i>noun</i><br><ol><li>office</li></ol>
ᮊᮕᮥᮒ᮪|kaput	<i>verb</i><br><ol><li>to sew</li></ol>
ᮊᮙ᮪ᮘᮀ|kambang	<i>verb</i><br><ol><li>to float</li></ol>
ᮊᮛᮦᮒ᮪|karét	<i>noun</i><br><ol><li>natural rubber</li></ol>
ᮊᮛᮨᮞᮨᮘᮔ᮪|kareseban	<i>noun</i><br><ol><li>menstruation</li></ol>
ᮊᮜᮕ|kalapa	<i>noun</i><br><ol><li>coconut</li></ol>
ᮊᮜᮚᮔ᮪|kalayan	<i>prep</i><br><ol><li>with, by (by means of)</li><li>with (expressing manner)</li></ol>
ᮊᮜᮝᮔ᮪|kalawan	<i>prep</i><br><ol><li>with (in addition to)</li></ol>
ᮊᮝᮤᮂ|kawih	<i>noun</i><br><ol><li>song</li></ol><br><i>verb</i><br><ol><li>to sing</li></ol>
ᮊᮞᮥᮁ|kasur	<i>noun</i><br><ol><li>mattress</li></ol>
ᮊᮤᮙ᮪ᮕᮨᮜ᮪|kimpel	<i>verb</i><br><ol><li>to freeze</li></ol>
ᮊᮤᮝ|kiwa	<i>adj</i><br><ol><li>left (of direction)</li></ol>
ᮊᮥᮊᮥ|kuku	<i>noun</i><br><ol><li>(anatomy) nail</li></ol>
ᮊᮥᮎᮥᮁ|kucur	<i>verb</i><br><ol><li>to flow</li></ol>
ᮊᮥᮎᮨᮜ᮪|kucel	<i>adj</i><br><ol><li>rumpled</li></ol>
ᮊᮥᮙᮠ|kumaha	<i>adv</i><br><ol><li>how</li></ol>
ᮊᮥᮙ᮪ᮘᮂ|kumbah	<i>verb</i><br><ol><li>to wash</li></ol>
ᮊᮥᮜᮝᮥ|kulawu	<i>noun</i><br><ol><li>gray (color)</li></ol>
ᮊᮥᮜᮤᮒ᮪|kulit	<i>noun</i><br><ol><li>skin</li><li>hide</li><li>fleece</li><li>bark</li><li>bast</li><li>rind</li><li>peel</li><li>crust (of pastry etc.)</li><li>cover</li><li>(book-,etc.) jacket</li><li>exterior</li><li>uper side</li><li>surface (eg. of the water)</li><li>leather</li></ol>
ᮊᮥᮜᮨᮙ᮪|kulem	<i>verb</i><br><ol><li>to sleep</li></ol>
ᮊᮥᮜ᮪ᮊᮞ᮪|kulkas	<i>noun</i><br><ol><li>refrigerator</li></ol>
ᮊᮦᮎᮕ᮪|kécap	<i>noun</i><br><ol><li>soy sauce</li></ol>
ᮊᮧᮔᮦᮀ|konéng	<i>adj</i><br><ol><li>yellow (having yellow as its colour)</li></ol><br><i>noun</i><br><ol><li>yellow (colour)</li></ol>
ᮊᮧᮕᮤ|kopi	<i>noun</i><br><ol><li>coffee</li></ol>
ᮊᮧᮞᮧᮊ᮪|kosok	<i>verb</i><br><ol><li>to rub</li></ol>
ᮊᮨᮁᮞ|kersa	<i>adj</i><br><ol><li>able (to do something)</li></ol>
ᮊᮨᮊᮨᮘᮥᮜ᮪|kekebul	<i>noun</i><br><ol><li>dust</li></ol>
ᮊᮨᮎᮕ᮪|kecap	<i>noun</i><br><ol><li>word</li></ol>
ᮊᮨᮓᮨᮀ|kedeng	<i>verb</i><br><ol><li>to lie</li></ol>
ᮊᮨᮓᮨᮜᮦ|kedelé	<i>noun</i><br><ol><li>soybean</li></ol>
ᮊᮨᮔ᮪ᮓᮀ|kendang	<i>noun</i><br><ol><li>kendhang</li></ol>
ᮊᮨᮙ᮪ᮘᮀ|kembang	<i>noun</i><br><ol><li>flower</li></ol>
ᮊᮨᮚᮨᮀ|keyeng	<i>adj</i><br><ol><li>firm</li></ol>
ᮊᮩᮞᮢᮊ᮪|keusrak	<i>adj</i><br><ol><li>rough</li></ol>
ᮊᮩᮞᮤᮊ᮪|keusik	<i>noun</i><br><ol><li>sand</li></ol>
ᮌᮁᮝ|garwa	<i>noun</i><br><ol><li>wife</li></ol>
ᮌᮏᮤᮂ|gajih	<i>noun</i><br><ol><li>fat (animal tissue)</li></ol>
ᮌᮛᮤᮀ|garing	<i>adj</i><br><ol><li>dry (free from liquid or moisture)</li></ol>
ᮌᮛᮧ|garo	<i>verb</i><br><ol><li>to scratch</li></ol>
ᮌᮜᮊ᮪ᮞᮤ|galaksi	<i>noun</i><br><ol><li>(astronomy) galaxy</li></ol>
ᮌᮜᮥᮁ|galur	<i>noun</i><br><ol><li>plot (of a story)</li></ol>
ᮌᮤᮔ᮪ᮏᮜ᮪|ginjal	<i>noun</i><br><ol><li>(anatomy) kidney</li></ol>
ᮌᮥᮌᮥᮊ᮪|guguk	<i>noun</i><br><ol><li>dog</li></ol>
ᮌᮥᮔᮥᮀ|gunung	<i>noun</i><br><ol><li>mountain</li></ol>
ᮌᮥᮔ᮪ᮒᮤᮀ|gunting	<i>noun</i><br><ol><li>scissors</li></ol>
ᮌᮥᮙᮥᮏᮨᮀ|gumujeng	<i>verb</i><br><ol><li>to laugh</li></ol>
ᮌᮥᮛᮒ᮪|gurat	<i>noun</i><br><ol><li>line</li></ol>
ᮌᮥᮜ|gula	<i>noun</i><br><ol><li>sugar</li></ol>
ᮌᮦᮞᮦᮂ|géséh	<i>verb</i><br><ol><li>change</li></ol>
ᮌᮧᮌᮧᮒ᮪|gogot	<i>verb</i><br><ol><li>to bite</li></ol>
ᮌᮨᮒᮤᮂ|getih	<i>noun</i><br><ol><li>blood</li></ol>
ᮌᮨᮓᮀ|gedang	<i>noun</i><br><ol><li>papaya</li></ol>
ᮌᮨᮜᮥᮒ᮪|gelut	<i>verb</i><br><ol><li>to fight</li></ol>
ᮌᮨᮜᮧᮙ᮪ᮘᮀ|gelombang	<i>noun</i><br><ol><li>wave</li></ol>
ᮌᮨᮜᮧᮙ᮪ᮘᮀ ᮙᮤᮊᮢᮧ|gelombang mikro	<i>noun</i><br><ol><li>microwave</li></ol>
ᮌᮩᮜᮤᮞ᮪|geulis	<i>adj</i><br><ol><li>pretty</li></ol>
ᮍᮊ᮪ᮒᮤᮕ᮪ᮊᮩᮔ᮪|ngaktipkeun	<i>verb</i><br><ol><li>(transitive) to activate, to enable (to put something into action)</li></ol>
ᮍᮔᮧᮔᮊ᮪ᮒᮤᮕ᮪ᮊᮩᮔ᮪|nganonaktipkeun	<i>verb</i><br><ol><li>(transitive) to deactivate, to disable (to put something out of action)</li></ol>
ᮍᮕᮥᮀ|ngapung	<i>verb</i><br><ol><li>to fly</li></ol>
ᮍᮖᮥᮀᮞᮤᮊᮩᮔ᮪|ngafungsikeun	<i>verb</i><br><ol><li>(transitive) to put into function, to activate, to enable</li></ol>
ᮍᮙᮔᮂ|ngamanah	<i>verb</i><br><ol><li>to think</li></ol>
ᮍᮛᮔ᮪|ngaran	<i>noun</i><br><ol><li>name</li></ol>
ᮍᮜᮠᮤᮁᮊᮩᮔ᮪|ngalahirkeun	<i>noun</i><br><ol><li>birth, childbirth</li></ol>
ᮍᮠᮥᮛᮥᮀᮊᮩᮔ᮪|ngahurungkeun	<i>verb</i><br><ol><li>to switch on, to turn on</li><li>to ignite</li></ol>
ᮍᮧᮏᮄ|ngojai	<i>verb</i><br><ol><li>to swim</li></ol>
ᮎᮀᮊᮀ|cangkang	<i>noun</i><br><ol><li>cover</li><li>rind</li><li>skin</li></ol>
ᮎᮄ|cai	<i>noun</i><br><ol><li>water (clear liquid H₂O)</li><li>fluid</li><li>liquid</li><li>juice (of fruit)</li></ol>
ᮎᮄ ᮒᮔᮩᮂ|cai taneuh	<i>noun</i><br><ol><li>groundwater</li></ol>
ᮎᮊᮨᮒ᮪|caket	<i>adj</i><br><ol><li>near</li></ol>
ᮎᮎᮁ|cacar	<i>noun</i><br><ol><li>chickenpox</li></ol>
ᮎᮎᮄ|cacai	<i>noun</i><br><ol><li>liquid</li></ol>
ᮎᮎᮤᮀ|cacing	<i>noun</i><br><ol><li>worm</li></ol>
ᮎᮛᮤᮇᮞ᮪|carios	<i>verb</i><br><ol><li>to say</li></ol>
ᮎᮛᮧᮌᮦ|carogé	<i>noun</i><br><ol><li>husband</li></ol>
ᮎᮜᮤᮊ᮪|calik	<i>verb</i><br><ol><li>to sit</li></ol>
ᮎᮝᮧᮊᮂ|cawokah	<i>noun</i><br><ol><li>smut</li></ol>
ᮎᮠᮚ|cahaya	<i>noun</i><br><ol><li>light</li></ol>
ᮎᮤᮊᮤᮄᮂ|cikiih	<i>noun</i><br><ol><li>urine</li></ol>
ᮎᮥᮎᮥᮊ᮪|cucuk	<i>noun</i><br><ol><li>thorn</li><li>prickle</li><li>fish-bone</li></ol>
ᮎᮥᮎᮥᮍᮥᮊ᮪|cungunguk|cucunguk|ᮎᮥᮍᮥᮍᮥᮊ᮪	<i>noun</i><br><ol><li>cockroach</li></ol>
ᮎᮥᮎᮥᮒ᮪|cucut	<i>noun</i><br><ol><li>shark</li></ol>
ᮎᮧᮀᮎᮧᮛᮀ|congcorang	<i>noun</i><br><ol><li>mantis</li></ol>
ᮎᮨᮕᮤᮜ᮪|cepil	<i>noun</i><br><ol><li>ear</li></ol>
ᮎᮨᮕᮨᮀ|cepeng	<i>verb</i><br><ol><li>to hold</li></ol>
ᮏᮀᮏᮀ|jangjang	<i>noun</i><br><ol><li>wing</li></ol>
ᮏᮌᮧᮀ|jagong	<i>noun</i><br><ol><li>maize</li></ol>
ᮏᮏᮔ᮪ᮒᮥᮀ|jajantung	<i>noun</i><br><ol><li>heart</li></ol>
ᮏᮔ᮪ᮒᮥᮀ|jantung	<i>noun</i><br><ol><li>heart</li></ol>
ᮏᮘᮣᮧᮌ᮪|jablog	<i>verb</i><br><ol><li>(Banten) to eat</li></ol>
ᮏᮛᮝᮒ᮪|jarawat	<i>noun</i><br><ol><li>acne</li></ol>
ᮏᮜᮔ᮪ ᮎᮄ|jalan cai	<i>noun</i><br><ol><li>aqueduct</li></ol>
ᮏᮜᮛᮔ᮪|jalaran	<i>prep</i><br><ol><li>because of</li></ol>
ᮏᮠᮒ᮪|jahat	<i>adj</i><br><ol><li>bad, evil</li></ol>
ᮏᮠᮦ|jahé	<i>noun</i><br><ol><li>ginger</li></ol>
ᮏᮥᮊᮥᮒ᮪|jukut	<i>noun</i><br><ol><li>grass</li></ol>
ᮏᮥᮙᮃᮂ|jumaah	<i>noun</i><br><ol><li>Friday</li></ol>
ᮏᮥᮙᮨᮔᮨᮀ|jumeneng	<i>verb</i><br><ol><li>to live</li></ol>
ᮏᮨᮔᮨᮍᮔ᮪|jenengan	<i>noun</i><br><ol><li>name</li></ol>
ᮏᮨᮕᮀ|jepang	<i>name</i><br><ol><li>Japan</li></ol>
ᮏᮨᮙ᮪ᮕᮧᮜ᮪|jempol	<i>noun</i><br><ol><li>thumb</li></ol>
ᮏᮨᮛᮥᮊ᮪|jeruk	<i>noun</i><br><ol><li>citrus, lemon, orange</li></ol>
ᮑᮔ|nyana	<i>pron</i><br><ol><li>(Banten) third person singular pronoun, he, she, it</li></ol>
ᮒᮀᮊᮜ᮪|tangkal	<i>noun</i><br><ol><li>tree</li></ol>
ᮒᮀᮌᮄ|tanggai	<i>noun</i><br><ol><li>fingernail</li></ol>
ᮒᮃᮊ᮪|taak	<i>verb</i><br><ol><li>stretch</li></ol>
ᮒᮅᮔ᮪|taun	<i>noun</i><br><ol><li>year</li></ol>
ᮒᮒᮔᮦᮔ᮪|tatanén	<i>noun</i><br><ol><li>agriculture</li></ol>
ᮒᮒᮙ᮪ᮘ|tatamba	<i>noun</i><br><ol><li>medicine</li></ol>
ᮒᮔᮂ	<i>noun</i><br><ol><li>land</li><li>district</li><li>estate</li></ol>
ᮒᮔᮩᮂ|taneuh	<i>noun</i><br><ol><li>earth</li><li>soil</li></ol>
ᮒᮔ᮪ᮓᮥᮊ᮪|tanduk	<i>noun</i><br><ol><li>horn (of an animal)</li></ol>
ᮒᮙ᮪ᮕᮧᮜᮧᮀ|tampolong	<i>noun</i><br><ol><li>spittoon, spitbox</li></ol>
ᮒᮛᮥᮀ|tarung	<i>verb</i><br><ol><li>to fight</li></ol>
ᮒᮜᮌ|talaga	<i>noun</i><br><ol><li>lake</li></ol>
ᮒᮤᮀᮌᮀ|tinggang	<i>verb</i><br><ol><li>to hit</li></ol>
ᮒᮤᮄᮞ᮪|tiis	<i>adj</i><br><ol><li>cold (temperature)</li></ol>
ᮒᮤᮅᮕ᮪|tiup	<i>verb</i><br><ol><li>to blow</li></ol>
ᮒᮤᮍᮜᮤ|tingali	<i>verb</i><br><ol><li>to see</li></ol>
ᮒᮤᮙᮂ|timah	<i>noun</i><br><ol><li>tin (element)</li></ol>
ᮒᮤᮙᮔ᮪ᮒᮨᮔ᮪|timanten	<i>adv</i><br><ol><li>where</li></ol>
ᮒᮤᮛᮤᮞ᮪|tiris	<i>adj</i><br><ol><li>cold (weather)</li></ol>
ᮒᮤᮜᮥ|tilu	<i>num</i><br><ol><li>three</li></ol>
ᮒᮥᮀᮊᮄ|tungkai	<i>noun</i><br><ol><li>leg</li></ol>
ᮒᮥᮃᮀ|tuang	<i>verb</i><br><ol><li>to eat</li></ol>
ᮒᮥᮅᮞ᮪|tuus	<i>adj</i><br><ol><li>slightly wet</li></ol>
ᮒᮥᮒᮥᮝᮥᮠᮔ᮪|tutuwuhan	<i>noun</i><br><ol><li>plant</li></ol>
ᮒᮥᮜᮀ|tulang	<i>noun</i><br><ol><li>bone</li></ol>
ᮒᮥᮠᮥᮁ|tuhur	<i>adj</i><br><ol><li>dry (free of water in any state)</li></ol>
ᮒᮦᮊᮧ|téko	<i>noun</i><br><ol><li>teapot</li></ol>
ᮒᮨᮊᮥ|teku	<i>noun</i><br><ol><li>knee</li></ol>
ᮒᮨᮍᮨᮊ᮪|tengek	<i>noun</i><br><ol><li>neck</li></ol>
ᮒᮨᮍᮨᮔ᮪|tengen	<i>adj</i><br><ol><li>right (of direction)</li></ol>
ᮒᮨᮘᮤᮂ|tebih	<i>adj</i><br><ol><li>far</li></ol>
ᮒᮨᮙ᮪ᮘᮀ|tembang	<i>noun</i><br><ol><li>song</li></ol>
ᮒᮨᮜᮞ᮪|telas	<i>verb</i><br><ol><li>to kill</li></ol>
ᮒᮨᮝᮨᮊ᮪|tewek	<i>verb</i><br><ol><li>to stab</li></ol>
ᮒᮩᮊ᮪ᮒᮩᮊ᮪|teukteuk	<i>verb</i><br><ol><li>to cut</li></ol>
ᮓᮀᮓᮩᮁ|dangdeur	<i>noun</i><br><ol><li>(Banten) cassava</li></ol>
ᮓᮅᮁ ᮎᮄ|daur cai	<i>noun</i><br><ol><li>water cycle</li></ol>
ᮓᮅᮔ᮪|daun	<i>noun</i><br><ol><li>leaf</li></ol>
ᮓᮍᮥ|dangu	<i>verb</i><br><ol><li>to hear</li></ol>
ᮓᮓᮝᮥᮠᮔ᮪|dadawuhan	<i>verb</i><br><ol><li>to have periods, or be subject to periodicity, as a tree which becomes bare when it changes its leaves. A period when any particular fruit comes into season. Said also of birds which appear to migrate, and are only seen at certain seasons, as snipe, or plover.</li><li>(Bali) To measure time by a kind of clepsydra.</li></ol>
ᮓᮚᮀ|dayang	<i>noun</i><br><ol><li>damsel, maid of honour</li></ol>
ᮓᮚᮩᮂ|dayeuh	<i>noun</i><br><ol><li>capital city</li></ol>
ᮓᮛᮒ᮪|darat	<i>noun</i><br><ol><li>ground</li></ol>
ᮓᮜᮤᮀᮓᮤᮀ|dalingding	<i>adj</i><br><ol><li>fragrant</li></ol>
ᮓᮜᮥᮛᮥᮀ|dalurung|darurung	<i>noun</i><br><ol><li>the rafters of a flooring, to which the planks are nailed, and in a native's house the round bamboo rafters on which are laid the palupuh or flooring of the house, and which are tied together by the sarang, or slips of split bamboo.</li></ol>
ᮓᮝᮥᮂ|dawuh	<i>noun</i><br><ol><li>period of time</li></ol>
ᮓᮝᮥᮂ ᮊᮤᮝᮛᮤ|dawuh kiwari	<i>phrase</i><br><ol><li>at this moment in time</li></ol>
ᮓᮠᮁ|dahar	<i>verb</i><br><ol><li>to eat</li></ol>
ᮓᮠᮥ|dahu	<i>noun</i><br><ol><li>period, precise time, the moment when anything is to occur.</li></ol>
ᮓᮤᮑ|dinya	<i>adv</i><br><ol><li>(proximal) there</li></ol>
ᮓᮤᮒᮥ|ditu	<i>adv</i><br><ol><li>there (far away)</li></ol>
ᮓᮤᮔ|dina	<i>prep</i><br><ol><li>at</li></ol>
ᮓᮤᮔ᮪ᮒᮨᮔ᮪|dinten	<i>noun</i><br><ol><li>day (24 hours period)</li></ol>
ᮓᮥᮛᮦᮔ᮪|durén	<i>noun</i><br><ol><li>durian</li></ol>
ᮓᮦᮛᮦᮒ᮪ ᮝᮊ᮪ᮒᮥ|dérét waktu	<i>noun</i><br><ol><li>time series</li></ol>
ᮓᮧᮙ᮪ᮕᮦᮒ᮪|dompét	<i>noun</i><br><ol><li>wallet</li></ol>
ᮓᮨᮒᮤᮊ᮪|detik	<i>noun</i><br><ol><li>second</li></ol>
ᮔᮇᮔ᮪|naon	<i>pron</i><br><ol><li>what</li></ol>
ᮔᮜᮤᮃᮔ᮪|nalian	<i>verb</i><br><ol><li>to tie something</li></ol>
ᮕᮆᮂ|paéh	<i>verb</i><br><ol><li>die</li><li>dead</li><li>killed</li></ol>
ᮕᮇᮞ᮪|paos	<i>adj</i><br><ol><li>long</li></ol>
ᮕᮊᮛᮀ|pakarang	<i>noun</i><br><ol><li>weapon</li></ol>
ᮕᮌᮛᮚᮥ|pagarayu	<i>noun</i><br><ol><li>bridesmaid</li></ol>
ᮕᮌᮥᮔᮥᮍᮔ᮪|pagunungan	<i>noun</i><br><ol><li>mountain range</li></ol>
ᮕᮍᮔ᮪|pangan	<i>noun</i><br><ol><li>food</li></ol>
ᮕᮍᮙ᮪ᮘᮥᮀ|pangambung	<i>noun</i><br><ol><li>nose</li></ol>
ᮕᮍᮝᮨᮛᮥᮂ|pangaweruh	<i>noun</i><br><ol><li>knowledge</li></ol>
ᮕᮍᮤᮛᮤᮙᮔ᮪|pangiriman	<i>noun</i><br><ol><li>(telecommunications) transmission</li></ol>
ᮕᮍᮦᮛᮔ᮪|pangéran	<i>noun</i><br><ol><li>prince</li></ol>
ᮕᮍᮦᮞ᮪ᮒᮥ|pangéstu	<i>adj</i><br><ol><li>well (in good health)</li></ol>
ᮕᮒᮣᮧᮒ᮪|patlot	<i>noun</i><br><ol><li>pencil</li></ol>
ᮕᮒᮥᮃᮍᮔ᮪|patuangan	<i>noun</i><br><ol><li>belly</li><li>stomach</li></ol>
ᮕᮔᮍᮔ᮪|panangan	<i>noun</i><br><ol><li>arm</li><li>hand</li></ol>
ᮕᮔᮞ᮪|panas	<i>noun</i><br><ol><li>heat</li></ol>
ᮕᮔᮧᮔ᮪|panon	<i>noun</i><br><ol><li>eye</li></ol>
ᮕᮔᮧᮔ᮪ᮕᮧᮆ|panonpoé	<i>noun</i><br><ol><li>sun</li></ol>
ᮕᮕᮂ|papah	<i>verb</i><br><ol><li>to walk</li></ol>
ᮕᮕᮌᮔ᮪|papagan	<i>noun</i><br><ol><li>bark (of a tree)</li></ol>
ᮕᮙᮥᮕᮥᮞ᮪|pamupus	<i>noun</i><br><ol><li>eraser</li></ol>
ᮕᮙᮨᮌᮨᮒ᮪|pameget	<i>noun</i><br><ol><li>man (male human)</li></ol>
ᮕᮚᮥᮀ|payung	<i>noun</i><br><ol><li>umbrella</li></ol>
ᮕᮛᮥᮀᮌᮥ|parunggu	<i>noun</i><br><ol><li>statue</li></ol>
ᮕᮞᮤᮁ|pasir	<i>noun</i><br><ol><li>hill</li></ol>
ᮕᮞᮤᮠᮔ᮪|pasihan	<i>verb</i><br><ol><li>to give</li></ol>
ᮕᮤᮃᮔᮊᮔ᮪|pianakan	<i>noun</i><br><ol><li>womb, uterus</li></ol>
ᮕᮤᮔᮛᮨᮕ᮪|pinarep	<i>noun</i><br><ol><li>breast</li></ol>
ᮕᮤᮔᮥᮂ|pinuh	<i>adj</i><br><ol><li>full</li></ol>
ᮕᮥᮀᮊᮥᮁ|pungkur	<i>noun</i><br><ol><li>back (the rear of the body)</li></ol>
ᮕᮥᮕᮥᮞ᮪|pupus	<i>verb</i><br><ol><li>to die</li></ol>
ᮕᮥᮞ᮪ᮕ|puspa	<i>noun</i><br><ol><li>flower</li></ol>
ᮕᮦᮞᮧ|péso	<i>noun</i><br><ol><li>knife</li></ol>
ᮕᮧᮔ᮪ᮓᮧᮊ᮪|pondok	<i>adj</i><br><ol><li>short</li></ol>
ᮕᮨᮁᮕᮥᮞ᮪ᮒᮊᮃᮔ᮪|perpustakaan	<i>noun</i><br><ol><li>library</li></ol>
ᮕᮨᮕᮨᮓᮥᮒ᮪|pepedut	<i>noun</i><br><ol><li>mist</li></ol>
ᮕᮨᮕᮨᮜᮊᮔ᮪|pepelakan	<i>noun</i><br><ol><li>plant (organism capable of photosynthesis)</li></ol>
ᮕᮩᮏᮤᮒ᮪|peujit	<i>noun</i><br><ol><li>bowel</li><li>guts</li><li>intestine</li></ol>
ᮘᮀᮞ|bangsa	<i>noun</i><br><ol><li>nation</li></ol>
ᮘᮌᮨᮓᮥᮁ|bagedur	<i>adj</i><br><ol><li>dirty</li></ol>
ᮘᮎ|baca	<i>verb</i><br><ol><li>to read</li></ol>
ᮘᮏᮤᮀ|bajing	<i>noun</i><br><ol><li>squirrel</li></ol>
ᮘᮒᮥ|batu	<i>noun</i><br><ol><li>stone (substance)</li><li>stone (small piece of stone)</li></ol>
ᮘᮚᮂ|bayah	<i>noun</i><br><ol><li>lung</li></ol>
ᮘᮚᮥ|bayu	<i>noun</i><br><ol><li>wind</li></ol>
ᮘᮛᮔᮠᮔ᮪|baranahan	<i>noun</i><br><ol><li>(biology) reproduction</li></ol>
ᮘᮛᮥ|baru	<i>adj</i><br><ol><li>new (recently made or created)</li></ol>
ᮘᮛᮩᮂ|bareuh	<i>verb</i><br><ol><li>to swell</li></ol>
ᮘᮜᮧᮀ|balong	<i>noun</i><br><ol><li>pond</li></ol>
ᮘᮞ|basa	<i>noun</i><br><ol><li>language</li></ol><br><i>conj</i><br><ol><li>when</li></ol>
ᮘᮞᮩᮂ|baseuh	<i>adj</i><br><ol><li>wet (of an object: covered with or impregnated with liquid)</li></ol>
ᮘᮠᮙ᮪|baham	<i>noun</i><br><ol><li>mouth</li></ol>
ᮘᮤᮀᮊᮨᮀ|bingkeng	<i>adj</i><br><ol><li>bent</li></ol>
ᮘᮤᮃᮀ|biang	<i>noun</i><br><ol><li>mother</li></ol>
ᮘᮤᮔᮤᮂ|binih	<i>noun</i><br><ol><li>seed</li></ol>
ᮘᮥᮃᮂ|buah	<i>noun</i><br><ol><li>fruit</li></ol>
ᮘᮥᮃᮔ|buana	<i>noun</i><br><ol><li>continent</li></ol>
ᮘᮥᮅᮊ᮪|buuk	<i>noun</i><br><ol><li>hair</li></ol>
ᮘᮥᮏᮨᮀ|bujeng	<i>verb</i><br><ol><li>to hunt</li></ol>
ᮘᮥᮒᮊ᮪|butak	<i>adj</i><br><ol><li>bald (having no hair)</li></ol>
ᮘᮥᮒᮥᮂ|butuh	<i>verb</i><br><ol><li>to need</li></ol>
ᮘᮥᮔ᮪ᮒᮥᮒ᮪|buntut	<i>noun</i><br><ol><li>tail (of an animal)</li></ol>
ᮘᮥᮔ᮪ᮓᮨᮁ|bunder	<i>adj</i><br><ol><li>circular</li><li>round</li></ol>
ᮘᮥᮛᮤᮂ|burih	<i>noun</i><br><ol><li>(anatomy) stomach</li></ol>
ᮘᮥᮛᮥ|buru	<i>verb</i><br><ol><li>to hunt</li></ol>
ᮘᮥᮛᮥᮊ᮪|buruk	<i>adj</i><br><ol><li>decayed</li><li>rotten</li></ol>
ᮘᮥᮜᮇ|bulao	<i>noun</i><br><ol><li>blue</li></ol>
ᮘᮥᮜᮔ᮪|bulan	<i>noun</i><br><ol><li>moon</li><li>month</li></ol>
ᮘᮥᮜᮩᮓ᮪|buleud	<i>adj</i><br><ol><li>round</li><li>spherical</li><li>globular</li><li>cylindrical</li></ol>
ᮘᮥᮠᮚ|buhaya	<i>noun</i><br><ol><li>crocodile (reptile)</li></ol>
ᮘᮦᮃᮞ᮪|béas	<i>noun</i><br><ol><li>uncooked rice</li></ol>
ᮘᮦᮔ᮪ᮒᮀ|béntang	<i>noun</i><br><ol><li>star</li></ol>
ᮘᮧᮏᮧ|bojo	<i>noun</i><br><ol><li>wife</li></ol>
ᮘᮧᮜᮧᮊᮧᮒ᮪|bolokot	<i>adj</i><br><ol><li>muddy</li></ol>
ᮘᮨᮓᮧᮜ᮪|bedol	<i>verb</i><br><ol><li>to pull</li></ol>
ᮘᮨᮔᮨᮁ|bener	<i>adj</i><br><ol><li>decent (of a person)</li></ol>
ᮘᮨᮜᮨᮝᮥᮊ᮪|belewuk	<i>adj</i><br><ol><li>dusty</li></ol>
ᮘᮩᮀᮊᮩᮒ᮪|beungkeut	<i>verb</i><br><ol><li>to tie</li></ol>
ᮘᮩᮀᮠᮁ|beunghar	<i>adj</i><br><ol><li>rich</li></ol>
ᮘᮩᮘᮩᮛᮤᮒᮔ᮪|beubeuritan	<i>noun</i><br><ol><li>(computing) mouse</li></ol>
ᮘᮩᮛᮩᮙ᮪|beureum	<i>noun</i><br><ol><li>red</li></ol>
ᮘᮩᮜᮂ|beulah	<i>adj</i><br><ol><li>broken</li><li>shattered</li><li>split</li></ol><br><i>verb</i><br><ol><li>to split</li></ol>
ᮘᮩᮜᮩᮙ᮪|beuleum	<i>verb</i><br><ol><li>to burn</li></ol>
ᮘᮩᮞᮤ|beusi	<i>noun</i><br><ol><li>(physics, chemistry, metallurgy) iron (element)</li></ol>
ᮙᮀᮌᮥ|manggu	<i>noun</i><br><ol><li>The mangosteen</li></ol>
ᮙᮁᮌᮤ|margi	<i>adv</i><br><ol><li>because</li></ol><br><i>conj</i><br><ol><li>because</li></ol><br><i>prep</i><br><ol><li>because</li></ol>
ᮙᮁᮎᮕᮓ|marcapada	<i>noun</i><br><ol><li>Earth</li></ol>
ᮙᮓᮥ|madu	<i>noun</i><br><ol><li>honey</li></ol>
ᮙᮔᮂ|manah	<i>noun</i><br><ol><li>mind</li><li>soul</li></ol>
ᮙᮔ᮪ᮒᮦᮌ|mantéga	<i>noun</i><br><ol><li>butter</li></ol>
ᮙᮛᮔᮨᮂᮔ|maranehna	<i>pron</i><br><ol><li>(Banten) they</li></ol>
ᮙᮛᮥᮒ|maruta	<i>noun</i><br><ol><li>wind</li></ol>
ᮙᮛᮩᮙᮔ᮪|mareuman	<i>verb</i><br><ol><li>to switch off, to turn off</li><li>to extinguish</li></ol>
ᮙᮞ᮪ᮒᮊ|mastaka	<i>noun</i><br><ol><li>head</li></ol>
ᮙᮤᮑᮊ᮪|minyak	<i>noun</i><br><ol><li>oil</li></ol>
ᮙᮤᮒᮨᮞ᮪|mites	<i>verb</i><br><ol><li>to break; the act of breaking a solid object</li></ol>
ᮙᮥᮔ᮪ᮓᮤᮀ|munding	<i>noun</i><br><ol><li>water buffalo</li></ol>
ᮙᮥᮕᮥᮞ᮪|mupus	<i>verb</i><br><ol><li>to wipe</li></ol>
ᮙᮥᮛᮀᮊᮜᮤᮂ|murangkalih	<i>noun</i><br><ol><li>child</li></ol>
ᮙᮦᮌ|méga	<i>noun</i><br><ol><li>cloud</li></ol>
ᮙᮧᮊᮤᮃ|mokia	<i>noun</i><br><ol><li>(Banten) blood</li></ol>
ᮙᮧᮙᮧᮊ᮪|momok	<i>noun</i><br><ol><li>vagina</li></ol>
ᮙᮨᮔ᮪ᮒᮥᮓ᮪|mentud	<i>adj</i><br><ol><li>dull</li></ol>
ᮙᮨᮞᮤᮔ᮪|mesin	<i>noun</i><br><ol><li>machine</li></ol>
ᮙᮨᮞᮤᮔ᮪ ᮒᮤᮊ᮪|mesin tik	<i>noun</i><br><ol><li>typewriter</li></ol>
ᮙᮨᮞᮤᮔ᮪ ᮒᮨᮃᮀ|mesin teang	<i>noun</i><br><ol><li>(computing) search engine</li></ol>
ᮛᮊᮤᮒ᮪|rakit	<i>noun</i><br><ol><li>raft</li></ol>
ᮛᮎᮥᮔ᮪|racun	<i>noun</i><br><ol><li>poison</li></ol>
ᮛᮔ᮪ᮏᮀ|ranjang	<i>noun</i><br><ol><li>bed</li></ol>
ᮛᮙ|rama	<i>noun</i><br><ol><li>father</li></ol>
ᮛᮙᮒᮣᮧᮊ|ramatloka	<i>noun</i><br><ol><li>website</li></ol>
ᮛᮙᮒ᮪ᮊᮎ|ramatkaca	<i>noun</i><br><ol><li>webpage</li></ol>
ᮛᮙᮨᮞ᮪|rames	<i>verb</i><br><ol><li>to squeeze</li></ol>
ᮛᮙ᮪ᮘᮥᮒ᮪|rambut	<i>noun</i><br><ol><li>hair</li></ol>
ᮛᮤᮑᮥᮂ|rinyuh	<i>noun</i><br><ol><li>termite</li></ol>
ᮛᮤᮞ᮪ᮘᮀ|risbang	<i>noun</i><br><ol><li>bed</li></ol>
ᮛᮥᮘᮊ᮪|rubak	<i>adj</i><br><ol><li>wide</li></ol>
ᮛᮦᮊᮚᮞ|rékayasa	<i>noun</i><br><ol><li>engineering</li></ol>
ᮛᮦᮌᮀ|régang	<i>noun</i><br><ol><li>stick</li></ol>
ᮛᮧᮘᮂ|robah	<i>verb</i><br><ol><li>(intransitive) to turn</li></ol>
ᮛᮧᮠᮍᮔ᮪ ᮠᮕ|rohangan hapa	<i>noun</i><br><ol><li>vacuum</li></ol>
ᮛᮩᮉᮊ᮪|reueuk	<i>adj</i><br><ol><li>cloudy</li></ol>
ᮜᮅᮊ᮪|lauk	<i>noun</i><br><ol><li>fish</li></ol>
ᮜᮅᮒ᮪|laut	<i>noun</i><br><ol><li>sea</li></ol>
ᮜᮅᮒ᮪ ᮏᮨᮕᮀ|laut jepang	<i>name</i><br><ol><li>Sea of Japan</li></ol>
ᮜᮍᮣᮚᮍᮔ᮪|langlayangan	<i>noun</i><br><ol><li>kite</li><li>(geometry) kite</li></ol>
ᮜᮍᮤᮒ᮪|langit	<i>noun</i><br><ol><li>sky</li></ol>
ᮜᮏᮥ|laju	<i>noun</i><br><ol><li>velocity</li></ol>
ᮜᮏᮥ ᮎᮠᮚ|laju cahaya	<i>noun</i><br><ol><li>(physics) speed of light</li></ol>
ᮜᮔ᮪ᮓᮊ᮪|landak	<i>noun</i><br><ol><li>hedgehog</li></ol>
ᮜᮘᮥᮂ|labuh	<i>verb</i><br><ol><li>to fall</li></ol>
ᮜᮚᮁ|layar	<i>noun</i><br><ol><li>(nautical) sail (a piece of fabric attached to a boat)</li></ol>
ᮜᮚᮍᮔ᮪|layangan	<i>noun</i><br><ol><li>kite</li></ol>
ᮜᮜᮊᮤ|lalaki	<i>noun</i><br><ol><li>man (male human), boy</li></ol>
ᮜᮤᮊᮥᮁ|likur	<i>num</i><br><ol><li>(to form numbers 21 - 29)</li></ol>
ᮜᮤᮔᮤ|lini	<i>noun</i><br><ol><li>earthquake</li></ol>
ᮜᮤᮞᮂ|lisah	<i>noun</i><br><ol><li>oil</li></ol>
ᮜᮥᮃᮞ᮪|luas	<i>adj</i><br><ol><li>determined</li></ol>
ᮜᮥᮌ|luga	<i>verb</i><br><ol><li>to puke</li><li>to vomit</li></ol>
ᮜᮥᮓᮂ|ludah	<i>verb</i><br><ol><li>to spit</li></ol>
ᮜᮦᮒᮂ|létah	<i>noun</i><br><ol><li>tongue</li></ol>
ᮜᮧᮌᮙ᮪|logam	<i>noun</i><br><ol><li>metal</li></ol>
ᮜᮧᮙ|loma	<i>adj</i><br><ol><li>harsh (said of language)</li></ol>
ᮜᮧᮜᮧ|lolo	<i>adj</i><br><ol><li>unclean</li></ol>
ᮜᮨᮎᮨᮊ᮪|lecek	<i>adj</i><br><ol><li>very dirty (of a cloth)</li><li>turbid (of water)</li></ol>
ᮜᮨᮓᮢᮨᮊ᮪|ledrek	<i>adj</i><br><ol><li>squalid</li></ol>
ᮜᮨᮘᮥ|lebu	<i>noun</i><br><ol><li>ash</li></ol>
ᮜᮨᮘᮨᮒ᮪|lebet	<i>adv</i><br><ol><li>inside</li></ol><br><i>prep</i><br><ol><li>in</li><li>inside</li></ol>
ᮜᮨᮙᮂ|lemah	<i>noun</i><br><ol><li>land</li></ol>
ᮜᮨᮙᮨᮞ᮪|lemes	<i>adj</i><br><ol><li>smooth</li></ol>
ᮜᮨᮙ᮪ᮕᮨᮀ|lempeng	<i>adj</i><br><ol><li>straight</li></ol>
ᮜᮨᮙ᮪ᮘᮥᮒ᮪|lembut	<i>adj</i><br><ol><li>smooth</li></ol>
ᮜᮨᮛᮨᮞ᮪|leres	<i>adj</i><br><ol><li>correct</li></ol>
ᮜᮩᮉᮒ᮪|leueut	<i>verb</i><br><ol><li>to drink</li></ol>
ᮜᮩᮍᮩᮔ᮪|leungeun	<i>noun</i><br><ol><li>hand</li><li>arm</li></ol>
ᮜᮩᮙ᮪ᮕᮀ|leumpang	<i>noun</i><br><ol><li>walking</li></ol>
ᮜᮩᮝᮩᮀ|leuweung	<i>noun</i><br><ol><li>forest</li></ol>
ᮝᮁᮒ|warta	<i>noun</i><br><ol><li>news</li></ol>
ᮝᮁᮞᮤᮂ|warsih	<i>noun</i><br><ol><li>year</li></ol>
ᮝᮇᮞ᮪|waos	<i>noun</i><br><ol><li>tooth</li></ol>
ᮝᮔ|wana	<i>noun</i><br><ol><li>forest</li></ol>
ᮝᮔᮧᮏ|wanoja	<i>noun</i><br><ol><li>woman</li></ol>
ᮝᮜᮤᮛᮀ|walirang	<i>noun</i><br><ol><li>sulfur (element)</li></ol>
ᮝᮜᮥᮍᮔ᮪|walungan	<i>noun</i><br><ol><li>river</li></ol>
ᮝᮠᮍᮔ᮪|wahangan	<i>noun</i><br><ol><li>river</li></ol>
ᮝᮤᮜᮍᮔ᮪|wilangan	<i>noun</i><br><ol><li>(mathematics) number</li></ol>
ᮝᮤᮜᮍᮔ᮪ ᮘᮥᮜᮩᮓ᮪|wilangan buleud	<i>noun</i><br><ol><li>(mathematics) integer</li></ol>
ᮝᮨᮍᮤ|wengi	<i>noun</i><br><ol><li>night</li></ol>
ᮝᮨᮜᮞ᮪|welas	<i>num</i><br><ol><li>-teen (to form numbers 11 - 19)</li></ol>
ᮝᮩᮒᮩᮂ|weuteuh	<i>adj</i><br><ol><li>intact</li><li>new</li></ol>
ᮞᮀᮌᮙ|sanggama	<i>noun</i><br><ol><li>sexual intercourse</li></ol>
ᮞᮁᮒ|sarta	<i>conj</i><br><ol><li>and</li></ol>
ᮞᮃᮘ᮪|saab	<i>noun</i><br><ol><li>water vapor</li></ol>
ᮞᮆ|saé	<i>adj</i><br><ol><li>good</li></ol>
ᮞᮊᮨᮓᮤᮊ᮪|sakedik	<i>adv</i><br><ol><li>little</li></ol><br><i>adj</i><br><ol><li>little</li></ol><br><i>det</i><br><ol><li>few</li><li>little</li></ol><br><i>pron</i><br><ol><li>few</li></ol>
ᮞᮌᮛ|sagara	<i>noun</i><br><ol><li>sea</li></ol>
ᮞᮍᮥ|sangu	<i>noun</i><br><ol><li>cooked rice</li></ol>
ᮞᮒᮧ|sato	<i>noun</i><br><ol><li>animal</li></ol>
ᮞᮓᮚ|sadaya	<i>det</i><br><ol><li>all</li></ol>
ᮞᮔᮦᮞ᮪|sanés	<i>adv</i><br><ol><li>not</li></ol><br><i>conj</i><br><ol><li>not</li></ol>
ᮞᮘᮘᮛᮠ|sababaraha	<i>det</i><br><ol><li>some</li></ol><br><i>pron</i><br><ol><li>some</li></ol>
ᮞᮙ᮪ᮕᮦᮃᮔ᮪|sampéan	<i>noun</i><br><ol><li>foot (of a human)</li></ol>
ᮞᮙ᮪ᮕᮩ|sampeu	<i>noun</i><br><ol><li>cassava</li></ol>
ᮞᮛᮦ|saré	<i>noun</i><br><ol><li>sleep</li></ol>
ᮞᮛᮨᮀ|sareng	<i>prep</i><br><ol><li>with (against)</li><li>with (in the company of)</li></ol>
ᮞᮜᮊᮤ|salaki	<i>noun</i><br><ol><li>husband</li></ol>
ᮞᮜ᮪ᮏᮥ|salju	<i>noun</i><br><ol><li>snow</li></ol>
ᮞᮝᮂ|sawah	<i>noun</i><br><ol><li>(agriculture) paddy field</li></ol>
ᮞᮞᮊ᮪|sasak	<i>noun</i><br><ol><li>bridge</li></ol>
ᮞᮞᮊ᮪ ᮃᮀᮊᮒ᮪|sasak angkat	<i>noun</i><br><ol><li>drawbridge, bascule bridge</li></ol>
ᮞᮞᮊ᮪ ᮊᮘᮨᮜ᮪|sasak kabel	<i>noun</i><br><ol><li>cable-stayed bridge</li></ol>
ᮞᮞᮊ᮪ ᮌᮔ᮪ᮒᮥᮀ|sasak gantung	<i>noun</i><br><ol><li>suspension bridge</li></ol>
ᮞᮞᮊ᮪ ᮌᮨᮛᮊ᮪|sasak gerak	<i>noun</i><br><ol><li>movable bridge</li></ol>
ᮞᮞᮊ᮪ ᮒᮀᮊᮜ᮪ ᮊᮄ|sasak tangkal kai	<i>noun</i><br><ol><li>log bridge</li></ol>
ᮞᮞᮊ᮪ ᮕᮔᮀᮌᮩᮚ᮪|sasak pananggeuy	<i>noun</i><br><ol><li>cantilever bridge</li></ol>
ᮞᮞᮊ᮪ ᮙᮜᮀ|sasak malang	<i>noun</i><br><ol><li>beam bridge</li></ol>
ᮞᮞᮊ᮪ ᮛᮧᮛᮧᮀᮊᮧᮀ|sasak rorongkong	<i>noun</i><br><ol><li>truss bridge</li></ol>
ᮞᮞᮊ᮪ ᮜᮨᮀᮊᮥᮀ|sasak lengkung	<i>noun</i><br><ol><li>arch bridge</li></ol>
ᮞᮞᮤᮂ|sasih	<i>noun</i><br><ol><li>month</li></ol>
ᮞᮠ|saha	<i>pron</i><br><ol><li>who; what person or people; which person or people (used in a direct or indirect question).</li></ol>
ᮞᮤᮊᮤ|siki	<i>noun</i><br><ol><li>seed</li></ol>
ᮞᮤᮒᮥ|situ	<i>noun</i><br><ol><li>lake: large, landlocked, naturally occurring stretch of water.</li></ol>
ᮞᮤᮔ᮪ᮓᮤᮁ|sindir	<i>noun</i><br><ol><li>allusion</li></ol>
ᮞᮤᮙ᮪ᮘᮥᮒ᮪|simbut	<i>noun</i><br><ol><li>blanket</li></ol>
ᮞᮤᮛᮂ|sirah	<i>noun</i><br><ol><li>head</li></ol>
ᮞᮤᮞᮤᮁ|sisir	<i>noun</i><br><ol><li>comb</li></ol>
ᮞᮤᮞᮤᮔ᮪ᮓᮤᮛᮔ᮪|sisindiran	<i>noun</i><br><ol><li>sisindiran, a style of Sundanese poetry</li></ol>
ᮞᮥᮊᮥ|suku	<i>noun</i><br><ol><li>foot</li></ol>
ᮞᮥᮙ᮪ᮕᮤᮀ|sumping	<i>verb</i><br><ol><li>to come</li></ol>
ᮞᮥᮛᮦᮜᮦᮊ᮪|surélék	<i>noun</i><br><ol><li>e-mail</li></ol>
ᮞᮥᮜᮥᮂ|suluh	<i>noun</i><br><ol><li>fuel</li></ol>
ᮞᮥᮞᮥᮊᮔ᮪|susukan	<i>noun</i><br><ol><li>stream</li></ol>
ᮞᮥᮞ᮪ᮒᮨᮁ ᮘᮞᮩᮂ|suster baseuh	<i>noun</i><br><ol><li>wet nurse</li></ol>
ᮞᮥᮠᮥ|suhu	<i>noun</i><br><ol><li>temperature</li></ol>
ᮞᮥᮠᮥᮔ᮪|suhun	<i>verb</i><br><ol><li>politely ask or request for something</li></ol><br><i>noun</i><br><ol><li>the act of carrying items on the head</li></ol>
ᮞᮦᮏᮦᮔ᮪|séjén	<i>det</i><br><ol><li>other</li></ol>
ᮞᮦᮔ᮪ᮓᮧᮊ᮪|séndok	<i>noun</i><br><ol><li>spoon</li></ol>
ᮞᮧᮎ|soca	<i>noun</i><br><ol><li>eye</li></ol>
ᮞᮧᮛᮧᮀ|sorong	<i>verb</i><br><ol><li>to push</li></ol>
ᮞᮨᮕᮥᮂ|sepuh	<i>adj</i><br><ol><li>old (of living thing)</li></ol>
ᮞᮨᮘᮦᮁ|sebér	<i>verb</i><br><ol><li>to fear</li></ol>
ᮞᮨᮛᮀᮌ|serangga	<i>noun</i><br><ol><li>insect</li></ol>
ᮞᮩᮉᮁ|seueur	<i>det</i><br><ol><li>many</li></ol>
ᮞᮩᮊᮩᮒ᮪|seukeut	<i>adj</i><br><ol><li>sharp</li></ol>
ᮞᮩᮔᮩ|seuneu	<i>noun</i><br><ol><li>fire</li></ol>
ᮞᮩᮞᮩᮕ᮪|seuseup	<i>verb</i><br><ol><li>to suck</li></ol>
ᮞ᮪ᮕᮦᮞᮤᮆᮞ᮪|spésiés	<i>noun</i><br><ol><li>(taxonomy) species</li></ol>
ᮠᮊᮔ᮪|hakan	<i>verb</i><br><ol><li>(Banten) to eat</li></ol>
ᮠᮓᮦ|hadé	<i>adj</i><br><ol><li>good (of people)</li></ol>
ᮠᮔᮩᮒ᮪|haneut	<i>adj</i><br><ol><li>warm</li></ol>
ᮠᮛᮤᮒ|harita	<i>adj</i><br><ol><li>past</li></ol>
ᮠᮜᮤᮙᮥᮔ᮪|halimun	<i>noun</i><br><ol><li>fog</li></ol>
ᮠᮜᮩᮀᮠᮩᮙ᮪|haleungheum	<i>adj</i><br><ol><li>overcast</li></ol>
ᮠᮝᮥ|hawu	<i>noun</i><br><ol><li>stove</li></ol>
ᮠᮞᮩᮕ᮪|haseup	<i>noun</i><br><ol><li>smoke</li></ol>
ᮠᮤᮅ|hiu	<i>noun</i><br><ol><li>shark</li></ol>
ᮠᮤᮏᮤ|hiji	<i>num</i><br><ol><li>one</li></ol>
ᮠᮤᮓᮩᮀ|hideung	<i>noun</i><br><ol><li>black</li></ol>
ᮠᮤᮘᮨᮁ|hiber	<i>verb</i><br><ol><li>to fly</li></ol>
ᮠᮤᮛᮥᮕ᮪|hirup	<i>noun</i><br><ol><li>life</li></ol>
ᮠᮥᮏᮔ᮪|hujan	<i>noun</i><br><ol><li>rain</li></ol>
ᮠᮥᮛᮥ|huru	<i>verb</i><br><ol><li>to burn</li></ol>
ᮠᮦᮏᮧ|héjo	<i>adj</i><br><ol><li>green (having green as its colour)</li></ol><br><i>noun</i><br><ol><li>green (colour)</li></ol>
ᮠᮩᮔ᮪ᮎᮩᮒ᮪|heunceut	<i>noun</i><br><ol><li>(anatomy) vulva</li></ol>
ᮠᮩᮘᮩᮜ᮪|heubeul	<i>adj</i><br><ol><li>old (of an object)</li></ol>
ᮠᮩᮛᮩᮒ᮪|heureut	<i>adj</i><br><ol><li>narrow</li></ol>
