adùbiʼíne|adùbiʼíne III.6	<i>noun</i><br><ol><li>adobe</li></ol>
belísena|belísena III.5|belísene	<i>noun</i><br><ol><li>suitcase, valise</li></ol>
benę̀nuʼúne|benę̀nuʼúne III.6	<i>noun</i><br><ol><li>poison</li></ol>
biną̀greʼéne|biną̀greʼéne III.6	<i>noun</i><br><ol><li>vinegar</li></ol>
butéyoną|butéyoną II.3|butèyo’óne	<i>noun</i><br><ol><li>bottle</li></ol>
bòyiʼína|bòyiʼína III.5|local	<i>noun</i><br><ol><li>valley</li></ol>
bósuną|bósuną III.5|bòsu’úne	<i>noun</i><br><ol><li>glass tumbler, glass</li></ol>
bùtúnena|bùtúnene|bùtúnena III.5	<i>noun</i><br><ol><li>button</li></ol>
bútoną|bùto’óne|bútoną II.3	<i>noun</i><br><ol><li>boot (footwear)</li></ol>
cikulòtiʼína|cikulòtiʼína III.5	<i>noun</i><br><ol><li>chocolate</li></ol>
cìakǫʼóna|cìakǫʼóna III.5|cìakǫ́ne	<i>noun</i><br><ol><li>question</li></ol>
cìatúną|cìatúną II.3|cìatúne	<i>noun</i><br><ol><li>legging</li></ol>
cìatʼáwaną|cìatʼáwaną II.3	<i>noun</i><br><ol><li>knife wheel</li></ol>
cìaʼáne|cìaʼáne III.6	<i>noun</i><br><ol><li>walk</li></ol>
cìbikína|cìbikína I.1|cìbíkiną	<i>noun</i><br><ol><li>robin</li></ol>
cìlithə̀oʼóne|cìlithə̀oʼóne III.6	<i>noun</i><br><ol><li>chili powder</li></ol>
cìlixòyʼȕʼúna|cìlixòyʼȕʼúna III.5	<i>noun</i><br><ol><li>string of chilis</li></ol>
cìliłə̀ʼə́ne|cìliłə̀ʼə́ne III.6	<i>noun</i><br><ol><li>chili soup</li></ol>
cìliʼíne|cìliʼíne III.6	<i>noun</i><br><ol><li>chili</li></ol>
cìp’ȍxwìliʼíne|cìp’ȍxwìliʼíne III duoplural	<i>noun</i><br><ol><li>eyeglasses</li></ol>
cìwyuʼúna|cíwyuną|cìwyuʼúna I.1	<i>noun</i><br><ol><li>bird</li></ol>
cìyúna|cíyuną|cìyúna I.1	<i>noun</i><br><ol><li>mouse (mammal)</li></ol>
cìʼíne|cìʼíne III.6	<i>noun</i><br><ol><li>knot</li></ol>
cínemą|cíne|cínemą II.4	<i>noun</i><br><ol><li>(anatomy) eye</li></ol>
cíwena|cíwena I.2|cìwénemą	<i>noun</i><br><ol><li>eagle (bird)</li></ol>
cíłoʼȕ	<i>noun</i><br><ol><li>(proper name) Little Big-Eye (Trager); Little Bleary-Eye (Parsons)</li></ol>
còhəoʼóna|cóhəoną|còhəoʼóna I.1	<i>noun</i><br><ol><li>witch</li></ol>
cùloʼóna|cùloʼóna I.1|cúloną	<i>noun</i><br><ol><li>dog (mammal)</li></ol>
cùpána|cùpáną|cùpána I.1	<i>noun</i><br><ol><li>judge</li></ol>
cúsǐen	<i>num</i><br><ol><li>seven hundred</li></ol>
cúsǐeną	<i>num</i><br><ol><li>seven hundred</li></ol>
cûdena|cûdena III.5 cȕdéne	<i>noun</i><br><ol><li>shirt</li></ol>
cą̀pienéna|cą̀píenene|cą̀pienéna III.5	<i>noun</i><br><ol><li>yeast</li></ol>
cȅdéna|cȅdéne|cȅdéna III.5	<i>noun</i><br><ol><li>(anatomy) anus</li></ol>
cʼìpána|cʼìpána I.1|cʼípaną	<i>noun</i><br><ol><li>doll</li></ol>
cʼòwowoʼóna|cʼòwowoʼóne|cʼòwowoʼóna III.5	<i>noun</i><br><ol><li>(anatomy) ankle</li></ol>
cʼóne|cʼóne III.6	<i>noun</i><br><ol><li>(anatomy) liver</li></ol>
cʼùwalaʼána|cʼùwalaʼána I.1|cʼúwalaną	<i>noun</i><br><ol><li>squirrel (mammal)</li></ol>
cʼúnena|cʼúnene|cʼúnena III.5	<i>noun</i><br><ol><li>deerhide strip</li></ol>
cʼȁwéna|cʼȁwéna I.2|cʼȁwénemą	<i>noun</i><br><ol><li>bluejay</li></ol>
cʼȕnéna|cʼȕnéna I.1|cʼȕnéną	<i>noun</i><br><ol><li>coyote (mammal)</li></ol>
cʼə́olena	<i>noun</i><br><ol><li>buffalo (mammal) yearling (little and yellowish)</li></ol>
cʼə́otho	<i>postp</i><br><ol><li>in front of</li></ol>
c’ìliyoʼóna|cʼíliyoną|c’ìliyoʼóna I.1	<i>noun</i><br><ol><li>bat (mammal)</li></ol>
gosulínene|gosulínene III.6	<i>noun</i><br><ol><li>gasoline</li></ol>
gòyuʼúna|gòyuʼúna I.1|góyuną	<i>noun</i><br><ol><li>rooster</li></ol>
hálgoną|hàlgo’óne|hálgoną II.3	<i>noun</i><br><ol><li>rug, carpet</li></ol>
hìwkwíalto	<i>particle</i><br><ol><li>Stone Fence (place name)</li></ol>
híli	<i>pron</i><br><ol><li>(interrogative) what</li></ol>
hóbo	<i>particle</i><br><ol><li>also</li></ol>
hónxu	<i>particle</i><br><ol><li>so then</li></ol>
húki	<i>particle</i><br><ol><li>whether</li></ol>
húoloną	<i>noun</i><br><ol><li>(botany) wire weeds (genus Rigiopappus)</li></ol>
húoną	<i>particle</i><br><ol><li>then</li></ol>
húwi	<i>particle</i><br><ol><li>whew!</li></ol>
húxu	<i>particle</i><br><ol><li>and so</li></ol>
hûmo	<i>particle</i><br><ol><li>the north side (of the pueblo)</li></ol>
hûokwimo	<i>particle</i><br><ol><li>the south side (of the pueblo)</li></ol>
hûtho	<i>particle</i><br><ol><li>on the north side (of the pueblo)</li></ol>
hą	<i>particle</i><br><ol><li>yes</li></ol>
hų́łoliną|hų̀łolíne|hų́łoliną II.3	<i>noun</i><br><ol><li>weapon</li></ol>
hų̂nemą|hų̂nemą II.4|hų̂ne	<i>noun</i><br><ol><li>cedar (tree)</li></ol>
hų̏pʼôhaną|hų̏pʼôhaną II.3|hų̏pʼôhane	<i>noun</i><br><ol><li>juniper (tree)</li></ol>
hǫ́lpʼȍno	<i>particle</i><br><ol><li>Santa Fe</li></ol>
hǫ́luną|hǫ̀lu’úne|hǫ́luną II.3	<i>noun</i><br><ol><li>(anatomy) lung</li></ol>
hȕolóna|hȕolóna I.1	<i>noun</i><br><ol><li>quail</li></ol>
hȕthóna|hûthoną|hȕthóna I.1	<i>noun</i><br><ol><li>northsider (i.e. person from north side of the pueblo)</li></ol>
hə́olene|hə́olene III.6	<i>noun</i><br><ol><li>sickness</li></ol>
hə̏olune|hə̏olune III.6	<i>noun</i><br><ol><li>arroyo, canyon</li></ol>
kayúnena|kayúnena III.5|local|kayúnene	<i>noun</i><br><ol><li>canyon</li></ol>
komòlto’óna|komòlto’óna III.5|komòlto’óne|local	<i>noun</i><br><ol><li>bed frame, bedstead</li></ol>
kophà’ąsíne|kophà’ąsíne III.6	<i>noun</i><br><ol><li>commercial sugar</li></ol>
kopháne|kopháne III.6	<i>noun</i><br><ol><li>coffee</li></ol>
kumpàyli’ína|kumpàyli’ína I.1|kumpáyliną	<i>noun</i><br><ol><li>godfather</li></ol>
kumàyli’ína|kumàyli’ína I.1|kumáyliną	<i>noun</i><br><ol><li>godmother</li></ol>
kuyúna	<i>noun</i><br><ol><li>(religion, botany) sacred corn</li></ol>
kwiléna|kwiléna I	<i>noun</i><br><ol><li>girl</li></ol>
kwìawìp’į́ęna|kwìawìp’į́ęne|kwìawìp’į́ęna III.5	<i>noun</i><br><ol><li>racetrack</li></ol>
kwìawíne	<i>noun</i><br><ol><li>race</li></ol>
kwíamena|kwíamena I	<i>noun</i><br><ol><li>(archaic) young woman</li></ol>
kwíanena|kwíanena I.2|kwíanenemą	<i>noun</i><br><ol><li>bitch (mammal)</li></ol>
kwíltoną|kwíltoną II.3|kwìlto’óne	<i>noun</i><br><ol><li>quilt</li></ol>
kwònéne|kwònéne III.6	<i>noun</i><br><ol><li>arrival</li></ol>
kwóna|kwóna III.5|kwóne	<i>noun</i><br><ol><li>axe</li></ol>
kwę̀mų́na|kwę̀mų́na III.5|kwę́mųne	<i>noun</i><br><ol><li>carpenter's apron</li></ol>
kwę̀xòci’ína|kwę̀xòci’ína III.5|kwę̀xòci’íne	<i>noun</i><br><ol><li>bracelet</li></ol>
kwę́na|kwę́nemą|kwę́na I.2	<i>noun</i><br><ol><li>Mexican, Spanish-speaking person</li></ol>
kwę́łoną|kwę́łoną II.3|kwę̀łóne	<i>noun</i><br><ol><li>oak (tree)</li></ol>
kwę́’ogą	<i>particle</i><br><ol><li>among the Mexicans (i.e. Taos city, Taos village)</li></ol>
kwə́lena|kwə́lenemą|kwə́lena I.2	<i>noun</i><br><ol><li>maiden, girl</li></ol>
kw’àyána|kw’àyána I.1|kw’áyaną	<i>noun</i><br><ol><li>magpie</li></ol>
kàsu’úna|kàsu’úna III.5|kàsu’úne	<i>noun</i><br><ol><li>cheese</li></ol>
kàyi’ína|kàyi’ína III.5|kàyi’íne|local	<i>noun</i><br><ol><li>street</li></ol>
kàyúna|káyuną|kàyúna I.1	<i>noun</i><br><ol><li>maternal aunt, mother's sister</li></ol>
ká|form|ká vocative	<i>noun</i><br><ol><li>(diminutive) mommy (used by very young children to mother)</li></ol>
kána|form|ká|kánemą|kána I.2|ká vocative	<i>noun</i><br><ol><li>mother, mother-in-law</li><li>wife (used by husband when speaking to wife)</li><li>mother (used by husband to refer to wife when speaking to his children)</li></ol>
ká’ȕ|ká’ȕ vocative	<i>noun</i><br><ol><li>(diminutive) mommy (used by children to mother)</li><li>(diminutive) wifey (used by husband to wife)</li><li>(diminutive) relatively older woman (by younger speaker to show friendly respect but less common in this sense than łá’ȕ)</li></ol>
kèke’éna|kèke’éne|kèke’éna III.5	<i>noun</i><br><ol><li>cake, cracker</li></ol>
kìłu’úna|kìłu’úna I.1|kíłuną	<i>noun</i><br><ol><li>nephew, niece, younger cousin</li></ol>
kínemą|kíne|kínemą II.4	<i>noun</i><br><ol><li>blanket</li></ol>
kòki’ína	<i>noun</i><br><ol><li>crow (crow)</li></ol>
kòlno’óna|kòlno’óna I.1|kólnoną	<i>noun</i><br><ol><li>badger (mammal)</li></ol>
kòléna|kòléna I.2|kólenemą	<i>noun</i><br><ol><li>wolf (mammal)</li></ol>
kòmpu’úna|kòmpu’úne|kòmpu’úna III.5	<i>noun</i><br><ol><li>camp</li></ol>
kònk’ə́obo	<i>particle</i><br><ol><li>placename for a place where a buffalo turned into stone in ancient times about 0.5 miles east of Taos</li></ol>
kònéna|kònénemą|kònéna I.2	<i>noun</i><br><ol><li>buffalo (mammal)</li></ol>
kòsi’ína|kósiną|kòsi’ína I.1	<i>noun</i><br><ol><li>buffalo cow, cow (mammal)</li></ol>
kòwmą̏celéna|kòwmą̏celéne|kòwmą̏celéna III.5	<i>noun</i><br><ol><li>(anatomy) hoof</li></ol>
kòw’ȕ’úna|kòw’ȕ’úna I.1|ków’uną	<i>noun</i><br><ol><li>colt (young horse)</li></ol>
kò’óne|kò’óne III.6	<i>noun</i><br><ol><li>washing</li></ol>
kówena|kówena I.2|kòwénema	<i>noun</i><br><ol><li>horse (mammal)</li></ol>
kóywona|kóywoną|kóywona I.1	<i>noun</i><br><ol><li>Kiowa Indian</li></ol>
kùcitúone|kùcitúone III.6	<i>noun</i><br><ol><li>pork</li></ol>
kùci’ína|kúciną|kùci’ína I.1	<i>noun</i><br><ol><li>pig (mammal)</li></ol>
kùku’úne|kùku’úne III.6	<i>noun</i><br><ol><li>cocoa</li></ol>
kùli’ína|kùli’ína III.5|kùli’íne	<i>noun</i><br><ol><li>cabbage</li></ol>
kùti’ína|kùti’íne|kùti’ína III.5	<i>noun</i><br><ol><li>coat</li></ol>
kùylulúna|kùylúluną|kùylulúna I.1	<i>noun</i><br><ol><li>skunk (mammal)</li></ol>
kǫyxwę́kimą	<i>verb</i><br><ol><li>you have a tail</li></ol>
kǫ̏wéna|kǫ̏wéna I.2|kǫ̏wénemą	<i>noun</i><br><ol><li>owl</li></ol>
kȕphúone|kȕphúone III.6	<i>noun</i><br><ol><li>act of dropping</li></ol>
kə̀nénemą|kə̀nénemą II.4|kə̀néne	<i>noun</i><br><ol><li>cradle</li></ol>
kə̀obénemą|kə̀obénemą II.4|kə̀obéne	<i>noun</i><br><ol><li>shoe, moccasin</li></ol>
kə́na|kə́ne|kə́na III.5	<i>noun</i><br><ol><li>(anatomy) vulva</li></ol>
kə́ona|kə́ona I.2|kə́onemą	<i>noun</i><br><ol><li>bear (mammal)</li></ol>
kə̏dénemą|kə̏déne|kə̏dénemą II.4	<i>noun</i><br><ol><li>door</li></ol>
k’òwa’ána|k’òwa’ána I.1|k’ówaną	<i>noun</i><br><ol><li>relative</li></ol>
k’ùopána	<i>noun</i><br><ol><li>wool dress</li></ol>
k’ùowoxə́na	<i>noun</i><br><ol><li>(botany) spruce seed</li></ol>
k’ùoxwį́wna	<i>noun</i><br><ol><li>chipmunk (mammal)</li></ol>
k’ùołàxenlo’óna	<i>noun</i><br><ol><li>lizard, horned toad</li></ol>
k’ùo’ȕ’úna|k’ùo’ȕ’úna I.1	<i>noun</i><br><ol><li>lamb (young sheep)</li></ol>
k’úona|k’úona I	<i>noun</i><br><ol><li>sheep (mammal)</li></ol>
k’ȍ’óna	<i>noun</i><br><ol><li>corncob</li></ol>
k’ə́onemą|k’ə́one|k’ə́onemą II.4	<i>noun</i><br><ol><li>(anatomy) neck</li></ol>
k’ə́otho	<i>postp</i><br><ol><li>up on top (as a hill)</li></ol>
lecùgoʼóne|lecùgoʼóne III.6	<i>noun</i><br><ol><li>lettuce</li></ol>
láyna|láyne|láyna III.5|láyną|láyna I.1	<i>noun</i><br><ol><li>king</li><li>law</li></ol>
lìlúna|lìlúna I.1|líluną	<i>noun</i><br><ol><li>chicken; hen</li></ol>
lìmunéna|lìmunéne|lìmunéna III.5	<i>noun</i><br><ol><li>lemon (fruit)</li></ol>
lílena|lìléne|lílena III.5	<i>noun</i><br><ol><li>belt</li></ol>
lúnąsi|lúnąsi uninflected	<i>noun</i><br><ol><li>Monday</li></ol>
moltìyu’úna|moltìyu’úna III.5|moltìyu’úne	<i>noun</i><br><ol><li>hammer</li></ol>
monsònu’úna|monsònu’úne|monsònu’úna III.5	<i>noun</i><br><ol><li>apple tree</li></ol>
mèstu’úna|mèstu’úna I.1|méstuną	<i>noun</i><br><ol><li>teacher</li></ol>
mètu’úna|mètu’úna I.1	<i>noun</i><br><ol><li>teacher</li></ol>
míalkulisi|míalkulisi uninflected	<i>noun</i><br><ol><li>Wednesday</li></ol>
míalnąsi|míalnąsi uninflected	<i>noun</i><br><ol><li>Friday</li></ol>
mílą|míl	<i>num</i><br><ol><li>thousand</li></ol>
móltəsi|móltəsi uninflected	<i>noun</i><br><ol><li>Tuesday</li></ol>
móxwoluną	<i>noun</i><br><ol><li>Wheeler Peak, Taos Peak (highest point in New Mexico)</li></ol>
mùldu’úna|múlduną|mùldu’úna I.1	<i>noun</i><br><ol><li>donkey, burro (mammal)</li></ol>
mùlo’óna|mùlo’óna I.1|múloną	<i>noun</i><br><ol><li>mule (mammal)</li></ol>
mùlso’óna|mùlso’óna III.5|local|mùlso’óne	<i>noun</i><br><ol><li>pocket, purse</li></ol>
mùoli’íne|mùoli’íne III.6	<i>noun</i><br><ol><li>return</li></ol>
mùoya’ána|mùoya’ána I.1|múoyaną	<i>noun</i><br><ol><li>ox, steer (mammal)</li></ol>
múluną	<i>noun</i><br><ol><li>drum, box, jar</li></ol>
múoli	<i>verb</i><br><ol><li>return</li></ol>
mąkìno’óna|mąkìno’óna III.5|mąkìno’óne|local	<i>noun</i><br><ol><li>machine</li></ol>
mą̀kupòpóna|mą̀kupòpóna I.1	<i>noun</i><br><ol><li>wife's elder brother (elder brother-in-law related to wife), younger sister's husband (brother-in-law from younger sister's marriage)</li></ol>
mą́kuna|mą́kuna I.1|mą́ku|mą́kuną	<i>noun</i><br><ol><li>grandchild</li></ol>
mą́wįęna	<i>noun</i><br><ol><li>(botany) corn pollen</li></ol>
mą́łi	<i>num</i><br><ol><li>six</li></ol>
mą́łisǐen	<i>num</i><br><ol><li>six hundred</li></ol>
mą́łisǐeną	<i>num</i><br><ol><li>six hundred</li></ol>
mą̂nmųną|mą̂nmųną II.3|mą̏nmų́ne	<i>noun</i><br><ol><li>glove</li></ol>
mą̏c’élena|mą̏c’élena III.5|mą̏c’élene	<i>noun</i><br><ol><li>(anatomy) fingernail</li></ol>
mą̏nénemą|mą̏nénemą II.4|mą̏néne	<i>noun</i><br><ol><li>(anatomy) hand</li></ol>
mę̀diaxų̀ci’ína|mę̀diaxų̀ci’ína III.5|mę̀diaxų̀ci’íne|local	<i>noun</i><br><ol><li>garter</li></ol>
mę̀sotu’úna|mę̀sotu’úna III.5|alternate duoplural: mę́sotune|mę̀sotu’úne	<i>noun</i><br><ol><li>(religion) church</li></ol>
mę̀so’óna|mę̀so’óna III.5|mę̀so’óne	<i>noun</i><br><ol><li>(religion) (Catholic) mass, church</li></ol>
mę́dianą|mę̀dia’áne|mę́dianą II.3	<i>noun</i><br><ol><li>stocking</li></ol>
mę́soną|mę́soną II.3|mę̀so’óną	<i>noun</i><br><ol><li>table</li></ol>
mį̀yo’óna|mį̀yo’óne|mį̀yo’óna III.5	<i>noun</i><br><ol><li>mile</li></ol>
mį̏mína|mį̏mína I.1|mį̏míną	<i>noun</i><br><ol><li>maternal uncle, mother's brother</li></ol>
mųstúnena|mųstúnene|mųstúnena III.5	<i>noun</i><br><ol><li>button</li></ol>
mų̀si’ína|mų́siną|mų̀si’ína I.1	<i>noun</i><br><ol><li>cat (mammal)</li></ol>
mǫ̀tunéna	<i>noun</i><br><ol><li>button</li></ol>
nábahuna|nábahuną|nábahuna I.1	<i>noun</i><br><ol><li>Navajo Indian</li></ol>
nòdu’úna|nòdu’úna I.1|nóduną	<i>noun</i><br><ol><li>soldier</li></ol>
ną	<i>pron</i><br><ol><li>(first person) I, we</li></ol>
nąłàcit’ə́otuna	<i>noun</i><br><ol><li>thunder</li></ol>
ną̀méne|ną̀méne III.6	<i>noun</i><br><ol><li>soil</li></ol>
ną̀phę́tho	<i>particle</i><br><ol><li>Sandia Pueblo (folk etymological meaning: “place of the cloud hills”, a reference to the sand dunes in the area)</li></ol>
ną̀xù’úna|ną̀xù’úna III.5|ną̀xù’úne	<i>noun</i><br><ol><li>adobe brick</li></ol>
ną́nemą	<i>noun</i><br><ol><li>hill</li></ol>
nų̀tòke’éna|nų̀tòke’éna I	<i>noun</i><br><ol><li>nighthawk</li></ol>
obènu’úne|obènu’úne III.6	<i>noun</i><br><ol><li>oats (wild and domestic)</li></ol>
oxènti’ína|oxènti’ína I.1|oxéntiną	<i>noun</i><br><ol><li>agent, superintendent of Indian agency</li></ol>
phonsàytų’úne|phonsàytų’úne III.6	<i>noun</i><br><ol><li>English (language)</li></ol>
phonsáyna|phonsáyną|phonsáyna I.1	<i>noun</i><br><ol><li>non-Spanish-speaking white man, American</li></ol>
phrútona|phrútona III.5|local	<i>noun</i><br><ol><li>(botany) fruit</li></ol>
phàc’íene	<i>noun</i><br><ol><li>lightning</li></ol>
phà’áne|phà’áne III.6	<i>noun</i><br><ol><li>fire</li></ol>
pháywi	<i>verb</i><br><ol><li>be red</li></ol>
phìayána|phíayaną|phìayána I.1	<i>noun</i><br><ol><li>louse, flea</li></ol>
phìstuléna|phìstuléne|phìstuléna III.5	<i>noun</i><br><ol><li>pin</li></ol>
phò’ína|phò’ína III.5|phò’íne	<i>noun</i><br><ol><li>peach (fruit)</li></ol>
phóna|phóna III.5|phóne	<i>noun</i><br><ol><li>(anatomy) hair</li></ol>
phùolénemą|phùoléne|phùolénemą II.4	<i>noun</i><br><ol><li>yucca</li></ol>
phę́na|phę́ne|phę́na III.5	<i>noun</i><br><ol><li>cloud</li></ol>
phų̀yu’úna|phų̀yu’úna I.1|phų́yuną	<i>noun</i><br><ol><li>fly (insect)</li></ol>
phȉwéna|phȉwéna I.2|phȉwénemą	<i>noun</i><br><ol><li>daughter, daughter-in-law</li><li>any female child or younger female person</li></ol>
phə́yna|phə́yna III.5|phə́yne	<i>noun</i><br><ol><li>(anatomy) nose</li></ol>
piakə̀nénemą|piakə́nene|piakə̀nénemą II.4	<i>noun</i><br><ol><li>(anatomy) chest, heart</li></ol>
pisóloną|pisóloną II.3|pisòlo’óne	<i>noun</i><br><ol><li>blanket</li></ol>
plòso’óna|plòso’óne|plòso’óna III.5	<i>noun</i><br><ol><li>city, town</li><li>the town of Taos</li></ol>
prìmu’úna|prìmu’úna I.1|prímuną	<i>noun</i><br><ol><li>cousin</li></ol>
pulísena|pulísena I.2|pulísenemą	<i>noun</i><br><ol><li>policeman</li></ol>
pànąthóna|pànąthóne|pànąthóna III.5	<i>noun</i><br><ol><li>underwear</li></ol>
páne|páne III.6|pána	<i>noun</i><br><ol><li>clothing</li></ol>
pènku’úna|pénkuną|pènku’úna I.1	<i>noun</i><br><ol><li>orphan</li></ol>
pèro’óna|pèro’óna III.5|pèro’óne	<i>noun</i><br><ol><li>pear (fruit)</li></ol>
pìa’ąsíne|pìa’ąsíne I.1 duoplural	<i>noun</i><br><ol><li>sweethearts</li></ol>
pìwcìayána	<i>noun</i><br><ol><li>tale, story, "dump-telling" (translated thus because the dead were buried in dumps, i.e. refuse mounds in early times)</li></ol>
píana|píane|píana III.5	<i>noun</i><br><ol><li>(anatomy) heart, breast</li></ol>
pòmų́na|pòmų́ne|pòmų́na III.5	<i>noun</i><br><ol><li>trouser leg, trousers/pants</li></ol>
pòpóna|pòpó|póponą|pòpóna I.1	<i>noun</i><br><ol><li>elder brother, elder brother-in-law, elder half-brother, elder stepbrother</li><li>friendly greeting to a man of same or greater age of speaker (mostly used by male speakers)</li></ol>
pòstaléna|pòstaléna III.5	<i>noun</i><br><ol><li>pastry, pie</li></ol>
pòwdo’óne|pòwdo’óne III.6	<i>noun</i><br><ol><li>baking powder</li></ol>
pòxə̀phialúna	<i>noun</i><br><ol><li>pumpkin seed earring</li></ol>
póna|póne|póna III.5	<i>noun</i><br><ol><li>pumpkin</li></ol>
póyuo|form for noun class I|póyuoną	<i>num</i><br><ol><li>three</li></ol>
póyuosǐen	<i>num</i><br><ol><li>three hundred</li></ol>
póyuosǐeną	<i>num</i><br><ol><li>three hundred</li></ol>
pôb’ȕ	<i>noun</i><br><ol><li>(proper name) Little Flower</li></ol>
pùlulúna|pùlulúne|pùlulúna III.5	<i>noun</i><br><ol><li>plum (fruit)</li></ol>
pùohóna|pùohóna III.5|pùohóne	<i>noun</i><br><ol><li>ball</li><li>squawberry ?</li></ol>
pùot’ę́ną|pùot’ę́ną II.3|pùot’ę́ne	<i>noun</i><br><ol><li>basket</li></ol>
pùru’úna|pùru’úne|pùru’úna III.5	<i>noun</i><br><ol><li>cigar</li></ol>
púeloną|púeloną II.3|pùelo’óne	<i>noun</i><br><ol><li>frying pan</li></ol>
púyena|púyena I.2|pùyénemą	<i>noun</i><br><ol><li>friend</li></ol>
pę̀cu’úna|pę̀cu’úna I.1|pę́cuną	<i>noun</i><br><ol><li>rattlesnake</li></ol>
pę̀łȉwéna	<i>noun</i><br><ol><li>doe (mammal)</li></ol>
pę́na|pę́na I.2|pę́nemą	<i>noun</i><br><ol><li>deer (mammal)</li></ol>
pį́ęna|pį́ęne|pį́ęna III.5	<i>noun</i><br><ol><li>road</li></ol>
pį̏ę’éna|pį̏ę’éna III.5|pį̏ę’éne|local	<i>noun</i><br><ol><li>(with local place prefix) bed</li><li>(without local place prefix) mattress, sleeping mat</li></ol>
pų̏’úne	<i>noun</i><br><ol><li>(botany) tall white plants resembling willows</li></ol>
pǫ̀’óne	<i>noun</i><br><ol><li>earth</li></ol>
pǫ̂to	<i>particle</i><br><ol><li>on the earth, on the plains</li></ol>
pǫ̏’óna|pǫ̏’óne|pǫ̏’óna III.5	<i>noun</i><br><ol><li>land, country, the earth</li></ol>
pȉléna	<i>noun</i><br><ol><li>summer</li></ol>
pȉwéna|pȉwénemą|pȉwéna I.2	<i>noun</i><br><ol><li>rabbit (mammal)</li></ol>
pȍbénemą|pȍbénemą II.4|pȍbéne	<i>noun</i><br><ol><li>(botany) flower</li></ol>
pəolénemą	<i>noun</i><br><ol><li>Hopi blanket</li></ol>
pə̏’ə́na|pə̏’ə́nemą|pə̏’ə́na I.2	<i>noun</i><br><ol><li>fish</li></ol>
pʼìtąmúluną	<i>noun</i><br><ol><li>skull</li></ol>
p’àyu’úna|p’àyu’úna I.1|p’áyuną	<i>noun</i><br><ol><li>younger sister</li></ol>
p’ìanwílaną	<i>noun</i><br><ol><li>Picuris Indians</li></ol>
p’íanenemą|p’íanenemą II.4|p’íanene	<i>noun</i><br><ol><li>mountain</li></ol>
p’ínemą|p’ínemą II.4|p’íne	<i>noun</i><br><ol><li>(anatomy) head</li></ol>
p’óna|p’óna III.5|p’óne	<i>noun</i><br><ol><li>moon</li></ol>
p’óyona|p’òyóną|p’óyona I.1	<i>noun</i><br><ol><li>beaver (mammal)</li></ol>
p’ą́nyuo|form for noun class I|p’ą́nyuoną	<i>num</i><br><ol><li>five</li></ol>
p’ą́nyuosǐen	<i>num</i><br><ol><li>five hundred</li></ol>
p’ą́nyuosǐeną	<i>num</i><br><ol><li>five hundred</li></ol>
p’į́wna|p’į́wnemą|p’į́wna I.2	<i>noun</i><br><ol><li>sparrow</li></ol>
p’į́ęna|p’į́ęne|p’į́ęna III.5	<i>noun</i><br><ol><li>road</li></ol>
p’ų́	<i>pron</i><br><ol><li>(interrogative) who</li></ol>
p’ǫ́yna|p’ǫ́yna I.2|p’ǫ́ynemą	<i>noun</i><br><ol><li>younger brother, younger brother-in-law, half-brother, stepbrother</li><li>friendly greeting to younger male</li></ol>
p’ȍcákana	<i>noun</i><br><ol><li>wild goose</li></ol>
p’ȍcíane|p’ȍcíane III.6	<i>noun</i><br><ol><li>ice</li></ol>
p’ȍkúna|p’ȍkúna III.5|p’ȍkúne	<i>noun</i><br><ol><li>loaf of bread</li></ol>
p’ȍk’úowoną|p’ȍk’úowoną II.3	<i>noun</i><br><ol><li>fir, spruce (tree)</li></ol>
p’ȍpíaną	<i>noun</i><br><ol><li>ducks</li></ol>
p’ȍpə́na|p’ȍpə́na III.5|p’ȍpə́ne	<i>noun</i><br><ol><li>sky</li></ol>
p’ȍsį́wną	<i>noun</i><br><ol><li>wild celery (?), watercress (?), wild asparagus (?)</li></ol>
p’ȍtukw’ilóna|p’ȍtukw’ilóne|p’ȍtukw’ilóna III.5	<i>noun</i><br><ol><li>(botany) mint</li></ol>
p’ȍwàya’ána|p’ȍwàya’ána I.1|p’ȍwáyaną	<i>noun</i><br><ol><li>worm</li></ol>
p’ȍxwìli’ína	<i>noun</i><br><ol><li>glass</li></ol>
p’ȍxwíana|p’ȍxwíana I.1|p’ȍxwíaną	<i>noun</i><br><ol><li>egg</li></ol>
p’ȍxúone|p’ȍxúone III.6	<i>noun</i><br><ol><li>steam</li></ol>
p’ȍxəłóna|p’ȍxəłóne|p’ȍxəłóna III.5	<i>noun</i><br><ol><li>star</li></ol>
p’ȍxə̀t’į́ęnemą	<i>noun</i><br><ol><li>abalone bowl</li></ol>
p’ȍłìlap’ȍ’óne	<i>noun</i><br><ol><li>hot springs</li></ol>
p’ȍ’óne|p’ȍ’óne|p’ȍ’óne III.5|p’ȍ’óne III.6	<i>noun</i><br><ol><li>water</li><li>drop of water; river, stream, body of water</li></ol>
p’ȍ’ǫ́yona|p’ȍ’ǫ́yoną|p’ȍ’ǫ́yona I.1	<i>noun</i><br><ol><li>spider</li></ol>
p’ȍ’ȕ’úna	<i>noun</i><br><ol><li>corn mash</li></ol>
p’ə̀o’óne	<i>noun</i><br><ol><li>(botany) fruit, ripe seeds, ripe corn</li></ol>
rarą̀xu’úna|rarą̀xu’úna III.5|rarą̀xu’úne	<i>noun</i><br><ol><li>orange, lemon (fruits)</li></ol>
ràncu’úna|ràncu’úne|ràncu’úna III.5	<i>noun</i><br><ol><li>ranch</li></ol>
sayénuna|sayénuna I.1|sayénuną	<i>noun</i><br><ol><li>Cheyenne Indian</li></ol>
si̋en	<i>num</i><br><ol><li>hundred (only in combination with single digit numbers beside "one"; "one hundred" is formed differently as tę̋tę̌)</li></ol>
si̋eną	<i>num</i><br><ol><li>hundred</li></ol>
supòno’óna|supòno’óna III.5|supòno’óne	<i>noun</i><br><ol><li>bedspring</li></ol>
sédoną|sédoną II.3	<i>noun</i><br><ol><li>silk</li></ol>
sóbolu|sóbolu uninflected	<i>noun</i><br><ol><li>Saturday</li></ol>
sùdo’óne|sùdo’óne III.6	<i>noun</i><br><ol><li>baking soda</li></ol>
sȕléna|sȕlénemą|sȕléna I.2	<i>noun</i><br><ol><li>bluebird (bird)</li></ol>
sə̀onp’óna	<i>noun</i><br><ol><li>January</li></ol>
sə̀oyi’ína|sə̀oyi’ína I.1|sə́oyiną	<i>noun</i><br><ol><li>daughter-in-law</li></ol>
sə́onena|sə̀onénemą|sə́onena I.2	<i>noun</i><br><ol><li>man, husband</li></ol>
telędúnenemą|telędúnene|telędúnenemą II.4	<i>noun</i><br><ol><li>fork</li></ol>
thį̀ę’éna|thį̀ę’éna III.5|thį̀ę’éne	<i>noun</i><br><ol><li>(anatomy) stomach</li></ol>
thǫ́ne|thǫ́ne III.6	<i>noun</i><br><ol><li>act of finding</li></ol>
thǫ̂	<i>verb</i><br><ol><li>find</li></ol>
thȕléna|thȕléne|thȕléna III.5	<i>noun</i><br><ol><li>sun</li></ol>
thə̀łopǫ́na	<i>noun</i><br><ol><li>kiva gopher (mammal)</li></ol>
thə̀łó’oy	<i>adv</i><br><ol><li>(religion) at Big House (the home of the lachina, which is under Blue Lake)</li></ol>
thə́na|thə́na III.5|thə́ne|local	<i>noun</i><br><ol><li>house</li></ol>
thə́tho	<i>particle</i><br><ol><li>in the house</li></ol>
thə̏’ə́na	<i>noun</i><br><ol><li>day</li></ol>
titá|titá vocative	<i>noun</i><br><ol><li>father (by child to father)</li><li>husband (by wife to husband)</li><li>relatively older man (by younger speaker showing friendly respect)</li></ol>
tomòli’ína|tomòli’íne|tomòli’ína III.5	<i>noun</i><br><ol><li>tamale</li></ol>
tràmpi’ína|tràmpi’ína I.1|trámpiną	<i>noun</i><br><ol><li>tramp, thief, bum</li></ol>
tròki’ína|tròki’íne|tròki’ína III.5	<i>noun</i><br><ol><li>truck</li></ol>
tumą̀ti’ína|tumą̀ti’íne|tumą̀ti’ína III.5	<i>noun</i><br><ol><li>tomato</li></ol>
tumį́ku|tumį́ku uninflected	<i>noun</i><br><ol><li>Sunday</li><li>week</li></ol>
tàłułi’ína|táłułiną|tàłułi’ína I.1	<i>noun</i><br><ol><li>grandfather</li></ol>
tà’ána|tá’aną|tà’ána I.1	<i>noun</i><br><ol><li>son-in-law</li></ol>
téne|téne III.6	<i>noun</i><br><ol><li>tea</li></ol>
tìendo’óna|tìendo’óna III.5|local|tìendo’óne	<i>noun</i><br><ol><li>store, shop</li></ol>
tìkiti’ína|tìkiti’íne|tìkiti’ína III.5	<i>noun</i><br><ol><li>ticket</li></ol>
tòbúna|tóbuną|tòbúna I.1	<i>noun</i><br><ol><li>governor of pueblo</li></ol>
tòkeną	<i>noun</i><br><ol><li>hawk</li></ol>
tòpháy’ȕ	<i>noun</i><br><ol><li>(proper name) Red Dancer</li></ol>
tò’óna|tò’ónemą|tò’óna I.2	<i>noun</i><br><ol><li>dancer</li></ol>
tò’óne|tò’óne III.6	<i>noun</i><br><ol><li>dance, dancing</li></ol>
tùlu’úna|túluną|tùlu’úna I.1	<i>noun</i><br><ol><li>bull, ox (mammal)</li></ol>
tùsíwbo	<i>particle</i><br><ol><li>Questa (a city in New Mexico)</li></ol>
tùtúna|tútuną|tùtúna I.1	<i>noun</i><br><ol><li>elder sister</li></ol>
tùxwána|tùxwána I.1|túxwaną	<i>noun</i><br><ol><li>fox, coyote (mammal)</li></ol>
túybu’oyą	<i>particle</i><br><ol><li>(moving) eastward</li></ol>
túykwitho	<i>particle</i><br><ol><li>south down the mountain</li></ol>
túynąw	<i>particle</i><br><ol><li>west</li></ol>
túy’ugą	<i>particle</i><br><ol><li>being north (of something)</li></ol>
túłoną|tùłóne|túłoną II.3	<i>noun</i><br><ol><li>tree</li><li>cottonwood (tree)</li></ol>
tûoyoną|tȕoyo’óne|tûoyoną II.3	<i>noun</i><br><ol><li>towel</li></ol>
tą̀tə̀’ə́wyu	<i>name</i><br><ol><li>a being in a traditional tale; the name is translated as "Seed-Marked Boy" by Trager, as "Printed-Red Boy, Spotted Corn Boy" by Parsons</li></ol>
tą́na|tą́na III.5|tą́ne	<i>noun</i><br><ol><li>bean</li></ol>
tę̀’éne|tę̀’éne III.6	<i>noun</i><br><ol><li>act of cutting</li></ol>
tę̋tę̌	<i>num</i><br><ol><li>one hundred</li></ol>
tį̀ęndo’óna|tį̀ęndo’óna III.5|tį̀ęndo’óne|local	<i>noun</i><br><ol><li>store, shop</li></ol>
tų̀łu’úna|tų̀łu’úna I.1|tų́łuną	<i>noun</i><br><ol><li>paternal uncle, father's brother, elder cousin</li></ol>
tų́łęną|tų́łęną II.3|tų̀łę́ne	<i>noun</i><br><ol><li>birch (tree)</li></ol>
tǫ̂mą|tǫ̂m|tǫ̂mą vocative|tǫ̂m vocative	<i>noun</i><br><ol><li>father (by child to father)</li><li>husband (by wife to husband)</li><li>relatively older man (by younger speaker showing friendly respect)</li></ol>
tǫ̂m’ȕ|tǫ̂m’ȕ vocative	<i>noun</i><br><ol><li>(diminutive) daddy (used by children to father)</li><li>(diminutive) hubby (used by wife to husband)</li></ol>
tǫ̏ména|tǫ̏ména I.2|tǫ̂mą vocative|tǫ̂m vocative|tǫ̏ménemą|tǫ̂m|tǫ̂mą	<i>noun</i><br><ol><li>father, father-in-law</li><li>husband (used by mother to refer husband when speaking to her children)</li></ol>
tǫ̏’one	<i>noun</i><br><ol><li>(botany) snakewood, dogwood</li></ol>
tȕculóna|tȕculóna I.1|tûculoną	<i>noun</i><br><ol><li>hummingbird</li></ol>
tə̀ot’ų́nena	<i>noun</i><br><ol><li>town chief, house chief</li></ol>
tə́bu	<i>particle</i><br><ol><li>direction of the mountain Taos Peak (which is in the northeast)</li><li>east (true east)</li></ol>
tə́kwitho	<i>particle</i><br><ol><li>south</li></ol>
tə́nąwą	<i>particle</i><br><ol><li>west</li></ol>
tə́wt’o	<i>particle</i><br><ol><li>northward</li></ol>
tə́ybobo	<i>particle</i><br><ol><li>east up the creek</li></ol>
tə́ybo’oyą	<i>particle</i><br><ol><li>eastward</li></ol>
tə́ynąwą	<i>particle</i><br><ol><li>down the west hill</li></ol>
tə́y’uk’u	<i>particle</i><br><ol><li>north up the hill</li></ol>
tə́ʼutho	<i>particle</i><br><ol><li>north</li></ol>
tə̂obo	<i>particle</i><br><ol><li>to the village, toward the village, Taos pueblo</li></ol>
tə̂otho	<i>particle</i><br><ol><li>in the village, at the village, Taos pueblo</li></ol>
tʼàmų́na|tʼàmų́ne|tʼàmų́na III.5	<i>noun</i><br><ol><li>(anatomy) cheek</li></ol>
tʼáwaną|tʼáwaną II.3|tʼáwane	<i>noun</i><br><ol><li>wheel</li></ol>
tʼòyłóna|tʼòyłóna I.1|tʼóyłoną	<i>noun</i><br><ol><li>giant</li></ol>
tʼóyna|tʼóyna I.2|tʼóynemą	<i>noun</i><br><ol><li>people, person, human being, American Indian, Taos Indians</li></ol>
tʼółəona|tʼółəone|tʼółəona III.5	<i>noun</i><br><ol><li>(anatomy) ear</li></ol>
tʼę̋	<i>verb</i><br><ol><li>cut</li></ol>
tʼő	<i>verb</i><br><ol><li>dance</li><li>do, make</li></ol>
tʼə̀odmúluną|tʼə̀odmúluną II.3	<i>noun</i><br><ol><li>basket, pot-shaped container, basket water jar</li></ol>
upę̀yuʼúna|úpęyuną|upę̀yuʼúna I.1	<i>noun</i><br><ol><li>girl</li></ol>
upę́lena	<i>noun</i><br><ol><li>lightning</li></ol>
woléne	<i>noun</i><br><ol><li>medicine</li></ol>
wàltoʼóna|wàltoʼóna III.5|wàltoʼóne|local	<i>noun</i><br><ol><li>garden</li></ol>
wána|wáne|wána III.5	<i>noun</i><br><ol><li>(anatomy) penis</li></ol>
wíansǐen	<i>num</i><br><ol><li>four hundred</li></ol>
wíansǐeną	<i>num</i><br><ol><li>four hundred</li></ol>
wíaną	<i>num</i><br><ol><li>four</li></ol>
wílatho	<i>particle</i><br><ol><li>Picuris Pueblo; literally, "at the pass", referring to location of the pueblo near the west end of a pass leading to the Great Plains</li></ol>
wísǐen	<i>num</i><br><ol><li>two hundred</li></ol>
wísǐeną	<i>num</i><br><ol><li>two hundred</li></ol>
wíʼiną	<i>num</i><br><ol><li>two</li></ol>
wóną	<i>verb</i><br><ol><li>drop</li></ol>
wę̀puopʼôto	<i>particle</i><br><ol><li>Pine-Near-Water (place name)</li></ol>
wę̀ʼénemą|wę̀ʼénemą II.4|wę̀ʼéne	<i>noun</i><br><ol><li>pine (tree)</li></ol>
wǫ́	<i>verb</i><br><ol><li>blow</li></ol>
wǫ́nemą|wǫ́nemą II.4	<i>noun</i><br><ol><li>wind</li></ol>
xomúnenemą|xomúnenemą II.4|xomúnene	<i>noun</i><br><ol><li>ham</li></ol>
xwábasi|xwábasi uninflected	<i>noun</i><br><ol><li>Thursday</li></ol>
xwílena|xwílena III.5|xwìléne	<i>noun</i><br><ol><li>bow</li></ol>
xwíli	<i>num</i><br><ol><li>eight</li></ol>
xwílisǐen	<i>num</i><br><ol><li>eight hundred</li></ol>
xwílisǐeną	<i>num</i><br><ol><li>eight hundred</li></ol>
xwę́na	<i>noun</i><br><ol><li>(anatomy) tail</li></ol>
xwį́ęsǐen	<i>num</i><br><ol><li>nine hundred</li></ol>
xwį́ęsǐeną	<i>num</i><br><ol><li>nine hundred</li></ol>
xína|xínemą|xína I.2	<i>noun</i><br><ol><li>watchman</li></ol>
xíwana	<i>noun</i><br><ol><li>Apache Indian</li></ol>
xónemą|xóne|xónemą II.4	<i>noun</i><br><ol><li>(anatomy) arm</li></ol>
xę̀młòxòyłùomų́na	<i>noun</i><br><ol><li>big mountain lion skin quiver</li></ol>
xų̀pʼíną|xų̀pʼíne|xų̀pʼíną II.3	<i>noun</i><br><ol><li>(anatomy) knee</li></ol>
xų́nemą|xų́nemą II.4|xų́ne	<i>noun</i><br><ol><li>(anatomy) leg</li></ol>
yàwoʼóna|yáwoną|yàwoʼóna I.1	<i>noun</i><br><ol><li>mare (mammal)</li></ol>
yía	<i>verb</i><br><ol><li>walk</li></ol>
yíane	<i>particle</i><br><ol><li>then</li></ol>
yíanexǫ	<i>particle</i><br><ol><li>then, then indeed</li></ol>
yòtʼő	<i>verb</i><br><ol><li>sing, make a song, make a singing</li></ol>
yòʼóna|yòʼóna I	<i>noun</i><br><ol><li>singer</li></ol>
yòʼónemą|yòʼónemą II.4|yòʼóne	<i>noun</i><br><ol><li>song</li></ol>
yúhi	<i>particle</i><br><ol><li>perhaps</li></ol>
yúwi	<i>particle</i><br><ol><li>whew!</li></ol>
yúwolaną|yúwolaną II.3|yùwola’áne	<i>noun</i><br><ol><li>skirt</li></ol>
àłuʼúna|àłuʼúna I.1|áłuną	<i>noun</i><br><ol><li>paternal grandmother, father's mother</li></ol>
ìałophàymųpʼȍhəothəltʼóynemą	<i>noun</i><br><ol><li>(ceremonial) Taos people (literally: "Red Willows Canyon People", "Canyon of the Red Willows People")</li></ol>
íałoną|íałoną II.3|ìałóne	<i>noun</i><br><ol><li>willow (tree)</li></ol>
ílena	<i>noun</i><br><ol><li>bundle</li></ol>
òʼílena	<i>noun</i><br><ol><li>metate bundle</li><li>Metate Bundle (a being in a traditional tale)</li></ol>
ó	<i>verb</i><br><ol><li>wash</li></ol>
óna	<i>noun</i><br><ol><li>metate</li></ol>
ùboʼóna|ùboʼóne|ùboʼóna III.5	<i>noun</i><br><ol><li>grape, raisin (fruit)</li></ol>
ùdmiléna|ùdmiléna III.5	<i>noun</i><br><ol><li>oatmeal</li></ol>
ùlitʼáwaną|ùlitʼàwaʼáne|ùlitʼáwaną II.3	<i>noun</i><br><ol><li>tire</li></ol>
ùroʼóna|ùroʼóne|ùroʼóna III.5|local	<i>noun</i><br><ol><li>hour</li></ol>
ùruʼúna|ùruʼúna III.5	<i>noun</i><br><ol><li>gold object, gold (the substance)</li></ol>
ùyphaʼána|ùyphaʼáne|ùyphaʼána III.5	<i>noun</i><br><ol><li>burning coal</li></ol>
úliną|úliną II.3|úline	<i>noun</i><br><ol><li>In singular: rubber (object); in duoplural: rubber (the substance), rubber (objects)</li></ol>
úyna|úyne|úyna III.5	<i>noun</i><br><ol><li>charcoal</li></ol>
ûphuo	<i>verb</i><br><ol><li>drop</li></ol>
ą́wąn	<i>pron</i><br><ol><li>(third person) he, she, it, they</li></ol>
ą́wąną	<i>pron</i><br><ol><li>(third person) he, she, it, they</li></ol>
ę́nemą|ę́nemą II.4|ę́ne	<i>noun</i><br><ol><li>(anatomy) shoulder</li></ol>
ę̋	<i>pron</i><br><ol><li>(second person) you</li></ol>
į̀ękǫ́ne|form|į̀ękǫ́ne III.6|į̀ękǫ́na	<i>noun</i><br><ol><li>hail</li></ol>
į̀ęmęʼéna|į̀ęmęʼéna I.1|į́ęmęną	<i>noun</i><br><ol><li>paternal aunt, father's sister</li></ol>
į̂ęthuną|į̂ęthuną II.3|į̏ęthu’úne	<i>noun</i><br><ol><li>ladder</li></ol>
į̏ęmę̀kiʼína	<i>noun</i><br><ol><li>ant</li></ol>
į̏ęnénemą|į̏ęnénemą II.4|į̏ęnéne	<i>noun</i><br><ol><li>(anatomy) foot</li></ol>
łitǫ́ne|łitǫ́ne III.6	<i>noun</i><br><ol><li>(botany) wheat</li></ol>
łàcisə́onenemą|łàcisə́onenemą I.2 duoplural	<i>noun</i><br><ol><li>(religion) kachina men</li></ol>
łácianą	<i>noun</i><br><ol><li>tale, story</li></ol>
łáne|łáne III.6	<i>noun</i><br><ol><li>(botany) tobacco</li></ol>
łáwkwimo	<i>particle</i><br><ol><li>the south side (of the pueblo)</li></ol>
łáʼȕ|łáʼȕ vocative	<i>noun</i><br><ol><li>mommy (used by children to mother)</li><li>wifey (used by husband to wife)</li><li>maternal aunt (by younger niece to aunt)</li><li>relatively older woman (very commonly used by younger speaker to show friendly respect)</li></ol>
łìtúna|łítu|łítu I.1|łìtúna I.1|łítuną	<i>noun</i><br><ol><li>maternal grandmother (mother's mother), maternal great-grandmother (mother's father's mother or mother's mother's mother)</li><li>older woman (used by younger speaker to any older woman in friendly respect)</li></ol>
łíne|łíne III.6	<i>noun</i><br><ol><li>(botany) grass</li></ol>
łòkʼútuną	<i>noun</i><br><ol><li>wooden spoon</li></ol>
łòmų́ną|łòmų́ną II.3|łòmų́ne	<i>noun</i><br><ol><li>(anatomy) mouth</li></ol>
łòthə́na|łòthə́na III.5|łòthə́ne|local	<i>noun</i><br><ol><li>boat</li></ol>
łòtúna	<i>noun</i><br><ol><li>wagon</li></ol>
łòwatúną|łòwatúną II.3|łòwatúne	<i>noun</i><br><ol><li>chief's cane</li></ol>
łòwaʼána	<i>noun</i><br><ol><li>chief</li></ol>
łòxwóloną|łòxwóloną II.3|łòxwòlóne	<i>noun</i><br><ol><li>window</li></ol>
łòxóyna|łòxóyna III.5|łòxóyne	<i>noun</i><br><ol><li>(anatomy) lip</li></ol>
łòʼóne|łòʼóne III.6	<i>noun</i><br><ol><li>wood</li></ol>
łó	<i>verb</i><br><ol><li>(in compounds) be big</li></ol>
łùléne|łùléne III.5|łùléne III.6|łùléna|łùléne	<i>noun</i><br><ol><li>rain</li><li>raindrop</li></ol>
łùłiʼína|łùłiʼína I.2|łùłiʼínemą	<i>noun</i><br><ol><li>old man</li></ol>
łúna|łúne|łúna III.5	<i>noun</i><br><ol><li>piece of buckskin</li></ol>
łúonemą|łúonemą II.4|łúone	<i>noun</i><br><ol><li>arrow</li></ol>
łę́newą	<i>noun</i><br><ol><li>(botany) cactus</li></ol>
łȉwéna|łȉwéna I.2|łȉwénemą	<i>noun</i><br><ol><li>woman</li><li>wife</li><li>(in compounds) female</li></ol>
łȉwʼȕʼúna|łȉwʼȕʼúna I	<i>noun</i><br><ol><li>(little) old woman</li></ol>
ȉacǫ̀lekwíame	<i>noun</i><br><ol><li>(religion) (proper name) Blue Corn Woman</li></ol>
ȉacʼùlekwíame	<i>noun</i><br><ol><li>(religion) (proper name) Yellow Corn Woman</li></ol>
ȉaʼáne|ȉaʼáne III.6	<i>noun</i><br><ol><li>corn</li></ol>
ȍdénemą|ȍdénemą II.4|ȍdéne	<i>noun</i><br><ol><li>(anatomy) chin, jaw</li></ol>
ȕpʼiléna|ȕpʼiléna I.2|ȕpʼilénemą	<i>noun</i><br><ol><li>baby</li></ol>
ȕsú|ȕsú vocative	<i>noun</i><br><ol><li>younger brother, younger brother-in-law, half-brother, stepbrother</li></ol>
ȕłęłęʼéna|ûłęłęną|ȕłęłęʼéna I.1	<i>noun</i><br><ol><li>youth, young man</li></ol>
ȕʼúna|ȕʼúnemą|ȕʼúnemą I.2|of ȕʼúna|ȕʼúna I.2	<i>noun</i><br><ol><li>son</li><li>child</li><li>son-in-law</li><li>offspring</li><li>any male child or younger male person</li><li>children</li><li>family (children, wife, and other household members)</li><li>(in compounds) little one (has the content of a diminutive or affection)</li></ol>
ȕʼúnemą|ȕʼúnemą I.2|of ȕʼúna	<i>noun</i><br><ol><li>sons, children, sons-in-law</li><li>offspring</li><li>any male children or younger male persons</li><li>little ones (has the content of a diminutive or affection in compounds)</li><li>family (children, wife, and other household members)</li></ol>
ə̀wyuʼúna|ə́wyuną|ə̀wyuʼúna I.1	<i>noun</i><br><ol><li>boy</li></ol>
ə̂bena|ə̂bena III.5|ə̏béne	<i>noun</i><br><ol><li>cherry (fruit)</li></ol>
ə̂na|ə̂na III.5|ə̂ne|local	<i>noun</i><br><ol><li>(botany) leaf</li></ol>
ə̂łì	<i>noun</i><br><ol><li>(proper name) Grass Leaf</li></ol>
