Ahad	<i>noun</i><br><ol><li>Sunday</li></ol>
Awrusalam	<i>noun</i><br><ol><li>Jerusalem</li></ol>
Daud	<i>name</i><br><ol><li>David (king of Judah)</li></ol>
Isnin	<i>noun</i><br><ol><li>Monday</li></ol>
Istanbul	<i>name</i><br><ol><li>Istanbul</li></ol>
Jawa	<i>name</i><br><ol><li>Java</li></ol>
Jumaat	<i>noun</i><br><ol><li>Friday</li></ol>
Makka	<i>name</i><br><ol><li>Mecca</li></ol>
Misil	<i>name</i><br><ol><li>Egypt</li></ol>
Nū	<i>name</i><br><ol><li>Noah</li></ol>
Salasa	<i>noun</i><br><ol><li>Tuesday</li></ol>
Sūg	<i>name</i><br><ol><li>Jolo (an island in Sulu, Philippines)</li><li>Tausug area</li></ol>
Tausug	<i>name</i><br><ol><li>The Tausug people, an ethnic group who live mainly in Sulu, other parts of Mindanao, Indonesia and Malaysia.</li></ol>
Yahudi	<i>noun</i><br><ol><li>Jew</li></ol>
abaga	<i>noun</i><br><ol><li>shoulder</li></ol>
abu	<i>noun</i><br><ol><li>ashes</li></ol>
abuhan	<i>noun</i><br><ol><li>stove</li></ol>
ad|ād	<i>noun</i><br><ol><li>fence</li><li>wall</li></ol>
adab	<i>noun</i><br><ol><li>manners</li></ol>
adlaw	<i>noun</i><br><ol><li>day</li></ol>
adlaw-adlaw	<i>adv</i><br><ol><li>every day</li></ol>
agap	<i>noun</i><br><ol><li>parrot</li></ol>
agasi	<i>noun</i><br><ol><li>ogre, legendary giant</li></ol>
agung	<i>noun</i><br><ol><li>brazen gong</li></ol>
ajab	<i>noun</i><br><ol><li>curse</li></ol>
akkal	<i>noun</i><br><ol><li>intellect</li></ol>
aku	<i>pron</i><br><ol><li>I</li></ol>
alkansiya	<i>noun</i><br><ol><li>piggy bank</li></ol>
alpa	<i>noun</i><br><ol><li>harp</li></ol>
alupan	<i>noun</i><br><ol><li>front (of something)</li><li>(euphemistic) private parts</li></ol>
aluwa	<i>noun</i><br><ol><li>spirit (usually of a dead person)</li></ol>
ama	<i>noun</i><br><ol><li>father</li></ol>
aman	<i>verb</i><br><ol><li>to boil</li></ol>
ambak	<i>noun</i><br><ol><li>frog</li></ol>
ambaw	<i>noun</i><br><ol><li>mouse, rat, vermin</li></ol>
amu	<i>noun</i><br><ol><li>monkey</li></ol>
anak	<i>noun</i><br><ol><li>child</li><li>offspring</li></ol>
anak-kampung	<i>noun</i><br><ol><li>relatives</li></ol>
anay	<i>noun</i><br><ol><li>termite</li></ol>
andukang	<i>noun</i><br><ol><li>buffoon; clown</li></ol>
andum	<i>noun</i><br><ol><li>dark cloud</li></ol>
ani	<i>noun</i><br><ol><li>harvest</li></ol>
anjibi	<i>noun</i><br><ol><li>dye; coloring</li></ol>
antib	<i>noun</i><br><ol><li>granary; storage barn</li></ol>
antil	<i>noun</i><br><ol><li>smelly pus from one's ear</li></ol>
apam	<i>noun</i><br><ol><li>pancake</li></ol>
apdu	<i>noun</i><br><ol><li>gall; bile</li></ol>
api	<i>noun</i><br><ol><li>fire</li></ol>
apul	<i>noun</i><br><ol><li>coagulated blood</li></ol>
apus	<i>noun</i><br><ol><li>gambling</li></ol>
araru	<i>noun</i><br><ol><li>plow</li></ol>
asam	<i>noun</i><br><ol><li>tamarind</li></ol>
asang	<i>noun</i><br><ol><li>gills (of a fish)</li></ol>
asawa	<i>noun</i><br><ol><li>wife</li></ol>
asin	<i>noun</i><br><ol><li>salt</li></ol>
aslag	<i>noun</i><br><ol><li>thickness</li></ol>
assang	<i>noun</i><br><ol><li>pigeon</li></ol>
asu	<i>noun</i><br><ol><li>smoke</li><li>steam, vapor</li></ol>
atal	<i>noun</i><br><ol><li>lipstick</li></ol>
atay	<i>noun</i><br><ol><li>liver</li></ol>
atay-itum	<i>noun</i><br><ol><li>treachery</li></ol>
atis	<i>noun</i><br><ol><li>sugar apple (Annona squamosa)</li></ol>
atu	<i>noun</i><br><ol><li>enemy; opponent</li></ol>
atup	<i>noun</i><br><ol><li>roof</li></ol>
awwal	<i>noun</i><br><ol><li>origin</li></ol>
ayl	<i>noun</i><br><ol><li>(Islam) ablution</li></ol>
baat	<i>noun</i><br><ol><li>A kind of ballad or song sung in Tausug for entertainment or self-enjoyment, which deals with the themes of love, sadness, or joy and is frequently sung to the bride or groom at weddings.</li></ol>
babai	<i>noun</i><br><ol><li>woman</li></ol>
babat	<i>noun</i><br><ol><li>(derogatory) belly</li></ol>
babayu	<i>noun</i><br><ol><li>small pestle</li></ol>
babbal	<i>adj</i><br><ol><li>foolish; stupid; idiotic</li></ol>
babuy	<i>noun</i><br><ol><li>pig</li></ol>
bagid	<i>noun</i><br><ol><li>match (for lighting fires)</li></ol>
bagu	<i>adj</i><br><ol><li>new</li></ol>
bagunbun	<i>noun</i><br><ol><li>dust</li></ol>
bahasa	<i>noun</i><br><ol><li>language</li></ol>
bahu	<i>noun</i><br><ol><li>smell; odor</li></ol>
baka	<i>noun</i><br><ol><li>cow</li></ol>
baldi	<i>noun</i><br><ol><li>bucket, pail</li></ol>
balik	<i>verb</i><br><ol><li>to repeat</li></ol>
balu	<i>noun</i><br><ol><li>widow</li></ol>
bana	<i>noun</i><br><ol><li>husband</li></ol>
bangaw|bāngaw	<i>noun</i><br><ol><li>raibow</li></ol>
bangka	<i>noun</i><br><ol><li>a boat; a canoe</li></ol>
bangkay	<i>noun</i><br><ol><li>corpse</li></ol>
bantuk	<i>noun</i><br><ol><li>shape</li></ol>
banyaga'	<i>noun</i><br><ol><li>slave</li></ol>
basa	<i>adj</i><br><ol><li>wet</li></ol>
basag	
bastun	<i>noun</i><br><ol><li>cane, walking stick</li></ol>
bata	<i>noun</i><br><ol><li>child</li></ol>
batu	<i>noun</i><br><ol><li>stone</li></ol>
batung	<i>noun</i><br><ol><li>bean</li></ol>
bay|bāy	<i>noun</i><br><ol><li>house</li></ol>
bayad|magbayad	<i>noun</i><br><ol><li>payment</li></ol><br><i>verb</i><br><ol><li>to pay</li></ol>
bibang	<i>noun</i><br><ol><li>monitor lizard</li></ol>
bigi	<i>noun</i><br><ol><li>seed</li></ol>
bii	<i>verb</i><br><ol><li>to buy</li></ol>
bilik	<i>noun</i><br><ol><li>room</li></ol>
bingit	<i>noun</i><br><ol><li>fishhook</li></ol>
bituanan	<i>noun</i><br><ol><li>A type of confection with spicy fillings.</li><li>divorcee</li></ol>
bituun	<i>noun</i><br><ol><li>star</li></ol>
buaya	<i>noun</i><br><ol><li>crocodile</li></ol>
bud|būd	<i>noun</i><br><ol><li>mountain</li></ol>
bugas	<i>noun</i><br><ol><li>rice (husked)</li></ol>
bugsay	<i>noun</i><br><ol><li>oar; paddle</li></ol>
buhangin	<i>noun</i><br><ol><li>sand</li></ol>
buhuk	<i>noun</i><br><ol><li>hair</li></ol>
bukug	<i>noun</i><br><ol><li>bone</li></ol>
bulan	<i>noun</i><br><ol><li>moon (largest natural satellite of planet Earth)</li><li>moon (any substantially sized natural satellite of a planet)</li><li>month (period into which a year is divided)</li></ol>
bulawan	<i>noun</i><br><ol><li>gold</li></ol>
bulbul	<i>noun</i><br><ol><li>fur, hair</li><li>feather</li></ol>
buli	<i>noun</i><br><ol><li>buttocks</li></ol>
bunga	<i>noun</i><br><ol><li>fruit</li></ol>
buntul atay	<i>noun</i><br><ol><li>honesty</li></ol>
bunu|bunu'	<i>verb</i><br><ol><li>to kill</li></ol>
bunut	<i>noun</i><br><ol><li>coconut husk</li></ol>
buta	<i>adj</i><br><ol><li>blind</li></ol>
buwa'	<i>noun</i><br><ol><li>large, shallow gong (usually struck when there is an emergency)</li></ol>
buwaran	<i>noun</i><br><ol><li>clothesline</li></ol>
buwis	<i>noun</i><br><ol><li>tribute</li></ol>
bāng	<i>noun</i><br><ol><li>(Islam) call to prayer</li></ol>
būd	
dagang	<i>verb</i><br><ol><li>to sell</li></ol>
dagat	<i>noun</i><br><ol><li>sea</li></ol>
dahal	<i>adj</i><br><ol><li>greedy; gluttonous</li></ol>
dahun	<i>noun</i><br><ol><li>leaf</li></ol>
daira	<i>noun</i><br><ol><li>city, sizeable town</li></ol>
dakula	<i>adj</i><br><ol><li>big</li></ol>
dalima'	<i>noun</i><br><ol><li>pomegranate</li></ol>
dan|dān	<i>adj</i><br><ol><li>old (of things)</li></ol><br><i>noun</i><br><ol><li>path; trail; way</li></ol>
dangdang	<i>verb</i><br><ol><li>to roast (meat or fish); to broil</li></ol>
dangin	<i>noun</i><br><ol><li>someone or people invited to help</li></ol>
datag	<i>adj</i><br><ol><li>flat</li></ol>
datung	<i>verb</i><br><ol><li>to arrive</li></ol>
daugdug	<i>noun</i><br><ol><li>thunder</li></ol>
dawa	<i>noun</i><br><ol><li>millet</li></ol>
di	<i>adv</i><br><ol><li>not</li></ol>
dila	<i>noun</i><br><ol><li>(anatomy) tongue</li></ol>
dinding	<i>noun</i><br><ol><li>inner wall of a house</li></ol>
dugu|magdugu	<i>noun</i><br><ol><li>blood</li></ol><br><i>verb</i><br><ol><li>to bleed</li></ol>
dukka	<i>noun</i><br><ol><li>grief, woe</li><li>tribulation</li></ol>
dulangdulang	<i>noun</i><br><ol><li>(anatomy) palate</li></ol>
dulaw	<i>noun</i><br><ol><li>turmeric</li></ol>
dum	<i>noun</i><br><ol><li>night</li></ol>
dungug|magdungug	<i>verb</i><br><ol><li>to hear; to listen</li></ol>
dunuk	<i>noun</i><br><ol><li>flood</li></ol>
dunya|دنيا	<i>noun</i><br><ol><li>world</li></ol>
duru	<i>noun</i><br><ol><li>breast</li></ol>
durul	<i>noun</i><br><ol><li>An indigenous confection usually made of powdered rice, powdered corn or flour mixed with coconut milk and sugar.</li></ol>
dusa	<i>noun</i><br><ol><li>sin</li><li>crime</li><li>guilt, fault</li></ol>
duwa	<i>num</i><br><ol><li>two</li></ol>
duyung	<i>noun</i><br><ol><li>dugong</li></ol>
dūm	
dūyan	<i>noun</i><br><ol><li>durian</li></ol>
gabun	<i>noun</i><br><ol><li>cloud</li></ol>
gaddung	<i>adj</i><br><ol><li>green</li></ol>
gallang	<i>noun</i><br><ol><li>bracelet</li></ol>
gamut	<i>noun</i><br><ol><li>root</li></ol>
gandang	<i>noun</i><br><ol><li>kendhang, drum</li></ol>
gapas	<i>noun</i><br><ol><li>cotton</li></ol>
garing	<i>noun</i><br><ol><li>ivory</li></ol>
gatas	<i>noun</i><br><ol><li>milk</li></ol>
gatus	<i>num</i><br><ol><li>hundred</li></ol>
gawang	<i>noun</i><br><ol><li>pitfall, hidden trap</li><li>hole</li></ol>
gayung	<i>noun</i><br><ol><li>dipper, ladle</li></ol>
giling	<i>verb</i><br><ol><li>to turn</li></ol>
gilingan	<i>noun</i><br><ol><li>grinder</li></ol>
guling	<i>verb</i><br><ol><li>to sauté</li></ol>
gusuk	<i>noun</i><br><ol><li>rib</li></ol>
gutas	<i>noun</i><br><ol><li>hunger, starvation</li></ol>
gutum	<i>noun</i><br><ol><li>famine, starvation</li></ol>
hagdan	<i>noun</i><br><ol><li>ladder</li><li>stairs; stairway; staircase</li></ol>
haggut atay	<i>noun</i><br><ol><li>calmness</li></ol>
halga	<i>noun</i><br><ol><li>price</li></ol>
halu	<i>noun</i><br><ol><li>pestle</li></ol>
hamut	<i>noun</i><br><ol><li>nice smell; scent; fragrance</li></ol>
hangin	<i>noun</i><br><ol><li>wind (movement of air)</li></ol>
hangpu'	<i>num</i><br><ol><li>ten</li></ol>
hapak	<i>noun</i><br><ol><li>dryness (of hair)</li></ol><br><i>verb</i><br><ol><li>to become dry (of hair)</li></ol>
harapan	<i>noun</i><br><ol><li>the front (of something)</li></ol>
harat	<i>noun</i><br><ol><li>acridness, bitterness</li></ol>
has|hās	<i>noun</i><br><ol><li>snake</li></ol>
hasa	<i>verb</i><br><ol><li>to sharpen, to whet</li></ol>
hasaan	<i>noun</i><br><ol><li>whetstone</li></ol>
hasang	<i>noun</i><br><ol><li>gills (of a fish)</li></ol>
hilam	<i>noun</i><br><ol><li>mosquito</li></ol>
hilu	<i>noun</i><br><ol><li>dizziness, seasickness, drunkenness</li><li>confusion (of mind)</li><li>trouble, disturbance</li></ol><br><i>adj</i><br><ol><li>dizzy, seasick, drunk</li><li>confused, disturbed</li></ol>
hugas	<i>verb</i><br><ol><li>to wash</li><li>to clean</li></ol>
hukuman	<i>noun</i><br><ol><li>judgement, decision (of a court)</li></ol>
hula|maghula	<i>verb</i><br><ol><li>to live somewehere, to dwell</li></ol>
hulaan	<i>noun</i><br><ol><li>place of residence</li></ol>
hulas	<i>noun</i><br><ol><li>sweat; perspiration</li></ol>
hulat	<i>noun</i><br><ol><li>stopper, plug, cork</li></ol>
hulug	<i>verb</i><br><ol><li>to fall</li></ol>
humay	<i>noun</i><br><ol><li>rice (cooked)</li><li>Spiced cooked rice with yellow coloring wrapped in a banana leaf.</li></ol>
hunus	<i>noun</i><br><ol><li>typhoon</li><li>strong wind</li></ol>
huun	<i>adv</i><br><ol><li>yes</li></ol>
huyup	<i>verb</i><br><ol><li>to blow</li></ol>
hūlin	<i>noun</i><br><ol><li>marble (toy)</li></ol>
iban	<i>conj</i><br><ol><li>and</li></ol><br><i>noun</i><br><ol><li>companion, associate</li></ol><br><i>prep</i><br><ol><li>with</li></ol>
ibu	<i>num</i><br><ol><li>thousand</li></ol>
idda	<i>noun</i><br><ol><li>deadline</li></ol>
ihi	<i>noun</i><br><ol><li>urine; pee</li></ol>
iklug	<i>noun</i><br><ol><li>egg</li></ol>
ikug	<i>noun</i><br><ol><li>tail</li></ol>
ila	<i>noun</i><br><ol><li>birthmark</li></ol>
ilaw	<i>noun</i><br><ol><li>light</li></ol>
iluk	<i>noun</i><br><ol><li>armpit</li></ol>
ilung	<i>noun</i><br><ol><li>nose</li></ol>
impis	<i>noun</i><br><ol><li>chick</li></ol>
ina	<i>noun</i><br><ol><li>mother</li></ol>
indan	<i>noun</i><br><ol><li>memory</li></ol>
indung	<i>noun</i><br><ol><li>salt-water eel</li></ol>
ingat	<i>noun</i><br><ol><li>knowledge, wisdom, intellect</li></ol><br><i>verb</i><br><ol><li>to know</li></ol>
ingkahi	<i>noun</i><br><ol><li>lace</li></ol><br><i>verb</i><br><ol><li>to sew lace unto something</li></ol>
ini	<i>pron</i><br><ol><li>this</li></ol>
inig	<i>noun</i><br><ol><li>gloss, luster, shine</li></ol>
inum|maginum	<i>verb</i><br><ol><li>to drink</li></ol>
inuman	<i>noun</i><br><ol><li>breakfast</li><li>refreshments</li></ol>
ipul	<i>noun</i><br><ol><li>leprosy</li></ol>
ipun	<i>noun</i><br><ol><li>tooth</li></ol>
iru'	<i>noun</i><br><ol><li>dog</li></ol>
isa	<i>num</i><br><ol><li>one</li></ol>
isay	<i>noun</i><br><ol><li>namesake</li></ol>
ista	<i>noun</i><br><ol><li>fish</li></ol>
isuk	<i>noun</i><br><ol><li>pith</li><li>filling</li></ol><br><i>verb</i><br><ol><li>to stuff</li></ol>
isun	
isārat	<i>noun</i><br><ol><li>sign language</li></ol><br><i>verb</i><br><ol><li>to use sign language</li></ol>
itum	<i>noun</i><br><ol><li>blackness</li></ol><br><i>verb</i><br><ol><li>to blacken</li></ol>
itung	<i>verb</i><br><ol><li>to count</li><li>to consider (something or someone as something)</li></ol>
jaga	<i>noun</i><br><ol><li>guard, watchman; mourner</li></ol><br><i>verb</i><br><ol><li>to watch, to be on watch, to beware, to be on guard</li></ol>
jamaa	<i>noun</i><br><ol><li>(Islam) congregation member</li></ol>
jaman	<i>noun</i><br><ol><li>period; era, epoch, age</li></ol>
jambangan	<i>noun</i><br><ol><li>flower garden</li></ol>
jantung	<i>noun</i><br><ol><li>heart</li></ol>
jawm	<i>noun</i><br><ol><li>needle</li></ol>
jām	<i>noun</i><br><ol><li>hour</li></ol>
jīn	<i>noun</i><br><ol><li>jinn, genie</li></ol>
kabakaba	<i>noun</i><br><ol><li>butterfly</li></ol>
kabal	<i>noun</i><br><ol><li>colugo</li></ol>
kaban	<i>noun</i><br><ol><li>coffin (specifically, a closed one)</li></ol>
kabaw	<i>noun</i><br><ol><li>water buffalo; carabao</li></ol>
kabii	<i>adv</i><br><ol><li>last night</li></ol>
kagang	<i>noun</i><br><ol><li>crab</li></ol>
kagaw|خگاو	<i>noun</i><br><ol><li>vermin feeding on sores</li><li>germ; microbe</li></ol>
kahawa	<i>noun</i><br><ol><li>coffee</li></ol>
kahuy	<i>noun</i><br><ol><li>tree; wood</li></ol>
kakal	<i>verb</i><br><ol><li>to club, to hit with a stick (or anything used as a club)</li></ol>
kalang	<i>noun</i><br><ol><li>dead coral grit</li></ol><br><i>verb</i><br><ol><li>to sing</li></ol>
kalangan	<i>noun</i><br><ol><li>song</li></ol>
kali|magkali	<i>verb</i><br><ol><li>to dig</li></ol>
kami	<i>pron</i><br><ol><li>we (exclusive)</li></ol>
kampung	<i>noun</i><br><ol><li>kindred, relatives (not including parents, children, or siblings)</li></ol>
kamu	<i>pron</i><br><ol><li>you</li></ol>
kandang	<i>noun</i><br><ol><li>cemetery</li></ol>
kapa	<i>noun</i><br><ol><li>ax, hatchet</li></ol>
kasap	<i>noun</i><br><ol><li>coarseness, roughness (as of texture, cloth, or the edge of a broken glass)</li></ol>
katawa|magkatawa	<i>verb</i><br><ol><li>to laugh</li></ol>
katul|magkatul	<i>verb</i><br><ol><li>to itch</li></ol>
kaun|magkaun	<i>verb</i><br><ol><li>to eat</li></ol>
kawasa	<i>noun</i><br><ol><li>strength, power</li><li>ability</li><li>authority</li></ol>
kawat	<i>noun</i><br><ol><li>wire</li></ol>
kawhaan	<i>num</i><br><ol><li>twenty</li></ol>
kayawan	<i>noun</i><br><ol><li>bamboo</li></ol>
kaytan	<i>noun</i><br><ol><li>shark</li></ol>
kayu|kāyu	<i>noun</i><br><ol><li>fire</li></ol>
kilat	<i>noun</i><br><ol><li>lightning</li></ol>
kilay	<i>noun</i><br><ol><li>(anatomy) eyebrow</li></ol>
kilikili	<i>noun</i><br><ol><li>(anatomy) armpit</li></ol>
kiput	<i>noun</i><br><ol><li>narrowness</li></ol>
kita|kimita	<i>pron</i><br><ol><li>we (inclusive)</li></ol><br><i>verb</i><br><ol><li>to see</li></ol>
kubul	<i>noun</i><br><ol><li>grave</li></ol><br><i>verb</i><br><ol><li>to bury</li></ol>
kugita	<i>noun</i><br><ol><li>octopus</li></ol>
kukku	<i>noun</i><br><ol><li>nail (fingernail, toenail)</li></ol>
kura	<i>noun</i><br><ol><li>horse</li></ol>
kusug	<i>noun</i><br><ol><li>power, force, strength</li></ol>
kutkut|magkutkut	<i>verb</i><br><ol><li>to bite</li></ol>
kutu	<i>noun</i><br><ol><li>louse</li></ol>
kuuk	<i>noun</i><br><ol><li>cockroach</li></ol>
kūmu	<i>noun</i><br><ol><li>underbrush</li></ol>
labung	<i>noun</i><br><ol><li>thickness, heaviness (of hair, eyebrows, or cereal grains)</li></ol>
lakat	<i>noun</i><br><ol><li>dampness</li><li>dankness</li><li>slight muddiness</li></ol>
lamma	<i>noun</i><br><ol><li>weakness, illness, sickness</li><li>boredom</li></ol>
lana	<i>noun</i><br><ol><li>oil (usually cooking oil)</li></ol>
lanab	<i>noun</i><br><ol><li>taste, flavor</li></ol>
lanaw	<i>noun</i><br><ol><li>lake</li><li>puddle</li><li>pool</li></ol>
landasan	<i>noun</i><br><ol><li>anvil</li></ol>
langit	<i>noun</i><br><ol><li>sky (atmosphere above a point)</li></ol>
languy|maglanguy	<i>verb</i><br><ol><li>to swim</li></ol>
lantay	<i>noun</i><br><ol><li>floor</li></ol>
laring	<i>noun</i><br><ol><li>knife, kitchen knife</li></ol>
lasig	<i>noun</i><br><ol><li>activity, liveliness</li></ol>
laul	<i>noun</i><br><ol><li>tiredness; fatigue</li></ol>
lawa	<i>noun</i><br><ol><li>left hand, foot or limb</li><li>left side</li><li>spider</li></ol>
lawang	<i>noun</i><br><ol><li>door, gate</li><li>(euphemistic) vulva</li></ol>
laway	<i>noun</i><br><ol><li>saliva</li></ol>
layag|maglayag	<i>noun</i><br><ol><li>sail</li></ol><br><i>verb</i><br><ol><li>to sail (to a place)</li></ol>
ligang	<i>verb</i><br><ol><li>to fry (in a moderate amount of oil)</li></ol>
lima	<i>noun</i><br><ol><li>hand</li></ol><br><i>num</i><br><ol><li>five</li></ol>
limut	<i>noun</i><br><ol><li>gossip</li></ol>
lintang	<i>noun</i><br><ol><li>bamboo buoy (used to mark the anchorage of a fish trap)</li></ol>
linug	<i>noun</i><br><ol><li>earthquake</li></ol>
lisag	<i>noun</i><br><ol><li>stroke</li><li>time</li></ol><br><i>verb</i><br><ol><li>to beat, to strike (someone or something)</li></ol>
liug	<i>noun</i><br><ol><li>neck</li></ol>
liyang	<i>noun</i><br><ol><li>recess or niche in the side of a Muslim grave where the dead body is laid</li></ol>
lubid	<i>noun</i><br><ol><li>rope</li></ol>
luha	<i>noun</i><br><ol><li>tear</li></ol>
lukluk	<i>noun</i><br><ol><li>owl</li></ol>
luman	<i>noun</i><br><ol><li>A mixed feeling of fear, profound respect, and shyness (toward someone); social distance.</li></ol>
lumura	<i>verb</i><br><ol><li>to spit</li></ol>
lumut	<i>noun</i><br><ol><li>moss</li></ol>
lunga	<i>noun</i><br><ol><li>sesame</li></ol>
lungag	<i>noun</i><br><ol><li>hole</li></ol>
lupa	<i>noun</i><br><ol><li>earth; ground; soil</li></ol>
lupad	<i>verb</i><br><ol><li>to fly</li></ol>
lura|maglura	<i>noun</i><br><ol><li>saliva</li></ol><br><i>verb</i><br><ol><li>to spit</li></ol>
lusung	<i>noun</i><br><ol><li>mortar</li></ol>
lutaw	<i>noun</i><br><ol><li>spirit of a dead person (forced because of his badness to return to earth as an evil-smelling, half decayed body), evil ghost</li></ol>
lutu|maglutu	<i>verb</i><br><ol><li>to cook</li></ol>
luwan	<i>noun</i><br><ol><li>cargo</li><li>load</li><li>freight</li></ol>
luya	<i>noun</i><br><ol><li>ginger</li></ol>
maasin	<i>adj</i><br><ol><li>salty</li></ol>
maaslum	<i>adj</i><br><ol><li>sour</li></ol>
maasu	<i>adj</i><br><ol><li>smoky</li></ol>
mabagunbun	<i>adj</i><br><ol><li>dusty</li></ol>
mabud|mabūd	<i>adj</i><br><ol><li>mountainous</li></ol>
mabugat	<i>adj</i><br><ol><li>heavy</li></ol>
mabuhangin	<i>adj</i><br><ol><li>sandy</li></ol>
mabukug	<i>adj</i><br><ol><li>bony</li></ol>
magabun	<i>adj</i><br><ol><li>cloudy</li></ol>
mahaba	<i>adj</i><br><ol><li>long</li></ol>
mahalga	<i>adj</i><br><ol><li>dear, pricey, expensive</li></ol>
mahamut	<i>adj</i><br><ol><li>fragrant</li></ol>
mahugut	<i>adj</i><br><ol><li>firm, solid</li></ol>
maingat	<i>adj</i><br><ol><li>wise, intelligent</li></ol>
mainum	<i>adj</i><br><ol><li>drinkable</li></ol>
maitum	<i>adj</i><br><ol><li>black</li></ol>
makina	<i>noun</i><br><ol><li>machine</li></ol>
makusug	<i>adj</i><br><ol><li>strong</li></ol>
malamma	<i>adj</i><br><ol><li>weak</li></ol>
malanggang	<i>adj</i><br><ol><li>thirsty</li></ol>
malaul	<i>adj</i><br><ol><li>tired</li></ol>
malim	<i>noun</i><br><ol><li>guide</li></ol>
maluhay	<i>adj</i><br><ol><li>cheap</li><li>easy</li></ol>
mangga	<i>noun</i><br><ol><li>mango (fruit)</li></ol>
manipis	<i>adj</i><br><ol><li>thin</li></ol>
manuk	<i>noun</i><br><ol><li>chicken</li></ol>
manuk-manuk	<i>noun</i><br><ol><li>bird</li></ol>
mapait	<i>adj</i><br><ol><li>bitter</li></ol>
mapii	<i>adj</i><br><ol><li>choosy</li></ol>
mapisak	<i>adj</i><br><ol><li>muddy</li></ol>
maputi	<i>adj</i><br><ol><li>white</li></ol>
marat	<i>noun</i><br><ol><li>opium</li></ol>
mas|mās	<i>adj</i><br><ol><li>old (of persons)</li></ol>
masa	<i>noun</i><br><ol><li>era, epoch, age</li></ol>
masagbut	<i>adj</i><br><ol><li>full of weeds</li></ol>
masakit	<i>adj</i><br><ol><li>painful</li></ol>
masjid	<i>noun</i><br><ol><li>mosque</li></ol>
mata	<i>noun</i><br><ol><li>eye (organ)</li></ol>
matas|matās	<i>adj</i><br><ol><li>high</li><li>eminent, great</li></ol>
matembuk	<i>adj</i><br><ol><li>fat</li></ol>
matubig	<i>adj</i><br><ol><li>watery</li><li>juicy</li></ol>
matugas	<i>adj</i><br><ol><li>hard</li></ol>
mayat	<i>noun</i><br><ol><li>corpse</li></ol>
maylang	<i>noun</i><br><ol><li>sulfur</li></ol>
musim	<i>noun</i><br><ol><li>season</li></ol>
nabi	<i>noun</i><br><ol><li>prophet</li></ol>
nana	<i>noun</i><br><ol><li>pus</li></ol>
nanam	<i>noun</i><br><ol><li>taste, flavor</li></ol>
napas	<i>noun</i><br><ol><li>breath</li></ol>
narka'	<i>noun</i><br><ol><li>Hell</li></ol>
ngan|ngān	<i>noun</i><br><ol><li>name</li></ol>
nipis	<i>noun</i><br><ol><li>thinness</li></ol>
niyug	<i>noun</i><br><ol><li>coconut tree</li></ol>
nyawa	<i>noun</i><br><ol><li>soul, spirit</li></ol>
nyuknyuk	<i>noun</i><br><ol><li>fineness (of a cloth's texture)</li></ol>
paa	<i>noun</i><br><ol><li>(anatomy) thigh</li></ol>
pad|pād	<i>noun</i><br><ol><li>the palm of the hand</li></ol>
pagat	<i>noun</i><br><ol><li>scratch</li></ol>
pagaw	<i>adj</i><br><ol><li>hoarse</li></ol>
pagi	<i>noun</i><br><ol><li>ray, stingray (fish)</li></ol>
pagkaun	<i>noun</i><br><ol><li>food</li></ol>
pagkausug	<i>noun</i><br><ol><li>manhood, masculinity</li></ol>
pait	<i>noun</i><br><ol><li>bitterness</li></ol>
pakayan	<i>noun</i><br><ol><li>costume, formal dress, good clothes</li></ol>
paksiyu	<i>noun</i><br><ol><li>fish or meat cooked in vinegar, garlic, ginger and salt</li></ol>
palmata	<i>noun</i><br><ol><li>gem, precious stone</li></ol>
panaw|magpanaw	<i>verb</i><br><ol><li>to walk</li></ol>
panayam|panayam-nayam|magpanayam	<i>noun</i><br><ol><li>game</li></ol><br><i>verb</i><br><ol><li>to play</li></ol>
panayaman	<i>noun</i><br><ol><li>toy, plaything</li></ol>
panganan	<i>noun</i><br><ol><li>A pretzel-like confection made of rice flour or powdered corn and syrup and fried in oil.</li></ol>
pangarap	<i>noun</i><br><ol><li>prayer (conversational rather than memorized)</li></ol>
pangkut	<i>noun</i><br><ol><li>smallpox</li></ol>
pangpang	<i>noun</i><br><ol><li>cliff, precipice</li></ol>
panji	<i>noun</i><br><ol><li>flag</li><li>banner</li></ol>
papagan	<i>noun</i><br><ol><li>frame (of eye-glasses or pictures)</li></ol>
parang	<i>noun</i><br><ol><li>grass</li></ol>
parat	<i>noun</i><br><ol><li>intense heat (of the sun)</li></ol>
parian	<i>noun</i><br><ol><li>market</li></ol>
pasang	<i>noun</i><br><ol><li>pair; couple</li></ol>
patag	<i>adj</i><br><ol><li>level</li></ol>
patay	<i>adj</i><br><ol><li>dead</li></ol>
patung	<i>noun</i><br><ol><li>bamboo</li></ol>
pay|pāy	<i>noun</i><br><ol><li>rice (with husk)</li></ol>
payung	<i>noun</i><br><ol><li>umbrella</li></ol>
pihak	<i>noun</i><br><ol><li>tribe</li><li>clan</li></ol>
pii|mangpii	<i>verb</i><br><ol><li>to choose</li></ol>
pikpik	<i>noun</i><br><ol><li>wing</li></ol>
pila	<i>pron</i><br><ol><li>how many</li></ol>
pilak	<i>noun</i><br><ol><li>silver</li></ol>
pilang	<i>noun</i><br><ol><li>fireplace, stove</li></ol>
pilay	<i>adj</i><br><ol><li>lame</li></ol>
pinggan	<i>noun</i><br><ol><li>bowl</li></ol>
pinta	<i>noun</i><br><ol><li>paint</li></ol>
pirma	<i>noun</i><br><ol><li>signature</li></ol><br><i>verb</i><br><ol><li>to sign (make (a document) official by writing one's signature)</li></ol>
pisak	<i>noun</i><br><ol><li>mud</li></ol>
pisang	<i>noun</i><br><ol><li>pineapple (plant and fruit)</li></ol>
pitu	<i>num</i><br><ol><li>seven</li></ol>
puasa	<i>verb</i><br><ol><li>to fast</li></ol><br><i>noun</i><br><ol><li>fasting</li></ol>
puga	<i>verb</i><br><ol><li>to squeeze out fluid</li></ol>
pugad|magpugad	<i>noun</i><br><ol><li>nest</li></ol><br><i>verb</i><br><ol><li>to settle in a nest</li><li>to make a hideout</li></ol>
pugay	<i>noun</i><br><ol><li>nape</li></ol>
puhun	<i>noun</i><br><ol><li>complaint, report</li></ol><br><i>verb</i><br><ol><li>to complain (to someone, esp. a parent, usu. against a member of the family or a close relative)</li></ol>
pukat	<i>noun</i><br><ol><li>tartness, acerbity</li></ol>
pukpuk|magpukpuk	<i>verb</i><br><ol><li>to hammer</li></ol>
pukut	<i>noun</i><br><ol><li>a net for fishing</li></ol>
pula	<i>adj</i><br><ol><li>red</li></ol>
pun|pūn	<i>noun</i><br><ol><li>origin</li><li>beginning</li></ol>
punda	<i>noun</i><br><ol><li>pillowcase</li></ol><br><i>verb</i><br><ol><li>to place a pillowcase on (something)</li></ol>
pungut	<i>noun</i><br><ol><li>beard</li><li>mustache</li></ol><br><i>verb</i><br><ol><li>to grow a beard</li></ol>
purda	<i>noun</i><br><ol><li>side curtains</li></ol><br><i>verb</i><br><ol><li>to make a side curtain</li></ol>
pusud	<i>noun</i><br><ol><li>navel</li></ol>
puti	<i>noun</i><br><ol><li>whiteness</li></ol>
puting|magputing	<i>noun</i><br><ol><li>falsehood, lie</li></ol><br><i>verb</i><br><ol><li>to lie</li></ol>
putti	<i>noun</i><br><ol><li>rich coconut milk</li></ol>
putu	<i>noun</i><br><ol><li>A confection made by steaming grated cassava.</li></ol>
putus	<i>noun</i><br><ol><li>wrapper, wrapping</li><li>covering</li></ol><br><i>verb</i><br><ol><li>to wrap</li><li>to dip, to coat</li></ol>
raja	<i>noun</i><br><ol><li>king</li></ol>
sa|sā	<i>noun</i><br><ol><li>fault, mistake</li></ol>
sabaw	<i>noun</i><br><ol><li>soup; broth</li></ol>
sagbut	<i>noun</i><br><ol><li>weeds</li><li>trash</li></ol>
saing	<i>noun</i><br><ol><li>banana</li></ol>
sakit	<i>noun</i><br><ol><li>pain</li></ol>
sakulati	<i>noun</i><br><ol><li>chocolate</li></ol>
salban	<i>noun</i><br><ol><li>(sewing) thread</li></ol>
sambu	<i>noun</i><br><ol><li>health</li><li>prosperity</li></ol>
sambulaan	<i>noun</i><br><ol><li>hawk</li></ol>
sampul	<i>noun</i><br><ol><li>Rice cooked with coconut milk and turmeric.The rice cooked thus is pressed into a bowl or cup, which is then overturned on a plate and surrounded by egg halves or pieces of roasted chicken. It is offered to the ancestors in a kāja or duwaa pa taas ceremony, offered to spirits, used at weddings, and used formerly to feed important people.</li></ol>
sanam	<i>noun</i><br><ol><li>ant</li></ol>
sanga	<i>noun</i><br><ol><li>branch</li><li>bough</li></ol><br><i>verb</i><br><ol><li>to branch</li></ol>
santan	<i>noun</i><br><ol><li>Sugared coconut milk with cooked rice.</li></ol>
sap	<i>noun</i><br><ol><li>seal; stamp</li></ol>
sapa	<i>noun</i><br><ol><li>a small river; a stream</li></ol>
sapat	<i>noun</i><br><ol><li>quickness, swiftness, rapidity, haste</li></ol>
sapu|magsapu	<i>verb</i><br><ol><li>to wipe</li></ol>
sarat	<i>noun</i><br><ol><li>token, mark, indication</li></ol>
sasat	<i>noun</i><br><ol><li>seducement, disturbance, nuisance</li></ol>
sassing	<i>noun</i><br><ol><li>pinworm</li></ol>
sat	<i>noun</i><br><ol><li>paint</li></ol>
satariya	<i>noun</i><br><ol><li>soldier; veteran warrior</li><li>(historical) a title in ancient historical legends of Sulu</li></ol>
satti	<i>noun</i><br><ol><li>kabobs</li></ol>
sayul	<i>noun</i><br><ol><li>vegetable</li></ol>
sia	<i>pron</i><br><ol><li>he</li></ol>
sibit	<i>noun</i><br><ol><li>claw (of a crab, etc.)</li></ol>
siga	<i>noun</i><br><ol><li>cigarette</li></ol>
sigpit	<i>noun</i><br><ol><li>tightness (of clothing or shoes)</li><li>hardship, difficulty</li></ol>
siki	<i>noun</i><br><ol><li>foot</li></ol>
siku	<i>noun</i><br><ol><li>(anatomy) elbow</li></ol>
simpan	<i>noun</i><br><ol><li>A game similar to jacks, where objects are placed on the back of the hand then tossed into the air and caught with the palm.</li></ol>
sinag	<i>noun</i><br><ol><li>brightness; gleam</li></ol>
singsing	<i>noun</i><br><ol><li>ring</li></ol>
sipa|magsipa	<i>noun</i><br><ol><li>a kick</li></ol><br><i>verb</i><br><ol><li>to kick</li></ol>
siput	<i>noun</i><br><ol><li>screw</li></ol>
siyam|siyám	<i>num</i><br><ol><li>nine</li></ol>
su|sū	<i>noun</i><br><ol><li>source of light</li></ol>
suba	<i>noun</i><br><ol><li>river</li></ol>
subu	<i>noun</i><br><ol><li>dawn</li></ol>
sug	<i>noun</i><br><ol><li>the part of a fluid that moves continuously in a certain direction, water current.</li></ol>
suga	<i>noun</i><br><ol><li>sun</li></ol>
suka'	<i>noun</i><br><ol><li>vinegar</li></ol>
sukal	<i>noun</i><br><ol><li>sugar</li></ol>
sukay|magsukay	<i>noun</i><br><ol><li>fare</li><li>rent</li><li>tax</li></ol><br><i>verb</i><br><ol><li>to pay a fare, rent or tax</li></ol>
sulab	<i>noun</i><br><ol><li>blade</li></ol>
sulat	<i>noun</i><br><ol><li>document, letter</li></ol><br><i>verb</i><br><ol><li>to write</li></ol>
sulga'	<i>noun</i><br><ol><li>Heaven</li></ol>
suling	<i>noun</i><br><ol><li>flute, fife (traditionally made with bamboo)</li></ol>
sullit	<i>noun</i><br><ol><li>loincloth</li></ol>
sultan	<i>noun</i><br><ol><li>sultan (Muslim king)</li></ol>
sumba	<i>verb</i><br><ol><li>to worship, to pay homage</li></ol>
sumbahan	<i>noun</i><br><ol><li>church</li></ol>
sumping	<i>noun</i><br><ol><li>flower</li></ol>
sumsum	<i>noun</i><br><ol><li>bone marrow</li></ol>
sungab	<i>noun</i><br><ol><li>cave</li></ol>
sungka	<i>noun</i><br><ol><li>rosin (for violin bows)</li></ol>
sungut	<i>noun</i><br><ol><li>asthma</li></ol>
sunsun	<i>verb</i><br><ol><li>to tighten the weaving (of nipa or coconut-leaf shingles or woven material such as a mat or basket)</li></ol>
suntuk	<i>noun</i><br><ol><li>punch, box, blow</li></ol><br><i>verb</i><br><ol><li>to punch, to box</li></ol>
sunug	<i>verb</i><br><ol><li>to burn</li></ol>
supsup	<i>verb</i><br><ol><li>to suck</li></ol>
sāt	<i>noun</i><br><ol><li>paint</li></ol>
sīni	<i>noun</i><br><ol><li>movie, film</li><li>cinema</li></ol>
sūg	<i>noun</i><br><ol><li>current (flow of water in a definite direction)</li></ol>
tabaku'	<i>noun</i><br><ol><li>tobacco</li></ol>
tabang	<i>noun</i><br><ol><li>help, aid, assistance</li></ol>
tagainup|magtagainup	<i>noun</i><br><ol><li>dream</li></ol><br><i>verb</i><br><ol><li>to dream</li></ol>
tahay	<i>adj</i><br><ol><li>dry</li></ol><br><i>noun</i><br><ol><li>dried fish</li></ol>
tahi|magtahi	<i>verb</i><br><ol><li>to sew</li></ol>
tahun	<i>noun</i><br><ol><li>year</li></ol>
tai	<i>noun</i><br><ol><li>excrement, feces</li></ol>
tainga	<i>noun</i><br><ol><li>ear</li></ol>
takaw|magtakaw	<i>verb</i><br><ol><li>to steal</li></ol>
taling	<i>noun</i><br><ol><li>tusk</li></ol>
tallang	<i>adj</i><br><ol><li>very dark (in color)</li></ol>
talum	<i>noun</i><br><ol><li>eggplant</li></ol>
tambul	<i>adj</i><br><ol><li>closed</li><li>unlucky</li></ol>
taming	<i>noun</i><br><ol><li>shield</li></ol>
tampan	<i>noun</i><br><ol><li>covering</li></ol>
tampat	<i>noun</i><br><ol><li>shrine</li><li>grave of a prophet or a person believed to be descended from the prophet Muhammad</li></ol>
tangis|magtangis	<i>verb</i><br><ol><li>to cry; to weep</li></ol>
tangkay	<i>noun</i><br><ol><li>stem, stalk</li><li>handle</li><li>bow, temple (of eye-glasses)</li></ol>
tanglung	<i>noun</i><br><ol><li>Chinese lantern (made of a bamboo frame covered with paper)</li></ol>
tanud	<i>noun</i><br><ol><li>thread</li></ol>
tanum|magtanum	<i>verb</i><br><ol><li>to plant</li></ol>
tapahan	<i>noun</i><br><ol><li>A rack used to roast food</li></ol>
tapak	<i>noun</i><br><ol><li>saucer</li></ol>
tapung	<i>noun</i><br><ol><li>rice flour</li></ol>
tarrang	<i>adj</i><br><ol><li>lawful, legal, legitimate, licensed</li></ol>
tas|tās	<i>noun</i><br><ol><li>height</li></ol>
tau	<i>noun</i><br><ol><li>person</li><li>human</li></ol>
taud	<i>noun</i><br><ol><li>number</li><li>quantity</li><li>multitude</li><li>profusion</li></ol>
tawag	<i>verb</i><br><ol><li>to call</li></ol>
taytayan	<i>noun</i><br><ol><li>a foot bridge</li></ol>
tian	<i>noun</i><br><ol><li>belly; abdomen</li></ol>
timbak	<i>noun</i><br><ol><li>explosion</li><li>gunshot</li></ol>
timbangan	<i>noun</i><br><ol><li>scales, balance</li></ol>
tindug|timindug	<i>verb</i><br><ol><li>to stand</li></ol>
tu|tū|magtu	<i>adj</i><br><ol><li>right (not left)</li></ol><br><i>noun</i><br><ol><li>right hand</li><li>a drop</li></ol><br><i>num</i><br><ol><li>three</li></ol><br><i>verb</i><br><ol><li>to drip</li></ol>
tuba	<i>noun</i><br><ol><li>wine (made from plants, e.g. rice)</li></ol>
tubig	<i>noun</i><br><ol><li>water</li><li>juice</li></ol>
tubu	<i>noun</i><br><ol><li>sugar cane</li></ol>
tug|magtūg|tūg	<i>verb</i><br><ol><li>to sleep</li></ol>
tuhud	<i>noun</i><br><ol><li>knee</li></ol>
tuku	<i>noun</i><br><ol><li>pole (used to support something)</li></ol>
tukul	<i>noun</i><br><ol><li>hammer</li></ol><br><i>verb</i><br><ol><li>to hammer</li></ol>
tukun	<i>noun</i><br><ol><li>pole (for propelling a boat)</li></ol>
tulis	<i>verb</i><br><ol><li>to write</li></ol>
tulung	<i>noun</i><br><ol><li>help, aid, assistance</li></ol>
tumangis	<i>verb</i><br><ol><li>to cry</li></ol>
tumbaga	<i>noun</i><br><ol><li>brass, bronze</li><li>copper</li></ol>
tumpul	<i>adj</i><br><ol><li>blunt, dull</li></ol>
tumtum|magtumtum	<i>verb</i><br><ol><li>to remember</li></ol>
tunga|magtunga	<i>noun</i><br><ol><li>half</li></ol><br><i>verb</i><br><ol><li>to halve</li></ol>
tungaan	<i>noun</i><br><ol><li>middle</li></ol>
tunggul	<i>noun</i><br><ol><li>the stump of a tree</li></ol>
tunuk	<i>noun</i><br><ol><li>thorn</li><li>spine (of a fish)</li></ol><br><i>verb</i><br><ol><li>to be pricked</li></ol>
tuu	<i>noun</i><br><ol><li>right hand</li><li>right side</li></ol>
tuwang	<i>verb</i><br><ol><li>to pour</li></ol>
tī	<i>noun</i><br><ol><li>tea</li></ol>
u|ū	<i>noun</i><br><ol><li>head</li></ol>
uan|ūan	<i>noun</i><br><ol><li>pillow</li></ol>
uay	<i>noun</i><br><ol><li>rattan</li></ol>
uban	<i>noun</i><br><ol><li>gray hair</li></ol>
ubat	<i>noun</i><br><ol><li>medicine</li></ol>
ubu	<i>noun</i><br><ol><li>cough</li></ol>
ugat	<i>noun</i><br><ol><li>(anatomy) vein</li></ol>
ugis	<i>noun</i><br><ol><li>albino (person)</li></ol>
uhaw	<i>noun</i><br><ol><li>thirst</li></ol>
ukab	<i>adj</i><br><ol><li>open</li></ol>
ukuman	<i>noun</i><br><ol><li>possession</li></ol>
ukuy	<i>noun</i><br><ol><li>weakness (due to sickness)</li></ol>
ulakan	<i>noun</i><br><ol><li>(weaving) shuttle</li></ol>
ulan	<i>noun</i><br><ol><li>rain</li></ol>
ulang	<i>noun</i><br><ol><li>yell</li></ol>
uma	<i>noun</i><br><ol><li>farm</li></ol>
umagad	<i>noun</i><br><ol><li>courage, bravery, spirit, nerve</li></ol>
umaw	<i>adj</i><br><ol><li>dumb, mute</li></ol>
umpan	<i>noun</i><br><ol><li>bait</li></ol>
undam	<i>noun</i><br><ol><li>bowl, small basin</li></ol>
unu	<i>pron</i><br><ol><li>what</li></ol>
unum	<i>num</i><br><ol><li>six</li></ol>
unung	<i>noun</i><br><ol><li>companion (sharing the same circumstances with someone)</li></ol>
upat	<i>num</i><br><ol><li>four</li></ol>
ural	<i>noun</i><br><ol><li>coarseness (of cloth)</li></ol>
usa	<i>noun</i><br><ol><li>deer</li></ol>
usug	<i>noun</i><br><ol><li>man, male</li></ol>
usuk	<i>noun</i><br><ol><li>pole</li><li>post</li><li>stake</li></ol>
utang	<i>noun</i><br><ol><li>debt</li></ol>
utin	<i>noun</i><br><ol><li>penis</li></ol>
utuk	<i>noun</i><br><ol><li>brain</li></ol>
uwak	<i>noun</i><br><ol><li>crow</li></ol>
uwi	<i>verb</i><br><ol><li>to return home</li></ol>
uwian	<i>noun</i><br><ol><li>The place to which (one) returns, (one’s) home.</li></ol>
uyum	<i>noun</i><br><ol><li>smile</li></ol>
wajib	<i>adj</i><br><ol><li>obligatory, compulsory</li></ol>
waktu	<i>noun</i><br><ol><li>time</li></ol>
walu	<i>num</i><br><ol><li>eight</li></ol>
waris	<i>noun</i><br><ol><li>maternal kinfolk</li></ol>
yakut	<i>noun</i><br><ol><li>ruby, garnet or any red gem</li></ol>
yatim	<i>noun</i><br><ol><li>orphan (without both parents)</li></ol>
Īsa	<i>name</i><br><ol><li>Jesus</li></ol>
