A|a	<i>character</i><br><ol><li>The first letter of the Turkmen alphabet, called a and written in the Latin script.</li></ol>
Afganistan	<i>name</i><br><ol><li>Afghanistan (a country in Asia)</li></ol>
Afrika	<i>name</i><br><ol><li>Africa</li></ol>
Albaniýa	<i>name</i><br><ol><li>Albania (a country in Europe)</li></ol>
Alžir	<i>name</i><br><ol><li>Algeria (a country in Africa)</li><li>Algiers (the capital city of Algeria)</li></ol>
Amyderýa	<i>name</i><br><ol><li>Amu Darya</li></ol>
Andorra	<i>name</i><br><ol><li>Andorra (a country in Europe)</li></ol>
Argentina	<i>name</i><br><ol><li>Argentina (a country in South America)</li></ol>
Awstraliýa|Австралия	<i>name</i><br><ol><li>Australia (a continent and country in Oceania)</li></ol>
Awstriýa|Awstriýā|Awstriýadan|Awstriýany|Awstriýanyň|Awstriýada	<i>name</i><br><ol><li>Austria (a country in Europe)</li></ol>
Azerbaýjan|Азербайҗан	<i>name</i><br><ol><li>Azerbaijan (a country in Europe and Asia)</li></ol>
Aziýa	<i>name</i><br><ol><li>Asia</li></ol>
Aşgabat	<i>name</i><br><ol><li>Ashgabat (the capital city of Turkmenistan)</li></ol>
Bagdat	<i>name</i><br><ol><li>Baghdad (the capital city of Iraq)</li></ol>
Bahreýn	<i>name</i><br><ol><li>Bahrain (a country in Asia)</li></ol>
Bangladeş	<i>name</i><br><ol><li>Bangladesh (a country in Asia)</li></ol>
Belgiýa	<i>name</i><br><ol><li>Belgium (a country in Europe)</li></ol>
Beliz	<i>name</i><br><ol><li>Belize (a country in Central America)</li></ol>
Beýik Britaniýa	<i>name</i><br><ol><li>United Kingdom</li><li>Great Britain</li></ol>
Birleşen Arap Emirlikleri	<i>name</i><br><ol><li>United Arab Emirates</li></ol>
Bişkek	<i>name</i><br><ol><li>Bishkek (the capital city of Kyrgyzstan)</li></ol>
Bolgariýa	<i>name</i><br><ol><li>Bulgaria (a country in Europe)</li></ol>
Boliwiýa	<i>name</i><br><ol><li>Bolivia (a country in South America)</li></ol>
Bosniýa we Gersegowina	<i>name</i><br><ol><li>Bosnia and Herzegovina (a country in Europe)</li></ol>
Braziliýa	<i>name</i><br><ol><li>Brazil (a country in South America)</li></ol>
Bruneý	<i>name</i><br><ol><li>Brunei</li></ol>
Butan	<i>name</i><br><ol><li>Bhutan (a country in Asia)</li></ol>
Daniýa	<i>name</i><br><ol><li>Denmark</li></ol>
Demirgazyk Koreýa	<i>name</i><br><ol><li>North Korea</li></ol>
Ekwador	<i>name</i><br><ol><li>Ecuador (a country in South America)</li></ol>
Ermenistan	<i>name</i><br><ol><li>Armenia (a country in Europe and Asia)</li></ol>
Estoniýa	<i>name</i><br><ol><li>Estonia</li></ol>
Eýran	<i>name</i><br><ol><li>Iran</li></ol>
Farer adalary	<i>name</i><br><ol><li>Faroe Islands (group of islands between Scotland and Iceland)</li></ol>
Fiji	<i>name</i><br><ol><li>Fiji (a country and archipelago in Oceania)</li></ol>
Filippinler	<i>name</i><br><ol><li>Philippines</li></ol>
Finlýandiýa	<i>name</i><br><ol><li>Finland</li></ol>
Fransiýa	<i>name</i><br><ol><li>France</li></ol>
Gara deňiz|gara deňiz	<i>name</i><br><ol><li>the Black Sea</li></ol>
Garagum	<i>name</i><br><ol><li>Karakum</li></ol>
Gazagystan	<i>name</i><br><ol><li>Kazakhstan</li></ol>
Gaýana	<i>name</i><br><ol><li>Guyana (a country in South America)</li></ol>
Germaniýa	<i>name</i><br><ol><li>Germany</li></ol>
Gibraltar	<i>name</i><br><ol><li>Gibraltar (a peninsula and overseas territory of the United Kingdom, at the southern end of Iberia)</li></ol>
Grenlandiýa	<i>name</i><br><ol><li>Greenland</li></ol>
Gresiýa	<i>name</i><br><ol><li>Greece</li></ol>
Gruziýa	<i>name</i><br><ol><li>Georgia</li></ol>
Gulyýew	<i>noun</i><br><ol><li>a male surname, feminine equivalent Gulyýewa</li></ol>
Gyrgyzystan	<i>name</i><br><ol><li>Kyrgyzstan</li></ol>
Gündogar Timor	<i>name</i><br><ol><li>East Timor</li></ol>
Günorta Koreýa	<i>name</i><br><ol><li>South Korea</li></ol>
Gürjüstan	<i>name</i><br><ol><li>Georgia (a country in Europe and Asia)</li></ol>
Hazar deňzi	<i>name</i><br><ol><li>the Caspian Sea</li></ol>
Hindistan	<i>name</i><br><ol><li>India (a country in Asia)</li></ol>
Horezm	<i>name</i><br><ol><li>Khwarazm, Chorasmia</li><li>Xorazm, a region in Uzbekistan</li></ol>
Horwatiýa	<i>name</i><br><ol><li>Croatia</li></ol>
Hytaý	<i>name</i><br><ol><li>China</li></ol>
Ikinji Jahan urşy	<i>name</i><br><ol><li>World War 2</li></ol>
Indoneziýa	<i>name</i><br><ol><li>Indonesia</li></ol>
Iordaniýa	<i>name</i><br><ol><li>Jordan</li></ol>
Irlandiýa	<i>name</i><br><ol><li>Ireland (a country in Europe)</li></ol>
Islandiýa	<i>name</i><br><ol><li>Iceland (a country in Europe)</li></ol>
Ispaniýa	<i>name</i><br><ol><li>Spain (a country in Europe)</li></ol>
Italiýa	<i>name</i><br><ol><li>Italy</li></ol>
Kamboja	<i>name</i><br><ol><li>Cambodia</li></ol>
Katar	<i>name</i><br><ol><li>Qatar</li></ol>
Kipr	<i>name</i><br><ol><li>Cyprus</li></ol>
Kiribati	<i>name</i><br><ol><li>Kiribati</li></ol>
Kolumbiýa	<i>name</i><br><ol><li>Colombia (a country in South America)</li></ol>
Koreýa	<i>name</i><br><ol><li>Korea</li></ol>
Kot-d'Iwuar	<i>name</i><br><ol><li>Ivory Coast, Côte d'Ivoire (a country in West Africa)</li></ol>
Kuba	<i>name</i><br><ol><li>Cuba (an island and country in the Caribbean)</li></ol>
Kuweýt	<i>name</i><br><ol><li>Kuwait (a country in Asia)</li></ol>
Laos	<i>name</i><br><ol><li>Laos (a country in Asia)</li></ol>
Latwiýa	<i>name</i><br><ol><li>Latvia</li></ol>
Lihtenşteýn	<i>name</i><br><ol><li>Liechtenstein</li></ol>
Litwa	<i>name</i><br><ol><li>Lithuania</li></ol>
Liwan	<i>name</i><br><ol><li>Lebanon</li></ol>
Lýuksemburg	<i>name</i><br><ol><li>Luxembourg</li></ol>
Magtymguly|مخدوم قلی|Магтымгулы	<i>name</i><br><ol><li>Magtymguly</li></ol>
Majarystan	<i>name</i><br><ol><li>Hungary</li></ol>
Makedoniýa	<i>name</i><br><ol><li>Macedonia</li></ol>
Malaýziýa	<i>name</i><br><ol><li>Malaysia</li></ol>
Maldiwler	<i>name</i><br><ol><li>Maldives</li></ol>
Malta	<i>name</i><br><ol><li>Malta</li></ol>
Marşal Adalary	<i>name</i><br><ol><li>Marshall Islands</li></ol>
Mikroneziýanyň Birleşen Ştatlary	<i>name</i><br><ol><li>Federated States of Micronesia</li></ol>
Monako	<i>name</i><br><ol><li>Monaco (a city-state in Western Europe)</li></ol>
Mongoliýa	<i>name</i><br><ol><li>Mongolia</li></ol>
Müsür	<i>name</i><br><ol><li>Egypt</li></ol>
Mýanma	<i>name</i><br><ol><li>Myanmar</li></ol>
Nauru	<i>name</i><br><ol><li>Nauru</li></ol>
Nepal	<i>name</i><br><ol><li>Nepal</li></ol>
Niderlandlar	<i>name</i><br><ol><li>Netherlands</li></ol>
Norwegiýa	<i>name</i><br><ol><li>Norway</li></ol>
Nuryýew	<i>name</i><br><ol><li>a male surname, feminine equivalent Nuryýewa</li></ol>
Nuryýewa	<i>name</i><br><ol><li>a female surname, masculine equivalent Nuryýew</li></ol>
Oman	<i>name</i><br><ol><li>Oman</li></ol>
Owganystan	<i>name</i><br><ol><li>Afghanistan (a country in Asia)</li></ol>
Palau	<i>name</i><br><ol><li>Palau</li></ol>
Paragwaý	<i>name</i><br><ol><li>Paraguay (a country in South America)</li></ol>
Pariž	<i>name</i><br><ol><li>Paris (the capital and largest city of France)</li></ol>
Peru	<i>name</i><br><ol><li>Peru (a country in South America)</li></ol>
Polşa	<i>name</i><br><ol><li>Poland (a country in Europe)</li></ol>
Portugaliýa	<i>name</i><br><ol><li>Portugal (a country in Europe)</li></ol>
Päkistan|Päkistana|Päkistany|Päkistanyň|Päkistanda|Päkistandan	<i>name</i><br><ol><li>Pakistan</li></ol>
Rumyniýa	<i>name</i><br><ol><li>Romania</li></ol>
Russiýa	<i>name</i><br><ol><li>Russia</li></ol>
Salwador	<i>name</i><br><ol><li>El Salvador (a country in Central America)</li></ol>
Samoa	<i>name</i><br><ol><li>Samoa</li></ol>
San-Marino	<i>name</i><br><ol><li>San Marino</li></ol>
Sankt-Peterburg	<i>name</i><br><ol><li>Saint Petersburg (a federal city of Russia)</li></ol>
Saud Arabystany	<i>name</i><br><ol><li>Saudi Arabia</li></ol>
Serbiýa	<i>name</i><br><ol><li>Serbia</li></ol>
Singapur	<i>name</i><br><ol><li>Singapore (an island and city-state in Southeast Asia)</li></ol>
Siriýa	<i>name</i><br><ol><li>Syria</li></ol>
Slowakiýa	<i>name</i><br><ol><li>Slovakia</li></ol>
Sloweniýa	<i>name</i><br><ol><li>Slovenia</li></ol>
Solomon Adalary	<i>name</i><br><ol><li>Solomon Islands</li></ol>
Surinam	<i>name</i><br><ol><li>Suriname (a country in South America)</li></ol>
Syrderýa	<i>name</i><br><ol><li>Syr Darya</li></ol>
Taýland	<i>name</i><br><ol><li>Thailand</li></ol>
Trinidad we Tobago	<i>name</i><br><ol><li>Trinidad and Tobago (a country consisting of two main islands in the Caribbean)</li></ol>
Tuwalu	<i>name</i><br><ol><li>Tuvalu</li></ol>
Täjigistan|Тәжигистан|Teajikistan	<i>name</i><br><ol><li>Tajikistan</li></ol>
Täze Zelandiýa	<i>name</i><br><ol><li>New Zealand</li></ol>
Töwriz	<i>name</i><br><ol><li>Tabriz</li></ol>
Türkiýe|Türkiýede|Türkiýäniň|Türkiýeden|Türkiýä|Türkiýäni	<i>name</i><br><ol><li>Turkey</li></ol>
Türkmenistan	<i>name</i><br><ol><li>Turkmenistan</li></ol>
Ukraina	<i>name</i><br><ol><li>Ukraine (a country in Eastern Europe; capital and largest city: Kyiv)</li></ol>
Urugwaý	<i>name</i><br><ol><li>Uruguay (a country in South America)</li></ol>
Wanuatu	<i>name</i><br><ol><li>Vanuatu</li></ol>
Wenesuela	<i>name</i><br><ol><li>Venezuela (a country in South America)</li></ol>
Wengriýa	<i>name</i><br><ol><li>Hungary</li></ol>
Wýetnam	<i>name</i><br><ol><li>Vietnam</li></ol>
Yrak|Ырак	<i>name</i><br><ol><li>Iraq</li></ol>
Ysraýyl	<i>name</i><br><ol><li>Israel</li></ol>
a|A	<i>character</i><br><ol><li>The first letter of the Turkmen alphabet, written in the Latin script.</li></ol>
abadançylyk	<i>noun</i><br><ol><li>prosperity</li></ol>
adat|adada|adady|adatlar|adadyň|adatlara|adatda|adatlarda|adatlardan|adatlary|adatlaryň|adatdan	<i>noun</i><br><ol><li>custom</li></ol>
adrenalin	<i>noun</i><br><ol><li>adrenaline</li></ol>
agawa	<i>noun</i><br><ol><li>agave</li></ol>
agaç|agaja|agaçda|agaçlarda|agajyň|agajy|agaçlary|agaçdan|agaçlara|agaçlaryň|agaçlar|agaçlardan	<i>noun</i><br><ol><li>tree</li></ol>
aglamak	<i>verb</i><br><ol><li>to cry, bewail, wail, weep.</li></ol>
agyr|agyrrak|iň agyr	<i>adj</i><br><ol><li>heavy</li></ol>
agyz|agyzlarda|agyzdan|agyzlary|agza|agyzlara|agzy|agyzlardan|agzyň|agyzlar|agyzda|agyzlaryň	<i>noun</i><br><ol><li>mouth</li></ol>
agşam|agşamlar|agşamy	<i>noun</i><br><ol><li>evening</li></ol>
ajy|ajyrak|iň ajy	<i>adj</i><br><ol><li>bitter (having an acrid taste)</li></ol>
ak|akrak|iň ak	<i>adj</i><br><ol><li>white</li></ol>
ak öý	<i>noun</i><br><ol><li>yurt</li></ol>
akademiýa|akademiýā|akademiýanyň|akademiýalar|akademiýalardan|akademiýalary|akademiýada|akademiýalaryň|akademiýalarda|akademiýalara|akademiýadan|akademiýany	<i>noun</i><br><ol><li>academy</li></ol>
akula|akuladan|akulalaryň|akulalar|akulā|akulalara|akulany|akulada|akulalardan|akulalary|akulanyň|akulalarda	<i>noun</i><br><ol><li>shark</li></ol>
akyl|akyllara|akyly|akyldan|akylyň|akyllary|akyllar|akyla|akyllardan|akyllaryň|akyllarda|akylda	<i>noun</i><br><ol><li>mind</li></ol>
alaşa	
allergiýa|allergiýalara|allergiýany|allergiýalardan|allergiýanyň|allergiýada|allergiýā|allergiýalarda|allergiýadan|allergiýalaryň|allergiýalary|allergiýalar	<i>noun</i><br><ol><li>(pathology, immunology) allergy</li></ol>
alma	<i>noun</i><br><ol><li>apple</li></ol>
altmyş	<i>num</i><br><ol><li>sixty</li></ol>
alty	<i>num</i><br><ol><li>six</li></ol>
altyn|altynlarda|altьn|altьnlar|altynlar|altyndan|altyny|altyna|altynlara|altynlary|altynyň|altynda|altynrak|altynlardan|altynlaryň|iň altyn|altьnь	<i>noun</i><br><ol><li>gold</li></ol><br><i>adj</i><br><ol><li>golden</li></ol>
alýuminiý|alýuminiýlerde|alýuminiýleri|alýuminiýlere|alýuminiýe|alýuminiýler|alýuminiýleriň|alýuminiýiň|alýuminiýde|alýuminiýden|alýuminiýi|alýuminiýlerden	<i>noun</i><br><ol><li>aluminium</li></ol>
ammar	
anna|annalar|annany	<i>noun</i><br><ol><li>Friday</li></ol>
ant	<i>noun</i><br><ol><li>oath</li></ol>
aprel|apreller|apreli	<i>noun</i><br><ol><li>April</li></ol>
aram	<i>noun</i><br><ol><li>peacefulness</li></ol>
arpa	<i>noun</i><br><ol><li>barley</li></ol>
ary|arylar|aryny	<i>noun</i><br><ol><li>bee</li></ol>
arzuw|arzuwlar|arzuwu	<i>noun</i><br><ol><li>desire</li></ol>
asyr|asyrlar|asyry	<i>noun</i><br><ol><li>century</li></ol>
at|atda|atdan|atlary|atlara|at|atlardan|adyň|atlaryň|ada|atlarda|ata|atlar|atyň|aty|ady	<i>noun</i><br><ol><li>horse</li><li>name</li></ol>
atuw	<i>noun</i><br><ol><li>execution by firearms</li></ol>
awgust|awgusty|awgustlar	<i>noun</i><br><ol><li>August</li></ol>
awlamak	<i>verb</i><br><ol><li>to hunt</li></ol>
awtobus|awtobusy|awtobuslar	<i>noun</i><br><ol><li>bus</li></ol>
azat|iň azat|azatrak	<i>adj</i><br><ol><li>free</li></ol>
azatlyk|azatlygy|azatlyklar	<i>noun</i><br><ol><li>freedom, liberty</li></ol>
aý|aýydan|aýlarda|aýyň|aýa|aýylar|aýlaryň|aýylarda|aýlar|aýlara|aýda|aýdan|aýylary|aýynyň|aýyda|aýylara|aýā|aýy|aýlardan|aýylaryň|aýyny|aýlary|aýylardan	<i>noun</i><br><ol><li>month</li><li>moon</li></ol>
aýak|aýaklardan|aýaklary|aýakdan|aýagy|aýaklar|aýaky|aýakyň|aýaka|aýaklara|aýaklarda|aýakda|aýaklaryň	<i>noun</i><br><ol><li>(anatomy) leg</li></ol>
aýakgap	<i>noun</i><br><ol><li>shoe</li></ol>
aýaz|aýazlar|aýazy	<i>noun</i><br><ol><li>frost</li></ol>
aýdym|aýdymlar|aýdymy	<i>noun</i><br><ol><li>song</li></ol>
aýy|aýydan|aýylaryň|aýylary|aýyny|aýylarda|aýynyň|aýylardan|aýyda|aýylara|aýylar|aýā	<i>noun</i><br><ol><li>(zoology) bear</li></ol>
b|B	<i>character</i><br><ol><li>The second letter of the Turkmen alphabet, written in the Latin script.</li></ol>
badam	<i>noun</i><br><ol><li>almond</li></ol>
badamjan|badamjandan|badamjanlaryň|badamjanyň|badamjanlarda|badamjanlar|badamjanlardan|badamjanda|badamjanlara|badamjanlary|badamjana|badamjany	<i>noun</i><br><ol><li>eggplant, aubergine</li></ol>
bag|baglar|bagy	<i>noun</i><br><ol><li>garden</li></ol>
bagyr|bagyrlara|bagyryň|bagyrlary|bagyra|bagyry|bagyrdan|bagyrda|bagyrlarda|bagyrlar|bagyrlaryň|bagyrlardan	<i>noun</i><br><ol><li>liver</li></ol>
bakmak|bakjakdylar|bagypdyrlar|bakdyňyz|bagardyň|bakmakçydyňyz|bakýārys|bagan|bagypsyňyz|bakmakçydyk|bakmakçydylar|bakdylar|baksaň|bakýārsyn|bagypdyk|bakmalydylar|bagypdym|bagypdyr|bagypdyryn|bagaryn|bakaýyň|bakmakçy|bakyň|bak|bakalyň|present participle + conditional of bolmak|bakýān|past participle + conditional of bolmak|bakjakdyk|bakjak|bagypdyrys|bakýār|bakdym|bagardyňyz|bakjakdy|bakmaly|bagypdyňyz|bakmalydy|bakmakçydym|bakmalydyňyz|bakýāryn|bagypdy|bagarlar|bagypdylar|bagardym|bakmakçydyň|bagardyk|bakjakdyň|baksa|bakmalydyk|bagarys|bagardy|bakdyň|bakjakdym|bagardylar|bagarsyň|baksam|baksaňyz|baksyn|bakýārlar|bakmalydym|bakdy|bakmakçydy|bagar|bagypsyň|bagypdyň|bakýārsyňyz|bagyş|bagarsyňyz|baksak|baksalar|baksynlar|future participle + conditional of bolmak|bakmalydyň|bakdyk|bakjakdyňyz	<i>verb</i><br><ol><li>to look</li><li>to graze</li></ol>
bal|baly|ballar	<i>noun</i><br><ol><li>honey</li></ol>
baldyz	<i>noun</i><br><ol><li>a woman's husband's younger sister</li></ol>
balyk|balykda|balykdan|balyklar|balyklara|balyklaryň|balykyň|balyklardan|balyklarda|balygy|balyka|balyky|balyklary	<i>noun</i><br><ol><li>fish</li></ol>
balykçy|balykçyny|balykçylar	<i>noun</i><br><ol><li>fisherman</li></ol>
banan|bananlar|banany	<i>noun</i><br><ol><li>banana</li></ol>
bap	<i>noun</i><br><ol><li>chapter</li></ol>
barmak|barmaklarda|barmaklar|barmaklaryň|barmaklardan|barmagy|barmaka|barmakda|barmaklary|barmakdan|barmaklara|barmakyň|barmaky	<i>noun</i><br><ol><li>finger</li></ol>
baýdak|baýdaklar|baýdagy	<i>noun</i><br><ol><li>flag</li></ol>
baýlyk|baýlygy|baýlyklar	<i>noun</i><br><ol><li>wealth</li></ol>
baş|başlardan|başlary|başdan|başa|başlaryň|başy|başyň|başda|başlarda|bāş|başlar|baş|başlara	<i>noun</i><br><ol><li>(anatomy) head</li><li>wound</li></ol>
bejermek|bejerseler|bejerýǟr|bejerersiň|bejeripdik|bejereýiň|bejeriş|bejersinler|bejererdiň|bejermeli|bejerjekdim|bejeriň|bejerjekdi|bejerseňiz|bejermelidim|bejermelidik|bejermekçidiň|bejermekçi|bejerdi|bejerýǟrin|bejermelidiň|bejer|bejermekçidik|bejersin|bejerjekdiler|bejerdiň|bejeripsiňiz|bejermekçidi|bejeripdiris|present participle + conditional of bolmak|bejeripdiler|bejerjekdiňiz|bejersem|bejerýǟris|bejerersiňiz|past participle + conditional of bolmak|bejermekçidiňiz|bejerdim|bejerdiňiz|bejerýǟrsin|bejereliň|bejerer|bejererdim|bejermelidiňiz|bejereris|bejerdik|bejerjekdiň|bejeripdi|bejermelidi|bejeripsiň|bejeripdim|bejererler|bejeripdir|bejererdi|bejererdiler|bejeren|bejerýǟrler|bejererdik|bejerjek|bejerýǟn|bejeripdirin|bejermekçidim|bejersek|bejerdiler|bejeripdiň|bejerse|bejerjekdik|bejeripdirler|bejermekçidiler|bejerseň|bejererin|bejermelidiler|bejererdiňiz|future participle + conditional of bolmak|bejeripdiňiz|bejerýǟrsiňiz	<i>verb</i><br><ol><li>to prepare the land for sowing (by plowing and watering)</li><li>to embellish</li><li>to repair, mend</li><li>to sew, patch</li><li>to look after, care for</li><li>to cure a disease</li></ol>
benewşe|benewşeräk|iň benewşe	<i>adj</i><br><ol><li>purple</li></ol>
bermek|bērmekçidiňiz|bēripsiňiz|bērjekdiňiz|bērjekdi|bērdim|bērdiler|bēriň|bērerdiň|bērýǟn|bēreliň|bērer|bēreýiň|bērersiňiz|bērseň|bērerin|bērsinler|bērýǟr|bērdiňiz|bērerdi|bērjekdiler|bērmeli|bērjekdik|bērsin|bērmekçidik|bērýǟrsin|bērmelidiň|bērjek|bērmelidiňiz|bērdi|bērdiň|bērjekdiň|bēripdiňiz|bērerler|bēripdim|present participle + conditional of bolmak|bērýǟrler|past participle + conditional of bolmak|bērsek|bērmelidi|bēripdi|bērmekçidi|bērerdiňiz|bēripdiris|bēren|bēripdir|bēriş|bēripdirin|bēripdirler|bērseler|bērerdik|bēr|bērmelidim|bēripdiler|bēreris|bērerdim|bērmekçidim|bērerdiler|bērmekçidiň|bērdik|bērmekçi|bērmelidik|bērýǟrin|bērýǟrsiňiz|bērýǟris|bēripdiň|bērsem|bēripdik|bērmekçidiler|bērmelidiler|bēripsiň|bērse|future participle + conditional of bolmak|bērmek|bērersiň|bērseňiz|bērjekdim	<i>verb</i><br><ol><li>to give</li></ol>
bilim	<i>noun</i><br><ol><li>science</li></ol>
bilmek|bilipdirler|biljekdiň|biljekdiler|bileýiň|bilsinler|biliş|bilmekçidiň|bilipdiňiz|bilsem|bilmekçidi|biljekdim|bilmekçidik|bilerdiň|bilmelidik|bilersiň|bildi|bilmelidiňiz|bilýǟrler|bilipdiler|bilerdiňiz|biljekdik|present participle + conditional of bolmak|bilipdi|bilipdiris|past participle + conditional of bolmak|bilseňiz|biliň|bilmelidim|bildik|bilerin|bilmekçidim|bilýǟrin|bildiň|bilipdim|bilerler|bilmeli|bilýǟrsin|bilipdiň|bildiler|bilersiňiz|bilýǟris|bilerdik|bilsin|bilmekçidiňiz|bilipdik|biljek|bilmekçi|bilerdiler|biler|bilsek|biljekdi|bil|bildim|bilýǟrsiňiz|bilen|bilipsiň|bilýǟn|bilipdir|bildiňiz|bilmekçidiler|bilipdirin|bilmelidi|bilýǟr|bilmelidiň|bilmelidiler|bilse|biljekdiňiz|bileliň|bilerdim|bilseň|bilerdi|bilseler|bileris|future participle + conditional of bolmak|bilipsiňiz	<i>verb</i><br><ol><li>to know (something)</li></ol>
bir|бир	<i>num</i><br><ol><li>one</li></ol>
birinji	<i>adj</i><br><ol><li>first</li></ol>
birlik|birlikler|birliki	<i>noun</i><br><ol><li>union, uniqueness</li><li>partnership</li><li>lonesome</li></ol>
bit|bitler|bidiň|bitleri|bitlerden|bitlere|bitde|bitden|bitleriň|bide|bitlerde|bidi	<i>noun</i><br><ol><li>(zoology) louse</li></ol>
biz|men|mende|biziň|meni|bizde|bizden|menden|bizi|meniň|bize|maňa	<i>pron</i><br><ol><li>(personal) we</li></ol>
bogaz|bogazlary|bogazlardan|bogaza|bogazlara|bogazyň|bogazda|bogazlarda|bogazlaryň|bogazdan|bogazy|bogazlar	<i>noun</i><br><ol><li>(anatomy) throat</li><li>(geography) sound, strait</li></ol>
bolmak|bolýārsyn|bolardym|bolupsyňyz|bolmalydyňyz|bolarsyň|boljakdyk|bolupdyrys|bolardyňyz|boljak|bolsa|bolupdyrlar|bolar|bolarsyňyz|bolsalar|boljakdyň|bolmaly|bolaryn|bol|bolsun|bolyň|bolmakçydy|bolardy|bolýāryn|bolýārys|bolmalydy|bolupdyňyz|bolsak|boljakdylar|boljakdy|bolsaňyz|bolupdy|present participle + conditional of bolmak|bolmalydyň|bolmakçy|past participle + conditional of bolmak|bolmakçydylar|boldu|bolýārsyňyz|bolýār|bolmakçydym|bolsaň|bolarlar|bolupdyryn|bolalyň|bolmakçydyň|bolaýyň|bolsunlar|bolduk|boldum|boluş|bolardylar|bolmakçydyk|bōlmak|bolan|bolduň|boldular|bolupsyň|bolsam|bolupdyr|boljakdyňyz|bolupdyk|boljakdym|bolmalydym|bolmalydyk|bolupdylar|bolmalydylar|bolardyň|bolmakçydyňyz|bolupdym|future participle + conditional of bolmak|bolduňyz|bolarys|bolýārlar|bolýān|bolupdyň|bolardyk	<i>verb</i><br><ol><li>to be</li><li>to become</li><li>to happen, occur</li></ol>
boran	
bu ýerde	<i>adv</i><br><ol><li>here</li></ol>
bugdaý|bugdaýyň|bugdaýda|bugdaýa|bugdaýy|bugdaýdan	<i>noun</i><br><ol><li>wheat</li></ol>
bulut|bulutlar|buludu	<i>noun</i><br><ol><li>cloud</li></ol>
burun|burunu|burunlar	<i>noun</i><br><ol><li>(anatomy) nose</li></ol>
buz|buzlar|buzlary|buzlara|buzdan|buzlardan|buzlarda|buza|būz|buzda|buzlaryň|buzuň|buzy	<i>noun</i><br><ol><li>ice</li></ol>
bäri	<i>adv</i><br><ol><li>here</li></ol>
bäş|beash|bä¢	<i>num</i><br><ol><li>five</li></ol>
bäşinji	<i>num</i><br><ol><li>fifth</li></ol>
böri|börüler|börüni	<i>noun</i><br><ol><li>wolf</li></ol>
böwürslen|böwürsleni|böwürslenleri|böwürslenden|böwürsleniň|böwürslenlerde|böwürslenlere|böwürslenlerden|böwürslende|böwürslene|böwürslenleriň|böwürslenler	<i>noun</i><br><ol><li>blackberry</li></ol>
bürgüt	<i>noun</i><br><ol><li>eagle</li></ol>
bürünç|bürünçler|bürünji	<i>noun</i><br><ol><li>rice</li><li>bronze</li></ol>
bütin	<i>det</i><br><ol><li>all</li><li>whole, entire, all</li></ol>
d|D	<i>character</i><br><ol><li>The fourth letter of the Turkmen alphabet, called de and written in the Latin script.</li></ol>
dag|daga|dagy|dagdan|daglardan|daglary|dagyň|daglarda|dagda|daglara|daglaryň|daglar	<i>noun</i><br><ol><li>mountain</li></ol>
damja|damjada|damjalary|damjalaryň|damjalarda|damjalara|damjalardan|damjany|damjā|damjalar|damjanyň|damjadan	<i>noun</i><br><ol><li>drop</li></ol>
daramak|darady|darapdyrys|dararyn|darardym|darasaňyz|daradyňyz|dararsyň|daradyk|darasyn|darālyň|darāň|daramakçy|daramakçydy|darajak|daradym|darapsyň|darardyňyz|darasa|daradylar|darapdyr|daramakçydyň|dararsyňyz|darapdyrlar|darajakdylar|daraýārys|daraýān|darapdylar|darasaň|present participle + conditional of bolmak|dara|past participle + conditional of bolmak|daramalydyňyz|darapdyryn|darardyk|darasynlar|daramakçydyňyz|daraýārsyn|darardyň|daraýyş|darasam|daraýār|darapdyňyz|darapsyňyz|darajakdyňyz|daramalydylar|daramalydyk|daran|dararys|darajakdy|daraýāryn|darapdy|daraýārsyňyz|darar|darasak|darapdyň|darāýyn|daramaly|daramakçydylar|darajakdym|darapdyk|darasalar|darajakdyk|darardy|darajakdyň|daramalydyň|darardylar|dararlar|daraýārlar|daramakçydym|darapdym|daramakçydyk|daramalydy|daradyň|future participle + conditional of bolmak|daramalydym	<i>verb</i><br><ol><li>(transitive) to comb</li></ol>
daň|daňa|daňlaryň|daňdan|daňlary|daňlardan|daňlar|daňlarda|daňlara|daňy|daňda|daňyň	<i>noun</i><br><ol><li>dawn, daybreak</li></ol>
daş|daşlar|daşy	<i>noun</i><br><ol><li>stone</li></ol>
dekabr|dekabry|dekabrlar	<i>noun</i><br><ol><li>December</li></ol>
dem almak|dem aljak|dem alardylar|dem alýārys|dem alarys|dem aljakdyň|dem aljakdyňyz|dem alýāryn|dem almalydylar|dem alarsyňyz|dem alsalar|dem aldylar|dem alýār|dem alar|dem aldyk|dem aljakdy|dem almalydyňyz|dem alsam|dem aljakdylar|dem almalydy|dem aldym|dem alsaň|dem aldyňyz|dem almalydym|dem aldy|dem alypsyňyz|dem alypdyňyz|dem almakçydy|dem aljakdym|present participle + conditional of bolmak|dem alypdym|past participle + conditional of bolmak|dem alalyň|dem aldyň|dem alypdyk|dem alyş|dem alýārlar|dem alsynlar|dem alarlar|dem almakçydyň|dem almakçydyňyz|dem alyň|dem alypdyň|dem alypdyr|dem alypdyryn|dem alypsyň|dem alardyk|dem alardyňyz|dem aljakdyk|dem alypdylar|dem alardy|dem alaýyň|dem alan|dem alýārsyn|dem alýārsyňyz|dem alypdyrys|dem alardym|dem almakçydyk|dem almakçydylar|dem al|dem almalydyk|dem alypdyrlar|dem almaly|dem alaryn|dem almakçydym|dem alypdy|dem alsa|dem alsak|dem almakçy|future participle + conditional of bolmak|dem alýān|dem alsaňyz|dem alarsyň|dem almalydyň|dem alardyň|dem alsyn	<i>verb</i><br><ol><li>to breathe</li></ol>
demirgazyk|demirgazygy	<i>noun</i><br><ol><li>north</li></ol>
derýa|derýany|derýalar	<i>noun</i><br><ol><li>river</li></ol>
deňiz|deňizler|deňzi	<i>noun</i><br><ol><li>sea</li></ol>
dinozawr|dinozawrlar|dinozawrlary|dinozawrda|dinozawrlaryň|dinozawrlara|dinozawrdan|dinozawry|dinozawrlarda|dinozawrlardan|dinozawra|dinozawryň	<i>noun</i><br><ol><li>dinosaur</li></ol>
disket	<i>noun</i><br><ol><li>(computing) diskette, floppy disk</li></ol>
diş|dīş|dişi|dişleri|dişden|dişlerden|dişde|dişlere|dişe|dişleriň|dişiň|dişlerde|dişler	<i>noun</i><br><ol><li>tooth</li></ol>
dişlemek	<i>verb</i><br><ol><li>to bite</li></ol>
doglan günüň gutly bolsun	<i>intj</i><br><ol><li>happy birthday</li></ol>
dokuz	<i>num</i><br><ol><li>nine</li></ol>
doly|dolylar|dolyrak|dolyny|dolyda|dolylarda|dōly|dolā|dolylaryň|dolynyň|dolylardan|dolylary|dolylara|dolydan|iň doly	<i>adj</i><br><ol><li>full</li><li>heavy, massive, bulky, corpulent (of bodies)</li></ol><br><i>noun</i><br><ol><li>(meteorology) hail (icy rain)</li></ol>
doňuz|doňuzlar|doňzy	<i>noun</i><br><ol><li>pig, swine</li></ol>
durmuş|durmuşlar|durmuşy	<i>noun</i><br><ol><li>life</li></ol>
duz|duzlar|duzy	<i>noun</i><br><ol><li>salt</li></ol>
duýgy|duýgylary|duýgydan|duýgylarda|duýgylardan|duýgyny|duýgā|duýgylara|duýgylaryň|duýgyda|duýgynyň|duýgylar	<i>noun</i><br><ol><li>feeling</li><li>emotion</li></ol>
duýmak	<i>verb</i><br><ol><li>to feel (an emotion or sensation)</li><li>to perceive (by ears or nose)</li></ol>
duşenbe|duşenbeler|duşenbeni	<i>noun</i><br><ol><li>Monday</li></ol>
duşman|duşmandan|duşmanlardan|duşmanlar|duşmanyň|duşmanlaryň|duşmanda|duşmanlara|duşmanlarda|duşmany|duşmanlary|duşmana	<i>noun</i><br><ol><li>foe, enemy</li></ol>
dynç almak|dynç alarlar|dynç aljakdyň|dynç alsam|dynç alardy|dynç aldylar|dynç alan|dynç alýārsyňyz|dynç almakçy|dynç almakçydyňyz|dynç alypdylar|dynç almakçydylar|dynç alsynlar|dynç almakçydyk|dynç alypdyňyz|dynç alarys|dynç alypsyň|dynç alsalar|dynç aldy|dynç aldyk|dynç alypdyr|dynç alyş|dynç alaryn|dynç almalydylar|dynç alarsyňyz|dynç almakçydym|dynç alaýyň|dynç almalydyňyz|present participle + conditional of bolmak|dynç al|dynç almalydyk|dynç alypsyňyz|dynç alypdy|past participle + conditional of bolmak|dynç aldyň|dynç alypdym|dynç alardyk|dynç alýān|dynç alypdyk|dynç alardyň|dynç alýārsyn|dynç alsaň|dynç alypdyrys|dynç alýār|dynç alsak|dynç alsaňyz|dynç alalyň|dynç aljak|dynç alarsyň|dynç alar|dynç aljakdy|dynç aljakdyk|dynç alýārys|dynç aljakdym|dynç aljakdylar|dynç aldym|dynç alsa|dynç almalydy|dynç almakçydy|dynç almalydym|dynç alypdyryn|dynç alardyňyz|dynç aldyňyz|dynç alardylar|dynç alardym|dynç alýārlar|dynç aljakdyňyz|dynç almakçydyň|dynç alypdyň|dynç almaly|dynç alyň|dynç alypdyrlar|future participle + conditional of bolmak|dynç almalydyň|dynç alýāryn|dynç alsyn	<i>verb</i><br><ol><li>to rest</li></ol>
dyrnak|dyrnaklar|dyrnagy	<i>noun</i><br><ol><li>nail</li><li>fingernail</li></ol>
dyz|dyzlara|dyzlardan|dyzy|dyzlarda|dyzyň|dyzlar|dyza|dyzda|dyzlary|dyzdan|dyzlaryň	<i>noun</i><br><ol><li>knee</li></ol>
dört	<i>num</i><br><ol><li>four</li></ol>
döwlet|döwleti|döwletler	<i>noun</i><br><ol><li>state</li></ol>
döwür|döwürleri|döwürlerde|döwürleriň|döwürlerden|döwriň|döwürler|döwürlere|döwri|döwürden|döwürde|döwre	<i>noun</i><br><ol><li>period, era, epoch</li></ol>
dünýä|dünýälerde|dünýäden|dünýäde|dünýäniň|dünýäleri|dünýē|dünýälere|dünýälerden|dünýäleriň|dünýäni|dünýäler	<i>noun</i><br><ol><li>world</li></ol>
düýe|düýeni|düýeler	<i>noun</i><br><ol><li>camel</li></ol>
düýeguş|düýeguşlara|düýeguşlarda|düýeguşlary|düýeguşlardan|düýeguşlaryň|düýeguşa|düýeguşuň|düýeguşdan|düýeguşlar|düýeguşda|düýeguşy	<i>noun</i><br><ol><li>ostrich</li></ol>
düýn|düýnler|ü	<i>noun</i><br><ol><li>yesterday</li></ol>
düýş|düýşi|düýşler	<i>noun</i><br><ol><li>dream</li></ol>
e|E	<i>character</i><br><ol><li>The fifth letter of the Turkmen alphabet, called e and written in the Latin script.</li></ol>
edebi|edebiräk|iň edebi	<i>adj</i><br><ol><li>literary</li></ol>
edebiýat|edebiýaty|edebiýatlar	<i>noun</i><br><ol><li>literature</li></ol>
eje	<i>noun</i><br><ol><li>mother</li></ol>
elipbiý|elipbiýleri|elipbiýi|elipbiýlerden|elipbiýler|elipbiýden|elipbiýleriň|elipbiýe|elipbiýiň|elipbiýde|elipbiýlere|elipbiýlerde	<i>noun</i><br><ol><li>alphabet</li></ol>
elli	<i>num</i><br><ol><li>fifty</li></ol>
energiýa|energiýany|energiýalar	<i>noun</i><br><ol><li>energy</li></ol>
esger|esgerde|esgere|esgerden|esgerlere|esgeri|esgerlerde|esgerlerden|esgerleriň|esgeriň|esgerler|esgerleri	<i>noun</i><br><ol><li>soldier</li></ol>
etaž|etažlardan|etažlarda|etažyň|etažy|etažlaryň|etaždan|etažlary|etaža|etažlara|etažlar|etažda	<i>noun</i><br><ol><li>floor, storey</li></ol>
eýmenmek|eýmenmelidiň|eýmenýǟn|eýmenipsiň|eýmeneris|eýmenerler|eýmenerdiler|eýmenjekdiň|eýmendiň|eýmensinler|eýmenýǟrin|eýmenipdiňiz|eýmenmekçidik|eýmendiler|eýmenersiňiz|eýmenipdiris|eýmenseň|eýmenipdirin|eýmenseler|eýmenmekçi|eýmener|eýmen|eýmenmelidim|eýmenmelidi|eýmendiňiz|eýmenmekçidiler|eýmenmelidik|eýmenmelidiňiz|eýmenjekdiler|eýmendim|eýmenipdi|eýmeneýiň|eýmenýǟr|eýmenmelidiler|eýmenerdiňiz|eýmenmeli|eýmenmekçidi|present participle + conditional of bolmak|eýmeneliň|eýmenerin|eýmensem|eýmensek|past participle + conditional of bolmak|eýmense|eýmenjekdi|eýmenjekdik|eýmenýǟrsin|eýmenerdi|eýmenjekdiňiz|eýmenseňiz|eýmenjek|eýmendi|eýmenipdim|eýmenipsiňiz|eýmenerdik|eýmenmekçidim|eýmenýǟris|eýmenýǟrsiňiz|eýmenipdiler|eýmenerdim|eýmenipdirler|eýmeniş|eýmenipdik|eýmenýǟrler|eýmenipdiň|eýmenerdiň|eýmenmekçidiňiz|eýmeniň|future participle + conditional of bolmak|eýmenmekçidiň|eýmenipdir|eýmensin|eýmenersiň|eýmenjekdim|eýmenen|eýmendik	<i>verb</i><br><ol><li>to fear</li><li>to be afraid</li></ol>
eýranly	<i>noun</i><br><ol><li>Iranian (person)</li></ol>
eşek|eşekiň|eşeklere|eşegi|eşeke|eşekleriň|eşeklerde|eşeklerden|eşekleri|eşekde|eşekden|eşeki|eşekler	<i>noun</i><br><ol><li>donkey</li></ol>
eşitmek|eşidipdik|eşiderdiler|eşidipsiňiz|eşider|eşitmelidim|eşitdiň|eşidipdiris|eşitmelidiň|eşitdim|eşitmekçidiler|eşidipdirler|eşidipdir|eşitsin|eşitýǟrin|eşiderdik|eşitmelidi|eşitmekçidiňiz|eşitdiňiz|eşidipdiňiz|eşideris|eşitýǟrsiňiz|eşiderdiňiz|eşitjekdim|eşitseň|present participle + conditional of bolmak|past participle + conditional of bolmak|eşitmekçidi|eşitýǟr|eşitmekçidik|eşit|eşidipdi|eşitse|eşitjekdi|eşitmeli|eşitýǟrsin|eşiderin|eşidersiňiz|eşitýǟris|eşitsinler|eşitmelidik|eşiteliň|eşitdik|eşitiň|eşidipdiler|eşitýǟrler|eşitjekdiler|eşitjekdik|eşidipdirin|eşitmekçidiň|eşitmekçi|eşitjek|eşidipsiň|eşiderdim|eşidersiň|eşiderdi|eşitjekdiň|eşitsem|eşitdi|eşiderler|eşitmelidiňiz|eşidiş|eşitmekçidim|eşitdiler|eşidipdiň|eşitmelidiler|eşitseler|eşiteýiň|future participle + conditional of bolmak|eşitsek|eşitjekdiňiz|eşitseňiz|eşiden|eşidipdim|eşitýǟn|eşiderdiň	<i>verb</i><br><ol><li>to hear</li></ol>
f|F	<i>character</i><br><ol><li>The seventh letter of the Turkmen alphabet, called fe and written in the Latin script.</li></ol>
fabrik|fabrikler|fabrigi	<i>noun</i><br><ol><li>factory</li></ol>
familiýa|familiýā|familiýadan|familiýalary|familiýada|familiýalara|familiýalardan|familiýanyň|familiýany|familiýalaryň|familiýalarda|familiýalar	<i>noun</i><br><ol><li>surname, last name, family name</li></ol>
fe|feni|feler	<i>noun</i><br><ol><li>The name of the Latin-script letter F.</li></ol>
fewral|fewralyň|fewraldan|fewraly|fewrala|fewralda|fewrallary|fewrallar|fewrallara|fewrallarda|fewrallaryň|fewrallardan	<i>noun</i><br><ol><li>February (second month of the Gregorian calendar)</li></ol>
furgon|furgonlar|furgonu	<i>noun</i><br><ol><li>van (small covered vehicle)</li></ol>
g|G	<i>character</i><br><ol><li>The eighth letter of the Turkmen alphabet, called ge and written in the Latin script.</li></ol>
gadymy|gadymyrak|iň gadymy	<i>adj</i><br><ol><li>ancient</li></ol>
gahryman|gahrymany|gahrymanyň|gahrymana|gahrymanlardan|gahrymanlar|gahrymanlary|gahrymanlaryň|gahrymanlara|gahrymanlarda|gahrymanda|gahrymandan	<i>noun</i><br><ol><li>hero</li></ol>
galam|galamlar|galamlarda|galamlardan|galamlary|galamy|galamlara|galamda|galamlaryň|galamdan|galama|galamyň	<i>noun</i><br><ol><li>pencil</li></ol>
galyň|galyňrak|iň galyň	<i>adj</i><br><ol><li>thick</li></ol>
gamburger|gamburgerlerden|gamburgerleri|gamburgerlere|gamburgerleriň|gamburgerlerde|gamburgeriň|gamburgerde|gamburgerler|gamburgere|gamburgerden|gamburgeri	<i>noun</i><br><ol><li>hamburger</li></ol>
gan|ganlaryň|ganlarda|ganlary|ganyň|ganlar|gany|ganda|ganlara|ganlardan|gana|gandan	<i>noun</i><br><ol><li>blood</li></ol>
ganat|ganaty|ganatlar	<i>noun</i><br><ol><li>wing</li></ol>
gaplaň|gaplaňdan|gaplaňlaryň|gaplaňlar|gaplaňa|gaplaňlardan|gaplaňyň|gaplaňda|gaplaňlary|gaplaňlara|gaplaňlarda|gaplaňy	<i>noun</i><br><ol><li>tiger</li></ol>
gapy|gapyny|gapydan|gapyda|gapylaryň|gapylar|gapylara|gapylardan|gapylarda|gapylary|gapā|gapynyň	<i>noun</i><br><ol><li>door</li></ol>
gar	<i>noun</i><br><ol><li>snow</li></ol>
gara|iň gara|gararak	<i>adj</i><br><ol><li>black</li></ol>
gara öý	<i>noun</i><br><ol><li>yurt</li></ol>
garaşsyzlyk|garaşsyzlygy|garaşsyzlyklar	<i>noun</i><br><ol><li>independence</li></ol>
garpyz|garpyzlar|garpyzy|гарпыз	<i>noun</i><br><ol><li>watermelon</li></ol>
garyn|garynlar|garyny	<i>noun</i><br><ol><li>belly</li></ol>
garynja|garynjalaryň|garynjalara|garynjada|garynjalar|garynjā|garynjany|garynjalarda|garynjanyň|garynjadan|garynjalary|garynjalardan	<i>noun</i><br><ol><li>ant</li></ol>
gatyk|gatykyň|gatyklara|gatyklarda|gatyklary|gatyklar|gatyklardan|gatygy|gatyka|gatykda|gatykdan|gatyky|gatyklaryň	<i>noun</i><br><ol><li>yoghurt, yogurt</li></ol>
gawun|gawuny|gawunlar|قاون	<i>noun</i><br><ol><li>melon</li></ol>
gazmak|gazardy|gazypdyrlar|gazmakçydyň|gazjakdyň|gaz|gazjak|gazan|gazýān|gazarlar|gazmakçydyňyz|gazardylar|gazmalydyň|gazjakdyk|gazdyň|gazaryn|gazdylar|gazjakdy|gazypdyrys|gazsak|gazsaňyz|gazypdym|gazsaň|gazmalydym|gazmakçy|gazypdyňyz|gazypdyr|gazmakçydyk|gazsalar|gazýārys|gazjakdym|gazsyn|present participle + conditional of bolmak|gazypdyk|gazmakçydy|past participle + conditional of bolmak|gazýār|gazýāryn|gazmalydy|gazarys|gazyş|gazypdyryn|gazypdyň|gazalyň|gazsa|gazaýyň|gazardyň|gazyň|gazmakçydym|gazypsyň|gazarsyňyz|gazmalydyňyz|gazarsyň|gazmaly|gazdyňyz|gazjakdylar|gazmalydyk|gazýārlar|gazdym|gazmalydylar|gazar|gazypdy|gazardym|gazdy|gazardyk|gazardyňyz|gazdyk|gazjakdyňyz|gazypsyňyz|gazýārsyňyz|future participle + conditional of bolmak|gazsynlar|gazmakçydylar|gazýārsyn|gazsam|gazypdylar	<i>verb</i><br><ol><li>to dig</li></ol>
ge|geler|geni	<i>noun</i><br><ol><li>The name of the Latin-script letter G.</li></ol>
gelmek|gelen|gelipdiňiz|gelipsiňiz|geleris|gelýǟrler|geldi|geldik|geljekdik|geleliň|geljekdiňiz|gelmelidik|gelýǟrsiňiz|geldiňiz|gelipdiris|gelipdiler|gelseň|gelýǟrsin|gelmekçidik|geljek|gelmekçi|gelerdiň|geljekdiler|gelipdim|gelmelidi|gelerler|geldiler|gelýǟris|gelipdik|gelerdiňiz|gelseňiz|gelmekçidiň|gelipdir|present participle + conditional of bolmak|gel|geliň|past participle + conditional of bolmak|gelmekçidiňiz|gelipdi|gelmelidiler|gelipdirler|gelmelidiň|gelýǟn|geler|gelmekçidim|geljekdi|gelipdiň|gelipdirin|gelýǟrin|gelsin|gelmelidim|gelerdim|gelmekçidi|gelerin|geljekdiň|gelipsiň|gelerdiler|gelsinler|gelmekçidiler|geldim|gelersiňiz|geljekdim|gelerdik|gelseler|gelersiň|geldiň|gelsem|gelmeli|gelse|future participle + conditional of bolmak|geleýiň|gelerdi|gelýǟr|gelsek|geliş|gelmelidiňiz	<i>verb</i><br><ol><li>to come</li></ol>
gerb|gerbi|gerbler	<i>noun</i><br><ol><li>coat of arms</li></ol>
geň	<i>noun</i><br><ol><li>surprising</li></ol>
gije|gijäniň|gijeleri|gijeler|gijelere|gijeleriň|gijeni|gijä|gijeden|gijede|gijäni|gijelerden|gijelerde	<i>noun</i><br><ol><li>night</li></ol>
gitmek|gidipsiňiz|gitdim|gitsek|gitmelidi|giderdik|gitdiňiz|gidersiň|gitjek|gitdiň|gitmekçidim|gitsin|gitmekçidiňiz|gitýǟrler|gitýǟrsin|gitjekdi|gidipdir|giderler|git|gidipdi|gitýǟris|gidipdik|gidipdiris|gitjekdiňiz|gitdik|gitýǟr|present participle + conditional of bolmak|gidipsiň|gitýǟn|gidipdiler|gidipdirler|past participle + conditional of bolmak|giteliň|gitmelidik|giderdiň|gitmelidiler|giderdiler|gideris|gitdi|gitjekdik|gidipdiňiz|gitsem|gitseňiz|giteýiň|gitdiler|gidiş|gitmeli|gitmekçidiň|gitmekçidik|gitjekdiler|gitýǟrsiňiz|gitjekdiň|gitseň|gidipdirin|giderdim|gider|gidersiňiz|gitse|gitýǟrin|gitmekçidiler|gidipdim|giderdiňiz|giderdi|gitmelidim|gitmelidiň|gitseler|gitmelidiňiz|gitmekçidi|gitjekdim|gidipdiň|gitsinler|future participle + conditional of bolmak|giderin|gitiň|giden|gitmekçi	<i>verb</i><br><ol><li>to go</li><li>to leave</li><li>to continue, last</li><li>to pay a visit</li></ol>
gorkmak	<i>verb</i><br><ol><li>to fear</li><li>to be afraid</li></ol>
gorky|gorkyny|gorkylar	<i>noun</i><br><ol><li>fear</li></ol>
goýun|goýunlarda|goýundan|goýuna|goýunlaryň|goýunu|goýunlar|goýunuň|goýunlara|goýunda|goýunlardan|goýuny|goýunlary	<i>noun</i><br><ol><li>sheep</li></ol>
goňur|goňurrak|iň goňur	<i>adj</i><br><ol><li>brown</li></ol>
goňşy|goňşynyň|goňşylary|goňşā|goňşylardan|goňşylaryň|goňşylara|goňşyda|goňşylarda|goňşyny|goňşylar|goňşydan	<i>noun</i><br><ol><li>neighbor</li></ol>
gul|guldan|gullaryň|gullarda|guluň|gulda|gullardan|gullary|guly|gula|gullara|gullar	<i>noun</i><br><ol><li>slave</li><li>servant</li></ol>
gulak|gulaklary|gulakdan|gulaklaryň|gulagy|gulaka|gulaklar|gulakyň|gulaklara|gulakda|gulaky|gulaklarda|gulaklardan	<i>noun</i><br><ol><li>ear</li></ol>
gulp	<i>noun</i><br><ol><li>lock</li></ol>
gum	<i>noun</i><br><ol><li>sand</li></ol>
gurban|gurbanlar|gurbany	<i>noun</i><br><ol><li>sacrifice</li></ol>
gurşun|gurşunlar|gurşunlarda|gurşunda|gurşuny|gurşunlary|gurşundan|gurşunlara|gurşuna|gurşunlaryň|gurşunlardan|gurşunyň	<i>noun</i><br><ol><li>lead (metal)</li></ol>
guty|gutyny|gutular	<i>noun</i><br><ol><li>box</li></ol>
guw|guwu|guwlar	<i>noun</i><br><ol><li>swan</li></ol>
guzy	<i>noun</i><br><ol><li>lamb</li></ol>
guýruk|guýruklar|guýrugy	<i>noun</i><br><ol><li>tail</li></ol>
guş|guşy|guşlar	<i>noun</i><br><ol><li>bird</li></ol>
guşak|guşaklar|guşagy	<i>noun</i><br><ol><li>belt</li></ol>
gylyç|gylyçlardan|gylyçda|gylyçlar|gylyçlary|gylyçlarda|gylyçlaryň|gylyçlara|gylyçdan|gylyça|gylyçy|gylyjy|gylyçyň	<i>noun</i><br><ol><li>sword</li></ol>
gysga|iň gysga|gysgarak	<i>adj</i><br><ol><li>short</li><li>brief</li></ol>
gyz|gyza|gyzdan|gyzlaryň|gyzyň|gyzlara|gȳz|gyzlardan|gyzlarda|gyzlar|gyzda|gyzlary|gyzy	<i>noun</i><br><ol><li>girl</li></ol>
gyzyl|iň gyzyl|gyzylrak	<i>adj</i><br><ol><li>red</li></ol>
gyzylbaş|gyzylbaşlar|гызылбаш|гызылбашлар|гызылбашы|gyzylbaşy	<i>noun</i><br><ol><li>a Qizilbash</li></ol>
gyş|gyşlar|gyşy	<i>noun</i><br><ol><li>winter</li></ol>
gök|iň gök|gökräk	<i>adj</i><br><ol><li>blue</li></ol>
göreş|göreşe|göreşlere|göreşlerde|göreşde|göreşden|göreşler|göreşlerden|göreşiň|göreşi|göreşleri|göreşleriň	<i>noun</i><br><ol><li>(sports) wrestling, kurash</li><li>war</li></ol>
göwrelilik|göwreliligi|göwrelilikler	<i>noun</i><br><ol><li>pregnancy</li></ol>
göz|gözi|gözlerden|gözlere|gözleri|gözlerde|göziň|gözden|gözler|göze|gözde|gözleriň	<i>noun</i><br><ol><li>(anatomy) eye</li></ol>
gül|gülüň|gülleri|gülde|güllere|güli|gülleriň|gülden|güllerden|güller|güle|güllerde	<i>noun</i><br><ol><li>flower</li></ol>
gün|günlerde|günden|günler|güne|güni|günlere|günde|günlerden|günleriň|günüň|günleri	<i>noun</i><br><ol><li>sun (light and warmth received from the sun)</li><li>daytime</li><li>daylight</li><li>day</li><li>date</li></ol>
günbatar|günbatary	<i>noun</i><br><ol><li>west</li></ol>
gündogar|гүндогар|gündogary	<i>noun</i><br><ol><li>east</li></ol>
günorta|günortany	<i>noun</i><br><ol><li>south</li></ol>
günä|günälere|günäler|günäni|günäleri|günälerden|günē|günäniň|günäden|günäde|günäleriň|günälerde	<i>noun</i><br><ol><li>(religion) sin</li></ol>
gürrüldi|gürrüldide|gürrüldini|gürrüldilerden|gürrüldilere|gürrüldē|gürrüldiler|gürrüldiniň|gürrüldiden|gürrüldilerde|gürrüldileri|gürrüldileriň	<i>noun</i><br><ol><li>noise</li></ol>
güýz|güýzler|güýzi	<i>noun</i><br><ol><li>autumn, fall</li></ol>
h|H	<i>character</i><br><ol><li>The ninth letter of the Turkmen alphabet, called he and written in the Latin script.</li></ol>
habar	<i>noun</i><br><ol><li>news</li><li>information, message</li><li>knowledge</li></ol>
halkara	<i>adj</i><br><ol><li>international</li></ol>
hamyr|hamyrlar|hamyrlara|hamyry|hamyrda|hamyrdan|hamyryň|hamyra|hamyrlardan|hamyrlary|hamyrlarda|hamyrlaryň	<i>noun</i><br><ol><li>dough</li></ol>
harp|harplaryň|harplar|harplara|harpa|harplarda|harplardan|harpdan|harplary|harpy|harpda|harpyň	<i>noun</i><br><ol><li>letter (of an alphabet)</li></ol>
hasap|hasaba|hasaplarda|hasaplary|hasapda|hasaplardan|hasaplaryň|hasapdan|hasaplara|hasaby|hasab|hasaplar|hasabyň	<i>noun</i><br><ol><li>account</li></ol>
hat|hatdan|hatlaryň|hatlary|hatda|hatlara|haty|hatlarda|hatlar|hata|hatyň|hatlardan	<i>noun</i><br><ol><li>letter (written message)</li></ol>
haçan	<i>adv</i><br><ol><li>(interrogative) when?</li></ol>
haýsy	<i>pron</i><br><ol><li>(interrogative) which?</li></ol>
haýwan|haýwanyň|haýwandan|haýwanlardan|haýwanlaryň|haýwanlar|haýwanda|haýwany|haýwanlarda|haýwana|haýwanlara|haýwanlary	<i>noun</i><br><ol><li>animal</li></ol>
haýyş	<i>adv</i><br><ol><li>used when making a politie request.</li><li>please</li></ol>
hekaýa|hekaýany|hekaýalary|hekaýalar|hekaýalardan|hekaýada|hekaýalarda|hekaýanyň|hekaýalaryň|hekaýalara|hekaýadan|hekaýā	<i>noun</i><br><ol><li>story</li></ol>
hepde	<i>noun</i><br><ol><li>week</li></ol>
hyzmat	<i>noun</i><br><ol><li>service</li></ol>
hyýar|hyýary|hyýarlar	<i>noun</i><br><ol><li>cucumber</li></ol>
i|I	<i>character</i><br><ol><li>The tenth letter of the Turkmen alphabet, called i and written in the Latin script.</li></ol>
iki	<i>num</i><br><ol><li>two</li></ol>
ikinji	<i>num</i><br><ol><li>second</li></ol>
ikki	<i>num</i><br><ol><li>two</li></ol>
ilginç|iň ilginç|ilginçräk	<i>adj</i><br><ol><li>salient, bold, dazzling</li></ol>
inçe|īnçe	<i>adj</i><br><ol><li>thin</li></ol>
isim|isimlere|isimleri|isimde|isime|isimleriň|isimler|isimi|isimlerde|isimlerden|isimiň|isimden	<i>noun</i><br><ol><li>name</li><li>(grammar) noun</li></ol>
islandiýaly|islandiýalydan|islandiýalylardan|islandiýalyda|islandiýalynyň|islandiýalylarda|islandiýalylara|islandiýalylary|islandiýalā|islandiýalylaryň|islandiýalyny|islandiýalylar	<i>name</i><br><ol><li>Icelander, a person from Iceland</li></ol>
islemek	<i>verb</i><br><ol><li>to want</li></ol>
ispança	<i>noun</i><br><ol><li>Spanish (language)</li></ol>
it|idi|itlere|itleri|itler|itlerden|itlerde|iti|itleriň|itden|itde|ite|itiň	<i>noun</i><br><ol><li>dog</li></ol>
içaly	<i>noun</i><br><ol><li>spy</li></ol>
içmek	<i>verb</i><br><ol><li>to drink</li></ol>
içýan|içýanyň|içýanlardan|içýana|içýanlarda|içýanlary|içýanlar|içýanda|içýanlara|içýandan|içýanlaryň|içýany	<i>noun</i><br><ol><li>scorpion</li></ol>
iýmek|iýýǟrin|iýmelidik|iýmelidiler|iýmelidiňiz|iýmeli|iýseler|iýmekçidik|iýjekdiň|iýdik|iýmekçidi|iýipdirin|iýmekçidim|iýseň|iýýǟris|iýerdi|iýipsiňiz|iýipdiler|iýjekdiňiz|iýersiňiz|iýýǟrsin|iýipdim|iýersiň|iýseňiz|iýjekdiler|iýipdik|iýýǟr|iýdi|iýse|present participle + conditional of bolmak|iýjekdim|past participle + conditional of bolmak|iýmekçidiň|iýen|iýmekçidiňiz|iýmelidi|iý|iýsinler|iýmelidim|iýerin|iýerdiňiz|iýipdirler|iýeris|iýerdik|iýerdiler|iýer|iýipdi|iýýǟn|iýipdir|iýerler|iýsem|iýmekçidiler|iýeliň|iýerdim|iýiň|iýsin|iýýǟrler|iýdim|iýdiler|iýdiň|iýipdiňiz|iýipsiň|iýjekdi|iýipdiň|iýipdiris|iýjekdik|iýýǟrsiňiz|iýerdiň|iýsek|iýiş|iýmelidiň|future participle + conditional of bolmak|iýmekçi|iýdiňiz|iýjek|iýeýiň	<i>verb</i><br><ol><li>to eat</li></ol>
iýmiş	<i>noun</i><br><ol><li>berry</li></ol>
iýul|iýuly|iýullar	<i>noun</i><br><ol><li>July</li></ol>
iýun|iýuny|iýunlar	<i>noun</i><br><ol><li>June</li></ol>
iň	<i>adv</i><br><ol><li>the most ..., the ...-est (marks the superlative degree of adjectives)</li></ol>
iňňe|iňňeler|iňňeni	<i>noun</i><br><ol><li>needle</li></ol>
iş|işler|işi	<i>noun</i><br><ol><li>work, labor</li><li>job, employment</li><li>affair</li></ol>
işan|işanlar|işany	<i>noun</i><br><ol><li>ishan</li></ol>
işjeň|iň işjeň|işjeňräk	<i>adj</i><br><ol><li>active, operational</li></ol>
işjeňleşdirmek|işjeňleşdirjekdiňiz|işjeňleşdirmekçidik|işjeňleşdirjek|işjeňleşdirseňiz|işjeňleşdirdi|işjeňleşdirmelidiňiz|işjeňleşdiripdim|işjeňleşdirmeli|işjeňleşdirseler|işjeňleşdirjekdim|işjeňleşdirerdiň|işjeňleşdirdik|işjeňleşdirerdiňiz|işjeňleşdirerin|işjeňleşdiripsiňiz|işjeňleşdirseň|işjeňleşdireliň|işjeňleşdiriş|işjeňleşdirmelidim|işjeňleşdirjekdik|işjeňleşdirsek|işjeňleşdiripdir|işjeňleşdirersiňiz|işjeňleşdirmekçidi|işjeňleşdirsem|işjeňleşdirmekçidiler|present participle + conditional of bolmak|past participle + conditional of bolmak|işjeňleşdirmelidik|işjeňleşdirsin|işjeňleşdirmekçi|işjeňleşdirerdim|işjeňleşdirýǟrsin|işjeňleşdirýǟrler|işjeňleşdirerler|işjeňleşdireýiň|işjeňleşdirmekçidim|işjeňleşdiriň|işjeňleşdiripdiň|işjeňleşdiripdiris|işjeňleşdiripdi|işjeňleşdirdiler|işjeňleşdiripsiň|işjeňleşdirerdik|işjeňleşdirjekdiler|işjeňleşdirmelidi|işjeňleşdiripdik|işjeňleşdirersiň|işjeňleşdirýǟris|işjeňleşdirsinler|işjeňleşdirmekçidiňiz|işjeňleşdirjekdiň|işjeňleşdirýǟrsiňiz|işjeňleşdiripdirler|işjeňleşdirýǟrin|işjeňleşdirerdiler|işjeňleşdirerdi|işjeňleşdiripdiler|işjeňleşdiripdirin|işjeňleşdirmelidiň|işjeňleşdirmelidiler|işjeňleşdirdim|işjeňleşdirse|işjeňleşdirýǟn|işjeňleşdirdiňiz|işjeňleşdiren|işjeňleşdirjekdi|işjeňleşdir|işjeňleşdirýǟr|işjeňleşdirmekçidiň|işjeňleşdireris|işjeňleşdirdiň|future participle + conditional of bolmak|işjeňleşdirer|işjeňleşdiripdiňiz	<i>verb</i><br><ol><li>(transitive) to activate</li><li>(transitive, chiefly computing) to enable</li></ol>
j|J	<i>character</i><br><ol><li>The eleventh letter of the Turkmen alphabet, called je and written in the Latin script.</li></ol>
jahan|jahanlar|jahany	<i>noun</i><br><ol><li>world</li></ol>
je|jeleri|jeden|jä|jeni|jede|jeleriň|jelere|jäniň|jelerde|jäni|jelerden|jeler	<i>noun</i><br><ol><li>The name of the Latin-script letter J.</li></ol>
jemgyýet|jemgyýetlerde|jemgyýetler|jemgyýetlere|jemgyýetleriň|jemgyýetde|jemgyýetiň|jemgyýetlerden|jemgyýete|jemgyýeti|jemgyýetleri|jemgyýetden	<i>noun</i><br><ol><li>society</li></ol>
jeň|jeňleriň|jeňler|jeňe|jeňlerde|jeňden|jeňlerden|jeňleri|jeňde|jeňiň|jeňi|jeňlere	<i>noun</i><br><ol><li>(dated) war</li></ol>
jilt|jiltlerde|jiltden|jilte|jiltde|jiltleri|jilti|jiltleriň|jiltler|jiltiň|jiltlerden|jiltlere	<i>noun</i><br><ol><li>skin</li></ol>
jogap|jogabi|jogaplar	<i>noun</i><br><ol><li>answer</li></ol>
jyk	
k|K	<i>character</i><br><ol><li>The thirteenth letter of the Turkmen alphabet, called ka and written in the Latin script.</li></ol>
kagyz|kagyzlar|kagyzy	<i>noun</i><br><ol><li>paper</li></ol>
kaka|kakalaryň|kakada|kakalardan|kakadan|kakalary|kakā|kakany|kakalar|kakanyň|kakalara|kakalarda	<i>noun</i><br><ol><li>father</li></ol>
kantata	<i>noun</i><br><ol><li>cantata</li></ol>
kanun|kanuny|kanunlar	<i>noun</i><br><ol><li>law</li></ol>
kartoşka|kartoşkalardan|kartoşkalary|kartoşkanyň|kartoşkada|kartoşkany|kartoşkalar|kartoşkā|kartoşkalaryň|kartoşkalara|kartoşkalarda|kartoşkadan	<i>noun</i><br><ol><li>potato</li></ol>
keselhana	<i>noun</i><br><ol><li>hospital</li></ol>
kimin	<i>prep</i><br><ol><li>like</li></ol>
kit|kitiň|kitlere|kitleri|kite|kidi|kitde|kitlerde|kitler|kitden|kiti|kitlerden|kitleriň	<i>noun</i><br><ol><li>whale</li></ol>
kitap|kitabyň|kitaby|kitapdan|kitaplardan|kitaplarda|kitaplara|kitaplary|kitaplar|kitaplaryň|kitapda|kitaba|kitāp	<i>noun</i><br><ol><li>book</li></ol>
kitaphana|kitaphanalar|kitaphananyň|kitaphanany|kitaphanā|kitaphanalarda|kitaphanada|kitaphanalara|kitaphanalary|kitaphanadan|kitaphanalaryň|kitaphanalardan	<i>noun</i><br><ol><li>library</li></ol>
kiçi|kiçiräk|iň kiçi	<i>adj</i><br><ol><li>small</li></ol>
klawiatura	<i>noun</i><br><ol><li>keyboard</li></ol>
klinika	<i>noun</i><br><ol><li>clinic</li></ol>
konstitusiýa|konstitusiýalardan|konstitusiýany|konstitusiýalara|konstitusiýalary|konstitusiýada|konstitusiýanyň|konstitusiýā|konstitusiýalarda|konstitusiýalaryň|konstitusiýalar|konstitusiýadan	<i>noun</i><br><ol><li>constitution</li></ol>
korol|korollar|koroly	<i>noun</i><br><ol><li>king</li></ol>
kyrk	<i>num</i><br><ol><li>forty</li></ol>
käşir|käşiri|käşirler|käşirleriň|käşire|käşirlere|käşirlerden|käşirden|käşirlerde|käşirleri|käşiriň|käşirde	<i>noun</i><br><ol><li>carrot</li></ol>
köl|kölleri|köle|köller|köli|köllerde|kölleriň|kölüň|kölden|köllerden|kölde|köllere	<i>noun</i><br><ol><li>lake</li></ol>
kömür	<i>noun</i><br><ol><li>coal</li></ol>
köp	<i>adj</i><br><ol><li>many</li></ol>
köpek|köpeklere|köpegi|köpekler|köpeke|köpekden|köpeklerden|köpekde|köpeklerde|köpeki|köpekleriň|köpekleri|köpekiň	<i>noun</i><br><ol><li>male dog, hound</li></ol>
köpri	<i>noun</i><br><ol><li>bridge</li></ol>
körük	
köwlemek	<i>verb</i><br><ol><li>to dig</li></ol>
köçe|köçeden|köçeleri|köçäni|köçelere|köçeni|köçelerde|köçelerden|köçeleriň|köçä|köçede|köçeler|köçäniň	<i>noun</i><br><ol><li>street</li></ol>
köşk	<i>noun</i><br><ol><li>palace</li></ol>
kükürt|kükürte|kükürtden|kükürtlere|kükürtlerden|kükürtleri|kükürtde|kükürtlerde|kükürti|kükürtler|kükürtüň|kükürtleriň	<i>noun</i><br><ol><li>sulfur</li><li>match (device to make fire)</li></ol>
kümüş|kümüşler|kümşü	<i>noun</i><br><ol><li>silver</li></ol>
küşt|küştler|küşti	<i>noun</i><br><ol><li>chess</li></ol>
l|L	<i>character</i><br><ol><li>The fourteenth letter of the Turkmen alphabet, called el and written in the Latin script.</li></ol>
lukman	<i>noun</i><br><ol><li>physician</li></ol>
lukmançylyk	<i>noun</i><br><ol><li>medicine</li></ol>
m|M	<i>character</i><br><ol><li>The fifteenth letter of the Turkmen alphabet, called em and written in the Latin script.</li></ol>
magtym|magtymrak|magtymlar|magtymy|iň magtym	<i>adj</i><br><ol><li>who is served</li></ol><br><i>noun</i><br><ol><li>the son of a great person</li></ol>
manat|manatyň|manata|manatlarda|манат|manatlar|manatlara|manatlary|manady|manatdan|manatlaryň|manatlardan|manatda|manaty	<i>noun</i><br><ol><li>manat</li></ol>
mart|marty|martlar	<i>noun</i><br><ol><li>March</li></ol>
maý|maýy|maýlar	<i>noun</i><br><ol><li>May</li></ol>
maýmyn|maýmynlary|maýmynda|maýmynyň|maýmynlaryň|maýmyndan|maýmyna|maýmynlardan|maýmynlarda|maýmyny|maýmynlara|maýmynlar	<i>noun</i><br><ol><li>monkey</li></ol>
maşgala|ýyny|ýylar|ýy	<i>noun</i><br><ol><li>family</li></ol>
maşyn	<i>noun</i><br><ol><li>car</li></ol>
mebel|mebellere|mebeller|mebelden|mebelde|mebeliň|mebelleri|mebeli|mebele|mebellerde|mebellerden|mebelleriň	<i>noun</i><br><ol><li>furniture</li></ol>
medeniýet|medeniýetler|medeniýetden|medeniýeti|medeniýetiň|medeniýetleriň|medeniýetleri|medeniýete|medeniýetlere|medeniýetlerden|medeniýetlerde|medeniýetde	<i>noun</i><br><ol><li>culture</li><li>civilization</li></ol>
mekdep	<i>noun</i><br><ol><li>school</li></ol>
men|mende|biziň|meni|bizde|bizden|menden|bizi|biz|meniň|bize|maňa	<i>pron</i><br><ol><li>(personal) I</li></ol>
meniňki	<i>pron</i><br><ol><li>mine</li></ol>
merkezi|iň merkezi|merkeziräk	<i>adj</i><br><ol><li>central</li></ol>
metal	<i>noun</i><br><ol><li>metal</li></ol>
metjit|metjiti|metjitler	<i>noun</i><br><ol><li>mosque</li></ol>
mif|mifden|mifleriň|miflere|mifler|mife|miflerden|miflerde|mifi|mifiň|mifleri|mifde	<i>noun</i><br><ol><li>myth, fable</li><li>legend</li></ol>
mifologiýa|mifologiýany	<i>noun</i><br><ol><li>mythology</li></ol>
milad	<i>noun</i><br><ol><li>Christmas</li></ol>
miwe	<i>noun</i><br><ol><li>fruit</li></ol>
mukaddes|iň mukaddes|mukaddesräk	<i>adj</i><br><ol><li>holy</li></ol>
mukaddeslik|mukaddesligi|mukaddeslikler	<i>noun</i><br><ol><li>holiness</li></ol>
muzeý|muzeýler|muzeýde|muzeýniň|muzeýe|muzeýlere|muzeýlerniň|muzeýlerden|muzeýi|muzeýlerde|muzeýleri|muzeýden	<i>noun</i><br><ol><li>museum</li></ol>
myhman	<i>noun</i><br><ol><li>guest</li></ol>
mysal|mysala|mysaly|mysallardan|mysallarda|mysalyň|mysallar|mysallara|mysallaryň|mysaldan|mysallary|mysalda	<i>noun</i><br><ol><li>example</li><li>pattern</li></ol>
mähriban|iň mähriban|mähribanrak	<i>adj</i><br><ol><li>kind</li></ol>
müň|müňü|müňler	<i>noun</i><br><ol><li>thousand</li></ol>
müňýyllyk	<i>noun</i><br><ol><li>millennium</li></ol>
n|N	<i>character</i><br><ol><li>The sixteenth letter of the Turkmen alphabet, called en and written in the Latin script.</li></ol>
narynç|narynjy|narynçlar	<i>noun</i><br><ol><li>orange (fruit)</li></ol>
nebit	<i>noun</i><br><ol><li>petroleum, mineral oil</li></ol>
ner|inerleriň|neriň|nerler|inere|nerleri|ineriň|nerlerden|nere|nerde|iner|nerleriň|inerden|inerler|نر|ineri|inerde|neri|nerlere|nerden|nerlerde|inerleri|inerlerden|ner|inerlere|inerlerde	<i>adj</i><br><ol><li>male</li></ol><br><i>noun</i><br><ol><li>male camel</li></ol>
nirede	<i>pron</i><br><ol><li>(interrogative) where?</li></ol>
nokat|nokatdan|nokatda|nokata|nokady|nokatlarda|nokatlardan|nokaty|nokatlary|nokatlaryň|nokatlar|nokatyň|nokatlara	<i>noun</i><br><ol><li>dot</li></ol>
noýabr|noýabrlar|noýabry	<i>noun</i><br><ol><li>November</li></ol>
nähili	<i>pron</i><br><ol><li>(interrogative) how?</li></ol>
näme	<i>pron</i><br><ol><li>(interrogative) what?</li></ol>
näwagt	<i>pron</i><br><ol><li>(interrogative) when?</li></ol>
näçe	<i>pron</i><br><ol><li>(interrogative) how many?, how much?</li></ol>
o|O	<i>character</i><br><ol><li>The eighteenth letter of the Turkmen alphabet, called o and written in the Latin script.</li></ol>
oglan|oglanlara|oglandan|oglanda|oglanlary|oglanyň|oglanlaryň|oglanlardan|oglanlar|oglana|oglanlarda|oglany	<i>noun</i><br><ol><li>boy</li></ol>
ogul|ogla|ogullary|ogly|ogullarda|ogullar|ogullara|ogulda|oguldan|ogluň|ogullardan|ogullaryň	<i>noun</i><br><ol><li>son</li></ol>
oktýabr|oktýabry|oktýabrlar	<i>noun</i><br><ol><li>October</li></ol>
ol|olara|olardan|onda|oňa|onuň|ondan|olary|olaryň|ony|o|olarda|olar	<i>pron</i><br><ol><li>(personal) she, he, it, that</li></ol>
ol ýerde	<i>adv</i><br><ol><li>there</li></ol>
olca	<i>noun</i><br><ol><li>booty, plunder</li></ol>
on	<i>num</i><br><ol><li>ten</li></ol>
ormon	<i>noun</i><br><ol><li>(dialectal) forest</li></ol>
ornaşmak	<i>verb</i><br><ol><li>to settle down (gradually)</li></ol>
ot|otlar|ody|ōt	<i>noun</i><br><ol><li>grass</li><li>fire</li></ol>
otag	<i>noun</i><br><ol><li>room (of a building)</li></ol>
otly|otlyny|otlydan|otlā|otlylara|otlylar|otlylardan|otlylary|otlylarda|otlylaryň|otlyda|otlynyň	<i>noun</i><br><ol><li>train</li></ol>
oturgyç	<i>noun</i><br><ol><li>chair</li></ol>
otuz	<i>num</i><br><ol><li>thirty</li></ol>
oý	<i>noun</i><br><ol><li>thought</li></ol>
oýnamak|oýnadylar|oýnardylar|oýnan|oýnapdyrlar|oýnaýyş|oýnar|oýnajakdy|oýnajakdyňyz|oýnāýyn|oýnadyň|oýnardyk|oýnarys|oýnapdyň|oýnadyk|oýnapdylar|oýnarsyň|oýnarlar|oýnālyň|oýnajakdyk|oýnamalydyňyz|oýnaýār|oýnarsyňyz|oýnāň|oýnapdyrys|oýnasaňyz|oýnaryn|oýnaýān|oýnardym|oýnamakçy|oýnardyň|present participle + conditional of bolmak|oýnasam|oýnaýārsyňyz|oýnapdy|oýnasa|past participle + conditional of bolmak|oýnamakçydyk|oýnady|oýnamakçydym|oýnajak|oýnapdyryn|oýnapsyň|oýna|oýnapdym|oýnajakdylar|oýnadyňyz|oýnajakdyň|oýnamalydyň|oýnamalydy|oýnardyňyz|oýnapsyňyz|oýnamalydym|oýnamaly|oýnadym|oýnasyn|oýnasalar|oýnamakçydyň|oýnamakçydy|oýnasak|oýnaýāryn|oýnaýārlar|oýnajakdym|oýnardy|oýnaýārsyn|oýnamalydylar|oýnamakçydylar|oýnamalydyk|oýnapdyk|oýnasynlar|oýnapdyr|oýnamakçydyňyz|oýnasaň|oýnaýārys|future participle + conditional of bolmak|oýnapdyňyz	<i>verb</i><br><ol><li>to play</li></ol>
oýun|oýunu|oýunlar	<i>noun</i><br><ol><li>game, play</li><li>joke</li></ol>
p|P	<i>character</i><br><ol><li>The twentieth letter of the Turkmen alphabet, called pe and written in the Latin script.</li></ol>
pagta|pagtalardan|pagtada|pagtalar|pagtalara|pagtalaryň|pagtalary|pagtalarda|pagtanyň|pagtany|pagtadan|pagtā	<i>noun</i><br><ol><li>cotton</li></ol>
paradoks	<i>noun</i><br><ol><li>paradox</li></ol>
parik	<i>noun</i><br><ol><li>wig</li></ol>
paýtagt|paýtagtlarda|paýtagty|paýtagtdan|paýtagtlar|paýtagtyň|paýtagta|paýtagtlardan|paýtagtlaryň|paýtagtlary|paýtagtlara|paýtagdy|paýtagtda	<i>noun</i><br><ol><li>capital (city)</li></ol>
pe	<i>noun</i><br><ol><li>The name of the Latin-script letter P.</li></ol>
pelsepe	<i>noun</i><br><ol><li>philosophy</li></ol>
penjire|penjirede|penjireleriň|penjirelere|penjiräni|penjireler|penjiräniň|penjirä|penjireleri|penjirelerden|penjireden|penjirelerde	<i>noun</i><br><ol><li>window</li></ol>
penşenbe	<i>noun</i><br><ol><li>Thursday</li></ol>
peýnir	<i>noun</i><br><ol><li>cheese</li></ol>
pikir etmek|pikir edipdiň|pikir ederdiler|pikir etýǟrin|pikir etjek|pikir etdik|pikir etdi|pikir etmekçidiler|pikir edipdi|pikir eder|pikir etjekdiňiz|pikir et|pikir etmekçidik|pikir etýǟrsiňiz|pikir edipdiler|pikir etseler|pikir edipdirler|pikir etýǟrler|pikir etdiň|pikir edersiň|pikir ederis|pikir etmelidi|pikir etseňiz|pikir etýǟrsin|pikir etmekçidiňiz|pikir etmekçidi|pikir edipdik|present participle + conditional of bolmak|pikir ediş|past participle + conditional of bolmak|pikir etdiler|pikir etsem|pikir etmelidim|pikir etdim|pikir etýǟris|pikir eteliň|pikir etseň|pikir ederdim|pikir edipdiris|pikir edipsiňiz|pikir etjekdiler|pikir etmeli|pikir etsinler|pikir etmekçidiň|pikir etmelidiler|pikir ederdik|pikir etýǟn|pikir etmelidiňiz|pikir etmekçidim|pikir etjekdi|pikir edipdirin|pikir eteýiň|pikir etmelidik|pikir etjekdik|pikir ederdiň|pikir ederin|pikir edipsiň|pikir etsek|pikir edersiňiz|pikir edipdiňiz|pikir etse|pikir edipdir|pikir edipdim|pikir etiň|pikir etmelidiň|pikir ederler|pikir ederdiňiz|pikir etjekdiň|pikir eden|pikir etsin|pikir etmekçi|future participle + conditional of bolmak|pikir etýǟr|pikir etjekdim|pikir etdiňiz|pikir ederdi	<i>verb</i><br><ol><li>to think</li></ol>
pil|pili|пиллерден|пил|belde|пиллер|пиллериң|belleriň|pilden|pillere|bellerden|пилден|piller|пиллере|пиле|piliň|pilleri|пиллерде|pilde|bellerde|belleri|bele|pillerde|пилиң|pile|pillerden|pil|пили|pilleriň|beller|belden|пилде|bellere|beli|bel|beliň|пиллери	<i>noun</i><br><ol><li>shovel, spade</li><li>elephant</li></ol>
pissa|pissalaryň|pissada|pissalary|pissadan|pissanyň|pissalara|pissany|pissā|pissalarda|pissalar|pissalardan	<i>noun</i><br><ol><li>pizza</li></ol>
piwo|piwony|piwā|piwoda|piwolarda|piwolaryň|piwodan|piwolara|piwonuň|piwolar|piwolary|piwolardan	<i>noun</i><br><ol><li>beer</li></ol>
pişik|pişikler|pişigi	<i>noun</i><br><ol><li>cat (mammal)</li></ol>
polat	<i>noun</i><br><ol><li>steel</li></ol>
polisiýa|polisiýalar|polisiýany	<i>noun</i><br><ol><li>police</li></ol>
polkovnik	<i>noun</i><br><ol><li>colonel</li></ol>
prezident	<i>noun</i><br><ol><li>president</li></ol>
programma üpjünçiligi	<i>noun</i><br><ol><li>(computing) software (encoded computer instructions)</li></ol>
pygamber	<i>noun</i><br><ol><li>prophet</li></ol>
pyçak	<i>noun</i><br><ol><li>knife</li></ol>
pyýada|pyýadalar|pyýadany	<i>noun</i><br><ol><li>(chess) pawn</li></ol>
r|R	<i>character</i><br><ol><li>The twenty-first letter of the Turkmen alphabet, called er and written in the Latin script.</li></ol>
reýhan|reýhanlary|reýhanyň|ریحان|reýhanlarda|reýhany|reýhanlara|reýhandan|reýhanlardan|reýhanlar|reýhanda|reýhanlaryň|reýhana	<i>noun</i><br><ol><li>fragrant plants, aromatic herbs</li></ol>
reňk|reňkler|reňki	<i>noun</i><br><ol><li>color</li></ol>
roždestwo|roždestwony	<i>noun</i><br><ol><li>Christmas</li></ol>
rul|rulda|rullarda|rullardan|ruldan|rullaryň|ruly|rullary|ruluň|rula|rullara|rullar	<i>noun</i><br><ol><li>steering wheel</li></ol>
rus|ruslar|iň rus|rusy|rusrak	<i>adj</i><br><ol><li>Russian</li></ol><br><i>noun</i><br><ol><li>Russian (person)</li></ol>
ruçka|ruçkalara|ruçkalarda|ruçkanyň|ruçkalaryň|ruçkā|ruçkalary|ruçkany|ruçkadan|ruçkalar|ruçkalardan|ruçkada	<i>noun</i><br><ol><li>pen</li></ol>
s|S	<i>character</i><br><ol><li>The twenty-second letter of the Turkmen alphabet, called es and written in the Latin script.</li></ol>
sabyn|sabyny|sabynlar	<i>noun</i><br><ol><li>soap</li></ol>
sagana	
saglyk	<i>noun</i><br><ol><li>health</li></ol>
sahypa|sahypalar|sahypany	<i>noun</i><br><ol><li>page</li></ol>
sakgal|sakgaly|sakgallar	<i>noun</i><br><ol><li>beard</li></ol>
sakgally|iň sakgally|sakgallyrak	<i>adj</i><br><ol><li>bearded</li></ol>
sakgalsyz|iň sakgalsyz|sakgalsyzrak	<i>adj</i><br><ol><li>beardless</li></ol>
salamaleýkim	<i>intj</i><br><ol><li>(Islam) salaam alaikum (Muslim greeting)</li></ol>
sarymsak	<i>noun</i><br><ol><li>garlic</li></ol>
saýmak	<i>verb</i><br><ol><li>to suppose, to think, to reckon</li></ol>
saýramak	<i>verb</i><br><ol><li>to sing</li></ol>
segsen	<i>num</i><br><ol><li>eighty</li></ol>
sekiz	<i>num</i><br><ol><li>eight</li></ol>
selin|selinler|selini	<i>noun</i><br><ol><li>perennial large grass, particularly Stipagrostis karelinii and Stipagrostis pennata, growing on sandy grounds such as the Karakum desert</li></ol>
sen|sizde|size|siz|saňa|seniň|sende|sizden|seni|senden|sizi|siziň	<i>pron</i><br><ol><li>(personal) you (singular, informal)</li></ol>
sentýabr|sentýabry|sentýabrlar	<i>noun</i><br><ol><li>September</li></ol>
sigara	<i>noun</i><br><ol><li>cigar</li></ol>
siz|sizde|size|saňa|seniň|sende|sen|sizden|seni|senden|sizi|siziň	<i>pron</i><br><ol><li>(personal) you (second-person plural, second-person singular formal)</li></ol>
sişenbe	<i>noun</i><br><ol><li>Tuesday</li></ol>
sogan	<i>noun</i><br><ol><li>onion</li></ol>
soltan|soltanlar|soltany	<i>noun</i><br><ol><li>sultan</li></ol>
suw|suwa|suwlardan|suwlarda|suwuň|suwdan|suwlar|suwlara|suwy|suwlary|suwda|suwlaryň	<i>noun</i><br><ol><li>water</li></ol>
sygyr|sygyrlarda|sygry|sygyrlary|sygyrlara|sygyrlardan|sygra|sygyrlar|sygyrdan|sygryň|sygyrda|sygyrlaryň	<i>noun</i><br><ol><li>cow</li></ol>
sypat	<i>noun</i><br><ol><li>adjective</li></ol>
syçan|syçany|syçanlar	<i>noun</i><br><ol><li>mouse</li></ol>
syýahat	<i>noun</i><br><ol><li>trip, travel, journey</li></ol>
syýahatçy|syýahatçyny|syýahatçylar	<i>noun</i><br><ol><li>traveler, tourist</li></ol>
syýahatçylyk|syýahatçylygy|syýahatçylyklar	<i>noun</i><br><ol><li>tourism</li></ol>
syýasat	<i>noun</i><br><ol><li>politics</li></ol>
sähra	<i>noun</i><br><ol><li>steppe</li></ol>
söweş|söweşleriň|söweşlerde|söweşi|söweşlerden|söweşden|söweşde|söweşe|söweşlere|söweşleri|söweşiň|söweşler	<i>noun</i><br><ol><li>war</li></ol>
söz|sözde|sözden|sözlerden|sözleri|sözler|sözlerde|sözüň|söze|sözleriň|sözlere|sözi	<i>noun</i><br><ol><li>word</li><li>speech</li></ol>
söýgi	<i>noun</i><br><ol><li>love</li></ol>
sümürmek	<i>verb</i><br><ol><li>to devour</li><li>to place a hat</li></ol>
süpürgi|süpürgide|süpürgiler|süpürgilerde|süpürgä|süpürgäni|süpürgileri|süpürgileriň|süpürgilere|süpürgäniň|süpürgilerden|süpürgiden	<i>noun</i><br><ol><li>broom</li></ol>
süýt|süýti|süýtler	<i>noun</i><br><ol><li>milk</li></ol>
süňk|süňkleriň|süňklerden|süňküň|süňkde|süňklere|süňklerde|süňkleri|süňke|süňkler|süňkden|süňki	<i>noun</i><br><ol><li>bone</li></ol>
t|T	<i>character</i><br><ol><li>The twenty-fourth letter of the Turkmen alphabet, called te and written in the Latin script.</li></ol>
tagan	
talaban	<i>noun</i><br><ol><li>a worker hired by rich people</li></ol>
talyp|talyplar|talyby	<i>noun</i><br><ol><li>student</li></ol>
tanap	<i>noun</i><br><ol><li>rope</li></ol>
taryh|taryhlaryň|taryhdan|taryhlar|taryhlary|taryha|taryhda|taryhlardan|taryhy|taryhlarda|taryhlara|taryhyň	<i>noun</i><br><ol><li>history</li></ol>
taryhy|taryhyrak|iň taryhy	<i>adj</i><br><ol><li>historical</li><li>historic</li></ol>
taňry|taňryny|taňrylar	<i>noun</i><br><ol><li>god</li></ol>
te	<i>noun</i><br><ol><li>The name of the Latin-script letter T.</li></ol>
tebigat	<i>noun</i><br><ol><li>nature</li></ol>
terjime|terjimeni|terjimeler	<i>noun</i><br><ol><li>translation</li></ol>
terjimeçi|terjimeçini|terjimeçiler	<i>noun</i><br><ol><li>translator</li></ol>
tilki	<i>noun</i><br><ol><li>fox</li></ol>
tirsek	<i>noun</i><br><ol><li>elbow</li></ol>
togsan	<i>num</i><br><ol><li>ninety</li></ol>
tokaý	<i>noun</i><br><ol><li>forest</li></ol>
tomus|tomuslar|tomusy	<i>noun</i><br><ol><li>summer</li></ol>
torsuk|torsuklar|torsugy	<i>noun</i><br><ol><li>badger</li></ol>
towuk	<i>noun</i><br><ol><li>hen</li></ol>
towşan|towşanda|towşandan|towşanlar|towşanlara|towşanlardan|towşanlarda|towşanlaryň|towşana|towşanyň|towşanlary|towşany	<i>noun</i><br><ol><li>hare</li></ol>
trubka	<i>noun</i><br><ol><li>tobacco pipe</li></ol>
täze|iň täze|täzeräk	<i>adj</i><br><ol><li>new</li></ol>
tüpeň|tüpeňleriň|tüpeňlerden|tüpeňlere|tüpeňde|tüpeňleri|tüpeňlerde|tüpeňler|tüpeňi|tüpeňden|tüpeňe|tüpeňiň	<i>noun</i><br><ol><li>rifle</li></ol>
türkmen|türkmenlar|iň türkmen|türkmenräk|türkmeny	<i>adj</i><br><ol><li>Turkmen</li></ol><br><i>noun</i><br><ol><li>Turkmen, Turkman (person)</li></ol>
türme	<i>noun</i><br><ol><li>prison</li></ol>
tüsse|tüsseni|tüsseler	<i>noun</i><br><ol><li>smoke</li></ol>
u|U	<i>character</i><br><ol><li>The twenty-fifth letter of the Turkmen alphabet, called u and written in the Latin script.</li></ol>
uklamak	<i>verb</i><br><ol><li>to sleep</li></ol>
un	<i>noun</i><br><ol><li>flour</li></ol>
uniwersitet|uniwersiteti|uniwersitetler	<i>noun</i><br><ol><li>university</li></ol>
uruş|uruşlarda|uruşlar|uruşy|uruşyň|uruşda|uruşlary|uruşdan|uruşa|uruşlardan|uruşlaryň|uruşlara	<i>noun</i><br><ol><li>war</li></ol>
ussat	<i>noun</i><br><ol><li>expert, specialist, professional</li><li>(computing) wizard</li></ol>
uzyn|iň uzyn|uzynrak	<i>adj</i><br><ol><li>long</li><li>tall</li></ol>
vagt	<i>noun</i><br><ol><li>time</li></ol>
w|W	<i>character</i><br><ol><li>The twenty-seventh letter of the Turkmen alphabet, called we and written in the Latin script.</li></ol>
watan|watany|watanlary|watanlarda|watanyň|watanlaryň|watanlar|watanda|watandan|watana|watanlardan|watanlara	<i>noun</i><br><ol><li>fatherland, country</li></ol>
watançy|watançylar|watançā|watançyny|watançylarda|watançyda|watançylaryň|watançydan|watançylary|watançynyň|watançylardan|watançylara	<i>noun</i><br><ol><li>patriot</li></ol>
watançylyk	<i>noun</i><br><ol><li>patriotism</li></ol>
we	<i>conj</i><br><ol><li>and</li></ol><br><i>noun</i><br><ol><li>The name of the Latin-script letter W.</li></ol>
welosiped|welosipedi|welosipedlerden|welosipediň|welosipedlere|welosipedleriň|welosipedden|welosipedlerde|welosipedde|welosipedleri|welosipedler|welosipede	<i>noun</i><br><ol><li>bicycle</li></ol>
wertolýot|wertolýotlary|wertolýoty|wertolýotlaryň|wertolýotlar|wertolýotlara|wertolýotdan|wertolýotlarda|wertolýota|wertolýotda|wertolýotuň|wertolýotlardan	<i>noun</i><br><ol><li>helicopter</li></ol>
wideo|wideonuň|wideolar|wideolardan|wideony|wideolaryň|wideolara|wideolary|wideodan|wideoda|wideā|wideolarda	<i>noun</i><br><ol><li>video</li></ol>
y|Y	<i>character</i><br><ol><li>The twenty-eighth letter of the Turkmen alphabet, called y and written in the Latin script.</li></ol>
ykbal	<i>noun</i><br><ol><li>fate</li></ol>
ykdysadyýet|ykdysadyýety|ykdysadyýetlar	<i>noun</i><br><ol><li>economy</li><li>economics</li></ol>
ylym	<i>noun</i><br><ol><li>science</li></ol>
ynanç	<i>noun</i><br><ol><li>belief</li></ol>
ynkylap	<i>noun</i><br><ol><li>revolution</li></ol>
yşyk|yşygy|yşyklar	<i>noun</i><br><ol><li>light</li></ol>
z|Z	<i>character</i><br><ol><li>The thirtieth letter of the Turkmen alphabet, called ze and written in the Latin script.</li></ol>
zag	
zaman|zamany|zamanda|zamanlarda|zamanlardan|zamanlar|zamanlaryň|zamanlara|zamanlary|zamanyň|zamandan|zamana	<i>noun</i><br><ol><li>time, age, era</li><li>time, occasion</li><li>(grammar) tense</li></ol>
zamana	<i>noun</i><br><ol><li>(dialectal) time</li></ol>
zar	
zat|zatlar|zaty|zata|zatda|zatlarda|zatlary|zatlara|zatlardan|zatlaryň|zatdan|zatyň	<i>noun</i><br><ol><li>thing</li></ol>
zaň	
ze	<i>noun</i><br><ol><li>The name of the Latin-script letter Z.</li></ol>
zefir	
zekat	
zelel	<i>noun</i><br><ol><li>damage</li></ol>
zelelli|iň zelelli|zelelliräk	<i>adj</i><br><ol><li>harmful, noxious</li></ol>
zelelsiz|iň zelelsiz|zelelsizräk	<i>adj</i><br><ol><li>harmless</li></ol>
zemin	
zer	
zerre|zerreni|zerreler	<i>noun</i><br><ol><li>the smallest particles of dust and dustlike materials</li><li>a small amount of, a little bit of</li></ol>
zeýtun|zeýtuny|zeýtunlar|zeýtuna|zeýtunlardan|zeýtunlary|zeýtunlarda|zeýtunuň|zeýtundan|zeýtunlara|zeýtunlaryň|zeýtunda	<i>noun</i><br><ol><li>olive</li></ol>
zibil	
zok	
zol	
zulum	
zyna	
zynjyr	<i>noun</i><br><ol><li>chain</li></ol>
zyýan	<i>noun</i><br><ol><li>damage</li></ol>
zyýanly|zyýanlyrak|iň zyýanly	<i>adj</i><br><ol><li>harmful, noxious</li></ol>
zyýansyz|zyýansyzrak|iň zyýansyz	<i>adj</i><br><ol><li>harmless</li></ol>
zäher|zäherler|zäheri	<i>noun</i><br><ol><li>poison</li></ol>
zähmet	
Ä|ä	<i>character</i><br><ol><li>The sixth letter of the Turkmen alphabet, written in the Latin script.</li></ol>
Ç|ç	<i>character</i><br><ol><li>The third letter of the Turkmen alphabet, called çe and written in the Latin script.</li></ol>
Çad	<i>name</i><br><ol><li>Chad (a country in Central Africa)</li></ol>
Çehiýa	<i>name</i><br><ol><li>Czech Republic</li></ol>
Çernogoriýa	<i>name</i><br><ol><li>Montenegro</li></ol>
Çili	<i>name</i><br><ol><li>Chile (a country in South America)</li></ol>
Özbegistan|Özbegistanda|Özbegistanyň|Özbegistandan|Özbegistana|Özbegistany	<i>name</i><br><ol><li>Uzbekistan</li></ol>
Ürgenç	<i>name</i><br><ol><li>Urgench</li></ol>
Ý|ý	<i>character</i><br><ol><li>The twenty-ninth letter of the Turkmen alphabet, written in the Latin script.</li></ol>
Ýaponiýa	<i>name</i><br><ol><li>Japan</li></ol>
Ýemen|¥emen	<i>name</i><br><ol><li>Yemen</li></ol>
Ýerorta deňzi	<i>name</i><br><ol><li>the Mediterranean Sea</li></ol>
Ýewropa	<i>name</i><br><ol><li>Europe</li></ol>
Ýunanystan	<i>name</i><br><ol><li>Greece</li></ol>
ä|Ä	<i>character</i><br><ol><li>The sixth letter of the Turkmen alphabet, called ä and written in the Latin script.</li></ol>
äbermek|äbermekçidiňiz|äberdik|äberýǟrsiňiz|äberjekdiňiz|äbersinler|äberjekdim|äbermekçi|äberjekdiň|äberýǟr|äberdiler|äberer|äberipdiňiz|äberýǟris|äberipdirler|äberersiňiz|äberjekdik|äberjekdiler|äbermeli|äbermekçidi|äbermekçidik|äbererler|äberseň|äberipdiler|äbermekçidim|äberipdim|äberdiň|äberýǟrler|äberipdik|äberipdi|äberdiňiz|äbersem|äberersiň|äbererdi|äberdi|äberseler|present participle + conditional of bolmak|past participle + conditional of bolmak|äber|äbereliň|äberiň|äbermelidim|äbermelidik|äberipsiňiz|äbereris|äberýǟrsin|äberipsiň|äbererdik|äberiş|äberýǟn|äberipdiris|äberdim|äberipdir|äbererdiň|äbersek|äbermelidiň|äberseňiz|äbermelidi|äbersin|äbermekçidiň|äberýǟrin|äbererin|äberjekdi|äbermekçidiler|äberipdirin|äberjek|äberse|äbererdiler|äbermelidiler|äbererdim|äberen|äbereýiň|future participle + conditional of bolmak|äberipdiň|äbermelidiňiz|äbererdiňiz	<i>verb</i><br><ol><li>to bring</li><li>to buy; take</li></ol>
çadyr	<i>noun</i><br><ol><li>tent</li></ol>
çag|çaglardan|çagyň|çagy|çaglaryň|çaga|çagdan|çaglara|çaglar|çaglary|çaglarda|çagda	<i>noun</i><br><ol><li>time</li></ol>
çagalyk	<i>noun</i><br><ol><li>childhood</li></ol>
çagyl	<i>noun</i><br><ol><li>gravel</li></ol>
çagyryş	<i>noun</i><br><ol><li>invitation</li></ol>
çal|iň çal|çalrak	<i>adj</i><br><ol><li>grey</li></ol>
çalgy	<i>noun</i><br><ol><li>scythe</li></ol>
çarşenbe	<i>noun</i><br><ol><li>Wednesday</li></ol>
çaý|çaýlar|çaýy	<i>noun</i><br><ol><li>tea (the plant, the dried leaves or buds of the plant, the drink made by infusing these dried leaves or buds in hot water)</li><li>a small river</li></ol>
çaň	<i>noun</i><br><ol><li>dust</li></ol>
çe|çeler|çeni	<i>noun</i><br><ol><li>The name of the Latin-script letter Ç.</li></ol>
çempion|çempionda|çempiondan|çempionlaryň|çempionlara|çempionuň|çempionlary|çempiona|çempionlar|çempionlardan|çempiony|çempionlarda	<i>noun</i><br><ol><li>champion</li></ol>
çemçe|çemçeni|çemçeler	<i>noun</i><br><ol><li>spoon</li></ol>
çeýe|iň çeýe|çeýeräk	<i>adj</i><br><ol><li>elastic, resilient, springy</li></ol>
çeýe disk	<i>noun</i><br><ol><li>(computing) floppy disk</li></ol>
çopan	<i>noun</i><br><ol><li>shepherd</li></ol>
çöl	<i>noun</i><br><ol><li>desert</li></ol>
çörek|çöregi|çörekler	<i>noun</i><br><ol><li>bread</li></ol>
ö|Ö	<i>character</i><br><ol><li>The nineteenth letter of the Turkmen alphabet, called ö and written in the Latin script.</li></ol>
öküz	<i>noun</i><br><ol><li>ox</li></ol>
öldürmek|öldürýǟn|öldüren|öldürýǟrler|öldürdüň|öldürdüler|öldürsünler|öldürmelidi|öldürýǟrin|öldürüpdirin|öldüreliň|öldürjekdiler|öldürmelidik|öldürjekdiňiz|öldürerdiňiz|öldürsek|öldürmekçi|öldürmekçidim|öldürjekdim|öldürmekçidiňiz|öldürüpsiň|öldürseňiz|öldürerdi|öldürüş|öldürerdik|öldürerdiler|öldürjekdiň|öldürmelidiň|öldürýǟrsin|öldürjek|present participle + conditional of bolmak|past participle + conditional of bolmak|öldürdü|öldürmelidim|öldüriň|öldürmelidiler|öldürmekçidi|öldürüpdiň|öldürýǟris|öldürmelidiňiz|öldürüpdim|öldüreris|öldürüpdiris|öldüreýiň|öldürüpdiler|öldürmekçidiler|öldürüpsiňiz|öldürüpdik|öldürerin|öldürüpdirler|öldürersiňiz|öldürerler|öldürjekdi|öldürjekdik|öldürýǟrsiňiz|öldürdüm|öldürüpdi|öldürerdiň|öldür|öldürýǟr|öldürmeli|öldürse|öldürersiň|öldürseler|öldürmekçidik|öldürer|öldürsem|öldürüpdir|öldürerdim|öldürseň|future participle + conditional of bolmak|öldürüpdiňiz|öldürdük|öldürsün|öldürdüňiz|öldürmekçidiň	<i>verb</i><br><ol><li>to kill, to murder</li></ol>
ölüm|ölümden|ölümlere|ölümi|ölümler|ölümüň|ölüme|ölümlerde|ölümleri|ölümleriň|ölümde|ölümlerden	<i>noun</i><br><ol><li>death</li></ol>
ördek|ördekler|ördekleri|ördekleriň|ördegi|ördeke|ördeklere|ördekde|ördeklerde|ördeklerden|ördeki|ördekden|ördekiň	<i>noun</i><br><ol><li>(ornithology) duck</li></ol>
öwrenmek|öwrenipdiler|öwrenerler|öwrenýǟrler|öwrenerdi|öwrenýǟris|öwrenipdirin|öwren|öwrener|öwrenipdik|öwrenmekçi|öwrenýǟrin|öwrenerdiň|öwrenipdirler|öwrensek|öwreneliň|öwrenmeli|öwrenmelidiň|öwrenmelidik|öwrenmekçidiň|öwrendi|öwrenipdiris|öwrenerin|öwrenipsiňiz|öwrense|present participle + conditional of bolmak|öwrenjekdim|öwreneýiň|past participle + conditional of bolmak|öwrenmelidiler|öwrenmelidi|öwrenmekçidim|öwrenjekdiňiz|öwrendiň|öwrenjekdiler|öwrensin|öwrenmekçidiler|öwrenjekdik|öwrenipdiňiz|öwrendiler|öwrenýǟr|öwreneris|öwreniň|öwrendik|öwrenjek|öwrenersiňiz|öwrenerdiler|öwrenmelidim|öwrenmelidiňiz|öwrenjekdiň|öwrenersiň|öwrenjekdi|öwrenerdik|öwrenmekçidi|öwrenerdim|öwrenseň|öwrenmekçidiňiz|öwrenerdiňiz|öwrenipdim|öwrenýǟrsiňiz|öwrenipdi|öwrendim|öwrenseler|öwrenen|öwrendiňiz|öwreniş|öwrenýǟn|öwrenýǟrsin|öwrenipsiň|öwrenseňiz|future participle + conditional of bolmak|öwrenipdir|öwrenmekçidik|öwrensinler|öwrensem|öwrenipdiň	<i>verb</i><br><ol><li>to learn, to study</li></ol>
öwretmek|öwretjekdiler|öwretse|öwretdik|öwret|öwredipdiler|öwrederdiňiz|öwretsin|öwredipdi|öwrederler|öwretseň|öwreteliň|öwretsinler|öwredipdirin|öwredipsiň|öwretiň|öwretmelidiňiz|öwretjekdik|öwrederin|öwretseňiz|öwrederdik|öwretmekçidiňiz|öwreden|öwretjekdi|present participle + conditional of bolmak|past participle + conditional of bolmak|öwrederis|öwretdiler|öwretjekdiňiz|öwretsem|öwretsek|öwretmeli|öwrederdiler|öwrediş|öwretýǟn|öwretýǟrin|öwretmelidim|öwretmelidiň|öwretjekdiň|öwredersiň|öwretseler|öwretjekdim|öwretmekçidim|öwretýǟrsin|öwretdim|öwretjek|öwredipdim|öwredipdiň|öwredipdiris|öwreder|öwredipdir|öwreteýiň|öwredipdirler|öwretmelidik|öwretmekçidiler|öwredipdik|öwretmekçi|öwretýǟr|öwredipsiňiz|öwretdiňiz|öwrederdim|öwretmekçidi|öwretýǟris|öwretmelidiler|öwretýǟrler|öwretmelidi|öwretmekçidiň|öwretdi|öwrederdiň|öwretdiň|öwrederdi|öwretýǟrsiňiz|future participle + conditional of bolmak|öwredersiňiz|öwredipdiňiz|öwretmekçidik	<i>verb</i><br><ol><li>to teach</li></ol>
öý|öýlere|öýi|öýleriň|öýden|öýlerde|öýlerden|öýüň|öýde|öýler|öýleri|öýe	<i>noun</i><br><ol><li>house</li></ol>
öýtmek|öýtseňiz|öýtmelidi|öýtýǟrsiňiz|öýtjekdim|öýtse|öýden|öýtýǟrler|öýtýǟrin|öýtsem|öýtmeli|öýtsün|öýtýǟr|öýtjekdiňiz|öýtmelidiň|öýtmekçidim|öýdersiňiz|öýtýǟn|öýtmekçidiň|öýdüpdim|öýderdik|öýtdü|öýdüpsiňiz|öýtjekdik|öýt|öýteliň|öýtjek|öýtsünler|öýtmelidiler|öýdüpdiris|öýdüpsiň|öýteýiň|öýderler|öýtmekçidi|present participle + conditional of bolmak|öýtmekçidiler|öýderdi|past participle + conditional of bolmak|öýdüpdiň|öýtýǟris|öýdüpdiler|öýder|öýtdük|öýtdüň|öýderis|öýdüpdik|öýderdim|öýtseler|öýtmekçidik|öýtjekdi|öýtdüňiz|öýtýǟrsin|öýdüpdiňiz|öýdüpdirin|öýderin|öýtmelidim|öýtmekçidiňiz|öýtiň|öýtsek|öýderdiň|öýdüpdi|öýtdüm|öýtmekçi|öýtjekdiň|öýtdüler|öýderdiler|öýtjekdiler|öýderdiňiz|öýtmelidik|öýdüpdir|öýtseň|öýdersiň|future participle + conditional of bolmak|öýdüş|öýtmelidiňiz|öýdüpdirler	<i>verb</i><br><ol><li>to suppose, to think, to reckon</li></ol>
ülemek	<i>verb</i><br><ol><li>to divide, split</li></ol>
üleşmek	<i>verb</i><br><ol><li>to share</li></ol>
üpjünçilik	<i>noun</i><br><ol><li>provision, supply</li></ol>
üç|vc	<i>num</i><br><ol><li>three</li></ol>
üçburçluk	<i>noun</i><br><ol><li>triangle</li></ol>
ý|Ý	<i>character</i><br><ol><li>The twenty-ninth letter of the Turkmen alphabet, called ýe and written in the Latin script.</li></ol>
ýa|я	<i>conj</i><br><ol><li>or</li></ol>
ýagdaý	<i>noun</i><br><ol><li>situation</li></ol>
ýagly|ýaglyny	<i>noun</i><br><ol><li>bunny</li></ol>
ýagmyr|ýagmyryň|ýagmyrdan|ýagmyrlar|ýagmyrlara|ýagmyrda|ýagmyra|ýagmyry|ýagmyrlardan|ýagmyrlarda|ýagmyrlary|ýagmyrlaryň	<i>noun</i><br><ol><li>rain</li></ol>
ýagyn|ýagyndan|ýagynlaryň|ýagynlarda|ýagyny|ýagynyň|ýagynlar|ýagynlary|ýagyna|ýagynlara|ýagynda|ýagynlardan	<i>noun</i><br><ol><li>rain</li></ol>
ýagyş	<i>noun</i><br><ol><li>rain</li></ol>
ýagşy|iň ýagşy|ýagşyrak	<i>adj</i><br><ol><li>good</li></ol>
ýaly	<i>prep</i><br><ol><li>like</li></ol>
ýalyn	<i>noun</i><br><ol><li>flame</li></ol>
ýalňyzlyk	<i>noun</i><br><ol><li>loneliness, solitude</li></ol>
ýalňyş	<i>noun</i><br><ol><li>error, mistake</li></ol>
ýama|ýamalardan|ýamadan|ýamalar|ýamā|ýamalaryň|ýamada|ýamalary|ýamalarda|ýamany|ýamanyň|ýamalara	<i>noun</i><br><ol><li>patch</li></ol>
ýanjamak	<i>verb</i><br><ol><li>to babble</li><li>to be saturated</li></ol>
ýanwar|ýanwary|ýanwarlar	<i>noun</i><br><ol><li>January</li></ol>
ýaprak	<i>noun</i><br><ol><li>leaf</li></ol>
ýara|ýaralar|ýaralary|ýarada|ýaralardan|ýaralarda|ýaralara|ýaralaryň|ýarā|ýaranyň|ýarany|ýaradan	<i>noun</i><br><ol><li>wound, injury</li></ol>
ýardam	<i>noun</i><br><ol><li>help, assistance</li></ol>
ýarym	<i>noun</i><br><ol><li>half</li></ol>
ýarymada	<i>noun</i><br><ol><li>peninsula</li></ol>
ýassyk|ýassyklar|ýassygy	<i>noun</i><br><ol><li>pillow</li></ol>
ýat|ýaty|ýatlar	<i>noun</i><br><ol><li>foreign</li><li>far and unknown lands</li></ol>
ýaz|ýazy|ýazlar	<i>noun</i><br><ol><li>spring</li></ol>
ýazmak|ýazsaň|ýazmakçydylar|ýazsam|ýazypdyr|ýazjakdym|ýazsynlar|ýazmalydym|ýazmalydy|ýazmalydyňyz|ýazdyk|ýazyş|ýazýārlar|ýazdym|ýazjakdyňyz|ýazjakdylar|ýazmakçydy|ýazdyňyz|ýazýār|ýazýān|ýazalyň|ýazardyň|ýazypdyň|ýazjakdyk|ýazdylar|ýazan|ýazaryn|present participle + conditional of bolmak|ýazsalar|ýazmakçydyk|past participle + conditional of bolmak|ýazypdyk|ýazypsyň|ýazypdylar|ýazardylar|ýazyň|ýazmalydyň|ýazsaňyz|ýazsyn|ýazýārsyňyz|ýazypdy|ýazypdyrys|ýazardy|ýazjakdyň|ýazjakdy|ýazmakçydym|ýazardyk|ýazardyňyz|ýazmalydylar|ýazmakçydyň|ýazmakçydyňyz|ýaz|ýazsak|ýazmalydyk|ýazar|ýazsa|ýazaýyň|ýazýāryn|ýazýārys|ýazypdyryn|ýazdyň|ýazarsyňyz|ýazarys|ýazdy|ýazýārsyn|ýazypdyňyz|ýazmakçy|ýazardym|future participle + conditional of bolmak|ýazarsyň|ýazmaly|ýazjak|ýazarlar|ýazypdym|ýazypdyrlar|ýazypsyňyz	<i>verb</i><br><ol><li>to write</li><li>to lay down</li></ol>
ýazyjy|ýazyjynyň|ýazyjylar|ýazyjyda|ýazyjylarda|ýazyjylary|ýazyjā|ýazyjylardan|ýazyjylara|ýazyjylaryň|ýazyjyny|ýazyjydan	<i>noun</i><br><ol><li>writer</li></ol>
ýaş|ýaşlar|iň ýaş|ýaşy|ýaşa|ýaşlary|ýaşlardan|ýaşrak|ýaşdan|ýaşyň|ýaş|ýaşlaryň|ýaşda|ýaşlarda|ýaşlara	<i>adj</i><br><ol><li>young</li></ol><br><i>noun</i><br><ol><li>age</li><li>tear</li></ol>
ýaşamak|ýaşaýyş|ýaşamakçydyňyz|ýaşajakdylar|ýaşadyň|ýaşajakdym|ýaşapdyň|ýaşarlar|ýaşaýārys|ýaşardym|ýaşaýāryn|ýaşālyň|ýaşaýān|ýaşamaly|ýaşapdyňyz|ýaşamalydym|ýaşamalydyk|ýaşardyňyz|ýaşamakçydyk|ýaşarsyň|ýaşadym|ýaşapdy|ýaşapdyr|ýaşady|present participle + conditional of bolmak|ýaşajakdy|past participle + conditional of bolmak|ýaşapdyrys|ýaşajakdyň|ýaşasyn|ýaşamakçy|ýaşadylar|ýaşamakçydym|ýaşamakçydy|ýaşajak|ýaşapdym|ýaşapdyryn|ýaşapsyň|ýaşardy|ýaşardyk|ýaşajakdyňyz|ýaşardylar|ýaşan|ýaşardyň|ýaşasa|ýaşa|ýaşamalydyň|ýaşapdyk|ýaşapsyňyz|ýaşadyk|ýaşasynlar|ýaşarys|ýaşamalydylar|ýaşamakçydylar|ýaşar|ýaşapdylar|ýaşapdyrlar|ýaşarsyňyz|ýaşasaňyz|ýaşaýārlar|ýaşasaň|ýaşamakçydyň|ýaşajakdyk|ýaşamalydy|ýaşasalar|ýaşadyňyz|ýaşaryn|ýaşasam|future participle + conditional of bolmak|ýaşamalydyňyz|ýaşāň|ýaşaýār|ýaşasak|ýaşaýārsyňyz|ýaşāýyn|ýaşaýārsyn	<i>verb</i><br><ol><li>to live</li></ol>
ýaşyl|iň ýaşyl|یاشیل|ýaşylrak	<i>adj</i><br><ol><li>green</li></ol>
ýaşylbaş|ýaşylbaşy|ýaşylbaşlar	<i>noun</i><br><ol><li>(zoology) mallard</li></ol>
ýe	<i>noun</i><br><ol><li>The name of the Latin-script letter Ý ý.</li></ol>
ýedi	<i>num</i><br><ol><li>seven</li></ol>
ýekşenbe	<i>noun</i><br><ol><li>Sunday</li></ol>
ýel	<i>noun</i><br><ol><li>wind</li></ol>
ýer|ýerde	<i>noun</i><br><ol><li>earth</li></ol>
ýetmiş|етмыш	<i>num</i><br><ol><li>seventy</li></ol>
ýigrimi	<i>num</i><br><ol><li>twenty</li></ol>
ýok	<i>intj</i><br><ol><li>no, nope</li></ol>
ýolbars	<i>noun</i><br><ol><li>lion</li></ol>
ýumurtga	<i>noun</i><br><ol><li>egg</li></ol>
ýunan|ýunanlar|ýunany	<i>noun</i><br><ol><li>Greek</li></ol>
ýurt|ýurta|ýurtlary|ýurty|ýurtlarda|ýurtlar|ýurtdan|ýurtlardan|ýurtda|ýurtlaryň|ýurdy|ýurtlara|ýurtuň	<i>noun</i><br><ol><li>country, land</li><li>nation</li></ol>
ýuwmak|ýuwan|ýuwduňyz|ýuwduň|ýuwupdyrlar|ýuwupdyk|ýuwupsyň|ýuwarys|ýuwjakdyňyz|ýuwdum|ýuwýārsyn|ýuwmakçydyňyz|ýuwjakdyk|ýuwupsyňyz|ýuwmakçydy|ýuwarsyňyz|ýuwdular|ýuwýāryn|ýuwarlar|ýuwjakdym|ýuwaýyň|ýuwupdyrys|ýuwmaly|ýuwsalar|ýuwmakçydyň|ýuwsa|ýuwardyň|ýuwupdym|ýuwaryn|ýuwardylar|ýuwardyk|ýuwsak|ýuwarsyň|present participle + conditional of bolmak|past participle + conditional of bolmak|ýuwmalydyňyz|ýuwsunlar|ýuwmalydy|ýuwsun|ýuwjakdyň|ýuwupdyňyz|ýuwdu|ýuwýār|ýuwjakdylar|ýuwalyň|ýuwmalydylar|ýuwar|ýuwmalydyk|ýuwýārsyňyz|ýuwmalydym|ýuwupdylar|ýuwjak|ýuwmakçydylar|ýuw|ýuwupdyr|ýuwyň|ýuwupdyryn|ýuwuş|ýuwupdyň|ýuwupdy|ýuwsaň|ýuwmalydyň|ýuwardyňyz|ýuwmakçydyk|ýuwduk|ýuwýārlar|ýuwjakdy|ýuwardym|ýuwmakçy|ýuwýārys|ýuwsam|ýuwýān|ýuwardy|ýuwsaňyz|future participle + conditional of bolmak|ýuwmakçydym	<i>verb</i><br><ol><li>to wash</li></ol>
ýy|ýyny|ýylar	<i>noun</i><br><ol><li>The name of the Latin-script letter Ý.</li></ol>
ýyl|ýyldan|ýyllarda|ýylda|ýylyň|ýyllar|ýyla|ýyllary|ýyllara|ýyllardan|ýyllaryň|ýyly	<i>noun</i><br><ol><li>year</li></ol>
ýylan|ýylanyň|ýylanlara|ýylanlardan|ýylany|ýylana|ýylanlar|ýylanlarda|ýylanda|ýylandan|ýylanlary|ýylanlaryň	<i>noun</i><br><ol><li>snake</li></ol>
ýyldyz|ýyldyzlary|ýyldyzlarda|ýyldyza|ýyldyzda|ýyldyzdan|ýyldyzlara|ýyldyzlardan|ýyldyzlaryň|ýyldyzlar|ýyldyzyň|ýyldyzy	<i>noun</i><br><ol><li>star</li></ol>
ýyly|iň ýyly|ýylyrak	<i>adj</i><br><ol><li>warm</li></ol>
ýylylyk|ýylylyklar|ýylylygy	<i>noun</i><br><ol><li>warmth</li></ol>
ýüpek	<i>noun</i><br><ol><li>silk</li></ol>
ýürek|ýüregi|ýüreki|ýürekleriň|ýürekleri|ýürekden|ýürekiň|ýürekde|ýüreklere|ýüreklerden|ýüreklerde|ýürekler|ýüreke	<i>noun</i><br><ol><li>heart</li></ol>
ýüz|ÿüzi|ÿüz|ÿüzlere|ÿüzlerden|ÿüzleriñ|ýüzi|ÿüzlerde|ýüzde|ÿüzden|ýüzleri|ÿüze|ÿüzde|ýüzüň|ýüzlere|ÿüzler|ýüzden|ÿüzüñ|ÿüzü|yvz|ÿüzleri|ýüzleriň|ýüzlerde|ýüzlerden|ýüze|ýüzler	<i>num</i><br><ol><li>hundred</li></ol><br><i>noun</i><br><ol><li>(anatomy) face</li></ol>
ýüzük|ýüzügi|ýüzüke|ýüzüklere|ýüzükden|ýüzüklerden|ýüzükleriň|ýüzüklerde|ýüzükler|ýüzükde|ýüzüküň|ýüzükleri|ýüzüki	<i>noun</i><br><ol><li>ring</li></ol>
ýüň|ýüňi|ýüňler|iň ýüň|ýüňräk	<i>noun</i><br><ol><li>wool</li></ol><br><i>adj</i><br><ol><li>woolen</li></ol>
Ň|ň	<i>character</i><br><ol><li>The seventeenth letter of the Turkmen alphabet, called eň and written in the Latin script.</li></ol>
ň|Ň	<i>character</i><br><ol><li>The seventeenth letter of the Turkmen alphabet, called eň and written in the Latin script.</li></ol>
Şri-Lanka	<i>name</i><br><ol><li>Sri Lanka</li></ol>
Şwesiýa	<i>name</i><br><ol><li>Sweden</li></ol>
Şweýsariýa	<i>name</i><br><ol><li>Switzerland</li></ol>
ş|Ş	<i>character</i><br><ol><li>The twenty-third letter of the Turkmen alphabet, called şe and written in the Latin script.</li></ol>
şa|şalar|şany	<i>noun</i><br><ol><li>king</li><li>(chess) king</li></ol>
şagal|şagaly|şagallar	<i>noun</i><br><ol><li>jackal</li></ol>
şahyr|şahyra|şahyrdan|şahyrlary|şahyry|şahyrlaryň|şahyrlara|şahyrlardan|şahyrlar|şahyryň|şahyrda|şahyrlarda	<i>noun</i><br><ol><li>poet</li></ol>
şalgam|şalgamda|şalgama|şalgamdan|şalgamlaryň|şalgamlary|şalgamlara|şalgamyň|şalgamlar|şalgamlarda|şalgamlardan|şalgamy	<i>noun</i><br><ol><li>turnip</li></ol>
şazada|şazadadan|şazadalara|şazadalardan|şazadā|şazadany|şazadanyň|şazadalary|şazadada|şazadalaryň|şazadalar|şazadalarda	<i>noun</i><br><ol><li>prince, princess (offspring of king)</li></ol>
şe	<i>noun</i><br><ol><li>The name of the Latin-script letter Ş.</li></ol>
şenbe	<i>noun</i><br><ol><li>Saturday</li></ol>
şerap	<i>noun</i><br><ol><li>wine</li></ol>
şin	<i>noun</i><br><ol><li>tyre, tire</li></ol>
şire	<i>noun</i><br><ol><li>juice</li></ol>
şu taýda	<i>adv</i><br><ol><li>here</li></ol>
şu ýerde	<i>adv</i><br><ol><li>here</li></ol>
şugundyr|şugundyra|şugundyryň|şugundyrlarda|şugundyrlar|şugundyrdan|şugundyrlardan|şugundyrda|şugundyrlary|şugundyrlaryň|şugundyrlara|şugundyry	<i>noun</i><br><ol><li>(botany) beet, beetroot</li></ol>
şäher|şäherler|şäheri	<i>noun</i><br><ol><li>city, town</li></ol>
şöhle|şöhlä|şöhlelere|şöhlelerde|şöhleleriň|şöhlede|şöhlelerden|şöhläni|şöhläniň|şöhleler|şöhleleri|şöhleden	<i>noun</i><br><ol><li>beam, ray of light</li></ol>
ž|Ž	<i>character</i><br><ol><li>The twelfth letter of the Turkmen alphabet, called že and written in the Latin script.</li></ol>
žandarm|žandarmy|žandarmda|žandarma|žandarmlar|žandarmdan|žandarmlaryň|žandarmlardan|žandarmlara|žandarmlarda|žandarmyň|žandarmlary	<i>noun</i><br><ol><li>gendarme</li></ol>
žanr|žanrlarda|žanry|žanrlary|žanra|žanrlaryň|žanrda|žanryň|žanrlardan|žanrlar|žanrlara|žanrdan	<i>noun</i><br><ol><li>genre</li></ol>
že|ženi|želer	<i>noun</i><br><ol><li>The name of the Latin-script letter Ž.</li></ol>
žiraf|žirafy|žiraflaryň|žiraflar|žirafa|žirafda|žiraflarda|žirafdan|žirafyň|žiraflara|žiraflardan|žiraflary	<i>noun</i><br><ol><li>giraffe</li></ol>
žonglýor|žonglýorlara|žonglýorlardan|žonglýoruň|ſonglÿor|žonglýorlaryň|žonglýorlary|žonglýory|žonglýordan|žonglýorlarda|jhonglyor|žonglýora|žonglýorda|žonglýorlar	<i>noun</i><br><ol><li>juggler</li></ol>
žurnal|žurnallar|žurnaly	<i>noun</i><br><ol><li>journal, magazine</li></ol>
žurnalist|žurnalistler|žurnalisti	<i>noun</i><br><ol><li>journalist</li></ol>
žurnalistika|žurnalistikany	<i>noun</i><br><ol><li>journalism</li></ol>
برلەشڭز بوتين دونيا يوقسيلارى	<i>phrase</i><br><ol><li>workers of the world, unite! (pre-1929 Arabic spelling)</li></ol>
نگ|ňūn	<i>character</i><br><ol><li>The thirtieth letter of the Turkmen in Arabic script. It represents the Latin letter Ň</li></ol>
◌́	
