А|а	<i>character</i><br><ol><li>The first letter of the Tuvan alphabet, written in the Cyrillic script.</li></ol>
Азия|Азияларымже|Азиямга|Азияны|Азияларымны|Азияларга|Азиямдан|Азияда|Aziya|Азияларда|Азиялар|Азиядан|Азияларым|Азиям|Азиямда|Азиямның|Азиядыва|Азияларның|Азияның|Aziyaje|Азияларны|Азияларымда|Азияже|Азияларымга|Азиялардыва|Азияларымдыва|Азиямже|Азиямны|Азиямдыва|Азияларже|Азияларымның|Азиялардан|Азияларымдан|Азияга	<i>noun</i><br><ol><li>Asia (a continent)</li></ol>
Алдай|Alday	<i>name</i><br><ol><li>Altai (mountain range)</li></ol>
Бурган|Бурганнарның|Бурганнардан|Бурганнарымның|Бурганже|Бурганымны|Бурганнарда|Бурганымның|Бурганнарымдан|Бурганнарымны|Бурганнар|Бурганнарымдыва|Бурганга|Бурганның|Бурганымдыва|Burgan|Бурганымже|Бурганымга|Бурганымда|Бурганымдан|Бургандан|Бурганнардыва|Бурганнарымже|Бурганым|Бурганнарымда|Бурганнарже|Бургандыва|Бурганнарны|Бурганны|Бурганнарга|Бурганнарымга|Бурганнарым|Бурганда	<i>noun</i><br><ol><li>(Christianity) God</li></ol>
Кыдат|Kıdat	<i>name</i><br><ol><li>China</li></ol>
Кызыл|Кызылдан|Кызылымдыва|Кызылымның|Кызылымда|Кызылым|Кызылымга|Кызылже|Кызылымже|Кызылдың|Кызылымдан|Kızıl|Кызылымны|Кызылдыва|Кызылды|Кызылда|Кызылга	<i>name</i><br><ol><li>Kyzyl (the capital city of the Tuva Republic, Russia)</li></ol>
Көпсү-Хөл|Köpsü-Xöl	<i>name</i><br><ol><li>Khövsgöl (lake in northwestern Mongolia)</li></ol>
Моол|Mool	<i>name</i><br><ol><li>Mongolia (a country in inner Asia)</li></ol>
Пөштүг-Хем|Pöştüg-Xem	<i>name</i><br><ol><li>Poshtug-Khem (river in Bai-Taiginsky Kozhuun, Tuva, Russia)</li></ol>
Тес-Хем|Tes-Xem	<i>name</i><br><ol><li>the Tes River</li></ol>
Тыва|Тываның|Тывага|Тываларга|Тывамның|Tıvaga|Тываларымга|Тывалардан|Тываларымда|Тываларым|Тывалар|Тывамдыва|Тываларның|Тываларымже|Тываларда|Tıva|Тывам|Тывада|Тывадыва|Тываларымны|Тываларже|Тываларымның|Тывамны|Тывамдан|Тываларны|Тывадан|Тывамда|Тываны|Тываже|Тываларымдан|Тывалардыва|Тывамже|Тывамга|Тываларымдыва	<i>name</i><br><ol><li>Tuva (a republic of Russia)</li></ol>
Улуг-Хем|Ulug-Xem	<i>name</i><br><ol><li>Yenisei (a major river in Russia)</li></ol>
Ы|I	<i>character</i><br><ol><li>The thirty-second letter of the Tuvan alphabet</li></ol>
аал|аалымны|аалымга|аалдар|аалдарымны|аалдыва|аалдарымдан|аалже|аалымдан|аалдарымже|аалымның|аалдарга|aal|аалдарже|аалдарда|аалымда|аалдарымның|аалда|аалдарымдыва|аалдардан|аалды|аалдың|аалдан|аалга|аалдарымда|аалымже|аалдардыва|аалдарны|аалымдыва|аалым|аалдарның|аалдарым|аалдарымга	<i>noun</i><br><ol><li>village</li><li>tent (housing structure)</li><li>(by extension) home</li></ol>
аар|aar	<i>adj</i><br><ol><li>heavy</li><li>expensive (price)</li></ol>
аарыг|aarıg|аарыгны|аарыглар	<i>adj</i><br><ol><li>sick, ill</li></ol><br><i>noun</i><br><ol><li>disease, illness</li></ol>
аарыыр|аараан|аарывас|aarıır	<i>verb</i><br><ol><li>(intransitive, + ablative) to be sick, suffer of</li><li>(intransitive) to hurt, ache, sting</li></ol>
аас|аасты|аастер|aas	<i>noun</i><br><ol><li>(anatomy) mouth</li></ol>
аас-кежик|аас-кежиктердиве|аас-кежикимже|аас-кежикимни|аас-кежиктеримге|аас-кежиктерниң|аас-кежикимниң|аас-кежиктеримде|аас-кежикте|аас-кежикимдиве|аас-кежиктеримдиве|аас-кежиктер|аас-кежиктерим|аас-кежиктиң|аас-кежикимде|аас-кежиктерде|аас-кежиктеримниң|аас-кежиктеримже|аас-кежиктеримден|аас-кежиким|аас-кежикимден|аас-кежиктеримни|аас-кежикимге|аас-кежиктерни|аас-кежикче|аас-кежиктерге|аас-кежикке|aas-kejik|аас-кежиктен|аас-кежиктерже|аас-кежикти|аас-кежиктерден|аас-кежиктиве	<i>noun</i><br><ol><li>happiness</li></ol>
ава|авамда|авага|аваны|аваларга|авадыва|аваларымда|авамдан|аваларым|аваже|аваларымдыва|авалардыва|аваларымның|авамны|авада|аваларымга|аваларның|аваларда|аваның|авалардан|аваларже|аваларымны|ava|авалар|авамдыва|авам|авамга|аваларны|аваларымже|авамже|авамның|авадан|аваларымдан	<i>noun</i><br><ol><li>mother</li></ol>
авырал|авыралдарымны|авыралдар|авыралдарымдыва|авыралдардыва|авыралдарже|авыралымдыва|авыралым|авыралдыва|авыралымга|авыралда|avıral|авыралдың|авыралдарымдан|авыралымда|авыралдарымже|авыралдарым|авыралымның|авыралдарның|авыралдарымга|авыралымдан|авыралдарны|авыралды|авыралымже|авыралдарга|авыралдарымда|авыралга|авыралдарымның|авыралже|авыралдардан|авыралымны|авыралдан|авыралдарда	<i>noun</i><br><ol><li>help, assistance</li></ol>
агаар|agaar|агаарлар|агаарны	<i>noun</i><br><ol><li>air</li><li>weather</li></ol>
агаарлаар|agaarlaar|агаарлавас|агаарлаан	<i>verb</i><br><ol><li>(intransitive) to take a walk, stroll</li></ol>
агып|agıp	<i>verb</i><br><ol><li>modal converb of ак- (ak-, “to flow”, affirmative stem)</li></ol>
адаар|адавас|адаан|adaar	<i>verb</i><br><ol><li>(transitive) to name, entitle</li><li>(transitive) to pronounce</li></ol>
адыг|адыглар|adıg|адыгны	<i>noun</i><br><ol><li>bear</li></ol>
адыңар кымыл|adıñar kımıl?	<i>phrase</i><br><ol><li>what's your name?</li></ol>
ажар|ашпадыңар|ашсыңарза|ашсылар|ашпагай|ашпас|ашпаза|аш|ашпадың|ашкай|ашчай|ажап|ашпаан|ашпазыңза|ашпазыңарза|аштыр|ашпазывысса|ажа|ашпазымза|ашсымза|ашпазылар|ажайн|ашты|ajar|аштың|ашкан|ашса|аштым|ашпаңар|ашсын|ашпайн|аштыңар|аштылар|ашпады|ашпалыңар|ашпадым|ашсыңза|ашпазыннар|ашсыннар|аштывыс|ажылыңар|ашпадыр|ашпазын|ашпадывыс|ашпа|ашпадылар|ашсывысса|ажыңар|ашкаш	<i>verb</i><br><ol><li>(intransitive, transitive) to open</li></ol>
ажык|ажыкты|ажыктар|ajık	<i>adj</i><br><ol><li>open</li><li>profitable, beneficial</li></ol><br><i>noun</i><br><ol><li>(phonetics) vowel</li><li>profit, gain</li></ol>
ажыл|ajıl|ажылдар|ажылды	<i>noun</i><br><ol><li>work, job</li></ol>
аза|азаларымга|азаларымже|азаларымдан|азаларда|азамда|азаларның|азаже|азада|азамга|азаларга|азаларымдыва|азаларымның|азалардыва|азаларымны|азамны|aza|азамдан|азалар|азага|азам|азамдыва|азаларым|азалардан|азаның|азаны|азаларымда|азамже|азадыва|азаларны|азамның|азадан|азаларже	<i>noun</i><br><ol><li>demon, devil (evil spirit)</li></ol>
азы|azı	<i>conj</i><br><ol><li>or</li></ol>
ай|айны|айлар|ay	<i>noun</i><br><ol><li>moon</li><li>month</li></ol>
айлаң куш|айлаң кушту|айлаң куштар|aylañ kuş	<i>noun</i><br><ol><li>nightingale (bird)</li></ol>
айыыл|айыылымже|айыылымга|айыылга|айыылдарда|айыылдың|айыылдарны|айыылдарымда|айыылымдан|айыылдарымның|айыылда|айыылдарның|айыылымны|айыылдыва|айыылды|айыылымдыва|айыылдарымга|айыылдарымже|айыылдар|айыылымда|айыылдарга|айыылдарымдыва|айыылдарже|айыылдарымны|айыылдардыва|айыылже|айыылым|айыылымның|ayııl|айыылдан|айыылдарым|айыылдардан|айыылдарымдан	<i>noun</i><br><ol><li>danger</li><li>accident, disaster</li></ol>
ак|ak|актар|акты	<i>adj</i><br><ol><li>white</li></ol><br><i>noun</i><br><ol><li>white (colour)</li></ol>
ак-кызыл|ак-кызылдар|ak-kızıl|ак-кызылды	<i>adj</i><br><ol><li>pink</li></ol><br><i>noun</i><br><ol><li>pink (colour)</li></ol>
ак-көк|ak-kök|ак-көктү|ак-көктер	<i>adj</i><br><ol><li>light blue</li></ol><br><i>noun</i><br><ol><li>light blue (colour)</li></ol>
ак-сарыг|ак-сарыглар|ak-sarıg|ак-сарыгны	<i>adj</i><br><ol><li>light yellow, cream</li></ol><br><i>noun</i><br><ol><li>light yellow, cream (colour)</li></ol>
акша|akşa|акшалар|акшаны	<i>noun</i><br><ol><li>money</li><li>(by extension) ruble (national currency of Russia)</li></ol>
акы|акылардан|акыларымга|akı|акыларже|акым|акыга|акымны|акыдыва|акылар|акыларымже|акыларны|акыже|акымже|акыларымдан|акыларым|акыларга|акымдыва|акымның|акымда|акыны|акыларымның|акымдан|акылардыва|акымга|акыларның|акыларда|акының|акыда|акыдан|акыларымны|акыларымдыва|акыларымда	<i>noun</i><br><ol><li>elder brother</li></ol>
акы-дуңма|акы-дуңмага|акы-дуңмаларымдан|акы-дуңмаларда|акы-дуңмаларга|акы-дуңмадан|акы-дуңманы|акы-дуңмамда|акы-дуңмаларым|акы-дуңмамның|акы-дуңмалардан|акы-дуңмаларның|акы-дуңмалар|акы-дуңмаларже|акы-дуңмаже|акы-дуңмаларны|акы-дуңмада|акы-дуңмаларымны|акы-дуңманың|akı-duñma|акы-дуңмамдыва|акы-дуңмамже|акы-дуңмаларымда|акы-дуңмамны|акы-дуңмадыва|акы-дуңмамдан|акы-дуңмаларымдыва|акы-дуңмаларымның|акы-дуңмамга|акы-дуңмаларымга|акы-дуңмам|акы-дуңмалардыва|акы-дуңмаларымже	<i>noun</i><br><ol><li>siblings, brothers, sisters</li><li>relatives</li></ol>
алдан|aldan	<i>num</i><br><ol><li>sixty</li></ol>
алды|aldı	<i>num</i><br><ol><li>six</li></ol>
алдыгы|6-гы|aldıgı	<i>adj</i><br><ol><li>sixth</li></ol>
алдын|aldın|алдыннар|алдынны	<i>noun</i><br><ol><li>gold</li><li>(attributive) golden</li></ol>
алыр|alır	<i>noun</i><br><ol><li>to take</li></ol>
ам|am	<i>adv</i><br><ol><li>now</li></ol>
амдыызында|amdıızında	<i>adv</i><br><ol><li>still, yet</li></ol>
амы|амыны|amı|амылар	<i>noun</i><br><ol><li>life</li></ol>
амыдыраар|amıdıraar|амыдыраан|амыдыравас	<i>verb</i><br><ol><li>(intransitive) to live</li></ol>
амыр|амырдан|амырларымга|амырларны|амырларже|амырның|амырлардан|амырдыва|амырымның|amır|амырларда|амырым|амырларымдыва|амырымда|амырларымны|амырга|амырларым|амырларымның|амырымже|амырымдыва|амырлардыва|амырже|амырымга|амырымны|амырларның|амырны|амырларымже|амырлар|амырларымдан|амырларга|амырымдан|амырларымда|амырда	<i>adj</i><br><ol><li>easy</li></ol><br><i>intj</i><br><ol><li>A greeting, more formal than экии; hello, greetings</li></ol><br><i>noun</i><br><ol><li>peace, tranquility</li></ol>
амыраар|амыравас|amıraar|амыраан	<i>verb</i><br><ol><li>to be relieved</li><li>to be glad, happy</li></ol>
амытан|amıtan|амытаннар|амытанны	<i>noun</i><br><ol><li>animal</li></ol>
анаа|anaa	<i>adj</i><br><ol><li>normal, ordinary</li></ol>
аныяк|anıyak	<i>adj</i><br><ol><li>young</li></ol>
апаар|апарган|apaar|апарбас	<i>verb</i><br><ol><li>(intransitive) to become</li><li>(auxiliary) to must, have to do</li></ol>
апрель|апрельди|aprelʹ|апрельдер	<i>noun</i><br><ol><li>April</li></ol>
арага|арагалар|араганы|araga	<i>noun</i><br><ol><li>alcohol, liquor</li></ol>
арга|arga|аргалар|арганы	<i>noun</i><br><ol><li>forest of coniferous trees</li><li>method, way</li></ol>
ары|арылар|arı|арыны	<i>noun</i><br><ol><li>bee; wasp</li><li>north slope (yin side) of a mountain</li></ol>
арыг|арыгны|арыглар|arıg	<i>noun</i><br><ol><li>forest of broad-leaved trees</li></ol><br><i>adj</i><br><ol><li>clean, pure</li></ol>
арын|арынымда|арындан|арыным|арыннарга|арыннарымны|арыннарда|arın|арыннардыва|арыннарымның|арыннар|арыннарны|арынымдан|арыннарымдыва|арынымга|арыннарымга|арынның|арынымны|арынга|арынже|арында|арынны|арынымже|арыннарже|арындыва|арыннардан|арыннарым|арыннарымдан|арыннарның|арынымның|арыннарымже|арынымдыва|арыннарымда	<i>noun</i><br><ol><li>face</li><li>page</li><li>(Internet) web page</li></ol>
аскыр|askır	<i>noun</i><br><ol><li>stallion</li></ol>
ат|атымны|атымдан|аттарда|аттан|аттарымдыва|атты|аттар|атымга|аттардан|атымның|аттарже|аттарымже|аттарымны|атта|атче|аттың|аттарым|аттарымның|аттарымга|аттарны|аттыва|атымже|аттардыва|at|аттарның|аттарымдан|атымда|атка|аттарымда|атымдыва|аттарга|атым	<i>noun</i><br><ol><li>name</li></ol>
ача|ачалардан|ачаларымда|ачадан|ачаларымны|ачаларымның|ачамдан|ачаларның|ачаларда|ачамга|ачамдыва|ачаларже|ачамның|ачаларымдан|aça|ачаның|ачага|ачадыва|ачаларны|ачалар|ачаже|ачамже|ачада|ачаларым|ачаларымже|ачаларымга|ачамда|ачаны|ачамны|ачалардыва|ачаларга|ачам|ачаларымдыва	<i>noun</i><br><ol><li>father</li></ol>
ашак|ашактарым|ашактардан|ашактарның|ашакымга|ашактарда|ашактарга|ашактарымдан|ашактарже|ашактарымны|ашактарымдыва|ашактарымга|ашактарны|ашактарымның|ашакымда|ашакка|ашактан|ашактарымже|ашакым|ашакымдыва|ашакты|ашактың|ашактарымда|aşak|ашакта|ашакче|ашакымны|ашакымның|ашактардыва|ашакымдан|ашактар|ашакымже|ашактыва	<i>noun</i><br><ol><li>elderly man</li><li>husband, male spouse</li></ol>
аът|аътты|аъттар|àt	<i>noun</i><br><ol><li>horse</li></ol>
аэропорт|аэропортту|aeroport|аэропорттар	<i>noun</i><br><ol><li>airport</li></ol>
аяк|аяктар|ayak|аякты	<i>noun</i><br><ol><li>cup</li></ol>
аң|аңнарның|аңның|аңда|аңдыва|аңымдыва|añ|аңже|аңымны|аңымның|аңнардыва|аңым|аңнарымже|аңымже|аңнарымны|аңнар|аңнарны|аңымдан|аңны|аңнарда|аңнарымдан|аңдан|аңнарымдыва|аңымда|аңнарым|аңга|аңымга|аңнарымда|аңнардан|аңнарымга|аңнарже|аңнарымның|аңнарга	<i>noun</i><br><ol><li>beast, wild animal</li></ol>
аңгы|аңгылар|añgı|аңгыны	<i>adj</i><br><ol><li>different, separate</li></ol><br><i>noun</i><br><ol><li>class, grade, rank</li></ol>
аңнаар|аңнаан|añnaar|аңнавас	<i>verb</i><br><ol><li>(transitive) to hunt (an animal)</li></ol>
аңчы|аңчылар|аңчыны|añçı	<i>noun</i><br><ol><li>hunter</li></ol>
баар|барбас|baar|баарны|барган|баарлар	<i>verb</i><br><ol><li>(intransitive) to go</li></ol><br><i>noun</i><br><ol><li>(anatomy) liver</li></ol>
багай|bagay	<i>adj</i><br><ol><li>bad, faulty</li><li>evil</li></ol>
бажа|baja	<i>noun</i><br><ol><li>husband of sisters</li></ol>
бажың|бажыңны|бажыңнар|bajıñ	<i>noun</i><br><ol><li>house (fixed residence, as opposed to a yurt)</li><li>building</li></ol>
база|baza	<i>adv</i><br><ol><li>also, as well</li></ol><br><i>conj</i><br><ol><li>and</li></ol>
бай|bay	<i>adj</i><br><ol><li>rich, wealthy</li><li>abundant, plentiful</li></ol>
байырлыг|bayırlıg|ornative	<i>adj</i><br><ol><li>delighted, joyful</li></ol><br><i>intj</i><br><ol><li>goodbye</li></ol>
байыыр|байывадым|bayıır|байывалыңар|байылыңар|байый|байыза|байывадыр|байыңар|байывадыңар|байыды|байызыңарза|байызыннар|байывадың|байыжай|байывазывысса|байызылар|байыдыңар|байывазылар|байаан|байып|байааш|байываан|байыдыр|байывагай|байыгай|байывады|байывазыңарза|байывазыннар|байыдың|байывадывыс|байываза|байывазын|байызын|байыдылар|байыва|байыдывыс|байывадылар|байывазымза|байызывысса|байывайн|байывазыңза|байызыңза|байывас|байызымза|bayı|байы|байываңар|байыйн|байыдым	<i>verb</i><br><ol><li>(intransitive) to grow rich</li></ol>
байыыр мен|bayıır men	<i>verb</i><br><ol><li>first-person singular present-future of байыыр (bayıır)</li></ol>
балыг|балыгда|балыгны|балыгдан|балыгларже|балыгларны|балыгымны|балыгымга|балыгымда|балыгларда|балыгымның|балыгым|балыгымже|балыгларның|балыгларымны|балыгларым|балыгларымдан|балыгларымда|балыгларымдыва|балыглардыва|балыгже|балыгларга|балыгдыва|балыгларымга|балыглардан|балыгга|балыгларымның|балыгларымже|балыглар|balıg|балыгымдыва|балыгның|балыгымдан	<i>noun</i><br><ol><li>wound, injury</li></ol>
балык|балыктар|балыкты|balık	<i>noun</i><br><ol><li>fish</li></ol>
бар|bar	<i>adj</i><br><ol><li>there is</li></ol>
барыын|barıın	<i>adj</i><br><ol><li>west</li></ol>
баш|баштарымны|башымның|башка|баштарымга|баштарның|баштың|baş|башымда|башымдыва|башта|башымже|баштан|башымны|баштарымның|башты|баштарымда|баштарымдан|баштар|башче|баштарымдыва|баштарымже|баштарга|башымга|баштарны|баштарым|баштыва|баштарда|башым|баштардан|башымдан|баштардыва|баштарже	<i>noun</i><br><ol><li>(anatomy) head</li><li>(figuratively) beginning</li></ol>
башкыш|başkış	<i>noun</i><br><ol><li>stairway</li></ol>
баштайгы|baştaygı	<i>adj</i><br><ol><li>initial</li><li>first</li></ol>
бе|be	<i>particle</i><br><ol><li>Particle for forming yes-or-no questions.</li></ol>
бедик|bedik	<i>adj</i><br><ol><li>big, tall</li></ol>
бежен|bejen	<i>num</i><br><ol><li>fifty</li></ol>
белен|belen	<i>adj</i><br><ol><li>easy, simple</li><li>ready, prepared</li></ol>
берге|berge	<i>adj</i><br><ol><li>difficult, hard</li></ol>
бертен|berten	<i>adv</i><br><ol><li>this morning</li></ol>
беш|beş	<i>num</i><br><ol><li>five</li></ol>
бешки|5-ки|beşki	<i>adj</i><br><ol><li>fifth</li></ol>
бижек|bijek|бижектер|бижекти	<i>noun</i><br><ol><li>knife</li></ol>
бижиир|bijiir	<i>noun</i><br><ol><li>(transitive) to write</li></ol>
биле|bile	<i>particle</i><br><ol><li>Hyphenated after a word, forming its comitative or instrumental case.</li></ol><br><i>conj</i><br><ol><li>and</li></ol>
билир|билген|bilir|билбес	<i>verb</i><br><ol><li>(transitive) to know, understand</li><li>(auxiliary, + -п) to be able to, can</li></ol>
бир|bir	<i>num</i><br><ol><li>one</li></ol>
бирги|1-ги|birgi	<i>adj</i><br><ol><li>first</li></ol>
бис|bis	<i>pron</i><br><ol><li>we (first-person plural personal pronoun)</li></ol>
бичии|biçii	<i>adj</i><br><ol><li>small, little</li></ol>
бо|bo|мында|mında	<i>pron</i><br><ol><li>(demonstrative) this</li></ol>
бодаар|bodaar|бодавас|бодаан	<i>verb</i><br><ol><li>(transitive) to think, suppose</li></ol>
бодум|bodum	<i>pron</i><br><ol><li>(reflexive) myself</li></ol>
бойдус|бойдусту|boydus|бойдустар	<i>noun</i><br><ol><li>nature, environment</li></ol>
бок|bok|боктар|бокту	<i>noun</i><br><ol><li>garbage</li></ol>
болар|bolar	<i>pron</i><br><ol><li>(demonstrative) these</li></ol>
болгаш|bolgaş	<i>conj</i><br><ol><li>and</li><li>after (of time)</li></ol>
болур|болза|болзувусса|болбас|болбагай|болбазымза|болбазыңза|болбаза|болбаңар|болап|болбалыңар|болзуңарза|бола|болбадуңар|болдуңар|болзуңза|болзун|болган|болжай|болгаш|болзулар|бол|болдуң|болбазын|болуңар|болайн|болбазылар|болбазыңарза|болбазывусса|болдур|болбадыр|болзуннар|болбадуң|болбадувус|болба|bolur|болбадулар|болдувус|болбазыннар|болулыңар|болдулар|болгай|болдум|болбайн|болбадум|болду|болзумза|болбаду|болбаан	<i>verb</i><br><ol><li>to be, become</li><li>(auxiliary, + -п) indicates permission or feasibility of an action</li></ol>
боо|боолар|боону|boo	<i>noun</i><br><ol><li>gun (firearm)</li></ol>
боолаар|boolaar	<i>verb</i><br><ol><li>to shoot, to fire</li></ol>
боостаа|боостаалар|boostaa|боостааны	<i>noun</i><br><ol><li>throat, windpipe</li></ol>
бош|boş	<i>adj</i><br><ol><li>empty</li></ol>
будук|будуктар|buduk|будукту	<i>noun</i><br><ol><li>stick, branch</li><li>ink, paint</li></ol>
булут|булутту|булуттар|bulut	<i>noun</i><br><ol><li>cloud</li></ol>
бурунгаар|burungaar	<i>adv</i><br><ol><li>before (time)</li><li>forward</li><li>in front of</li></ol>
буруу|бурууну|buruu|буруулар	<i>noun</i><br><ol><li>wrongdoing, error</li></ol>
буруулуг болдум|buruulug boldum	<i>intj</i><br><ol><li>sorry (apology)</li></ol>
буряттаар|buryattaar	<i>verb</i><br><ol><li>to speak in Buryat</li></ol>
бут|буттува|буттардува|бутумнуң|бутумже|буттар|буттарда|бутумдува|бутум|бутумдан|буттуң|буттарымдува|буттарымдан|буттарымга|буттарны|буттарымже|буттан|буттарга|буттарым|but|буттарымны|бутумга|буттарның|буттарже|буттарымда|бутту|буттардан|буттарымның|бутта|бутумда|бутче|бутка|бутумну	<i>noun</i><br><ol><li>leg</li><li>foot</li></ol>
бызаа|bızaa|бызааны|бызаалар	<i>noun</i><br><ol><li>calf</li></ol>
быт|бытты|быттар|bıt	<i>noun</i><br><ol><li>louse</li></ol>
быштак|bıştak|быштакты|быштактар	<i>noun</i><br><ol><li>cheese</li></ol>
бээр	<i>verb</i><br><ol><li>to give</li><li>(auxiliary) Used to form the perfective of a verb, following its imperfective converbal in variant -е (-e), -э (-e), -и (-i), -ү (-ü), -а (-a), -ы (-ı), -у (-u), or -й (-y)</li><li>(auxiliary) Used to indicate an action having its external concern or purpose, following associative converbal in -п (-p) or its epenthetic variants</li></ol>
бүгү|bügü	<i>det</i><br><ol><li>all</li></ol>
бүгүде|bügüde	<i>pron</i><br><ol><li>entirety, whole, everyone</li></ol>
бүзүрел|бүзүрелдер|büzürel|бүзүрелди	<i>noun</i><br><ol><li>faith, trust</li></ol>
бүзүрээр|бүзүрээн|бүзүревес|büzüreer	<i>verb</i><br><ol><li>(transitive, + dative case) to believe, trust</li></ol>
бүле|бүлелеримден|бүледен|бүлени|бүлелерде|бүлелеримни|бүлелерни|бүлелерим|бүлелерже|бүлемге|бүлелеримге|бүлемден|бүлем|бүлениң|бүлеже|бүлемниң|бүлелеримниң|бүледе|бүлеге|бүлемдиве|бүлелеримже|бүлелер|бүлелердиве|büle|бүлемни|бүлелеримде|бүлемже|бүлелерге|бүлемде|бүледиве|бүлелерниң|бүлелерден|бүлелеримдиве	<i>noun</i><br><ol><li>(rare, poetic) family</li></ol>
бүрү|bürü	<i>det</i><br><ol><li>every, each</li></ol>
бүүрек|бүүректи|büürek|бүүректер	<i>noun</i><br><ol><li>kidney (organ)</li></ol>
бөгүн|bögün	<i>adv</i><br><ol><li>(predicative) today</li></ol>
бөгүнгү|bögüngü	<i>adj</i><br><ol><li>(attributive) today</li></ol>
бөрү|börü|бөрүлер|бөрүнү	<i>noun</i><br><ol><li>wolf</li></ol>
даа|daa|даалар|дааны	<i>particle</i><br><ol><li>(in the form …-даа, …-даа) both … and … (affirmatively); neither … nor … (negatively)</li><li>(after a conditional verb) even if</li></ol><br><i>noun</i><br><ol><li>short for үгер-даа (üger-daa, “appointed chief of a banner”)</li></ol>
даарта|daarta	<i>adv</i><br><ol><li>tomorrow</li></ol>
дааш|даашты|дааштар|daaş	<i>noun</i><br><ol><li>noise, stir</li></ol>
даг|dagnıñ|дагның|dag|даглар|дагны	<i>noun</i><br><ol><li>(geography) mountain</li></ol>
дагаа|дагаалар|дагааны|dagaa	<i>noun</i><br><ol><li>chicken</li></ol>
дазыл|дазылды|дазылдар|dazıl	<i>noun</i><br><ol><li>root</li></ol>
дайзын|dayzın|дайзынны|дайзынлар	<i>noun</i><br><ol><li>enemy, foe</li></ol>
дайын|дайынны|dayın|дайыннар	<i>noun</i><br><ol><li>war</li></ol>
дайынчы|дайынчыны|dayınçı|дайынчылар	<i>noun</i><br><ol><li>warrior, soldier</li></ol>
далай|далайларымга|далайдыва|далайымның|далайларымже|далайларда|далайдан|далайларны|далайымга|далайларымдан|далайым|далайларымны|далайымже|далайда|далайларымның|далайлардан|далайларымда|далайны|далайлардыва|далайымны|далайымда|далайымдыва|далайлар|далайларымдыва|dalay|далайларның|далайларже|далайның|далайларым|далайга|далайже|далайларга|далайымдан	<i>noun</i><br><ol><li>sea, ocean</li></ol>
дамды|damdı|дамдылар|дамдыны	<i>noun</i><br><ol><li>drop (of water)</li></ol>
даргат|dargat	<i>noun</i><br><ol><li>Darkhad</li></ol>
даш|даштар|daş|дашты	<i>noun</i><br><ol><li>stone</li></ol>
делгем|delgem	<i>adj</i><br><ol><li>wide, broad</li></ol>
делегей|делегейни|делегейлер|delegey	<i>noun</i><br><ol><li>world</li></ol>
демир|демирни|демирлер|demir	<i>noun</i><br><ol><li>iron</li><li>metal</li></ol>
демир-үжүк|демир-үжүкүмден|демир-үжүктен|демир-үжүктеримни|демир-үжүкүмдүве|демир-үжүктерге|демир-үжүкүмнүң|демир-үжүктерже|демир-үжүктеримден|демир-үжүкче|демир-үжүктеримниң|демир-үжүктерни|демир-үжүктүве|демир-үжүктерим|демир-үжүктеримдүве|демир-үжүкүмде|демир-үжүкүмже|демир-үжүктердүве|демир-үжүкүмге|демир-үжүктеримде|демир-үжүктүң|демир-үжүктерден|демир-үжүкүмнү|демир-үжүктеримге|демир-үжүктеримже|демир-үжүктү|демир-үжүкүм|demir-üjük|демир-үжүкке|демир-үжүктер|демир-үжүктерде|демир-үжүктерниң|демир-үжүкте	<i>noun</i><br><ol><li>pen (writing tool)</li></ol>
дер|дерлер|дерни|der	<i>noun</i><br><ol><li>sweat</li></ol>
деридер|derider	<i>verb</i><br><ol><li>to sweat</li></ol>
дидим|didim	<i>adj</i><br><ol><li>brave, courageous</li></ol><br><i>verb</i><br><ol><li>first-person singular past II of дээр (deer)</li></ol>
диис|diis|диисти|диистер	<i>noun</i><br><ol><li>cat</li></ol>
дилги|дилгилер|dilgi|дилгини	<i>noun</i><br><ol><li>fox</li></ol>
дириг|dirig	<i>adj</i><br><ol><li>alive</li></ol>
дискек|дискекти|дискектер|diskek	<i>noun</i><br><ol><li>knee</li></ol>
диш|diş|диштер|дишти	<i>noun</i><br><ol><li>tooth</li></ol>
довурак|довуракымже|довурактарымны|довурактар|довурактан|довурактарның|довуракымдан|довурактарны|довуракымны|довуракта|довурактарымдан|довуракты|довурактарымның|довуракче|довурактарым|довурактың|довуракымда|довурактарымже|довурактардан|довурактарымда|довурактарымга|довуракым|довуракымның|довуракымга|довуракка|довурактарымдыва|довурактардыва|довурактарга|довурактарда|довурактарже|довуракымдыва|довурактыва|dovurak	<i>noun</i><br><ol><li>land, soil, earth</li></ol>
доктаадыр|doktaadır|доктааткан|доктаатпас	<i>verb</i><br><ol><li>(transitive) to stop</li></ol>
доктаал|доктаалдарым|доктаалдарымның|doktaal|доктаалга|доктаалдарымга|доктаалдарның|доктаалымга|доктаалдыва|доктаалдың|доктаалды|доктаалдарымдан|доктаалдарымже|доктаалдарымдыва|доктаалдарымда|доктаалдарымны|доктаалдарже|доктаалымже|доктаалымдыва|доктаалдардан|доктаалымның|доктаалже|доктаалда|доктаалдарны|доктаалдар|доктаалдардыва|доктаалым|доктаалымда|доктаалымдан|доктаалдан|доктаалымны|доктаалдарда|доктаалдарга	<i>noun</i><br><ol><li>decision, resolution</li></ol>
доктаамал|doktaamal	<i>adj</i><br><ol><li>decided, determined</li></ol>
доктаар|доктавас|doktaar|доктаан	<i>verb</i><br><ol><li>(intransitive) to stop, halt</li></ol>
доозар|дооскан|дооспас|doozar	<i>verb</i><br><ol><li>(transitive) to finish, end</li></ol>
доозун|doozun|доозуннер|доозунну	<i>noun</i><br><ol><li>dust</li></ol>
дораан|doraan	<i>adv</i><br><ol><li>immediately</li></ol>
дош|дошумнуң|дошче|дошумже|дошумну|дошту|доштарымдан|доштардува|доштува|доштардан|доштарда|doş|доштарымга|дошумдан|доштан|доштарымже|доштарымдува|доштарымның|дошумда|доштарже|дошум|дошумдува|дошка|доштар|доштарым|доштарымны|доштарга|дошта|доштарның|доштарны|доштуң|дошумга|доштарымда	<i>noun</i><br><ol><li>ice</li></ol>
дугаар|dugaar|дугаарны|дугаарлар	<i>noun</i><br><ol><li>number (sequence of digits)</li><li>Forms ordinals out of cardinal numbers.</li></ol>
дугайында|dugayında	<i>postp</i><br><ol><li>about, concerning</li></ol>
дугуй|дугуйлар|duguy|дугуйну	<i>noun</i><br><ol><li>wheel</li></ol>
дуза|дузадан|дузаларымда|дузамда|дузаларымга|дузага|дузаның|дузалардан|дузаларымның|дузамга|дузамдан|дузаже|дузаны|дузалардыва|дузамның|дузаларның|duza|дузаларда|дузадыва|дузада|дузаларже|дузаларны|дузамже|дузалар|дузам|дузаларымдыва|дузамны|дузаларымдан|дузамдыва|дузаларымже|дузаларымны|дузаларга|дузаларым	<i>noun</i><br><ol><li>benefit, profit</li><li>help, assistance</li></ol>
дузалаар|дузалавас|duzalaar|дузалаан	<i>verb</i><br><ol><li>(transitive) to help, assist</li></ol>
думчук|думчукту|dumçuk|думчуктар	<i>noun</i><br><ol><li>nose</li></ol>
дус|дустар|dus|дусту	<i>noun</i><br><ol><li>salt</li></ol>
дуңма|дуңмамже|дуңмадыва|дуңмамда|дуңмам|duñma|дуңмаларга|дуңмаларның|дуңмаларны|дуңмаларымда|дуңмалар|дуңмаларымның|дуңмаларымже|дуңмага|дуңмаларже|дуңмаларымдан|дуңмамдан|дуңмамны|дуңмаларымга|дуңманы|дуңмаларда|дуңмаларымны|дуңмаларымдыва|дуңмамдыва|дуңмаже|дуңмаларым|дуңмалардан|дуңмада|дуңмамга|дуңмалардыва|дуңмамның|дуңманың|дуңмадан	<i>noun</i><br><ol><li>a younger sibling of any gender</li></ol>
дыка|dıka	<i>adv</i><br><ol><li>very, quite</li></ol>
дыл|дылдар|dıl|дылды	<i>noun</i><br><ol><li>tongue</li><li>language</li></ol>
дырбак|дырбакты|дырбактар|dırbak	<i>noun</i><br><ol><li>fingernail</li><li>claw</li></ol>
дыштаныр|дыштанмас|дыштанган|dıştanır	<i>verb</i><br><ol><li>to rest</li></ol>
дыңнаар|дыңнаан|dıñnaar|дыңнавас	<i>verb</i><br><ol><li>(transitive) to hear, listen</li></ol>
дээк|deek|дээктер|дээкти	<i>noun</i><br><ol><li>lock</li></ol>
дээр|deer|дивезе|дип|дивезиңерзе|дивезиннер|дидиңер|диведим|дизимзе|дивелиңер|дээрни|диведиң|дидивис|дээн|дийн|дизиңерзе|диведир|дивезивиссе|дивес|дизин|дидим|диведилер|дизивиссе|дидилер|дээш|didim|дижей|диведивис|дизе|дивезин|дий|ди|дивегей|дегген|диңер|deeş|дивезиңзе|дегбес|диведиңер|дидиң|дивезилер|дизиннер|диведи|дээрлер|дивезимзе|дивеен|дигей|диве|диди|дивеңер|дидир|дизилер|дивейн|дилиңер|дизиңзе	<i>verb</i><br><ol><li>(transitive) to say, tell</li><li>(transitive) to touch</li></ol><br><i>postp</i><br><ol><li>until, up to (of time)</li></ol><br><i>noun</i><br><ol><li>sky</li></ol>
дээш|deeş	<i>postp</i><br><ol><li>for, in order to</li></ol><br><i>verb</i><br><ol><li>-геш converb of дээр (deer)</li></ol>
дүжер|дүшкен|düjer|дүшпес	<i>verb</i><br><ol><li>(intransitive) to descend, go down</li><li>(intransitive) to fall, drop</li></ol>
дүк|дүктүң|дүктен|дүкүмнү|дүктеримге|dük|дүкте|дүктерже|дүктер|дүкче|дүкке|дүктүве|дүктерден|дүктерни|дүктеримде|дүктеримниң|дүкүмде|дүкүм|дүкүмдүве|дүктерниң|дүкүмнүң|дүктердүве|дүктеримни|дүктерде|дүктеримже|дүктү|дүктеримдүве|дүкүмден|дүктеримден|дүктерге|дүкүмге|дүкүмже|дүктерим	<i>noun</i><br><ol><li>hair</li><li>fur</li></ol>
дүлгүүр|дүлгүүрлер|дүлгүүрнү|dülgüür	<i>noun</i><br><ol><li>key</li></ol>
дүмбей|dümbey	<i>adj</i><br><ol><li>dark</li></ol>
дүн|dün|дүннү|дүннер	<i>noun</i><br><ol><li>night</li></ol>
дүрген|dürgen	<i>adj</i><br><ol><li>fast</li></ol>
дүрзү|дүрзүлерим|дүрзүнүң|дүрзүлерге|дүрзүге|дүрзүлеримниң|дүрзүлеримде|дүрзүлеримни|дүрзүлерни|дүрзүлер|дүрзүлерден|дүрзүлеримден|дүрзүлеримдүве|дүрзүмдүве|дүрзүлеримге|дүрзүнү|дүрзүмнү|дүрзүлердүве|дүрзүдүве|дүрзүлерже|дүрзүде|дүрзүмде|дүрзүмге|дүрзүмден|dürzü|дүрзүлерниң|дүрзүмнүң|дүрзүмже|дүрзүлерде|дүрзүм|дүрзүлеримже|дүрзүже|дүрзүден	<i>noun</i><br><ol><li>appearance, look</li></ol>
дүш|düş|дүштер|дүштү	<i>noun</i><br><ol><li>dream</li><li>noon</li></ol>
дүштеки чем|дүштеки чемнер|дүштеки чемни|düşteki çem	<i>noun</i><br><ol><li>lunch (meal usually eaten in the afternoon)</li></ol>
дүъш|дүъштү|dǜş|дүъштер	<i>noun</i><br><ol><li>noon</li></ol>
дүүн|düün	<i>adv</i><br><ol><li>yesterday</li></ol>
дүүнгү|düüngü	<i>adj</i><br><ol><li>(attributive) today</li></ol>
дөрт|dört	<i>num</i><br><ol><li>four</li></ol>
дөртен|dörten	<i>num</i><br><ol><li>forty</li></ol>
дөрткү|dörtkü|4-кү	<i>adj</i><br><ol><li>fourth</li></ol>
дөө|döö	<i>pron</i><br><ol><li>(demonstrative) that (far from the speaker and listener)</li></ol>
дөөлер|dööler	<i>pron</i><br><ol><li>(demonstrative) those (far from the speaker and listener)</li></ol>
идегел|идегелдерже|идегелимдиве|идегелдеримни|идегелдеримже|идегелимниң|идегелдерге|идегелдиң|идегелге|идегелдеримге|идегелде|идегелимде|идегелден|идегелимни|идегелдеримде|идегелдерде|идегелдерим|идегелди|идегелже|идегелдеримниң|идегелдеримдиве|идегелимге|идегелим|идегелдиве|идегелдердиве|идегелдер|идегелимден|идегелимже|idegel|идегелдерниң|идегелдерден|идегелдеримден|идегелдерни	<i>noun</i><br><ol><li>hope, expectation</li></ol>
идегээр|idegeer|идегээн|идегевес	<i>verb</i><br><ol><li>(transitive) to hope for, expect</li><li>(transitive, + dative) to believe in, trust</li></ol>
ижер|ijer|ишкен|ишпес	<i>verb</i><br><ol><li>to drink</li></ol>
ижин|ijin|ижиннер|ижинни	<i>noun</i><br><ol><li>interior</li><li>stomach, abdomen</li></ol>
изиг|izig|изиглер|изигни	<i>noun</i><br><ol><li>heat</li></ol><br><i>adj</i><br><ol><li>warm, hot</li></ol>
ийе|iye	<i>particle</i><br><ol><li>yes</li></ol>
ийи|iyi	<i>num</i><br><ol><li>two</li></ol>
ийиги|iyigi|2-ги	<i>adj</i><br><ol><li>second</li></ol>
ийин|iyin	<i>particle</i><br><ol><li>Particle that softens a statement.</li></ol>
ине|ine|инелер|инени	<i>noun</i><br><ol><li>needle</li></ol>
ирги|irgi	<i>particle</i><br><ol><li>Particle that softens a question.</li></ol>
июнь|июньнар|iyunʹ|июньну	<i>noun</i><br><ol><li>June</li></ol>
каар|kaar	<i>verb</i><br><ol><li>(transitive) to leave, put down, place</li><li>(auxiliary, + -п) indicates completeness of an action</li></ol>
кадай|кадайлар|kaday|кадайны	<i>noun</i><br><ol><li>woman (adult female human)</li><li>wife</li></ol>
кадар|каткан|катпас|kadar	<i>conj</i><br><ol><li>(mathematics) plus</li></ol><br><i>verb</i><br><ol><li>(transitive) to add</li><li>(transitive, mathematics) to add, sum</li></ol>
кады|kadı	<i>adv</i><br><ol><li>together</li></ol>
кадыг|kadıg	<i>adj</i><br><ol><li>hard, solid</li></ol>
кадык|кадыкымга|кадыкымже|кадыктардан|кадыкче|kadık|кадыкым|кадыктарымдыва|кадыкымда|кадыкымны|кадыктың|кадыктар|кадыкымдан|кадыктыва|кадыктардыва|кадыктарны|кадыктарым|кадыктарда|кадыктарымны|кадыктан|кадыкымдыва|кадыктарымга|кадыктарымдан|кадыкты|кадыктарның|кадыкта|кадыктарымже|кадыкымның|кадыктарымда|кадыктарже|кадыктарга|кадыктарымның|кадыкка	<i>adj</i><br><ol><li>healthy</li></ol><br><i>noun</i><br><ol><li>health</li></ol>
кажан|kajan	<i>pron</i><br><ol><li>(interrogative) when?</li></ol>
казыыр|казывас|казаан|kazıır	<i>conj</i><br><ol><li>(mathematics) minus</li></ol><br><i>verb</i><br><ol><li>to subtract, reduce</li><li>(mathematics) to subtract</li></ol>
кайда|kayda	<i>adv</i><br><ol><li>(interrogative) where?</li></ol>
кайнаар|kaynaar	<i>adv</i><br><ol><li>(interrogative) to what place? whereto?</li></ol>
кайы|kayı	<i>pron</i><br><ol><li>(interrogative) which one?</li></ol>
кайыын|kayıın	<i>adv</i><br><ol><li>(interrogative) from what place? whence?</li></ol>
калга|калганы|kalga|калгалар	<i>noun</i><br><ol><li>Khalkha (Mongolian tribe)</li><li>Khalkha (person)</li></ol>
калыр|калбас|калган|kalır	<i>verb</i><br><ol><li>(intransitive) to remain, be left</li><li>(auxiliary) to end up doing</li></ol>
кандыг|kandıg	<i>adj</i><br><ol><li>(interrogative) what kind of?</li></ol>
канчаар|kançaar|канчавас|канчаан	<i>verb</i><br><ol><li>(interrogative) what to do?</li></ol><br><i>adv</i><br><ol><li>how, in what way</li></ol>
капка|капкаларымны|капкаларны|капкаларның|капкаларым|капкаларымдан|капкаларга|капкамны|капкалардан|капкамга|капкага|капкамның|капкаларымже|капкадыва|капкаларымның|kapka|капкам|капканың|капкалардыва|капкадан|капкаларымдыва|капкамда|капкамдан|капкаже|капкалар|капкада|капканы|капкаларда|капкаларже|капкамдыва|капкаларымда|капкамже|капкаларымга	<i>noun</i><br><ol><li>trap (device designed to catch animals)</li></ol>
кара|каралар|караны|kara	<i>adj</i><br><ol><li>black</li></ol><br><i>noun</i><br><ol><li>black (colour)</li></ol>
кара-бажың|кара-бажыңнарның|кара-бажыңдыва|кара-бажыңнарым|кара-бажыңнарны|кара-бажыңымда|кара-бажыңымны|кара-бажыңнарымда|кара-бажыңымже|кара-бажыңнар|кара-бажыңнардан|кара-бажыңым|кара-бажыңнарже|кара-бажыңнарымже|кара-бажыңнарымдыва|кара-бажыңны|кара-бажыңнарымга|кара-бажыңнарымны|kara-bajıñ|кара-бажыңымдан|кара-бажыңнарымның|кара-бажыңның|кара-бажыңда|кара-бажыңнардыва|кара-бажыңга|кара-бажыңымга|кара-бажыңнарга|кара-бажыңдан|кара-бажыңымдыва|кара-бажыңже|кара-бажыңымның|кара-бажыңнарда|кара-бажыңнарымдан	<i>noun</i><br><ol><li>prison, jail</li></ol>
карак|karak|каракты|карактар	<i>noun</i><br><ol><li>eye (organ of sight)</li></ol>
карт|kart	<i>noun</i><br><ol><li>hull, skin, shell</li><li>cover (the front and back of a book, magazine, etc.)</li></ol>
кас|kas	<i>noun</i><br><ol><li>goose</li></ol>
кат|kat|катты|каттар	<i>noun</i><br><ol><li>berry</li></ol>
каттырар|каттырган|каттырбас|kattırar	<i>verb</i><br><ol><li>(intransitive) to laugh</li></ol>
каш|kaş	<i>pron</i><br><ol><li>(interrogative) how many?</li></ol><br><i>det</i><br><ol><li>some, a few</li></ol>
каш харлыг силер|kaş xarlıg siler	<i>phrase</i><br><ol><li>how old are you?</li></ol>
каш шак-тыр|kaş şak-tır?	<i>phrase</i><br><ol><li>what time is it?</li></ol>
каң|каңнарымже|каңымга|каңымның|каңымда|каңны|каңнарны|каңнарда|каңымже|каңдыва|каңнардан|каңнарже|каңнарымдыва|каңнарымда|каңнарга|kañ|каңымдан|каңже|каңга|каңымдыва|каңнар|каңда|каңнарымның|каңнарым|каңымны|каңым|каңнарымны|каңнарымга|каңнардыва|каңнарның|каңнарымдан|каңдан|каңның	<i>noun</i><br><ol><li>steel</li></ol>
кедер|keder|кеткен|кетпес	<i>verb</i><br><ol><li>to dress, wear, put on</li></ol>
кежээ|кежээни|kejee|кежээлер	<i>noun</i><br><ol><li>evening</li></ol>
кежээки хаяа|kejeeki xayaa|кежээки хаяалары|кежээки хаяаны	<i>noun</i><br><ol><li>sunset</li></ol>
кезер|kezer	<i>verb</i><br><ol><li>to cut, carve,</li><li>to reap</li><li>to cross (e.g. the street)</li></ol>
кезик|кезиктеримни|кезиктерден|кезиктеримге|кезиким|кезиктен|кезикти|кезиктерге|кезикимниң|кезиктер|кезикимге|кезикимже|кезиктерни|кезикке|кезиктеримже|кезикимде|кезиктеримден|кезиктерим|кезиктердиве|кезикимдиве|кезиктерже|кезиктиң|кезиктеримниң|кезиктерниң|кезиктиве|кезиктеримде|кезиктеримдиве|кезикимден|кезиктерде|kezik|кезикче|кезикимни|кезикте	<i>noun</i><br><ol><li>half</li><li>part, piece</li></ol>
келиксээр|kelikseer	<i>verb</i><br><ol><li>to want to come</li></ol>
келир|келген|келбес|kelir	<i>verb</i><br><ol><li>to come</li></ol><br><i>adj</i><br><ol><li>forthcoming</li></ol>
кеш|кештеримниң|кешимге|кештеримни|кешимде|кеште|кештеримже|кештерге|кештеримде|кештен|кешимниң|кештеримден|кешимдиве|кештерже|кештерни|кешим|кештер|кештиве|кешче|кештердиве|кештерим|кешимден|кештерде|кешти|кешимже|кештеримдиве|кешке|кештерниң|кештиң|кештерден|keş|кештеримге|кешимни	<i>noun</i><br><ol><li>skin</li></ol>
кижи|кижини|кижиде|кижилеримниң|кижим|кижилерниң|кижимде|кижимден|кижимже|кижиден|кижилеримже|кижилерден|кижилеримден|кижимге|кижилерни|кижиниң|кижилерде|кижилерже|кижилердиве|кижилер|kiji|кижилерим|кижиже|кижимни|кижилеримде|кижимдиве|кижиге|кижимниң|кижилеримдиве|кижилеримни|кижилерге|кижилеримге|кижидиве	<i>noun</i><br><ol><li>person, human</li></ol>
килең|килеңмнң|килеңдн|килеңнрм|килеңмже|килеңнрд|килеңнрдн|килеңдв|килеңнрмнң|килеңнрмдн|килеңнрмже|килеңмд|килеңнрмг|килеңмдн|килеңнрмд|килеңнрмдв|килеңмн|килеңнрн|килеңмг|килеңд|килеңнрнң|килеңнрмн|килеңнрг|килеңже|килеңм|kileñ|килеңмдв|килеңн|килеңг|килеңнрже|килеңнр|килеңнрдв|килеңнң	<i>noun</i><br><ol><li>IPA⁽ᵏᵉʸ⁾: /kɪɫɛŋ/</li></ol>
кино|kino	<i>noun</i><br><ol><li>movie, motion picture</li></ol>
кирбик|кирбиктер|кирбикти|kirbik	<i>noun</i><br><ol><li>eyelash</li></ol>
кирер|кирбес|кирген|kirer	<i>verb</i><br><ol><li>to enter, go in</li><li>(auxiliary, + -п) to start (doing something)</li></ol>
кичээл|кичээлдер|kiçeel|кичээлди	<i>noun</i><br><ol><li>lesson</li></ol>
кичээлдээр|kiçeeldeer|кичээлдевес|кичээлдээн	<i>noun</i><br><ol><li>(transitive) to study, take lessons</li></ol>
кичээнгей|kiçeengey|кичээнгейлер|кичээнгейни	<i>adj</i><br><ol><li>cautious</li></ol><br><i>noun</i><br><ol><li>attention, caution</li></ol>
кодан|коданны|коданнар|kodan	<i>noun</i><br><ol><li>hare</li></ol>
кожуун|кожуунну|kojuun|кожууннар	<i>noun</i><br><ol><li>a kozhuun, a banner (administrative division, originally Mongolian military subdivision)</li></ol>
кол|kol	<i>adj</i><br><ol><li>main, chief, principal</li></ol>
колониалдыг|kolonialdıg	<i>adj</i><br><ol><li>(qualitative) colonial</li></ol>
копьё|kopʹyo|копьёну|копьёлер	<i>noun</i><br><ol><li>spear</li></ol>
коргар|корткан|korgar|кортпас	<i>verb</i><br><ol><li>(intransitive, transitive, + allative case) to be afraid, fear</li></ol>
кошкак|koşkak	<i>adj</i><br><ol><li>weak, feeble</li></ol>
коңга|коңганы|koñga|коңгалар	<i>noun</i><br><ol><li>bell</li></ol>
куду|kudu	<i>adj</i><br><ol><li>low (height)</li></ol>
кудурук|кудуруктар|kuduruk|кудурукту	<i>noun</i><br><ol><li>tail</li></ol>
кулак|кулакымже|кулактарымдан|кулактардыва|кулактың|кулакымда|кулакымга|кулактардан|кулактарымдыва|кулактарга|кулактар|кулакымдан|кулактарда|кулактан|кулактарны|кулакка|kulak|кулактарның|кулакче|кулактарымны|кулактарымда|кулакымның|кулакымдыва|кулакты|кулактарже|кулакым|кулактыва|кулактарымның|кулакта|кулакымны|кулактарымга|кулактарымже|кулактарым	<i>noun</i><br><ol><li>ear</li></ol>
кум|kum|кумну|кумнар	<i>noun</i><br><ol><li>sand</li></ol>
кундус|кундусту|кундустар|kundus	<i>noun</i><br><ol><li>otter</li></ol>
курт|kurt	<i>noun</i><br><ol><li>worm</li></ol>
куу|kuu|кууну|куулар	<i>adj</i><br><ol><li>grey</li></ol><br><i>noun</i><br><ol><li>grey (colour)</li><li>swan</li></ol>
куш|кушту|kuş|куштар	<i>noun</i><br><ol><li>bird</li></ol>
кыдат|kıdat	<i>noun</i><br><ol><li>(⁓ чон, ⁓ улус) the Chinese (people)</li><li>(⁓ кижи) Chinese (person)</li></ol>
кыдаттаар|kıdattaar	<i>verb</i><br><ol><li>to speak in Chinese</li></ol>
кыдыында|kıdıında	<i>postp</i><br><ol><li>near</li></ol>
кызаңнааш|кызаңнаашты|kızañnaaş|кызаңнааштар	<i>noun</i><br><ol><li>lightning</li></ol>
кызыл|кызылдар|kızıl|кызылды	<i>adj</i><br><ol><li>red</li></ol><br><i>noun</i><br><ol><li>red (colour)</li></ol>
кызыл-сарыг|kızıl-sarıg|кызыл-сарыглар|кызыл-сарыгны	<i>adj</i><br><ol><li>orange</li></ol><br><i>noun</i><br><ol><li>orange (colour)</li></ol>
кыйгы|кыйгыларда|кыйгыларым|кыйгыларже|кыйгылардан|кыйгылардыва|кыйгым|кыйгыларны|кыйгыже|кыйгымдан|кыйгыларымда|кыйгылар|кыйгыларымның|кыйгымдыва|кыйгымда|kıygı|кыйгыда|кыйгыларымдан|кыйгыларымны|кыйгыдыва|кыйгыларымже|кыйгымга|кыйгыга|кыйгыларымдыва|кыйгымны|кыйгының|кыйгымның|кыйгыдан|кыйгыларымга|кыйгымже|кыйгыны|кыйгыларның|кыйгыларга	<i>noun</i><br><ol><li>yell, scream</li><li>call</li></ol>
кыйгырар|kıygırar|кыйгырбас|кыйгырган	<i>verb</i><br><ol><li>(intransitive) to yell, scream</li><li>(transitive) to call</li></ol>
кылыр|кылбас|кылган|kılır	<i>verb</i><br><ol><li>to do, make</li></ol>
кым|kım	<i>pron</i><br><ol><li>(interrogative) who</li></ol>
кымыскаяк|kımıskayak|кымыскаяктар|кымыскаякты	<i>noun</i><br><ol><li>ant</li></ol>
кыр|kır|кырлар|кырны	<i>noun</i><br><ol><li>mountain range</li></ol><br><i>postp</i><br><ol><li>above</li></ol>
кырган|кырганымны|кырганнарымдан|кырганнарымның|кырганнарга|кырганда|кырганымже|кырганнарже|кырганнар|кырганнардан|кырганнарымдыва|кырганым|кырганымдыва|кырганга|кырганнарны|кырганнардыва|кырганнарымда|кырганнарымны|кырганның|kırgan|кырганымда|кыргандан|кырганнарымже|кырганымның|кырганнарымга|кырганнарның|кырганны|кырганнарда|кырганымга|кырганже|кырганнарым|кыргандыва|кырганымдан	<i>adj</i><br><ol><li>(of a person) old, elderly</li></ol><br><i>noun</i><br><ol><li>elderly person</li><li>grandparent</li></ol>
кыргыс|кыргысымның|кыргыстарымның|кыргыстан|кыргыстыва|кыргыстарымже|кыргысче|кыргысымда|кыргыстарымда|кыргыстарымга|кыргыска|кыргыстарымдан|кыргыстар|кыргысты|кыргысымны|кыргыстарымны|кыргыстың|кыргыстардыва|кыргыстарда|кыргысым|кыргысымдан|кыргыстардан|кыргысымга|кыргыстарны|кыргысымдыва|кыргыстарым|кыргыстарга|кыргыста|кыргысымже|кыргыстарымдыва|кыргыстарже|kırgıs|кыргыстарның	<i>noun</i><br><ol><li>Yenisei Kirghiz</li></ol>
кыры|кырылар|kırı|кырыны	<i>noun</i><br><ol><li>ulna (elbow bone)</li></ol>
кыс|кыстар|кысты|kıs	<i>noun</i><br><ol><li>girl, lass</li><li>daughter</li></ol><br><i>adj</i><br><ol><li>female</li></ol>
кыска|kıska	<i>adj</i><br><ol><li>short</li></ol>
кыш|кышты|кыштар|kış	<i>noun</i><br><ol><li>winter</li></ol>
күдээ|күдээни|күдээлер|küdee	<i>noun</i><br><ol><li>son-in-law</li></ol>
күс|күстер|küs|күстү	<i>noun</i><br><ol><li>autumn, fall</li></ol>
көвей|kövey	<i>adj</i><br><ol><li>many, a lot</li></ol>
көвүрүг|kövürüg|көвүрүгнү|көвүрүглер	<i>noun</i><br><ol><li>bridge</li></ol>
көдээ суур|ködee suur	<i>noun</i><br><ol><li>village</li></ol>
көже|көжени|köje|көжелер	<i>noun</i><br><ol><li>barley</li></ol>
көзенек|көзенекти|közenek|көзенектер	<i>noun</i><br><ol><li>window</li></ol>
көрүнчүк|көрүнчүктер|körünçük|көрүнчүктү	<i>noun</i><br><ol><li>mirror</li></ol>
көөр|köör	<i>verb</i><br><ol><li>(transitive) to see</li><li>(auxiliary, + -п) Used to soften a request; please</li></ol>
лампа|лампалар|лампаны|lampa	<i>noun</i><br><ol><li>lamp</li></ol>
ланчыы|lançıı|ланчыылар|ланчыыны	<i>noun</i><br><ol><li>rifle</li></ol>
маадыр|maadır	<i>noun</i><br><ol><li>hero, champion</li></ol>
магалыг|magalıg	<i>adj</i><br><ol><li>fantastic, great</li></ol>
май|майлар|майны|may	<i>noun</i><br><ol><li>May</li></ol>
мал|mal|малды|малдар	<i>noun</i><br><ol><li>cattle, livestock</li></ol>
манаар|манады|маназыңарза|манавазыннар|маназын|манавазывысса|манавайн|маналыңар|манавадыңар|манай|манавадыр|манавадылар|манавазымза|маназыңза|манажай|манаан|манавады|манагай|манаваан|маназылар|манаваза|манааш|маназымза|манаңар|манавадым|манавазыңарза|манавазылар|манадыңар|манадыр|манавалыңар|маназыннар|манавадың|манава|манаваңар|манап|мана|манавас|манавазын|манадың|маназа|манавагай|манадым|manaar|маназывысса|манавазыңза|манадывыс|манадылар|манавадывыс|манайн	<i>verb</i><br><ol><li>(intransitive) to wait, await</li></ol>
манчы|манчылар|mançı|манчыны	<i>noun</i><br><ol><li>dumpling</li></ol>
маңнаар|mañnaar	<i>verb</i><br><ol><li>to run</li></ol>
медерел|медерелимде|медерелдеримде|медерелимден|медерелимдиве|медерелдеримже|медерелдеримге|медерелдерден|медерелдерже|медерелдеримниң|медерелдерни|медерелдерде|медерелимни|медерелден|медерелдердиве|медерелдерим|медерелимниң|медерелди|медерелдеримни|медерелимге|медерелдеримден|медерелдиве|медерелже|медерелдер|медерелде|медерелдеримдиве|медерелим|медерелдерниң|медерелдерге|медерелимже|mederel|медерелдиң|медерелге	<i>noun</i><br><ol><li>consciousness</li></ol>
медээ|medee|медээни|медээлер	<i>noun</i><br><ol><li>information</li><li>news (programme)</li></ol>
медээлээр|medeeleer|медээлээн|медээлевес	<i>verb</i><br><ol><li>(transitive) to inform, notify</li></ol>
мен|men|mende|meeñ|meni|менде|мени|мээң	<i>pron</i><br><ol><li>I (first-person singular subject pronoun)</li></ol><br><i>particle</i><br><ol><li>Forms the first-person singular predicative when used in conjunction with nouns, adjectives, and certain verb tenses, including the present-future and indefinite past.</li></ol>
мергежиир|mergejiir	<i>verb</i><br><ol><li>to practice</li></ol>
моол|mool|моолду|моолдар	<i>noun</i><br><ol><li>Mongol (person)</li><li>(attributive) Mongol, Mongolian</li></ol>
моортай|моортайны|moortay|моортайлар	<i>noun</i><br><ol><li>cat</li></ol>
моюн|моюнну|moyun|моюннар	<i>noun</i><br><ol><li>neck (body part)</li></ol>
мурнуку|murnuku	<i>adj</i><br><ol><li>advanced</li><li>earlier, former, predecessing</li><li>front-like</li></ol>
мыйыс|мыйысты|mıyıs|мыйыстар	<i>noun</i><br><ol><li>horn</li></ol>
мындыг|mındıg	<i>adj</i><br><ol><li>(demonstrative) like this, this kind of</li></ol><br><i>adv</i><br><ol><li>(demonstrative) thus, in this way</li></ol>
мээ|мээлер|мээни|mee	<i>noun</i><br><ol><li>brain</li></ol>
мээрең|мээреңнер|мээреңни|meereñ	<i>noun</i><br><ol><li>(historical) meiren (adjutant during the Qing Dynasty)</li></ol>
мээрең-чаңгы|meereñ-çañgı|мээрең-чаңгылар|мээрең-чаңгыны	<i>noun</i><br><ol><li>One of the Qing official ranks</li></ol>
мээң адым|meeñ adım	<i>phrase</i><br><ol><li>my name is</li></ol>
мээңии|meeñii	<i>pron</i><br><ol><li>(possessive) mine</li></ol>
мөңге|möñge	<i>adj</i><br><ol><li>eternal, everlasting, perpetual</li></ol>
мөңгүн|мөңгүннер|möñgün|мөңгүннү	<i>noun</i><br><ol><li>silver (metal)</li></ol><br><i>adj</i><br><ol><li>silver</li></ol>
назы|назым|назыларның|назылардан|назыдыва|назыларже|назыны|nazı|назыларымның|назымның|назымда|назыларымны|назымдыва|назыга|назыларда|назылар|назымже|назылардыва|назыларымдан|назыларым|назыларымдыва|назымдан|назыда|назыларымже|назыларга|назыларымда|назыларны|назымны|назыдан|назымга|назыларымга|назыже|назының	<i>noun</i><br><ol><li>age (of a person)</li></ol>
назылаар|nazılaar|назылавас|назылаан	<i>verb</i><br><ol><li>to age, get old</li></ol>
найырал|найыралды|nayıral|найыралдар	<i>noun</i><br><ol><li>friendship</li></ol>
неделя|nedelya|неделялар|неделяны	<i>noun</i><br><ol><li>week</li></ol>
ногаан|ногаанны|nogaan|ногааннар	<i>adj</i><br><ol><li>green</li></ol><br><i>noun</i><br><ol><li>green (colour)</li></ol>
ном|номумну|номже|номнардува|номнарымдува|номнарымда|номга|номнарда|nom|номнарның|номнуң|номнарымны|номумдан|номнарже|номумдува|номнардан|номумда|номнар|номнарга|номдува|номумнуң|номум|номда|номумга|номумже|номнарны|номнарымже|номнарымдан|номну|номнарым|номнарымга|номдан|номнарымның	<i>noun</i><br><ol><li>book</li></ol>
номчуур|номчувас|номчаан|nomçuur	<i>noun</i><br><ol><li>(transitive) to read</li></ol>
ноябрь|ноябрьлар|ноябрьны|noyabrʹ	<i>noun</i><br><ol><li>November</li></ol>
овур|овурларны|овурларымның|овурумга|овурдува|овурну|овурга|овурнуң|овурумну|овурларымдува|овурларым|овурум|овурлардан|овурларымдан|овурларда|овурларның|овурлар|овурже|овурумже|овурумда|овурларымны|овурлардува|овурдан|овурларже|овурларымже|овурумдува|овурумнуң|овурумдан|ovur|овурларымда|овурларга|овурда|овурларымга	<i>noun</i><br><ol><li>appearance, look</li><li>form, shape</li></ol>
овур-хевир|овур-хевирлеримде|овур-хевирлерге|овур-хевирлердиве|овур-хевирлеримни|овур-хевирге|овур-хевирлерде|овур-хевиримге|ovur-xevir|овур-хевирден|овур-хевиримде|овур-хевирлерже|овур-хевирлеримге|овур-хевирлеримден|овур-хевирлерим|овур-хевиримни|овур-хевирим|овур-хевирлеримниң|овур-хевирлер|овур-хевирлерниң|овур-хевирни|овур-хевирже|овур-хевиримден|овур-хевирлеримдиве|овур-хевиримдиве|овур-хевирниң|овур-хевиримже|овур-хевирлерден|овур-хевиримниң|овур-хевирлерни|овур-хевирде|овур-хевирдиве|овур-хевирлеримже	<i>noun</i><br><ol><li>image, form</li></ol>
оглу|oglu	<i>noun</i><br><ol><li>third-person singular possessed nominative of оол (ool)</li></ol>
ойнаар|ойнаан|ойнавас|oynaar	<i>verb</i><br><ol><li>(transitive) to play (a game, a sport, an instrument, etc.)</li></ol>
ойнап|oynap	<i>verb</i><br><ol><li>modal converb of ойна- (oyna-, “to play”, affirmative stem)</li></ol>
октаар|октаан|oktaar|октавас	<i>verb</i><br><ol><li>(transitive) to throw, toss</li><li>(transitive) to load a bullet</li></ol>
октябрь|октябрьны|oktyabrʹ|октябрьлар	<i>noun</i><br><ol><li>October</li></ol>
ол|ында|onu|ında|ону|ol	<i>pron</i><br><ol><li>he, she, it (third-person singular subject pronoun)</li><li>(demonstrative) that, this</li></ol>
олар|оларны|оларның|оларда|olarnı|olarnıñ|olarda|olar	<i>pron</i><br><ol><li>they (third-person plural personal pronoun)</li><li>(demonstrative) those</li></ol>
олурар|olurar|олурган|олурбас|olur|олур	<i>verb</i><br><ol><li>to sit</li><li>(auxiliary, + -п) Used to form the habitual aspect for certain verbs, namely when the subject is sat down or otherwise stationary.</li><li>(auxiliary, олур + -п) Used to form the progressive tense for certain verbs, namely when the subject is sat down or otherwise stationary.</li></ol>
омааш|омааштар|omaaş|омаашты	<i>noun</i><br><ol><li>spoon</li></ol>
он|on	<i>num</i><br><ol><li>ten</li></ol>
онгу|ongu|10-гу	<i>adj</i><br><ol><li>tenth</li></ol>
онза|onza	<i>adj</i><br><ol><li>particular, special</li></ol><br><i>adv</i><br><ol><li>particularly, in particular</li></ol>
оожум|oožum	<i>adj</i><br><ol><li>slow</li></ol>
оол|оолдар|оолду|ool	<i>noun</i><br><ol><li>son</li></ol>
оор|оорлар|oor|оорну	<i>noun</i><br><ol><li>thief, burglar</li></ol>
оорга|ооргаларымны|ооргага|ооргаларда|ооргалардан|oorga|ооргаларга|ооргаларым|ооргаларны|ооргаже|ооргалардыва|ооргаларымдыва|ооргамдан|ооргамны|оорганы|ооргамже|ооргаларның|ооргаларымның|ооргамдыва|ооргамда|ооргамга|ооргаларже|оорганың|ооргамның|ооргаларымга|ооргада|ооргаларымда|ооргалар|ооргадыва|ооргам|ооргадан|ооргаларымже|ооргаларымдан	<i>noun</i><br><ol><li>(anatomy) back, spine</li></ol>
ооңуу|ooñuu	<i>pron</i><br><ol><li>(possessive) his, hers, its</li></ol>
орай|oray	<i>adv</i><br><ol><li>late</li></ol>
оран|oran|ораннарның|ораннарда|орандыва|оранның|ораннарымдан|оранны|оранымны|ораннарымда|ораннарымга|ораннарымже|оранда|ораннарымны|оранга|оранымдан|ораннарны|оранымдыва|ораным|ораннарымдыва|ораннар|оранымның|оранымга|ораннарымның|оранымже|ораннарым|орандан|оранымда|ораннарже|ораннардыва|ораннардан|ораннарга|оранже	<i>noun</i><br><ol><li>country, region, territory</li></ol>
орта|orta	<i>adj</i><br><ol><li>proper</li></ol><br><i>conj</i><br><ol><li>(conditional) as soon as</li></ol><br><i>adv</i><br><ol><li>(spatial) there, in that place</li><li>(temporal) then, at that time</li></ol>
орту|ортуну|ортулар|ortu	<i>noun</i><br><ol><li>middle, center</li></ol>
ортулук|ортулуктар|ortuluk|ортулукту	<i>noun</i><br><ol><li>island</li></ol>
орук|оруктар|орукту|oruk	<i>noun</i><br><ol><li>road</li></ol>
от|ot|отту|оттар	<i>noun</i><br><ol><li>fire</li></ol>
оттур|одуннун|одуннувусса|одунмаан|одунмадыр|одунган|одунайн|одуннуңарза|одунмагай|одуннулар|одуннуң|одуннум|одунап|одунна|одунмазылар|одунмаза|одуннур|одуна|одунмас|одунмадувус|одунмадум|одунулыңар|одун|одуннувус|одунгай|одунмадулар|одунма|одунмазывусса|одунмаңар|ottur|одуннуңза|одунгаш|одунмадуңар|одуннуннар|одунмазын|одунжай|одуннумза|одунмазыннар|одунмазыңарза|одунмазымза|одунмаду|одунмалыңар|одуннуңар|одунмайн|одунну|одунмадуң|одунуңар|одунмазыңза	<i>verb</i><br><ol><li>(intransitive) to wake up</li></ol>
оът|оъттар|òt|оътту	<i>noun</i><br><ol><li>grass</li></ol>
оюн|оюннар|оюнну|oyun	<i>noun</i><br><ol><li>game</li></ol>
оң|oñ	<i>adj</i><br><ol><li>right (opposite of left)</li></ol>
пага|паганы|paga|пагалар	<i>noun</i><br><ol><li>frog</li></ol>
пага төлү|пага төлүн|пага төлүлер|paga tölü	<i>noun</i><br><ol><li>tadpole</li></ol>
партия|партиям|партияларымдан|партияга|партиямның|партияларым|партиядан|партиямны|partiya|партияларымже|партиямда|партияларымга|партиялар|партияларымда|партиялардан|партияларда|партияларымның|партиялардыва|партияның|партиямдыва|партиямга|партияже|партиядыва|партияда|партияларымдыва|партияларже|партияларымны|партияларны|партиямдан|партиямже|партияны|партияларның|партияларга	<i>noun</i><br><ol><li>(politics) party</li></ol>
президент|prezidentiden|президентини|prezidentiler|президентилер|prezident|президентиден	<i>noun</i><br><ol><li>a president (of a state or an organisation)</li></ol>
саар|saar	<i>verb</i><br><ol><li>to milk</li></ol>
сааскан|саасканны|саасканнар|saaskan	<i>noun</i><br><ol><li>magpie (bird)</li></ol>
сагыш|сагыштарга|сагышымны|сагыштарда|сагыштар|сагыштарже|сагыштарым|сагыштарны|сагыштың|сагышка|сагыштарымдыва|сагыштарымже|сагыштарымда|сагыштарымны|sagış|сагышымдан|сагышым|сагышта|сагышымже|сагышымның|сагыштарның|сагыштарымның|сагышче|сагышымдыва|сагыштардыва|сагышты|сагыштарымдан|сагыштан|сагышымга|сагыштарымга|сагышымда|сагыштыва|сагыштардан	<i>noun</i><br><ol><li>memory, remembrance</li><li>thought</li></ol>
садар|сатпас|саткан|sadar	<i>verb</i><br><ol><li>to sell</li><li>to deal, to trade</li><li>(chess) to exchange</li></ol>
садыг|sadıg|садыгны|садыглар	<i>noun</i><br><ol><li>commerce</li><li>shop, store</li></ol>
сактыр|сагынмас|saktır|сагынган	<i>noun</i><br><ol><li>(transitive) to remember, recall</li><li>(transitive) to think about</li><li>(transitive) to miss</li></ol>
сал|салдар|салды|sal	<i>noun</i><br><ol><li>beard</li><li>moustache</li></ol>
салаа|салаалар|salaa|салааны	<i>noun</i><br><ol><li>finger</li></ol>
салгын|салгыннар|salgın|салгынны	<i>noun</i><br><ol><li>wind</li></ol>
сарай|saray	<i>noun</i><br><ol><li>barn</li></ol>
саргы|sargı|саргылар|саргыны	<i>noun</i><br><ol><li>tick</li></ol>
сарлык|сарлыктар|сарлыкты|sarlık	<i>noun</i><br><ol><li>yak</li></ol>
сарыг|сарыгны|sarıg|сарыглар	<i>noun</i><br><ol><li>yellow</li></ol>
сарыг-ногаан|сарыг-ногаанны|sarıg-nogaan|сарыг-ногааннар	<i>adj</i><br><ol><li>light green, lime</li></ol><br><i>noun</i><br><ol><li>light green, lime (colour)</li></ol>
саттынар|sattınar	<i>verb</i><br><ol><li>to sell</li></ol>
сегел|segel|сегелди|сегелдер	<i>noun</i><br><ol><li>chin</li></ol>
сегел сал|segel sal|сегел салдар|сегел салды	<i>noun</i><br><ol><li>beard</li></ol>
сезен|sezen	<i>num</i><br><ol><li>eighty</li></ol>
селеске|селескелер|селескени|seleske	<i>noun</i><br><ol><li>lizard</li></ol>
сен|сени|sende|sen|сенде|seni	<i>pron</i><br><ol><li>you (singular)</li></ol>
сес|ses	<i>num</i><br><ol><li>eight</li></ol>
сески|seski|8-ки	<i>adj</i><br><ol><li>eighth</li></ol>
силер|siler|силерниң|silerniñ	<i>pron</i><br><ol><li>you (plural or formal)</li></ol>
согар|sogar|сокпас|соккан	<i>verb</i><br><ol><li>(transitive) to beat, hit, strike</li></ol>
согун|согунну|sogun|согуннар	<i>noun</i><br><ol><li>arrow (projectile fired from a bow)</li></ol>
согуна|soguna|согунаны|согуналар	<i>noun</i><br><ol><li>onion</li></ol>
солаңгы|solañgı|солаңгыны|солаңгылар	<i>noun</i><br><ol><li>sunrise</li><li>rainbow</li><li>weasel (animal)</li></ol>
солун|солунну|solun|солуннар	<i>adj</i><br><ol><li>interesting, exciting</li></ol><br><i>noun</i><br><ol><li>newspaper, journal</li></ol>
сонуургаар|sonuurgaar|сонуургаан|сонуургавас	<i>verb</i><br><ol><li>(transitive) to be interested in</li></ol>
сонуургал|sonuurgal|сонуургалдар|сонуургалды	<i>noun</i><br><ol><li>interest, concern</li></ol>
соок|sook	<i>adj</i><br><ol><li>cold</li></ol>
соонда|soonda	<i>postp</i><br><ol><li>after, later</li></ol>
сорар|сорган|sorar|сорбас	<i>verb</i><br><ol><li>to suck</li></ol>
сояр|soyar	<i>verb</i><br><ol><li>to strip</li></ol>
соң|соңнар|soñ|соңну	<i>noun</i><br><ol><li>end</li></ol>
суг|sug|сугну|суглар	<i>noun</i><br><ol><li>water</li></ol>
сылдыс|sıldıs|сылдыстар|сылдысты	<i>noun</i><br><ol><li>(astronomy) star</li></ol>
сып|сыптар|сыпты|sıp	<i>noun</i><br><ol><li>handle</li></ol>
сээңии|seeñii	<i>pron</i><br><ol><li>(possessive, in the singular) yours</li></ol>
сүме|сүмемге|сүмемдиве|сүмеже|сүмелеримниң|сүмелеримни|сүмемни|сүмеге|сүмеде|сүмелеримже|сүмени|сүмелерде|сүмемде|сүмедиве|сүмеден|сүмелеримде|сүмемниң|сүмелеримдиве|сүмелерден|сүмелерниң|сүмелеримден|сүмемден|сүмелердиве|süme|сүмелерге|сүмелер|сүмелерже|сүмелерим|сүмелерни|сүмемже|сүмелеримге|сүмениң|сүмем	<i>noun</i><br><ol><li>advice, counsel</li></ol>
сүмелээр|сүмелевес|sümeleer|сүмелээн	<i>verb</i><br><ol><li>to advise, counsel</li></ol>
сүнезин|сүнезинимден|сүнезиннерже|сүнезинимни|сүнезинни|сүнезинимде|сүнезиннерниң|сүнезиннеримже|сүнезиннеримге|сүнезиннерге|сүнезинден|сүнезинге|сүнезиндиве|сүнезинимдиве|сүнезиннеримниң|сүнезинде|сүнезинимге|сүнезинимже|сүнезиннерден|сүнезинниң|сүнезиннеримде|сүнезиннерде|sünezin|сүнезиннеримдиве|сүнезиним|сүнезинже|сүнезинимниң|сүнезиннер|сүнезиннерим|сүнезиннеримден|сүнезиннерни|сүнезиннеримни|сүнезиннердиве	<i>noun</i><br><ol><li>soul (essence of a being)</li></ol>
сүт|сүттү|süt	<i>noun</i><br><ol><li>milk</li></ol>
сөглээр|sögleer|сөглевес|сөглээн	<i>verb</i><br><ol><li>(transitive) to say, speak</li></ol>
сөс|сөстү|сөстер|sös	<i>noun</i><br><ol><li>word, speech</li></ol>
сөстүк|söstük|сөстүктер|сөстүктү	<i>noun</i><br><ol><li>dictionary</li></ol>
сөөк|söök|сөөктү|сөөктер	<i>noun</i><br><ol><li>bone</li></ol>
тайбың|тайбыңнар|taybıñ|тайбыңны	<i>noun</i><br><ol><li>peace</li></ol>
такпы|takpı|такпыны|такпылар	<i>noun</i><br><ol><li>tobacco</li></ol>
такпылаар|такпылаан|такпылавас|takpılaar	<i>verb</i><br><ol><li>to smoke</li></ol>
таныжар|tanıjar|танышпас|танышкан	<i>noun</i><br><ol><li>(intransitive, + -биле) to be acquainted with, meet</li></ol>
таныштырар|таныштырбас|tanıştırar|таныштырган	<i>noun</i><br><ol><li>(transitive) to introduce, to cause to meet</li></ol>
таныыр|танаан|tanıır|танывас	<i>verb</i><br><ol><li>(transitive) to know, recognise</li></ol>
таптыг|taptıg	<i>adj</i><br><ol><li>delicious, tasty</li><li>charming</li><li>proper, correct</li></ol>
тар|tar	<i>adj</i><br><ol><li>narrow</li></ol>
тараачын|тараачынны|тараачыннар|taraaçın	<i>noun</i><br><ol><li>farmer, peasant, tiller</li></ol>
тарыыр мен|tarıır men	<i>verb</i><br><ol><li>first-person singular present-future of тарыыр (tarıır)</li></ol>
теве|тевени|teve|тевелер	<i>noun</i><br><ol><li>camel</li></ol>
тей|tey	<i>noun</i><br><ol><li>hill</li></ol>
телег|телеглер|teleg|телегни	<i>noun</i><br><ol><li>a Telengit, an Altaian, or a Teleut (person)</li></ol>
тик|tik	<i>num</i><br><ol><li>zero</li></ol>
тикки|tikki	<i>adj</i><br><ol><li>zeroth</li></ol>
тодар|тот|тотпас|tot|тоткан|todar	<i>verb</i><br><ol><li>(intransitive) to be satisfied</li></ol>
тодар мен|todar men	<i>verb</i><br><ol><li>first-person singular present-future of тодар (todar)</li></ol>
тозан|tozan	<i>num</i><br><ol><li>ninety</li></ol>
тос|tos	<i>num</i><br><ol><li>nine</li></ol>
тоску|9-ку|tosku	<i>adj</i><br><ol><li>ninth</li></ol>
тудар|тутпас|tudar|туткан	<i>verb</i><br><ol><li>(transitive) to hold, grasp</li><li>(transitive) to build, construct</li></ol>
тур|tur	<i>verb</i><br><ol><li>third-person present punctual auxiliary of турар</li></ol>
турар|tur|тур|turar	<i>verb</i><br><ol><li>to stand, get up</li><li>(auxiliary, + -п) Used to form the habitual aspect for most verbs, including when the subject's physical position is unimportant or unknown.</li><li>(auxiliary, тур + -п) Used to form the progressive tense for most verbs, including when the subject's physical position is unimportant or unknown.</li></ol>
тыва|тываларымда|тываларымже|тываларның|тываларымдан|тывада|тывалардыва|tıva|тываны|тывалар|тываларымны|тываның|тываларымга|тываларда|тывадан|тываларже|тывага|тываже|тываларны|тывамда|тывамның|тывам|тывамже|тывадыва|тывамга|тываларым|тываларымдыва|тываларымның|тываларга|тывалардан|тывамдан|тывамдыва|тывамны	<i>noun</i><br><ol><li>Tuvan (person)</li><li>(attributive) Tuvan</li></ol>
тыва дыл|tıva dıl|тыва дылды	<i>noun</i><br><ol><li>Tuvan, Tuvan language</li></ol>
тывалаар|tıvala|тывала|тывалаан|тывалавас|tıvalaar	<i>verb</i><br><ol><li>to speak in Tuvan</li></ol>
тывалаар мен|tıvalaar men	<i>verb</i><br><ol><li>first-person singular present-future of тывалаар (tıvalaar)</li></ol>
тывалап билбес мен|tıvalap bilbes men	<i>phrase</i><br><ol><li>I don't speak Tuvan</li></ol>
тывар|tıvar	<i>verb</i><br><ol><li>(transitive) to find, discover, guess</li></ol>
тын|тынны|tın|тыннар	<i>noun</i><br><ol><li>life</li><li>spirit, soul</li></ol>
тынар|тынган|tınar|тынмас	<i>verb</i><br><ol><li>(intransitive) to breathe</li></ol>
тырыкы|тырыкыже|тырыкымны|тырыкыларны|тырыкылар|tırıkı|тырыкыда|тырыкыларда|тырыкыларымдыва|тырыкымның|тырыкыларым|тырыкым|тырыкыларымда|тырыкыдан|тырыкыларга|тырыкымга|тырыкының|тырыкылардан|тырыкыны|тырыкыларже|тырыкыларымже|тырыкымдан|тырыкылардыва|тырыкыга|тырыкыдыва|тырыкыларымдан|тырыкымдыва|тырыкымда|тырыкыларымга|тырыкыларның|тырыкымже|тырыкыларымның|тырыкыларымны	<i>adj</i><br><ol><li>circular, round</li></ol><br><i>noun</i><br><ol><li>circle</li></ol>
төндүрер|töndürer|төндүрген|төндүрбес	<i>verb</i><br><ol><li>(transitive) to end, put to an end</li></ol>
төнер|төнген|төнмес|töner	<i>verb</i><br><ol><li>(intransitive) to end, conclude</li></ol>
төнчү|төнчүде|төнчүмдүве|төнчүмге|төнчүлеримдүве|төнчүдүве|tönçü|төнчүмде|төнчүге|төнчүлеримни|төнчүлерим|төнчүмнүң|төнчүлеримде|төнчүлеримже|төнчүлер|төнчүлерден|төнчүлерниң|төнчүже|төнчүлердүве|төнчүнү|төнчүлерни|төнчүлерже|төнчүлеримге|төнчүлерде|төнчүлеримден|төнчүмнү|төнчүмже|төнчүден|төнчүмден|төнчүлеримниң|төнчүлерге|төнчүнүң|төнчүм	<i>noun</i><br><ol><li>end, conclusion</li></ol>
төрүттүнген хүнү|törüttüngen xünü|төрүттүнген хүнүлер|төрүттүнген хүнүн	<i>noun</i><br><ol><li>birthday, anniversary</li></ol>
төөгү|töögü|төөгүлер|төөгүнү	<i>noun</i><br><ol><li>history</li></ol>
уг|угну|углар|угларымга|угумдан|угумда|угларым|угдан|угумга|угже|угларымда|угларны|угларже|угдува|углардан|угларымдува|углардува|угум|угларның|угнуң|угларымдан|угумну|угларга|угларымны|угумдува|угларымже|угда|угларда|угга|угларымның|угумже|угумнуң|ug	<i>noun</i><br><ol><li>direction</li></ol>
угаан|угааннар|угаанда|угаанже|угааннарым|угаанымда|угаанга|угаандан|угааннарны|угаанны|угаанымдыва|угааным|угааннардан|угааннарымдыва|угааннардыва|угааннарже|угаанның|угаанымның|угаанымны|угааннарымда|угааннарымны|угаанымже|угааннарга|угааннарның|угааннарымже|ugaan|угааннарда|угаанымдан|угааннарымның|угааннарымга|угаандыва|угааннарымдан|угаанымга	<i>noun</i><br><ol><li>mind, intellect</li></ol>
угаанныг|ugaannıg	<i>adj</i><br><ol><li>intelligent, smart</li></ol>
угаар|ugaar|угааган|угаавас	<i>verb</i><br><ol><li>to understand, comprehend</li></ol>
угба|ugba|угбамже|угбаларда|угбадыва|угбаларже|угбаже|угбамга|угбаларымны|угбаларымдан|угбалар|угбамның|угбаны|угбамдан|угбалардан|угбаларымның|угбалардыва|угбаларым|угбаның|угбаларымже|угбаларга|угбаларымга|угбам|угбамда|угбада|угбадан|угбамны|угбаларның|угбаларымда|угбага|угбаларымдыва|угбамдыва|угбаларны	<i>noun</i><br><ol><li>elder sister</li></ol>
удуп|udup	<i>verb</i><br><ol><li>modal converb of уду- (udu-, “to sleep”, affirmative stem)</li></ol>
удуур|uduur|удаан|удувас	<i>verb</i><br><ol><li>(intransitive) to sleep</li></ol>
ужар|ушпас|ujar|ушкан	<i>verb</i><br><ol><li>(intransitive) to fly</li><li>(intransitive) to fall</li></ol>
ужурашкыже|ujuraşkıje	<i>intj</i><br><ol><li>see you later, farewell</li></ol>
узун|uzun	<i>adj</i><br><ol><li>long</li></ol>
узун чыда|узун чыданы|uzun çıda|узун чыдалар	<i>noun</i><br><ol><li>spear</li></ol>
уйгу|уйгудан|уйгуларның|уйгуларымда|уйгулардува|уйгуларга|уйгумну|уйгумже|уйгунуң|уйгудува|уйгуларымдан|уйгуларда|уйгуларымның|uygu|уйгум|уйгумга|уйгуларже|уйгуну|уйгуга|уйгуларымже|уйгуже|уйгумдан|уйгумнуң|уйгуларымны|уйгумдува|уйгулар|уйгумда|уйгулардан|уйгуларымга|уйгуларны|уйгуларымдува|уйгуларым|уйгуда	<i>noun</i><br><ol><li>sleep, rest</li></ol>
улуг|ulug	<i>adj</i><br><ol><li>big, large</li></ol>
улуг өөрдүм|ulug öördüm	<i>intj</i><br><ol><li>thank you</li></ol>
улус|ulus|улусту|улустар	<i>noun</i><br><ol><li>people (group of individuals)</li></ol>
уруг|уругларымдува|уругда|уругларымже|уругларымда|уругумга|уругларны|уругларже|urug|уругларым|уругну|уругум|уругумдува|уругумдан|уругдува|уругларымны|уругумнуң|уругже|уруглардан|уругларымга|уругларга|уругдан|уругумда|уругумже|uruglar|уругларда|уругларның|уругнуң|уругларымның|уругга|уругларымдан|уруглар|уруглардува|уругумну	<i>noun</i><br><ol><li>child</li><li>young girl, daughter</li></ol>
уттур|uttur	<i>verb</i><br><ol><li>(transitive) to forget</li></ol>
федералдыг|federaldıg	<i>adj</i><br><ol><li>federal</li></ol>
ха-дуңма|xa-duñma|ха-дуңманы	<i>noun</i><br><ol><li>Synonym of акы-дуңма (akı-duñma)</li></ol>
хаай|хаайны|xaay|хаайлар	<i>noun</i><br><ol><li>nose</li></ol>
хавак|xavak|хавактар|хавакты	<i>noun</i><br><ol><li>(anatomy) forehead</li></ol>
хавак кирбии|xavak kirbii|хавак кирбиини|хавак кирбиилер	<i>noun</i><br><ol><li>(anatomy) eyebrow</li></ol>
хаван|хаванны|хаваннар|xavan	<i>noun</i><br><ol><li>pig</li></ol>
хадың|хадыңны|хадыңнар|xadıñ	<i>noun</i><br><ol><li>birch</li></ol>
хамаан|хамааннарның|хамааннарымга|хамааннардыва|хамааннарымда|хамааннарга|хамааным|хамааннарымдан|хамаандан|хамаанымга|хамааннарымже|хамаанның|хамааннардан|хамаанга|хамаанымдан|хамааннарда|хамаанымның|хамаанымны|хамаандыва|хамааннарже|хамааннарымдыва|хамааннарымның|хамаанымже|xamaan|хамааннар|хамааннарым|хамааннарымны|хамаанже|хамаанда|хамаанымдыва|хамааннарны|хамаанны|хамаанымда	<i>noun</i><br><ol><li>relation, tie</li></ol>
хамаанчок|xamaançok	<i>adj</i><br><ol><li>unrelated</li></ol>
хамааржыр|xamaarjır|хамаарышпас|хамаарышкан	<i>verb</i><br><ol><li>to be related to</li></ol>
хамаарылга|хамаарылганы|xamaarılga|хамаарылгалар	<i>noun</i><br><ol><li>Synonym of хамаан (xamaan, “relation”)</li></ol>
хамык|xamık	<i>det</i><br><ol><li>all</li></ol>
хан|ханны|xan|ханнар	<i>noun</i><br><ol><li>blood</li></ol>
хар|харлар|xar|харны	<i>noun</i><br><ol><li>snow</li><li>age (of someone)</li></ol>
хартыга|xartıga	<i>noun</i><br><ol><li>hawk</li></ol>
харын|xarın	<i>conj</i><br><ol><li>but, however</li></ol>
харыы|харыыларны|харыыга|харыымның|харыыларымдыва|харыыларымда|харыыларымны|харыыларымга|харыыны|харыымже|харыыларның|харыыларым|харыымда|харыымдан|харыым|харыының|харыымга|харыылардыва|харыыларда|харыымны|харыыларымның|харыыларга|харыыже|харыыда|xarıı|харыылардан|харыыдыва|харыыларымже|харыыдан|харыыларже|харыыларымдан|харыылар|харыымдыва	<i>noun</i><br><ol><li>answer, response</li></ol>
харыылаар|харыылаан|xarıılaar|харылавас	<i>verb</i><br><ol><li>(transitive) to answer, respond</li></ol>
хат|xat|хатты|хаттар	<i>noun</i><br><ol><li>wind</li></ol>
хевир|хевирлеримге|хевирим|хевирниң|хевирлер|хевирже|хевиримниң|хевирни|хевирлеримни|хевирлерге|хевиримде|xevir|хевирден|хевирлерже|хевиримни|хевирлеримдиве|хевирлеримже|хевиримден|хевиримдиве|хевирде|хевирлеримде|хевиримге|хевирлеримден|хевирлерни|хевирлерден|хевирдиве|хевирге|хевирлерим|хевирлерде|хевирлеримниң|хевиримже|хевирлердиве|хевирлерниң	<i>noun</i><br><ol><li>shape, form</li></ol>
хем|xem|хемни|хемнер	<i>noun</i><br><ol><li>river</li></ol>
хеме|хемени|хемелер|xeme	<i>noun</i><br><ol><li>boat</li></ol>
хеп|хепимге|хепте|хепимден|хептеримже|хептеримден|хепим|хептерге|хептерниң|хептиң|хептиве|хептеримде|хептеримге|хепимде|хептерим|хептеримниң|хептеримни|хепке|хептер|хептерни|xep|хептерден|хепти|хептерже|хепимже|хепимни|хепимдиве|хептеримдиве|хепче|хепимниң|хептердиве|хептен|хептерде	<i>noun</i><br><ol><li>clothes, garment</li></ol>
херечи|xereçi|херечилерниң|херечилерже|херечимде|херечини|херечимдиве|херечиниң|херечилеримде|херечиже|херечилеримни|херечилердиве|херечимни|херечилерден|херечилеримдиве|херечимниң|херечилеримже|херечим|херечимге|херечиден|херечилер|херечилерге|херечилерим|херечилеримден|херечиде|херечимже|херечилеримге|херечилерни|херечилеримниң|херечидиве|херечилерде|херечиге|херечимден	<i>noun</i><br><ol><li>witness, onlooker</li></ol>
херечилээр|xereçileer|херечилээн|херечилевес	<i>verb</i><br><ol><li>(transitive) to witness, see</li></ol>
херээжен|xereejen|херээженнер|херээженни	<i>noun</i><br><ol><li>woman</li></ol>
хирлиг|xirlig	<i>adj</i><br><ol><li>dirty, unclean</li></ol>
ховаган|xovagan|ховаганнар|ховаганны	<i>noun</i><br><ol><li>butterfly</li></ol>
ховар|xovar	<i>adj</i><br><ol><li>rare</li></ol>
хой|xoy|хойлар|хойну	<i>noun</i><br><ol><li>sheep</li></ol>
хол|холдар|холду|xol	<i>noun</i><br><ol><li>hand</li></ol>
хомус|хомустар|хомусту|xomus	<i>noun</i><br><ol><li>short for демир-хомус (demir-xomus, “Tuvan national mouth harp”)</li></ol>
хонук|хонукту|хонуктар|xonuk	<i>noun</i><br><ol><li>day (period of 24 hours)</li></ol>
хоорай|хоорайлар|хоорайны|xooray	<i>noun</i><br><ol><li>town, city</li></ol>
хорадаар|xoradaar|хорадаан|хорадавас	<i>verb</i><br><ol><li>(intransitive) to be angry, rage</li></ol>
хүл|xül	<i>noun</i><br><ol><li>ash</li></ol>
хүлээдир|хүлээткен|хүлээтпес|xüleedir	<i>verb</i><br><ol><li>(transitive) to deliver, give</li><li>(transitive) to make take responsibility</li></ol>
хүлээкчи|xüleekçi|хүлээкчилер|хүлээкчини	<i>noun</i><br><ol><li>recipient (someone who receives something)</li></ol>
хүлээлге|хүлээлгени|хүлээлгелер|xüleelge	<i>noun</i><br><ol><li>duty, responsibility</li></ol>
хүлээнир|хүлээнген|xüleenir|хүлээнмес	<i>verb</i><br><ol><li>(intransitive) to take on duty</li></ol>
хүлээр|xüleer|хүлээвес|хүлээген	<i>verb</i><br><ol><li>(transitive) to accept, receive</li><li>(transitive) to acknowledge, recognise</li><li>(transitive) to take responsibility</li></ol>
хүлүмзүрүүр|xülümzürüür	<i>verb</i><br><ol><li>to smile</li></ol>
хүн|хүннеримге|хүндүве|хүннеримни|хүнже|хүннерге|хүнден|хүннеримдүве|хүнүм|хүннүң|хүннерден|хүннерже|хүннү|хүнде|хүннерим|xün|хүннерни|хүнүмде|хүннеримде|хүннеримден|хүнүмже|хүннеримниң|хүннердүве|хүнүмдүве|хүнге|хүнүмге|хүнүмнүң|хүннеримже|хүннерниң|хүннерде|хүнүмнү|хүнүмден|хүннер	<i>noun</i><br><ol><li>sun</li><li>day (period of 24 hours)</li></ol>
хүндү|хүндүнү|хүндүлер|xündü	<i>noun</i><br><ol><li>respect, regard</li></ol>
хүннүң ажары|xünnüñ ajarı|хүннүң ажарын|хүннүң ажарлары	<i>noun</i><br><ol><li>sunrise</li></ol>
хүрең|хүреңни|xüreñ|хүреңнер	<i>adj</i><br><ol><li>brown</li></ol><br><i>noun</i><br><ol><li>brown (colour)</li></ol>
хөгжүм|хөгжүмнү|xögjüm|хөгжүмнер	<i>noun</i><br><ol><li>music</li><li>orchestra</li></ol>
хөй|xöy	<i>adj</i><br><ol><li>many, a lot of</li></ol><br><i>adv</i><br><ol><li>much, a lot</li></ol>
хөйлең|xöyleñ|хөйлеңнер|хөйлеңни	<i>noun</i><br><ol><li>shirt</li></ol>
хөл|хөлдүве|xöl|хөлдерже|хөлдеримни|хөлдердүве|хөлде|хөлүмден|хөлдүң|хөлдеримге|хөлдерден|хөлге|хөлүмде|хөлдерде|хөлдеримде|хөлүмдүве|хөлдерниң|хөлдерим|хөлдерге|хөлдерни|хөлүмге|хөлүм|хөлдеримниң|хөлдеримже|хөлдер|хөлден|хөлүмнү|хөлдү|хөлүмже|хөлүмнүң|хөлже|хөлдеримден|хөлдеримдүве	<i>noun</i><br><ol><li>lake</li></ol>
хөлеге|xölege|хөлегелер|хөлегени	<i>noun</i><br><ol><li>shadow, shade</li></ol>
хөмүр|хөмүрлер|хөмүрнү|xömür	<i>noun</i><br><ol><li>coal, charcoal</li></ol>
хөрзүн|хөрзүннеримниң|хөрзүнүмнү|хөрзүннеримден|хөрзүннерни|хөрзүннеримже|хөрзүнүмже|хөрзүндүве|хөрзүннеримдүве|хөрзүнде|хөрзүнүмден|хөрзүннерге|хөрзүнүмде|хөрзүнүмдүве|хөрзүнүмге|xörzün|хөрзүнже|хөрзүннерниң|хөрзүннерим|хөрзүннар|хөрзүннерден|хөрзүнден|хөрзүннерже|хөрзүннүң|хөрзүннеримни|хөрзүннерде|хөрзүнүмнүң|хөрзүннер|хөрзүннеримде|хөрзүннеримге|хөрзүннердүве|хөрзүннү|хөрзүнүм|хөрзүнге	<i>noun</i><br><ol><li>soil, dirt, earth</li></ol>
хөөмей|xöömey|хөөмейлер|хөөмейни	<i>noun</i><br><ol><li>khoomei (traditional Tuvan throat singing)</li></ol>
хөөмейлээр|хөөмейлевес|хөөмейлээн|xöömeyleer	<i>verb</i><br><ol><li>(intransitive) to sing in khoomei, throat sing</li></ol>
хөөн|хөөннерде|хөөнүм|хөөннерим|хөөнүмдүве|xöön|хөөннерни|хөөнүмден|хөөнүмге|хөөннеримже|хөөннер|хөөннеримниң|хөөннерниң|хөөннеримде|хөөнге|хөөннеримге|хөөннерден|хөөнүмнүң|хөөннеримден|хөөннеримни|хөөнүмже|хөөндүве|хөөнүмнү|хөөннеримдүве|хөөнден|хөөнже|хөөннү|хөөннердүве|хөөнде|хөөннүң|хөөннерже|хөөннерге|хөөнүмде	<i>noun</i><br><ol><li>harmony, tuning</li><li>(figuratively) interest, intention</li><li>(+ verb) Indicates inclination or desire to do something, especially when in negation.</li></ol>
ча|чаны|чалар|ça	<i>noun</i><br><ol><li>bow (weapon used with arrows)</li></ol>
чаа|çaa	<i>adj</i><br><ol><li>new, fresh</li></ol>
чаагай|çaagay	<i>adj</i><br><ol><li>nice, pleasant</li><li>aromatic</li><li>tasty, delicious</li><li>rich</li></ol>
чаак|çaak|чаактар|чаакты	<i>noun</i><br><ol><li>cheek</li></ol>
чаан|çaan|чаанны|чааннар	<i>noun</i><br><ol><li>elephant</li></ol>
чаг|чаглар|чагны|çag	<i>noun</i><br><ol><li>fat</li></ol>
чагаа|чагаалар|çagaa|чагааны	<i>noun</i><br><ol><li>letter</li></ol>
чадаар|чадавас|çadaar|чадаан	<i>verb</i><br><ol><li>(auxiliary, + -п) cannot</li><li>(auxiliary, in the negative) Indicates possibility or probability; perhaps, possibly, might, maybe</li></ol>
чазак|чазакты|чазактар|çazak	<i>noun</i><br><ol><li>government</li></ol>
чазыг|çazıg|чазыглар|чазыгны	<i>noun</i><br><ol><li>mistake, error</li></ol>
чай|чайлар|чайны|çay	<i>noun</i><br><ol><li>summer</li></ol>
чайгаар|çaygaar	<i>adv</i><br><ol><li>naturally, by itself</li></ol>
чайзаң|чайзаңнарга|чайзаңда|чайзаңнарымдыва|чайзаңнар|чайзаңнарымны|чайзаңымны|чайзаңже|чайзаңны|чайзаңдыва|чайзаңнарны|чайзаңымдыва|чайзаңнарда|чайзаңнардан|çayzañ|чайзаңдан|чайзаңымже|чайзаңымга|чайзаңнарның|чайзаңнарымда|чайзаңнарже|чайзаңнарымның|чайзаңнарымга|чайзаңымда|чайзаңга|чайзаңнардыва|чайзаңымдан|чайзаңның|чайзаңнарым|чайзаңнарымже|чайзаңымның|чайзаңым|чайзаңнарымдан	<i>noun</i><br><ol><li>chief (of non-Genghisid origin)</li></ol>
чалбарыыр|çalbarıır	<i>verb</i><br><ol><li>to pray</li></ol>
чалгын|çalgın|чалгынны|чалгыннар	<i>noun</i><br><ol><li>wing</li></ol>
чамдык|çamdık	<i>det</i><br><ol><li>some, a few</li></ol>
чан|çan|чанны|чаннар	<i>noun</i><br><ol><li>side</li></ol>
чанар|çanar	<i>verb</i><br><ol><li>to go home</li></ol>
чарар|чарбас|çarar|чарган	<i>verb</i><br><ol><li>(transitive) to divide, split</li></ol>
чараш|çaraş	<i>adj</i><br><ol><li>beautiful, handsome, pretty</li></ol>
час|часты|ças|частар	<i>noun</i><br><ol><li>spring</li></ol>
чаш|чаштыва|чаштарымга|чаштарымже|чашымдан|чаш|чаштарже|чашче|чаштан|чаштарымда|чашымда|чашым|чаштың|çaş|чаштар|чаштарда|чаштарга|чаштарның|чаштарымдыва|чаштардан|чашымны|чаштарны|чашымның|чаштардыва|чашта|чашка|чаштарымны|чашымга|чаштарымның|чаштарым|чашты|чашымдыва|чашымже|чаштарымдан	<i>noun</i><br><ol><li>tear (secretion from lacrimal glands)</li><li>braid, plait (hair)</li></ol><br><i>adj</i><br><ol><li>young, juvenile</li></ol>
чаъс|чаъсты|çàs|чаъстар	<i>noun</i><br><ol><li>rain</li></ol>
чаңгыс|çañgıs	<i>adj</i><br><ol><li>alone, sole, single</li><li>same</li></ol>
чаңнык|çañnık|чаңныкты|чаңныктар	<i>noun</i><br><ol><li>lightning</li></ol>
чевег|çeveg	<i>noun</i><br><ol><li>grave</li><li>cemetery</li></ol>
чеден|çeden	<i>num</i><br><ol><li>seventy</li></ol>
чедер|çeder	<i>verb</i><br><ol><li>(intransitive) to reach, arrive at</li></ol>
чеди|çedi	<i>num</i><br><ol><li>seven</li></ol>
чеди хонук|чеди хонукту|çedi xonuk	<i>noun</i><br><ol><li>week, seven days</li></ol>
чедиги|7-ги|çedigi	<i>adj</i><br><ol><li>seventh</li></ol>
чедир|çedir	<i>postp</i><br><ol><li>until, up to</li></ol>
чедирер|çedirer	<i>verb</i><br><ol><li>(transitive) to deliver</li></ol>
чем|чемни|çem|чемнер	<i>noun</i><br><ol><li>food, meal</li></ol>
чер|черге|черлерге|черим|черлеримни|черлеримже|черлерден|черлеримниң|черимде|черимден|черлердиве|черлеримге|çer|черимни|черлер|черниң|черлерниң|черимже|черлеримден|черден|черлеримде|черни|черже|черлерни|черлерде|чердиве|черлеримдиве|черимдиве|черде|черимниң|черлерим|черимге|черлерже	<i>noun</i><br><ol><li>land</li><li>place</li><li>Earth</li></ol>
чес|честер|чести|çes	<i>noun</i><br><ol><li>copper</li></ol>
честек-кат|честек-каттар|честек-катты|çestek-kat	<i>noun</i><br><ol><li>strawberry</li></ol>
четтирдим|çettirdim	<i>intj</i><br><ol><li>thank you</li></ol>
чечек|çeçektiñ|чечектерни|чечектеримге|чечекимниң|чечектеримниң|чечекимге|чечектен|çeçek|чечектерге|чечекке|чечекимден|чечектер|чечеким|чечекте|чечектеримден|чечекимже|чечекимни|чечектердиве|чечектерде|чечектерже|чечектеримдиве|чечекимде|чечектеримже|чечектерниң|чечекимдиве|чечектерден|чечекти|чечектеримде|чечективе|çeçekti|çeçekter|чечектеримни|чечектиң|чечектерим|чечекче	<i>noun</i><br><ol><li>flower</li></ol>
чең|çeñ|чеңни|чеңнер	<i>noun</i><br><ol><li>sleeve</li></ol>
чигир|чигирлерим|çigir|чигирниң|чигиримдиве|чигирлердиве|чигирлеримни|чигирлер|чигирден|чигиримден|чигирлерден|чигирлерни|чигирлерниң|чигиримде|чигирни|чигирлеримден|чигирлеримде|чигиримни|чигирде|чигирдиве|чигирлеримже|чигирлеримниң|чигирлерге|чигирлеримге|чигирлерже|чигирим|чигиримниң|чигиримге|чигирге|чигирлерде|чигиримже|чигирлеримдиве|чигирже	<i>noun</i><br><ol><li>sugar</li></ol>
чидер|çider	<i>verb</i><br><ol><li>(intransitive) to disappear, vanish</li></ol>
чидиг|çidig	<i>adj</i><br><ol><li>sharp, pointed</li></ol>
чиик|čiik	<i>adj</i><br><ol><li>light (having little weight)</li></ol>
чиир|çiir|чиген|чивес	<i>verb</i><br><ol><li>(transitive) to eat</li></ol>
чиктиг|çiktig	<i>adj</i><br><ol><li>strange, weird</li><li>questionable, doubtful</li></ol>
чогаал|чогаалдар|çogaal|чогаалды	<i>noun</i><br><ol><li>literature</li><li>work, piece (of literature)</li></ol>
чок|çok	<i>verb</i><br><ol><li>there is not</li></ol><br><i>particle</i><br><ol><li>no, nay</li></ol>
чон|чонну|çon|чоннар	<i>noun</i><br><ol><li>people, race</li></ol>
чонак|чонакты|çonak|чонактар	<i>noun</i><br><ol><li>saddle blanket</li></ol>
чоок|çook	<i>adj</i><br><ol><li>near, close</li></ol>
чоокта|çookta	<i>adv</i><br><ol><li>nearby</li><li>recently</li></ol>
чорук|çoruk|чорукту|чоруктар	<i>noun</i><br><ol><li>journey, trip</li><li>A word put after adjectives in order to form certain nouns; manner, way</li></ol>
чоруур|чор|çor|çoruur	<i>verb</i><br><ol><li>to go, walk</li><li>(auxiliary, + -п) Used to form the habitual aspect for certain verbs, namely when the subject is moving.</li><li>(auxiliary, чор + -п) Used to form the progressive tense for certain verbs, namely when the subject is moving.</li></ol>
чугаа|чугааны|çugaa|чугаалар	<i>noun</i><br><ol><li>speech</li></ol>
чугаалаар|çugaalaar	<i>verb</i><br><ol><li>to speak, talk</li></ol>
чурт|чурттар|чуртту|çurt	<i>noun</i><br><ol><li>country, land</li></ol>
чурттаар|çurttaar|чурттавас|чурттаан	<i>verb</i><br><ol><li>(intransitive) to live (somewhere), to reside</li></ol>
чурук|чуруктар|çuruk|чурукту	<i>noun</i><br><ol><li>drawing, picture</li><li>photograph</li></ol>
чуруур|чурувас|чураан|çuruur	<i>verb</i><br><ol><li>(transitive) to draw</li></ol>
чуур|чудум|чузуннар|чувазывусса|чаан|чузулар|чуваңар|чувадуң|чувас|чудулар|чугай|чуваза|чувадувус|чувалыңар|чулыңар|чувазыңза|чувадуңар|чудувус|чувазыңарза|чувадыр|чузумза|чувайн|чузун|чудур|чуйн|чааш|чузуңарза|чувагай|чуду|чузуңза|чуваан|чудуңар|чувадум|чувазылар|чувазын|чуй|чуңар|чудуң|чужай|чувазымза|чуп|чузувусса|чува|чувадулар|чуза|чуваду|čuur|чувазыннар|чу	<i>verb</i><br><ol><li>to clean, to wash</li></ol>
чуурга|чуурганы|чуургалар|çuurga	<i>noun</i><br><ol><li>(zoology) egg</li><li>testicle</li></ol>
чыдар|çıdar|чытпас|чыткан	<i>verb</i><br><ol><li>to lie down</li><li>(auxiliary, + -п) Used to form the habitual aspect for certain verbs, namely when the subject is lying down or otherwise stationary.</li><li>(auxiliary, чыдыр + -п) Used to form the progressive tense for certain verbs, namely when the subject is lying down or otherwise stationary.</li></ol>
чыл|çıl|чылды|чылдар	<i>noun</i><br><ol><li>year</li></ol>
чылан|чыланны|çılan|чыланнар	<i>noun</i><br><ol><li>snake</li></ol>
чылгаар|чилгадым|чилгавадывыс|çılgaar|чилгава|чилгады|чилгаваан|чилгавадыңар|чилгааш|чилгагай|чилгавадылар|чилгажай|чилгазымза|чилгаза|чилгавагай|чилгазыннар|чилгадылар|чилгавайн|чилгадыр|чилгаваза|чилгавазымза|чилгазывысса|чилгазын|чилгавазывысса|чилгавазыңза|чилгавазын|чилгаваңар|чилгавазыннар|чилгавады|чилгавалыңар|чилгавазылар|чилгап|чилгавадым|чилгавадың|чилгаңар|чилгазыңарза|чилгайн|чилгаан|чилгай|чилгалыңар|чилга|чилгадыңар|чилгавадыр|чилгавазыңарза|чилгавас|чилгадывыс|чилгадың|чилгазыңза|чилгазылар	<i>verb</i><br><ol><li>to lick</li></ol>
чылыг|чылыгымга|чылыгларымдыва|чылыгымже|чылыгларның|чылыгларымга|чылыгымдыва|чылыгларымның|чылыгларымдан|чылыглардан|çılıg|чылыгымны|чылыглар|чылыгым|чылыгымның|чылыгже|чылыгда|чылыгдыва|чылыгдан|чылыгларымны|чылыглардыва|чылыгларже|чылыгларда|чылыгымдан|чылыгларымже|чылыгларга|чылыгның|чылыгларны|чылыгны|чылыгларым|чылыгларымда|чылыгга|чылыгымда	<i>adj</i><br><ol><li>warm</li></ol><br><i>noun</i><br><ol><li>warmth</li></ol>
чымчак|çımçak	<i>adj</i><br><ol><li>soft</li></ol>
чырык|çırık|чырыктар|чырыкты	<i>noun</i><br><ol><li>light</li></ol><br><i>adj</i><br><ol><li>bright, clear</li></ol>
чырыыр|чыраан|çırıır|чырывас	<i>noun</i><br><ol><li>(intransitive) to shine, gleam</li></ol>
чээрби|çeerbi	<i>num</i><br><ol><li>twenty</li></ol>
чүве|чүвени|чүвелер|çüve	<i>noun</i><br><ol><li>thing, stuff</li><li>Used to indicate a predicate.</li></ol>
чүг|çüg|чүгнү|чүглер	<i>noun</i><br><ol><li>feather</li></ol>
чүге|çüge	<i>adv</i><br><ol><li>(interrogative) why</li></ol>
чүге дээрге|çüge deerge	<i>conj</i><br><ol><li>because</li></ol>
чүгүрер|чүгүрген|чүгүрбес|çügürer	<i>verb</i><br><ol><li>to run</li></ol>
чүдей|çüdey	<i>verb</i><br><ol><li>-а participle of чүдээр (çüdeer)</li></ol>
чүрек|чүректи|чүректер|çürek	<i>noun</i><br><ol><li>(anatomy) heart</li></ol>
чүс|çüs	<i>num</i><br><ol><li>hundred</li></ol>
чүү|чүге|çüü|çüge	<i>pron</i><br><ol><li>(interrogative) what</li></ol>
чөдүрер|чөдүрбес|çödürer|чөдүрген	<i>verb</i><br><ol><li>(intransitive) to cough</li></ol>
шаг|şag|шаглар|шагны	<i>noun</i><br><ol><li>period of time, age</li></ol>
шагдаа|шагдаалар|шагдааны|şagdaa	<i>noun</i><br><ol><li>a police officer</li></ol>
шажын|шажыннар|шажынны|şajın	<i>noun</i><br><ol><li>religion</li></ol>
шак|şak|шакты|шактар	<i>noun</i><br><ol><li>time</li><li>hour (of the day); o'clock</li><li>clock, watch</li></ol>
шанчар|шашпас|şançar|шашкан	<i>verb</i><br><ol><li>(transitive) to punch, hit</li></ol>
шенек|шенектер|шенекти|şenek	<i>noun</i><br><ol><li>elbow</li></ol>
шенеттинер|šenettiner	<i>verb</i><br><ol><li>to practice</li></ol>
шерги|шергини|шергилер|şergi	<i>noun</i><br><ol><li>grasshopper</li></ol>
шой|şoy|шойну|шойлар	<i>noun</i><br><ol><li>pig iron</li></ol>
шооча|шоочаны|şooça|шоочалар	<i>noun</i><br><ol><li>lock</li></ol>
шупту|şuptu	<i>det</i><br><ol><li>all, every</li></ol>
шын|шыннарымдан|шынже|шынымже|шыннарның|шынымны|шынымда|шыннарымда|шыннардан|шынымдыва|шынны|шынымга|шыным|шыннарга|шыннарны|шыннарым|шынымдан|шыннарымны|шыннарымже|шынга|шыннарымның|шыннарже|шыннардыва|шыннарымдыва|шындыва|шыннарымга|шынның|шыннар|şın|шында|шындан|шыннарда|шынымның	<i>noun</i><br><ol><li>truth</li></ol>
шынныг|şınnıg	<i>adj</i><br><ol><li>correct, true, truthful</li></ol>
шыңган|шыңганже|шыңганымдыва|шыңганымны|шыңганнарымны|шыңганымда|шыңганнарымже|шыңганнарымның|шыңганнарда|шыңганнарны|шыңганда|шыңганны|шыңганнарның|шыңганнарымдан|шыңганнарымда|шыңганнарже|шыңганымга|шыңганнардыва|шыңганымже|шыңганнарга|шыңганнардан|шыңгандан|шыңганның|шыңганнарымдыва|шыңганымдан|шыңганнарымга|шыңганнар|шыңганга|шыңганнарым|шыңганым|шыңганымның|şıñgan|шыңгандыва	<i>noun</i><br><ol><li>muscle</li></ol>
щётка|щёткада|щёткага|щёткаларның|щёткаларда|щёткаларже|щёткаларымның|щёткаларым|щёткаларымны|щёткалардыва|щёткалардан|щёткамдыва|щёткадан|щёткаларымга|щёткадыва|щёткамга|şşyotka|щёткаже|щёткам|щёткаларымда|щёткаларымже|щёткаларга|щёткамның|щёткаларны|щёткаларымдыва|щётканы|щёткамны|щёткамже|щёткамда|щёткамдан|щётканың|щёткалар|щёткаларымдан	<i>noun</i><br><ol><li>brush</li></ol>
ыглаар|ıglaar|ыглаан|ыглавас	<i>verb</i><br><ol><li>(intransitive) to cry, weep</li></ol>
ынак|ınak	<i>adj</i><br><ol><li>(+ dative case) favourite, liked</li></ol>
ынакшыл|ınakşıl|ынакшылга|ынакшылдарны|ынакшылдарже|ынакшылда|ынакшылымдыва|ынакшылдарым|ынакшылдың|ынакшылымның|ынакшылымдан|ынакшылдарымдыва|ынакшылдардыва|ынакшылымже|ынакшылдарымже|ынакшылдар|ынакшылдарымның|ынакшылдарымдан|ынакшылдыва|ынакшылдарымга|ынакшылымда|ынакшылдардан|ынакшылдан|ынакшылым|ынакшылже|ынакшылды|ынакшылдарга|ынакшылдарның|ынакшылымны|ынакшылдарда|ынакшылымга|ынакшылдарымда|ынакшылдарымны	<i>noun</i><br><ol><li>love, affection</li></ol>
ындыг|ındıg	<i>adj</i><br><ol><li>(demonstrative) such, that kind of</li></ol><br><i>adv</i><br><ol><li>(demonstrative) thus, in that way</li></ol>
ындында|ındında	<i>postp</i><br><ol><li>beyond, behind</li></ol>
ыр|ырны|ır|ырлар	<i>noun</i><br><ol><li>song</li></ol>
ырак|ırak	<i>adj</i><br><ol><li>remote, distant</li></ol><br><i>adv</i><br><ol><li>far</li></ol>
ырлаар|ırlaar	<i>verb</i><br><ol><li>to sing</li></ol>
ырладыр|ırladır	<i>verb</i><br><ol><li>(causative) to make … sing</li><li>(causative) to play (a recording)</li></ol>
ыт|ыттар|ıt|ытты	<i>noun</i><br><ol><li>dog</li></ol>
ыш|ış|ыштар|ышты	<i>noun</i><br><ol><li>smoke</li></ol>
ышкаш|ışkaş	<i>postp</i><br><ol><li>like, resembling</li></ol>
ыыт|ыытты|ыыттар|ııt	<i>noun</i><br><ol><li>voice</li><li>sound, noise</li></ol>
ыяш|ıyaş|ыяштар|ыяшты	<i>noun</i><br><ol><li>tree</li><li>wood</li></ol>
эвес|eves	<i>adv</i><br><ol><li>is not</li></ol>
эвээш|eveeş	<i>adj</i><br><ol><li>few</li></ol><br><i>adv</i><br><ol><li>not much, little</li></ol>
эге|эгелер|ege|эгени	<i>noun</i><br><ol><li>start, beginning</li></ol>
эгелээр|egeleer	<i>verb</i><br><ol><li>(transitive) to begin, start</li></ol>
эгээ|egee|эгээни|эгээлер	<i>noun</i><br><ol><li>file (tool)</li></ol>
эзер|эзерни|ezer|эзерлер	<i>noun</i><br><ol><li>saddle</li></ol>
эки|eki	<i>adj</i><br><ol><li>good</li></ol>
экии|ekii	<i>intj</i><br><ol><li>hello, hi (greeting)</li></ol>
элдеп|eldep	<i>adj</i><br><ol><li>strange, weird</li><li>amazing, marvelous</li><li>questionable, doubtful</li></ol>
элээн|eleen	<i>adv</i><br><ol><li>quite, rather, considerably</li></ol>
эм|эмнер|em|эмни	<i>noun</i><br><ol><li>medicine, drug</li></ol>
эмчи|эмчини|emçi|эмчилер	<i>noun</i><br><ol><li>doctor</li></ol>
эр|эрни|er|эрлер	<i>adj</i><br><ol><li>male</li></ol><br><i>noun</i><br><ol><li>man</li></ol>
эр кижи|er kiji|эр кижилер|эр кижини	<i>noun</i><br><ol><li>man (adult male human)</li></ol>
эрги|ergi	<i>adj</i><br><ol><li>(of an object) old</li></ol>
эргим|ergim	<i>adj</i><br><ol><li>dear (term of endearment)</li></ol>
эргин|ergin	<i>noun</i><br><ol><li>threshold (bottom-most part of a doorway)</li></ol>
эрес|eres	<i>adj</i><br><ol><li>brave, courageous, gallant</li></ol>
эрес дидим чорук|эрес дидим чорукту|эрес дидим чоруктар|eres didim çoruk	<i>noun</i><br><ol><li>courage</li></ol>
эрин|эриннер|erin|эринни	<i>noun</i><br><ol><li>(anatomy) lip</li></ol>
эрте|erte	<i>adv</i><br><ol><li>early</li></ol>
эртен|erten|эртенни|эртеннер	<i>noun</i><br><ol><li>morning</li></ol>
эртенги|ertengi	<i>adj</i><br><ol><li>morning</li></ol>
эртенги хаяа|ertengi xayaa|эртенги хаяаны|эртенги хаяалар	<i>noun</i><br><ol><li>sunrise</li></ol>
эртенги чем|эртенги чемнер|эртенги чемни|ertengi çem	<i>noun</i><br><ol><li>breakfast</li></ol>
эрткен үе|ertken üe|эрткен үени|эрткен үелер	<i>noun</i><br><ol><li>past tense</li></ol>
эш|эшти|eş|эштер	<i>noun</i><br><ol><li>friend, mate</li></ol>
эштир|эжинген|эжинмес|eştir	<i>verb</i><br><ol><li>to swim</li></ol>
эът|èt|эъттер|эътти	<i>noun</i><br><ol><li>meat</li></ol>
ээ|ээлеримже|ээге|ээдиве|ээлерим|ee|ээмден|ээлерге|ээлеримдиве|ээмниң|ээлеримниң|ээлеримге|ээлерниң|ээлерни|ээлеримни|ээлеримден|ээмже|ээлер|ээлердиве|ээде|ээден|ээмдиве|ээмни|ээмде|ээже|ээниң|ээлерден|ээлерже|ээлерде|ээлеримде|ээм|ээмге|ээни	<i>noun</i><br><ol><li>owner (person who holds something as his property)</li></ol>
ээжек|ээжектер|eejek|ээжекти	<i>noun</i><br><ol><li>heel</li></ol>
эң|eñ	<i>pron</i><br><ol><li>Marks a superlative case (the most; -est)</li></ol>
ягаан|ягааннар|yagaan|ягаанны	<i>adj</i><br><ol><li>rose-coloured, pink</li></ol><br><i>noun</i><br><ol><li>rose, pink (colour)</li></ol>
январь|yanvarʹ|январьлар|январьны	<i>noun</i><br><ol><li>January</li></ol>
ёзулуг|yozulug	<i>adj</i><br><ol><li>real, true, genuine</li></ol>
ң|Ң|ñ	<i>character</i><br><ol><li>The sixteenth letter of the Tuvan alphabet</li></ol>
үжен|üjen	<i>num</i><br><ol><li>thirty</li></ol>
үжүк|үжүктү|үжүктер|üjük	<i>noun</i><br><ol><li>letter (of the alphabet)</li></ol>
үн|ün|үннү|үннер	<i>noun</i><br><ol><li>voice</li><li>sound, tone</li></ol>
үнер|үнген|üner|үнмес	<i>verb</i><br><ol><li>to leave, exit</li><li>to ascend, go up</li><li>(auxiliary, + -п) to start (doing something)</li></ol>
үнүш|ünüş|үнүштү|үнүштер	<i>noun</i><br><ol><li>plant</li><li>bush</li></ol>
үр|ür	<i>adv</i><br><ol><li>for a long time</li></ol>
үст|үсттер|үсттү|üst	<i>noun</i><br><ol><li>top</li></ol>
үш|üş	<i>num</i><br><ol><li>three</li></ol>
үшкү|3-кү|üşkü	<i>adj</i><br><ol><li>third</li></ol>
өвүр|övür|өвүрнү|өвүрлер	<i>noun</i><br><ol><li>south slope (yang side) of a mountain</li></ol>
өг|ög|өгнү|өглер	<i>noun</i><br><ol><li>yurt, ger</li></ol>
өг-бүле|өг-бүлелеримдиве|өг-бүлелеримниң|өг-бүлемже|өг-бүлелерде|өг-бүледиве|өг-бүлениң|өг-бүлемниң|өг-бүлеже|өг-бүлелерже|өг-бүлемде|өг-бүлелеримни|өг-бүлелерге|өг-бүлени|өг-бүлемге|өг-бүлелеримге|өг-бүлелерни|өг-бүлелеримде|өг-бүлелерден|өг-бүледен|өг-бүлелер|өг-бүлеге|өг-бүлелеримден|өг-бүлелердиве|өг-бүлемни|өг-бүлемдиве|өг-бүлелеримже|өг-бүледе|өг-бүлелерим|өг-бүлемден|өг-бүлем|өг-бүлелерниң|ög-büle	<i>noun</i><br><ol><li>family, immediate family</li></ol>
өкпе|ökpe|өкпелер|өкпени	<i>noun</i><br><ol><li>lung</li></ol>
өкпең|ökpeñ|өкпеңни|өкпеңнер	<i>adj</i><br><ol><li>purple</li></ol><br><i>noun</i><br><ol><li>purple (colour)</li></ol>
өлүр|өлүп калыр|ölüp kalır|ölür|өлбес|өлген	<i>verb</i><br><ol><li>(intransitive) to die</li></ol>
өлүрер|ölürer|өлүрген|өлүрбес	<i>verb</i><br><ol><li>(transitive) to kill, murder</li></ol>
өршээп көрүңерем|өршээп көрүңер|örşeep körüñer|örşeep körüñerem	<i>intj</i><br><ol><li>sorry</li><li>pardon, excuse me</li></ol>
өршээр|örşeer|өршээвес|өршээген	<i>verb</i><br><ol><li>(transitive) to forgive, spare</li></ol>
өрээл|өрээлди|öreel|өрээлдер	<i>noun</i><br><ol><li>room, chamber</li></ol>
өске|öske	<i>adj</i><br><ol><li>other, different</li></ol>
өшкү|öşkü|өшкүнү|өшкүлер	<i>noun</i><br><ol><li>goat</li></ol>
өң|öñ|өңнер|өңнү	<i>noun</i><br><ol><li>colour</li><li>friend, comrade</li></ol>
өңнүк|öñnük|өңнүктер|өңнүктү	<i>noun</i><br><ol><li>friend</li></ol>
өөлет|өөлеттер|өөлетти|öölet	<i>noun</i><br><ol><li>(~ сөөк) a subgroup of the Tuvans of Dzungarian origin</li><li>(also ~ кижи) a member of the group</li></ol>
өөредир|өөреткен|ööredir|өөретпес	<i>verb</i><br><ol><li>(transitive) to teach</li></ol>
өөреникчи|öörenikçi|өөреникчилер|өөреникчини	<i>noun</i><br><ol><li>student</li></ol>
өөренир|öörenir|өөренген|өөренбес	<i>verb</i><br><ol><li>(transitive) to learn, practice</li></ol>
