A	<i>character</i><br><ol><li>The first letter of the Vilamovian alphabet, called a and written in the Latin script.</li></ol>
Abda	<i>name</i><br><ol><li>the tenth judge of Israel; Abdon (biblical character)</li></ol>
Bestwa	<i>name</i><br><ol><li>Bestwina</li></ol>
Brejskia	<i>name</i><br><ol><li>Brzeszcze</li></ol>
Byłc	<i>name</i><br><ol><li>Bielsko</li></ol>
Byłc-Bejł	<i>name</i><br><ol><li>Bielsko-Biała (a city in the Silesian Voivodeship, Poland)</li></ol>
Büldiüf	<i>name</i><br><ol><li>Bulowice</li></ol>
Ciajnc	<i>name</i><br><ol><li>Czaniec</li></ol>
Cygonn	<i>name</i><br><ol><li>(plural only) Gypsies</li></ol>
Daojćłaond	<i>name</i><br><ol><li>Germany</li></ol>
Grusy Fost	<i>name</i><br><ol><li>(Christianity) Lent</li></ol>
Göt	<i>name</i><br><ol><li>God</li></ol>
Halikier Łajchnaomstaog	<i>name</i><br><ol><li>Corpus Christi (Boże Ciało)</li></ol>
Hylciadiüf	<i>name</i><br><ol><li>Hecznarowice</li></ol>
Italjen	<i>name</i><br><ol><li>Italy</li></ol>
Italjener|Italjenyn	<i>noun</i><br><ol><li>Italian (male person)</li></ol>
Italjeneryn|Italjenerynn	<i>noun</i><br><ol><li>Italian (female person)</li></ol>
Jyndziydüf	<i>name</i><br><ol><li>Andrychów</li></ol>
Jüd	<i>noun</i><br><ol><li>Jew</li></ol>
Krök|Krȫk	<i>name</i><br><ol><li>Cracow (a city in Poland)</li></ol>
Kywynik	<i>name</i><br><ol><li>Kobiernice</li></ol>
Mongȫl|Mongȫln	<i>noun</i><br><ol><li>Mongolian</li></ol>
Naojśtaod	<i>name</i><br><ol><li>Zator</li></ol>
Ojrōpa	<i>name</i><br><ol><li>The continent Europe</li><li>(Greek mythology) A Phoenician princess abducted to Crete by Zeus</li><li>(astronomy) A moon of Jupiter</li></ol>
Prȧjzən	<i>name</i><br><ol><li>Prussia</li></ol>
Pulk|Pulkia|Pylkla	<i>noun</i><br><ol><li>Polish woman, female Pole</li></ol>
Pöłn|Pȫłn	<i>name</i><br><ol><li>Poland</li></ol>
Pȫła	<i>noun</i><br><ol><li>Pole</li></ol>
Serb	<i>noun</i><br><ol><li>Serb (person)</li></ol>
Tiykaj	<i>name</i><br><ol><li>Turkey</li></ol>
Wielki Post	<i>name</i><br><ol><li>(Christianity) Lent</li></ol>
Wymysoü	<i>name</i><br><ol><li>Wilamowice</li></ol>
Wīn	<i>name</i><br><ol><li>Vienna</li></ol>
Wȧjsuł	<i>name</i><br><ol><li>(geography) Vistula (The longest river in Poland)</li><li>(geography) a town in Silesia, near the source of the Vistula</li></ol>
Zunn	<i>name</i><br><ol><li>the Sun (the star at the center of our solar system)</li></ol>
aach|aachla|aachia	<i>noun</i><br><ol><li>oak</li></ol>
achuł|achułn	<i>noun</i><br><ol><li>An acorn, the fruit of an oak tree</li><li>(anatomy) The glans</li></ol>
adum|ȧn|dy|ȧm|ǡduma|aduma|ym|der|yn|ǡdum|ȧ	<i>noun</i><br><ol><li>son-in-law</li></ol>
adwökāt|adwökāta	<i>noun</i><br><ol><li>advocate, lawyer</li></ol>
agl|agln	<i>noun</i><br><ol><li>leech</li></ol>
ah	<i>intj</i><br><ol><li>oh: expressing of surprise</li><li>oh: expressing wonder, amazement, or awe</li><li>oh: expressing understanding, recognition, or realization</li><li>oh: preceding an offhand or annoyed remark</li><li>oh: an invocation or address</li></ol>
ahynder	<i>adv</i><br><ol><li>backwards</li></ol>
ajs|ȧjs	<i>noun</i><br><ol><li>ice</li></ol>
ajsig|ȧjsig	<i>adj</i><br><ol><li>cold, frosty</li></ol>
ajza|ȧjza	<i>noun</i><br><ol><li>iron</li></ol>
ajłaoda	<i>verb</i><br><ol><li>invite</li></ol>
ajłyt	<i>noun</i><br><ol><li>churching (blessing given to new mothers)</li></ol>
ajśłöfa	<i>verb</i><br><ol><li>to fall asleep</li></ol>
akademī	<i>noun</i><br><ol><li>academy</li></ol>
aker	<i>noun</i><br><ol><li>field (wide, open space used to grow crops)</li></ol>
akta	<i>noun</i><br><ol><li>(plural only) document, paper, file, dossier</li></ol>
akurāt	<i>adv</i><br><ol><li>accurately</li></ol>
alf|ȧlf	<i>num</i><br><ol><li>eleven</li></ol>
alfabet	<i>noun</i><br><ol><li>alphabet</li></ol>
alfty|ȧlfty	<i>num</i><br><ol><li>eleventh</li></ol>
amsa|amst|gyamst	<i>verb</i><br><ol><li>to resemble</li></ol>
amt	<i>noun</i><br><ol><li>office</li></ol>
an|ān	<i>conj</i><br><ol><li>and</li></ol><br><i>num</i><br><ol><li>one</li></ol>
ana	<i>conj</i><br><ol><li>and</li></ol>
ander	<i>adj</i><br><ol><li>other, different</li><li>second</li></ol>
anjerig	<i>adj</i><br><ol><li>annual</li></ol>
ant|ȧnt|anta	<i>noun</i><br><ol><li>duck</li></ol>
aochcao	<i>num</i><br><ol><li>eighteen</li></ol>
aochcyty	<i>num</i><br><ol><li>eighteenth</li></ol>
aochsuł|aochsułn	<i>noun</i><br><ol><li>(anatomy) shoulder</li></ol>
aocht	<i>num</i><br><ol><li>eight</li></ol>
aocht hundyt	<i>num</i><br><ol><li>eight hundred</li></ol>
aochty	<i>num</i><br><ol><li>eighth</li></ol>
aodera	<i>adj</i><br><ol><li>clay, earthen</li></ol>
aoj	<i>particle</i><br><ol><li>also, too</li></ol>
aojg|aojga|öegla	<i>noun</i><br><ol><li>eye</li></ol>
aojsbildung	<i>noun</i><br><ol><li>education</li></ol>
aojł	<i>noun</i><br><ol><li>owl</li></ol>
aokys|aokysa	<i>noun</i><br><ol><li>axe</li></ol>
aon|ann	<i>noun</i><br><ol><li>harvest</li></ol>
aondaocht	<i>noun</i><br><ol><li>(religion) devotion, devotions, devotional prayer</li></ol>
aongst	<i>noun</i><br><ol><li>fear, awe</li></ol>
aoraok	<i>noun</i><br><ol><li>arak</li></ol>
aorpuł|aorpułn	<i>noun</i><br><ol><li>potato</li></ol>
aosa	<i>verb</i><br><ol><li>to eat</li></ol><br><i>noun</i><br><ol><li>food</li></ol>
aoscymer	<i>noun</i><br><ol><li>dining room</li></ol>
aost|aostła	<i>noun</i><br><ol><li>branch</li></ol>
aot|aota	<i>noun</i><br><ol><li>work</li><li>effort, difficulty</li></ol>
aota	<i>verb</i><br><ol><li>to work</li></ol>
aowys	<i>noun</i><br><ol><li>pea, bean</li></ol>
aołd	<i>adj</i><br><ol><li>old</li></ol>
aołder	<i>noun</i><br><ol><li>age (latter part of life)</li></ol>
aołdyn|aołdyt|gyaołdyt	<i>verb</i><br><ol><li>to age (become old)</li></ol>
aprīl	<i>noun</i><br><ol><li>April</li></ol>
aptykier	<i>noun</i><br><ol><li>apothecary, pharmacist</li></ol>
aptȳḱ	<i>noun</i><br><ol><li>pharmacy (a place where prescription drugs are dispensed)</li></ol>
arcybisku̇p|arcybisku̇pa	<i>noun</i><br><ol><li>archbishop</li></ol>
astronomi	<i>noun</i><br><ol><li>astronomy</li></ol>
ałan	<i>adj</i><br><ol><li>alone</li></ol>
bajcht	<i>noun</i><br><ol><li>confession</li></ol>
bajsa|gebyssa|bȧss	<i>verb</i><br><ol><li>to bite</li></ol>
bajśpil|bajśpiln	<i>noun</i><br><ol><li>model</li><li>example</li><li>comparison</li></ol>
bakka	<i>verb</i><br><ol><li>to bake</li></ol>
bakkūwa	<i>noun</i><br><ol><li>oven</li></ol>
balkōn	<i>noun</i><br><ol><li>balcony</li></ol>
baoba	<i>noun</i><br><ol><li>grandmother</li></ol>
baoch|baochła|baocha	<i>noun</i><br><ol><li>brook, stream</li></ol>
baojm|biöm	<i>noun</i><br><ol><li>tree</li></ol>
baol|baola	<i>noun</i><br><ol><li>ball</li></ol>
baoldaoch	<i>noun</i><br><ol><li>canopy, baldachin</li></ol>
baon	<i>noun</i><br><ol><li>railway, railroad (transport system)</li></ol>
baor|baorn	<i>noun</i><br><ol><li>bear</li></ol>
baota|gybatt|batt	<i>verb</i><br><ol><li>pray</li></ol>
baotłergiełd	<i>noun</i><br><ol><li>alms</li></ol>
baozum	<i>noun</i><br><ol><li>broom (tool for sweeping)</li></ol>
barhet	<i>noun</i><br><ol><li>fustian (coarse cotton fabric)</li></ol>
bawjǡn	<i>verb</i><br><ol><li>to play</li></ol>
ba̐jhta	<i>verb</i><br><ol><li>to confess</li></ol>
ba̐jł	<i>noun</i><br><ol><li>axe, hatchet</li></ol>
bekier	<i>noun</i><br><ol><li>baker</li></ol>
bet	<i>noun</i><br><ol><li>bed</li></ol>
bicha	<i>noun</i><br><ol><li>beech (tree)</li></ol>
bichła	<i>noun</i><br><ol><li>booklet</li></ol>
bier|biern	<i>noun</i><br><ol><li>berry</li></ol>
bih́łiḱ	<i>noun</i><br><ol><li>(botany) A beech (Fagus); the common tree</li><li>beech; the wood of the tree</li></ol>
bilet	<i>noun</i><br><ol><li>ticket</li></ol>
biologii	<i>noun</i><br><ol><li>biology</li></ol>
bisküp|bisküpa	<i>noun</i><br><ol><li>bishop (church official)</li></ol>
biyn|bjynn	<i>noun</i><br><ol><li>pear (an edible fruit produced by the pear tree, similar to an apple but elongated towards the stem).</li></ol>
biyr	<i>noun</i><br><ol><li>beer</li></ol>
biyśt|biyśtła|biyśta	<i>noun</i><br><ol><li>brush</li></ol>
biöt	<i>noun</i><br><ol><li>beard</li></ol>
bjygjamȧster|bjygjamȧstyn	<i>noun</i><br><ol><li>mayor (leader of a city)</li></ol>
bjygjamȧsteryn	<i>noun</i><br><ol><li>female mayor (leader of a city)</li></ol>
bjygjer	<i>noun</i><br><ol><li>Legally recognized inhabitant of a country or a city; citizen, burgher</li><li>Member of a social class, usually richer and/or more influential than peasants and workers and poorer and/or less influential than noblemen</li></ol>
bjyrtiḱ	<i>adj</i><br><ol><li>native</li></ol>
bjyḱ|bjyḱja	<i>noun</i><br><ol><li>birch (tree)</li></ol>
bjēr|bjērn	<i>noun</i><br><ol><li>berry</li></ol>
bjȳd|bjȳda	<i>noun</i><br><ol><li>burden</li></ol>
bjȳda	<i>noun</i><br><ol><li>poverty</li></ol>
blüz	<i>noun</i><br><ol><li>blouse, sweatshirt</li></ol>
blȧjśtift	<i>noun</i><br><ol><li>pencil</li></ol>
bow|bōw|bōwa|bowa	<i>noun</i><br><ol><li>woman</li><li>wife</li></ol>
bość	<i>noun</i><br><ol><li>borscht</li></ol>
braat	<i>adj</i><br><ol><li>wide</li></ol>
bracha	<i>verb</i><br><ol><li>to break</li></ol>
branfȧjn	<i>noun</i><br><ol><li>vodka</li></ol>
brant	<i>noun</i><br><ol><li>fire, blaze</li><li>gangrene</li><li>grain smut</li></ol>
braojcha	<i>verb</i><br><ol><li>need</li></ol>
braond	<i>noun</i><br><ol><li>fire, blaze</li><li>gangrene</li><li>grain smut</li></ol>
braower	<i>adj</i><br><ol><li>brave</li></ol>
bratki|bratkja	<i>noun</i><br><ol><li>(botany) pansy</li></ol>
briftröejer	<i>noun</i><br><ol><li>postman, mailman</li></ol>
britt	<i>noun</i><br><ol><li>brood hen, layer</li></ol>
brjēsuł|brjēsułn	<i>noun</i><br><ol><li>nettle, plant of genus Urtica</li></ol>
bronz	<i>noun</i><br><ol><li>bronze</li></ol>
brust|brūst|brysta|brystła	<i>noun</i><br><ol><li>(anatomy) breast; the fleshy organs on the chest of a sexually mature human female</li><li>(anatomy) chest, thorax; the portion of the body from the base of the neck to the top of the abdomen</li><li>bosom</li></ol>
brut|brūtła|brūt|brutła	<i>noun</i><br><ol><li>bread</li><li>loaf (of bread)</li></ol>
bryk|brykia|brykla	<i>noun</i><br><ol><li>bridge</li></ol>
bröta|brȫta	<i>noun</i><br><ol><li>a roast (big portion of meat, usually fried in the oven)</li></ol><br><i>verb</i><br><ol><li>to bake</li></ol>
brüder|bridyn	<i>noun</i><br><ol><li>brother</li></ol>
brīf	<i>noun</i><br><ol><li>letter (written message)</li></ol>
brīfpopjȳr	<i>noun</i><br><ol><li>letter paper</li></ol>
brīn	<i>verb</i><br><ol><li>to burn</li></ol>
brȳma	<i>noun</i><br><ol><li>(plural only) blackberry, bramble</li></ol>
bukfuruk	<i>noun</i><br><ol><li>quail</li></ol>
byaomter	<i>noun</i><br><ol><li>official, clerk</li></ol>
bycoła|bycōła	<i>verb</i><br><ol><li>to pay</li></ol>
bydȧjta	<i>verb</i><br><ol><li>to mean, to signify</li></ol>
bygrytnys	<i>noun</i><br><ol><li>funeral, burial</li></ol>
bygrōwa	<i>verb</i><br><ol><li>to bury</li></ol>
byks|byksa	<i>noun</i><br><ol><li>gun, shotgun</li></ol>
bykłöen	<i>verb</i><br><ol><li>complain</li></ol>
bymin	<i>noun</i><br><ol><li>trouble</li></ol>
byn	<i>noun</i><br><ol><li>bee</li></ol>
bynda|bund|gybunda	<i>verb</i><br><ol><li>to bind</li></ol>
bynder	<i>noun</i><br><ol><li>cooper (craftsman)</li></ol>
bynzeła	<i>noun</i><br><ol><li>ribbon</li><li>tape</li><li>hatband</li><li>fillet</li></ol>
byriyn	<i>verb</i><br><ol><li>to touch</li></ol>
byrīmt	<i>adj</i><br><ol><li>famous, well-known, renowned, celebrated, noted</li></ol>
byrȫta	<i>verb</i><br><ol><li>to discuss</li><li>to advise</li></ol>
byrȫter|byrȫtyn	<i>noun</i><br><ol><li>advisor, consultant</li></ol>
bys	<i>conj</i><br><ol><li>until</li></ol>
byt|bytła	<i>noun</i><br><ol><li>barrel (container for wine, fish, etc.)</li></ol>
bytter	<i>adj</i><br><ol><li>bitter</li></ol>
bywajs	<i>noun</i><br><ol><li>proof</li></ol>
bywundyn	<i>verb</i><br><ol><li>to admire</li></ol>
bywȧjza	<i>verb</i><br><ol><li>to prove</li></ol>
byłünung	<i>noun</i><br><ol><li>reward, prize</li></ol>
bödum|bydum|bydyn	<i>noun</i><br><ol><li>bottom, ground</li></ol>
böga|bȫga	<i>noun</i><br><ol><li>bow, arch, bend, curve, arc</li></ol>
böta|bȫta	<i>noun</i><br><ol><li>messenger, envoy</li></ol>
böła|bȫła	<i>noun</i><br><ol><li>beam (of wood)</li></ol>
büch|bichła|bichjyn	<i>noun</i><br><ol><li>book</li></ol>
büchhaolter	<i>noun</i><br><ol><li>accountant, bookkeeper</li></ol>
büjer	<i>noun</i><br><ol><li>auger, (drill?)</li></ol>
büw|büwa	<i>noun</i><br><ol><li>boy</li></ol>
bāh|bāha	<i>noun</i><br><ol><li>brook, stream</li></ol>
bākcōn	<i>noun</i><br><ol><li>a molar (tooth)</li></ol>
bātliḱ	<i>adj</i><br><ol><li>bearded</li></ol>
bātputtynystyn	<i>noun</i><br><ol><li>(plural only) rosary</li></ol>
bātłer|bātłyn	<i>noun</i><br><ol><li>beggar</li></ol>
bātłeryn	<i>noun</i><br><ol><li>a female beggar</li></ol>
bātłyn	<i>verb</i><br><ol><li>to beg</li></ol>
bīber	<i>noun</i><br><ol><li>beaver, mammal of the genus Castor</li></ol>
bīst	<i>noun</i><br><ol><li>colostrum</li></ol>
błach|błachia	<i>noun</i><br><ol><li>sheet metal</li></ol>
błaj|błȧj	<i>noun</i><br><ol><li>lead (chemical element - Pb, atomic number 82)</li></ol>
błajn|błȧjn	<i>verb</i><br><ol><li>to remain</li></ol>
bławatki|bławatkja	<i>noun</i><br><ol><li>cornflower</li></ol>
błimła|błīmła	<i>noun</i><br><ol><li>flower</li></ol>
błin|błīn	<i>verb</i><br><ol><li>to blossom</li></ol>
błot|błȳtyn|błytyn|błōt	<i>noun</i><br><ol><li>(botany) a leaf; the organ of a plant or tree</li><li>(botany) the petal of a flower or blossom</li><li>a page in a book or magazine</li><li>a sheet of paper</li><li>(card games) the cards of a card game</li></ol>
błös|błösa	<i>noun</i><br><ol><li>bubble</li><li>blister</li><li>(anatomy) bladder</li></ol>
błöw|błȫw	<i>adj</i><br><ol><li>blue</li></ol>
błöza|błȫza	<i>verb</i><br><ol><li>to blow</li></ol>
błüt	<i>noun</i><br><ol><li>blood</li></ol>
błütwiyśt	<i>noun</i><br><ol><li>black pudding</li></ol>
błȫter|błȫtyn	<i>noun</i><br><ol><li>blister</li></ol>
błȫtyn	<i>noun</i><br><ol><li>smallpox (disease)</li></ol>
bōda	<i>verb</i><br><ol><li>to bathe</li></ol>
bōder|bōdyn	<i>noun</i><br><ol><li>barber surgeon</li></ol>
būzŭm	<i>noun</i><br><ol><li>bosom</li></ol>
bǡnwał	<i>noun</i><br><ol><li>comfrey</li></ol>
bǡsuł|bǡsułn	<i>noun</i><br><ol><li>chisel</li></ol>
bȧjwys	<i>noun</i><br><ol><li>mugwort (Artemisia vulgaris)</li></ol>
bȧjönett	<i>noun</i><br><ol><li>bayonet</li></ol>
bȧlzam|bȧlzama	<i>noun</i><br><ol><li>balm, balsam</li></ol>
bȧsułn|bȧsułt	<i>verb</i><br><ol><li>to pick with a chisel</li></ol>
cajt|cȧjta|cȧjt|cajta	<i>noun</i><br><ol><li>time</li></ol>
cajtung	<i>noun</i><br><ol><li>newspaper</li></ol>
caon	<i>num</i><br><ol><li>ten</li></ol>
caoł|caołn	<i>noun</i><br><ol><li>number (abstract entity)</li></ol>
cejg	<i>noun</i><br><ol><li>goat</li></ol>
cejn	<i>noun</i><br><ol><li>tin</li></ol>
celt|celta	<i>noun</i><br><ol><li>tent</li></ol>
cigār	<i>noun</i><br><ol><li>cigar</li></ol>
ciment	<i>noun</i><br><ol><li>cement</li></ol>
cimentiyn	<i>verb</i><br><ol><li>to cement</li></ol>
cin|cīn	<i>verb</i><br><ol><li>to pull</li><li>to draw</li></ol>
col|cōl|cōln|coln	<i>noun</i><br><ol><li>inch (unit of measure)</li></ol>
cug	<i>noun</i><br><ol><li>train</li></ol>
cunder	<i>noun</i><br><ol><li>tinder</li></ol>
cung	<i>noun</i><br><ol><li>(anatomy) tongue</li></ol>
cu̇maha	<i>verb</i><br><ol><li>to close</li></ol>
cwancikjer	<i>noun</i><br><ol><li>zwanziger</li></ol>
cwe|cwē	<i>num</i><br><ol><li>two</li></ol>
cwencik|cwenciḱ	<i>num</i><br><ol><li>twenty</li></ol>
cwenciksty	<i>num</i><br><ol><li>twentieth</li></ol>
cwełf	<i>num</i><br><ol><li>twelve</li></ol>
cwełfty	<i>num</i><br><ol><li>twelfth</li></ol>
cwypuł|cwypułn	<i>noun</i><br><ol><li>onion</li></ol>
cy	<i>prep</i><br><ol><li>to</li></ol>
cydyjyśt	<i>adv</i><br><ol><li>first</li></ol>
cygār	<i>noun</i><br><ol><li>cigar</li></ol>
cyndhełcła	<i>noun</i><br><ol><li>match (to use to make a fire)</li></ol>
cyttyn|cyttyt|gycyttyt	<i>verb</i><br><ol><li>to tremble, to shiver</li></ol>
cökela	<i>noun</i><br><ol><li>sweet, candy</li></ol>
cöp	<i>noun</i><br><ol><li>plait, braid (of hair)</li></ol>
cănteryj	<i>noun</i><br><ol><li>centaury (Centaurium)</li></ol>
cīmet	<i>noun</i><br><ol><li>cinnamon (spice)</li></ol>
cōn|cȳn	<i>noun</i><br><ol><li>tooth</li></ol>
cȧjgjer|cȧjgjyn	<i>noun</i><br><ol><li>witness m</li></ol>
cȧjgjeryn|cȧjgjerynn	<i>noun</i><br><ol><li>witness f</li></ol>
cȧjhnyn	<i>verb</i><br><ol><li>to draw</li></ol>
cȧjł|cȧjłn	<i>noun</i><br><ol><li>line, row</li></ol>
cȧnkner|cȧnknyn	<i>noun</i><br><ol><li>hundredweight</li></ol>
dajsuł|dajsułn|dȧjsuł	<i>noun</i><br><ol><li>drawbar</li></ol>
daoch|daochła|daochjyn	<i>noun</i><br><ol><li>roof</li></ol>
decimēter|decimētyn	<i>noun</i><br><ol><li>decimetre, (US) decimeter</li></ol>
depresion	<i>noun</i><br><ol><li>depression</li></ol>
dessa	<i>adv</i><br><ol><li>outside</li></ol>
dinn	<i>verb</i><br><ol><li>to serve</li></ol>
dinstmiöed	<i>noun</i><br><ol><li>servant, maid</li></ol>
diüem	<i>noun</i><br><ol><li>gut</li></ol>
djēmyt	<i>noun</i><br><ol><li>diamond (mineral)</li></ol>
domf	<i>noun</i><br><ol><li>water vapor, steam</li></ol>
draj|drȧj	<i>num</i><br><ol><li>three</li></ol>
draowa	<i>noun</i><br><ol><li>army</li></ol>
drecao	<i>num</i><br><ol><li>thirteen</li></ol>
drow|drowa|drōwa|drōw	<i>noun</i><br><ol><li>soldier</li></ol>
drybaonk	<i>noun</i><br><ol><li>lathe</li></ol>
drökk	<i>noun</i><br><ol><li>print (the letters forming the text of a document)</li></ol>
drökka	<i>verb</i><br><ol><li>to print</li></ol>
drökker	<i>noun</i><br><ol><li>printer (person)</li><li>engraver beetle (Ips typographus)</li></ol>
drökkerȧj	<i>noun</i><br><ol><li>printing-house, printing-office</li></ol>
drüz|drüza	<i>noun</i><br><ol><li>gland</li><li>bump</li></ol>
drȳskommer	<i>noun</i><br><ol><li>vestry, sacristy</li></ol>
dunyśtaog	<i>noun</i><br><ol><li>Thursday</li></ol>
duł	<i>adj</i><br><ol><li>dumb</li></ol>
dułyt|dułyta	<i>noun</i><br><ol><li>stupidity</li></ol>
du̇bski	<i>noun</i><br><ol><li>Arse (meaning anus), as pars pro toto: posterior.</li></ol>
dy|and plural form of dyr	<i>article</i><br><ol><li>The; declined form of dyr</li></ol>
dynstaog	<i>noun</i><br><ol><li>Tuesday</li></ol>
dyr	<i>article</i><br><ol><li>the</li></ol>
dyrcīn	<i>verb</i><br><ol><li>to educate</li></ol>
dyrr	<i>adj</i><br><ol><li>dry</li></ol>
dziada	<i>noun</i><br><ol><li>grandfather</li></ol>
dziodek	<i>noun</i><br><ol><li>grandfather</li></ol>
dökter|döktyn	<i>noun</i><br><ol><li>doctor</li></ol>
dökteryn	<i>noun</i><br><ol><li>a female doctor</li></ol>
döktyn	<i>verb</i><br><ol><li>to cure, to treat</li></ol>
döstuł|döstułn	<i>noun</i><br><ol><li>thistle</li></ol>
dīb|dīw	<i>noun</i><br><ol><li>thief</li></ol>
dīner|diyn|dinyn	<i>noun</i><br><ol><li>servant</li></ol>
dīnst|dinsta	<i>noun</i><br><ol><li>service</li><li>work, duty</li></ol>
dōs	<i>article</i><br><ol><li>The; declined form of dyr</li></ol>
dūner	<i>noun</i><br><ol><li>rumble (low pitched noise, such as that of thunder)</li></ol>
dȧjner|dȧjny|dȧjs	<i>pron</i><br><ol><li>(possessive) yours (informal, friends, relatives).</li></ol>
e	<i>noun</i><br><ol><li>egg</li></ol>
edikjys|edikja	<i>noun</i><br><ol><li>lizard</li></ol>
egia	<i>noun</i><br><ol><li>harrow</li></ol><br><i>verb</i><br><ol><li>to harrow</li></ol>
ejggl	<i>noun</i><br><ol><li>hedgehog</li></ol>
ejweron	<i>adv</i><br><ol><li>everywhere</li></ol>
ekselenc	<i>noun</i><br><ol><li>Excellency (form of address for certain high officials or dignitaries)</li></ol>
elefaont|elefaonta	<i>noun</i><br><ol><li>elephant</li></ol>
end	<i>noun</i><br><ol><li>end</li></ol>
engl	<i>noun</i><br><ol><li>angel</li></ol>
englyś	<i>adj</i><br><ol><li>English</li></ol>
enkylkynd|enkylkyndyn	<i>noun</i><br><ol><li>grandson</li></ol>
epuł|epułn	<i>noun</i><br><ol><li>apple</li></ol>
epułkücha	<i>noun</i><br><ol><li>apple pie</li></ol>
erb	<i>noun</i><br><ol><li>heritage</li></ol>
erba	<i>verb</i><br><ol><li>to inherit</li></ol>
erbyn	<i>noun</i><br><ol><li>(plural only) heirs</li></ol>
ere|ēre	<i>noun</i><br><ol><li>homage, honor</li><li>fame</li></ol>
ełböga	<i>noun</i><br><ol><li>The elbow</li></ol>
ełdyn	<i>noun</i><br><ol><li>(plural only) parents</li></ol>
ełter|ełtyn	<i>noun</i><br><ol><li>altar (A table or similar structure used for religious rites.)</li></ol>
fabryk|fabryka	<i>noun</i><br><ol><li>factory</li></ol>
fabryḱ|fabrykja	<i>noun</i><br><ol><li>factory</li></ol>
fajf|fajfła|fajfa|fȧjf	<i>noun</i><br><ol><li>pipe (for smoking)</li><li>whistle</li></ol>
fajł|fǡjł|fajłn	<i>noun</i><br><ol><li>file (abrasive tool)</li></ol>
fajła|fǡjła	<i>verb</i><br><ol><li>(to smooth with a file) to file</li></ol>
fakel|fakeln	<i>noun</i><br><ol><li>piglet</li></ol>
fald|faldyn	<i>noun</i><br><ol><li>field</li></ol>
familī	<i>noun</i><br><ol><li>family</li></ol>
faod	<i>noun</i><br><ol><li>horse</li></ol>
faoder|faodyn	<i>noun</i><br><ol><li>feather</li></ol>
faojer|faojyn	<i>noun</i><br><ol><li>fire</li><li>bonfire</li><li>blaze</li></ol>
faojerwerk	<i>noun</i><br><ol><li>firework</li></ol>
faonküch	<i>noun</i><br><ol><li>scrambled eggs</li></ol>
faonn|fannła|fonna	<i>noun</i><br><ol><li>frying pan</li></ol>
faoś	<i>noun</i><br><ol><li>heel</li></ol>
faryzejer	<i>noun</i><br><ol><li>Pharisee (A member of a political party, a social movement, and a school of thought among Jews that flourished during the Second Temple Era (536 B.C.E.–70 C.E.). The movement was ultimately the basis for most contemporary forms of Judaism.)</li><li>A person who values the letter of the law over the spirit or intention of the law.</li></ol>
fegfojer	<i>noun</i><br><ol><li>purgatory</li></ol>
fehta	<i>verb</i><br><ol><li>(to) beg</li></ol>
fehter|fehtyn	<i>noun</i><br><ol><li>beggar</li></ol>
fehteryn	<i>noun</i><br><ol><li>(female) beggar</li></ol>
fender	<i>noun</i><br><ol><li>forester</li></ol>
fernȧjz	<i>noun</i><br><ol><li>varnish</li></ol>
fett	<i>noun</i><br><ol><li>fat</li></ol>
fetter|fettyn	<i>noun</i><br><ol><li>paternal uncle (brother of someone’s father)</li></ol>
fibl̥	<i>noun</i><br><ol><li>primer (an elementary book for teaching children to read and write)</li></ol>
ficc|ficca	<i>noun</i><br><ol><li>slice of bread</li></ol>
fieder	<i>adj</i><br><ol><li>front</li></ol>
figür	<i>noun</i><br><ol><li>figure</li></ol>
fiht|fihta	<i>noun</i><br><ol><li>pine</li></ol>
filcłauz	<i>noun</i><br><ol><li>crab louse, pubic louse</li></ol>
fiycao	<i>num</i><br><ol><li>fourteen</li></ol>
fiycyty	<i>num</i><br><ol><li>fourteenth</li></ol>
fiydy	<i>num</i><br><ol><li>fourth</li></ol>
fiyr	<i>num</i><br><ol><li>four</li></ol>
fjołki|fjołkja	<i>noun</i><br><ol><li>The flower violet.</li></ol>
fjyrmament	<i>noun</i><br><ol><li>sky, firmament</li></ol>
fjȳwyt	<i>noun</i><br><ol><li>(season) spring</li></ol>
flamandyś	<i>adj</i><br><ol><li>Flemish</li></ol>
flöt	<i>noun</i><br><ol><li>flute</li></ol>
flēt	<i>noun</i><br><ol><li>(music) flute (woodwind instrument)</li></ol>
fon	<i>prep</i><br><ol><li>from</li><li>of (belonging to)</li></ol>
fonn|fannła|fonna|fōn|fānła	<i>noun</i><br><ol><li>flags</li></ol>
fost	<i>name</i><br><ol><li>Lent</li></ol>
fosta	<i>verb</i><br><ol><li>to fast</li></ol>
foter|fotyn	<i>noun</i><br><ol><li>father</li></ol>
fraj|frȧj	<i>adj</i><br><ol><li>free</li></ol>
frajmaon|frajłaojt	<i>noun</i><br><ol><li>suitor, wooer</li></ol>
frajt	<i>noun</i><br><ol><li>friendship</li></ol>
fraoj|fraoja	<i>noun</i><br><ol><li>an adult female, a woman</li><li>one's wife</li><li>a title of courtesy, equivalent to Mrs/Ms</li><li>lady, mistress</li></ol>
fremder	<i>adj</i><br><ol><li>foreign</li></ol>
fretaog	<i>noun</i><br><ol><li>Friday</li></ol>
friza|frīza	<i>noun</i><br><ol><li>malaria</li></ol>
fru̇ht|fru̇hta	<i>noun</i><br><ol><li>fruit (part of plant)</li></ol>
fryłiḱ	<i>adj</i><br><ol><li>happy, merry</li></ol>
fryś	<i>adj</i><br><ol><li>fresh</li></ol>
frög|frȫg	<i>noun</i><br><ol><li>question</li></ol>
fröst|frest|frȫst	<i>noun</i><br><ol><li>frost</li></ol>
frȧjd	<i>noun</i><br><ol><li>joy</li></ol>
fu	<i>prep</i><br><ol><li>from</li></ol>
fulgia	<i>verb</i><br><ol><li>to hear</li></ol>
fulḱ|felkjyn	<i>noun</i><br><ol><li>people</li></ol>
funfcao	<i>num</i><br><ol><li>fifteen</li></ol>
funt	<i>noun</i><br><ol><li>pound (unit of either weight or currency)</li></ol>
fynf	<i>num</i><br><ol><li>five</li></ol>
fyngier	<i>noun</i><br><ol><li>finger</li></ol>
fyrrȫta	<i>verb</i><br><ol><li>to betray</li></ol>
fyłn	<i>noun</i><br><ol><li>foal, colt</li></ol>
föguł|fygieła|fygln|fȫguł	<i>noun</i><br><ol><li>bird</li></ol>
föł|fȫł|fyłn	<i>noun</i><br><ol><li>stake</li></ol>
füks|füksa	<i>noun</i><br><ol><li>fox</li></ol>
für	
fürcymer	<i>noun</i><br><ol><li>corridor</li></ol>
fürmaon	<i>noun</i><br><ol><li>coachman, wagoner, carter</li></ol>
füs|fisa	<i>noun</i><br><ol><li>foot</li></ol>
fādermassela	<i>noun</i><br><ol><li>penknife</li></ol>
fāt|fādła|fād	<i>noun</i><br><ol><li>horse</li></ol>
fāła	<i>verb</i><br><ol><li>to lack</li><li>to be absent</li></ol>
fłanc|fłanca	<i>noun</i><br><ol><li>plant (living organism)</li></ol>
fłaojm|fłaojmła	<i>noun</i><br><ol><li>plum</li></ol>
fłaoks	<i>noun</i><br><ol><li>flax</li></ol>
fłasier	<i>noun</i><br><ol><li>butcher</li></ol>
fłaś	<i>noun</i><br><ol><li>meat</li><li>muscle</li></ol>
fłig|fłīǵ|fłigia	<i>noun</i><br><ol><li>(zoology) fly (insect)</li></ol>
fłigiapyłc	<i>noun</i><br><ol><li>fly agaric, Amanita muscaria (type of mushroom)</li></ol>
fłotermaojs	<i>noun</i><br><ol><li>bat (creature)</li></ol>
fłuch|fłyj	<i>noun</i><br><ol><li>flea</li></ol>
fłus|fłūs	<i>noun</i><br><ol><li>river</li></ol>
fłygel	<i>noun</i><br><ol><li>flail</li><li>wing</li><li>piano</li></ol>
fłücha	<i>verb</i><br><ol><li>to swear, to curse</li></ol>
fłüg	<i>noun</i><br><ol><li>plough, plow</li></ol>
fłȧjs	<i>noun</i><br><ol><li>diligence</li></ol>
fōn|fannła|fonna|fonn|fānła	<i>noun</i><br><ol><li>the flag (of a nation, organisation, etc); a banner</li><li>the noticeable smell of alcohol on one's breath</li></ol>
fȧjermōn	<i>noun</i><br><ol><li>fireman</li></ol>
fȧjerwēr	<i>noun</i><br><ol><li>fire brigade</li></ol>
fȧjǵ|fȧjgja	<i>noun</i><br><ol><li>fig</li></ol>
gajc|gȧjc	<i>noun</i><br><ol><li>avarice, stinginess</li></ol>
ganc	<i>adv</i><br><ol><li>entirely</li></ol>
gaon	<i>adv</i><br><ol><li>gladly</li></ol><br><i>verb</i><br><ol><li>to give</li></ol>
gaonn|gann	<i>verb</i><br><ol><li>to yawn, to gape</li></ol>
gaons|gens	<i>noun</i><br><ol><li>goose</li></ol>
gaoł	<i>adj</i><br><ol><li>yellow</li></ol>
gaołzyft	<i>noun</i><br><ol><li>jaundice</li></ol>
gaośt|gaośta	<i>noun</i><br><ol><li>barley, Hordeum vulgare</li></ol>
gatkja	<i>noun</i><br><ol><li>(plural only) undershorts, underpants</li></ol>
gerber|gerbyn	<i>noun</i><br><ol><li>tanner</li></ol>
giełd|giełdyn	<i>noun</i><br><ol><li>currency</li><li>money</li></ol>
gisa	<i>verb</i><br><ol><li>to pour</li></ol>
git	<i>noun</i><br><ol><li>goodness</li></ol>
giüen	<i>noun</i><br><ol><li>yarn</li></ol>
goss|gossa	<i>noun</i><br><ol><li>street</li></ol>
gost|gest	<i>noun</i><br><ol><li>guest</li></ol>
gowuł|gōwuł|gōwułn|gowułn	<i>noun</i><br><ol><li>fork</li><li>pitchfork</li><li>prong</li></ol>
gołł|gołła	<i>noun</i><br><ol><li>bile, gall</li></ol>
graob	<i>noun</i><br><ol><li>grave, tomb</li></ol>
grenn	<i>verb</i><br><ol><li>to cry</li></ol>
grin|grīn	<i>adj</i><br><ol><li>green</li></ol>
grob	<i>noun</i><br><ol><li>grave</li></ol>
gros|grōs	<i>noun</i><br><ol><li>grass</li></ol>
grus|grūs	<i>adj</i><br><ol><li>great</li><li>big</li></ol>
gryłł|gryłła	<i>noun</i><br><ol><li>cricket (insect of the family Gryllidae)</li><li>(archaic) hobby</li></ol>
grām	<i>noun</i><br><ol><li>grief</li></ol>
grōwa	<i>noun</i><br><ol><li>ditch</li><li>trench</li></ol><br><i>verb</i><br><ol><li>To dig</li><li>To burrow</li></ol>
grȧjn	<i>noun</i><br><ol><li>cry (shedding of tears)</li></ol>
guolgia	<i>noun</i><br><ol><li>gallows</li></ol>
gułd	<i>noun</i><br><ol><li>gold</li></ol>
gybaojd	<i>noun</i><br><ol><li>building</li></ol>
gybjyǵ	<i>noun</i><br><ol><li>a group of mountains, mountain range, mountains</li><li>geographical area containing mountains</li></ol>
gybünhyłferyn	<i>noun</i><br><ol><li>midwife</li></ol>
gybāt	<i>noun</i><br><ol><li>prayer</li></ol>
gybātbihła	<i>noun</i><br><ol><li>prayer book</li></ol>
gydychtnys	<i>noun</i><br><ol><li>memory</li></ol>
gyfattela	<i>noun</i><br><ol><li>weasel</li></ol>
gymöłd	<i>noun</i><br><ol><li>painting, picture</li></ol>
gyrycht|gyrychta	<i>noun</i><br><ol><li>court</li></ol>
gytrad	<i>noun</i><br><ol><li>cereal, grain, crop</li></ol>
gytrenḱ	<i>noun</i><br><ol><li>drink</li></ol>
gytłiḱ	<i>adj</i><br><ol><li>divine, godly</li></ol>
gywełn	<i>noun</i><br><ol><li>shop, store</li></ol>
gywier	<i>noun</i><br><ol><li>rifle</li></ol>
gywylk|gywylḱ|gywylkia	<i>noun</i><br><ol><li>cloud, a visible mass of condensed water droplets in the air</li></ol>
gyzeł|gyzełn	<i>noun</i><br><ol><li>journeyman</li></ol>
gyzycht|gyzychtyn	<i>noun</i><br><ol><li>face</li></ol>
gyzymp|gyzympa	<i>noun</i><br><ol><li>swamp, marsh, bog</li></ol>
gyłdera	<i>adj</i><br><ol><li>gold, golden</li></ol>
gyłenḱ|gyłenkja	<i>noun</i><br><ol><li>(anatomy) joint</li></ol>
gyłyk|gyłyḱ	<i>noun</i><br><ol><li>happiness</li><li>luck</li></ol>
gyłyklich	<i>adj</i><br><ol><li>happy</li><li>lucky, fortunate</li></ol>
gyśicht|gyśichta	<i>noun</i><br><ol><li>history</li><li>event</li><li>novel</li></ol>
gügel	<i>noun</i><br><ol><li>(anatomy) throat, pharynx</li></ol>
güt	<i>adj</i><br><ol><li>good</li></ol><br><i>adv</i><br><ol><li>well</li></ol>
gātner|gātnyn	<i>noun</i><br><ol><li>gardener</li></ol>
gātneryn|gātnerynn	<i>noun</i><br><ol><li>female gardener.</li></ol>
gāłymela	<i>noun</i><br><ol><li>yellowhammer: A passerine bird, Emberiza citrinella, of Eurasia which is mainly yellow in colour.</li><li>yellowhammer: A native or resident of the American state of Alabama.</li></ol>
gāłzöft	<i>noun</i><br><ol><li>(pathology) jaundice</li></ol>
głaichmesig	<i>adj</i><br><ol><li>monotonous, uniform</li></ol>
głoos	<i>noun</i><br><ol><li>glass</li></ol>
głot|głōt	<i>adj</i><br><ol><li>smooth</li></ol><br><i>adv</i><br><ol><li>smoothly</li></ol>
gȧjcwonst|gȧjcwenst	<i>noun</i><br><ol><li>miser, skinflint</li></ol>
gȧjer	<i>noun</i><br><ol><li>vulture</li><li>(euphemistic) devil</li></ol>
gȧjst	<i>noun</i><br><ol><li>ghost (spirit appearing after death)</li><li>spirit</li></ol>
haas	<i>adj</i><br><ol><li>hot</li></ol>
hadra	<i>noun</i><br><ol><li>ragpicker</li></ol>
haltaog	<i>noun</i><br><ol><li>holiday</li></ol>
handuł	<i>noun</i><br><ol><li>trade (exchange)</li></ol>
handułn|handułt|gyhandułt	<i>verb</i><br><ol><li>to trade</li></ol>
haoc	<i>noun</i><br><ol><li>heart</li></ol>
haojer	<i>adv</i><br><ol><li>this year</li></ol>
haojt	<i>adv</i><br><ol><li>today</li></ol>
haond	<i>noun</i><br><ol><li>hand</li></ol>
harmonii	<i>noun</i><br><ol><li>harmony</li></ol>
hasa	<i>verb</i><br><ol><li>to hight; to be called</li></ol>
hee|heeia	<i>noun</i><br><ol><li>hay</li></ol>
hemd	<i>noun</i><br><ol><li>shirt</li></ol>
hetmon	<i>noun</i><br><ol><li>(chess) Queen.</li><li>Title used by the second-highest military commander in Poland and Lithuania (15th to 18th century).</li></ol>
hełcera	<i>adj</i><br><ol><li>wooden</li></ol>
hiewystmaontuł	<i>noun</i><br><ol><li>overcoat</li></ol>
hirś	<i>noun</i><br><ol><li>deer, stag</li></ol>
hiöt	<i>noun</i><br><ol><li>head</li></ol>
hjenc|hjenca	<i>noun</i><br><ol><li>hornet</li></ol>
hjēner|hjēnyn	<i>noun</i><br><ol><li>horn (of an animal)</li><li>(music) horn</li></ol>
hjēriḱ|hjērikja	<i>noun</i><br><ol><li>herring (fish)</li><li>tent peg</li></ol>
hjēwyst	<i>noun</i><br><ol><li>autumn, fall</li></ol>
hon	<i>verb</i><br><ol><li>to have</li></ol>
honnys	<i>noun</i><br><ol><li>anise</li></ol>
hoon	<i>noun</i><br><ol><li>rooster</li></ol>
hopp	<i>noun</i><br><ol><li>hop (Humulus lupulus)</li></ol>
hosp|hospa	<i>noun</i><br><ol><li>hasp</li></ol>
hotel	<i>noun</i><br><ol><li>hotel</li></ol>
houła	<i>verb</i><br><ol><li>To howl, to whine.</li></ol>
hoza|hāzła|hazła	<i>noun</i><br><ol><li>hare</li></ol>
hozułnūs|hozułnyss	<i>noun</i><br><ol><li>hazel, any tree or shrub of the genus Corylus, bearing edible nuts called hazelnuts or filberts.</li><li>hazel; The nut of the hazel tree.</li><li>hazel; The wood of a hazelnut tree.</li><li>hazel; A greenish-brown colour, the colour of a ripe hazelnut.</li></ol>
hołc|hałc	<i>noun</i><br><ol><li>neck</li></ol>
hołpander	<i>num</i><br><ol><li>one and a half</li></ol><br><i>adj</i><br><ol><li>pregnant</li></ol>
huch	<i>adj</i><br><ol><li>high, tall</li></ol>
humuł|humułn	<i>noun</i><br><ol><li>bumblebee</li></ol>
hunctāk|hunctāg	<i>noun</i><br><ol><li>dog days</li></ol>
hund	<i>noun</i><br><ol><li>dog</li></ol>
hundyt	<i>num</i><br><ol><li>hundred</li></ol>
hung	<i>noun</i><br><ol><li>honey</li></ol>
huć|hećła|hūć|hućia	<i>noun</i><br><ol><li>frog</li></ol>
hułc|hełcyn	<i>noun</i><br><ol><li>wood, timber</li></ol>
hułckoła	<i>noun</i><br><ol><li>(plural only) charcoal</li></ol>
hyc	<i>noun</i><br><ol><li>heat</li></ol>
hymuł	<i>noun</i><br><ol><li>sky, heaven</li><li>palate</li></ol>
hyndertȧl|hyndertȧln	<i>noun</i><br><ol><li>behind, hindquarter, butt</li></ol>
hyndła	<i>noun</i><br><ol><li>doggy</li></ol>
hytt|hytta|hyttła	<i>noun</i><br><ol><li>hut (primitive dwelling)</li></ol>
hywa|hȳwa	<i>noun</i><br><ol><li>yeast</li></ol>
hyłf	<i>noun</i><br><ol><li>help</li></ol>
hyłfer|hyłfyn	<i>noun</i><br><ol><li>helper</li></ol>
höfnan	<i>noun</i><br><ol><li>hope</li></ol>
höza|hȫza	<i>noun</i><br><ol><li>trousers</li></ol>
hüf|hüfa	<i>noun</i><br><ol><li>hoof</li></ol>
hün	<i>noun</i><br><ol><li>hen</li></ol>
hāmyt	<i>noun</i><br><ol><li>home, homeland</li><li>native country</li><li>home town, home village</li></ol>
hār	<i>adv</i><br><ol><li>hither, to this place, to here, to me/us</li></ol><br><i>pron</i><br><ol><li>he</li></ol><br><i>noun</i><br><ol><li>male (animal of masculine gender)</li></ol>
hās	<i>noun</i><br><ol><li>hatred, hate</li></ol>
hēgowuł|hēgowułn	<i>noun</i><br><ol><li>hay fork</li></ol>
hīrys	<i>noun</i><br><ol><li>hart, deer</li></ol>
hōn|honn	<i>noun</i><br><ol><li>cock, rooster</li></ol>
hōwer|hāwyn	<i>noun</i><br><ol><li>oat (cereal, plant of genus Avena and its seeds)</li></ol>
hōza|hāzła	<i>noun</i><br><ol><li>hare</li></ol>
hūh	<i>adj</i><br><ol><li>high, tall</li></ol>
hǡda	<i>noun</i><br><ol><li>buckwheat</li></ol>
hǡlikjȫwyt	<i>name</i><br><ol><li>Christmas Eve (day before Christmas Day)</li></ol>
hȫfāt	<i>noun</i><br><ol><li>socage</li></ol>
hȫka|hȳkla	<i>noun</i><br><ol><li>hook</li><li>catch, hitch (a concealed difficulty, especially in a deal or negotiation)</li><li>checkmark</li></ol>
hȫz	<i>noun</i><br><ol><li>leg (part of garment covering the leg)</li></ol>
hȳkla	<i>noun</i><br><ol><li>checkmark</li></ol>
ibercijer	<i>noun</i><br><ol><li>overcoat, topcoat</li></ol>
ibung	<i>noun</i><br><ol><li>instruction, exercise</li></ol>
imponiet	<i>verb</i><br><ol><li>impress</li></ol>
inkaojst	<i>noun</i><br><ol><li>ink</li></ol>
inžyniyr	<i>noun</i><br><ol><li>engineer</li></ol>
jałmu̇żna	<i>noun</i><br><ol><li>alms</li></ol>
jela|jēla	<i>noun</i><br><ol><li>alder, any tree of the genus Alnus</li></ol>
jemuł|jemułn	<i>noun</i><br><ol><li>sleeve</li></ol>
jer|jes|jeny	<i>pron</i><br><ol><li>that, that one</li></ol>
jugyt	<i>noun</i><br><ol><li>youth</li></ol>
jung	<i>adj</i><br><ol><li>young</li></ol>
jüd	<i>noun</i><br><ol><li>Jew</li></ol>
jür	<i>noun</i><br><ol><li>year</li></ol>
jāwer	<i>noun</i><br><ol><li>sycamore maple (Acer pseudoplatanus)</li></ol>
jēgjer|jēgjyn	<i>noun</i><br><ol><li>hunter</li></ol>
jū	<i>adv</i><br><ol><li>yes</li></ol><br><i>intj</i><br><ol><li>yes</li></ol>
kadet|kadeta	<i>noun</i><br><ol><li>cadet (student at a military school)</li></ol>
kaffer	<i>noun</i><br><ol><li>camphor</li></ol>
kafki|kafkja	<i>noun</i><br><ol><li>jackdaw</li></ol>
kafton	<i>noun</i><br><ol><li>kaftan</li></ol>
kafy	<i>noun</i><br><ol><li>coffee</li></ol>
kaksa	<i>verb</i><br><ol><li>to cluck</li></ol>
kalender|kalendyn	<i>noun</i><br><ol><li>calendar</li></ol>
kanap|kanapa	<i>noun</i><br><ol><li>sofa</li></ol>
kanapē	<i>noun</i><br><ol><li>sofa</li></ol>
kanarek|kanarkja	<i>noun</i><br><ol><li>canary (bird)</li></ol>
kaniür	<i>noun</i><br><ol><li>cannon</li></ol>
kaon|kaonn	<i>noun</i><br><ol><li>pip, seed</li></ol>
kaołder	<i>adj</i><br><ol><li>cold</li></ol>
kaplic|kaplica	<i>noun</i><br><ol><li>chapel</li></ol>
kaprol|kaproln	<i>noun</i><br><ol><li>(military) corporal</li></ol>
kardynaoł|kardynaołn	<i>noun</i><br><ol><li>cardinal (official in Catholic Church)</li><li>grosbeak, cardinal</li></ol>
kasaor	<i>noun</i><br><ol><li>(military) barracks</li></ol>
kasta|kastła	<i>noun</i><br><ol><li>chest (strong box)</li></ol>
katalög	<i>noun</i><br><ol><li>catalog, catalogue</li></ol>
kategorii	<i>noun</i><br><ol><li>category</li></ol>
katöłer|katöłyn	<i>noun</i><br><ol><li>Catholic (A member of a Catholic church)</li></ol>
kehjeryn	<i>noun</i><br><ol><li>female cook, a cooker</li></ol>
kejmbaok	<i>noun</i><br><ol><li>(anatomy) jaw</li></ol>
kemma	<i>verb</i><br><ol><li>to comb</li></ol>
kenna	<i>verb</i><br><ol><li>to know (be acquainted or familiar with)</li></ol>
kerper	<i>noun</i><br><ol><li>body</li><li>(mathematics) field</li></ol>
kełwercōn|kełwercyn	<i>noun</i><br><ol><li>milk tooth (tooth of the first set of teeth)</li></ol>
kilof	<i>noun</i><br><ol><li>pickaxe</li></ol>
kilö	<i>noun</i><br><ol><li>kilo, short form of kilogram (unit of mass equal to 1000 grams)</li></ol>
kilömeter|kilömetyn	<i>noun</i><br><ol><li>kilometer (US), kilometre (UK)</li></ol>
kiwic	<i>noun</i><br><ol><li>lapwing</li></ol>
kiych|kiychia	<i>noun</i><br><ol><li>church</li></ol>
kiychhöf	<i>noun</i><br><ol><li>cemetery, graveyard</li></ol>
kić|kićia	<i>noun</i><br><ol><li>cat</li></ol>
kjerot	<i>noun</i><br><ol><li>horse mill</li></ol>
kjyś|kjyśja	<i>noun</i><br><ol><li>sweet cherry</li></ol>
kjyśner|kjyśnyn	<i>noun</i><br><ol><li>furrier</li></ol>
kjȳmys|kjȳmysa	<i>noun</i><br><ol><li>fair (celebration)</li></ol>
kjȳt|ȧn|dy|ȧm|ym|der|yn|ȧ|kjȳta	<i>noun</i><br><ol><li>shepherd</li></ol>
klarnet|klarneta	<i>noun</i><br><ol><li>clarinet (musical instrument)</li></ol>
klass	<i>noun</i><br><ol><li>class</li></ol>
klin|klīn	<i>adj</i><br><ol><li>small</li></ol>
knaojf	<i>noun</i><br><ol><li>button</li></ol>
kni|knī	<i>noun</i><br><ol><li>knee</li></ol>
knöta|knȫta	<i>noun</i><br><ol><li>knot</li></ol>
knöwłoch	<i>noun</i><br><ol><li>garlic</li></ol>
knāta	<i>verb</i><br><ol><li>to knead</li></ol>
knīn	<i>verb</i><br><ol><li>to kneel (to rest on the knees)</li></ol>
koc|koca	<i>noun</i><br><ol><li>cat</li></ol>
koha|koht|gykoht	<i>verb</i><br><ol><li>to cook</li><li>to boil (cook in boiling water)</li><li>to boil (begin to turn into a gas)</li></ol>
koma	<i>noun</i><br><ol><li>horse collar</li></ol>
komp|kemp	<i>noun</i><br><ol><li>comb</li></ol>
kompanī|kompanija	<i>noun</i><br><ol><li>A group of individuals, created by law or under authority of law, having a continuous existence independent of the existences of its members, and powers and liabilities distinct from those of its members.</li><li>company (companionship)</li><li>(military) company</li></ol>
konduktör|konduktörn	<i>noun</i><br><ol><li>conductor (public transportation person)</li></ol>
konn|konna|konnła	<i>noun</i><br><ol><li>watering can</li></ol>
kopyt|kopyta	<i>noun</i><br><ol><li>hoof</li></ol>
kora	<i>noun</i><br><ol><li>punishment</li></ol>
korespondent	<i>noun</i><br><ol><li>correspondent (“journalist”)</li></ol>
korǡn	<i>verb</i><br><ol><li>punish</li></ol>
kołb	<i>noun</i><br><ol><li>Synonym of kołp</li></ol>
kołp|kełwyn	<i>noun</i><br><ol><li>calf</li></ol>
kołtu̇n	<i>noun</i><br><ol><li>Polish plait</li></ol>
kołw|kołwa	<i>noun</i><br><ol><li>heifer</li></ol>
krajd	<i>noun</i><br><ol><li>chalk</li></ol>
kraoft|krefta	<i>noun</i><br><ol><li>strength</li></ol>
krawōt	<i>noun</i><br><ol><li>Croat</li></ol>
krejn	<i>noun</i><br><ol><li>horseradish</li></ol>
krig|krigia	<i>noun</i><br><ol><li>war</li></ol>
krojc|krojcła	<i>noun</i><br><ol><li>cross</li><li>(anatomy) sacrum</li></ol>
krojcer	<i>noun</i><br><ol><li>medieval silver coin and unit of currency</li></ol>
krojcigia	<i>verb</i><br><ol><li>to cross</li><li>to crossbreed</li></ol>
kröp|krypła|kryp	<i>noun</i><br><ol><li>goitre</li><li>struma</li></ol>
kröst|krystła|krösta	<i>noun</i><br><ol><li>crust</li><li>scab</li></ol>
kröw|kröwa|krȫwa|krȫw	<i>noun</i><br><ol><li>crow</li></ol>
krüg|krigla|krigia|krig	<i>noun</i><br><ol><li>jug</li></ol>
krāwys	<i>noun</i><br><ol><li>cancer (disease)</li><li>crayfish (term also used for certain other crustaceans)</li></ol>
krȫm	<i>noun</i><br><ol><li>small shop</li></ol>
krȫp|krȳpła|krȳp|kryp	<i>noun</i><br><ol><li>goitre</li><li>struma</li></ol>
krȫwabjer|krȫwabjern	<i>noun</i><br><ol><li>lingonberry, cowberry</li></ol>
krȳt	<i>noun</i><br><ol><li>toad</li></ol>
kultür	<i>noun</i><br><ol><li>culture</li></ol>
kunst	<i>noun</i><br><ol><li>art</li></ol>
ku̇ku̇k	<i>noun</i><br><ol><li>cuckoo, Cuculus canorus</li></ol>
kwamuł|kwāmuł	<i>noun</i><br><ol><li>thyme; any plant of the genus Thymus</li></ol>
kwaoł|kwaołn	<i>noun</i><br><ol><li>source</li><li>spring (water source)</li></ol>
kwāk|kwāka	<i>noun</i><br><ol><li>rutabaga, swede</li></ol>
kwȫł	<i>noun</i><br><ol><li>heartburn</li></ol>
kych|kychia|kychła	<i>noun</i><br><ol><li>kitchen</li><li>cuisine</li></ol>
kynd|kyndyn	<i>noun</i><br><ol><li>child</li></ol>
kynela	<i>noun</i><br><ol><li>cuff</li></ol>
kyng	<i>noun</i><br><ol><li>king</li></ol>
kyngel	<i>noun</i><br><ol><li>rabbit</li></ol>
kyngrajch	<i>noun</i><br><ol><li>kingdom</li></ol>
kysła	<i>noun</i><br><ol><li>pillow</li></ol>
kyyt|kyyta	<i>noun</i><br><ol><li>chain</li></ol>
köc|köca	<i>noun</i><br><ol><li>blanket</li></ol>
köch|kech	<i>noun</i><br><ol><li>cook</li></ol>
köła|kȫła	<i>noun</i><br><ol><li>coal</li></ol>
kü	<i>noun</i><br><ol><li>cow</li></ol>
kültür|kültüra	<i>noun</i><br><ol><li>culture</li></ol>
kāłer|kāłyn	<i>noun</i><br><ol><li>cellar</li><li>basement</li></ol>
kāłt	<i>adv</i><br><ol><li>cold (having a low temperature)</li></ol>
kłaja|kłȧja	<i>noun</i><br><ol><li>bran</li></ol>
kłatt|kłatta	<i>noun</i><br><ol><li>burdock, any of several flowering plants of the genus Arctium</li></ol>
kłej|kłeja	<i>noun</i><br><ol><li>clover (plant)</li></ol>
kłofer	<i>noun</i><br><ol><li>rattle, any plant of the genus Rhinanthus</li></ol>
kłuks	<i>noun</i><br><ol><li>brood-hen</li></ol>
kłöfter	<i>noun</i><br><ol><li>fathom</li><li>cord (4 cubic metres of wood)</li></ol>
kłūster|kłȳstyn	<i>noun</i><br><ol><li>monastery, convent</li></ol>
kłǡt|kłȧdyn	<i>noun</i><br><ol><li>dress</li><li>apparel</li></ol>
kłȧderōmer|kłȧderōmyn	<i>noun</i><br><ol><li>wardrobe</li></ol>
kōter|kōtyn	<i>noun</i><br><ol><li>tomcat (male cat)</li></ol>
kōł	<i>adj</i><br><ol><li>Having no hair, fur or feathers.</li><li>Having no hair on the head.</li></ol>
kȧjhja	<i>verb</i><br><ol><li>to gasp</li><li>to pant</li></ol>
kȫwuł|kȫwułn	<i>noun</i><br><ol><li>mare (adult female horse)</li></ol>
kȳt|kȳta	<i>noun</i><br><ol><li>chain</li></ol>
kȳz	<i>noun</i><br><ol><li>cheese</li></ol>
lajbik|lajbla|lȧjbiḱ	<i>noun</i><br><ol><li>waistcoat, vest</li></ol>
lerm	<i>noun</i><br><ol><li>noise</li></ol>
lilija	<i>noun</i><br><ol><li>lily</li></ol>
ljyhła	<i>noun</i><br><ol><li>skylark</li></ol>
ljȳkja	<i>noun</i><br><ol><li>remedy</li></ol>
lokomotiw|lokomotīw	<i>noun</i><br><ol><li>locomotive</li></ol>
lȧjzer	<i>noun</i><br><ol><li>tuberculosis (infectious disease)</li></ol>
ma	<i>pron</i><br><ol><li>(indefinite) one, they (indefinite third-person singular pronoun)</li></ol>
maha	<i>verb</i><br><ol><li>(transitive) to do or make</li></ol>
mahha	<i>verb</i><br><ol><li>to make</li><li>to do</li></ol>
maj	<i>noun</i><br><ol><li>May</li></ol>
maja	<i>noun</i><br><ol><li>May</li></ol>
makia	<i>noun</i><br><ol><li>girl</li></ol>
malīn|malīna	<i>noun</i><br><ol><li>raspberry</li></ol>
mandułkān|mandułkann	<i>noun</i><br><ol><li>almond</li><li>(anatomy, in brain) amygdala</li><li>(anatomy, in throat) tonsil</li></ol>
maocha	
maoga	<i>noun</i><br><ol><li>stomach</li></ol>
maojer	<i>noun</i><br><ol><li>wall</li></ol>
maojs	<i>noun</i><br><ol><li>mouse</li></ol>
maontuł	<i>noun</i><br><ol><li>coat, overcoat</li></ol>
maoser	<i>noun</i><br><ol><li>knife</li></ol>
maoł	<i>noun</i><br><ol><li>flour</li></ol>
masty	<i>adj</i><br><ol><li>most</li></ol>
małp	<i>noun</i><br><ol><li>monkey, ape</li></ol>
mejtwaoch	<i>noun</i><br><ol><li>Wednesday</li></ol>
merder|merdyn	<i>noun</i><br><ol><li>murderer</li></ol>
mess	<i>noun</i><br><ol><li>brass</li></ol>
mieca	<i>noun</i><br><ol><li>March</li></ol>
mien	<i>noun</i><br><ol><li>carrot</li></ol>
mikieła	<i>adv</i><br><ol><li>(a) bit, (a) little</li></ol>
miök	<i>noun</i><br><ol><li>marrow</li></ol>
mjynta	<i>noun</i><br><ol><li>mint, any plant of genus Mentha</li></ol>
mojjeliḱ|mojjelikja	<i>noun</i><br><ol><li>mason</li></ol>
mulkiadrymuł|mulkiadrymułn	<i>noun</i><br><ol><li>butterfly</li></ol>
myc	<i>noun</i><br><ol><li>cap</li></ol>
myk|mykla	<i>noun</i><br><ol><li>mosquito</li></ol>
mynich|mynichia	<i>noun</i><br><ol><li>monk</li></ol>
mysper|myspyn	<i>noun</i><br><ol><li>stretcher</li></ol>
myt	<i>prep</i><br><ol><li>with</li></ol>
mytuł	<i>noun</i><br><ol><li>middle</li></ol>
myłc	<i>noun</i><br><ol><li>(anatomy) spleen</li></ol>
myłich	<i>noun</i><br><ol><li>milk</li></ol>
myłm|myłma	<i>noun</i><br><ol><li>moth</li></ol>
myłner|myłnyn	<i>noun</i><br><ol><li>miller (owner or operator of a mill)</li></ol>
möntaog	<i>noun</i><br><ol><li>Monday</li></ol>
möss	<i>noun</i><br><ol><li>measure</li></ol>
möłer|mȫłer|möłyn	<i>noun</i><br><ol><li>painter</li></ol>
möłeryn	<i>noun</i><br><ol><li>painter</li></ol>
mütter	<i>noun</i><br><ol><li>mother</li></ol>
müzik	<i>noun</i><br><ol><li>music</li></ol>
māht	<i>noun</i><br><ol><li>might, power</li></ol>
mǡjkefer|mǡjkefyn	<i>noun</i><br><ol><li>cockchafer</li></ol>
mȧjł|mȧjłn	<i>noun</i><br><ol><li>mile</li></ol>
mȧld|mȧlda	<i>noun</i><br><ol><li>Atriplex</li></ol>
mȧlkja	<i>verb</i><br><ol><li>to milk (a cow)</li></ol>
mȧlter	<i>noun</i><br><ol><li>(masonry) mortar: A mixture of lime or cement, sand and water used for bonding bricks and stones.</li></ol>
nagȧna	<i>noun</i><br><ol><li>A severe, formal or official reproof; reprehension, rebuke, private or public.</li></ol>
naocht|naochta	<i>noun</i><br><ol><li>night</li></ol>
naojn	<i>num</i><br><ol><li>nine</li></ol>
naoka	<i>noun</i><br><ol><li>nape</li></ol>
naokyt	<i>adj</i><br><ol><li>naked, bare, nude</li></ol>
naost	<i>noun</i><br><ol><li>nest</li></ol>
naowuł	<i>noun</i><br><ol><li>fog, mist</li></ol>
ness|nessa	<i>noun</i><br><ol><li>rainy weather</li><li>wetness</li></ol>
nimanda	<i>pron</i><br><ol><li>nobody, no one</li></ol>
nisa	<i>verb</i><br><ol><li>to sneeze</li></ol>
nist	<i>pron</i><br><ol><li>nothing</li></ol>
niynt	<i>adv</i><br><ol><li>nowhere</li></ol>
nocht	<i>noun</i><br><ol><li>night</li></ol>
noma|nōma	<i>noun</i><br><ol><li>name</li></ol>
nomastaog	<i>noun</i><br><ol><li>name day</li></ol>
noss	<i>adj</i><br><ol><li>wet</li></ol><br><i>adv</i><br><ol><li>wetly</li></ol>
nowuł|nowułn|nōwuł	<i>noun</i><br><ol><li>navel</li></ol>
ny	<i>intj</i><br><ol><li>no</li></ol>
ny moh nist cy byhend, do der daj at ny śent|ny moh nist cy byhend|do der daj at ny śent	<i>proverb</i><br><ol><li>haste makes waste</li></ol>
nyn	<i>verb</i><br><ol><li>to sew</li><li>to stitch</li></ol>
nökwer|nökwyn	<i>noun</i><br><ol><li>neighbour</li></ol>
nönd|nȫnd	<i>adv</i><br><ol><li>near</li></ol>
nöt|nöta	<i>noun</i><br><ol><li>seam</li></ol>
nöłd	<i>noun</i><br><ol><li>needle</li></ol>
nāhtwȧhter|nāhtwȧhtyn	<i>noun</i><br><ol><li>night watchman</li></ol>
nōs	<i>noun</i><br><ol><li>(anatomy) nose</li></ol>
nōz|nōza	<i>noun</i><br><ol><li>(anatomy) nose</li></ol>
nōłd|nōłda	<i>noun</i><br><ol><li>awl</li></ol>
nǡǵ	<i>noun</i><br><ol><li>slope</li></ol>
nȧgwer|nȧgwyn	<i>noun</i><br><ol><li>auger</li></ol>
obfjȳn	<i>noun</i><br><ol><li>diarrhea, diarrhoea</li></ol>
obros|obrozła	<i>noun</i><br><ol><li>picture</li></ol>
ocacha	<i>noun</i><br><ol><li>feature, property, trait</li></ol>
odaonka	<i>noun</i><br><ol><li>abdication</li></ol>
oduł|ōduł|odułn|ōdułn	<i>noun</i><br><ol><li>eagle</li></ol>
ofaong	<i>noun</i><br><ol><li>beginning</li></ol>
ohȧjm	<i>noun</i><br><ol><li>(archaic) uncle being a brother or brother-in-law of someone’s mother.</li></ol>
ok	<i>conj</i><br><ol><li>only, to</li></ol>
olifant|olifanta	<i>noun</i><br><ol><li>elephant</li></ol>
ona	<i>prep</i><br><ol><li>without, lacking</li></ol>
ondenkia	<i>noun</i><br><ol><li>keepsake, souvenir, memento</li></ol>
ornot	<i>noun</i><br><ol><li>vestment: Any of the robes worn by members of the clergy etc., especially a garment worn at the celebration of the Eucharist.</li></ol>
osp|ospa	<i>noun</i><br><ol><li>aspen</li></ol>
ost	<i>noun</i><br><ol><li>bough, branch</li></ol>
ołły	<i>pron</i><br><ol><li>all</li></ol>
ołłys	<i>pron</i><br><ol><li>everything</li></ol>
oś	<i>noun</i><br><ol><li>ash (solid remains of a fire)</li></ol>
pach	<i>noun</i><br><ol><li>tar</li></ol>
paojk|paojka	<i>noun</i><br><ol><li>drum</li></ol>
paot	<i>noun</i><br><ol><li>godfather</li></ol>
papp|pappa	<i>noun</i><br><ol><li>muzzle (of a cow)</li></ol>
paradīs	<i>noun</i><br><ol><li>paradise</li></ol>
parafȳj	<i>noun</i><br><ol><li>parish</li></ol>
pałac	<i>noun</i><br><ol><li>palace</li></ol>
pella	<i>noun</i><br><ol><li>pearl</li></ol>
pełc|pełcła	<i>noun</i><br><ol><li>fur</li><li>pelt</li><li>hide</li></ol>
pik	<i>noun</i><br><ol><li>spear</li></ol>
pilla	<i>noun</i><br><ol><li>penis</li></ol>
pistöł	<i>noun</i><br><ol><li>pistol, gun</li></ol>
pić|pićła	<i>noun</i><br><ol><li>vulva</li></ol>
poem	<i>noun</i><br><ol><li>poem</li></ol>
pojer|pojyn	<i>noun</i><br><ol><li>farmer</li></ol>
polityk	<i>noun</i><br><ol><li>politics</li></ol>
popst	<i>noun</i><br><ol><li>pope</li></ol>
prałāt	<i>noun</i><br><ol><li>prelate</li></ol>
pressa	<i>verb</i><br><ol><li>to press, to compress</li></ol>
problem	<i>noun</i><br><ol><li>problem</li></ol>
profesor	<i>noun</i><br><ol><li>professor</li></ol>
prydik|prydikia	<i>noun</i><br><ol><li>sermon</li></ol>
prydikia|geprydikt|prydikt	<i>verb</i><br><ol><li>to order, to tell</li></ol>
prydikśtül	<i>noun</i><br><ol><li>pulpit</li></ol>
prync|prynca	<i>noun</i><br><ol><li>prince</li><li>duke</li></ol>
pryncesyn	<i>noun</i><br><ol><li>princess</li><li>duchess</li></ol>
prāht	<i>noun</i><br><ol><li>splendor, magnificence</li><li>resplendence</li></ol>
pstrong	<i>noun</i><br><ol><li>trout (fish)</li></ol>
putter	<i>noun</i><br><ol><li>butter</li></ol>
puttynystyn	<i>noun</i><br><ol><li>rosary</li><li>necklace</li></ol>
puś|pūś|pyś	<i>noun</i><br><ol><li>forest</li></ol>
pu̇stelnik|pu̇stelnika	<i>noun</i><br><ol><li>hermit</li></ol>
pyłwajs	<i>noun</i><br><ol><li>witch, hag</li></ol>
pönyś|pȫnyś	<i>adj</i><br><ol><li>Polish (of, from or native to Poland, or relating to the Polish language)</li></ol><br><i>name</i><br><ol><li>Polish (language)</li></ol>
pössa	<i>verb</i><br><ol><li>kiss</li></ol>
pöst|pösta	<i>noun</i><br><ol><li>post, mail</li><li>post office</li></ol>
pöstcuk	<i>noun</i><br><ol><li>mail train</li></ol>
pöstkiöt	<i>noun</i><br><ol><li>postcard</li></ol>
pöstmaster|pöstmastyn	<i>noun</i><br><ol><li>postmaster</li></ol>
pütca	<i>verb</i><br><ol><li>to clean</li></ol>
płent|płenta	<i>noun</i><br><ol><li>dress, gown</li><li>skirt</li></ol>
płoc|płacc|płōc	<i>noun</i><br><ol><li>a flat cake</li><li>kalach</li></ol>
płon|plann	<i>noun</i><br><ol><li>square</li><li>place, site, scene</li><li>room, space</li></ol>
pōpuł|pōpułn	<i>noun</i><br><ol><li>poplar</li></ol>
pōt|pōta	<i>noun</i><br><ol><li>godfather</li><li>godmother</li></ol>
pōtakyndyn	<i>noun</i><br><ol><li>godchild</li></ol>
pōtakynt|pōtakyndyn	<i>noun</i><br><ol><li>godchild</li></ol>
pōtyn	<i>noun</i><br><ol><li>godmother</li></ol>
pōw|pōwa	<i>noun</i><br><ol><li>peacock</li></ol>
raan	<i>noun</i><br><ol><li>rain</li></ol><br><i>adj</i><br><ol><li>clean</li></ol>
rajf|rȧjf	<i>noun</i><br><ol><li>hoarfrost</li></ol><br><i>adj</i><br><ol><li>ripe</li><li>mature</li></ol>
raod|rȳdyn	<i>noun</i><br><ol><li>wheel</li></ol>
raojp	<i>noun</i><br><ol><li>caterpillar</li></ol>
raom|raoma|raomła	<i>noun</i><br><ol><li>frame</li></ol>
raubhün	<i>noun</i><br><ol><li>partridge</li></ol>
rebełłer|rebełłyn	<i>noun</i><br><ol><li>rebel</li></ol>
regiment	<i>noun</i><br><ol><li>(military) regiment</li></ol>
rejw	<i>noun</i><br><ol><li>rib</li></ol>
rejła	<i>noun</i><br><ol><li>deer, roe deer</li></ol>
rekru̇t|rekru̇ta	<i>noun</i><br><ol><li>recruit</li></ol>
retta	<i>noun</i><br><ol><li>rescue, help</li></ol><br><i>verb</i><br><ol><li>to rescue</li><li>to save (somebody)</li></ol>
rezydenc	<i>noun</i><br><ol><li>residence</li><li>capital</li></ol>
riima	<i>verb</i><br><ol><li>to glorify</li><li>to praise</li></ol>
rima|rīma	<i>noun</i><br><ol><li>belt (band worn around the waist)</li><li>strap</li></ol>
rips	<i>noun</i><br><ol><li>rapeseed (Brassica napus)</li></ol>
risuł|risułn	<i>noun</i><br><ol><li>snout (long, projecting nose, mouth and jaw of a beast)</li></ol>
ritter|rittyn	<i>noun</i><br><ol><li>knight</li></ol>
rjȳriḱ	<i>noun</i><br><ol><li>cane brake</li></ol>
rot|rōt|rota	<i>noun</i><br><ol><li>installment (a kind of payment)</li></ol>
rott|rotta	<i>noun</i><br><ol><li>rat (rodent)</li></ol>
row|rōw|rowa|rōwa	<i>noun</i><br><ol><li>rook (bird)</li><li>raven</li></ol>
roza|rōza	<i>noun</i><br><ol><li>sod</li><li>lawn</li></ol>
rozinki|rozinkja	<i>noun</i><br><ol><li>raisin</li></ol>
rozynki|rozynkja	<i>noun</i><br><ol><li>raisin</li></ol>
rut|rūt	<i>adj</i><br><ol><li>red</li></ol>
ruu	<i>adj</i><br><ol><li>unprocessed; raw; crude</li><li>(figuratively) rough; rude</li></ol>
ruuz|rūza	<i>noun</i><br><ol><li>rose (shrub)</li></ol>
rychter|rychtyn	<i>noun</i><br><ol><li>judge</li></ol>
rychteryn	<i>noun</i><br><ol><li>female judge</li></ol>
rycyż	<i>noun</i><br><ol><li>knight (warrior, especially of the Middle Ages)</li></ol>
ryd|rȳd	<i>noun</i><br><ol><li>speech</li></ol>
ryda|rȳda	<i>verb</i><br><ol><li>to talk</li></ol>
ryk	<i>noun</i><br><ol><li>back</li></ol>
rynd	<i>noun</i><br><ol><li>bull, ox</li></ol>
ryndfłaś	<i>noun</i><br><ol><li>beef</li></ol>
ryś	<i>adj</i><br><ol><li>early</li></ol><br><i>adv</i><br><ol><li>early</li></ol>
ryź	<i>noun</i><br><ol><li>rice</li></ol>
röcc	<i>noun</i><br><ol><li>glanders: An infectious disease of horses, mules and donkeys caused by the bacterium Burkholderia, one species of which may be transmitted to humans.</li></ol>
rög|röga|rȫg	<i>noun</i><br><ol><li>(anatomy) calf</li></ol>
röt|rȫt	<i>noun</i><br><ol><li>advice</li><li>council</li></ol>
röter|rȫter|rötyn	<i>noun</i><br><ol><li>advisor</li></ol>
röök	<i>noun</i><br><ol><li>skirt</li></ol>
rü	<i>noun</i><br><ol><li>peace, calm</li></ol>
rīma	<i>noun</i><br><ol><li>belt (band worn around the waist)</li></ol><br><i>verb</i><br><ol><li>to praise</li></ol>
rīze	<i>noun</i><br><ol><li>giant (mythical creature)</li><li>giant (a large person)</li><li>giant (a large object or animal)</li></ol>
rǡnabȫga	<i>noun</i><br><ol><li>rainbow</li></ol>
rǡs|rǡsa	<i>noun</i><br><ol><li>journey, travel, trip</li></ol>
rǡsa	<i>verb</i><br><ol><li>to travel</li><li>to irritate</li></ol>
rǡć|rǡćja	<i>noun</i><br><ol><li>cloven hoof</li></ol>
rȧjter|rȧjtyn	<i>noun</i><br><ol><li>rider (one who rides (a horse))</li></ol>
rȧjz|rȧjzyn	<i>noun</i><br><ol><li>branch</li></ol>
rȫta|rött|gyrött	<i>verb</i><br><ol><li>to advise; to recommend</li><li>to guess</li></ol>
rȳdner	<i>noun</i><br><ol><li>(one who makes a speech) speaker</li></ol>
rȳmiś	<i>adj</i><br><ol><li>Roman</li></ol>
rȳmiś-katöliś	<i>adj</i><br><ol><li>Roman Catholic</li></ol>
sakrament	<i>noun</i><br><ol><li>sacrament</li></ol>
salniter	<i>noun</i><br><ol><li>niter, saltpeter (US); nitre, saltpetre (UK)</li></ol>
seler	<i>noun</i><br><ol><li>celery</li></ol>
shocka	<i>noun</i><br><ol><li>tryst, clandestine meeting</li></ol>
signal|signale	<i>noun</i><br><ol><li>signal</li></ol>
siöf	<i>noun</i><br><ol><li>sheep</li></ol>
siłer|siłyn	<i>noun</i><br><ol><li>teacher</li></ol>
siłeryn	<i>noun</i><br><ol><li>a female teacher</li></ol>
skāł	<i>noun</i><br><ol><li>rock</li></ol>
sond|sonda	<i>noun</i><br><ol><li>court of law</li></ol>
stüdent	<i>noun</i><br><ol><li>student</li></ol>
su̇ka	<i>noun</i><br><ol><li>bitch (female dog or other canine), especially one who has recently had puppies.</li></ol>
syster	<i>noun</i><br><ol><li>sister</li></ol>
taag	<i>noun</i><br><ol><li>dough</li></ol>
tabak	<i>noun</i><br><ol><li>the tobacco plant</li><li>tobacco, the product made from leaves of certain of its varieties, to be smoked in cigars etc., sniffed or chewed</li></ol>
tanc|tenc	<i>noun</i><br><ol><li>dance</li></ol>
tanca	<i>verb</i><br><ol><li>to dance</li></ol>
tant	<i>noun</i><br><ol><li>aunt</li></ol>
taog	<i>noun</i><br><ol><li>day</li></ol>
taonc|tenc|taonca	<i>noun</i><br><ol><li>dance</li></ol>
tejś|tyś	<i>noun</i><br><ol><li>table</li></ol>
telegraf	<i>noun</i><br><ol><li>telegraph</li></ol>
telegram	<i>noun</i><br><ol><li>telegram, wire</li></ol>
temperatür	<i>noun</i><br><ol><li>temperature</li></ol>
tepper|teppyn	<i>noun</i><br><ol><li>potter</li></ol>
tełłer|tełer|tełłyn	<i>noun</i><br><ol><li>plate</li></ol>
tiykiš	<i>adj</i><br><ol><li>Turkish</li></ol>
tjēr	<i>noun</i><br><ol><li>tar</li></ol>
toffer|toffyn	
tohter|tohtyn	<i>noun</i><br><ol><li>daughter</li></ol>
tojfuł|tojfułn	<i>noun</i><br><ol><li>devil</li></ol>
tok|takla|toka	<i>noun</i><br><ol><li>doll</li></ol>
tonn|tonna	<i>noun</i><br><ol><li>fir</li></ol>
trihter	<i>noun</i><br><ol><li>funnel</li></ol>
tromba	<i>noun</i><br><ol><li>trumpet</li></ol>
trumyt|trumyta	<i>noun</i><br><ol><li>trumpet (musical instrument)</li></ol>
trynkja	<i>verb</i><br><ol><li>to drink</li></ol>
tröjer	<i>noun</i><br><ol><li>porter</li></ol>
trȫk|trȳǵ	<i>noun</i><br><ol><li>A trough (for cattle)</li><li>(geology) A trench (often filled with sediments)</li></ol>
trȫn|trönn	<i>noun</i><br><ol><li>coffin</li></ol>
tut|tūt	<i>noun</i><br><ol><li>death</li></ol>
tutagrywer|tūtagrȳwer	<i>noun</i><br><ol><li>gravedigger</li></ol>
twiöeg	<i>noun</i><br><ol><li>quark (cheese)</li></ol>
tyfus	<i>noun</i><br><ol><li>typhus</li></ol>
typa|typła	<i>noun</i><br><ol><li>A pot: a vessel used for cooking food.</li></ol>
tyy	<i>noun</i><br><ol><li>tea</li></ol>
tyłł	<i>noun</i><br><ol><li>dill</li></ol>
tyśłer|tyśłyn	<i>noun</i><br><ol><li>carpenter</li></ol>
töcht|tȫht	<i>noun</i><br><ol><li>wick</li></ol>
töp|tȫp	<i>noun</i><br><ol><li>pot (cookware)</li></ol>
tür	<i>noun</i><br><ol><li>gate</li></ol>
tōłer|tōłyn	<i>noun</i><br><ol><li>taler (Germanic unit of currency used between the 15th and 19th centuries)</li></ol>
tūgyt	<i>noun</i><br><ol><li>virtue</li></ol>
tȧncer|tȧncyn	<i>noun</i><br><ol><li>(male) dancer</li></ol>
tȧnceryn|tȧncerynna	<i>noun</i><br><ol><li>(female) dancer</li></ol>
tȧnister|tȧnistyn	<i>noun</i><br><ol><li>knapsack</li></ol>
tȳbłōt|tȳbłōtyn	<i>noun</i><br><ol><li>tea leaf</li></ol>
uf|u̇f	<i>prep</i><br><ol><li>on</li><li>onto</li></ol>
ufa	<i>adj</i><br><ol><li>open</li></ol>
uwa	<i>noun</i><br><ol><li>oven</li></ol><br><i>adv</i><br><ol><li>in advance</li></ol>
u̇fbrȧhja	<i>verb</i><br><ol><li>burst, open</li></ol>
waas	<i>noun</i><br><ol><li>wheat</li><li>orphan</li></ol>
wachter|wachtyn	<i>noun</i><br><ol><li>guard</li></ol>
waganc	<i>noun</i><br><ol><li>(plural only) holiday/holidays (a period of one or more days taken off work by an employee for leisure)</li><li>(plural only) vacation</li></ol>
wagōn	<i>noun</i><br><ol><li>car (a railway carriage, a nonpowered unit in a railroad train)</li></ol>
wajd|wȧjd|wajda|wajdła	<i>noun</i><br><ol><li>willow, any tree of the genus Salix</li></ol>
wajn|wȧjn	<i>noun</i><br><ol><li>wine</li></ol>
wajnbier	<i>noun</i><br><ol><li>grape</li></ol>
wajs|wȧjs	<i>adj</i><br><ol><li>white</li></ol><br><i>adv</i><br><ol><li>whitely</li></ol>
waond|wenda	<i>noun</i><br><ol><li>wall</li></ol>
waor	<i>pron</i><br><ol><li>who</li></ol>
waos	<i>pron</i><br><ol><li>what</li></ol>
warr|warra	<i>noun</i><br><ol><li>mole cricket, any of various large insects from the family Gryllotalpidae that burrow into moist soil and feed on plant roots.</li></ol>
wat	<i>noun</i><br><ol><li>cotton wool</li></ol>
wawer	<i>noun</i><br><ol><li>weaver (person who weaves)</li></ol>
weksuł|weksułn	<i>noun</i><br><ol><li>promissory note</li></ol>
weksułn	
wesieryn	<i>noun</i><br><ol><li>washerwoman</li></ol>
wesp|wespa	<i>noun</i><br><ol><li>wasp</li></ol>
wełt	<i>noun</i><br><ol><li>world</li></ol>
wi	
wienikiel	<i>noun</i><br><ol><li>stye (a bacterial infection on an eyelid or eyelash)</li></ol>
wiig|wiigia	<i>noun</i><br><ol><li>cradle, bassinet</li></ol>
wikār	<i>noun</i><br><ol><li>vicar</li></ol>
wing	<i>adj</i><br><ol><li>little (by amount)</li></ol>
wistela	<i>noun</i><br><ol><li>redstart</li></ol>
wjēmyt	<i>noun</i><br><ol><li>vermouth</li><li>wormwood</li></ol>
wjȳgja	<i>verb</i><br><ol><li>to strangle</li><li>to gag</li><li>to retch</li></ol>
woch|wocha	<i>noun</i><br><ol><li>week</li></ol>
woh|woha	<i>noun</i><br><ol><li>week</li></ol>
wonn|wannła	<i>noun</i><br><ol><li>tub</li></ol>
wons	<i>noun</i><br><ol><li>moustache</li></ol>
wor ny at, gejt under dy ad|gejt under dy ad|wor ny at	<i>proverb</i><br><ol><li>no pain, no gain</li></ol>
woser|wasyn	<i>noun</i><br><ol><li>water</li></ol>
wossertroppa	<i>noun</i><br><ol><li>tear (drop of clear salty liquid from the eyes)</li></ol>
wuf|wūf	<i>noun</i><br><ol><li>wolf</li></ol>
wunder	<i>noun</i><br><ol><li>wonder</li></ol>
wuuł	<i>noun</i><br><ol><li>wool</li></ol>
wygiöd	<i>noun</i><br><ol><li>comfort</li></ol>
wynd	<i>noun</i><br><ol><li>wind</li></ol>
wynter	<i>noun</i><br><ol><li>winter</li></ol>
wytwa	<i>noun</i><br><ol><li>widow</li></ol>
wytwer	<i>noun</i><br><ol><li>widower</li></ol>
wzgarda	<i>noun</i><br><ol><li>contempt, disdain</li></ol>
wzmjanka	<i>noun</i><br><ol><li>mention</li></ol>
wāhs	<i>noun</i><br><ol><li>wax</li></ol>
wāhsa	<i>verb</i><br><ol><li>to wax</li></ol>
wāter|wātyn	<i>noun</i><br><ol><li>thunderstorm</li></ol>
wōta	<i>verb</i><br><ol><li>to wade</li></ol>
wȧhter	<i>noun</i><br><ol><li>guard (person who guards)</li></ol>
wȧjł	<i>conj</i><br><ol><li>because</li></ol><br><i>noun</i><br><ol><li>while</li></ol>
ych	<i>pron</i><br><ol><li>I (personal first person singular)</li></ol>
yjer|yjyn|ȳjer	<i>noun</i><br><ol><li>ear (fruiting body of a grain plant)</li></ol>
yncuł	<i>noun</i><br><ol><li>tallow, suet</li></ol>
ynwik	<i>prep</i><br><ol><li>inside</li></ol>
yter|ytyn	<i>noun</i><br><ol><li>snake, serpent</li></ol>
ywig	<i>adj</i><br><ol><li>eternal</li></ol>
yzuł|yzeła|ȳzułn|ȳzuł|yzułn	<i>noun</i><br><ol><li>donkey, ass</li></ol>
ył|ȳł	<i>noun</i><br><ol><li>oil</li></ol>
zaag|zaagia	<i>noun</i><br><ol><li>saw</li></ol>
zaagia	<i>verb</i><br><ol><li>to saw</li></ol>
zachs	<i>num</i><br><ol><li>six</li></ol>
zans|zansa	<i>noun</i><br><ol><li>scythe</li></ol>
zaof	<i>noun</i><br><ol><li>soap (substance)</li></ol>
zaoj|zaoja|zaojła	<i>noun</i><br><ol><li>sow (female pig)</li></ol>
zaon	<i>verb</i><br><ol><li>to see (perceive with the eyes)</li></ol>
zaotuł|zaotułn	<i>noun</i><br><ol><li>saddle</li></ol>
zaołc	<i>noun</i><br><ol><li>salt (common substance, NaCl)</li><li>(chemistry) salt</li></ol>
zaołca	<i>verb</i><br><ol><li>to salt, to add salt to</li></ol>
zdehlīn	<i>noun</i><br><ol><li>carcass (dead animal)</li></ol>
zejwa	<i>num</i><br><ol><li>seven</li></ol>
zenft	<i>noun</i><br><ol><li>mustard</li></ol>
zir	<i>adv</i><br><ol><li>very</li></ol>
ziss	<i>adj</i><br><ol><li>sweet</li></ol>
zoft|zōft	<i>noun</i><br><ol><li>juice</li><li>sap</li></ol>
zok|zoka	<i>noun</i><br><ol><li>sock</li></ol>
zomt	<i>prep</i><br><ol><li>together with</li></ol>
zoraza	<i>noun</i><br><ol><li>epidemic</li></ol>
zumer|zumyn	<i>noun</i><br><ol><li>summer</li></ol>
zun	<i>noun</i><br><ol><li>son</li><li>sun</li></ol>
zunn	<i>noun</i><br><ol><li>sun</li></ol>
zuntaog	<i>noun</i><br><ol><li>Sunday</li></ol>
zyc	<i>noun</i><br><ol><li>seat</li></ol>
zymmuł|zymmułn	<i>noun</i><br><ol><li>roll (made of flour)</li></ol>
zyn	<i>verb</i><br><ol><li>to sow</li></ol>
zynd|zynda	<i>noun</i><br><ol><li>sin</li></ol>
zynwyt	<i>noun</i><br><ol><li>Saturday</li></ol>
zyster|zystyn	<i>noun</i><br><ol><li>sister-in-law</li></ol>
zyter|zytys|zyty	<i>pron</i><br><ol><li>such</li></ol>
zyłwer	<i>noun</i><br><ol><li>silver</li></ol>
zyłwera	<i>adj</i><br><ol><li>silver</li></ol>
zöł|zöłn|zȫł	<i>noun</i><br><ol><li>sole</li></ol>
züp	<i>noun</i><br><ol><li>soup</li></ol>
zāfa	<i>verb</i><br><ol><li>to soap (apply soap in washing)</li></ol>
zūn|zynn	<i>noun</i><br><ol><li>son</li></ol>
zǡh	<i>noun</i><br><ol><li>(formal) urine</li></ol>
zǡhja	<i>verb</i><br><ol><li>(very formal) to urinate</li></ol>
zȧjt|zȧjta	<i>noun</i><br><ol><li>(geometry, and in general) a side; a bounding straight edge of a two-dimensional shape</li><li>(geometry) a face, side, surface of any three-dimensional object</li><li>a page; a single leaf of any manuscript or book</li><li>a side; one of the two surfaces of a sheet of paper</li><li>(figuratively) a side, fraction or group of competitors in a war, game, competition or any other conflict in opposite to their opponents</li><li>the face of a coin or dice</li><li>(computing) a site, a website on the internet</li></ol>
öbstgiöta	<i>noun</i><br><ol><li>orchard</li></ol>
öder|ödyn|ȫder|ȫdyn	<i>noun</i><br><ol><li>vein</li></ol>
ödum|ȫdum	<i>noun</i><br><ol><li>breath</li><li>spirit</li></ol>
öduma	<i>verb</i><br><ol><li>breathe</li></ol>
öks|ȫksa|ȫks|öksa	<i>noun</i><br><ol><li>ox</li></ol>
ömbłaotła	<i>noun</i><br><ol><li>Christmas wafer</li></ol>
ömys|ȫmyssa|ȫmys|ömyssa	<i>noun</i><br><ol><li>ant</li></ol>
öwyt|ȫwyt|ȫwyta|öwyta	<i>noun</i><br><ol><li>evening</li></ol>
öwytaosa	<i>noun</i><br><ol><li>supper</li></ol>
öłlaomp	<i>noun</i><br><ol><li>oil lamp</li></ol>
ür	<i>noun</i><br><ol><li>ear</li></ol>
Ād	<i>name</i><br><ol><li>Earth (third planet from the Sun)</li></ol>
ād	<i>noun</i><br><ol><li>soil</li><li>the ground</li></ol>
ādbödum	<i>noun</i><br><ol><li>ground</li></ol>
āpuł|āpułn	<i>noun</i><br><ol><li>potato</li></ol>
āta	<i>verb</i><br><ol><li>to work</li></ol>
āter|ātyn	<i>noun</i><br><ol><li>worker</li></ol>
āteryn|āterynn	<i>noun</i><br><ol><li>A female laborer, worker</li></ol>
ātsum	<i>adj</i><br><ol><li>hard-working, industrious</li></ol>
āwa	<i>adj</i><br><ol><li>pleasant</li><li>short for 'pleased to meet you'</li></ol>
ēd|ēda	<i>noun</i><br><ol><li>harrow</li></ol>
ība	<i>verb</i><br><ol><li>to exercise</li></ol>
īder|īdys|īdy	<i>pron</i><br><ol><li>each, every</li><li>everyone</li></ol>
Łiwert	<i>name</i><br><ol><li>Kęty</li></ol>
łajcht	<i>adj</i><br><ol><li>easy</li></ol>
łajn|łȧjn	<i>noun</i><br><ol><li>flax</li></ol><br><i>verb</i><br><ol><li>to lend</li><li>to borrow</li></ol>
łamm|łammła	<i>noun</i><br><ol><li>yeanling</li></ol>
łaoch|łaocha	<i>noun</i><br><ol><li>puddle</li></ol>
łaocha|gyłaocht|łaocht	<i>verb</i><br><ol><li>to laugh</li></ol>
łaojfa	<i>verb</i><br><ol><li>to run</li></ol>
łaojs	<i>noun</i><br><ol><li>louse</li></ol>
łaom	<i>noun</i><br><ol><li>clay</li></ol>
łaond	<i>noun</i><br><ol><li>land</li></ol>
łaong	<i>adj</i><br><ol><li>long</li></ol>
łaowa	<i>noun</i><br><ol><li>life (the state that follows birth, and precedes death; the state of being alive and living)</li><li>life (the essence of the manifestation and the foundation of the being)</li></ol><br><i>verb</i><br><ol><li>to live</li></ol>
łaower	<i>noun</i><br><ol><li>liver</li></ol>
łaoza	<i>verb</i><br><ol><li>to read</li></ol>
łata	<i>verb</i><br><ol><li>to guide, to lead</li></ol>
łatter|łattyn|łȧtter|łȧttyn	<i>noun</i><br><ol><li>ladder</li></ol>
łauf	<i>noun</i><br><ol><li>a run</li></ol>
łaufer|łaufyn|łauferyn	<i>noun</i><br><ol><li>runner</li></ol>
łeffeła	<i>noun</i><br><ol><li>teaspoon</li><li>dessertspoon</li></ol>
łeffuł|łeffeła|łeffułn	<i>noun</i><br><ol><li>spoon</li><li>spoonful</li></ol>
łefuł|łefułn	<i>noun</i><br><ol><li>spoon</li></ol>
łend|łenda	<i>noun</i><br><ol><li>loin, hip</li></ol>
łeń|łeńa	<i>noun</i><br><ol><li>length</li><li>duration</li></ol>
łicht|łichtła	<i>adj</i><br><ol><li>light, bright</li></ol><br><i>noun</i><br><ol><li>light</li></ol>
łid|łidła|łidyn|łīdła|łīd	<i>noun</i><br><ol><li>song</li></ol>
łidła|łīdła	<i>noun</i><br><ol><li>song (a musical piece with lyrics)</li></ol>
łiwa|łīwa	<i>noun</i><br><ol><li>love</li></ol><br><i>verb</i><br><ol><li>to love</li></ol>
łiyn	<i>verb</i><br><ol><li>to learn, to study</li></ol>
łupp|łuppa	<i>noun</i><br><ol><li>bitch: # A female dog or other canine. In particular one who has recently had puppies.</li></ol>
łyfta|gyłyft|łyft	<i>verb</i><br><ol><li>to air, to ventilate</li></ol>
łyp|łypa	<i>noun</i><br><ol><li>lip</li></ol>
ływ|ływła|łȳw|ływa|łȳwa	<i>noun</i><br><ol><li>lion</li></ol>
łöch	<i>noun</i><br><ol><li>A hole.</li><li>(dentistry) cavity</li><li>(colloquial) A room, apartment, flat or house in a bad condition; dump.</li></ol>
łöft	<i>noun</i><br><ol><li>air, atmosphere</li></ol>
łöst	<i>noun</i><br><ol><li>wish, desire</li></ol>
łāwer	<i>noun</i><br><ol><li>(anatomy) liver</li><li>(meats) liver</li></ol>
łīphober|łīphobyn	<i>noun</i><br><ol><li>aficionado, enthusiast</li><li>lover</li></ol>
łōda	<i>verb</i><br><ol><li>to load</li><li>to charge</li></ol>
łūnāter|łūnātyn	<i>noun</i><br><ol><li>(dated) day laborer</li></ol>
łūt	<i>noun</i><br><ol><li>(archaic) lot (an old unit of weight used in many European countries from the Middle Ages, often defined as 1/30 or 1/32 of a (local) pound).</li></ol>
łǡź	<i>noun</i><br><ol><li>agio</li></ol>
łȧj|łȧja	<i>noun</i><br><ol><li>rope</li></ol>
łȧjm	<i>noun</i><br><ol><li>glue</li></ol>
łȧjma	<i>verb</i><br><ol><li>to glue</li></ol>
łȧjmyt|łȧjmyta	<i>noun</i><br><ol><li>canvas (basis for creative work)</li></ol>
łȧjnȳł	<i>noun</i><br><ol><li>linseed oil, flaxseed oil</li></ol>
łȧjp	<i>noun</i><br><ol><li>(obsolete) the body (the body as a whole entity)</li><li>(obsolete) the trunk, torso (especially without limbs)</li><li>(archaic) the belly, abdomen</li><li>(archaic) the stomach</li></ol>
łȧjst|łȧjsta	<i>noun</i><br><ol><li>groin</li><li>batten (thin strip of wood used in construction)</li></ol>
ōzān	<i>verb</i><br><ol><li>(reflexive) to view</li></ol>
ōzȧgja	<i>verb</i><br><ol><li>to saw off</li></ol>
ōłaster|ōłastyn	<i>noun</i><br><ol><li>magpie</li></ol>
śispuwer	<i>noun</i><br><ol><li>gunpowder</li></ol>
śmejt	<i>noun</i><br><ol><li>blacksmith</li></ol>
śnajder|śnajdyn	<i>noun</i><br><ol><li>tailor, sewer, dressmaker</li></ol>
śnöptichła	<i>noun</i><br><ol><li>handkerchief</li></ol>
śnür	<i>noun</i><br><ol><li>rope, string, cord</li></ol>
śpaos	<i>noun</i><br><ol><li>joke, jest</li></ol>
śpaosa	<i>verb</i><br><ol><li>joke, kid, jest</li></ol>
śpielik|śpjeliḱ	<i>noun</i><br><ol><li>sparrow</li></ol>
śpigel	<i>noun</i><br><ol><li>mirror</li></ol>
śprejchwüt	<i>noun</i><br><ol><li>proverb, adage, saying</li></ol>
śpröch|śpröcha	<i>noun</i><br><ol><li>language</li></ol>
śpyrkia	<i>noun</i><br><ol><li>lard</li></ol>
śpytuł	<i>noun</i><br><ol><li>hospital</li></ol>
śpyłł	<i>noun</i><br><ol><li>spindle</li></ol>
śpöt	<i>adv</i><br><ol><li>late</li></ol>
śpüla	<i>noun</i><br><ol><li>spool</li></ol>
śrajbbichła	<i>noun</i><br><ol><li>notebook</li></ol>
śrajwa	<i>verb</i><br><ol><li>to write</li></ol>
śrejt	<i>noun</i><br><ol><li>step</li></ol>
śtajer	<i>noun</i><br><ol><li>tax</li></ol>
śtan	<i>noun</i><br><ol><li>stone</li></ol>
śtaod	<i>noun</i><br><ol><li>city, town</li></ol>
śtaom|śtaoma|śtaomła	<i>noun</i><br><ol><li>(astronomy) star</li></ol>
śtiyn	<i>noun</i><br><ol><li>forehead</li></ol>
śtröf	<i>noun</i><br><ol><li>punishment</li></ol>
śtröfa	<i>verb</i><br><ol><li>punish</li></ol>
śtöł	<i>noun</i><br><ol><li>steel</li></ol>
śtüch|śtüchia	<i>noun</i><br><ol><li>stork</li></ol>
śtül	<i>noun</i><br><ol><li>chair</li></ol>
śwaas	<i>noun</i><br><ol><li>sweat</li></ol>
śwaom	<i>noun</i><br><ol><li>sponge</li></ol>
śwaowuł	<i>noun</i><br><ol><li>sulfur</li></ol>
świrig	<i>adj</i><br><ol><li>difficult</li></ol>
świöc	<i>adj</i><br><ol><li>black</li></ol>
śwojmła	<i>noun</i><br><ol><li>swallow (bird)</li></ol>
śynder	<i>noun</i><br><ol><li>hangman</li></ol>
śynduł|śyndułn	<i>noun</i><br><ol><li>shingle</li></ol>
śłykiermyłich	<i>noun</i><br><ol><li>curd, sour milk, curdled milk</li></ol>
ǡ	<i>num</i><br><ol><li>one</li></ol><br><i>article</i><br><ol><li>a, an</li></ol>
ǡgul|ǡguln	<i>noun</i><br><ol><li>leech</li></ol>
ǡhja	<i>adj</i><br><ol><li>of, or pertaining to oak (trees or wood)</li></ol>
ǡhsuł|ǡhsułn	<i>noun</i><br><ol><li>axle</li></ol>
ǡny|ǡny + feminine noun	<i>num</i><br><ol><li>one</li></ol><br><i>article</i><br><ol><li>a, an</li></ol>
ǡter	<i>noun</i><br><ol><li>(pathology) pus</li><li>abscess</li></ol>
ǡtyn	<i>verb</i><br><ol><li>to suppurate (form or discharge pus)</li></ol>
ȧ-mȫł	<i>adv</i><br><ol><li>once, one time</li></ol>
ȧhkjenła	<i>noun</i><br><ol><li>squirrel</li></ol>
ȧjbrȧhja	<i>verb</i><br><ol><li>to break in</li><li>to break down</li></ol>
ȧjła	<i>verb</i><br><ol><li>to hurry</li></ol>
ȫne	<i>prep</i><br><ol><li>without</li></ol>
ȳduł	<i>adj</i><br><ol><li>noble</li></ol>
ȳwiḱȧjt	<i>noun</i><br><ol><li>eternity</li></ol>
