A	<i>character</i><br><ol><li>The first letter of the Votic alphabet, called a and written in the Latin script.</li></ol>
a	<i>character</i><br><ol><li>The first letter of the Votic alphabet, written in the Latin script.</li></ol><br><i>intj</i><br><ol><li>ah!, oh!</li><li>oops!</li><li>ouch!</li></ol><br><i>conj</i><br><ol><li>but (Following a negative clause or sentence) On the contrary, but rather</li><li>However, although, nevertheless, on the other hand</li></ol>
aa	<i>intj</i><br><ol><li>yep, yeah</li><li>aha, uh-huh</li></ol>
aapa|aavaa|aapaa	<i>noun</i><br><ol><li>aspen</li></ol>
adra|adraa	<i>noun</i><br><ol><li>plow</li></ol>
ahjo|ahjoo	<i>noun</i><br><ol><li>stove, oven</li></ol>
ahvakko|ahvakoo	<i>noun</i><br><ol><li>perch (fish)</li></ol>
ahvõn|ahvõnaa|ahvõnõõ	<i>noun</i><br><ol><li>perch (fish)</li></ol>
aika|aigassi|aigoiz|aigad|aikoje|aigalõssa|aigoilõ|aigoilõssa|aikoit|aigana|aigalt|aikaa|aigoina|aikoisõ|aigaa|aigoil|aigaz|aigoissi|aigalõ|aigoilt|aigass|aigoika|aiga|aigaka|aigall|aigoiss	<i>noun</i><br><ol><li>time</li></ol>
aita|aďďaa	<i>noun</i><br><ol><li>garden</li></ol>
ajaa|ajõn|ajan	<i>verb</i><br><ol><li>to drive</li></ol>
akkuna|akkunoje|akkunoissi|akkunoil|akkunoit|akkunoilõ|akkunoika|akkunalõ|akkunoiss|akkunoisõ|akkunass|akkunassi|akkunaz|akkunalõssa|akkunaka|akkunalt|akkunoina|akkunad|akkunoilt|akkunall|akkunoiz|akkunaa|akkunana|akkonoilõssa	<i>noun</i><br><ol><li>window</li></ol>
alkaa|algan|alkõn	<i>verb</i><br><ol><li>to begin, to start</li></ol>
ammaz|ammassa|ampaiss|ampaaz|ampaal|ampaiz|ampailõ|ampaasõssa|ampaaka|ampaďďeka|ampait|ampaass|ampailt|ampaad|ampaďďe|ampaisõ|ampail|ampaisõssa|ampaina|ampaasõ|ampaalt|ampaassi|ampaanna|ampaalõ|ampaa|ampaissi	<i>noun</i><br><ol><li>tooth</li></ol>
antaa|annan|annõn	<i>verb</i><br><ol><li>to give</li></ol>
api|avii	<i>noun</i><br><ol><li>help, aid</li></ol>
arina|arinaa	<i>noun</i><br><ol><li>hearth</li></ol>
arja	<i>noun</i><br><ol><li>brush</li></ol>
armaz|armaa	<i>adj</i><br><ol><li>dear, beloved</li></ol>
assua|asun|assuzin	<i>verb</i><br><ol><li>to step</li></ol>
aukko|aukoo	<i>noun</i><br><ol><li>hole</li></ol>
autši|auďii	<i>noun</i><br><ol><li>pike (fish)</li></ol>
avittaa|avitan|avitin	<i>verb</i><br><ol><li>to help</li></ol>
aźźa|aźźaa	<i>noun</i><br><ol><li>thing</li></ol>
baabukaz|baabukkaa	<i>noun</i><br><ol><li>raspberry</li></ol>
baabuška|baabuškaa	<i>noun</i><br><ol><li>grandmother</li></ol>
botška|bodžgaa	<i>noun</i><br><ol><li>barrel, cask</li></ol>
bruuda|bruudaa	<i>noun</i><br><ol><li>pond</li></ol>
dohtari|dohtarii	<i>noun</i><br><ol><li>doctor</li></ol>
doro	<i>noun</i><br><ol><li>acorn</li></ol>
einä|einää	<i>noun</i><br><ol><li>hay</li></ol>
ellä|ellää	<i>adj</i><br><ol><li>gentle, sensitive</li></ol>
elmi|elmee	<i>noun</i><br><ol><li>bead, pearl</li></ol>
elo|eloo	<i>noun</i><br><ol><li>life</li></ol>
eloza	<i>adv</i><br><ol><li>alive</li></ol>
eläin|eläimee	<i>noun</i><br><ol><li>animal</li></ol>
eläjä|eläjää	<i>noun</i><br><ol><li>inhabitant, human</li><li>creature, animal</li></ol>
elää|elin|elän	<i>verb</i><br><ol><li>to live</li></ol>
emintimä|emintimää	<i>noun</i><br><ol><li>stepmother</li></ol>
emä|emilessa|emije|emäle|emässi|emiinä|emiise|emiss|emäss|emält|emiz|emilt|emile|emänä|emiika|emäd|emäll|emiit|emää|emäz|emäkä|emälessa|emissi|emäse|emill	<i>noun</i><br><ol><li>mother</li></ol>
entši|enďed|enďissi|enďez|enďilessa|entšije|entšiika|enďee|entšee|enďelessa|entšiise|enďill|enďele|entšeä|enďilt|enďelt|enďenä|enďell|enďeka|enďiss|enďessi|enďess|entšiinä|enďile|enďiz|entšiit	<i>noun</i><br><ol><li>soul</li><li>individual</li></ol>
esimein|esimeizee	<i>adj</i><br><ol><li>first</li></ol>
esimespäivä|esimespäivää	<i>noun</i><br><ol><li>Monday</li></ol>
etelä|etelää	<i>noun</i><br><ol><li>southwest</li></ol>
frovva|frovvaa	<i>noun</i><br><ol><li>lady, Mrs.</li></ol>
gaada|gaadaa	<i>noun</i><br><ol><li>snake</li></ol>
guľu|guľuu	<i>noun</i><br><ol><li>(childish) dove, pigeon</li></ol>
haili|hailii	<i>noun</i><br><ol><li>Baltic herring</li></ol>
harjokka	<i>noun</i><br><ol><li>weasel</li></ol>
haukka|haukaa	<i>noun</i><br><ol><li>hawk</li></ol>
hoonopooli|hoonopoolõõ	<i>noun</i><br><ol><li>devil</li></ol>
hullu|hulluu	<i>adj</i><br><ol><li>crazy, insane</li></ol>
iho|ihoo	<i>noun</i><br><ol><li>body</li><li>skin</li></ol>
iili|iilee	<i>noun</i><br><ol><li>(hot) coal, ember</li></ol>
iiri|iiree	<i>noun</i><br><ol><li>mouse</li></ol>
ilma|ilmaa	<i>noun</i><br><ol><li>air</li><li>weather</li></ol>
ilozuz|ilozuil|ilozuu|ilozuulõ|ilozuul|ilozuuna|ilozuud|ilozuisõssa|ilozuusõssa|ilozuiz|ilozuusõ|ilozuussi|ilozuuka|ilozuuss|ilozuďďe|ilozutta|ilozuisõ|ilozuďďeka|ilozuuz|ilozuilta|ilozuit|ilozuiss|ilozuissi|ilozuina|ilozuilõ|ilozuult	<i>noun</i><br><ol><li>beauty (quality of pleasing appearance)</li></ol>
ilvez|ilvehsee	<i>noun</i><br><ol><li>lynx</li></ol>
ime|imeise|imeess|imeese|imeel|imettä|imeele|imeit|imeelt|imeďďekä|imee|imeekä|imeinä|imeesessä|imeilt|imeez|imeissi|imeil|imeisessä|imeďďe|imeiz|imeile|imeiss|imeessi|imeenä|imeed	<i>noun</i><br><ol><li>miracle</li></ol>
imeä|imin|imezin|imen	<i>verb</i><br><ol><li>to suck (apply suction)</li></ol>
inehmiin|inehmiizee	<i>noun</i><br><ol><li>human</li></ol>
inkerilain|inkerilaizõõ	<i>noun</i><br><ol><li>Ingrian person</li></ol>
isä|izässi|izält|izilessa|izill|isänä|iziss|isiit|isäz|isää|izää|izissi|isiz|isiika|isäse|izäd|isiinä|izilt|isije|izäll|izälessa|izäss|izäka|isiise|izile|izäle	<i>noun</i><br><ol><li>father</li></ol>
itä|iää	<i>noun</i><br><ol><li>east</li></ol>
itšee	<i>noun</i><br><ol><li>gum (part of the mouth)</li><li>(in the plural) gills</li></ol>
itši|igõõ	<i>noun</i><br><ol><li>sweat</li></ol>
itšä|itšäse|iäd|iďiss|itšije|iässi|itšiisessa|itšää|iä|iäle|iďile|iää|iďissi|iält|itšiit|itšiinä|itšiika|itšiise|itšäsessa|iäka|iďiz|iäz|iďill|iäll|iäss|iänä|iďilt	<i>noun</i><br><ol><li>age</li></ol>
ivuz	<i>noun</i><br><ol><li>(single) hair, strand of hair</li></ol>
izintimä|izintimää	<i>noun</i><br><ol><li>stepfather</li></ol>
iľľaa	<i>adv</i><br><ol><li>silently, quietly</li></ol>
jalgaz	<i>noun</i><br><ol><li>ski</li></ol>
jalka|jalkoiz|jalkoisõ|jalkoika|jalgaka|jalkoissaa|jalkoinn|jalkoill|jalgad|jalgall|jalkann|jalkoilt|jalgalt|jalgaa|jalkoillõ|jalgass|jalkoiss|jalkaa|jalkoit|jalgassaa|jalgaz|jalkasõ|jalgassi|jalkoissi|jalgallõ|jalkoi	<i>noun</i><br><ol><li>foot, leg</li></ol>
jarvi|järvee|järvijka|järviz|jarvõõ|järvessi|järvilt|järvese|järvil|järvi|järvez|järviss|järviä|järvess|järvelle|järvissaa|järvile|järvelt|järvijt|järvel|järvissi|järved|järveä|järvessaa|järvij|järvise|järveka|järven	<i>noun</i><br><ol><li>lake</li></ol>
javo	<i>noun</i><br><ol><li>flour</li></ol>
joomari|joomarii	<i>noun</i><br><ol><li>drunkard</li></ol>
jumala|jumalaa	<i>noun</i><br><ol><li>god</li></ol>
jupka|jubgaa	<i>noun</i><br><ol><li>skirt</li></ol>
juuri|juurõõ	<i>noun</i><br><ol><li>root</li></ol>
juusso|juussoil|juussoilõ|juussoika|juussoa|juussoissi|juusoalõssa|juussoilõssa|juussoz|juussoje|juusoss|juusoka|juussoiz|juusolõ|juussoisõ|juusolt|juusona|juussoilt|juuso|juussoo|juusoll|juussoiss|juusod|juussoina|juusossi|juussoit	<i>noun</i><br><ol><li>cheese</li></ol>
juvva|jõin	<i>verb</i><br><ol><li>to drink</li></ol>
jämiä	<i>adj</i><br><ol><li>thick</li></ol>
jänez|jänehsee	<i>noun</i><br><ol><li>rabbit</li></ol>
jätaži|jätažiz|jätažilassa|jätažiit|jätažiiz|jätažia|jätažill|jätažiinä|jätažilt|jätažissi|jätažii|jätažiil|jätažiise|jätažije|jätažiiss|jätažiikä|jätažid|jätažiss|jätažikä|jätažiile|jätažiilt|jätažinä|jätažiissi|jätažile|jätažiilassa	<i>noun</i><br><ol><li>floor, storey</li></ol>
jää|jääz|jäilt|jäänä|jäise|jääl|jäinä|jäälessä|jääle|jäikä|jäiz|jäit|jäissi|jäilessä|jäiss|jääss|jäil|jäässi|jäähee|jääd|jäät|jäält|jäďďe|jäile|jääkä	<i>noun</i><br><ol><li>ice</li></ol>
jäättüä|jäätüzin|jäätün	<i>verb</i><br><ol><li>to freeze, to become frozen</li></ol>
jäävvä|jään|jäin	<i>verb</i><br><ol><li>to stay, to remain</li></ol>
jõtši|jõďilõssa|jõkõa|jõgõd|jõtšiit|jõgõll|jõtšije|jõďilõ|jõgõlt|jõgõõ|jõgõna|jõďilt|jõgõz|jõgõssi|jõtšiisõ|jõďissi|jõtšiika|jõtšiina|jõgõlõ|jõkõõ|jõďiss|jõďiz|jõgõka|jõďill|jõgõlõssa|jõgõss	<i>noun</i><br><ol><li>river</li></ol>
jõutu|jõvvuu	<i>noun</i><br><ol><li>strength</li></ol>
jürü|jürüü	<i>noun</i><br><ol><li>thunder</li></ol>
kaakko	<i>noun</i><br><ol><li>owl</li></ol>
kaappi|kaapii	<i>noun</i><br><ol><li>cupboard, cabinet</li><li>closet</li></ol>
kaasi	
kaaska|kaazgaa	<i>noun</i><br><ol><li>tale, legend</li></ol>
kaatsad	<i>noun</i><br><ol><li>pants</li></ol>
kabja|kabjaa	<i>noun</i><br><ol><li>hoof</li></ol>
kagla|kaglaa	<i>noun</i><br><ol><li>neck</li></ol>
kagluz|kagluhsõõ	<i>noun</i><br><ol><li>collar</li></ol>
kagra|kagraa	<i>noun</i><br><ol><li>oat</li></ol>
kahsi|kahõõ	<i>num</i><br><ol><li>two</li></ol>
kahstõššõmõtta	<i>num</i><br><ol><li>twelve</li></ol>
kahtši|kazgõõ	<i>noun</i><br><ol><li>birch</li></ol>
kahtšümmettä|kahõõtšümmenee	<i>num</i><br><ol><li>twenty</li></ol>
kahtšümmettäkahsi|kahõõtšümmeneekahõõ	<i>num</i><br><ol><li>twenty-two</li></ol>
kahtšümmettühsi|kahõõtšümmeneeühee	<i>num</i><br><ol><li>twenty-one</li></ol>
kahõsaa|kahõssamaa|kahõssamõõ	<i>num</i><br><ol><li>eight</li></ol>
kahõsaatõššõmõtta	<i>num</i><br><ol><li>eighteen</li></ol>
kaittsaa|kaitsan|kaitsõn	<i>verb</i><br><ol><li>to shepherd</li></ol>
kaivo|kaivoo	<i>noun</i><br><ol><li>well</li></ol>
kajaga|kajagaa	<i>noun</i><br><ol><li>seagull</li></ol>
kala|kalaa	<i>noun</i><br><ol><li>fish</li></ol>
kalanikka|kalanikaa	<i>noun</i><br><ol><li>fisherman</li></ol>
kalliz|kallii	<i>adj</i><br><ol><li>dear, precious</li><li>beloved</li></ol>
kamunista|kamunistaa	<i>noun</i><br><ol><li>communist</li></ol>
kanava|kanavaa	<i>noun</i><br><ol><li>ditch, trench</li></ol>
kangaz|kankaa	<i>noun</i><br><ol><li>cloth, fabric</li></ol>
kanta|kannaa	<i>noun</i><br><ol><li>heel</li></ol>
kapussa|kapusaa	<i>noun</i><br><ol><li>cabbage</li></ol>
karja|karjaa	<i>noun</i><br><ol><li>pasture</li></ol>
karjušši|karjušii	<i>noun</i><br><ol><li>shepherd</li></ol>
karkõa	<i>adj</i><br><ol><li>bitter</li></ol>
karu|karult|karuit|karuiss|karuoilõ|karull|karuilt|karussi|karuna|karuisõ|karujeka|karuiz|karuka|karuje|karuill|karud|karuina|karulõssa|karua|karuuz|karuissi|karulõ|karuu|karuss	<i>noun</i><br><ol><li>bear</li></ol>
kassaa|kasõn|kasan	<i>verb</i><br><ol><li>to wet, to soak</li></ol>
kasõ|kassõõ	<i>noun</i><br><ol><li>dew</li></ol>
kataga|katagaa	<i>noun</i><br><ol><li>juniper</li></ol>
kattila|kattilaa	<i>noun</i><br><ol><li>kettle</li></ol>
katõ|kattõõ	<i>noun</i><br><ol><li>cover, coat</li><li>cloak, veil</li><li>bedspread, blanket</li><li>carpet, rug</li></ol>
kazvaa|kazvan|kazvõn	<i>verb</i><br><ol><li>to grow</li></ol>
kazvo|kazvoo	<i>noun</i><br><ol><li>growth</li></ol>
kaľaska|kaľaskaa	<i>noun</i><br><ol><li>carriage</li></ol>
kańevo|kańevoo	<i>noun</i><br><ol><li>cannabis</li></ol>
kerätä|keräsin|kerään	<i>verb</i><br><ol><li>to beg</li></ol>
kerääjä|kerääjää|keräjä|keräjää	<i>noun</i><br><ol><li>beggar</li></ol>
kirstu|kirstuu	<i>noun</i><br><ol><li>chest</li><li>coffin</li></ol>
kittrõõba	<i>noun</i><br><ol><li>whale</li></ol>
kiukka	<i>noun</i><br><ol><li>stove</li></ol>
klazi|klazii|klasi	<i>noun</i><br><ol><li>glass (material)</li></ol>
koira|koiraa|koirõje|koiralõssa|koirõiss|koirõika|koiralõ|koiraka|koirõiz|koirõisõ|koirõissi|koirõil|koirall|koiralt|koirass|koirõilõ|koirõlt|koirõina|koirõit|koirad|koiraz|koirassi|koirana|koirõilõssa	<i>noun</i><br><ol><li>dog</li></ol>
koivu|koivuu	<i>noun</i><br><ol><li>birch (tree)</li></ol>
konna|konnaa	<i>noun</i><br><ol><li>frog</li></ol>
koolla|koolõn|koolin	<i>verb</i><br><ol><li>to die</li></ol>
koori|koorõõ	<i>noun</i><br><ol><li>bark</li><li>skin</li><li>peel, rind</li></ol>
koorma|koormaa	<i>noun</i><br><ol><li>load</li><li>burden</li></ol>
koputtaa	<i>verb</i><br><ol><li>knock</li></ol>
kormuna|kormunaa	<i>noun</i><br><ol><li>pocket</li></ol>
kotikko|kotikoo	<i>noun</i><br><ol><li>sack</li></ol>
koto|koo	<i>noun</i><br><ol><li>house, home</li></ol>
kotti|kotii	<i>noun</i><br><ol><li>bag, sack</li></ol>
kramppi|krampii	<i>noun</i><br><ol><li>cramp</li></ol>
krapu|kravuu	<i>noun</i><br><ol><li>crab</li></ol>
krazguz	<i>noun</i><br><ol><li>paint</li></ol>
kreeposti|kreipostii|kreepostii|kreiposti	<i>noun</i><br><ol><li>fortress</li></ol>
krotta|krotaa	<i>noun</i><br><ol><li>mole (animal)</li></ol>
kukko|kukoo	<i>noun</i><br><ol><li>rooster</li></ol>
kukkõ|kukõõ	<i>noun</i><br><ol><li>rooster</li></ol>
kukšina|kukšinaa	<i>noun</i><br><ol><li>mug</li><li>jug</li></ol>
kullaz	<i>noun</i><br><ol><li>darling</li></ol>
kumma|kummaa	<i>noun</i><br><ol><li>miracle</li></ol>
kumpa|kummaa	<i>det</i><br><ol><li>which, what (of two)</li></ol>
kunikaz|kunikaa	<i>noun</i><br><ol><li>king</li></ol>
kuraz|kurahsõõ	<i>noun</i><br><ol><li>knife</li></ol>
kurtši|kurtšije|kurgõll|kurtšiina|kurďilt|kurkõõ|kurďissi|kurgõd|kurkõa|kurgõz|kurtšiit|kurďiz|kurďilõ|kurďilõssa|kurgõlõssa|kurgõss|kurgõlt|kurtšiika|kurďiss|kurgõssi|kurgõna|kurgõka|kurgõlõ|kurgõõ|kurtšiisõ|kurďill	<i>noun</i><br><ol><li>crane (bird)</li></ol>
kurõa	<i>adj</i><br><ol><li>left</li></ol>
kusi|kuõõ	<i>noun</i><br><ol><li>urine</li></ol>
kuttsua|kuttsuzin|kutsun	<i>verb</i><br><ol><li>to call, to summon</li><li>to invite</li></ol>
kuu|kuhõõ|kuuss|kuulõssa|kuuka|kuud|kuil|kuult|kuuz|kuit|kuussi|kuisõ|kuika|kuull|kuut|kuiz|kuďďe|kuiss|kuina|kuilõssa|kuilõ|kuuna|kuissi|kuilt|kuulõ	<i>noun</i><br><ol><li>moon</li><li>month</li></ol>
kuulla|kuulõn|kuulin	<i>verb</i><br><ol><li>to hear</li></ol>
kuusi|kuuzõõ|kuvvõõ	<i>num</i><br><ol><li>six</li></ol><br><i>noun</i><br><ol><li>spruce</li></ol>
kuustõššõmõtta	<i>num</i><br><ol><li>sixteen</li></ol>
kõlmaispäivä|kõlmaispäivää	<i>noun</i><br><ol><li>Wednesday</li></ol>
kõlmtõššõmõtta	<i>num</i><br><ol><li>thirteen</li></ol>
kõlmõd|kõlmõõ	<i>num</i><br><ol><li>three</li></ol>
kõrkõa	<i>adj</i><br><ol><li>tall, high</li></ol>
kõrkõuz|kõrkõuu	<i>noun</i><br><ol><li>height</li><li>altitude</li></ol>
kõrsi|kõrzill|kõrziz|kõrrõssi|kõrrõlõ|kõrrõss|kõrrõlt|kõrrõna|kõrrõz|kõrzilt|kõrrõd|kõrrõõ|kõrsijeka|kõrtta|kõrrõll|kõrsiisõ|kõrziss|kõrzilõ|kõrzilõssa|kõrsiit|kõrsiinä|kõrrõlõssa|kõrsije|kõrrõka|kõrtõõ	<i>noun</i><br><ol><li>(botany) stalk</li></ol>
kõrva|kõrvaka|kõrvalõ|kõrviisõ|kõrvissi|kõrvasõssa|kõrvaa|kõrviina|kõrvaz|kõrvill|kõrviss|kõrvilõ|kõrviika|kõrvassi|kõrvall|kõrvasõ|kõrviisõssa|kõrvalt|kõrviit|kõrvana|kõrvilt|kõrvije|kõrvass|kõrviz	<i>noun</i><br><ol><li>ear</li></ol>
kõssõa	<i>adj</i><br><ol><li>wet</li></ol>
kõta|kõaa	<i>noun</i><br><ol><li>house</li><li>chamber</li></ol>
kõva|kovaa	<i>adj</i><br><ol><li>hard (not soft)</li><li>stiff</li><li>strong, sturdy</li><li>harsh, strict</li></ol>
laatko|laadgoo|laatka|laadgaa	<i>noun</i><br><ol><li>bowl</li></ol>
lahja|lahjaa	<i>noun</i><br><ol><li>wedding gift</li><li>gift</li><li>sacrifice</li></ol>
lahsi|lahsilõ|lahsõõ|lahzõõ|lahsiina|lahsõlõ|lahsiisõssa|lahsill|lahsiz|lahsissi|lahsõka|lahsije|lahsõlt|lassa|lahsõll|lahsiisõ|lahsiit|lahsõz|lahsijeka|lahsõd|lahsilt|lahsõna|lahsõss|lahsõssi|lahsõõssa|lahsiss	<i>noun</i><br><ol><li>child</li></ol>
lahti|lahõõ	<i>noun</i><br><ol><li>bay, gulf</li></ol>
lainõ|lainõõ	<i>noun</i><br><ol><li>wave</li></ol>
laiskuz|laiskuu	<i>noun</i><br><ol><li>laziness</li></ol>
laiva|laivaa	<i>noun</i><br><ol><li>ship, boat</li></ol>
lakõa	<i>adj</i><br><ol><li>flat</li></ol>
lammaz|lampail|lampaiz|lampailõ|lampaaka|lampaisõ|lampaaz|lampaalõ|lampaal|lampaďďe|lammassa|lampailt|lampaissi|lampaďďeka|lampaasõssa|lampait|lampaanna|lampaalt|lampaassi|lampaisõssa|lampaassõ|lampaass|lampaina|lampaad|lampaa|lampaiss	<i>noun</i><br><ol><li>sheep</li></ol>
lapia|lapiaa	<i>noun</i><br><ol><li>shovel</li><li>spade</li></ol>
latši|laďilt|lagõd|lakõa|lagõlõssa|lagõlõ|lagõll|lakõõ|lagõ|laďiz|lagõka|lagõz|laďissi|laďilõ|latšije|laďilõssa|lagõlt|latšiit|laďill|latšiisõ|latšiina|lagõna|lagõss|latšiika|lagõssi|laďiss	<i>noun</i><br><ol><li>ceiling</li></ol>
laukopäivä|laukopäivää	<i>noun</i><br><ol><li>Saturday</li></ol>
laulaa|laulan|laulõn	<i>verb</i><br><ol><li>to sing</li></ol>
laulaja|laulajaa	<i>noun</i><br><ol><li>singer</li></ol>
laulu|lauluu	<i>noun</i><br><ol><li>song</li></ol>
lauta|lavvaa	<i>noun</i><br><ol><li>board, plank</li><li>table</li></ol>
lautta|lautaa	<i>noun</i><br><ol><li>shed, stable</li></ol>
laďďuuz|laďďuu	<i>noun</i><br><ol><li>width</li></ol>
leemi|leemee	<i>noun</i><br><ol><li>soup, broth</li></ol>
leevvä|leen	<i>verb</i><br><ol><li>to be going to</li></ol>
lehmä|lehmää	<i>noun</i><br><ol><li>cow</li></ol>
lehti|lehee	<i>noun</i><br><ol><li>leaf</li><li>newspaper</li></ol>
lehto|lehoo	<i>noun</i><br><ol><li>leaf</li></ol>
lehtši|lezzee	<i>noun</i><br><ol><li>widow</li></ol>
leipä|leipoiss|leipoina|leipoil|leiväz|leivässi|leiväss|leivänä|leivält|leipoje|leivää|leiväll|leiväkä|leipoiz|leiväd|leipoika|leipoit|leipoilt|leipoisessa|leipoilõ|leiväsessa|leiväle|leipää|leipoisõ|leipoissi	<i>noun</i><br><ol><li>bread</li></ol>
lentää|lenzin|lennän	<i>verb</i><br><ol><li>to fly</li></ol>
lentüz	<i>noun</i><br><ol><li>airplane</li></ol>
leppä|lepää	<i>noun</i><br><ol><li>alder</li></ol>
leütää|levvin|levvän	<i>verb</i><br><ol><li>to find, to discover</li></ol>
lidna|lidnaa	<i>noun</i><br><ol><li>town, city</li></ol>
liha|lihaa	<i>noun</i><br><ol><li>meat</li></ol>
lintu|linnult|lintuu|lintuje|linnuz|lintuiz|linnussi|lintua|linnulõssa|linnull|linnuu|linnuna|lintuissi|lintuit|lintuilõ|linnuss|lintuiika|lintuiina|linnulõ|lintuiss|lintuisõ|lintuiisõssa|linnud|lintuilt|linnuka|lintuil	<i>noun</i><br><ol><li>bird</li></ol>
lukõa|lugin|lugõn	<i>verb</i><br><ol><li>to read</li><li>to recite</li></ol>
lumi|lumõlt|lumiisõ|lumijeka|lumill|lumõssi|lumiit|lumõd|lumiss|lumõõ|lumõz|lumõna|lumilõ|lumõlõ|lumõka|lumiina|lumissi|lunta|lumilt|lumije|lumiisõssa|lumõss|lumõõssa|lumiz|lumõll	<i>noun</i><br><ol><li>snow</li></ol>
lupa|lupõika|lupõilõssa|lupõil|lupõiss|luvad|luvall|luvana|luvassi|lupaa|lupõiz|lupõje|luvaz|luvalõ|luvalõssa|lupõilõ|luvaa|lupõit|lupõissi|luvaka|lupõilt|luvalt|lupõisõ|lupõina|luvass	<i>noun</i><br><ol><li>permission</li></ol>
luu|luuka|luiz|luuna|luina|luuss|luise|luissa|luill|luilõ|luulõ|luull|luďďe|luud|luit|luussi|luussa|luiss|luut|luissi|luuz|luika|luilt|luhõõ|luult	<i>noun</i><br><ol><li>bone</li></ol>
luvva|loon|lõin	<i>verb</i><br><ol><li>to create, to make</li><li>to found, to establish</li><li>to throw, to fling</li><li>to raise, to bring up</li><li>to carry, to drag</li></ol>
lähteä|lähen|lähzin	<i>verb</i><br><ol><li>to go</li><li>to leave, to depart</li><li>to exit</li></ol>
lämmii|lämpimää	<i>adj</i><br><ol><li>warm, hot</li></ol>
lämmittää|lämmitin|lämmitän	<i>verb</i><br><ol><li>to warm, to heat</li></ol>
länsi|lännee	<i>noun</i><br><ol><li>west</li></ol>
läsia	<i>verb</i><br><ol><li>be ill</li></ol>
lõimi|lõimõõ	<i>noun</i><br><ol><li>warp (thread)</li></ol>
löülü|löülüü	<i>noun</i><br><ol><li>steam</li></ol>
lüvvä|lein|löön	<i>verb</i><br><ol><li>to hit, to strike, to beat</li></ol>
maa|maassi|maall|maat|maila|maass|maaz|maina|maiss|maad|maala|maaka|mait|mahaa|maalt|mailt|maalõssa|maissi|maill|maďďe|maika|maana|mailõssa|maiz|maisõ	<i>noun</i><br><ol><li>earth</li><li>soil</li><li>land</li><li>ground</li><li>country</li><li>countryside</li></ol>
maailma|maailmaa	<i>noun</i><br><ol><li>world</li></ol>
maamuna|maamunaa	<i>noun</i><br><ol><li>potato</li></ol>
magata|makaan|makazin	<i>verb</i><br><ol><li>to sleep</li><li>to lie down</li></ol>
mahla|mahlaa	<i>noun</i><br><ol><li>sap, juice</li></ol>
mahsa	<i>noun</i><br><ol><li>liver</li></ol>
makõa	<i>adj</i><br><ol><li>sweet</li></ol>
mato|maoo	<i>noun</i><br><ol><li>snake</li></ol>
meeletoo|meeletomaa	<i>adj</i><br><ol><li>frenzied, out of one's mind</li><li>mad, crazy</li></ol>
meeli|meelee	<i>noun</i><br><ol><li>mind</li></ol>
meez|meessä|meheess|mehese|meheesessa|meheeke|meheise|meheele|meheiz|meheenne|meheed|meheez|meheile|meheissi|meheina|meheďďe|meheisessa|meheil|meheessi|meheilt|mehee|meheďďeka|meheel|meheiss|meheit|meheelt	<i>noun</i><br><ol><li>man (adult male human being)</li><li>man, husband</li></ol>
mennä|menin|meen	<i>verb</i><br><ol><li>to go</li><li>to drive, to ride</li><li>to pass, pass by</li><li>to begin, to start</li><li>to begin, to arise</li><li>to advance, to go forward</li><li>to become</li></ol>
meri|meree	<i>noun</i><br><ol><li>sea</li></ol>
mesi|mee	<i>noun</i><br><ol><li>honey</li></ol>
mettsä|metsää	<i>noun</i><br><ol><li>forest</li></ol>
miä	<i>pron</i><br><ol><li>I</li></ol>
muna|munaa	<i>noun</i><br><ol><li>egg</li></ol>
murhõ|murhõõ	<i>noun</i><br><ol><li>sorrow, grief, sadness</li><li>care, concern</li><li>anxiety, distress</li></ol>
mussa|musaa	<i>adj</i><br><ol><li>black</li></ol>
mäntä|männää	<i>noun</i><br><ol><li>whorl</li><li>whisk</li></ol>
mätši|mäessi|mäeka|mäďilt|mäďile|mätšiinä|mäďiss|mäďiz|mätšije|mäďill|mäell|mäelessa|mäed|mätšiit|mäďilessa|mäele|mäen|mäess|mätšee|mätšeä|mätšiise|mäďissi|mäelt|mäe|mätšiika|mäez	<i>noun</i><br><ol><li>hill, mountain</li><li>shore, beach, dry land</li></ol>
mõõkka|mõõkaa	<i>noun</i><br><ol><li>sword</li></ol>
müvvä|müün|müin	<i>verb</i><br><ol><li>to sell</li></ol>
nagraa|nagran|nagrõn	<i>verb</i><br><ol><li>to laugh</li></ol>
nagriz|nagrii	<i>noun</i><br><ol><li>turnip</li></ol>
nain|naizõz|naizõlõ|naizõssi|naizilõssa|naisiina|naizilt|naizõna|naisije|naisijeka|naizilõ|naizõka|naizõlõssa|naisiit|naisiisõ|naizõõ|naizõd|naizissi|naissa|naisõõ|naizõss|naiziss|naizõll|naizill|naiziz|naizõlt	<i>noun</i><br><ol><li>woman</li></ol>
naďďa|naďďan|naizin	<i>verb</i><br><ol><li>to marry (a woman), to take as a wife</li></ol>
neemi|neemee	<i>noun</i><br><ol><li>meadow</li><li>floodplain</li></ol>
nenä|nenää	<i>noun</i><br><ol><li>nose</li><li>snout, muzzle</li></ol>
neľľä|nellä|nellää|neľľää	<i>num</i><br><ol><li>four</li></ol>
neľľätõššõmõtta	<i>num</i><br><ol><li>fourteen</li></ol>
nimi|nimiss|nimiisessa|nimije|nimele|nimilt|nimenä|nimell|nimiinä|nimiika|nime|nimiit|nimiise|nimeka|nimee|nimess|nimeessa|nimelt|nimeä|nimessi|nimile|nimez|nimiz|nimissi|nimill|nimed	<i>noun</i><br><ol><li>name</li></ol>
noori|noorõõ	<i>adj</i><br><ol><li>young</li></ol>
nooruz|nooruu	<i>noun</i><br><ol><li>youth, youngness</li></ol>
noľ	<i>num</i><br><ol><li>zero</li></ol>
nähä|näin|näen	<i>verb</i><br><ol><li>to see</li></ol>
nältšä|nällää	<i>noun</i><br><ol><li>hunger</li></ol>
nõita|nõďďaa	<i>noun</i><br><ol><li>witch</li><li>sorcerer, wizard</li></ol>
ono|onoo	<i>noun</i><br><ol><li>uncle</li></ol>
oonõ|oonõõ	<i>noun</i><br><ol><li>building</li></ol>
oottaa	<i>verb</i><br><ol><li>wait</li></ol>
opo|ovoo	<i>noun</i><br><ol><li>horse</li></ol>
opõnõ|opõziss|opõzõssi|opõzõõ|opõzissi|opõzõka|opõzõss|opõzill|ovõssa|opõzõlt|opõzõz|opõzõna|opõsõõ|opõsiisõ|opõsije|opõzillõ|opõsiina|opõziz|opõzõd|opõzilt|opõzõllõ|opõzillõssa|opõsiit|opõzõll|opõzõllõssa|opõsijeka	<i>noun</i><br><ol><li>horse</li></ol>
orjamarja|orjamarjaa	<i>noun</i><br><ol><li>brierberry</li></ol>
panna|panin|panõn	<i>verb</i><br><ol><li>to put, to place</li></ol>
peeni|peenee	<i>adj</i><br><ol><li>small, little</li><li>fine</li></ol>
pehmiä	<i>adj</i><br><ol><li>soft</li></ol>
peni|penii	<i>noun</i><br><ol><li>female dog</li></ol>
perze|persee	<i>noun</i><br><ol><li>arse, buttocks</li></ol>
pesä|pezää|pezen|pezin	<i>verb</i><br><ol><li>to wash</li></ol><br><i>noun</i><br><ol><li>nest</li><li>lair, den</li></ol>
piiri|piiriilt|piirilt|piirill|piiriile|piiriit|piirije|piirika|piiriiz|piirile|piiriissa|piirii|piirid|piiriss|piiriika|piiriä|piiriina|piiriise|piiriissi|piiriisessa|piirissi|piirinä|piiriiss|piiriz|piiriil	<i>noun</i><br><ol><li>line</li><li>border, limit</li><li>(hair) parting</li><li>juncture</li></ol>
pilvi|pilvee	<i>noun</i><br><ol><li>cloud</li></ol>
pimiä	<i>adj</i><br><ol><li>dark</li></ol><br><i>noun</i><br><ol><li>darkness</li></ol>
pittšä|pitšää	<i>adj</i><br><ol><li>long</li></ol>
pitää|piin|piän	<i>verb</i><br><ol><li>to have to, to be required to, must</li><li>to be necessary</li><li>to hold, to grasp</li><li>to hold, to keep</li></ol>
poika|poigalõssa|poigalõ|poikõina|poigaa|poigana|poikõilt|poigass|poikõilõ|poigalt|poikõil|poikaa|poigassi|poigaz|poigaka|poikõilõssa|poikõiz|poikõje|poigall|poikõisõ|poikõiss|poigad|poikõissi|poikõit|poikõika|poiga	<i>noun</i><br><ol><li>son</li></ol>
postojannoi	<i>adj</i><br><ol><li>permanent</li></ol>
puna|punaa	<i>noun</i><br><ol><li>red (colour)</li></ol>
punanõ|punazõõ	<i>adj</i><br><ol><li>red</li></ol>
purra|purin|purõn	<i>verb</i><br><ol><li>to bite</li></ol>
puu	<i>noun</i><br><ol><li>tree</li></ol>
pähtšinä|pähtšinillee|pähtšininää|pähtšiniz|pähtšinäzä|pähtšinizä|pähtšiniltä|pähtšinääk|pähtšiniss|pähtšinääkaa|pähtšinässä|pähtšinääka|pähtšinäd|pähtšinisee|pähtšinänn|pähtšinänää|pähtšiniit|pähtšinää|pähtšinällee|pähtšinill|pähtšininä|pähtšiniissaa|pähtšinillä|pähtšenä|pähtšinällä|pähtšänä|pähtšinije|pähtšinäss|pähtšinält|pähtšinissi|pähtšinäässaa|pähtšininn|pähtšinänä|pähtšenää|pähtšinäz|pähtšinäll|pähtšiniikaa|pähtšiniika|pähtšinilt|pähtšiniik|pähtšinissä|pähtšinältä|pähtšänää|pähtšinässi	<i>noun</i><br><ol><li>nut, hazelnut</li></ol>
päivä|päiväle|päiväse|päiväz|päiviise|päiviz|päivält|päiväll|päiviisessa|päivilt|päiviss|päivile|päänä|päiviina|päivissi|päiväka|päivässi|päiväss|päivää|päiväsessa|päivill|päivije|päiviika|päiviit	<i>noun</i><br><ol><li>day (when it's light outside)</li><li>day (24 hours, calendar day)</li></ol>
pää|pääka|päďďe|pääz|päile|päinä|päissi|päit|pääss|pääll|päänä|päisessa|päilt|pääle|päika|pähää|päise|päät|päässi|pääsessa|päält|pääd|päill|päiz|päiss	<i>noun</i><br><ol><li>head</li></ol>
põhja|põhjaa	<i>noun</i><br><ol><li>bottom</li><li>base, foundation</li><li>north</li></ol>
põlto|põlloo	<i>noun</i><br><ol><li>field (area for growing crops)</li></ol>
põlvi|põlvõõ	<i>noun</i><br><ol><li>knee</li></ol>
põski|põzgõõ	<i>noun</i><br><ol><li>cheek</li></ol>
pöörä|pöörää	<i>noun</i><br><ol><li>grindstone, millstone</li></ol>
pühä|pühää	<i>adj</i><br><ol><li>holy, sacred</li></ol><br><i>noun</i><br><ol><li>fast, Lent</li></ol>
püssü|püsüü	<i>noun</i><br><ol><li>gun</li></ol>
ragõ|rakõõ	<i>noun</i><br><ol><li>hail (precipitation)</li></ol>
rauta|ravvaa	<i>noun</i><br><ol><li>iron</li></ol>
razva|razvaa	<i>noun</i><br><ol><li>fat, grease</li></ol>
reitšä|reikoiz|reikoiss|reikoilt|reďďäss|reitšää|reikoissi|reďďält|reikoilõ|reďďäz|reikoisõ|reďďänä|reďďässi|reikoje|reďďäka|reikoika|reďďäle|reďďäsessa|reikoil|reikoina|reikoisessa|reďďäll|reikoit|reďďä|reďďäd	<i>noun</i><br><ol><li>hole</li></ol>
repo|revoo	<i>noun</i><br><ol><li>fox</li></ol>
rissi|rissiä|risii|risi|rišsii	<i>noun</i><br><ol><li>cross</li></ol>
ruskõa	<i>adj</i><br><ol><li>red-brown</li></ol>
rõhkõa	<i>adj</i><br><ol><li>bold</li></ol>
saari|saarõõ	<i>noun</i><br><ol><li>island</li></ol>
saata|sain|saavva|saan	<i>verb</i><br><ol><li>to get, to receive</li><li>to obtain</li><li>to fetch</li><li>to become</li><li>to earn (as income)</li></ol>
saattaa|saatan|saatin	<i>verb</i><br><ol><li>to send</li><li>to deliver, to bring</li><li>to transmit</li><li>to accompany, to escort</li><li>to lead, to guide</li></ol>
salmi|salmii	<i>noun</i><br><ol><li>bay, inlet</li></ol>
sata|saa	<i>num</i><br><ol><li>hundred</li></ol>
sataa|saan	<i>verb</i><br><ol><li>to rain, to fall, to precipitate</li></ol>
sato|saoo	<i>noun</i><br><ol><li>rain, precipitation</li></ol>
sauna|saunaa	<i>noun</i><br><ol><li>sauna</li></ol>
savi|savvõõ|savõõ|savvi	<i>noun</i><br><ol><li>clay</li></ol>
seemee|seemene|seemenissi|seemeniz|seemeneessa|seemeness|seemenill|seemeniit|seemenelt|seemenenä|seemened|seemenelle|seemenez|seemenee|seemenille|seemenell|seemenessi|seemeniise|seemenilt|seemenije|seemeniinä|seementä|seemeniss|seemenijeka|seemeneka|seemeniisessa	<i>noun</i><br><ol><li>seed</li></ol>
seitsee|seittsemee	<i>num</i><br><ol><li>seven</li></ol>
seitseetõššõmõtta	<i>num</i><br><ol><li>seventeen</li></ol>
seltšiä	<i>adj</i><br><ol><li>clear</li></ol>
seltšä|sellää	<i>noun</i><br><ol><li>back (of body or object)</li></ol>
seppä|seppiz|seppije|sepilt|seppiise|sepäle|seppää|sepissi|seppiika|sepill|sepäss|seppänä|sepälessa|sepää|sepile|sepäll|sepässi|sepäd|sepäka|seppiit|seppäz|sepält|seppiinä|sepiss|seppäse|sepilessa	<i>noun</i><br><ol><li>smith</li></ol>
siili|siilii|siiliä	<i>noun</i><br><ol><li>hedgehog</li></ol>
siini|siinee	<i>noun</i><br><ol><li>mushroom</li></ol>
sika|sigaa	<i>noun</i><br><ol><li>pig</li></ol>
silmä|silmije|silmiika|silmää|silmäle|silmiss|silmäll|silmiz|silmässi|silmilt|silmäss|silmiit|silmill|silmälessä|silmiisässa|silmält|silmissi|silmile|silmiinä|silmiise|silmäz|silänä|silmäse|silmäkä	<i>noun</i><br><ol><li>eye</li></ol>
silta|sillalt|siltoina|silloilõ|sillall|silloiss|sillalõ|siltoisõ|sillass|siltoit|siltaa|silloilt|silloil|siltoje|silloissi|sillad|siltana|sillaz|silla|silloiz|sillassi	<i>noun</i><br><ol><li>bridge (construction or natural feature that spans a divide)</li></ol>
sini|sinii	<i>noun</i><br><ol><li>blue</li></ol>
sinin|siniziisessa|sinizissi|sinizez|sinizije|sinize|sinizille|sinissä|siniziinä|sinizell|sinizessi|sinizilt|sinizelle|sinizee|sinizill|sinizeka|sinizelt|sinizessa|siniziise|sinized|siniziz|sinizess|sinizijeka|sinizenä|siniziss|siniziit	<i>adj</i><br><ol><li>blue</li></ol>
sipuli|sipuliilt|sipuliissi|sipuliiss|sipuliika|sipulika|sipuliil|sipulill|sipuliit|sipuliiz|sipulid|sipuliilõ|sipulilõssa|sipulii|sipulilt|sipulissi|sipuliisõ|sipulina|sipuliina|sipulia|sipuliss|sipulilõ|sipulije|sipuliz|sipuliilõssa	<i>noun</i><br><ol><li>onion</li></ol>
soldatti|soldatii	<i>noun</i><br><ol><li>soldier</li></ol>
soo|soot	<i>noun</i><br><ol><li>marsh</li></ol>
sooli|soolõõ	<i>noun</i><br><ol><li>gut, intestine, bowel</li></ol>
sooni	<i>noun</i><br><ol><li>sinew, tendon</li><li>blood vessel</li></ol>
sorsa|sorzaa	<i>noun</i><br><ol><li>duck</li></ol>
staruha|staruhissi|staruhill|staruhije|staruhiss|staruhilt|staruhillõssa|staruhiisõ|staruhaka|staruhassi|staruhiika|staruhana|staruhalt|staruhaz|staruhiina|staruhillõ|staruhallõ|staruhass|staruhallõssa|staruhiz|staruhaasõ|staruhaa|staruhall|staruhad|staruhiit	<i>noun</i><br><ol><li>old woman</li></ol>
stoikoi	<i>adj</i><br><ol><li>permanent</li></ol>
sukulain|sukulaizõõ	<i>noun</i><br><ol><li>relative</li></ol>
sulka|sulgaa	<i>noun</i><br><ol><li>feather</li><li>pen</li></ol>
surma|surmaa	<i>noun</i><br><ol><li>death</li></ol>
susi|suziz|suõss|susiit|suziss|sutaassa|susiisessa|suõla|suzile|suõlt|suzill|suõõ|suõka|suõssi|suzilt|suõna|susije|susijeka|suõz|suõd|sutaa|suzissi|susiina|suõll|susiise|sutta	<i>noun</i><br><ol><li>wolf, grey wolf</li></ol>
suu	<i>noun</i><br><ol><li>mouth</li></ol>
suurima	<i>noun</i><br><ol><li>barley</li></ol>
suuru	<i>noun</i><br><ol><li>breakfast</li></ol>
suvaamiin|suvaamizõõ	<i>noun</i><br><ol><li>love</li></ol>
suvi|suvõõ	<i>noun</i><br><ol><li>summer</li></ol>
särtši|särjee	<i>noun</i><br><ol><li>roach (fish; Rutilus rutilus)</li></ol>
sõbra|sõbrõina|sõbrall|sõbrõissi|sõbralõ|sõbraa|sõbrõika|sõbralõssa|sõbrõilõssa|sõbrõiss|sõbrõilt|sõbrõiz|sõbrana|sõbrõit|sõbralt|sõbrassi|sõbrõil|sõbrad|sõbraka|sõbraz|sõbrõisõ|sõbrõje|sõbrass|sõbrõilõ	<i>noun</i><br><ol><li>friend</li></ol>
sõkõa	<i>adj</i><br><ol><li>blind</li></ol>
sõlmu	<i>noun</i><br><ol><li>knot</li></ol>
sõna|sõnassi|sõnass|sõnoilt|sõnana|sõnoilõssa|sõnoje|sõnoisõ|sõnalõ|sõnoina|sõnoiz|sõnoika|sõnoissi|sõnaka|sõnad|sõnaa|sõnoil|sõnall|sõnoilõ|sõnaz|sõnoit|sõnoiss|sõnalt|sõnalõssa	<i>noun</i><br><ol><li>word</li></ol>
sõnatširja|sõnatširjaz|sõnatširjassi|sõnatširjalt|sõnatširjallõ|sõnatširjad|sõnatširjoilõ|sõnatširjass|sõnatširjoiz|sõnatširjoissi|sõnatširjoje|sõnatširjoilt|sõnatširjoiss|sõnatširjaa|sõnatširjoil|sõnatširjoisõ|sõnatširjoit|sõnatširjoina|sõnatširjana|sõnatširjall	<i>noun</i><br><ol><li>dictionary</li></ol>
sõpa|sõvaa	<i>noun</i><br><ol><li>garment</li><li>clothing</li></ol>
sõrmi|sõrmõõ	<i>noun</i><br><ol><li>finger</li></ol>
sõta|sõaa	<i>noun</i><br><ol><li>war, conflict</li></ol>
sõutaa|sõvvan|sõvvin	<i>verb</i><br><ol><li>to row (with oars)</li></ol>
sõzar|sõsarõnna|sõsarõllessa|sõsarõlt|sõsarissi|sõsarõssi|sõsariina|sõsarille|sõsarõd|sõsariss|sõsarijeka|sõsarije|sõsarõõ|sõsariise|sõsarõz|sõzarta|sõsarõllõ|sõsarõll|sõsarill|sõsariz|sõsarõss|sõsariit|sõsarillessa|sõsarõka|sõsarilt	<i>noun</i><br><ol><li>sister</li></ol>
süntüä|süntüzin|sünnün	<i>verb</i><br><ol><li>to be born</li></ol>
sütšüzü|sütšüzüü	<i>noun</i><br><ol><li>autumn, fall</li></ol>
süvvä|sein|söön	<i>verb</i><br><ol><li>to eat</li><li>to consume</li></ol>
süä|süämmed|süämmiijeka|süämmez|süämmilt|süämmije|süämmiinä|süämmelle|süämmelt|süämmille|süämmess|süämmiit|süämmiss|süämmeessa|süämmiisessa|süämmill|süämmee|süät|süämmell|süämmenä|süämmiise|süämmeka|süämmessi|süämee|süämmissi|süämmiz	<i>noun</i><br><ol><li>heart</li></ol>
süü	<i>noun</i><br><ol><li>fault, error</li><li>guilt</li><li>blame</li><li>reason, cause</li></ol>
taimi|taimõõ	<i>noun</i><br><ol><li>young tree</li><li>seedling</li></ol>
taivaz|taivaa	<i>noun</i><br><ol><li>sky</li><li>heaven</li></ol>
talvi|talvõõ	<i>noun</i><br><ol><li>winter</li></ol>
tanttsu	<i>noun</i><br><ol><li>dance, dancing</li></ol>
tedri|tedrii	<i>noun</i><br><ol><li>grouse</li></ol>
tee	<i>noun</i><br><ol><li>way, road</li></ol>
tehä|tein|teen	<i>verb</i><br><ol><li>to do</li><li>to make</li><li>to prepare, to ready</li><li>to arrange, to put in order, to set up</li></ol>
terve|tervee	<i>adj</i><br><ol><li>healthy</li><li>whole, unbroken</li></ol><br><i>intj</i><br><ol><li>hello</li></ol>
tervüüz|terveüz|tervüü|terveüü|tervühsee	<i>noun</i><br><ol><li>health</li></ol>
terä|terää	<i>noun</i><br><ol><li>ploughshare</li><li>blade</li></ol>
toomi|toomõõ	<i>noun</i><br><ol><li>bird cherry</li></ol>
traatti	<i>noun</i><br><ol><li>wire</li></ol>
truba|trubaa	<i>noun</i><br><ol><li>chimney</li><li>pipe</li></ol>
tuhad|tuhattõmõõ|tuhattõmaa	<i>num</i><br><ol><li>thousand</li></ol>
tuli|tulõõ	<i>noun</i><br><ol><li>fire</li></ol>
tulla|tulin|tulõn	<i>verb</i><br><ol><li>to come</li><li>to arrive</li><li>(of rain, snow etc.) to come down, to fall</li><li>to come to pass, to happen</li><li>to come up, to arise, to appear</li><li>to become, to turn into</li></ol>
tuntõa|tunnõn|tuuzin	<i>verb</i><br><ol><li>to know</li><li>to feel</li></ol>
tuvva|tõin|toon	<i>verb</i><br><ol><li>to bring, to fetch</li></ol>
tähti|tähtiinä|tähtee|tähdill|tähessi|tähell|tähelessa|tähdile|tähelt|tähdiz|tähed|tähess|tähtiise|tähtije|tähen|tähez|tähtiika|täheka|tähdiss|tähtiit|tähdissi|tähele|tähee|tähdilt|tähdilessa|tähtea	<i>noun</i><br><ol><li>star</li></ol>
tähtši|tähďee	<i>noun</i><br><ol><li>corn</li></ol>
täi	<i>noun</i><br><ol><li>louse</li></ol>
täätää|tään|tääzin	<i>verb</i><br><ol><li>to know</li><li>to know how, to be able, can</li></ol>
tõin|tõizõõ	<i>adj</i><br><ol><li>second</li><li>other, another</li></ol>
tõinõpäivä|tõinõpäivää	<i>noun</i><br><ol><li>Tuesday</li></ol>
tõrva|tõrvaa	<i>noun</i><br><ol><li>tar</li></ol>
tõuko	
töö|töössi|töďďe|töhee|tööd|töilt|töiz|tööt|töönä|tööz|tööl|töiss|tööka|tööle|töile|töit|töissi|töil|tööss|töölt|töise|töika|töinä|töösessa|töisessa	<i>noun</i><br><ol><li>work</li></ol>
tütär|tüttäred|tüttärez|tüttärilt|tüttärellessa|tüttäriit|tüttärillessa|tüttärell|tüttäress|tüttärill|tüttärennä|tüttäressi|tüttärelt|tütärtä|tüttäreka|tüttärille|tüttäriise|tüttärijeka|tüttäriz|tüttärije|tüttärelle|tüttärissi|tüttäriss|tüttäriinä|tüttäree	<i>noun</i><br><ol><li>daughter</li></ol>
tšeeli|tšeelee	<i>noun</i><br><ol><li>tongue</li><li>language</li></ol>
tšehsi	<i>noun</i><br><ol><li>middle, center</li></ol>
tšentšä|tšennä	<i>noun</i><br><ol><li>shoe</li></ol>
tšesä|tšezää	<i>noun</i><br><ol><li>summer</li></ol>
tševäd|tševäďďe|tševäil|tševääz|tševättä|tševääle|tševäiz|tševäält|tševäit|tševännä|tševäinä|tševää|tševäässi|tševäilt|tševäile|tševääl|tševäďďeka|tševäilessa|tševäälessa|tševääss|tševääse|tševäise|tševäiss|tševääd|tševäissi|tševääkä	<i>noun</i><br><ol><li>spring (season)</li></ol>
tšimo|tšimoo	<i>noun</i><br><ol><li>bee</li></ol>
tšipiä	<i>adj</i><br><ol><li>sore</li></ol>
tširiä	<i>adj</i><br><ol><li>taut</li></ol>
tširja|tširjaa	<i>noun</i><br><ol><li>book</li></ol>
tširjai|tširjaimiz|tširjaimõõssa|tširjaimõna|tširjaimill|tširjaimiss|tširjaimijeka|tširjait|tširjaimõka|tširjaimõlt|tširjaimõd|tširjaimiit|tširjaimiisõssa|tširjaimõ|tširjaimõss|tširjaimije|tširjaimiisõ|tširjaimõllõ|tširjaimillõ|tširjaimõll|tširjaimõz|tširjaimilt|tširjaimõssi|tširjaimiina|tširjaimõõ|tširjaimissi	<i>noun</i><br><ol><li>A character, letter.</li></ol>
tširppu|tširpuu	<i>noun</i><br><ol><li>flea</li></ol>
tširvez|tširvee	<i>noun</i><br><ol><li>axe</li></ol>
tšiutto|tšiutoo	<i>noun</i><br><ol><li>shirt</li></ol>
tšivi|tšivee|tšivelt|tšivilt|tšiviit|tšivele|tšiveka|tšiveessa|tšiviika|tšived|tšivessi|tšivez|tšiviiz|tšivell|tšivissi|tšivenä|tšivess|tšiveä|tšiviinä|tšivije|tšiviise|tšiviss|tšivill|tšivisessa|tšivile	<i>noun</i><br><ol><li>stone, rock</li></ol>
tšärppä|tšärpää	<i>noun</i><br><ol><li>ermine, stoat</li><li>least weasel</li></ol>
tšäsi|tšäzilt|tšäee|tšäzile|tšäsiise|tšäsiisessa|tšäessi|tšäteessa|tšäess|tšäeka|tšäenä|tšäziz|tšättä|tšäsije|tšäed|tšäele|tšäelt|tšäsiit|tšäziss|tšäsijeka|tšätee|tšäell|tšäzissi|tšäez|tšäzill|tšäsiinä	<i>noun</i><br><ol><li>hand</li></ol>
tšävvä|tšäün|tšäüzin	<i>verb</i><br><ol><li>to walk</li><li>to go</li></ol>
tšülmä|tšülmää	<i>adj</i><br><ol><li>cold</li></ol>
tšülä|tšülää	<i>noun</i><br><ol><li>village</li></ol>
tšüläläin|tšüläläizee	<i>noun</i><br><ol><li>villager</li></ol>
tšümmee|tšümmenee	<i>num</i><br><ol><li>ten</li></ol>
tšüsüä|tšüsüzin|tšüzün	<i>verb</i><br><ol><li>to ask, to enquire</li></ol>
tšüünel|tšuunelee	<i>noun</i><br><ol><li>tear (eye liquid)</li></ol>
tšüüsi|tšünnee|tšüünee	<i>noun</i><br><ol><li>nail (on finger or toe)</li><li>claw, talon</li></ol>
uhsi|uhsiisõssa|uhsõlt|uhsilõ|uhsiit|ussa|uhsiisõ|uhsõka|uhsõõ|uhsijeka|uhsõss|uhsissi|uhsill|uhzõõ|uhsõll|uhsõz|uhsiss|uhsõlõ|uhsõõssa|uhsilt|uhsiina|uhsõssi|uhsije|uhsõd|uhsõna|uhsiz	<i>noun</i><br><ol><li>door</li></ol>
ujua|ujun|ujuzin	<i>verb</i><br><ol><li>to swim</li></ol>
uusi|uvvõõ	<i>adj</i><br><ol><li>new</li></ol>
vahtši|vazgõõ	<i>noun</i><br><ol><li>copper (metal)</li></ol>
vaikko|vaikoo	<i>noun</i><br><ol><li>resin</li></ol>
valkõa	<i>adj</i><br><ol><li>white</li></ol>
vana|vanaa	<i>adj</i><br><ol><li>old</li></ol><br><i>noun</i><br><ol><li>old/elderly person</li></ol>
varõz|varõhsiilt|varõhsõõ|varõhsije|varõhsõka|varõhsõssi|varõhsiit|varõhsõsõ|varõhsiisõ|varõhsõz|varõhsiissi|varõhsijeka|varõhsiil|varõhsõlt|varõhsõnna|varõhsõllõ|varõhsiiz|varõhsõllõssa|varõhsiiss|varõhsiina|varõhsõd|varõhsõll|varõhsõss|varõssa|varõhsiilõ|varõhsiilõssa	<i>noun</i><br><ol><li>crow</li></ol>
vaďďa|vaďďaa	<i>noun</i><br><ol><li>pile</li><li>Votic (language)</li></ol>
vaďďalain|vaďďalaizõõ	<i>noun</i><br><ol><li>Vote, Votic person</li></ol>
veeri|veeree	<i>noun</i><br><ol><li>side</li><li>flank</li></ol>
veittsi|veitsee	<i>noun</i><br><ol><li>(Kukkuzi) knife</li></ol>
veitšiä	<i>adj</i><br><ol><li>merry</li></ol>
velli|velliinä|velliise|velliika|vellill|velled|velliit|velleessa|vellelt|vellisessa|velliz|vellessi|vellee|vellez|vellilt|vellile|vellele|velliss|velleka|velless|vellije|vellell|vellissi|velleä|vellenä	<i>noun</i><br><ol><li>brother</li></ol>
vene|venee|venehtä	<i>noun</i><br><ol><li>boat</li></ol>
veri|veree	<i>noun</i><br><ol><li>blood</li></ol>
vesi|vetee|veess|vezile|vezissi|veessi|vee|veenä|veelt|veed|veell|veeka|veele|veteessa|veziz|vettä|vesijeka|vesiisessa|vesiit|vesiise|vezilt|vezill|vesiinä|veziss|veez|vesije	<i>noun</i><br><ol><li>water</li></ol>
viha|vihaa	<i>noun</i><br><ol><li>anger, rage</li><li>hatred</li></ol>
viherä|viherää	<i>adj</i><br><ol><li>green (colour)</li><li>immature, inexperienced</li></ol>
vihma|vihmaa	<i>noun</i><br><ol><li>rain</li></ol>
viijjä|veen|vein	<i>verb</i><br><ol><li>to carry, to bear</li><li>to lead, to guide</li><li>to drive</li></ol>
viisi|viijjee	<i>num</i><br><ol><li>five</li></ol>
viistõššõmõtta	<i>num</i><br><ol><li>fifteen</li></ol>
virolain|virolaizõõ	<i>noun</i><br><ol><li>Estonian (person)</li></ol>
voosi|vovvõõ	<i>noun</i><br><ol><li>year</li></ol>
vätši|väee	<i>noun</i><br><ol><li>people</li><li>nation</li></ol>
vävü|vävüü	<i>noun</i><br><ol><li>son-in-law</li></ol>
väärä|väärää	<i>adj</i><br><ol><li>crooked, bent</li><li>guilty</li><li>wrong, incorrect</li><li>false, not true</li></ol>
võdna|võdnaa	<i>noun</i><br><ol><li>yeanling, newborn sheep</li></ol>
või	<i>conj</i><br><ol><li>or</li></ol><br><i>noun</i><br><ol><li>butter</li></ol>
võittaa|võittazin|võitan	<i>verb</i><br><ol><li>to defeat, to beat</li><li>to overcome</li><li>to win</li></ol>
võtii|võttimissi|võttimiisõssa|võttimõka|võttimõõssa|võttimõss|võttimilt|võttimõd|võttimiz|võttimõssi|võttimillõ|võttimije|võttimõz|võttimijeka|võttimõllõ|võttimiisõ|võttimõ|võttimiit|võttimõlt|võttimõll|võtiit|võttimill|võttimõna|võttimõõ|võttimiina|võttimiss	<i>noun</i><br><ol><li>key</li></ol>
võttaa|võtan|võtin	<i>verb</i><br><ol><li>to take</li><li>to take as a wife, to marry</li><li>to take away, to capture</li><li>to mow, to cut</li></ol>
yvää uutta vootta	<i>phrase</i><br><ol><li>Happy New Year</li></ol>
zemľänka|zemľänkaa	<i>noun</i><br><ol><li>dugout, earth-house, (mud) hut, zemlyanka</li></ol>
zveeri|zveerii	<i>noun</i><br><ol><li>wild animal, beast</li></ol>
äntä|ännää	<i>noun</i><br><ol><li>tail (of an animal)</li></ol>
ärtšä|ärjää	<i>noun</i><br><ol><li>bull</li></ol>
ätä|ädää	<i>noun</i><br><ol><li>father</li></ol>
ätšiä	<i>adj</i><br><ol><li>evil</li></ol>
ääli|äälee	<i>noun</i><br><ol><li>voice</li></ol>
ääni|äänee	<i>noun</i><br><ol><li>voice</li></ol>
ääri|ääree	<i>noun</i><br><ol><li>edge, verge</li><li>fringe</li></ol>
õhsa|õhzaa	<i>noun</i><br><ol><li>branch, twig</li></ol>
õhtago|õhtagoo	<i>noun</i><br><ol><li>evening</li></ol>
õikõa|õikõaa	<i>adj</i><br><ol><li>straight, unbent</li><li>direct</li><li>right, correct</li><li>righteous, just</li></ol>
õja|õjaa	<i>noun</i><br><ol><li>brook, stream</li></ol>
õlka|olaa	<i>noun</i><br><ol><li>shoulder</li></ol>
õlla|õõn|õlin	<i>verb</i><br><ol><li>to be</li></ol>
õltši|õlgõõ	<i>noun</i><br><ol><li>hay, straw</li></ol>
õlud|õluiss|õluud|õluusõssa|õlutta|õluulõ|õluďďeka|õluilt|õlunna|õluusõ|õluu|õluina|õluissi|õluult|õluilõ|õluussi|õluďďe|õluul|õluil|õluisõ|õluuka|õluiz|õluuss|õluisõssa|õluuz|õluit	<i>noun</i><br><ol><li>beer</li></ol>
õmmõlla|õmpõlin|ompõõn	<i>verb</i><br><ol><li>to sew</li></ol>
õnni|õnnõõ	<i>noun</i><br><ol><li>luck</li><li>fate</li></ol>
õppia|õppizin|õpin	<i>verb</i><br><ol><li>to learn</li><li>to study</li></ol>
õpõa|õppaa	<i>noun</i><br><ol><li>silver</li></ol>
õrava|õravaa	<i>noun</i><br><ol><li>squirrel</li></ol>
õssaa|õsin|õsan	<i>verb</i><br><ol><li>to buy</li></ol>
õźźa|õźall|õźďill|õźassi|õźďiit|õźďisõssa|õźďissi|õźźaz|õźźad|õźďiz|õźalt|õźźana|õźďiisõ|õźďilt|õźźaa|õźźasõ|õźaka|õźďije|õźďilõ|õźasõssa|õźalõ|õźďiina|õźass|õźďiika|õźďiss	<i>noun</i><br><ol><li>horsetail (plant)</li></ol>
öö|ööz|ühee|üüd|öit|üüss|öiz|öissi|üise|üit|öil|üzenä|üülessa|öďďe|ööl|ööka|öinä|üüle|öösessa|üül|üüssi|ööd|üült|üilt|öölt|öönä|üissi|üü|üüt|üďďe|üiz|üiss|ööle|üizenä|öise|ööss|üile|öiss|üilessa|öilt|üika|üüka|öhee|üüz|öile|öössi|ööt|öika|üil|öisessa	<i>noun</i><br><ol><li>night</li></ol>
ühesää|ühessämee	<i>num</i><br><ol><li>nine</li></ol>
ühesäätõššõmõtta	<i>num</i><br><ol><li>nineteen</li></ol>
ühsi|ühee	<i>num</i><br><ol><li>one</li></ol>
ühstõššõmõtta	<i>num</i><br><ol><li>eleven</li></ol>
üle|ülee	<i>noun</i><br><ol><li>sour cream</li></ol>
ülle|ültšee	<i>noun</i><br><ol><li>seal</li></ol>
üvä|parõpi|üvää|parõpaa|kõikkõa parõpi	<i>adj</i><br><ol><li>good</li></ol>
ńemoi|ńemoit	<i>adj</i><br><ol><li>mute</li></ol>
