A	<i>character</i><br><ol><li>The first letter of the Võro alphabet, called a and written in the Latin script.</li></ol>
Albaania|Albaanialt|Albaanian|Albaaniagaq|Albaanial|Albaanialdaq|Albaaniat|Albaaniahe|Albaanias|Albaaniahn|Albaanialõ|Albaaniast|Albaanianiq	<i>name</i><br><ol><li>Albania (a country in Europe)</li></ol>
Alžeeriä	<i>name</i><br><ol><li>Algeria (a country in Africa)</li></ol>
Ameeriga Ütisriigiq|Ameeriga Ütisriigen|Ameeriga Ütisriigelt|Ameeriga Ütisriigel|Ameeriga Ütisriike|Ameeriga Ütisriikehe|Ameeriga Ütisriigehn|Ameeriga Ütisriigest|Ameeriga Ütisriikegäq|Ameeriga Ütisriigeldäq|Ameeriga Ütisriigeniq|Ameeriga Ütisriigele|Ameeriga Ütisriiges	<i>name</i><br><ol><li>United States of America (a country in North America)</li></ol>
Araabia Ütisemiraadiq	<i>name</i><br><ol><li>United Arab Emirates</li></ol>
Armeeniä|Armeeniäniq|Armeeniän|Armeeniäst|Armeeniäle|Armeeniält|Armeeniäs|Armeeniät|Armeeniähn|Armeeniäl|Armeeniäldäq|Armeeniägäq|Armeeniähe	<i>name</i><br><ol><li>Armenia (a country in Europe and Asia)</li></ol>
Asõrbaidžaan	<i>name</i><br><ol><li>Azerbaijan (a country in Europe and Asia)</li></ol>
Belgiä|Belgiäs|Belgiäniq|Belgiält|Belgiäldäq|Belgiäst|Belgiäle|Belgiät|Belgiäl|Belgiähn|Belgiägäq|Belgiän|Belgiähe	<i>name</i><br><ol><li>Belgium (a country in Europe)</li></ol>
Bosnia|Bosniagaq|Bosnian|Bosnialõ|Bosnias|Bosnial|Bosniat|Bosnialt|Bosniast|Bosniahe|Bosnialdaq|Bosnianiq|Bosniahn	<i>name</i><br><ol><li>Bosnia</li></ol>
Bosnia ja Hertsegoviina|Bosniagaq|Hertsegoviinalt|Bosnian|Bosnialõ|Hertsegoviinan|Bosnialt|Hertsegoviinaniq|Hertsegoviinas|Bosnianiq ja Hertsegoviinaniq|Hertsegoviinna|Bosniahn ja Hertsegoviinan|Hertsegoviinalõ|Bosnialõ ja Hertsegoviinalõ|Bosnial|Bosnialdaq|Bosnialdaq ja Hertsegoviinaldaq|Bosnian ja Hertsegoviinahn|Bosnianiq|Bosnialt ja Hertsegoviinalt|Bosnias ja Hertsegoviinas|Hertsegoviinal|Hertsegoviinahn|Hertsegoviina|Bosniast ja Hertsegoviinast|Hertsegoviinaldaq|Hertsegoviinast|Bosniahn ja Hertsegoviinahn|Bosniast|Bosniahe ja Hertsegoviinna|Bosniahn|Bosnia|Bosniat ja Hertsegoviinna|Bosnian ja Hertsegoviinan|Bosnial ja Hertsegoviinal|Bosniagaq ja Hertsegoviinagaq|Bosnias|Bosniat|Hertsegoviinagaq|Bosniahe	<i>name</i><br><ol><li>Bosnia and Herzegovina (a country in Europe)</li></ol>
Eesti|Eestil|Eestis|Eestiniq|Eestile|Eestigäq|Eestilt|Eestildäq|Eestit|Iisti|Eestihte|Eestin|Eestist|Eestihn	<i>name</i><br><ol><li>Estonia</li></ol>
Egüptüs	<i>name</i><br><ol><li>Egypt</li></ol>
Elevandiluurand|Elevandiluurannagaq|Elevandiluurannaldaq|Elevandiluurannahn|Elevandiluuranda|Elevandiluurannalt|Elevandiluurannas|Elevandiluurannaniq|Elevandiluuranna|Elevandiluurannan|Elevandiluurannalõ|Elevandiluurannal|Elevandiluurannast	<i>name</i><br><ol><li>Côte d'Ivoire</li></ol>
Filipiiniq	<i>name</i><br><ol><li>Philippines</li></ol>
Helsinki	<i>name</i><br><ol><li>Helsinki (the capital city of Finland)</li></ol>
Hertsegoviina|Hertsegoviinna|Hertsegoviinahn|Hertsegoviinalõ|Hertsegoviinaldaq|Hertsegoviinalt|Hertsegoviinan|Hertsegoviinaniq|Hertsegoviinas|Hertsegoviinagaq|Hertsegoviinast|Hertsegoviinal	<i>name</i><br><ol><li>Herzegovina</li></ol>
Hummogu-Timor	<i>name</i><br><ol><li>East Timor</li></ol>
Indoneesiä	<i>name</i><br><ol><li>Indonesia</li></ol>
Inglüsmaa|Inglüsmaagaq|Inglüsmaahn|Inglüsmaad|Inglüsmaas|Inglüsmaalt|Inglüsmaan|Inglüsmaalõ|Inglüsmaaniq|Inglüsmaahtõ|Inglüsmaahõ|Inglüsmaaldaq|Inglüsmaal|Inglüsmaast	<i>name</i><br><ol><li>England</li></ol>
Island'|Islandihe|Islandit|Islandiniq|Islandihn|Islandist|Islandilt|Islandis|Islandi|Islandilõ|Islandin|Islandil|Islandildaq|Islandigaq	<i>name</i><br><ol><li>Iceland (a country in Europe)</li></ol>
Jõgõva	<i>name</i><br><ol><li>Jõgeva (a city in Estonia)</li></ol>
Kamõrun	<i>name</i><br><ol><li>Cameroon</li></ol>
Kar'ala	<i>name</i><br><ol><li>Karelia</li></ol>
Kar'ala Vabariik	<i>name</i><br><ol><li>The Republic of Karelia</li></ol>
Kasastan	<i>name</i><br><ol><li>Kazakhstan</li></ol>
Kesk-Afriga Vabariik	<i>name</i><br><ol><li>Central African Republic</li></ol>
Kriika	<i>name</i><br><ol><li>Greece</li></ol>
Kurõssaarõ	<i>name</i><br><ol><li>Kuressaare (a city in Estonia)</li></ol>
Kuuba	<i>name</i><br><ol><li>Cuba (an island and country in the Caribbean)</li></ol>
Küprüs|Küprüssel|Küprüsegäq|Küprüsseniq|Küprüsses|Küprüssest|Küprüsen|Küprüseniq|Küprüsselt|Küprüssegäq|Küprüssele|Küprüsele|Küprüse|Küprüsel|Küprüst|Küprüsehn|Küprüses|Küprüselt|Küprüsest|Küprüseldäq|Küprüssen|Küprüssehn|Küprüsseldäq|Küprüsse|Küprüssehe	<i>name</i><br><ol><li>Cyprus</li></ol>
Leedu	<i>name</i><br><ol><li>Lithuania</li></ol>
Makõdoonia	<i>name</i><br><ol><li>Macedonia</li></ol>
Montõnegro	<i>name</i><br><ol><li>Montenegro</li></ol>
Mõisakülä	<i>name</i><br><ol><li>Mõisaküla (small town in Southern Estonia)</li></ol>
Norra	<i>name</i><br><ol><li>Norway</li></ol>
Nõvvokogo Liit	<i>name</i><br><ol><li>Soviet Union</li></ol>
Otõmpää|Otõmpääldäq|Otõmpääl|Otõmpäähä|Otõmpääd|Otõmpääniq|Otõmpäägäq|Otõmpään|Otõmpäähn|Otõmpääle|Otõmpääst|Otõmpäält|Otõmpähäq|Otõmpääs	<i>name</i><br><ol><li>Otepää (a city in Estonia)</li></ol>
Paidõ	<i>name</i><br><ol><li>Paide (a city in Estonia)</li></ol>
Prantsusmaa|Prantsusmaalõ|Prantsusmaahõ|Prantsusmaalt|Prantsusmaahn|Prantsusmaagaq|Prantsusmaast|Prantsusmaaniq|Prantsusmaad|Prantsusmaas|Prantsusmaahtõ|Prantsusmaaldaq|Prantsusmaan|Prantsusmaal	<i>name</i><br><ol><li>France</li></ol>
Pärno	<i>name</i><br><ol><li>Pärnu (a city in Estonia)</li></ol>
Põh'a-Korea	<i>name</i><br><ol><li>North Korea</li></ol>
Romaania	<i>name</i><br><ol><li>Romania</li></ol>
Roodsi	<i>name</i><br><ol><li>Sweden</li></ol>
S'aksamaa|S'aksamaahõ|S'aksamaaldaq|S'aksamaast|S'aksamaahtõ|S'aksamaad|S'aksamaal|S'aksamaalt|S'aksamaahn|S'aksamaas|S'aksamaagaq|S'aksamaan|S'aksamaalõ|S'aksamaaniq	<i>name</i><br><ol><li>Germany</li></ol>
Saarõmaa|Saarõmaahtõ|Saarõmaalõ|Saarõmaahõ|Saarõmaad|Saarõmaalt|Saarõmaas|Saarõmaan|Saarõmaaldaq|Saarõmaal|Saarõmaast|Saarõmaaniq|Saarõmaagaq|Saarõmaahn	<i>name</i><br><ol><li>Saaremaa, the largest island of Estonia.</li><li>Saare County in Estonia.</li><li>Saaremaa, historical Estonian eldership.</li></ol>
Sloveeniä	<i>name</i><br><ol><li>Slovenia</li></ol>
Soomõ	<i>name</i><br><ol><li>Finland</li></ol>
Taani	<i>name</i><br><ol><li>Denmark</li></ol>
Talliin	<i>name</i><br><ol><li>Tallinn (the capital city of Estonia)</li></ol>
Tarto	<i>name</i><br><ol><li>Tartu (the second-largest city in Estonia)</li></ol>
Tsehhi	<i>name</i><br><ol><li>Czech Republic</li></ol>
Valgõvinne	<i>name</i><br><ol><li>Belarus (a country in Europe)</li></ol>
Vikipeediä	<i>name</i><br><ol><li>Wikipedia</li></ol>
Vikisynaraamat	<i>name</i><br><ol><li>Wiktionary</li></ol>
Viländi	<i>name</i><br><ol><li>Viljandi (a city in Estonia)</li></ol>
Vinnemaa|Vinnemaahõ|Vinnemaaldaq|Vinnemaan|Vinnemaahn|Vinnemaas|Vinnemaahtõ|Vinnemaalõ|Vinnemaalt|Vinnemaad|Vinnemaagaq|Vinnemaaniq|Vinnemaast|Vinnemaal	<i>name</i><br><ol><li>Russia</li></ol>
Võro|Võrolt|Võrro|Võros|Võrost|Võrogaq|Võrohn|Võrol|Võrolõ|Võroniq|Võroldaq|Võron	<i>name</i><br><ol><li>Võru (a town in Võru, Estonia)</li></ol>
aa	<i>noun</i><br><ol><li>The name of the Latin-script letter A.</li></ol>
aadom'|atomiq|atomi|atomin|atominiq|atomilt|aadominiq|aadomigaq|atomildaq|atomilõ|atomis|aadomilt|aadomihe|atomihn|aadomist|aadomilõ|atomidõgaq|atomit|aadomin|aadomidõ|atomist|atomil|aadomit|aadomildaq|atomidõ|aadomihn|aadomiq|aadomi|atom'|aadomil|aadomis|atomigaq|atomihe|aadomidõgaq	<i>noun</i><br><ol><li>atom</li></ol>
aadomisäsü|aadomisäsüs|aadomisäsüniq|aadomisässü|aadomisäseldäq|aadomisässeldäq|aadomisäsüldäq|aadomisäsühn|aadomisäsült|aadomisäsehn|aadomisässe|aadomisäsele|aadomisässel|aadomisässele|aadomisässelt|aadomisäseniq|aadomisässegäq|aadomisäses|aadomisäsest|aadomisässehe|aadomisässen|aadomisässest|aadomisäsün|aadomisäsüq|aadomisäsel|aadomisäselt|aadomisäsügäq|aadomisäsüle|aadomisäsül|aadomisäsüst|aadomisässeniq|aadomisässehn|aadomisässes|aadomisäsen	<i>noun</i><br><ol><li>atomic nucleus</li></ol>
aastak|aastildaq|aastilt|aastakka|aastalõ|aastis|aastihn|aastilõ|aastidõ|aastak .|aastahe|aastagat|aastit|aastast|aastat|aastahn|aastas|aastaldaq|aastaga|aastaniq|aastil|aastin|aastist|aastagaq|aastidõgaq|aastan|aastihe|aastiniq|aastal|aasta|aastalt|aastaq	<i>noun</i><br><ol><li>year</li></ol>
abi|abis|apõhe|abilt|abigaq|abõhn|abõlt|apõs|abõst|abõn|abõs|abõldaq|api|apõlõ|abil|abiq|apõgaq|abildaq|abihn|abõlõ|apõniq|apõlt|abõl|abiniq|abõniq|apõ|apõl|abin|abilõ|apõldaq|abist|apõst|apõhn|apõn	<i>noun</i><br><ol><li>help, aid, assistance</li></ol>
adõr|adralõ|adraniq|adrost|adros|adrolt|adroniq|adroldaq|adra|adraq|adrolõ|atrohe|atra|adragaq|adralt|adral|adrast|adrahn|adrol|atrogaq|adras|adran|adron|adraldaq|atr|adrohn|atro|adyr'	<i>noun</i><br><ol><li>plough</li></ol>
ago|akõ|ako|aoniq|akal|akast|akõldaq|akagaq|aost|akõs|aol|akka|akko|aon|akahn|akalõ|akaniq|aka|akkahe|akkõ|akõlt|akõhn|aogaq|akõgaq|aolõ|akõniq|aoq|aos|akaldaq|aoldaq|ao|aohn|akõlõ|akas|akalt|akan|akõn|aolt|akõl|akõst|akkõhe	<i>noun</i><br><ol><li>twilight</li></ol>
ahhun'|ahunahn|ahunilt|ahunihn|ahunagaq|ahunist|ahunalõ|ahunaniq|ahunas|ahunit|ahuniniq|ahunilõ|ahunahe|ahunidõgaq|ahunis|ahunast|ahunal|ahunin|ahunalt|ahunidõ|ahunan|ahunihe|ahunildaq|ahunaq|ahuna|ahunaldaq|ahunil|ahunat	<i>noun</i><br><ol><li>perch (fish)</li></ol>
ahi|ahan|ah'alõ|ah'ogaq|ah'õn|ahõlõ|ah'as|aholõ|ah'õlt|ahos|ahõn|ahoq|ah'ohn|ahaniq|ahjõ|ah'oldaq|ahon|ahast|ahõs|ahõniq|ahjahe|ahalt|ahaldaq|aholdaq|ah'aldaq|ahas|ah'õst|ahohn|ah'ahn|ahja|ahõhn|ahost|ah'oniq|ahõst|ah'ol|ahahn|ahalõ|ahol|ah'olõ|ahõl|ah'õhn|ah'os|ah'õniq|ah'an|ah'alt|ah'on|ah'ost|aholt|ah'o|ahjõhe|ahõldaq|ahogaq|ah'õlõ|ah'olt|ahõlt|ah'oq|ah'õl|ahal|ah'al|ah'õs|ahjõgaq|aho|ahoniq|ah'aniq|ah'õldaq|ahjagaq|ahjo|ah'ast	<i>noun</i><br><ol><li>oven</li></ol>
aid|aiol|aida|aido|aiolt|aiost|aios|aian|aialt|aidogaq|aiolõ|aialõ|aiaq|aial|aiohn|aiahn|aioniq|aia|aidohe|aiast|aialdaq|aioldaq|aiagaq|aion|aias|aianiq	<i>noun</i><br><ol><li>garden</li></ol>
aig|aes|aoniq|aigo|aeldaq|aost|aigõ|aol|aon|aehn|aeniq|aogaq|aelt|aolõ|aelõ|aen|aoq|aos|aigõhe|aoldaq|ao|aohn|aest|ael|aolt|aigõgaq	<i>noun</i><br><ol><li>time</li><li>(grammar) tense</li></ol>
ajama|aja|ajjaq|aiaq	<i>verb</i><br><ol><li>to drive</li></ol>
alomanõ|alomadsõgaq|alomadsõlõ|alomaidsilõl|alomastõl|alomaidsigaq|alomaidsilõs|alomastõst|alomastõniq|alomadsõl|alomaidsilõniq|alomadsõq|alomadsõldaq|alomastõn|alomadsõst|alomast|alomadsõn|alomaidsilõhn|alomaidsihe|alomadsõs|alomastõs|alomaidsilõlt|alomaidsilõn|alomastõlõ|alomaidsilõst|alomastõgaq|alomastõlt|alomaidsilõldaq|alomadsõlt|alomastõhn|alomastõldaq|alomadsõhn|alomadsõniq|alomadsõ|alomaidsi|alomastõ|alomaidsilõlõ	<i>adj</i><br><ol><li>lower</li><li>bottom</li></ol>
alonõ|alostõniq|alodsõlt|alodsõldaq|alodsõgaq|alotsihn|alodsõq|alostõlõ|alotsist|alotsidõ|alotsildaq|alotsiniq|alotsihe|alodsõhn|alostõst|alodsõl|alotsilõ|alostõn|alostõgaq|alodsõlõ|alostõhe|alotsõhe|alodsõniq|alostõldaq|alostõs|alotsidõgaq|alotsil|alodsõs|alostõlt|alostõhn|alostõl|alotsilt|alostõ|alotsin|alotsis|alotsit|alodsõ|alodsõn|alost|alodsõst	<i>adj</i><br><ol><li>(in compounds) below, sub-</li></ol>
alumiinium	<i>noun</i><br><ol><li>aluminium</li></ol>
andma|anna|andaq	<i>verb</i><br><ol><li>to give</li></ol>
armsa|armidõ|armil|armilt|armastõst|armaldaq|armsaldaq|armsalt|armsin|armas|armsat|armastõniq|armsaq|armsist|armsilt|armist|armsas|armaq|armildaq|armihe|armastõl|armsit|armilõ|armastõn|armaniq|armal|armastõ|armast|armin|armastõlõ|armsidõ|armsilõ|armagaq|armihn|armastõs|armastõldaq|armahe|armsis|armsal|armsast|armastõhe|armsiniq|armit|armastõhn|armastõgaq|armastõlt|armsagaq|arminiq|armidõgaq|armsihn|armsalõ|armsahn|armsahe|armsaniq|armsildaq|armsil|arma|arman|armsan|armalt|armis|armsihe|armsidõgaq|armalõ|armahn	<i>adj</i><br><ol><li>dear, beloved</li></ol>
asi|as'an|as'olõ|as'aniq|asjo|as'ost|as'aldaq|as'as|as'alõ|as'al|as'agaq|as'aq|asjohe|as'ast|asjogaq|as'alt|asja|as'ol|as'oldaq|as'on|as'ohn|as'os|as'olt|as'a|as'ahn|as'oniq	<i>noun</i><br><ol><li>matter</li><li>thing</li><li>subject</li><li>toy, plaything</li></ol>
astma|astuq|astu	<i>verb</i><br><ol><li>to step</li><li>to walk</li></ol>
asõq|asõmaniq|asõmõn|asõndõl|asõmõs|asõminiq|asõmõgaq|asõmaq|asõndõs|asõndõ|asõndõn|asõmahn|asõmidõ|asõmihe|asõndõlõ|asõmis|asõmõl|asõmaldaq|asõmal|asõmilõ|asõndõhe|asõmalt|asõmildaq|asõmagaq|asõndõlt|asõmil|asõndõgaq|asõmõniq|asõmist|asõmõhn|asõmit|asõmidõgaq|asõman|asõmilt|asõndõhn|asõndõniq|asõmin|asõmast|asõmõlõ|asõnd|asõma|asõmahe|asõmas|asõmõlt|asõmõq|asõmõhe|asõndõldaq|asõmalõ|asõndõst|asõmõldaq|asõmõst|asõmõ|asõmihn	<i>noun</i><br><ol><li>place, spot</li><li>bed, bedstead</li><li>print, track</li></ol>
avitama|avida|avitaq	<i>verb</i><br><ol><li>to help</li></ol>
bee	<i>noun</i><br><ol><li>The name of the Latin-script letter B.</li></ol>
dee	<i>noun</i><br><ol><li>The name of the Latin-script letter D.</li></ol>
edimäne|edimädse|edimädsehn|edimäste|edimäidsihn|edimästelt|edimädselt|edimäidsihe|edimädses|edimästele|edimäidsiniq|edimäidsilt|edimädseldäq|edimädsegäq|edimäidsist|edimädseq|edimästegäq|edimästest|edimädsel|edimädsest|edimädseniq|edimäidsin|edimäidsile|edimästes|edimästen|edimäidsigäq|edimästel|edimäidsis|edimädsen|edimäidsil|edimästehn|edimästeldäq|edimäst|edimädsele|edimästeniq|edimäidsildäq|edimäidsi	<i>adj</i><br><ol><li>first</li></ol>
ee	<i>noun</i><br><ol><li>The name of the Latin-script letter E.</li></ol>
eff	<i>noun</i><br><ol><li>The name of the Latin-script letter F.</li></ol>
ehitüs|ehitüstest|ehitüisin|ehitüste|ehitüstel|ehitüisis|ehitüisi|ehitüselt|ehitüsen|ehitüsteniq|ehitüsegäq|ehitüstegäq|ehitüseq|ehitüsteldäq|ehitüstelt|ehitüseldäq|ehitüisihe|ehitüseniq|ehitüisiniq|ehitüisildäq|ehitüisigäq|ehitüisihn|ehitüisil|ehitüsest|ehitüst|ehitüisist|ehitüsel|ehitüsele|ehitüstele|ehitüsten|ehitüstehn|ehitüse|ehitüsehn|ehitüisile|ehitüses|ehitüisilt|ehitüstes	<i>noun</i><br><ol><li>construction, (act of) building</li><li>architecture</li></ol>
elevandiluu|elevandiluihtõ|elevandiluuhn|elevandiluud|elevandiluun|elevandiluildaq|elevandiluihn|elevandiluin|elevandiluus|elevandiluiõgaq|elevandiluilt|elevandiluiõ|elevandiluuniq|elevandiluuq|elevandiluulõ|elevandiluilõ|elevandiluult|elevandiluust|elevandiluuldaq|elevandiluil|elevandiluuhtõ|elevandiluis|elevandiluiniq|elevandiluihõ|elevandiluuhõ|elevandiluist|elevandiluugaq|elevandiluid|elevandiluul	<i>noun</i><br><ol><li>ivory</li></ol>
elevant'|elevandigaq|elevandõl|elevandildaq|elevanti|elevandis|elevandõst|elevandiniq|elevantõ|elevandiq|elevandin|elevandi|elevandilõ|elevandõldaq|elevandist|elevandõlõ|elevantõhe|elevantõgaq|elevandõhn|elevandõn|elevandõniq|elevandihn|elevandilt|elevandõs|elevandil|elevandõlt	<i>noun</i><br><ol><li>elephant</li></ol>
ell	<i>noun</i><br><ol><li>The name of the Latin-script letter L.</li></ol>
elläi|eläjit|eläjält|eläjäle|eläjäniq|eläjile|eläjil|eläjäq|eläjägäq|eläjihn|eläjidegäq|eläjildäq|eläjilt|eläjän|eläjäl|eläjäldäq|eläjät|eläjis|eläjiniq|eläjin|eläjäs|eläjä|eläjäst|eläjähn|eläjide|eläjist|eläjihe|eläjähe	<i>noun</i><br><ol><li>animal</li></ol>
elolinõ|eloliidsilõlt|eloliidsilõldaq|elolistõl|elolistõs|elolistõst|elolistõ|elolidsõldaq|eloliidsihe|elolistõlõ|elolidsõlt|elolidsõ|elolidsõst|eloliidsilõlõ|eloliidsilõl|elolistõgaq|eloliidsilõs|eloliidsilõniq|elolidsõq|elolistõhn|elolidsõlõ|elolistõn|elolidsõl|eloliidsi|eloliidsilõn|elolidsõgaq|elolistõldaq|elolidsõniq|elolidsõn|elolidsõhn|eloliidsigaq|elolidsõs|eloliidsilõhn|eloliidsilõst|elolistõlt|elolistõniq|elolist	<i>noun</i><br><ol><li>organism</li></ol>
elämä|elläq|elä	<i>verb</i><br><ol><li>to live</li></ol>
emm	<i>noun</i><br><ol><li>The name of the Latin-script letter M.</li></ol>
enn	<i>noun</i><br><ol><li>The name of the Latin-script letter N.</li></ol>
entsüklopeediä	<i>noun</i><br><ol><li>encyclopedia</li></ol>
err	<i>noun</i><br><ol><li>The name of the Latin-script letter R.</li></ol>
ess	<i>noun</i><br><ol><li>The name of the Latin-script letter S.</li></ol>
esä|esihn|essi|esäq|essilt|esildaq|esäs|essis|esil|esilt|essildaq|essä|esän|esis|esist|esägaq|essist|esäl|essihe|essil|essigaq|esiniq|esäniq|esäldaq|esähn|esin|esälõ|esäst|essiniq|esält|essilõ|essin|essihn|esilõ	<i>noun</i><br><ol><li>father</li></ol>
füüsiga|füüsikat	<i>noun</i><br><ol><li>physics</li></ol>
gee	<i>noun</i><br><ol><li>The name of the Latin-script letter G.</li></ol>
haa	<i>noun</i><br><ol><li>The name of the Latin-script letter H.</li></ol>
haav|haavast|haavolt|haavaniq|haaval|haavoldaq|haavagaq|haavaldaq|haavoniq|haavan|haava|haavalõ|haavogaq|haavo|haavohn|haavos|haavalt|haavost|haavohe|haavaq|haavahn|haavas|haavol|haavolõ|haavon	<i>noun</i><br><ol><li>aspen</li></ol>
hain|hainohe|hainos|hainaq|hainagaq|hainost|hainogaq|haina|haino|hainol|hainalt|hainahn|hainoniq|hainan|hainolt|hainaniq|hainalõ|hainolõ|hainast|hainal|hainoldaq|hainohn|hainon|hainas|hainaldaq	<i>noun</i><br><ol><li>hay</li><li>weed, grass</li></ol>
hainakuu|hainakuuhn|hainakuuhtõ|hainakuihõ|hainakuist|hainakuulõ|hainakuil|hainakuid|hainakuus|hainakuun|hainakuul|hainakuin|hainakuilt|hainakuis|hainakuihtõ|hainakuiõgaq|hainakuuq|hainakuuniq|hainakuud|hainakuust|hainakuiniq|hainakuilõ|hainakuugaq|hainakuuhõ|hainakuuldaq|hainakuihn|hainakuildaq|hainakuult|hainakuiõ	<i>noun</i><br><ol><li>July</li></ol>
hammas|hambilõ|hambidõgaq|hambagaq|hambin|hammastõgaq|hambast|hambis|hambildaq|hambalt|hammastõhn|hambalõ|hambal|hambidõ|hambahe|hambil|hamba|hammast|hammastõlõ|hambaldaq|hammastõ|hambaniq|hammastõlt|hambihn|hammastõniq|hambilt|hambihe|hammastõl|hambahn|hammastõn|hammastõhe|hambit|hammastõs|hambiniq|hambist|hammastõst|hammastõldaq|hamban|hambaq|hambas	<i>noun</i><br><ol><li>tooth</li></ol>
hans'a|hans'agaq|hans'ast|hans'adõst|hans'at|hans'alõ|hans'adõhn|hans'adõlõ|hans'ahtõ|hans'adõs|hans'adõldaq|hans'asit|hans'adõlt|hans'adõniq|hans'adõl|hans'adõgaq|hans'alt|hans'aldaq|hans'adõn|hans'adõhe|hans'as|hans'adõ|hans'ahn|hans'an|hans'aniq|hans'aq|hans'al	<i>noun</i><br><ol><li>hooch, moonshine</li></ol>
hapu|hapnihn|hapnaniq|hapundõlt|hapnidõ|hapnõldaq|hapund|hapundõl|hapnagaq|hapundõn|hapnõq|hapundõhn|hapnis|hapnit|hapundõ|hapnan|hapnõhn|hapnildaq|hapna|hapnõl|hapnõhe|hapnalõ|hapniniq|hapnaq|hapnast|hapnas|hapnidõgaq|hapundõlõ|hapundõhe|hapundõniq|hapnin|hapnist|hapundõgaq|hapnahn|hapnõlt|hapnõ|hapundõs|hapundõst|hapnõniq|hapnalt|hapnihe|hapnil|hapnilt|hapnilõ|hapnõgaq|hapnõs|hapnahe|hapnõst|hapundõldaq|hapnõlõ|hapnaldaq|hapnõn|hapnal	<i>adj</i><br><ol><li>sour</li></ol>
haug'|havvõ|haugõ	<i>noun</i><br><ol><li>pike (fish)</li></ol>
helm'|helme	<i>noun</i><br><ol><li>bead (small round object)</li></ol>
heng'|hengi|hengel|hengihe|henginiq|hengeldäq|hengele|hengin|hengegäq|hengehn|hengil|hengihn|hengist|hengelt|hengeniq|hengilt|hengigäq|henges|henge|hengis|hengen|hengildäq|hengest|hengile|hengeq	<i>noun</i><br><ol><li>spirit</li><li>soul</li></ol>
herneh|hernehtele|hernehtel|hernen|hernes|hernel|hernele|hernidegäq|herne|hernelt|hernehteniq|hernilt|herniniq|hernihn|hernest|hernehtehe|hernist|hernil|herneq|herneldäq|hernildäq|hernin|hernehtest|herneniq|hernehtes|hernile|hernegäq|hernehte|hernit|hernehn|hernehtegäq|hernehten|hernis|hernehe|herneht|hernehtehn|hernide|hernehtelt|hernehteldäq|hernihe	<i>noun</i><br><ol><li>pea</li></ol>
higi|hiile|hiihn|hiin|hiist|hiigäq|hiiniq|hiki|hiilt|hiildäq|hiis|hikki|hiil|hii	<i>noun</i><br><ol><li>sweat</li></ol>
hiir'|hiirtel|hiiregäq|hiirtele|hiireniq|hiiri|hiiriniq|hiirtes|hiirde|hiireq|hiirtelt|hiirehn|hiirildäq|hiirihe|hiiril|hiirtehn|hiirtegäq|hiirilt|hiirihn|hiirin|hiirtest|hiire|hiirigäq|hiirten|hiirel|hiirest|hiirte|hiiren|hiires|hiireldäq|hiirteniq|hiiris|hiirt|hiirelt|hiirteldäq|hiirist|hiirile|hiirele	<i>noun</i><br><ol><li>mouse</li><li>computer mouse</li></ol>
hius|hiussõ|hiusõ|hiust	<i>noun</i><br><ol><li>(single) hair, strand of hair</li></ol>
hoonõh|huunõl|huuniniq|huunõs|huunil|huunõ|huunilõ|hoonõhtõlõ|hoonõhtõlt|huunõgaq|huunõhn|hoonõhtõ|huunidõ|hoonõhtõniq|huunõq|huunihe|hoonõht|huunõniq|hoonõhtõs|huunõhe|huunit|huunis|huunildaq|hoonõhtõn|hoonõhtõl|hoonõhtõhn|huunõst|hoonõhtõst|huunilt|huunõlõ|huunidõgaq|hoonõhtõhe|huunõlt|huunihn|huunõldaq|huunin|huunõn|hoonõhtõgaq|huunist|hoonõhtõldaq	<i>noun</i><br><ol><li>building</li></ol>
hopõn'|hobõst|hobõsõ	<i>noun</i><br><ol><li>horse</li></ol>
huss'|hussõgaq|hussin|hussilt|hussõs|hussõ|hussigaq|hussi|hussiq|hussõn|hussõldaq|hussihn|hussiniq|hussõlt|hussõl|hussõniq|hussõst|hussõhe|hussilõ|hussildaq|hussil|hussõlõ|hussist|hussõhn|hussis	<i>noun</i><br><ol><li>worm</li><li>snake</li></ol>
huulits|huulidsalõ|uulits|huulidsalt|huulitsis|huulitsilt|huulidsast|huulitsin|huulidsahn|uulitsat|huulidsan|huulitsat|huulitsihe|huulitsilõ|huulitsidõ|huulitsist|huulitsiniq|huulitsidõgaq|huulidsaniq|huulitsil|huulidsa|huulitsildaq|huulidsal|huulitsit|huulidsaldaq|huulidsaq|uulidsa|huulidsas|huulitsahe|huulidsagaq|huulitsihn	<i>noun</i><br><ol><li>street</li></ol>
häbü|häpel|häüq|häpelt|häpäle|häpähn|häpegäq|häpäl|häpäniq|häpeldäq|häppähe|häppü|häüst|häpü|häpäldäq|häpägäq|häpes|häpe|häün|häpäs|häült|häpä|häügäq|häpält|häüs|häüldäq|häpän|häppehe|häül|häpehn|häppä|häpen|häpele|häpeniq|häppe|häpäst|häühn|häü|häüniq|häpest|häüle	<i>noun</i><br><ol><li>shame, dishonour</li><li>embarrassment</li></ol>
hõpõ|hõbõhihn|hõbõhõlõ|hõbõhõq|hõbõhõlt|hõbõhiniq|hõpõt|hõppit|hõbõhõhn|hõpõl|hõppis|hõbõhildaq|hõpõniq|hõpõn|hõbõhõs|hõpõgaq|hõppõhe|hõbõhõhe|hõpõq|hõbõhilt|hõbõhit|hõbõhõ|hõbõhidõ|hõpõlõ|hõbõhilõ|hõppin|hõbõhist|hõppidõgaq|hõppildaq|hõppihn|hõbõhõst|hõppidõ|hõppihe|hõbõhil|hõbõhõt|hõpõlt|hõpõldaq|hõbõhidõgaq|hõppilõ|hõppiniq|hõpõs|hõbõhin|hõbõhõgaq|hõppilt|hõbõhõldaq|hõbõhihe|hõpõhn|hõpõst|hõppist|hõbõhis|hõbõhõn|hõbõhõniq|hõppil|hõbõhõl	<i>noun</i><br><ol><li>silver</li></ol>
hõrak|hõraguq|hõragan|hõrakidõ|hõragaq|hõraga|hõragult|hõragaldaq|hõragus|hõragahn|hõragun|hõragast|hõragul|hõraguldaq|hõragu|hõrakist|hõragust|hõrakahe|hõragas|hõragulõ|hõragal|hõrakit|hõragagaq|hõragalt|hõraguniq|hõrakuhe|hõrakilõ|hõrakiniq|hõrakis|hõragalõ|hõrakidõgaq|hõrakin|hõrakilt|hõraganiq|hõraguhn|hõrakil|hõrakat|hõrakihn|hõragugaq|hõrakihe|hõrakildaq	<i>noun</i><br><ol><li>some kind of berry</li></ol>
hüdsi|hüste|hüdsihn|hüdsilt|hüdseniq|hüdse|hüstehn|hüstest|hütsi|hüdseq|hüdsil|hüdsile|hüdsegäq|hüsten|hüdses|hüdsin|hüstegäq|hüdsiniq|hüdsest|hüdsildäq|hüstele|hüdsel|hüdsehn|hüsteldäq|hüdsen|hüdsist|hütsigäq|hütsihe|hüdselt|hüdsele|hüdsis|hüsteniq|hüdseldäq|hüst|hüstelt|hüstel|hüstes	<i>noun</i><br><ol><li>coal, charcoal</li><li>carbon</li></ol>
hüvä|hüin|hüist|häin|hüält|hääle|hüvält|hüildäq|hüvvigäq|häilt|häihte|hään|häähe|hüil|hüän|häid|hüvist|hüvviniq|häihn|hüiniq|hüväldäq|hääldäq|hüäniq|hüväle|häähte|häähn|hüvän|hüis|hüvvin|hüväst|hüäs|hüä|hüvvihn|hääq|hüilt|hüvvihe|häil|hüväl|hüäldäq|kygõ parõmb|hüvil|hüvähn|hää|hüvvist|häildäq|hüvvil|häile|hüvilt|hüähn|häie|häägäq|häiegäq|hüvihn|hüvvis|hüvvile|hääniq|hüvile|hüäst|hüvis|hääd|hüväs|hääs|hüile|hüvildäq|hüvin|hüvvi|hüviniq|hüägäq|häihe|häält|hüihn|hüäle|hüvvä|häiniq|hüvvildäq|hüväq|hääl|parõmb|hüvägäq|hüväniq|hääst|hüäl|hüvvilt|häis|hüäq|häist	<i>adj</i><br><ol><li>good</li></ol>
igä|iän|ikil|iäl|ikä|ikilt|ikkä|iki|iäst|ikis|iäniq|ikin|iäs|iäq|ikihn|ikki|iäldäq|ikist|ikigäq|iäle|ikkihe|iägäq|ijjä|iält|ikiniq|ikile|iä|ikildäq|iähn	<i>noun</i><br><ol><li>age</li></ol>
iho|ihhast|ihhaniq|ihhaldaq|ihõhn|ihahn|ihhan|ihalt|iholt|ihhõniq|ihan|ihhalt|ihõniq|ihõl|ihhal|ihhõ|ihõlõ|ihost|ihhas|ihaniq|iholõ|ihon|ihaldaq|ihhõlt|ihho|ihõlt|ihõs|iholdaq|ihalõ|ihoniq|ihhõl|ihhõs|ihoq|ihhõgaq|ihhõlõ|ihhahn|ihõn|ihas|ihhõhn|ihhalõ|ihhõn|ihõldaq|ihol|ihos|ihha|ihõst|ihal|ihhõldaq|ihhõst|ihast|ihhahe|ihhagaq|ihohn|ihogaq|ihhõhe	<i>noun</i><br><ol><li>body</li></ol>
ii	<i>noun</i><br><ol><li>The name of the Latin-script letter I.</li></ol>
iispäiv|iispääväl|iispäävildäq|iispäävil|iispääväniq|iispäävält|iispäivihe|iispäävist|iispääväst|iispääviniq|iispääväs|iispäävihn|iispäävile|iispäävis|iispäävähn|iispääväq|iispäävä|iispäävilt|iispäävägäq|iispäivä|iispäivigäq|iispäävän|iispäävin|iispääväle|iispäivi|iispääväldäq	<i>noun</i><br><ol><li>Monday</li></ol>
ikim|igend|igime	<i>noun</i><br><ol><li>gum (part of mouth)</li></ol>
iks	<i>noun</i><br><ol><li>The name of the Latin-script letter X.</li></ol>
ilm|ilmoniq|ilmaldaq|ilmast|ilmo|ilmolõ|ilmohn|ilmaniq|ilmaq|ilmost|ilmon|ilman|ilmal|ilmolt|ilmas|ilma|ilmagaq|ilmahn|ilmos|ilmogaq|ilmohe|ilmoldaq|ilmol|ilmalt|ilmalõ	<i>noun</i><br><ol><li>weather, climate</li><li>world, universe</li></ol>
ilma	<i>prep</i><br><ol><li>without</li></ol>
ilmakäänüs|ilmakäänüsseldäq|ilmakäänüstehe|ilmakäänüstele|ilmakäänüssist|ilmakäänüssidegäq|ilmakäänüsteniq|ilmakäänüssil|ilmakäänüstelt|ilmakäänüseldäq|ilmakäänüsteldäq|ilmakäänüssin|ilmakäänüssegäq|ilmakäänüssile|ilmakäänüssehn|ilmakäänüssehe|ilmakäänüstes|ilmakäänüssihe|ilmakäänüssele|ilmakäänüste|ilmakäänüstel|ilmakäänüseniq|ilmakäänüsest|ilmakäänüssen|ilmakäänüsses|ilmakäänüsseniq|ilmakäänüssis|ilmakäänüsen|ilmakäänüsse|ilmakäänüssihn|ilmakäänüssiniq|ilmakäänüssit|ilmakäänüsside|ilmakäänüsel|ilmakäänüssilt|ilmakäänüsele|ilmakäänüseq|ilmakäänüses|ilmakäänüsseq|ilmakäänüssildäq|ilmakäänüssest|ilmakäänüssel|ilmakäänüsten|ilmakäänüstehn|ilmakäänüsselt|ilmakäänüselt|ilmakäänüse|ilmakäänüsegäq|ilmakäänüstegäq|ilmakäänüsehn|ilmakäänüst|ilmakäänüstest	<i>noun</i><br><ol><li>(grammar) abessive case</li></ol>
ilves|ilvest|ilvese|ilvesse	<i>noun</i><br><ol><li>lynx</li></ol>
imeh|imme|imeht	<i>noun</i><br><ol><li>miracle</li></ol>
imemä|immeq|ime	<i>verb</i><br><ol><li>to suck (apply suction)</li></ol>
imä|immä	<i>noun</i><br><ol><li>mother</li></ol>
inemine|inemiste|inemistegäq|inemistes|inemiselt|inemiseldäq|inemiisilt|inemistele|inemiisihn|inemiisil|inemistehn|inemiisist|inemiisildäq|inemiisihe|inemisel|inemisen|inemist|inemistelt|inemisegäq|inemise|inemisest|inemiisile|inemiisigäq|inemistest|inemistel|inemiisis|inemises|inemiisiniq|inemiseq|inemiseniq|inemiisin|inemiisi|inemisteniq|inemisteldäq|inemisehn|inemisten|inemisele	<i>noun</i><br><ol><li>human, person</li></ol>
iä|ijjä	<i>noun</i><br><ol><li>ice</li></ol>
iätümä|iädü|iätüdäq	<i>verb</i><br><ol><li>to freeze, to become frozen</li></ol>
jalg|jalol|jalga|jalolõ|jalgo|jalgogaq|jalas|jalagaq|jalan|jalost|jala|jalast|jalahn|jalalt|jalalõ|jalgohe|jalolt|jalaniq|jaloldaq|jalon|jalal|jaloniq|jalohn|jalos|jalaq|jalaldaq	<i>noun</i><br><ol><li>foot</li><li>leg</li></ol>
jauh|jauhõ|jahhu|jahu	<i>noun</i><br><ol><li>flour</li></ol>
jott	<i>noun</i><br><ol><li>The name of the Latin-script letter J.</li></ol>
joulukuu|joulukuihtõ|joulukuul|joulukuud|joulukuuldaq|joulukuus|joulukuugaq|joulukuildaq|joulukuust|joulukuist|joulukuihn|joulukuuhtõ|joulukuis|joulukuult|joulukuiõ|joulukuin|joulukuil|joulukuun|joulukuiõgaq|joulukuuhn|joulukuilt|joulukuihõ|joulukuuhõ|joulukuid|joulukuulõ|joulukuuniq|joulukuiniq|joulukuilõ|joulukuuq	<i>noun</i><br><ol><li>December</li></ol>
jummal'|jumalat|jumala	<i>noun</i><br><ol><li>god</li></ol>
juuma|juu|juvvaq	<i>verb</i><br><ol><li>to drink</li></ol>
juur'|juurõhn|juurigaq|juurist|juurilõ|juurtõldaq|juurihe|juurtõs|juurtõlt|juurtõ|juurtõlõ|juurtõl|juurildaq|juurõldaq|juurtõn|juurõlt|juurõgaq|juurihn|juurõn|juurõst|juurt|juurtõhn|juurõs|juuril|juurin|juurdõ|juuris|juurõq|juuri|juurõniq|juuriniq|juurõ|juurõl|juurõlõ|juurtõniq|juurilt|juurtõst|juurtõgaq	<i>noun</i><br><ol><li>root (of a plant)</li><li>root, origin</li></ol>
jänes|jänesse|jänest|jänese	<i>noun</i><br><ol><li>hare</li></ol>
järv'|järve	<i>noun</i><br><ol><li>lake</li></ol>
jäämä|jää|jäiäq	<i>verb</i><br><ol><li>to stay, to remain</li></ol>
jõgi|jõkõ|jyy	<i>noun</i><br><ol><li>river</li></ol>
kaa	<i>noun</i><br><ol><li>The name of the Latin-script letter K.</li></ol>
kaal|kaalu|kaala	<i>noun</i><br><ol><li>neck</li><li>weight</li></ol>
kaar|kaara	<i>noun</i><br><ol><li>oats</li></ol>
kahr|kahru	<i>noun</i><br><ol><li>bear</li></ol>
kaitsma|kaidsa|kaitsaq	<i>verb</i><br><ol><li>to defend, to guard</li></ol>
kaiv|kao|kaivo	<i>noun</i><br><ol><li>well (water source)</li></ol>
kaksisvee	<i>noun</i><br><ol><li>The name of the Latin-script letter W.</li></ol>
kala|kalloldaq|kallohn|kallohe|kaloldaq|kallost|kalloniq|kalolõ|kalaldaq|kallolt|kalon|kalost|kalahn|kalol|kallos|kallolõ|kallon|kalaniq|kalalt|kaloniq|kalalõ|kalagaq|kalal|kalos|kalohn|kalas|kalast|kallo|kalaq|kalan|kalolt|kalla|kallogaq|kallol	<i>noun</i><br><ol><li>fish</li></ol>
kallis|kallist|kalli	<i>adj</i><br><ol><li>expensive</li><li>dear</li><li>precious</li></ol>
kana|kannoldaq|kanaq|kannogaq|kanaldaq|kanolt|kannohe|kannol|kanno|kannolõ|kannos|kanohn|kanoniq|kanan|kanon|kanos|kanal|kannolt|kanalt|kannoniq|kanas|kanahn|kanast|kannost|kanagaq|kanna|kanol|kanoldaq|kananiq|kannohn|kanost|kanalõ|kanolõ|kannon	<i>noun</i><br><ol><li>chicken</li></ol>
kanarik|kanarigal|kanarigalt|kanariguhn|kanarigust|kanarikkõhe|kanarigõniq|kanarigahn|kanarigõst|kanarikka|kanarigaldaq|kanariguldaq|kanariguniq|kanarigõlt|kanarigalõ|kanariganiq|kanarigast|kanarigulõ|kanarigõl|kanarikkõgaq|kanarikku|kanarikkahe|kanarigun|kanarikkagaq|kanarigõn|kanarigõhn|kanariguq|kanarigult|kanarigõldaq|kanarigu|kanarigõs|kanarigus|kanarigas|kanarigul|kanarigugaq|kanarikkõ|kanarigõlõ|kanarigan	<i>noun</i><br><ol><li>heather (plant)</li></ol>
kand|kandagaq|kannaniq|kannõs|kannoldaq|kannalõ|kannogaq|kandõhe|kannõhn|kannahn|kannast|kannol|kanno|kannolõ|kandahe|kannos|kannal|kannõniq|kannõlt|kannoq|kandõ|kannolt|kanda|kandõgaq|kannalt|kannõldaq|kannoniq|kannan|kannas|kando|kannõn|kannost|kannõst|kannõlõ|kannaldaq|kannõl|kannohn|kannon	<i>noun</i><br><ol><li>stump</li></ol>
kannõl'|kandlõl|kandlidõgaq|kandlit|kandlildaq|kandlõhn|kandliniq|kandlõgaq|kandlõq|kannõldõhn|kandlis|kannõldõlt|kannõldõl|kandlõlt|kannõldõs|kannõldõlõ|kannõldõgaq|kannõldõn|kandlilõ|kandlõldaq|kannõldõ|kandlõs|kandlõst|kannõld|kannõldõhe|kandlil|kandlõn|kannõldõniq|kandlõ|kandlidõ|kandlihn|kandlilt|kannõldõldaq|kandlin|kandlõniq|kandlist|kannõldõst|kandlõlõ|kandlihe|kandlõhe	<i>noun</i><br><ol><li>kantele</li></ol>
kask|kaskaldaq|kaskis|kaskit|kaska|kaskiniq|kaskahe|kaskagaq|kaskaniq|kaskihn|kaskihe|kaskalõ|kaskidõ|kaskan|kaskidõgaq|kaskildaq|kaskal|kaskat|kaskalt|kaskilõ|kaskahn|kaskin|kaskist|kaskaq|kaskil|kaskas|kaskast|kaskilt	<i>noun</i><br><ol><li>coat (clothing)</li></ol>
kastma|kasta|kastaq	<i>verb</i><br><ol><li>to knead (dough)</li><li>to soak, to douse</li></ol>
kastõq|kastõt|kastõ	<i>noun</i><br><ol><li>dew</li></ol>
kasuma|kasu|kassuq	<i>verb</i><br><ol><li>to grow</li></ol>
kasvatustiidüs	<i>noun</i><br><ol><li>pedagogy</li></ol>
kats'|kattõ|katõ	<i>num</i><br><ol><li>two</li></ol>
katõssa|katsat|katõsa|katsa	<i>num</i><br><ol><li>eight</li></ol>
kaudõnõ kynnõviis'	<i>noun</i><br><ol><li>(grammar) quotative mood</li></ol>
kerge|kergest|kergehe|kerginiq|kergehn|kergeniq|kergide|kergile|kergist|kerget|kergen|kergil|kergildäq|kergelt|kergilt|kergeldäq|kergihe|kergit|kergel|kergin|kergihn|kergeq|kerges|kergidegäq|kergele|kergis|kergegäq	<i>adj</i><br><ol><li>light, lightweight</li><li>easy</li></ol>
kesksyna|kesksynon|kesksynolt|kesksynolõ|kesksynaldaq|kesksynagaq|kesksynnohn|kesksynnol|kesksynohn|kesksynaniq|kesksynnos|kesksynnogaq|kesksynol|kesksynost|kesksynnohe|kesksynaq|kesksynnoniq|kesksynahn|kesksynnost|kesksynalõ|kesksynnon|kesksynnolõ|kesksynos|kesksynno|kesksynast|kesksynoniq|kesksynoldaq|kesksynal|kesksynnolt|kesksynas|kesksynnoldaq|kesksynna|kesksynalt|kesksynan	<i>noun</i><br><ol><li>(grammar) participle</li></ol>
kesv|kesvä	<i>noun</i><br><ol><li>barley</li></ol>
kesä|kessä	<i>noun</i><br><ol><li>fallow</li></ol>
kevväi|keväjät|keväjä	<i>noun</i><br><ol><li>spring (season)</li></ol>
kiil'|keele|kiilihe|keelis|keeleq|keelil|keelele|keeltele|keelin|kiilt|keelest|keelihn|keelile|keelelt|keeleldäq|keeltelt|keeliniq|keelteniq|keeleniq|keelehn|kiili|keelel|keelegäq|keelilt|keeles|keelteldäq|keelen|kiilde|keelist|keeltel|keeltehn|keeltest|keeltes|keelildäq|keelte|kiiligäq|keeltegäq|keelten	<i>noun</i><br><ol><li>language</li><li>tongue</li></ol>
kimmäs kynnõviis'	<i>noun</i><br><ol><li>(grammar) indicative mood</li></ol>
kipõn'|kibõnast|kibõnil|kibõnit|kibõnilõ|kibõnas|kibõnalõ|kibõnin|kibõnal|kibõnildaq|kibõnat|kibõnidõ|kibõnagaq|kibõnaq|kibõnihe|kibõniniq|kibõnidõgaq|kibõnahn|kibõnilt|kibõnan|kibõnaniq|kibõnalt|kibõnaldaq|kibõnahe|kibõnist|kibõnihn|kibõnis|kibõna	<i>noun</i><br><ol><li>spark</li><li>mote, speck, particle</li></ol>
kirvõs|kirvõst|kirvõ	<i>noun</i><br><ol><li>axe</li></ol>
kivi|kivvi	<i>noun</i><br><ol><li>stone, rock</li><li>mill</li></ol>
koda|kua|kota	<i>noun</i><br><ol><li>house</li><li>chamber</li></ol>
kogõr|kogris|kokrõ|kogrõniq|kogrõst|kogrist|kogrõn|kogrõldaq|kogrõhn|kokr|kokri|kogrõgaq|kogrõlt|kogrõq|kogrõl|kogrin|kokrigaq|kogrõlõ|kogriniq|kogrihn|kogrilt|kogrõs|kogrildaq|kokrihe|kogyr'|kogrõ|kogrilõ|kogril	<i>noun</i><br><ol><li>crucian carp</li></ol>
koir|koira	<i>noun</i><br><ol><li>male dog</li></ol>
kolm|kolmõ	<i>num</i><br><ol><li>three</li></ol>
kolmapäiv|kolmapäävist|kolmapäävält|kolmapäävilt|kolmapäävis|kolmapäivi|kolmapääväq|kolmapäävildäq|kolmapäivihe|kolmapäävin|kolmapäävän|kolmapäävähn|kolmapääväldäq|kolmapäävihn|kolmapääviniq|kolmapääväle|kolmapäivä|kolmapääväs|kolmapääväl|kolmapäävä|kolmapäävägäq|kolmapääväst|kolmapäävile|kolmapääväniq|kolmapäävil|kolmapäivigäq	<i>noun</i><br><ol><li>Wednesday</li></ol>
kommõq|kombihn|kombõn|kommõtõl|kombõs|kombõq|kombiniq|kommõtõniq|kommõtõgaq|kombilt|kombõlt|kombin|kommõtõst|kommõtõn|kombihe|kombilõ|kombist|kommõtõhe|kombõgaq|kombildaq|kommõtõs|kombidõgaq|kombis|kombõniq|kommõtõlõ|kommõtõldaq|kombõlõ|kombil|kombõl|kommõt|kommõtõhn|kombõldaq|kombit|kombõhe|kombõst|kombõ|kombõhn|kommõtõ|kombidõ|kommõtõlt	<i>noun</i><br><ol><li>manner, fashion</li><li>habit</li><li>custom, convention, tradition</li></ol>
kompuutri	<i>noun</i><br><ol><li>computer</li></ol>
korgus|korgust|korgusõ	<i>noun</i><br><ol><li>height</li><li>altitude</li></ol>
korgõ|korgõs|korgõniq|korgidõ|korgõst|korgilõ|korgõhn|korgilt|korgildaq|korgihe|korgõn|korgis|korginiq|korgist|korgihn|korgit|korgõlõ|korgil|korgin|korgõhe|korgõldaq|korgõlt|korgõt|korgõl|korgõq|korgidõgaq|korgõgaq	<i>adj</i><br><ol><li>tall, high</li></ol>
kotus|kotusõlõ|kotusõlt|kotussis|kotusõq|kotustõst|kotusõhn|kotusõldaq|kotussõs|kotussilt|kotussõ|kotussõst|kotustõldaq|kotustõlõ|kotusõs|kotusõgaq|kotussidõgaq|kotussildaq|kotussõldaq|kotussõq|kotustõs|kotussist|kotusõst|kotussõhe|kotustõniq|kotussidõ|kotust|kotussõhn|kotustõl|kotussin|kotussiniq|kotussil|kotustõ|kotussihe|kotustõn|kotussit|kotussõgaq|kotussõlt|kotussõniq|kotusõniq|kotusõ|kotustõhn|kotusõn|kotussilõ|kotustõgaq|kotusõl|kotustõlt|kotustõhe|kotussihn|kotussõn|kotussõlõ|kotussõl	<i>noun</i><br><ol><li>place, spot</li></ol>
kubõl|kublõlõ|kublan|kublõldaq|kublalt|kublõn|kublas|kublõniq|kublõs|kublaniq|kuplõhe|kublõl|kuplõ|kublõlt|kublahn|kupl|kuplõgaq|kublagaq|kubla|kublalõ|kublõst|kubyl'|kublal|kublõhn|kupla|kublaq|kublaldaq|kublast	<i>noun</i><br><ol><li>wheal</li></ol>
kuld|kullõhn|kullõlt|kuldõgaq|kullõn|kullas|kullõniq|kullan|kullaniq|kullõst|kulda|kullõs|kullõldaq|kullal|kullalt|kullagaq|kullahn|kullast|kuldõ|kullaq|kuldõhe|kullaldaq|kulla|kullalõ|kullõlõ|kullõl	<i>noun</i><br><ol><li>gold</li></ol>
kullanõ|kulladsõldaq|kullatsidõgaq|kuldsist|kullastõhn|kullatsõhe|kullastõhe|kulladsõl|kullastõn|kulladsõ|kullatsil|kuldsihn|kullastõ|kuldnõ|kuldsõlt|kuldsõt|kuldsõgaq|kullastõs|kullastõlt|kuldsõn|kuldsõniq|kuldsõst|kuldsil|kulladsõs|kullastõl|kulladsõlõ|kuldsilt|kullatsiniq|kuldsõl|kullastõst|kuldsilõ|kulladsõlt|kullatsildaq|kulladsõhn|kulladsõn|kullastõlõ|kuldsõlõ|kullatsilt|kullastõniq|kullast|kullastõldaq|kullatsist|kuldsin|kuldsis|kullatsis|kullastõgaq|kuldsiniq|kuldsõs|kullatsihe|kuldsõhn|kuldsidõ|kullatsilõ|kullatsihn|kullatsidõ|kuldsõldaq|kulladsõgaq|kuldsõ|kuldsõq|kullatsin|kuldsõhe|kullatsit|kuldsildaq|kulladsõst|kuldsidõgaq|kuldsihe|kuldsit|kulladsõniq|kulladsõq	<i>adj</i><br><ol><li>golden</li></ol>
kumb|kumma|kumba	<i>pron</i><br><ol><li>which</li></ol>
kund|kunnu|kunnõn|kunnõlõ|kundõhe|kunnul|kunnugaq|kunnuhn|kunnuldaq|kunnuq|kunnult|kunnõs|kunnun|kundõ|kundõgaq|kunnõlt|kunnus|kunnuniq|kunnust|kundu|kunnulõ|kunnõl|kunnõniq|kunnõst|kunnõldaq|kunnõhn	
kuning|kuningat|kuninga	<i>noun</i><br><ol><li>king</li></ol>
kuningriik'|kuningriigis|kuningriigihn|kuningriigildäq|kuningriigen|kuningriikehe|kuningriike|kuningriigelt|kuningriigel|kuningriigele|kuningriigehn|kuningriiges|kuningriiginiq|kuningriigiq|kuningriiki|kuningriigeniq|kuningriikegäq|kuningriigist|kuningriigi|kuningriigilt|kuningriigeldäq|kuningriigil|kuningriigin|kuningriigigäq|kuningriigest|kuningriigile	<i>noun</i><br><ol><li>kingdom</li></ol>
kurg'|kurõ|kurgõ	<i>noun</i><br><ol><li>crane (bird)</li></ol>
kusi|kusõ|kust	<i>noun</i><br><ol><li>urine</li></ol>
kutsma|kutsuq|kutsu	<i>verb</i><br><ol><li>to call, to summon</li><li>to invite</li></ol>
kuu|kuil|kuiniq|kuildaq|kuilõ|kuiõ|kuult|kuulõ|kuihn|kuuq|kuus|kuul|kuun|kuuhõ|kuihõ|kuuhn|kuuldaq|kuud|kuuhtõ|kuid|kuuniq|kuis|kuihtõ|kuust|kuilt|kuiõgaq|kuin|kuist|kuugaq	<i>noun</i><br><ol><li>moon</li><li>month</li><li>The name of the Latin-script letter Q.</li></ol>
kuul'|kuuligaq|koolõlõ|kuuliq|kuulilt|kuulõgaq|kuulõldaq|koolõldaq|kuulist|kuulõl|kuul'|kuulõhe|koolihn|kuuli|koolõlt|kuulõlõ|kuulõ|kuulõhn|koolis|kuulõst|kuulõs|koolõniq|kooliniq|kooligaq|koolõl|kuulil|koolin|koolõhn|kuulin|koolildaq|kuulilõ|kuulihn|koolist|koolilt|kooli|kuulõniq|kuulõlt|kuulõn|kooliq|koolõn|koolõst|koolõs|koolilõ|kuuliniq|kuulildaq|koolil|kuulis	<i>noun</i><br><ol><li>school</li><li>ball</li><li>bullet</li></ol>
kuuldma|kuulõ|kuuldaq	<i>verb</i><br><ol><li>to hear</li></ol>
kuulma|koolõ|kooldaq	<i>verb</i><br><ol><li>to die</li></ol>
kuur'|kuurt|koorõ	<i>noun</i><br><ol><li>bark</li><li>peel</li><li>crust</li><li>cream</li></ol>
kuus'|kuut|kuust|kuusõ|kuvvõ	<i>num</i><br><ol><li>six</li></ol><br><i>noun</i><br><ol><li>spruce</li></ol>
kynnõviis'|kynnõviisi	<i>noun</i><br><ol><li>(grammar) mood</li></ol>
käsi|kätt|käteldäq|kässin|kätest|käteniq|kässildäq|kätegäq|käel|käeldäq|kässile|käen|käsildäq|käe|käeq|käehn|kätelt|käegäq|kässist|käte|kätte|käele|kätel|käsiniq|käsin|käten|kässis|kässihn|kässi|kätehn|kässilt|käsilt|kätes|käeniq|käes|käest|kässil|käsile|kässiniq|kässigäq|kässihe|käsis|käelt|käsihn|käsist|kätele|käsil	<i>noun</i><br><ol><li>arm</li><li>hand</li></ol>
käskjä kynnõviis'	<i>noun</i><br><ol><li>(grammar) imperative mood</li></ol>
käänüs|käänüseldäq|käänüselt|käänüse|käänüste|käänüssest|käänüsseldäq|käänüstele|käänüstes|käänüses|käänüstelt|käänüssehe|käänüssihe|käänüssegäq|käänüsele|käänüstehe|käänüssel|käänüsten|käänüsen|käänüsel|käänüssihn|käänüssehn|käänüsseq|käänüstel|käänüsegäq|käänüstehn|käänüsses|käänüssile|käänüsteldäq|käänüssen|käänüssis|käänüssin|käänüsehn|käänüsse|käänüssilt|käänüssil|käänüssidegäq|käänüsseniq|käänüsside|käänüssildäq|käänüssist|käänüsteniq|käänüseniq|käänüssiniq|käänüssele|käänüsest|käänüstest|käänüst|käänüseq|käänüssit|käänüsselt|käänüstegäq	<i>noun</i><br><ol><li>lapel</li><li>(grammar, of nominals) case</li><li>(grammar, of verbs) person</li></ol>
käümä|käü|kävvüq	<i>verb</i><br><ol><li>to go, to walk</li></ol>
kõiv|kõivo|kõo	<i>noun</i><br><ol><li>birch (tree)</li></ol>
kõrs'|kõrrõ|kõrt	<i>noun</i><br><ol><li>stem, stalk (of a plant)</li></ol>
kõrv|kõrva	<i>noun</i><br><ol><li>ear</li><li>handle (of a cup or pot)</li></ol>
kõva|kõvolõ|kõvvohe|kõvol|kõvvoniq|kõvohn|kõvvoldaq|kõvvohn|kõvaq|kõvoldaq|kõvon|kõvast|kõvvost|kõvalõ|kõvva|kõvoniq|kõvost|kõvvol|kõvvolõ|kõvas|kõvvo|kõvagaq|kõvaniq|kõvos|kõvvos|kõvan|kõval|kõvaldaq|kõvalt|kõvolt|kõvvogaq|kõvvon|kõvvolt|kõvahn	<i>adj</i><br><ol><li>hard (not soft)</li><li>strict</li><li>harsh</li></ol>
külm|külmäle|külmäst|külminiq|külmile|külmi|külmält|külmäldäq|külmäs|külmän|külmähn|külmigäq|külmägäq|külmihe|külmildäq|külmis|külmäniq|külmist|külmä|külmäl|külmäq|külmil|külmilt|külmihn|külmin	<i>adj</i><br><ol><li>cold</li></ol>
külä|külägäq|külildäq|küläl|küläq|küllile|küllil|küllis|külin|külihn|külält|küläs|külis|külliniq|külile|külist|küllilt|küläldäq|küläst|külligäq|külli|küliniq|küllä|külil|küllin|küllihn|külilt|küllist|külän|küllildäq|külähn|küläle|küllihe|küläniq	<i>noun</i><br><ol><li>village</li></ol>
kümme|kümne|kümmend	<i>num</i><br><ol><li>ten</li></ol>
künnär'pää|künnär'päähä|künnär'pääd|künnär'päihte|künnär'päildäq|künnär'pääl|künnär'pääniq|künnär'pääq|künnär'päid|künnär'päile|künnär'päiegäq|künnär'pähäq|künnär'päägäq|künnär'pään|künnär'päis|künnär'päist|künnär'päin|künnär'päie|künnär'pääst|künnär'päilt|künnär'pääs|künnär'päält|künnär'pääle|künnär'päihn|künnär'pääldäq|künnär'päähn|künnär'päil|künnär'päihe|künnär'päiniq	<i>noun</i><br><ol><li>elbow</li></ol>
küsümä|küssüq|küsü	<i>verb</i><br><ol><li>to ask, to enquire</li></ol>
küsümüs|küsümüse|küsümüst	<i>noun</i><br><ol><li>question</li></ol>
küüds'|küüdse|küüst	<i>noun</i><br><ol><li>nail (on finger or toe)</li><li>claw</li><li>talon</li><li>clove (part of a plant)</li></ol>
lagi|lakõ|lae	<i>noun</i><br><ol><li>ceiling</li></ol>
laht'|lahe|lahtõ	<i>noun</i><br><ol><li>bay, gulf</li></ol>
lainõh|lainõ|lainõht	<i>noun</i><br><ol><li>wave</li></ol>
laiõh|laidist|laiõhtõs|laidõniq|laidin|laiõhtõlõ|laidilt|laidis|laiõhtõhn|laidõq|laidihn|laidildaq|laidõlõ|laiõhtõniq|laidõst|laiõhtõst|laiõhtõldaq|laididõgaq|laidõl|laiõhtõgaq|laidõgaq|laiõht|laidõn|laidõ|laidõldaq|laiõhtõ|laiõhtõl|laidihe|laiõhtõn|laiõhtõlt|laiõhtõhe|laidõs|laididõ|laidilõ|laidõhe|laidõhn|laidil|laidit|laidõlt|laidiniq	
lammas|lamba|lammast	<i>noun</i><br><ol><li>sheep</li></ol>
lapjo|lapjot	<i>noun</i><br><ol><li>shovel</li><li>spade</li></ol>
lats'|latsõ|last	<i>noun</i><br><ol><li>child</li></ol>
laulma|lauldaq|laula	<i>verb</i><br><ol><li>to sing</li></ol>
lehekuu|lehekuud|lehekuuhõ|lehekuugaq|lehekuilõ|lehekuid|lehekuihtõ|lehekuun|lehekuuniq|lehekuil|lehekuult|lehekuul|lehekuist|lehekuildaq|lehekuiõ|lehekuuldaq|lehekuuhtõ|lehekuihõ|lehekuuhn|lehekuust|lehekuin|lehekuus|lehekuihn|lehekuuq|lehekuis|lehekuilt|lehekuiõgaq|lehekuulõ|lehekuiniq	<i>noun</i><br><ol><li>May</li></ol>
lehm|lehmä	<i>noun</i><br><ol><li>cow</li></ol>
leht'|lehe|lehte	<i>noun</i><br><ol><li>leaf</li><li>sheet (of paper, metal etc.)</li><li>page (of a book)</li><li>newspaper</li></ol>
liha|lihha	<i>noun</i><br><ol><li>meat</li></ol>
liigaastak|liigaastagat|liigaastaga|liigaastakka	<i>noun</i><br><ol><li>leap year</li></ol>
liim'|liimi|leeme	<i>noun</i><br><ol><li>soup, broth</li></ol>
liin|liina	<i>noun</i><br><ol><li>town</li></ol>
lindama|linnadaq|linda	<i>verb</i><br><ol><li>to fly</li></ol>
lugõma|lukõq|loe	<i>verb</i><br><ol><li>to count</li><li>to read</li></ol>
lumi|lumõ|lummõ	<i>noun</i><br><ol><li>snow</li></ol>
luu|luuhtõ|luiõ|luus|luildaq|luil|luihn|luust|luilt|luihtõ|luuhn|luist|luulõ|luult|luihõ|luuniq|luid|luugaq|luiõgaq|luuhõ|luuldaq|luilõ|luin|luun|luiniq|luis|luud|luul|luuq	<i>noun</i><br><ol><li>bone</li></ol>
luuma|luu|luvvaq	<i>verb</i><br><ol><li>to create</li><li>to start, to get going, to set off</li><li>to found, to establish</li></ol>
lämmi|lämmägäq|lämminiq|lämmindeldäq|lämmin|lämmildäq|lämmäq|lämmindehe|lämmindehn|lämmähn|lämmäst|lämmile|lämmäl|lämmäs|lämminden|lämmihe|lämmil|lämmäldäq|lämmän|lämmä|lämmindegäq|lämmis|lämmind|lämmindeniq|lämmähe|lämmist|lämmidegäq|lämmält|lämmäle|lämmindes|lämmihn|lämmäniq|lämmindelt|lämmide|lämmindest|lämmilt|lämmindel|lämminde|lämmindele|lämmit	<i>adj</i><br><ol><li>warm</li></ol>
läsk'|läska|läsä	<i>noun</i><br><ol><li>widow</li></ol>
läteq|lätteldäq|läteteniq|lättile|lätetelt|lättist|lätete|lätetele|lättidegäq|lättel|lättehe|lättihe|lätetel|lätetegäq|lättihn|lätten|lätte|lättit|lätteniq|lätet|lätteq|lättilt|lättegäq|lätetest|lättildäq|lättiniq|lättide|läteten|lättin|lättehn|lättil|lättele|lättis|lätetes|lättelt|lätetehe|lättes|läteteldäq|lättest|lätetehn	<i>noun</i><br><ol><li>spring, source</li><li>well</li><li>fountain</li><li>source (origin)</li></ol>
lõim'|lõimõ	<i>noun</i><br><ol><li>thread</li><li>reel, spool</li></ol>
löüdmä|lövvä|löüdäq	<i>verb</i><br><ol><li>to find</li><li>to discover</li></ol>
lüümä|lüü|lüvväq	<i>verb</i><br><ol><li>to beat, to hit, to strike</li></ol>
maa|maalt|mais|maas|maaniq|maahõ|main|maiõgaq|maast|maal|maalõ|maaq|maist|maid|maan|maad|maaldaq|maihõ|maihn|mailõ|mainiq|mail|maiõ|maagaq|maahtõ|maahn|maildaq|mailt|maihtõ	<i>noun</i><br><ol><li>earth</li><li>soil</li><li>land</li><li>ground</li><li>country</li><li>countryside</li></ol>
maailm|maailma	<i>noun</i><br><ol><li>world</li></ol>
maakund|maakunnahn|maakunnal|maakunnas|maakunnõlt|maakunnõniq|maakunnagaq|maakunnaniq|maakundõ|maakunnõldaq|maakunnan|maakunnõlõ|maakunnõn|maakunnõs|maakunda|maakunnõst|maakunnaldaq|maakunnõl|maakundõhe|maakunnalõ|maakunnaq|maakunnast|maakunna|maakunnalt|maakunnõhn|maakundõgaq	<i>noun</i><br><ol><li>county</li></ol>
maasik|maasikat|maasiga	<i>noun</i><br><ol><li>strawberry</li></ol>
magama|maadaq|maka	<i>verb</i><br><ol><li>to sleep</li></ol>
mahl|mahla	<i>noun</i><br><ol><li>juice</li></ol>
mahlakuu|mahlakuilt|mahlakuihn|mahlakuun|mahlakuuhõ|mahlakuuldaq|mahlakuil|mahlakuihtõ|mahlakuid|mahlakuiniq|mahlakuuhn|mahlakuuhtõ|mahlakuus|mahlakuiõ|mahlakuis|mahlakuist|mahlakuilõ|mahlakuugaq|mahlakuuq|mahlakuul|mahlakuin|mahlakuust|mahlakuiõgaq|mahlakuildaq|mahlakuulõ|mahlakuuniq|mahlakuult|mahlakuud|mahlakuihõ	<i>noun</i><br><ol><li>April</li></ol>
makus|magusihe|magusihn|magusalõ|magusa|magusin|magusist|magusilõ|magusaldaq|magusaniq|magusalt|magusit|magusil|magusildaq|magusaq|magusiniq|magusal|magusis|magusilt|magusast|magusidõgaq|magusahe|magusas|magusan|magusat|magusidõ|magusagaq|magusahn	<i>adj</i><br><ol><li>sweet</li></ol>
makõ|makkihn|magõhihn|makkilõ|magõhihe|makõlõ|makõl|magõhildaq|makkist|magõhõniq|makkit|magõhõlt|magõhõlõ|makõn|magõhidõ|makõst|magõhilõ|magõhõst|magõhõldaq|magõhõl|magõhiniq|makkildaq|makõs|makkiniq|makõldaq|magõhõq|magõhõhn|makkihe|magõhõs|makõgaq|makõlt|makõhn|magõhis|makõq|magõhõn|magõhin|magõhõhe|magõhit|makkilt|magõhõ|makõt|magõhist|makkis|magõhidõgaq|magõhilt|magõhõt|magõhõgaq|makkõhe|makkidõ|makõniq|makkil|makkin|magõhil|makkidõgaq	<i>adj</i><br><ol><li>fresh</li><li>unflavoured</li><li>sweet</li></ol>
maq|muq|minno	<i>pron</i><br><ol><li>I</li></ol>
mass|massa|massu	<i>noun</i><br><ol><li>liver</li><li>tax, payment</li></ol>
matõmaatiga|matõmaatigat	<i>noun</i><br><ol><li>mathematics</li></ol>
meeledü|meeletüihn|meeletüin|meeletüile|meeledül|meeledügäq|meeledüst|meeledühn|meeletüt|meeletüildäq|meeletüihe|meeletüil|meeledüldäq|meeledült|meeletüidegäq|meeletüiniq|meeledüq|meeledüniq|meeledün|meeletüid|meeletüist|meeletüide|meeledüs|meeletüilt|meeletuhe|meeledüle|meeletüis	<i>adj</i><br><ol><li>frenzied, out of one's mind</li></ol>
meri|merden|merihe|meris|merdest|merdeldäq|merdes|merd|merdel|merelt|merde|merildäq|meren|merehn|merest|meril|merin|merdeniq|mereq|meriniq|merihn|merdelt|meres|merel|mereniq|merdele|merdehn|merile|meregäq|merigäq|merilt|merele|merdegäq|mere|mereldäq|merist	<i>noun</i><br><ol><li>sea</li></ol>
mesi|mett|mii	<i>noun</i><br><ol><li>honey</li></ol>
miil'|miilt|meele	<i>noun</i><br><ol><li>one's senses, mind</li><li>awareness, consciousness</li></ol>
miis'|mehiniq|mehest|mehilt|mehist|miist|miiste|mehehn|meheldaq|mehilõ|mehes|mehelt|mehil|miihi|mehe|mehildaq|meheniq|mehis|mehen|mehelõ|mehegaq|meheq|miihigaq|mehin|mehel|mehihn	<i>noun</i><br><ol><li>man (adult male human)</li><li>husband (a woman's spouse)</li></ol>
minemä|minnäq|lää	<i>verb</i><br><ol><li>to go</li></ol>
minevik|minevigu|minevikku	<i>noun</i><br><ol><li>(grammar) past tense</li></ol>
minnevaig|minevätaigo|mineväao|minnevao|minevao|minnevaigo	<i>noun</i><br><ol><li>(grammar) past tense</li></ol>
minot'|minotit|minodi	<i>noun</i><br><ol><li>minute</li></ol>
mitmus|mitmusõ|mitmust	<i>noun</i><br><ol><li>(grammar) plural</li></ol>
molõkul	<i>noun</i><br><ol><li>molecule</li></ol>
muna|munna	<i>noun</i><br><ol><li>egg</li></ol>
murõh|murõht|murrõ	<i>noun</i><br><ol><li>sorrow, woe, grief</li><li>care, concern</li><li>anxiety, distress</li></ol>
must|musten|mustast|mustalt|musteldaq|mustaq|musteniq|mustan|mustal|mustegaq|muste|musta|mustas|mustaldaq|mustelt|mustes|mustest|mustelõ|mustaniq|mustehn|mustagaq|mustehe|mustalõ|mustel|mustahn	<i>adj</i><br><ol><li>black (colour)</li></ol>
muud|muudu|moodu	<i>noun</i><br><ol><li>shape, form</li><li>style, manner, fashion</li></ol>
mägi|mäke|mäe	<i>noun</i><br><ol><li>hill, mountain</li></ol>
märtekuu|märtekuil|märtekuiõ|märtekuuldaq|märtekuuhtõ|märtekuugaq|märtekuulõ|märtekuildaq|märtekuilõ|märtekuust|märtekuun|märtekuid|märtekuihn|märtekuihtõ|märtekuus|märtekuihõ|märtekuul|märtekuuniq|märtekuult|märtekuiõgaq|märtekuist|märtekuin|märtekuiniq|märtekuis|märtekuuq|märtekuuhõ|märtekuilt|märtekuud|märtekuuhn	<i>noun</i><br><ol><li>November</li></ol>
mõts|mõtsa	<i>noun</i><br><ol><li>forest</li></ol>
müümä|müvväq|müü	<i>verb</i><br><ol><li>to sell</li></ol>
naanõ|naistõhn|naistõl|naisilõ|naisiniq|naisihn|naistõlt|naistõn|naistõs|naasõq|naasõs|naistõldaq|naasõlt|naistõgaq|naisihe|naist|naisi|naasõldaq|naisin|naisildaq|naisilt|naisil|naasõniq|naasõgaq|naistõlõ|naisist|naistõst|naasõlõ|naasõl|naasõ|naisis|naasõst|naistõniq|naasõn|naistõ|naisigaq|naasõhn	<i>noun</i><br><ol><li>woman</li><li>wife</li></ol>
naardma|naardaq|naara	<i>verb</i><br><ol><li>to laugh</li></ol>
nagõl|nakl|naglaldaq|naglalõ|naglos|naglaq|naglan|naglagaq|naklohe|naglast|naglol|naglalt|naglolõ|naglon|naklogaq|nakla|naglolt|naglaniq|nagloniq|naglal|nagloldaq|naglahn|naglohn|naglas|nagyl'|naglost|naklo|nagla	<i>noun</i><br><ol><li>nail (of metal)</li><li>pound (unit of measurement)</li><li>pound (currency)</li></ol>
nakri|naarist|nakrit|naaris|naari	<i>noun</i><br><ol><li>turnip</li></ol>
neli|nelli|nellä|neljä|nelä	<i>num</i><br><ol><li>four</li></ol>
neläpäiv|neläpäävihn|neläpääväniq|neläpääviniq|neläpäävilt|neläpäävile|neläpäivigäq|neläpääväs|neläpäävildäq|neläpäävist|neläpäävän|neläpääväq|neläpääväst|neläpäävin|neläpäivihe|neläpääväldäq|neläpäivä|neläpäävis|neläpäävält|neläpäävil|neläpääväle|neläpäävä|neläpäävägäq|neläpääväl|neläpäivi|neläpäävähn	<i>noun</i><br><ol><li>Thursday</li></ol>
nimekäänüs|nimekäänüses|nimekäänüssegäq|nimekäänüsten|nimekäänüssehe|nimekäänüssidegäq|nimekäänüsse|nimekäänüstegäq|nimekäänüstehn|nimekäänüssist|nimekäänüssihn|nimekäänüste|nimekäänüse|nimekäänüsen|nimekäänüssel|nimekäänüsside|nimekäänüsehn|nimekäänüselt|nimekäänüsseldäq|nimekäänüssis|nimekäänüseldäq|nimekäänüstele|nimekäänüstehe|nimekäänüsses|nimekäänüssele|nimekäänüsel|nimekäänüssin|nimekäänüssile|nimekäänüstest|nimekäänüsele|nimekäänüseq|nimekäänüssihe|nimekäänüst|nimekäänüssildäq|nimekäänüseniq|nimekäänüsteniq|nimekäänüssil|nimekäänüssilt|nimekäänüssiniq|nimekäänüssit|nimekäänüstes|nimekäänüsegäq|nimekäänüssen|nimekäänüssehn|nimekäänüsteldäq|nimekäänüsseq|nimekäänüsest|nimekäänüstel|nimekäänüsselt|nimekäänüssest|nimekäänüstelt|nimekäänüsseniq	<i>noun</i><br><ol><li>(grammar) nominative case</li></ol>
nimi|nime|nimme	<i>noun</i><br><ol><li>name</li><li>(grammar) nominal</li></ol>
nimisyna|nimisynalt|nimisynast|nimisynna|nimisynon|nimisynalõ|nimisynal|nimisynnolt|nimisynos|nimisynnogaq|nimisynohn|nimisynnost|nimisynahn|nimisynnoldaq|nimisynagaq|nimisynoniq|nimisynnon|nimisynnol|nimisynaldaq|nimisynnos|nimisynnohe|nimisynno|nimisynost|nimisynol|nimisynnohn|nimisynnolõ|nimisynolt|nimisynolõ|nimisynan|nimisynnoniq|nimisynoldaq|nimisynas|nimisynaq|nimisynaniq	<i>noun</i><br><ol><li>(grammar) noun, substantive</li></ol>
nuur'|noorõldaq|nooris|noorõq|noorin|noorõn|noorõlt|nuurigaq|noorõ|noorõst|noortõldaq|noortõst|noortõgaq|noorõl|noortõhn|nuurde|nuurt|noorihn|nooril|noorõs|noorõgaq|noorõhn|noortõl|noortõlt|nuuri|noorist|noorildaq|noortõs|noorilõ|noorõniq|noortõn|noorilt|noortõlõ|nuurihe|noortõniq|nooriniq|noorõlõ|noortõ	<i>adj</i><br><ol><li>young</li></ol>
nyna|nynna	<i>noun</i><br><ol><li>nose</li></ol>
nägemä|nätäq|näe	<i>verb</i><br><ol><li>to see</li></ol>
nälg|nälgä|nällä|nälä	<i>noun</i><br><ol><li>hunger</li></ol>
nätäl'|nädälit|nädäli	<i>noun</i><br><ol><li>week</li></ol>
nõid|nõia|nõida	<i>noun</i><br><ol><li>witch</li><li>sorcerer, wizard</li></ol>
oja|ojja|oia	<i>noun</i><br><ol><li>brook, creek</li></ol>
olg|ola|olga	<i>noun</i><br><ol><li>shoulder</li></ol>
olg'|olõ|olgõ	<i>noun</i><br><ol><li>straw, hay</li></ol>
ollõvaig|ollõvao|ollõvaigo|olõvaao|olõvataigo|olõvao	<i>noun</i><br><ol><li>(grammar) present tense</li></ol>
oluq|olt|ollõ	<i>noun</i><br><ol><li>beer</li></ol>
olõma|ollaq|olõ	<i>verb</i><br><ol><li>to be</li></ol>
olõvik|olõvikku|olõvigu	<i>noun</i><br><ol><li>(grammar) present tense</li></ol>
oo	<i>noun</i><br><ol><li>The name of the Latin-script letter O.</li></ol>
op'ma|oppiq|opi	<i>verb</i><br><ol><li>to learn</li></ol>
oppaja|oppajihn|oppajast|oppajilt|oppajalt|oppajihe|oppajal|oppajan|oppajas|oppajahn|oppajit|oppajin|oppajaldaq|oppajaq|oppajat|oppajilõ|oppajidõ|oppajis|oppajaniq|oppajildaq|oppajalõ|oppajagaq|oppajiniq|oppajahe|oppajist|oppajil|oppajidõgaq	<i>noun</i><br><ol><li>teacher</li><li>instructor</li></ol>
orrav|orava|oravat	<i>noun</i><br><ol><li>squirrel</li></ol>
osa|ossa	<i>noun</i><br><ol><li>part</li></ol>
osakäänüs|osakäänüsel|osakäänüsen|osakäänüstegäq|osakäänüselt|osakäänüsele|osakäänüssegäq|osakäänüssihn|osakäänüsside|osakäänüsse|osakäänüsehn|osakäänüssilt|osakäänüssehe|osakäänüsteldäq|osakäänüst|osakäänüstest|osakäänüssist|osakäänüstele|osakäänüsteniq|osakäänüsselt|osakäänüseldäq|osakäänüse|osakäänüsten|osakäänüsseq|osakäänüssele|osakäänüsest|osakäänüsegäq|osakäänüste|osakäänüssit|osakäänüstehn|osakäänüssest|osakäänüssile|osakäänüssil|osakäänüssin|osakäänüsseldäq|osakäänüseniq|osakäänüssiniq|osakäänüsses|osakäänüssen|osakäänüstelt|osakäänüssildäq|osakäänüses|osakäänüstehe|osakäänüsseniq|osakäänüssidegäq|osakäänüstel|osakäänüssihe|osakäänüssis|osakäänüssel|osakäänüstes|osakäänüssehn|osakäänüseq	<i>noun</i><br><ol><li>(grammar) partitive case</li></ol>
oss|ossa	<i>noun</i><br><ol><li>branch</li></ol>
ostma|ostaq|osta	<i>verb</i><br><ol><li>to buy</li></ol>
pandma|pandaq|panõ	<i>verb</i><br><ol><li>to put, to place</li></ol>
pedagoogiga	<i>noun</i><br><ol><li>pedagogy</li></ol>
pee	<i>noun</i><br><ol><li>The name of the Latin-script letter P.</li></ol>
perseq|perset|perse|perst	<i>noun</i><br><ol><li>arse, buttocks</li></ol>
perä|peris|perägäq|perihn|perän|perrihn|peräldäq|perähn|perildäq|perrigäq|perrihe|peril|perrist|peräq|peräle|perilt|perist|perrilt|perri|periniq|perriniq|perris|perile|perril|peräniq|peräl|peräst|perrä|peräs|perrildäq|perält|perrile|perrin|perin	<i>noun</i><br><ol><li>back, rear</li><li>rear end, rear part</li><li>backside</li><li>bottom</li></ol>
perädü|perädüle|perätühe|perätüidegäq|perätüilt|perätüihe|perätüid|perätüihn|perädült|perädügäq|perädüst|perädüq|perädüniq|perädüldäq|perädül|perätüin|perätüildäq|perätüile|perätüiniq|perätüil|perädüs|perädühn|perätüide|perätüis|perädün|perätüist|perätüt	<i>adj</i><br><ol><li>huge, enormous</li></ol>
pesä|pessä	<i>noun</i><br><ol><li>nest</li></ol>
pidämä|pitäq|piä	<i>verb</i><br><ol><li>to have to, must</li><li>to hold, to keep</li><li>to preserve</li><li>to hold back, to impede</li></ol>
piil'|piilt|peele	
piimäkuu|piimäkuud|piimäkuugaq|piimäkuin|piimäkuihtõ|piimäkuil|piimäkuuldaq|piimäkuulõ|piimäkuiniq|piimäkuildaq|piimäkuist|piimäkuis|piimäkuilt|piimäkuid|piimäkuuniq|piimäkuul|piimäkuihn|piimäkuiõ|piimäkuuhtõ|piimäkuuhõ|piimäkuun|piimäkuuhn|piimäkuiõgaq|piimäkuilõ|piimäkuust|piimäkuult|piimäkuuq|piimäkuus|piimäkuihõ	<i>noun</i><br><ol><li>June</li></ol>
piir'|piirõgaq|piirõlt|piirõ|piirõst|piirõniq|piiri|piirihn|piirin|piirilt|piirilõ|piirõhn|piirigaq|piiriniq|piirõs|piiril|piirõlõ|piirõl|piirist|piirildaq|piirõldaq|piiriq|piirõhe|piiris|piirõn	<i>noun</i><br><ol><li>limit</li><li>border, boundary</li></ol>
piirikäänüs|piirikäänüsest|piirikäänüseq|piirikäänüssis|piirikäänüseniq|piirikäänüsegäq|piirikäänüssen|piirikäänüsteldäq|piirikäänüssile|piirikäänüsse|piirikäänüsses|piirikäänüssele|piirikäänüst|piirikäänüssihn|piirikäänüssiniq|piirikäänüstehn|piirikäänüssest|piirikäänüstest|piirikäänüssidegäq|piirikäänüsseniq|piirikäänüssilt|piirikäänüssin|piirikäänüses|piirikäänüsehn|piirikäänüssegäq|piirikäänüseldäq|piirikäänüsteniq|piirikäänüstehe|piirikäänüssildäq|piirikäänüsseldäq|piirikäänüsen|piirikäänüstel|piirikäänüse|piirikäänüstele|piirikäänüste|piirikäänüsseq|piirikäänüssihe|piirikäänüssit|piirikäänüsel|piirikäänüstegäq|piirikäänüssist|piirikäänüssel|piirikäänüssil|piirikäänüselt|piirikäänüsele|piirikäänüsside|piirikäänüstelt|piirikäänüsselt|piirikäänüssehn|piirikäänüsten|piirikäänüssehe|piirikäänüstes	<i>noun</i><br><ol><li>(grammar) terminative case</li></ol>
pikk|pikemb|kygõ pikemb|pikkä|pikä	<i>adj</i><br><ol><li>long</li></ol>
pilv'|pilve	<i>noun</i><br><ol><li>cloud</li></ol>
pini|pinel|pinnest|pinest|pinihn|pinnen|pinneniq|pinehn|pinnes|pinile|pinnel|pines|pinen|pinil|pineldäq|pinnehn|pinin|pininiq|pinnele|piniq|pinele|pineniq|pinnegäq|pinnelt|pinne|pinilt|pinist|pinneldäq|pinelt|pinnehe|pinigäq|pinni|pinildäq|pinis	<i>noun</i><br><ol><li>dog</li></ol>
poig|poja|poiga|puja	<i>noun</i><br><ol><li>son</li><li>boy</li></ol>
puhm|puhmõ|puhmas|puhmaniq|puhmõst|puhmaldaq|puhmal|puhmõlõ|puhmõniq|puhmõn|puhmõs|puhmahn|puhmalõ|puhmõldaq|puhmast|puhmaq|puhmagaq|puhmõl|puhmalt|puhmõhn|puhman|puhmõhe|puhmõgaq|puhma|puhmõlt	<i>noun</i><br><ol><li>bush</li></ol>
purõma|purraq|purõ	<i>verb</i><br><ol><li>to bite</li></ol>
puu|puun|puihtõ|puilt|puin|puiniq|puulõ|puiõ|puiõgaq|puis|puugaq|puuhn|puihõ|puildaq|puilõ|puult|puid|puul|puuniq|puil|puuhõ|puuhtõ|puuldaq|puud|puuq|puust|puist|puus|puihn	<i>noun</i><br><ol><li>tree</li></ol>
puul'päiv|puul'päivä|puul'pääväle|puul'päävildäq|puul'pääviniq|puul'päävän|puul'päivigäq|puul'päävält|puul'päävilt|puul'päävägäq|puul'päävä|puul'päivi|puul'päävist|puul'pääväniq|puul'päävile|puul'pääväst|puul'päävähn|puul'päävin|puul'päävil|puul'pääväs|puul'päävihn|puul'pääväq|puul'päävis|puul'pääväl|puul'pääväldäq|puul'päivihe	<i>noun</i><br><ol><li>Saturday</li></ol>
puutri|puutrit	<i>noun</i><br><ol><li>computer</li></ol>
päheq|pähk'mest|pähk'midegäq|pähk'min|pähk'mihn|pähk'miniq|pähk'mil|pähk'meniq|pähk'mehe|pähk'mehn|pähk'mis|pähk'mildäq|pähk'me|pähk'meldäq|pähk'mide|pähk'melt|pähk'mihe|pähk'mele|pähk'mit|pähk'meq|pähend|pähk'mile|pähk'milt|pähk'mist|pähk'mes|pähk'megäq|pähk'men|pähk'mel	<i>noun</i><br><ol><li>nut</li></ol>
päiv|pääväl|pääväldäq|päävilt|pääväst|päävähn|päävihn|pääviniq|päivä|pääväle|päävägäq|päävält|päävän|pääväs|pääväniq|päävis|päivihe|pääväq|päävist|päävile|päävil|päävä|päävildäq|päivi|päivigäq|päävin	<i>noun</i><br><ol><li>day</li><li>sun</li></ol>
päkk|päkkä|päkä	<i>noun</i><br><ol><li>thumb</li></ol>
pää|päiniq|päihte|päil|päie|päid|päihn|päilt|päildäq|päist|pääq|pääd|pääs|päägäq|päihe|pään|pähäq|pääniq|pääldäq|päält|päile|pääst|pääl|päiegäq|päin|päis|päähn|pääle|päähä	<i>noun</i><br><ol><li>head</li><li>end, tip</li></ol>
päälekäänüs|päälekäänüssehn|päälekäänüstel|päälekäänüssil|päälekäänüssest|päälekäänüsselt|päälekäänüselt|päälekäänüsegäq|päälekäänüsen|päälekäänüst|päälekäänüssin|päälekäänüse|päälekäänüssehe|päälekäänüsside|päälekäänüssen|päälekäänüstes|päälekäänüsses|päälekäänüsele|päälekäänüsse|päälekäänüsseniq|päälekäänüssegäq|päälekäänüssit|päälekäänüsteniq|päälekäänüstelt|päälekäänüssilt|päälekäänüssile|päälekäänüstehn|päälekäänüsten|päälekäänüstegäq|päälekäänüssel|päälekäänüstest|päälekäänüsseldäq|päälekäänüsel|päälekäänüssis|päälekäänüssiniq|päälekäänüssihe|päälekäänüsest|päälekäänüssele|päälekäänüstehe|päälekäänüseq|päälekäänüssihn|päälekäänüsehn|päälekäänüses|päälekäänüste|päälekäänüseniq|päälekäänüssildäq|päälekäänüsteldäq|päälekäänüssist|päälekäänüseldäq|päälekäänüsseq|päälekäänüstele|päälekäänüssidegäq	<i>noun</i><br><ol><li>(grammar) allative case</li></ol>
päälkäänüs|päälkäänüssiniq|päälkäänüsen|päälkäänüssil|päälkäänüstehe|päälkäänüstes|päälkäänüsseniq|päälkäänüsses|päälkäänüsteldäq|päälkäänüselt|päälkäänüstel|päälkäänüsest|päälkäänüsel|päälkäänüsteniq|päälkäänüstehn|päälkäänüsseldäq|päälkäänüse|päälkäänüses|päälkäänüssis|päälkäänüsten|päälkäänüseldäq|päälkäänüseniq|päälkäänüsseq|päälkäänüssilt|päälkäänüssegäq|päälkäänüstegäq|päälkäänüssen|päälkäänüsse|päälkäänüssehn|päälkäänüssildäq|päälkäänüsegäq|päälkäänüsele|päälkäänüsside|päälkäänüssihn|päälkäänüseq|päälkäänüssele|päälkäänüssehe|päälkäänüssidegäq|päälkäänüste|päälkäänüssist|päälkäänüstest|päälkäänüssit|päälkäänüsselt|päälkäänüstelt|päälkäänüssihe|päälkäänüsehn|päälkäänüst|päälkäänüssel|päälkäänüssest|päälkäänüssin|päälkäänüssile|päälkäänüstele	<i>noun</i><br><ol><li>(grammar) adessive case</li></ol>
päältkäänüs|päältkäänüssehe|päältkäänüssihe|päältkäänüseq|päältkäänüstest|päältkäänüssil|päältkäänüssis|päältkäänüsele|päältkäänüstele|päältkäänüsteldäq|päältkäänüselt|päältkäänüsside|päältkäänüssehn|päältkäänüsteniq|päältkäänüst|päältkäänüssile|päältkäänüstehn|päältkäänüstel|päältkäänüsest|päältkäänüste|päältkäänüsegäq|päältkäänüseniq|päältkäänüssist|päältkäänüse|päältkäänüssen|päältkäänüstegäq|päältkäänüssin|päältkäänüsehn|päältkäänüssihn|päältkäänüseldäq|päältkäänüssel|päältkäänüsselt|päältkäänüssegäq|päältkäänüsses|päältkäänüssiniq|päältkäänüses|päältkäänüsseq|päältkäänüstelt|päältkäänüssildäq|päältkäänüssele|päältkäänüsse|päältkäänüstehe|päältkäänüsseldäq|päältkäänüssilt|päältkäänüstes|päältkäänüsen|päältkäänüsten|päältkäänüssidegäq|päältkäänüssit|päältkäänüssest|päältkäänüsel|päältkäänüsseniq	<i>noun</i><br><ol><li>(grammar) ablative case</li></ol>
põh'a|põhja|põhi	<i>noun</i><br><ol><li>base, foundation</li><li>floor</li><li>bottom</li></ol>
põhi|põhja|põh'a	<i>noun</i><br><ol><li>north</li></ol>
põimukuu|põimukuin|põimukuilt|põimukuun|põimukuilõ|põimukuid|põimukuiõ|põimukuuniq|põimukuihn|põimukuuldaq|põimukuuhtõ|põimukuist|põimukuihõ|põimukuust|põimukuus|põimukuud|põimukuil|põimukuildaq|põimukuugaq|põimukuuhn|põimukuuhõ|põimukuiniq|põimukuihtõ|põimukuul|põimukuiõgaq|põimukuult|põimukuuq|põimukuis|põimukuulõ	<i>noun</i><br><ol><li>August</li></ol>
põld|põldo|põllo	<i>noun</i><br><ol><li>field (area for growing crops)</li></ol>
põlv'|põlvõ	<i>noun</i><br><ol><li>knee</li></ol>
põsk'|põsõ|põskõ	<i>noun</i><br><ol><li>cheek</li></ol>
pühä|pühhä	<i>adj</i><br><ol><li>holy, sacred</li></ol>
pühäpäiv|pühäpääväst|pühäpäivigäq|pühäpäävist|pühäpääväle|pühäpäivi|pühäpäävile|pühäpääväldäq|pühäpäävilt|pühäpäävil|pühäpäävä|pühäpäävägäq|pühäpäävin|pühäpäävis|pühäpäävihn|pühäpäävähn|pühäpääväs|pühäpääväq|pühäpäävän|pühäpääviniq|pühäpääväl|pühäpääväniq|pühäpäivihe|pühäpäävält|pühäpäivä|pühäpäävildäq	<i>noun</i><br><ol><li>Sunday</li></ol>
püür|pöörä|püürä	
raamat|raamatilt|raamatin|raamatildaq|raamadul|raamatihe|raamatuhe|raamatit|raamaduq|raamatidõ|raamatilõ|raamadu|raamadulõ|raamadult|raamatiniq|raamaduniq|raamatil|raamaduhn|raamatis|raamatut|raamadun|raamadugaq|raamaduldaq|raamatihn|raamadus|raamatidõgaq|raamatist|raamadust	<i>noun</i><br><ol><li>book</li></ol>
radokuu|radokuiõgaq|radokuus|radokuuhn|radokuuhõ|radokuuhtõ|radokuugaq|radokuildaq|radokuil|radokuult|radokuulõ|radokuiõ|radokuud|radokuuniq|radokuilõ|radokuist|radokuilt|radokuihõ|radokuust|radokuuldaq|radokuihn|radokuid|radokuihtõ|radokuiniq|radokuin|radokuun|radokuis|radokuuq|radokuul	<i>noun</i><br><ol><li>February</li></ol>
rand|rannõst|rannahn|rannaq|rannalõ|rannaniq|rannõhn|rannas|randõhe|rannõl|rannõn|rannõniq|rannõlt|rannaldaq|ranna|rannalt|randõgaq|rannal|rannan|rannõs|rannast|rannagaq|randa|rannõlõ|rannõldaq|randõ	<i>noun</i><br><ol><li>beach, shore</li></ol>
rasõv|rasva	<i>noun</i><br><ol><li>fat, grease</li></ol>
raud|ravva|rauda	<i>noun</i><br><ol><li>iron</li></ol>
rebo|repo	<i>noun</i><br><ol><li>(childish) fox</li></ol>
rehekuu|rehekuildaq|rehekuihõ|rehekuiõ|rehekuugaq|rehekuiõgaq|rehekuul|rehekuil|rehekuuhtõ|rehekuilõ|rehekuus|rehekuuniq|rehekuun|rehekuud|rehekuist|rehekuust|rehekuihn|rehekuuldaq|rehekuid|rehekuuq|rehekuuhõ|rehekuilt|rehekuin|rehekuuhn|rehekuihtõ|rehekuiniq|rehekuulõ|rehekuis|rehekuult	<i>noun</i><br><ol><li>October</li></ol>
repän'|rebäst|rebäsildäq|rebästegäq|rebäsen|rebäsehe|rebäsegäq|rebäseniq|rebäside|rebäsidegäq|rebäsest|rebäsihe|rebäsilt|rebäsis|rebästes|rebäste|rebäsele|rebästehn|rebästel|rebästeldäq|rebäsiniq|rebästelt|rebäsile|rebäseldäq|rebästen|rebästest|rebäsihn|rebäsin|rebäselt|rebästehe|rebäsel|rebäsist|rebäsehn|rebäses|rebäseq|rebäse|rebästele|rebästeniq|rebäsit|rebäsil	<i>noun</i><br><ol><li>fox</li></ol>
riidi|riidit	<i>noun</i><br><ol><li>Friday</li></ol>
riik'|riigilt|riigiq|riiki|riigin|riigest|riigeldäq|riigehn|riigihn|riigile|riigel|riiges|riigi|riigildäq|riigil|riigelt|riigen|riigis|riigeniq|riiginiq|riigist|riike|riigele|riigigäq|riikehe|riikegäq	<i>noun</i><br><ol><li>state</li><li>country</li><li>kingdom</li><li>empire</li></ol>
rits'kas|rits'kan|rits'kalt|rits'kil|rits'kaldaq|rits'kastõldaq|rits'kin|rits'kastõst|rits'kaq|rits'kast|rits'kastõlõ|rits'kastõs|rits'kit|rits'kidõ|rits'kastõhe|rits'kidõgaq|rits'kagaq|rits'kilõ|rits'kihn|rits'kiniq|rits'kist|rits'kahn|rits'kastõl|rits'kildaq|rits'kastõ|rits'ka|rits'kis|rits'kastõniq|rits'kaniq|rits'kal|rits'kastõgaq|rits'kilt|rits'kat|rits'kalõ|rits'kahe|rits'kastõlt|rits'kastõhn|rits'kastõn|rits'kihe	<i>noun</i><br><ol><li>grasshopper</li><li>cricket</li></ol>
rõnnakuup|rõnnakooba|rõnnakuupa	<i>noun</i><br><ol><li>thoracic cavity</li></ol>
saabas|saapil|saabastõhe|saapaq|saabastõhn|saapal|saapahn|saabastõn|saapilt|saapas|saapast|saabastõs|saapilõ|saapit|saabast|saapan|saapagaq|saabastõlõ|saapin|saabastõniq|saapihn|saapalõ|saapihe|saapildaq|saapidõgaq|saabastõgaq|saapahe|saabastõ|saapiniq|saabastõst|saapaniq|saapaldaq|saabastõlt|saapidõ|saapa|saapist|saabastõldaq|saabastõl|saapalt|saapis	<i>noun</i><br><ol><li>boot</li></ol>
saajakäänüs|saajakäänüstes|saajakäänüssildäq|saajakäänüsside|saajakäänüssihn|saajakäänüssel|saajakäänüsses|saajakäänüssile|saajakäänüsteldäq|saajakäänüssele|saajakäänüsest|saajakäänüsel|saajakäänüssil|saajakäänüsseq|saajakäänüsteniq|saajakäänüsseniq|saajakäänüsele|saajakäänüseq|saajakäänüstehn|saajakäänüssihe|saajakäänüsten|saajakäänüssiniq|saajakäänüssehe|saajakäänüssin|saajakäänüssen|saajakäänüstest|saajakäänüste|saajakäänüssis|saajakäänüst|saajakäänüstel|saajakäänüseldäq|saajakäänüses|saajakäänüssidegäq|saajakäänüstele|saajakäänüssegäq|saajakäänüselt|saajakäänüstegäq|saajakäänüseniq|saajakäänüsse|saajakäänüssilt|saajakäänüsehn|saajakäänüsselt|saajakäänüsegäq|saajakäänüstehe|saajakäänüsseldäq|saajakäänüssist|saajakäänüse|saajakäänüsen|saajakäänüssit|saajakäänüssehn|saajakäänüstelt|saajakäänüssest	<i>noun</i><br><ol><li>(grammar) translative case</li></ol>
saama|saiaq|saa	<i>verb</i><br><ol><li>to get, to receive</li><li>to become</li></ol>
saar'|saart|saarõ	<i>noun</i><br><ol><li>island</li></ol>
saatma|saataq|saada	<i>verb</i><br><ol><li>to accompany, to escort</li><li>to direct, to guide</li><li>to send</li></ol>
sada|sata|saa	<i>num</i><br><ol><li>hundred</li></ol>
sadama|sata|sataq	<i>verb</i><br><ol><li>to fall, to drop</li><li>to rain, to precipitate (fall from the sky)</li></ol>
sann|sanna	<i>noun</i><br><ol><li>sauna</li></ol>
savi|savvi	<i>noun</i><br><ol><li>clay</li></ol>
seemen|siimne|seemend	<i>noun</i><br><ol><li>seed</li></ol>
seenkäänüs|seenkäänüsegäq|seenkäänüssihn|seenkäänüssilt|seenkäänüsteniq|seenkäänüseniq|seenkäänüssel|seenkäänüsseniq|seenkäänüssildäq|seenkäänüstehe|seenkäänüssele|seenkäänüstel|seenkäänüssis|seenkäänüsele|seenkäänüseq|seenkäänüstelt|seenkäänüssegäq|seenkäänüssile|seenkäänüssin|seenkäänüssidegäq|seenkäänüssest|seenkäänüssil|seenkäänüstegäq|seenkäänüseldäq|seenkäänüsteldäq|seenkäänüsseq|seenkäänüsside|seenkäänüsten|seenkäänüstehn|seenkäänüse|seenkäänüssen|seenkäänüsest|seenkäänüsses|seenkäänüstele|seenkäänüses|seenkäänüssiniq|seenkäänüsehn|seenkäänüsen|seenkäänüssihe|seenkäänüssist|seenkäänüstest|seenkäänüssit|seenkäänüsse|seenkäänüselt|seenkäänüssehn|seenkäänüsel|seenkäänüstes|seenkäänüsselt|seenkäänüsseldäq|seenkäänüssehe|seenkäänüste|seenkäänüst	<i>noun</i><br><ol><li>(grammar) inessive case</li></ol>
seestkäänüs|seestkäänüssis|seestkäänüssel|seestkäänüsehn|seestkäänüsteniq|seestkäänüstegäq|seestkäänüsseldäq|seestkäänüssihn|seestkäänüssin|seestkäänüssilt|seestkäänüsegäq|seestkäänüssil|seestkäänüsele|seestkäänüstehn|seestkäänüst|seestkäänüsside|seestkäänüsen|seestkäänüseniq|seestkäänüssile|seestkäänüstest|seestkäänüssen|seestkäänüssidegäq|seestkäänüsse|seestkäänüssihe|seestkäänüssit|seestkäänüstehe|seestkäänüsses|seestkäänüses|seestkäänüssegäq|seestkäänüssele|seestkäänüssehe|seestkäänüselt|seestkäänüsest|seestkäänüsselt|seestkäänüse|seestkäänüsseq|seestkäänüsten|seestkäänüssehn|seestkäänüsseniq|seestkäänüste|seestkäänüstel|seestkäänüseq|seestkäänüssest|seestkäänüstelt|seestkäänüssiniq|seestkäänüsel|seestkäänüseldäq|seestkäänüstele|seestkäänüssist|seestkäänüssildäq|seestkäänüsteldäq|seestkäänüstes	<i>noun</i><br><ol><li>(grammar) elative case</li></ol>
sekond	<i>noun</i><br><ol><li>second</li></ol>
seo ilma aigo	<i>adv</i><br><ol><li>nowadays</li></ol>
sepp|sepä|seppä	<i>noun</i><br><ol><li>smith</li><li>yeast</li></ol>
siil'|siili	<i>noun</i><br><ol><li>hedgehog</li></ol>
siin'|siint|seene	<i>noun</i><br><ol><li>mushroom</li><li>fungus</li></ol>
silm|silmihe|silmigäq|silminiq|silmä|silmäl|silmäle|silmäniq|silmist|silmähn|silmildäq|silmile|silmält|silmän|silmilt|silmis|silmäldäq|silmäs|silmil|silmin|silmihn|silmi|silmägäq|silmäst|silmäq	<i>noun</i><br><ol><li>eye</li></ol>
sinine|sinisteldäq|sinidseldäq|sinistegäq|sinitsidegäq|sinidses|sinistehe|sinist|sinidsen|sinitsihn|sinitsiniq|sinistes|siniste|sinidseniq|sinitsit|sinidselt|sinidsehn|sinitsin|sinisteniq|sinistel|sinitsildäq|sinisten|sinitsil|sinidseq|sinidsele|sinistehn|sinidse|sinistele|sinitsist|sinitsis|sinitsehe|sinidsel|sinitsilt|sinistest|sinitsihe|sinidsegäq|sinidsest|sinitside|sinitsile|sinistelt	<i>adj</i><br><ol><li>blue</li></ol>
sissekäänüs|sissekäänüst|sissekäänüsele|sissekäänüssildäq|sissekäänüsest|sissekäänüssehe|sissekäänüssihn|sissekäänüsteniq|sissekäänüsseldäq|sissekäänüstest|sissekäänüstehn|sissekäänüssehn|sissekäänüssil|sissekäänüseq|sissekäänüssit|sissekäänüssist|sissekäänüsside|sissekäänüstegäq|sissekäänüssilt|sissekäänüssidegäq|sissekäänüstele|sissekäänüsten|sissekäänüsseniq|sissekäänüsel|sissekäänüse|sissekäänüseniq|sissekäänüstes|sissekäänüstehe|sissekäänüssel|sissekäänüssest|sissekäänüssen|sissekäänüste|sissekäänüssile|sissekäänüssis|sissekäänüsegäq|sissekäänüsselt|sissekäänüssihe|sissekäänüses|sissekäänüselt|sissekäänüssiniq|sissekäänüsse|sissekäänüsen|sissekäänüstelt|sissekäänüsteldäq|sissekäänüssegäq|sissekäänüsses|sissekäänüsseq|sissekäänüssele|sissekäänüstel|sissekäänüseldäq|sissekäänüssin|sissekäänüsehn	<i>noun</i><br><ol><li>(grammar) illative case</li></ol>
siug|siugõgaq|sivvul|sivvuq|sivvuhn|sivvõn|siugu|sivvult|sivvõl|sivvuldaq|sivvõhn|sivvõs|sivvulõ|sivvõniq|sivvugaq|sivvust|sivvuniq|sivvõldaq|sivvus|sivvõlõ|sivvõlt|sivvõst|sivvu|siugõ|sivvun|siugõhe	<i>noun</i><br><ol><li>snake</li></ol>
suhvli|suhvlihn|suhvliist|suhvliilõ|suhvlis|suhvlin|suhvlil|suhvliil|suhvlidõgaq|suhvligaq|suhvliiniq|suhvlihe|suhvliniq|suhvliin|suhvlildaq|suhvlist|suhvlit|suhvliilt|suhvliis|suhvliihe|suhvlilt|suhvliid|suhvliihn|suhvlilõ|suhvliildaq|suhvliq|suhvlidõ	<i>noun</i><br><ol><li>drawer</li><li>compartment</li></ol>
susi|soe|sutt	<i>noun</i><br><ol><li>wolf, grey wolf</li></ol>
suu|suugaq|suu|suiõ|suuhu|soin|soiõgaq|suult|suuhtõ|soilõ|suulõ|soihtõ|soiniq|suist|soildaq|suildaq|soiõ|suiniq|suul|suil|suin|suilõ|suihõ|soist|sois|suis|suus|suuldaq|suun|suiõgaq|soilt|suuq|soil|suihn|suid|suust|suuniq|suilt|soihn|soid|suhuq|suuhõ|suud|soihe|suihtõ|suuhn	<i>noun</i><br><ol><li>mouth</li><li>swamp</li></ol>
suun'|suunt|soonõ	<i>noun</i><br><ol><li>sinew</li></ol>
suvi|suvõ|suvvõ	<i>noun</i><br><ol><li>summer</li></ol>
syna|synnohe|synnost|synoniq|synoldaq|synna|synol|synohn|synolt|synalõ|synos|synnolõ|synnolt|synaq|synno|synnon|synnogaq|synal|synagaq|synalt|synost|synahn|synnol|synnohn|synas|synaldaq|synolõ|synnoldaq|synnos|synon|synan|synast|synnoniq|synaniq	<i>noun</i><br><ol><li>word</li></ol>
synaraamat|synaraamaduq|synaraamadult|synaraamadul|synaraamatist|synaraamaduniq|synaraamatildaq|synaraamatilõ|synaraamadust|synaraamadugaq|synaraamadus|synaraamatut|synaraamatidõ|synaraamatihe|synaraamatuhe|synaraamaduldaq|synaraamatilt|synaraamatil|synaraamatihn|synaraamatiniq|synaraamatidõgaq|synaraamadun|synaraamatis|synaraamaduhn|synaraamadulõ|synaraamadu|synaraamatit|synaraamatin	<i>noun</i><br><ol><li>dictionary</li></ol>
säidse|säidsend|säitsme	<i>num</i><br><ol><li>seven</li></ol>
sälg|sällä|sälgä|sälä	<i>noun</i><br><ol><li>back (of the body)</li><li>back, rear</li></ol>
särg'|säreq|särge|sären|särgihe|särehn|särilt|säris|särin|säregäq|särihn|särile|särest|säreniq|särgigäq|särelt|säriniq|särgi|säre|särist|särel|säreldäq|säres|säril|särildäq|särele	<i>noun</i><br><ol><li>roach (fish)</li></ol>
säsü|säsest|tsätse|tsätsehn|tsätseniq|tsädsü|tsätsegäq|tsädselt|tsädsült|tsädsele|säsüq|tsädsüle|säsüst|tsädsün|tsädsest|sässehe|säselt|säsühn|sässes|säsen|sässen|säsül|tsätsen|tsädsüniq|tsädsühn|säsügäq|tsätsele|tsädsüq|sässeniq|sässele|säsüldäq|säsel|tsädsel|sässehn|säsüniq|tsädseldäq|tsätselt|tsädsüs|sässest|säseniq|sässeldäq|säsün|sässe|säsüle|säsele|säsüs|tsädsüst|tsädseniq|säses|tsädses|tsätsehe|tsädsül|tsädsen|tsädsügäq|säseldäq|tsätsü|sässü|sässel|säsült|sässelt|tsätseldäq|tsädsüldäq|tsätsel|tsädsehn|tsätsest|tsätses|sässegäq|säsehn	<i>noun</i><br><ol><li>pith</li><li>marrow</li><li>core</li><li>nucleus</li></ol>
sõba|sõpa	
sõda|syagaq|sõta|syan|syalt|syas|sõtoldaq|syaq|syaniq|sõtolõ|syalõ|syast|syal|sõtoniq|sõtohn|sya|sõtto|sõtta|sõtolt|syahn|sõto|sõton|sõtol|sõttohe|sõtogaq|sõtos|sõtost|syaldaq	<i>noun</i><br><ol><li>war</li></ol>
sõidoriist|sõidoriista	<i>noun</i><br><ol><li>vehicle</li></ol>
sõpr|sõbra|sõpra	<i>noun</i><br><ol><li>friend</li></ol>
sõrm'|sõrmõ	<i>noun</i><br><ol><li>finger</li></ol>
sõudma|sõvva|sõudaq	<i>verb</i><br><ol><li>to row (with oars)</li></ol>
süküs|sügüse|süküst	<i>noun</i><br><ol><li>autumn</li></ol>
süküskuu|süküskuin|süküskuuq|süküskuuniq|süküskuuhõ|süküskuihõ|süküskuid|süküskuihn|süküskuiõ|süküskuus|süküskuult|süküskuuhtõ|süküskuul|süküskuust|süküskuud|süküskuiniq|süküskuis|süküskuuldaq|süküskuiõgaq|süküskuulõ|süküskuist|süküskuildaq|süküskuuhn|süküskuilõ|süküskuihtõ|süküskuil|süküskuugaq|süküskuilt|süküskuun	<i>noun</i><br><ol><li>September</li></ol>
sündümä|sündüdäq|sünnü	<i>verb</i><br><ol><li>to be born</li><li>to fit, to be suitable</li><li>to happen</li></ol>
süä|süänd|süäme	<i>noun</i><br><ol><li>heart</li></ol>
süü|süühte|süihn|süiniq|süülõ|süüldaq|süihe|süügaq|süist|süüs|süühe|süült|süilt|süüq|süid|süül|süin|süildaq|süühn|süie|süis|süihte|süiegaq|süüniq|süüst|süün|süil|süilõ	<i>noun</i><br><ol><li>fault</li><li>guilt</li><li>reason, cause</li></ol>
süümä|süvväq|süü	<i>verb</i><br><ol><li>to eat</li></ol>
taivas|taiva|taivast	<i>noun</i><br><ol><li>sky</li><li>heaven</li></ol>
talo|tallõhe|talaniq|talalt|talõn|talõl|tallõgaq|talõhn|talõs|tallõl|talaldaq|talolt|tallahe|tallal|talolõ|talalõ|talal|talõlt|tallo|talohn|tallalõ|tallagaq|talast|tallalt|tallan|tallõldaq|tallaniq|tallahn|talos|tallõhn|talõniq|talan|taloq|tallõ|talol|taloldaq|tallõlt|talõlõ|talogaq|tallõn|tallõst|talahn|talon|talas|taloniq|tallaldaq|tallõlõ|talost|tallas|tallõniq|talõldaq|talõst|talla|tallõs|tallast	<i>noun</i><br><ol><li>farm, farmstead</li></ol>
talv'|talvõ	<i>noun</i><br><ol><li>winter</li></ol>
tarõ|tarõq|tarrigaq|tarilõ|tarrihe|tarihn|tarõlõ|tarõgaq|tarrildaq|tarriniq|tarõl|tarõs|tarõn|tarin|tarõldaq|tarri|tarrõ|tarrilt|tarrin|tarildaq|taril|tarõst|tarist|tarril|tarilt|tarrilõ|tarõhn|tarõlt|tariniq|tarõniq|taris|tarris|tarrist|tarrihn	<i>noun</i><br><ol><li>room</li><li>farmhouse</li></ol>
tee	<i>noun</i><br><ol><li>The name of the Latin-script letter T.</li></ol>
tegemä|tetäq|tii	<i>verb</i><br><ol><li>to do</li><li>to make</li><li>to produce</li></ol>
tego|teo|teko	<i>noun</i><br><ol><li>deed, act</li><li>action</li><li>fact</li></ol>
tegonimi|tegonime|tegonimme	<i>noun</i><br><ol><li>(grammar) infinitive</li></ol>
tegosyna|tegosynnolt|tegosynan|tegosynna|tegosynast|tegosynnolõ|tegosynaniq|tegosynahn|tegosynnohe|tegosynnos|tegosynas|tegosynaq|tegosynalt|tegosynnol|tegosynost|tegosynno|tegosynon|tegosynolt|tegosynnoniq|tegosynnohn|tegosynoniq|tegosynnogaq|tegosynnoldaq|tegosynagaq|tegosynnon|tegosynol|tegosynos|tegosynoldaq|tegosynnost|tegosynaldaq|tegosynal|tegosynohn|tegosynolõ|tegosynalõ	<i>noun</i><br><ol><li>(grammar) verb</li></ol>
terveh|tervehte|tervele|tervetest|tervetehn|terveteldäq|tervildäq|tervehtehe|terveten|tervehtehn|terves|tervehtele|tervile|tervil|tervetelt|tervel|tervelt|tervehtes|tervehtest|tervit|tervetehe|tervehteniq|terveht|terveldäq|tervehtelt|tervehtegäq|tervehtel|terveteniq|tervehn|tervihn|tervilt|terviniq|tervetes|tervis|tervidegäq|terve|tervegäq|terveq|terven|tervehten|tervest|tervist|tervehteldäq|tervehe|tervet|tervetele|tervetel|tervetegäq|tervide|tervete|tervihe|tervin|terveniq	<i>adj</i><br><ol><li>healthy</li><li>whole, unbroken</li></ol>
tervüs|tervüseq|tervüisildäq|tervüsen|tervüidegäq|tervühn|tervüse|tervüses|tervüid|tervüisis|tervüisin|tervüihn|tervüist|tervüsteldäq|tervüstehn|tervüisigäq|tervüstes|tervüst|tervüsest|tervün|tervüsele|tervüiniq|tervüldäq|tervüildäq|tervüisi|tervüis|tervül|tervült|tervüstest|tervüihe|tervüin|tervüselt|tervüt|tervügäq|tervüstehe|tervüniq|tervühe|tervüle|tervüstel|tervüisihe|tervüsten|tervüilt|tervüide|tervüsel|tervüstele|tervüste|tervüq|tervüisilt|tervüseldäq|tervüile|tervüisist|tervüstegäq|tervüisiniq|tervüsegäq|tervüsehn|tervü|tervüil|tervüisile|tervüseniq|tervüisihn|tervüisil|tervüstelt|tervüsteniq	<i>noun</i><br><ol><li>health</li></ol>
terä|terrä	
tetr|tedre|tetre	<i>noun</i><br><ol><li>black grouse</li></ol>
tialanõ|tialaidsigaq|tialadsõlõ|tialaisis|tialadsõniq|tialasõhn|tialaisildaq|tialasõs|tialadsõs|tialaisin|tialastõldaq|tialaidsildaq|tialastõlt|tialastõhn|tialadsõst|tialaisigaq|tialasõn|tialaidsihe|tialastõs|tialadsõhn|tialaisist|tialaidsiniq|tialastõn|tialaidsi|tialasõgaq|tialaidsin|tialastõlõ|tialastõ|tialaidsist|tialadsõn|tialaisi|tialaidsil|tialaisilõ|tialaisilt|tialaisihn|tialast|tialadsõ|tialastõgaq|tialadsõq|tialaisil|tialastõl|tialasõq|tialadsõl|tialaidsihn|tialadsõgaq|tialasõl|tialastõst|tialaidsis|tialasõlõ|tialaisiniq|tialastõniq|tialaidsilõ|tialasõst|tialadsõldaq|tialasõniq|tialasõlt|tialasõldaq|tialasõ|tialaidsilt|tialadsõlt	<i>noun</i><br><ol><li>titmouse</li></ol>
tii|tiihn|teil|tiile|tein|teildäq|teis|tiis|teilt|tiin|tiil|teile|tiihte|teiniq|teihte|teist|tiilt|teie|tiiq|tiist|tiid|teiegäq|tiiniq|tiihe|tiildäq|teihe|tiigäq|teid|teihn	<i>noun</i><br><ol><li>way, road, path</li><li>trip, journey</li></ol>
tiidmä|tiiä|teedäq	<i>verb</i><br><ol><li>to know</li><li>to feel</li></ol>
tina|tinna	<i>noun</i><br><ol><li>tin</li></ol>
tinkõlõja kynnõviis'	<i>noun</i><br><ol><li>(grammar) conditional mood</li></ol>
tsee	<i>noun</i><br><ol><li>The name of the Latin-script letter C.</li></ol>
tsiga|tsika|tsia	<i>noun</i><br><ol><li>pig</li></ol>
tsink'|tsingi|tsinki	<i>noun</i><br><ol><li>zinc</li></ol>
tsirk|tsirgu|tsirku	<i>noun</i><br><ol><li>bird</li></ol>
tsyyr'|tsyyri|tsõõri	<i>noun</i><br><ol><li>wheel</li></ol>
tuli|tulõ|tuld	<i>noun</i><br><ol><li>fire</li></ol>
tulõma|tulõ|tullaq	<i>verb</i><br><ol><li>to come</li></ol>
tundma|tundaq|tunnõ	<i>verb</i><br><ol><li>to know</li><li>to feel</li></ol>
tunn'|tunni	<i>noun</i><br><ol><li>hour</li></ol>
tuum'|toomõ|tuumõ	<i>noun</i><br><ol><li>bird cherry</li></ol>
tuuma|tuu|tuvvaq	<i>verb</i><br><ol><li>to get, to retrieve, to fetch</li><li>to bring</li></ol>
täht'|tähte|tähe	<i>noun</i><br><ol><li>star</li><li>letter (of the alphabet)</li></ol>
täi|täen|täis|täihte|täid|täil|täilt|täigäq|täiniq|täest|täildäq|täeniq|täiegäq|täihn|täes|täie|täel|täehn|täele|täihe|täist|täelt|täin|täiq|täeldäq|täile	<i>noun</i><br><ol><li>louse</li></ol>
täü|tävvü	<i>noun</i><br><ol><li>lung</li></ol>
täüs'|täüsigäq|täüteldäq|täütehn|tävvele|täütelt|tävve|tävvis|tävveq|täüde|tävvest|tävveniq|tävven|täüsihe|täüten|tävviniq|tävveldäq|täüsi|täütele|tävvildäq|tävvilt|täütes|tävvile|tävvist|täüteniq|tävvegäq|tävvin|tävvel|täütest|tävvelt|tävvil|tävvihn|täütel|tävves|täütegäq|täüte|täüt|tävvehn	<i>adj</i><br><ol><li>full</li><li>whole</li></ol>
tõrv|tõrva	<i>noun</i><br><ol><li>tar</li></ol>
tõõnõ|tyisigaq|tõõsõ|tõisilõ|tõõsõgaq|tõistõst|tysõs|tõistõl|tõisi|tysõgaq|tyistõniq|tõõsõn|tyistõlt|tõisihe|tõisin|tõõsõlt|tõõsõniq|tyisilõ|tõisilt|tyistõs|tõisil|tõisiniq|tyistõ|tyisilt|tyisis|tyistõldaq|tõõsõhn|tõisildaq|tysõlõ|tõisis|tõistõniq|tõõsõldaq|tysõ|tysõn|tysõniq|tõisihn|tyisin|tõistõldaq|tysõl|tyisihn|tõisist|tysõldaq|tõõsõlõ|tyisihe|tõõsõs|tysõq|tõistõn|tõistõgaq|tõõsõst|tõõsõq|tõistõs|tyist|tysõhn|tyisist|tyistõst|tysõst|tyisil|tyistõl|tõistõlõ|tyisildaq|tõisigaq|tõistõhn|tõõsõl|tyisi|tynõ|tyistõn|tyistõhn|tõist|tõistõlt|tyisiniq|tyistõgaq|tõistõ|tysõlt|tyistõlõ	<i>adj</i><br><ol><li>second</li><li>another</li></ol>
tõõsõpäiv|tõõsõpäivi|tõõsõpäivä|tõõsõpäävält|tõõsõpäivigäq|tõõsõpääväniq|tõõsõpäävile|tõõsõpäävilt|tõõsõpääviniq|tõõsõpäävähn|tõõsõpäävildäq|tõõsõpäävän|tõõsõpäävihn|tõõsõpäävägäq|tõõsõpääväl|tõõsõpäävil|tõõsõpääväle|tõõsõpäävis|tõõsõpäävin|tõõsõpääväldäq|tõõsõpäivihe|tõõsõpääväs|tõõsõpääväst|tõõsõpäävä|tõõsõpääväq|tõõsõpäävist	<i>noun</i><br><ol><li>Tuesday</li></ol>
tükk|tükkü|tüküldäq|tükkähe|tüküq|tükügäq|tükül|tükkä|tükel|tükü|tükühn|tüküst|tükält|tükehn|tükün|tükäniq|tükeldäq|tükän|tükäl|tükes|tükäle|tükäst|tükest|tükäs|tükeniq|tükkegäq|tükäldäq|tüküle|tükült|tükke|tükkehe|tüküniq|tükähn|tükkägäq|tüküs|tükele|tüken|tükelt	<i>noun</i><br><ol><li>piece, bit</li></ol>
tütär'|tütridegäq|tütärdes|tütrehn|tütrilt|tütrest|tütreldäq|tütres|tütris|tütärdehe|tütärdegäq|tütärden|tütrihe|tütriniq|tütren|tütregäq|tütärdel|tütrin|tütrihn|tütärdehn|tütärde|tütrit|tütreniq|tütrel|tütärdest|tütrehe|tütreq|tütärdeldäq|tütärd|tütrildäq|tütrile|tütride|tütrelt|tütrist|tütril|tütärdele|tütärdeniq|tütrele|tütre|tütärdelt	<i>noun</i><br><ol><li>daughter</li></ol>
tüü|töildäq|tüüniq|töist|töis|töie|töid|tüühü|töiniq|tüül|tüült|töin|töihn|tüüs|tüüd|tüün|tüühn|tüüst|töihte|töile|töil|tüüq|tüüldäq|töiegäq|tüüle|töihe|tühüq|töilt|tüügäq	<i>noun</i><br><ol><li>work, labour</li></ol>
ujoma|uioq|ujo|ujjoq	<i>verb</i><br><ol><li>to swim</li><li>to float, to drift</li></ol>
umahus|umahusõ|umahust	<i>noun</i><br><ol><li>quality, property</li></ol>
umahussyna|umahussynnohe|umahussynnogaq|umahussynalt|umahussynal|umahussynnolõ|umahussynno|umahussynos|umahussynnon|umahussynnolt|umahussynaldaq|umahussynaniq|umahussynna|umahussynnoniq|umahussynnol|umahussynalõ|umahussynoniq|umahussynagaq|umahussynnost|umahussynolt|umahussynnoldaq|umahussynolõ|umahussynoldaq|umahussynan|umahussynnohn|umahussynnos|umahussynohn|umahussynost|umahussynast|umahussynol|umahussynas|umahussynahn|umahussynaq|umahussynon	<i>noun</i><br><ol><li>(grammar) adjective</li></ol>
umakäänüs|umakäänüstegäq|umakäänüssile|umakäänüsse|umakäänüses|umakäänüssiniq|umakäänüssildäq|umakäänüseldäq|umakäänüssehe|umakäänüse|umakäänüstehe|umakäänüsehn|umakäänüssest|umakäänüssit|umakäänüssel|umakäänüsel|umakäänüssis|umakäänüssist|umakäänüstel|umakäänüselt|umakäänüsseq|umakäänüsselt|umakäänüsside|umakäänüst|umakäänüsegäq|umakäänüssidegäq|umakäänüsele|umakäänüssilt|umakäänüstes|umakäänüssen|umakäänüssehn|umakäänüstelt|umakäänüseq|umakäänüsten|umakäänüsteniq|umakäänüssil|umakäänüsses|umakäänüssegäq|umakäänüstele|umakäänüssihn|umakäänüsseniq|umakäänüseniq|umakäänüsest|umakäänüstehn|umakäänüstest|umakäänüsteldäq|umakäänüssihe|umakäänüssele|umakäänüsen|umakäänüsseldäq|umakäänüste|umakäänüssin	<i>noun</i><br><ol><li>(grammar) genitive case</li></ol>
umblõma|ummõldaq|umblõ	<i>verb</i><br><ol><li>to sew</li></ol>
uno|unno	<i>noun</i><br><ol><li>maternal uncle</li></ol>
urbõkuu|urbõkuihtõ|urbõkuust|urbõkuuniq|urbõkuuldaq|urbõkuuq|urbõkuid|urbõkuud|urbõkuun|urbõkuus|urbõkuildaq|urbõkuis|urbõkuiõgaq|urbõkuihn|urbõkuuhõ|urbõkuiniq|urbõkuilõ|urbõkuiõ|urbõkuul|urbõkuil|urbõkuihõ|urbõkuin|urbõkuugaq|urbõkuist|urbõkuilt|urbõkuuhtõ|urbõkuult|urbõkuuhn|urbõkuulõ	<i>noun</i><br><ol><li>March</li></ol>
uu	<i>noun</i><br><ol><li>The name of the Latin-script letter U.</li></ol>
vahtsõaastakuu|vahtsõaastakuihn|vahtsõaastakuilõ|vahtsõaastakuuq|vahtsõaastakuul|vahtsõaastakuildaq|vahtsõaastakuihtõ|vahtsõaastakuiõgaq|vahtsõaastakuil|vahtsõaastakuihõ|vahtsõaastakuud|vahtsõaastakuult|vahtsõaastakuuhn|vahtsõaastakuulõ|vahtsõaastakuugaq|vahtsõaastakuuldaq|vahtsõaastakuiniq|vahtsõaastakuis|vahtsõaastakuin|vahtsõaastakuist|vahtsõaastakuuhtõ|vahtsõaastakuuhõ|vahtsõaastakuus|vahtsõaastakuid|vahtsõaastakuilt|vahtsõaastakuun|vahtsõaastakuust|vahtsõaastakuuniq|vahtsõaastakuiõ	<i>noun</i><br><ol><li>January</li></ol>
vahtsõaastapäiv|vahtsõaastapäävile|vahtsõaastapäävil|vahtsõaastapääväs|vahtsõaastapäävist|vahtsõaastapääväq|vahtsõaastapäivi|vahtsõaastapäävägäq|vahtsõaastapäivihe|vahtsõaastapäävähn|vahtsõaastapäävä|vahtsõaastapäävän|vahtsõaastapäivä|vahtsõaastapääväniq|vahtsõaastapääväle|vahtsõaastapäävihn|vahtsõaastapääväst|vahtsõaastapäävis|vahtsõaastapäävildäq|vahtsõaastapäävält|vahtsõaastapäävilt|vahtsõaastapäävin|vahtsõaastapääväldäq|vahtsõaastapääviniq|vahtsõaastapääväl|vahtsõaastapäivigäq	<i>noun</i><br><ol><li>New Year's Day</li></ol>
vahtsõnõ|vahtsõ|vahtsõt	<i>adj</i><br><ol><li>new</li></ol>
valgõ|valgõniq|valgit|valgihn|valgõt|valgõlõ|valginiq|valgõhe|valgist|valgildaq|valgõst|valgõq|valgilt|valgõn|valgidõgaq|valgõhn|valgin|valgõl|valgõldaq|valgil|valgihe|valgõgaq|valgõs|valgõlt|valgidõ|valgis|valgilõ	<i>adj</i><br><ol><li>white</li></ol>
vana|vahnos|vahnohn|vahnogaq|vannoldaq|vanna|vannohn|vanaldaq|vahnaldaq|vahnast|vannol|vahnahn|vanas|vahnolõ|vannogaq|vanalt|vahnalõ|vanohn|vannon|vanal|vanolt|vanoldaq|vanos|vahnol|vahnohe|vanost|vanahn|vannolt|vahnolt|vahnoniq|vahnost|vanalõ|vannos|vahnan|vahnon|vanagaq|vannohe|vahnaq|vananiq|vahnas|vahnoldaq|vahnagaq|vahna|vanaq|vanolõ|vanoniq|vanno|vahn|vahnal|vanast|vannolõ|vahno|vanan|vanol|vannoniq|vannost|vahnalt|vahnaniq|vanon	<i>adj</i><br><ol><li>old</li></ol>
vari|var'ogaq|var'oldaq|varja|var'ol|var'o|varjõhe|var'alõ|varjo|var'al|var'ahn|varjagaq|var'oq|varjahe|var'õl|var'olt|var'õst|var'an|var'ast|var'õldaq|var'õn|var'õlõ|var'õhn|var'õlt|var'alt|var'õs|var'aldaq|var'as|var'ost|var'aniq|varjõgaq|varjõ|var'olõ|var'on|var'oniq|var'õniq|var'ohn|var'os	<i>noun</i><br><ol><li>shadow</li></ol>
varõs|varõstõlõ|varõstõlt|varõstõniq|varõssõ|varõstõs|varõssõgaq|varõsõniq|varõstõgaq|varõsõhn|varõstõldaq|varõsõq|varõssin|varõssiniq|varõssihe|varõsõl|varõsõldaq|varõst|varõssõniq|varõssildaq|varõssõhe|varõssit|varõssist|varõssidõ|varõstõst|varõstõl|varõssõs|varõssil|varõssõst|varõssidõgaq|varõssõlt|varõsõlt|varõssilt|varõssõldaq|varõsõst|varõssõl|varõsõ|varõstõhn|varõstõhe|varõssilõ|varõsõs|varõssis|varõsõlõ|varõsõgaq|varõssõhn|varõssõn|varõstõn|varõssihn|varõssõlõ|varõssõq|varõstõ|varõsõn	<i>noun</i><br><ol><li>crow</li></ol>
vask'|vasõ|vaskõ	<i>noun</i><br><ol><li>copper</li></ol>
vedelüs	<i>noun</i><br><ol><li>liquid</li></ol>
vee	<i>noun</i><br><ol><li>The name of the Latin-script letter V.</li></ol>
veli|vele|veljä|velle	<i>noun</i><br><ol><li>brother</li></ol>
veri|verd|vere	<i>noun</i><br><ol><li>blood</li></ol>
vesi|vett|vii	<i>noun</i><br><ol><li>water</li></ol>
viha|vihha	<i>noun</i><br><ol><li>anger, rage</li><li>hatred</li></ol>
vihm|vihma	<i>noun</i><br><ol><li>rain</li></ol>
viimä|viiäq|vii	<i>verb</i><br><ol><li>to carry</li><li>to lead</li></ol>
viir'|viirt|veere	<i>noun</i><br><ol><li>edge, fringe</li><li>shore, beach</li></ol>
viis'|viit|viie	<i>num</i><br><ol><li>five</li></ol>
vineh|vinne|vineht	<i>noun</i><br><ol><li>boat</li></ol>
vägi|väkiniq|väkki|väkkihe|väele|väkihn|väkilt|väke|väeldäq|väeniq|väe|väegäq|väest|väkildäq|väehn|väkin|väkigäq|väeq|väes|väkil|väen|väelt|väkis|väkke|väel|väkist|väki|väkile	<i>noun</i><br><ol><li>might, strength</li><li>force</li><li>energy</li></ol>
väits'|väistel|väistelt|väitsi|väidsis|väisteldäq|väidsihn|väidsen|väidselt|väidsehn|väistele|väidsegäq|väidsist|väidse|väidsel|väisten|väitsihe|väidsele|väidseldäq|väisteniq|väistest|väidseniq|väist|väistes|väidses|väidsin|väiste|väistegäq|väidsiniq|väitsigäq|väidseq|väidsile|väidsest|väidsil|väidsilt|väidsildäq|väistehn	<i>noun</i><br><ol><li>knife</li></ol>
väü|vävvü	<i>noun</i><br><ol><li>son-in-law</li></ol>
võid|võiu|võidu	<i>noun</i><br><ol><li>butter</li></ol>
võima|võidaq|või	<i>verb</i><br><ol><li>to be able, can</li><li>to be allowed</li></ol>
võitma|võitaq|võida	<i>verb</i><br><ol><li>to defeat, to beat</li><li>to win</li><li>to gain</li></ol>
võrokõnõ|võrokõsõldaq|võrokõist|võrokõistõniq|võrokõsõl|võrokõistõst|võrokõisihe|võrokõsõq|võrokõsõ|võrokõisis|võrokõisilõ|võrokõisihn|võrokõsõniq|võrokõistõ|võrokõisildaq|võrokõistõlõ|võrokõisilt|võrokõisin|võrokõsõst|võrokõisigaq|võrokõistõs|võrokõistõn|võrokõsõs|võrokõistõlt|võrokõistõldaq|võrokõisi|võrokõsõn|võrokõsõlt|võrokõisiniq|võrokõistõl|võrokõisist|võrokõsõlõ|võrokõisil|võrokõsõhn|võrokõistõhn|võrokõsõgaq|võrokõistõgaq	<i>noun</i><br><ol><li>Võro, person from Võru county</li></ol>
võtma|võta|võttaq	<i>verb</i><br><ol><li>to take</li></ol>
ynn'|ynnõ	<i>noun</i><br><ol><li>happiness</li></ol>
zett	<i>noun</i><br><ol><li>The name of the Latin-script letter Z.</li></ol>
Õdagumeri|Õdagumeren|Õdagumerehn|Õdagumerele|Õdagumereniq|Õdagumerest|Õdagumere|Õdagumerde|Õdagumerelt|Õdagumerd|Õdagumeres|Õdagumereldäq|Õdagumeregäq|Õdagumerel	<i>name</i><br><ol><li>Baltic Sea</li></ol>
Õuruupa Liit	<i>name</i><br><ol><li>The European Union (EU)</li></ol>
Ütiskuningriik'|Ütiskuningriigis|Ütiskuningriiki|Ütiskuningriigildäq|Ütiskuningriigigäq|Ütiskuningriigin|Ütiskuningriik|Ütiskuningriigilt|Ütiskuningriigi|Ütiskuningriigist|Ütiskuningriigihn|Ütiskuningriigil|Ütiskuningriigile|Ütiskuningriiginiq	<i>name</i><br><ol><li>United Kingdom</li></ol>
ää	<i>noun</i><br><ol><li>The name of the Latin-script letter Ä.</li></ol>
õdak|õtak|õdagu|õdagut	<i>noun</i><br><ol><li>evening</li><li>west</li></ol>
õigõ|õigidõgaq|õigõldaq|õigõn|õigilt|õigõt|õigõhn|õigin|õigõhe|õigõl|õigil|õigihn|õiginiq|õigilõ|õigõgaq|õigildaq|õigõq|õigit|õigõniq|õigihe|õigõlt|õigõs|õigis|õigidõ|õigõlõ|õigist|õigõst	<i>adj</i><br><ol><li>right, correct</li><li>straight (not bent)</li></ol>
õõ	<i>noun</i><br><ol><li>The name of the Latin-script letter Õ.</li></ol>
öö	<i>noun</i><br><ol><li>The name of the Latin-script letter Ö.</li></ol>
üten	<i>adv</i><br><ol><li>together</li><li>along, along with</li></ol>
ütenkäänüs|ütenkäänüssehn|ütenkäänüsest|ütenkäänüse|ütenkäänüstest|ütenkäänüstel|ütenkäänüsselt|ütenkäänüsseniq|ütenkäänüssidegäq|ütenkäänüselt|ütenkäänüstehn|ütenkäänüssele|ütenkäänüsside|ütenkäänüssiniq|ütenkäänüsegäq|ütenkäänüsseq|ütenkäänüsteniq|ütenkäänüsele|ütenkäänüssil|ütenkäänüstes|ütenkäänüssildäq|ütenkäänüsteldäq|ütenkäänüstegäq|ütenkäänüst|ütenkäänüssehe|ütenkäänüssihn|ütenkäänüsehn|ütenkäänüsel|ütenkäänüstelt|ütenkäänüseldäq|ütenkäänüssile|ütenkäänüseniq|ütenkäänüssegäq|ütenkäänüsse|ütenkäänüssis|ütenkäänüsseldäq|ütenkäänüssihe|ütenkäänüstehe|ütenkäänüsses|ütenkäänüsen|ütenkäänüses|ütenkäänüssin|ütenkäänüssest|ütenkäänüsten|ütenkäänüssen|ütenkäänüssist|ütenkäänüssit|ütenkäänüssilt|ütenkäänüseq|ütenkäänüstele|ütenkäänüste|ütenkäänüssel	<i>noun</i><br><ol><li>(grammar) comitative case</li></ol>
ütessä|ütsät|ütesä|ütsä	<i>num</i><br><ol><li>nine</li></ol>
ütiskund|ütiskundõhe|ütiskunnagaq|ütiskunnal|ütiskunnan|ütiskunnõlõ|ütiskunnahn|ütiskunnaq|ütiskunnõn|ütiskunnõhn|ütiskundõgaq|ütiskundõ|ütiskunnõldaq|ütiskunnõs|ütiskunnõl|ütiskunnast|ütiskunnaniq|ütiskunnõniq|ütiskunnalt|ütiskunnõst|ütiskunda|ütiskunnaldaq|ütiskunna|ütiskunnõlt|ütiskunnas|ütiskunnalõ	<i>noun</i><br><ol><li>community</li><li>society</li></ol>
üts'|ütte|üte	<i>num</i><br><ol><li>one</li></ol>
ütsüs|ütsüseq|ütsüstelt|ütsüstele|ütsüisihn|ütsüstest|ütsüisi|ütsüisis|ütsüste|ütsüisin|ütsüsteniq|ütsüseniq|ütsüsest|ütsüisildäq|ütsüsehn|ütsüsten|ütsüstehn|ütsüisiniq|ütsüisile|ütsüseldäq|ütsüsel|ütsüselt|ütsüisigäq|ütsüisilt|ütsüisil|ütsüstel|ütsüsen|ütsüses|ütsüstes|ütsüisist|ütsüse|ütsüisihe|ütsüsteldäq|ütsüsegäq|ütsüstegäq|ütsüsele|ütsüst	<i>noun</i><br><ol><li>(grammar) singular</li><li>unit</li></ol>
üü|üüniq|üül|öist|üühe|üühn|öid|öihte|öin|öilt|üün|öildäq|öihe|öile|üüst|üüle|üült|üüldäq|öie|üügäq|öis|üüs|üüq|öiegäq|öil|üühte|üüd|öihn|öiniq	<i>noun</i><br><ol><li>night</li><li>The name of the Latin-script letter Ü.</li></ol>
žee	<i>noun</i><br><ol><li>The name of the Latin-script letter Ž.</li></ol>
